start,end,duration,saccade,blink,fixation,eye
5086089,5086330,241,0,0,1,1
5086089,5086330,241,0,0,1,2
5086331,5086389,58,1,0,0,1
5086331,5086393,62,1,0,0,2
5086390,5086494,104,0,0,1,1
5086394,5086490,96,0,0,1,2
5086491,5086513,22,1,0,0,2
5086495,5086514,19,1,0,0,1
5086514,5088259,1745,0,0,1,2
5086515,5088261,1746,0,0,1,1
5088260,5088318,58,1,0,0,2
5088262,5088321,59,1,0,0,1
5088319,5088456,137,0,0,1,2
5088322,5088451,129,0,0,1,1
5088452,5088470,18,1,0,0,1
5088457,5088469,12,1,0,0,2
5088470,5090059,1589,0,0,1,2
5088471,5090059,1588,0,0,1,1
5090060,5090125,65,1,0,0,2
5090060,5090143,83,1,0,0,1
5090126,5090231,105,0,0,1,2
5090144,5090232,88,0,0,1,1
5090232,5090264,32,1,0,0,2
5090233,5090272,39,1,0,0,1
5090265,5090417,152,0,0,1,2
5090273,5090417,144,0,0,1,1
5090418,5090444,26,1,0,0,2
5090418,5090449,31,1,0,0,1
5090445,5091661,1216,0,0,1,2
5090450,5091662,1212,0,0,1,1
5091662,5091738,76,1,0,0,2
5091663,5091745,82,1,0,0,1
5091739,5091906,167,0,0,1,2
5091746,5091904,158,0,0,1,1
5091905,5091955,50,1,0,0,1
5091907,5091927,20,1,0,0,2
5091928,5093222,1294,0,0,1,2
5091956,5093223,1267,0,0,1,1
5093223,5093306,83,1,0,0,2
5093224,5093306,82,1,0,0,1
5093307,5093405,98,0,0,1,1
5093307,5093406,99,0,0,1,2
5093406,5093433,27,1,0,0,1
5093407,5093444,37,1,0,0,2
5093434,5093598,164,0,0,1,1
5093445,5093592,147,0,0,1,2
5093593,5093623,30,1,0,0,2
5093599,5093613,14,1,0,0,1
5093614,5094687,1073,0,0,1,1
5093624,5094686,1062,0,0,1,2
5094687,5094792,105,1,0,0,2
5094688,5094793,105,1,0,0,1
5094793,5094829,36,0,0,1,2
5094794,5094830,36,0,0,1,1
5094830,5094857,27,1,0,0,2
5094831,5094870,39,1,0,0,1
5094858,5095002,144,0,0,1,2
5094871,5095002,131,0,0,1,1
5095003,5095035,32,1,0,0,2
5095003,5095036,33,1,0,0,1
5095036,5096344,1308,0,0,1,2
5095037,5096343,1306,0,0,1,1
5096344,5096418,74,1,0,0,1
5096345,5096420,75,1,0,0,2
5096419,5096496,77,0,0,1,1
5096421,5096496,75,0,0,1,2
5096497,5096531,34,1,0,0,1
5096497,5096532,35,1,0,0,2
5096532,5096706,174,0,0,1,1
5096533,5096707,174,0,0,1,2
5096707,5096739,32,1,0,0,1
5096708,5096737,29,1,0,0,2
5096738,5097874,1136,0,0,1,2
5096740,5097873,1133,0,0,1,1
5097874,5097956,82,1,0,0,1
5097875,5097948,73,1,0,0,2
5097949,5098110,161,0,0,1,2
5097957,5098112,155,0,0,1,1
5098111,5098134,23,1,0,0,2
5098113,5098144,31,1,0,0,1
5098135,5099590,1455,0,0,1,2
5098145,5099210,1065,0,0,1,1
5099211,5099270,59,1,0,0,1
5099271,5099480,209,0,0,1,1
5099481,5099500,19,1,0,0,1
5099501,5099591,90,0,0,1,1
5099591,5099704,113,1,0,0,2
5099592,5099689,97,1,0,0,1
5099690,5099839,149,0,0,1,1
5099705,5099836,131,0,0,1,2
5099837,5099857,20,1,0,0,2
5099840,5099856,16,1,0,0,1
5099857,5101300,1443,0,0,1,1
5099858,5101301,1443,0,0,1,2
5101301,5101403,102,1,0,0,1
5101302,5101401,99,1,0,0,2
5101402,5101569,167,0,0,1,2
5101404,5101573,169,0,0,1,1
5101570,5101588,18,1,0,0,2
5101574,5101595,21,1,0,0,1
5101589,5102948,1359,0,0,1,2
5101596,5102949,1353,0,0,1,1
5102949,5103025,76,1,0,0,2
5102950,5103025,75,1,0,0,1
5103026,5103133,107,0,0,1,2
5103026,5103134,108,0,0,1,1
5103134,5103173,39,1,0,0,2
5103135,5103165,30,1,0,0,1
5103166,5104649,1483,0,0,1,1
5103174,5104648,1474,0,0,1,2
5104649,5104731,82,1,0,0,2
5104650,5104747,97,1,0,0,1
5104732,5104779,47,0,0,1,2
5104748,5104776,28,0,0,1,1
5104777,5104812,35,1,0,0,1
5104780,5104803,23,1,0,0,2
5104804,5104857,53,0,0,1,2
5104813,5104859,46,0,0,1,1
5104858,5104892,34,1,0,0,2
5104860,5104890,30,1,0,0,1
5104891,5106269,1378,0,0,1,1
5104893,5106269,1376,0,0,1,2
5106270,5106341,71,1,0,0,2
5106270,5106346,76,1,0,0,1
5106342,5106463,121,0,0,1,2
5106347,5106463,116,0,0,1,1
5106464,5106485,21,1,0,0,1
5106464,5106485,21,1,0,0,2
5106486,5107939,1453,0,0,1,1
5106486,5107939,1453,0,0,1,2
5107940,5108006,66,1,0,0,2
5107940,5108021,81,1,0,0,1
5108007,5108060,53,0,0,1,2
5108022,5108060,38,0,0,1,1
5108061,5108096,35,1,0,0,2
5108061,5108097,36,1,0,0,1
5108097,5108173,76,0,0,1,2
5108098,5108170,72,0,0,1,1
5108171,5108208,37,1,0,0,1
5108174,5108209,35,1,0,0,2
5108209,5109549,1340,0,0,1,1
5108210,5109551,1341,0,0,1,2
5109550,5109625,75,1,0,0,1
5109552,5109617,65,1,0,0,2
5109618,5109671,53,0,0,1,2
5109626,5109671,45,0,0,1,1
5109672,5109757,85,1,0,0,1
5109672,5109762,90,1,0,0,2
5109758,5109853,95,0,0,1,1
5109763,5109853,90,0,0,1,2
5109854,5109890,36,1,0,0,2
5109854,5109892,38,1,0,0,1
5109891,5111445,1554,0,0,1,2
5109893,5111443,1550,0,0,1,1
5111444,5111541,97,1,0,0,1
5111446,5111545,99,1,0,0,2
5111542,5111628,86,0,0,1,1
5111546,5111628,82,0,0,1,2
5111629,5111662,33,1,0,0,1
5111629,5111665,36,1,0,0,2
5111663,5113105,1442,0,0,1,1
5111666,5113105,1439,0,0,1,2
5113106,5113148,42,1,0,0,1
5113106,5113157,51,1,0,0,2
5113149,5113266,117,0,0,1,1
5113158,5113267,109,0,0,1,2
5113267,5113298,31,1,0,0,1
5113268,5113295,27,1,0,0,2
5113296,5114718,1422,0,0,1,2
5113299,5114715,1416,0,0,1,1
5114716,5114790,74,1,0,0,1
5114719,5114793,74,1,0,0,2
5114791,5114907,116,0,0,1,1
5114794,5114908,114,0,0,1,2
5114908,5114931,23,1,0,0,1
5114909,5114943,34,1,0,0,2
5114932,5116303,1371,0,0,1,1
5114944,5116301,1357,0,0,1,2
5116302,5116369,67,1,0,0,2
5116304,5116377,73,1,0,0,1
5116370,5116490,120,0,0,1,2
5116378,5116488,110,0,0,1,1
5116489,5116520,31,1,0,0,1
5116491,5116520,29,1,0,0,2
5116521,5117839,1318,0,0,1,1
5116521,5117840,1319,0,0,1,2
5117840,5117938,98,1,0,0,1
5117841,5117905,64,1,0,0,2
5117906,5118056,150,0,0,1,2
5117939,5118055,116,0,0,1,1
5118056,5118086,30,1,0,0,1
5118057,5118084,27,1,0,0,2
5118085,5119361,1276,0,0,1,2
5118087,5119362,1275,0,0,1,1
5119362,5119475,113,1,0,0,2
5119363,5119464,101,1,0,0,1
5119465,5119574,109,0,0,1,1
5119476,5119574,98,0,0,1,2
5119575,5119597,22,1,0,0,1
5119575,5119597,22,1,0,0,2
5119598,5119801,203,0,0,1,2
5119598,5119803,205,0,0,1,1
5119802,5119815,13,1,0,0,2
5119804,5119813,9,1,0,0,1
5119814,5121010,1196,0,0,1,1
5119816,5121010,1194,0,0,1,2
5121011,5121093,82,1,0,0,2
5121011,5121099,88,1,0,0,1
5121094,5121168,74,0,0,1,2
5121100,5121168,68,0,0,1,1
5121169,5121206,37,1,0,0,1
5121169,5121206,37,1,0,0,2
5121207,5121347,140,0,0,1,1
5121207,5121347,140,0,0,1,2
5121348,5121377,29,1,0,0,2
5121348,5121378,30,1,0,0,1
5121378,5122584,1206,0,0,1,2
5121379,5122584,1205,0,0,1,1
5122585,5122661,76,1,0,0,2
5122585,5122665,80,1,0,0,1
5122662,5122778,116,0,0,1,2
5122666,5122779,113,0,0,1,1
5122779,5122814,35,1,0,0,2
5122780,5122817,37,1,0,0,1
5122815,5123991,1176,0,0,1,2
5122818,5123993,1175,0,0,1,1
5123992,5124078,86,1,0,0,2
5123994,5124069,75,1,0,0,1
5124070,5124174,104,0,0,1,1
5124079,5124173,94,0,0,1,2
5124174,5124213,39,1,0,0,2
5124175,5124199,24,1,0,0,1
5124200,5125746,1546,0,0,1,1
5124214,5125746,1532,0,0,1,2
5125747,5125816,69,1,0,0,1
5125747,5125820,73,1,0,0,2
5125817,5125893,76,0,0,1,1
5125821,5125893,72,0,0,1,2
5125894,5125917,23,1,0,0,1
5125894,5125923,29,1,0,0,2
5125918,5127519,1601,0,0,1,1
5125924,5127519,1595,0,0,1,2
5127520,5127575,55,1,0,0,2
5127520,5127591,71,1,0,0,1
5127576,5127707,131,0,0,1,2
5127592,5127708,116,0,0,1,1
5127708,5127736,28,1,0,0,2
5127709,5127739,30,1,0,0,1
5127737,5129093,1356,0,0,1,2
5127740,5129093,1353,0,0,1,1
5129094,5129181,87,1,0,0,2
5129094,5129192,98,1,0,0,1
5129182,5129349,167,0,0,1,2
5129193,5129350,157,0,0,1,1
5129350,5129383,33,1,0,0,2
5129351,5129379,28,1,0,0,1
5129380,5130823,1443,0,0,1,1
5129384,5130822,1438,0,0,1,2
5130823,5130939,116,1,0,0,2
5130824,5130937,113,1,0,0,1
5130938,5131031,93,0,0,1,1
5130940,5131031,91,0,0,1,2
5131032,5131075,43,1,0,0,1
5131032,5131087,55,1,0,0,2
5131076,5132524,1448,0,0,1,1
5131088,5131545,457,0,0,1,2
5131546,5131561,15,1,0,0,2
5131562,5132525,963,0,0,1,2
5132525,5132574,49,1,0,0,1
5132526,5132575,49,1,0,0,2
5132575,5134180,1605,0,0,1,1
5132576,5134182,1606,0,0,1,2
5134181,5134323,142,1,0,0,1
5134183,5134279,96,1,0,0,2
5134280,5134528,248,0,0,1,2
5134324,5134530,206,0,0,1,1
5134529,5134551,22,1,0,0,2
5134531,5134556,25,1,0,0,1
5134552,5135869,1317,0,0,1,2
5134557,5135870,1313,0,0,1,1
5135870,5135988,118,1,0,0,2
5135871,5135991,120,1,0,0,1
5135989,5136132,143,0,0,1,2
5135992,5136128,136,0,0,1,1
5136129,5136160,31,1,0,0,1
5136133,5136157,24,1,0,0,2
5136158,5137638,1480,0,0,1,2
5136161,5137637,1476,0,0,1,1
5137638,5137726,88,1,0,0,1
5137639,5137718,79,1,0,0,2
5137719,5137806,87,0,0,1,2
5137727,5137810,83,0,0,1,1
5137807,5137842,35,1,0,0,2
5137811,5137841,30,1,0,0,1
5137842,5138016,174,0,0,1,1
5137843,5138017,174,0,0,1,2
5138017,5138045,28,1,0,0,1
5138018,5138049,31,1,0,0,2
5138046,5139346,1300,0,0,1,1
5138050,5139344,1294,0,0,1,2
5139345,5139394,49,1,0,0,2
5139347,5139391,44,1,0,0,1
5139392,5139572,180,0,0,1,1
5139395,5141019,1624,0,0,1,2
5139573,5139590,17,1,0,0,1
5139591,5141017,1426,0,0,1,1
5141018,5141115,97,1,0,0,1
5141020,5141102,82,1,0,0,2
5141103,5141238,135,0,0,1,2
5141116,5141238,122,0,0,1,1
5141239,5141268,29,1,0,0,1
5141239,5141269,30,1,0,0,2
5141269,5142629,1360,0,0,1,1
5141270,5142629,1359,0,0,1,2
5142630,5142702,72,1,0,0,2
5142630,5142715,85,1,0,0,1
5142703,5142793,90,0,0,1,2
5142716,5142791,75,0,0,1,1
5142792,5142833,41,1,0,0,1
5142794,5142831,37,1,0,0,2
5142832,5142998,166,0,0,1,2
5142834,5142997,163,0,0,1,1
5142998,5143029,31,1,0,0,1
5142999,5143029,30,1,0,0,2
5143030,5144234,1204,0,0,1,2
5143030,5144235,1205,0,0,1,1
5144235,5144325,90,1,0,0,2
5144236,5144326,90,1,0,0,1
5144326,5144414,88,0,0,1,2
5144327,5144414,87,0,0,1,1
5144415,5144449,34,1,0,0,1
5144415,5144450,35,1,0,0,2
5144450,5145880,1430,0,0,1,1
5144451,5145880,1429,0,0,1,2
5145881,5145956,75,1,0,0,2
5145881,5145966,85,1,0,0,1
5145957,5146055,98,0,0,1,2
5145967,5146056,89,0,0,1,1
5146056,5146094,38,1,0,0,2
5146057,5146103,46,1,0,0,1
5146095,5146488,393,0,0,1,2
5146104,5146488,384,0,0,1,1
5146489,5146510,21,1,0,0,2
5146489,5146518,29,1,0,0,1
5146511,5147544,1033,0,0,1,2
5146519,5147540,1021,0,0,1,1
5147541,5147633,92,1,0,0,1
5147545,5147636,91,1,0,0,2
5147634,5147714,80,0,0,1,1
5147637,5147714,77,0,0,1,2
5147715,5147764,49,1,0,0,1
5147715,5147764,49,1,0,0,2
5147765,5147936,171,0,0,1,2
5147765,5147942,177,0,0,1,1
5147937,5147956,19,1,0,0,2
5147943,5147955,12,1,0,0,1
5147956,5149248,1292,0,0,1,1
5147957,5149247,1290,0,0,1,2
5149248,5149335,87,1,0,0,2
5149249,5149347,98,1,0,0,1
5149336,5149405,69,0,0,1,2
5149348,5149405,57,0,0,1,1
5149406,5149442,36,1,0,0,2
5149406,5149443,37,1,0,0,1
5149443,5149575,132,0,0,1,2
5149444,5149574,130,0,0,1,1
5149575,5149622,47,1,0,0,1
5149576,5149613,37,1,0,0,2
5149614,5150843,1229,0,0,1,2
5149623,5150843,1220,0,0,1,1
5150844,5150919,75,1,0,0,1
5150844,5150930,86,1,0,0,2
5150920,5151095,175,0,0,1,1
5150931,5151091,160,0,0,1,2
5151092,5151114,22,1,0,0,2
5151096,5151136,40,1,0,0,1
5151115,5152538,1423,0,0,1,2
5151137,5152538,1401,0,0,1,1
5152539,5152590,51,1,0,0,1
5152539,5152590,51,1,0,0,2
5152591,5153948,1357,0,0,1,1
5152591,5153948,1357,0,0,1,2
5153949,5154044,95,1,0,0,2
5153949,5154048,99,1,0,0,1
5154045,5154124,79,0,0,1,2
5154049,5154124,75,0,0,1,1
5154125,5154174,49,1,0,0,2
5154125,5154176,51,1,0,0,1
5154175,5154367,192,0,0,1,2
5154177,5154366,189,0,0,1,1
5154367,5154398,31,1,0,0,1
5154368,5154386,18,1,0,0,2
5154387,5155600,1213,0,0,1,2
5154399,5155599,1200,0,0,1,1
5155600,5155698,98,1,0,0,1
5155601,5155700,99,1,0,0,2
5155699,5155798,99,0,0,1,1
5155701,5155798,97,0,0,1,2
5155799,5155840,41,1,0,0,2
5155799,5155843,44,1,0,0,1
5155841,5157283,1442,0,0,1,2
5155844,5157283,1439,0,0,1,1
5157284,5157346,62,1,0,0,2
5157284,5157357,73,1,0,0,1
5157347,5157456,109,0,0,1,2
5157358,5157458,100,0,0,1,1
5157457,5157493,36,1,0,0,2
5157459,5157502,43,1,0,0,1
5157494,5157791,297,0,0,1,2
5157503,5157791,288,0,0,1,1
5157792,5157814,22,1,0,0,2
5157792,5157827,35,1,0,0,1
5157815,5158943,1128,0,0,1,2
5157828,5158944,1116,0,0,1,1
5158944,5159060,116,1,0,0,2
5158945,5159057,112,1,0,0,1
5159058,5159162,104,0,0,1,1
5159061,5159161,100,0,0,1,2
5159162,5159204,42,1,0,0,2
5159163,5159202,39,1,0,0,1
5159203,5160575,1372,0,0,1,1
5159205,5160575,1370,0,0,1,2
5160576,5160638,62,1,0,0,2
5160576,5160645,69,1,0,0,1
5160639,5160693,54,0,0,1,2
5160646,5160694,48,0,0,1,1
5160694,5160731,37,1,0,0,2
5160695,5160740,45,1,0,0,1
5160732,5160886,154,0,0,1,2
5160741,5160886,145,0,0,1,1
5160887,5160906,19,1,0,0,2
5160887,5160907,20,1,0,0,1
5160907,5162254,1347,0,0,1,2
5160908,5162251,1343,0,0,1,1
5162252,5162321,69,1,0,0,1
5162255,5162312,57,1,0,0,2
5162313,5162432,119,0,0,1,2
5162322,5162436,114,0,0,1,1
5162433,5162466,33,1,0,0,2
5162437,5162460,23,1,0,0,1
5162461,5163874,1413,0,0,1,1
5162467,5163875,1408,0,0,1,2
5163875,5163952,77,1,0,0,1
5163876,5163951,75,1,0,0,2
5163952,5164047,95,0,0,1,2
5163953,5164047,94,0,0,1,1
5164048,5164080,32,1,0,0,2
5164048,5164083,35,1,0,0,1
5164081,5165472,1391,0,0,1,2
5164084,5165472,1388,0,0,1,1
5165473,5165529,56,1,0,0,2
5165473,5165530,57,1,0,0,1
5165530,5165704,174,0,0,1,2
5165531,5165702,171,0,0,1,1
5165703,5165716,13,1,0,0,1
5165705,5165719,14,1,0,0,2
5165717,5167182,1465,0,0,1,1
5165720,5167181,1461,0,0,1,2
5167182,5167259,77,1,0,0,2
5167183,5167267,84,1,0,0,1
5167260,5167406,146,0,0,1,2
5167268,5167403,135,0,0,1,1
5167404,5167552,148,1,0,0,1
5167407,5167545,138,1,0,0,2
5167432,5167525,93,0,1,0,1
5167440,5167500,60,0,1,0,2
5167546,5167876,330,0,0,1,2
5167553,5167877,324,0,0,1,1
5167877,5167901,24,1,0,0,2
5167878,5167901,23,1,0,0,1
5167902,5168106,204,0,0,1,2
5167902,5168107,205,0,0,1,1
5168107,5168179,72,1,0,0,2
5168108,5168181,73,1,0,0,1
5168180,5168296,116,0,0,1,2
5168182,5168297,115,0,0,1,1
5168297,5168334,37,1,0,0,2
5168298,5168324,26,1,0,0,1
5168325,5168497,172,0,0,1,1
5168335,5168497,162,0,0,1,2
5168498,5168508,10,1,0,0,1
5168498,5168521,23,1,0,0,2
5168509,5170800,2291,0,0,1,1
5168522,5170801,2279,0,0,1,2
5170801,5170850,49,1,0,0,1
5170802,5170855,53,1,0,0,2
5170851,5171004,153,0,0,1,1
5170856,5171005,149,0,0,1,2
5171005,5171029,24,1,0,0,1
5171006,5171033,27,1,0,0,2
5171030,5173007,1977,0,0,1,1
5171034,5173010,1976,0,0,1,2
5173008,5173210,202,1,0,0,1
5173011,5173194,183,1,0,0,2
5173049,5173167,118,0,1,0,1
5173056,5173135,79,0,1,0,2
5173195,5173616,421,0,0,1,2
5173211,5173617,406,0,0,1,1
5173617,5173662,45,1,0,0,2
5173618,5173661,43,1,0,0,1
5173662,5174582,920,0,0,1,1
5173663,5174583,920,0,0,1,2
5174583,5174629,46,1,0,0,1
5174584,5174630,46,1,0,0,2
5174630,5174819,189,0,0,1,1
5174631,5174819,188,0,0,1,2
5174820,5174883,63,1,0,0,1
5174820,5174893,73,1,0,0,2
5174884,5174965,81,0,0,1,1
5174894,5174965,71,0,0,1,2
5174966,5175001,35,1,0,0,2
5174966,5175002,36,1,0,0,1
5175002,5175122,120,0,0,1,2
5175003,5175123,120,0,0,1,1
5175123,5175153,30,1,0,0,2
5175124,5175144,20,1,0,0,1
5175145,5176532,1387,0,0,1,1
5175154,5176533,1379,0,0,1,2
5176533,5176583,50,1,0,0,1
5176534,5176580,46,1,0,0,2
5176581,5178677,2096,0,0,1,2
5176584,5178674,2090,0,0,1,1
5178675,5178883,208,1,0,0,1
5178678,5178862,184,1,0,0,2
5178724,5178835,111,0,1,0,1
5178730,5178818,88,0,1,0,2
5178863,5179236,373,0,0,1,2
5178884,5179236,352,0,0,1,1
5179237,5179285,48,1,0,0,2
5179237,5179287,50,1,0,0,1
5179286,5179609,323,0,0,1,2
5179288,5179609,321,0,0,1,1
5179610,5179663,53,1,0,0,2
5179610,5179664,54,1,0,0,1
5179664,5180050,386,0,0,1,2
5179665,5180048,383,0,0,1,1
5180049,5180089,40,1,0,0,1
5180051,5180101,50,1,0,0,2
5180090,5180302,212,0,0,1,1
5180102,5180301,199,0,0,1,2
5180302,5180372,70,1,0,0,2
5180303,5180370,67,1,0,0,1
5180371,5180470,99,0,0,1,1
5180373,5180468,95,0,0,1,2
5180469,5180500,31,1,0,0,2
5180471,5180502,31,1,0,0,1
5180501,5180688,187,0,0,1,2
5180503,5180689,186,0,0,1,1
5180689,5180700,11,1,0,0,2
5180690,5180701,11,1,0,0,1
5180701,5181049,348,0,0,1,2
5180702,5181655,953,0,0,1,1
5181050,5181054,4,1,0,0,2
5181055,5181655,600,0,0,1,2
5181656,5181714,58,1,0,0,2
5181656,5181715,59,1,0,0,1
5181715,5183799,2084,0,0,1,2
5181716,5183798,2082,0,0,1,1
5183799,5183981,182,1,0,0,1
5183800,5183968,168,1,0,0,2
5183833,5183941,108,0,1,0,1
5183844,5183925,81,0,1,0,2
5183969,5184630,661,0,0,1,2
5183982,5184632,650,0,0,1,1
5184631,5184674,43,1,0,0,2
5184633,5184682,49,1,0,0,1
5184675,5185030,355,0,0,1,2
5184683,5185029,346,0,0,1,1
5185030,5185095,65,1,0,0,1
5185031,5185098,67,1,0,0,2
5185096,5185201,105,0,0,1,1
5185099,5185202,103,0,0,1,2
5185202,5185238,36,1,0,0,1
5185203,5185242,39,1,0,0,2
5185239,5185407,168,0,0,1,1
5185243,5185405,162,0,0,1,2
5185406,5185422,16,1,0,0,2
5185408,5185423,15,1,0,0,1
5185423,5186232,809,0,0,1,2
5185424,5186232,808,0,0,1,1
5186233,5186282,49,1,0,0,1
5186233,5186290,57,1,0,0,2
5186283,5188443,2160,0,0,1,1
5186291,5188445,2154,0,0,1,2
5188444,5188622,178,1,0,0,1
5188446,5188610,164,1,0,0,2
5188471,5188581,110,0,1,0,1
5188477,5188568,91,0,1,0,2
5188611,5189365,754,0,0,1,2
5188623,5189365,742,0,0,1,1
5189366,5189422,56,1,0,0,2
5189366,5189423,57,1,0,0,1
5189423,5189533,110,0,0,1,2
5189424,5189534,110,0,0,1,1
5189534,5189613,79,1,0,0,2
5189535,5189622,87,1,0,0,1
5189614,5189719,105,0,0,1,2
5189623,5189719,96,0,0,1,1
5189720,5189759,39,1,0,0,2
5189720,5189764,44,1,0,0,1
5189760,5191158,1398,0,0,1,2
5189765,5191159,1394,0,0,1,1
5191159,5191214,55,1,0,0,2
5191160,5191215,55,1,0,0,1
5191215,5193359,2144,0,0,1,2
5191216,5193360,2144,0,0,1,1
5193360,5193523,163,1,0,0,2
5193361,5193512,151,1,0,0,1
5193391,5193453,62,0,1,0,1
5193394,5193449,55,0,1,0,2
5193513,5193735,222,0,0,1,1
5193524,5193736,212,0,0,1,2
5193736,5193779,43,1,0,0,1
5193737,5193787,50,1,0,0,2
5193780,5194806,1026,0,0,1,1
5193788,5194805,1017,0,0,1,2
5194806,5194863,57,1,0,0,2
5194807,5194863,56,1,0,0,1
5194864,5195035,171,0,0,1,2
5194864,5195036,172,0,0,1,1
5195036,5195057,21,1,0,0,2
5195037,5195055,18,1,0,0,1
5195056,5195357,301,0,0,1,1
5195058,5195358,300,0,0,1,2
5195358,5195377,19,1,0,0,1
5195359,5195387,28,1,0,0,2
5195378,5195555,177,0,0,1,1
5195388,5195549,161,0,0,1,2
5195550,5195568,18,1,0,0,2
5195556,5195568,12,1,0,0,1
5195569,5196404,835,0,0,1,1
5195569,5196404,835,0,0,1,2
5196405,5196466,61,1,0,0,2
5196405,5196474,69,1,0,0,1
5196467,5198632,2165,0,0,1,2
5196475,5198639,2164,0,0,1,1
5198633,5198776,143,1,0,0,2
5198640,5198778,138,1,0,0,1
5198657,5198745,88,0,1,0,1
5198658,5198742,84,0,1,0,2
5198777,5200153,1376,0,0,1,2
5198779,5200151,1372,0,0,1,1
5200152,5200231,79,1,0,0,1
5200154,5200232,78,1,0,0,2
5200232,5200377,145,0,0,1,1
5200233,5200375,142,0,0,1,2
5200376,5200407,31,1,0,0,2
5200378,5200409,31,1,0,0,1
5200408,5201497,1089,0,0,1,2
5200410,5201498,1088,0,0,1,1
5201498,5201573,75,1,0,0,2
5201499,5201577,78,1,0,0,1
5201574,5201736,162,0,0,1,2
5201578,5201736,158,0,0,1,1
5201737,5201758,21,1,0,0,2
5201737,5201772,35,1,0,0,1
5201759,5203632,1873,0,0,1,2
5201773,5203637,1864,0,0,1,1
5203633,5203788,155,1,0,0,2
5203638,5203769,131,1,0,0,1
5203666,5203731,65,0,1,0,2
5203667,5203730,63,0,1,0,1
5203770,5204760,990,0,0,1,1
5203789,5204758,969,0,0,1,2
5204759,5204829,70,1,0,0,2
5204761,5204820,59,1,0,0,1
5204821,5204949,128,0,0,1,1
5204830,5204949,119,0,0,1,2
5204950,5204980,30,1,0,0,1
5204950,5204982,32,1,0,0,2
5204981,5205157,176,0,0,1,1
5204983,5205155,172,0,0,1,2
5205156,5205169,13,1,0,0,2
5205158,5205169,11,1,0,0,1
5205170,5206159,989,0,0,1,2
5205170,5206160,990,0,0,1,1
5206160,5206210,50,1,0,0,2
5206161,5206210,49,1,0,0,1
5206211,5208226,2015,0,0,1,2
5206211,5208233,2022,0,0,1,1
5208227,5208397,170,1,0,0,2
5208234,5208393,159,1,0,0,1
5208255,5208349,94,0,1,0,2
5208257,5208355,98,0,1,0,1
5208394,5208624,230,0,0,1,1
5208398,5208625,227,0,0,1,2
5208625,5208688,63,1,0,0,1
5208626,5208690,64,1,0,0,2
5208689,5208856,167,0,0,1,1
5208691,5208856,165,0,0,1,2
5208857,5208916,59,1,0,0,1
5208857,5208916,59,1,0,0,2
5208917,5209138,221,0,0,1,1
5208917,5209138,221,0,0,1,2
5209139,5209207,68,1,0,0,2
5209139,5209208,69,1,0,0,1
5209208,5209418,210,0,0,1,2
5209209,5209418,209,0,0,1,1
5209419,5209486,67,1,0,0,2
5209419,5209502,83,1,0,0,1
5209487,5209613,126,0,0,1,2
5209503,5209612,109,0,0,1,1
5209613,5209647,34,1,0,0,1
5209614,5209647,33,1,0,0,2
5209648,5210084,436,0,0,1,1
5209648,5210091,443,0,0,1,2
5210085,5210116,31,1,0,0,1
5210092,5210103,11,1,0,0,2
5210104,5210490,386,0,0,1,2
5210117,5211017,900,0,0,1,1
5210491,5210500,9,1,0,0,2
5210501,5212231,1730,0,0,1,2
5211018,5211033,15,1,0,0,1
5211034,5212231,1197,0,0,1,1
5212232,5212297,65,1,0,0,2
5212232,5212298,66,1,0,0,1
5212298,5214600,2302,0,0,1,2
5212299,5214600,2301,0,0,1,1
5214601,5214625,24,1,0,0,1
5214601,5214635,34,1,0,0,2
5214626,5214908,282,0,0,1,1
5214636,5214907,271,0,0,1,2
5214908,5214926,18,1,0,0,2
5214909,5214931,22,1,0,0,1
5214927,5215897,970,0,0,1,2
5214932,5215897,965,0,0,1,1
5215898,5215992,94,1,0,0,2
5215898,5215996,98,1,0,0,1
5215993,5216165,172,0,0,1,2
5215997,5216164,167,0,0,1,1
5216165,5216250,85,1,0,0,1
5216166,5216245,79,1,0,0,2
5216246,5216379,133,0,0,1,2
5216251,5216380,129,0,0,1,1
5216380,5216452,72,1,0,0,2
5216381,5216450,69,1,0,0,1
5216451,5216608,157,0,0,1,1
5216453,5216604,151,0,0,1,2
5216605,5216633,28,1,0,0,2
5216609,5216622,13,1,0,0,1
5216623,5217914,1291,0,0,1,1
5216634,5217915,1281,0,0,1,2
5217915,5217972,57,1,0,0,1
5217916,5217972,56,1,0,0,2
5217973,5220066,2093,0,0,1,1
5217973,5220067,2094,0,0,1,2
5220067,5220281,214,1,0,0,1
5220068,5220262,194,1,0,0,2
5220107,5220250,143,0,1,0,1
5220108,5220215,107,0,1,0,2
5220263,5221462,1199,0,0,1,2
5220282,5221463,1181,0,0,1,1
5221463,5221535,72,1,0,0,2
5221464,5221536,72,1,0,0,1
5221536,5221629,93,0,0,1,2
5221537,5221631,94,0,0,1,1
5221630,5221665,35,1,0,0,2
5221632,5221667,35,1,0,0,1
5221666,5221747,81,0,0,1,2
5221668,5221748,80,0,0,1,1
5221748,5221784,36,1,0,0,2
5221749,5221786,37,1,0,0,1
5221785,5221920,135,0,0,1,2
5221787,5221917,130,0,0,1,1
5221918,5221940,22,1,0,0,1
5221921,5221935,14,1,0,0,2
5221936,5222730,794,0,0,1,2
5221941,5222730,789,0,0,1,1
5222731,5222801,70,1,0,0,2
5222731,5222806,75,1,0,0,1
5222802,5223964,1162,0,0,1,2
5222807,5224772,1965,0,0,1,1
5223965,5223981,16,1,0,0,2
5223982,5224785,803,0,0,1,2
5224773,5224991,218,1,0,0,1
5224786,5224986,200,1,0,0,2
5224810,5224953,143,0,1,0,1
5224816,5224923,107,0,1,0,2
5224987,5225260,273,0,0,1,2
5224992,5225261,269,0,0,1,1
5225261,5225320,59,1,0,0,2
5225262,5225317,55,1,0,0,1
5225318,5225976,658,0,0,1,1
5225321,5225977,656,0,0,1,2
5225977,5226042,65,1,0,0,1
5225978,5226038,60,1,0,0,2
5226039,5226191,152,0,0,1,2
5226043,5226192,149,0,0,1,1
5226192,5226211,19,1,0,0,2
5226193,5226223,30,1,0,0,1
5226212,5227731,1519,0,0,1,2
5226224,5227732,1508,0,0,1,1
5227732,5227792,60,1,0,0,2
5227733,5227800,67,1,0,0,1
5227793,5227914,121,0,0,1,2
5227801,5227915,114,0,0,1,1
5227915,5227950,35,1,0,0,2
5227916,5227958,42,1,0,0,1
5227951,5229877,1926,0,0,1,2
5227959,5229890,1931,0,0,1,1
5229878,5230107,229,1,0,0,2
5229891,5230092,201,1,0,0,1
5229928,5230047,119,0,1,0,1
5229937,5230015,78,0,1,0,2
5230093,5230120,27,0,0,1,1
5230108,5230330,222,0,0,1,2
5230121,5230138,17,1,0,0,1
5230139,5230333,194,0,0,1,1
5230331,5230472,141,1,0,0,2
5230334,5230472,138,1,0,0,1
5230354,5230445,91,0,1,0,1
5230362,5230417,55,0,1,0,2
5230473,5230940,467,0,0,1,1
5230473,5230941,468,0,0,1,2
5230941,5231015,74,1,0,0,1
5230942,5231013,71,1,0,0,2
5231014,5231260,246,0,0,1,2
5231016,5231262,246,0,0,1,1
5231261,5231338,77,1,0,0,2
5231263,5231339,76,1,0,0,1
5231339,5231571,232,0,0,1,2
5231340,5231572,232,0,0,1,1
5231572,5231643,71,1,0,0,2
5231573,5231641,68,1,0,0,1
5231642,5231724,82,0,0,1,1
5231644,5231723,79,0,0,1,2
5231724,5231801,77,1,0,0,2
5231725,5231789,64,1,0,0,1
5231790,5231905,115,0,0,1,1
5231802,5231906,104,0,0,1,2
5231906,5231950,44,1,0,0,1
5231907,5231940,33,1,0,0,2
5231941,5233603,1662,0,0,1,2
5231951,5232169,218,0,0,1,1
5232170,5232187,17,1,0,0,1
5232188,5233603,1415,0,0,1,1
5233604,5233672,68,1,0,0,1
5233604,5233675,71,1,0,0,2
5233673,5233779,106,0,0,1,1
5233676,5233779,103,0,0,1,2
5233780,5233818,38,1,0,0,1
5233780,5233827,47,1,0,0,2
5233819,5235665,1846,0,0,1,1
5233828,5235672,1844,0,0,1,2
5235666,5235915,249,1,0,0,1
5235673,5235869,196,1,0,0,2
5235715,5235828,113,0,1,0,2
5235715,5235843,128,0,1,0,1
5235870,5235891,21,0,0,1,2
5235892,5235897,5,1,0,0,2
5235898,5236051,153,0,0,1,2
5235916,5236050,134,0,0,1,1
5236051,5236138,87,1,0,0,1
5236052,5236136,84,1,0,0,2
5236137,5237654,1517,0,0,1,2
5236139,5237656,1517,0,0,1,1
5237655,5237723,68,1,0,0,2
5237657,5237733,76,1,0,0,1
5237724,5237840,116,0,0,1,2
5237734,5237842,108,0,0,1,1
5237841,5237887,46,1,0,0,2
5237843,5237888,45,1,0,0,1
5237888,5238267,379,0,0,1,2
5237889,5238268,379,0,0,1,1
5238268,5238299,31,1,0,0,2
5238269,5238300,31,1,0,0,1
5238300,5238929,629,0,0,1,2
5238301,5238930,629,0,0,1,1
5238930,5238983,53,1,0,0,2
5238931,5238994,63,1,0,0,1
5238984,5241051,2067,0,0,1,2
5238995,5241052,2057,0,0,1,1
5241052,5241276,224,1,0,0,2
5241053,5241305,252,1,0,0,1
5241097,5241251,154,0,1,0,1
5241099,5241237,138,0,1,0,2
5241277,5241304,27,0,0,1,2
5241305,5241314,9,1,0,0,2
5241306,5241755,449,0,0,1,1
5241315,5241756,441,0,0,1,2
5241756,5241816,60,1,0,0,1
5241757,5241815,58,1,0,0,2
5241816,5242219,403,0,0,1,2
5241817,5242220,403,0,0,1,1
5242220,5242297,77,1,0,0,2
5242221,5242294,73,1,0,0,1
5242295,5242428,133,0,0,1,1
5242298,5242426,128,0,0,1,2
5242427,5242468,41,1,0,0,2
5242429,5242464,35,1,0,0,1
5242465,5243384,919,0,0,1,1
5242469,5243384,915,0,0,1,2
5243385,5243429,44,1,0,0,1
5243385,5243441,56,1,0,0,2
5243430,5243566,136,0,0,1,1
5243442,5243565,123,0,0,1,2
5243566,5243596,30,1,0,0,2
5243567,5243597,30,1,0,0,1
5243597,5245574,1977,0,0,1,2
5243598,5245576,1978,0,0,1,1
5245575,5245734,159,1,0,0,2
5245577,5245741,164,1,0,0,1
5245601,5245706,105,0,1,0,2
5245604,5245712,108,0,1,0,1
5245735,5246700,965,0,0,1,2
5245742,5246701,959,0,0,1,1
5246701,5246765,64,1,0,0,2
5246702,5246768,66,1,0,0,1
5246766,5246879,113,0,0,1,2
5246769,5246878,109,0,0,1,1
5246879,5246914,35,1,0,0,1
5246880,5246915,35,1,0,0,2
5246915,5248183,1268,0,0,1,1
5246916,5248183,1267,0,0,1,2
5248184,5248245,61,1,0,0,2
5248184,5248252,68,1,0,0,1
5248246,5250323,2077,0,0,1,2
5248253,5250330,2077,0,0,1,1
5250324,5250530,206,1,0,0,2
5250331,5250557,226,1,0,0,1
5250351,5250492,141,0,1,0,1
5250357,5250472,115,0,1,0,2
5250531,5250976,445,0,0,1,2
5250558,5250975,417,0,0,1,1
5250976,5251037,61,1,0,0,1
5250977,5251037,60,1,0,0,2
5251038,5251365,327,0,0,1,1
5251038,5251365,327,0,0,1,2
5251366,5251425,59,1,0,0,1
5251366,5251426,60,1,0,0,2
5251426,5251722,296,0,0,1,1
5251427,5251723,296,0,0,1,2
5251723,5251812,89,1,0,0,1
5251724,5251788,64,1,0,0,2
5251789,5251892,103,0,0,1,2
5251813,5251892,79,0,0,1,1
5251893,5251940,47,1,0,0,2
5251893,5251956,63,1,0,0,1
5251941,5253336,1395,0,0,1,2
5251957,5253335,1378,0,0,1,1
5253336,5253382,46,1,0,0,1
5253337,5253388,51,1,0,0,2
5253383,5255891,2508,0,0,1,1
5253389,5255894,2505,0,0,1,2
5255892,5255960,68,1,0,0,1
5255895,5255957,62,1,0,0,2
5255958,5257164,1206,0,0,1,2
5255961,5257161,1200,0,0,1,1
5257162,5257226,64,1,0,0,1
5257165,5257221,56,1,0,0,2
5257222,5257367,145,0,0,1,2
5257227,5257361,134,0,0,1,1
5257362,5257404,42,1,0,0,1
5257368,5257396,28,1,0,0,2
5257397,5257624,227,0,0,1,2
5257405,5257633,228,0,0,1,1
5257625,5257635,10,1,0,0,2
5257634,5257638,4,1,0,0,1
5257636,5260211,2575,0,0,1,2
5257639,5260211,2572,0,0,1,1
5260212,5260260,48,1,0,0,2
5260212,5260264,52,1,0,0,1
5260261,5262596,2335,0,0,1,2
5260265,5262591,2326,0,0,1,1
5262592,5262718,126,1,0,0,1
5262597,5262726,129,1,0,0,2
5262636,5262671,35,0,1,0,1
5262638,5262654,16,0,1,0,2
5262719,5264277,1558,0,0,1,1
5262727,5264277,1550,0,0,1,2
5264278,5264363,85,1,0,0,1
5264278,5264364,86,1,0,0,2
5264364,5264560,196,0,0,1,1
5264365,5264559,194,0,0,1,2
5264560,5264599,39,1,0,0,2
5264561,5264599,38,1,0,0,1
5264600,5266645,2045,0,0,1,1
5264600,5266645,2045,0,0,1,2
5266646,5266692,46,1,0,0,1
5266646,5266693,47,1,0,0,2
5266693,5268656,1963,0,0,1,1
5266694,5268658,1964,0,0,1,2
5268657,5268858,201,1,0,0,1
5268659,5268836,177,1,0,0,2
5268681,5268787,106,0,1,0,1
5268683,5268775,92,0,1,0,2
5268837,5269539,702,0,0,1,2
5268859,5269538,679,0,0,1,1
5269539,5269654,115,1,0,0,1
5269540,5269635,95,1,0,0,2
5269636,5270478,842,0,0,1,2
5269655,5270478,823,0,0,1,1
5270479,5270539,60,1,0,0,2
5270479,5270548,69,1,0,0,1
5270540,5270651,111,0,0,1,2
5270549,5270649,100,0,0,1,1
5270650,5270683,33,1,0,0,1
5270652,5270685,33,1,0,0,2
5270684,5273040,2356,0,0,1,1
5270686,5273040,2354,0,0,1,2
5273041,5273090,49,1,0,0,2
5273041,5273115,74,1,0,0,1
5273091,5275129,2038,0,0,1,2
5273116,5275120,2004,0,0,1,1
5275121,5275342,221,1,0,0,1
5275130,5275351,221,1,0,0,2
5275155,5275268,113,0,1,0,1
5275157,5275253,96,0,1,0,2
5275343,5275363,20,0,0,1,1
5275352,5275433,81,0,0,1,2
5275364,5275368,4,1,0,0,1
5275369,5275429,60,0,0,1,1
5275430,5275472,42,1,0,0,1
5275434,5275469,35,1,0,0,2
5275470,5275825,355,0,0,1,2
5275473,5275826,353,0,0,1,1
5275826,5275877,51,1,0,0,2
5275827,5275877,50,1,0,0,1
5275878,5276770,892,0,0,1,1
5275878,5276771,893,0,0,1,2
5276771,5276883,112,1,0,0,1
5276772,5276838,66,1,0,0,2
5276839,5276960,121,0,0,1,2
5276884,5276960,76,0,0,1,1
5276961,5276992,31,1,0,0,2
5276961,5277014,53,1,0,0,1
5276993,5277139,146,0,0,1,2
5277015,5277143,128,0,0,1,1
5277140,5277158,18,1,0,0,2
5277144,5277185,41,1,0,0,1
5277159,5278433,1274,0,0,1,2
5277186,5277636,450,0,0,1,1
5277637,5277660,23,1,0,0,1
5277661,5278432,771,0,0,1,1
5278433,5278507,74,1,0,0,1
5278434,5278508,74,1,0,0,2
5278508,5278753,245,0,0,1,1
5278509,5278754,245,0,0,1,2
5278754,5278786,32,1,0,0,1
5278755,5278785,30,1,0,0,2
5278786,5279118,332,0,0,1,2
5278787,5279119,332,0,0,1,1
5279119,5279132,13,1,0,0,2
5279120,5279132,12,1,0,0,1
5279133,5280557,1424,0,0,1,1
5279133,5280557,1424,0,0,1,2
5280558,5280772,214,1,0,0,2
5280558,5280774,216,1,0,0,1
5280602,5280717,115,0,1,0,2
5280604,5280725,121,0,1,0,1
5280773,5281408,635,0,0,1,2
5280775,5281408,633,0,0,1,1
5281409,5281460,51,1,0,0,1
5281409,5281464,55,1,0,0,2
5281461,5281753,292,0,0,1,1
5281465,5281753,288,0,0,1,2
5281754,5281811,57,1,0,0,1
5281754,5281814,60,1,0,0,2
5281812,5282248,436,0,0,1,1
5281815,5282248,433,0,0,1,2
5282249,5282289,40,1,0,0,1
5282249,5282290,41,1,0,0,2
5282290,5282492,202,0,0,1,1
5282291,5282487,196,0,0,1,2
5282488,5282504,16,1,0,0,2
5282493,5282505,12,1,0,0,1
5282505,5284069,1564,0,0,1,2
5282506,5284069,1563,0,0,1,1
5284070,5284138,68,1,0,0,1
5284070,5284138,68,1,0,0,2
5284139,5284387,248,0,0,1,1
5284139,5284388,249,0,0,1,2
5284388,5284407,19,1,0,0,1
5284389,5284407,18,1,0,0,2
5284408,5286280,1872,0,0,1,1
5284408,5286281,1873,0,0,1,2
5286281,5286563,282,1,0,0,1
5286282,5286539,257,1,0,0,2
5286326,5286516,190,0,1,0,1
5286328,5286499,171,0,1,0,2
5286540,5286891,351,0,0,1,2
5286564,5286892,328,0,0,1,1
5286892,5286960,68,1,0,0,2
5286893,5286962,69,1,0,0,1
5286961,5287395,434,0,0,1,2
5286963,5287395,432,0,0,1,1
5287396,5287416,20,1,0,0,1
5287396,5287416,20,1,0,0,2
5287417,5288133,716,0,0,1,1
5287417,5288135,718,0,0,1,2
5288134,5288173,39,1,0,0,1
5288136,5288175,39,1,0,0,2
5288174,5289406,1232,0,0,1,1
5288176,5289407,1231,0,0,1,2
5289407,5289473,66,1,0,0,1
5289408,5289482,74,1,0,0,2
5289474,5289858,384,0,0,1,1
5289483,5289859,376,0,0,1,2
5289859,5289878,19,1,0,0,1
5289860,5289880,20,1,0,0,2
5289879,5291691,1812,0,0,1,1
5289881,5291689,1808,0,0,1,2
5291690,5291849,159,1,0,0,2
5291692,5291866,174,1,0,0,1
5291718,5291805,87,0,1,0,2
5291719,5291823,104,0,1,0,1
5291850,5292816,966,0,0,1,2
5291867,5292816,949,0,0,1,1
5292817,5292864,47,1,0,0,1
5292817,5292877,60,1,0,0,2
5292865,5294402,1537,0,0,1,1
5292878,5293032,154,0,0,1,2
5293033,5293051,18,1,0,0,2
5293052,5294401,1349,0,0,1,2
5294402,5294446,44,1,0,0,2
5294403,5294450,47,1,0,0,1
5294447,5296571,2124,0,0,1,2
5294451,5296582,2131,0,0,1,1
5296572,5296755,183,1,0,0,2
5296583,5296763,180,1,0,0,1
5296598,5296731,133,0,1,0,1
5296599,5296729,130,0,1,0,2
5296756,5297964,1208,0,0,1,2
5296764,5297964,1200,0,0,1,1
5297965,5298017,52,1,0,0,2
5297965,5298020,55,1,0,0,1
5298018,5298200,182,0,0,1,2
5298021,5298203,182,0,0,1,1
5298201,5298220,19,1,0,0,2
5298204,5298214,10,1,0,0,1
5298215,5298500,285,0,0,1,1
5298221,5298508,287,0,0,1,2
5298501,5298512,11,1,0,0,1
5298509,5298513,4,1,0,0,2
5298513,5300070,1557,0,0,1,1
5298514,5300069,1555,0,0,1,2
5300070,5300127,57,1,0,0,2
5300071,5300119,48,1,0,0,1
5300120,5300410,290,0,0,1,1
5300128,5300408,280,0,0,1,2
5300409,5300432,23,1,0,0,2
5300411,5300427,16,1,0,0,1
5300428,5302272,1844,0,0,1,1
5300433,5300771,338,0,0,1,2
5300772,5300784,12,1,0,0,2
5300785,5302272,1487,0,0,1,2
5302273,5302428,155,1,0,0,2
5302273,5302440,167,1,0,0,1
5302295,5302395,100,0,1,0,1
5302296,5302385,89,0,1,0,2
5302429,5302831,402,0,0,1,2
5302441,5302831,390,0,0,1,1
5302832,5302874,42,1,0,0,2
5302832,5302884,52,1,0,0,1
5302875,5304026,1151,0,0,1,2
5302885,5304026,1141,0,0,1,1
5304027,5304105,78,1,0,0,2
5304027,5304119,92,1,0,0,1
5304106,5304254,148,0,0,1,2
5304120,5304257,137,0,0,1,1
5304255,5304284,29,1,0,0,2
5304258,5304312,54,1,0,0,1
5304285,5304505,220,0,0,1,2
5304313,5304509,196,0,0,1,1
5304506,5304517,11,1,0,0,2
5304510,5304531,21,1,0,0,1
5304518,5305873,1355,0,0,1,2
5304532,5305273,741,0,0,1,1
5305274,5305286,12,1,0,0,1
5305287,5305873,586,0,0,1,1
5305874,5305938,64,1,0,0,2
5305874,5305945,71,1,0,0,1
5305939,5306101,162,0,0,1,2
5305946,5306101,155,0,0,1,1
5306102,5306135,33,1,0,0,1
5306102,5306136,34,1,0,0,2
5306136,5308068,1932,0,0,1,1
5306137,5308069,1932,0,0,1,2
5308069,5308361,292,1,0,0,1
5308070,5308329,259,1,0,0,2
5308116,5308293,177,0,1,0,2
5308116,5308307,191,0,1,0,1
5308330,5308765,435,0,0,1,2
5308362,5308765,403,0,0,1,1
5308766,5308821,55,1,0,0,2
5308766,5308822,56,1,0,0,1
5308822,5309691,869,0,0,1,2
5308823,5309692,869,0,0,1,1
5309692,5309771,79,1,0,0,2
5309693,5309771,78,1,0,0,1
5309772,5309874,102,0,0,1,2
5309772,5309875,103,0,0,1,1
5309875,5309910,35,1,0,0,2
5309876,5309911,35,1,0,0,1
5309911,5310121,210,0,0,1,2
5309912,5311325,1413,0,0,1,1
5310122,5310131,9,1,0,0,2
5310132,5311325,1193,0,0,1,2
5311326,5311377,51,1,0,0,2
5311326,5311380,54,1,0,0,1
5311378,5311553,175,0,0,1,2
5311381,5311555,174,0,0,1,1
5311554,5311584,30,1,0,0,2
5311556,5311585,29,1,0,0,1
5311585,5313564,1979,0,0,1,2
5311586,5313563,1977,0,0,1,1
5313564,5313753,189,1,0,0,1
5313565,5313738,173,1,0,0,2
5313609,5313690,81,0,1,0,2
5313609,5313705,96,0,1,0,1
5313739,5314230,491,0,0,1,2
5313754,5314232,478,0,0,1,1
5314231,5314322,91,1,0,0,2
5314233,5314320,87,1,0,0,1
5314321,5314589,268,0,0,1,1
5314323,5314589,266,0,0,1,2
5314590,5314652,62,1,0,0,1
5314590,5314654,64,1,0,0,2
5314653,5314878,225,0,0,1,1
5314655,5314879,224,0,0,1,2
5314879,5314943,64,1,0,0,1
5314880,5314951,71,1,0,0,2
5314944,5315077,133,0,0,1,1
5314952,5315076,124,0,0,1,2
5315077,5315149,72,1,0,0,2
5315078,5315151,73,1,0,0,1
5315150,5315319,169,0,0,1,2
5315152,5315319,167,0,0,1,1
5315320,5315347,27,1,0,0,2
5315320,5315350,30,1,0,0,1
5315348,5316458,1110,0,0,1,2
5315351,5316458,1107,0,0,1,1
5316459,5316517,58,1,0,0,2
5316459,5316519,60,1,0,0,1
5316518,5316724,206,0,0,1,2
5316520,5316723,203,0,0,1,1
5316724,5316753,29,1,0,0,1
5316725,5316757,32,1,0,0,2
5316754,5317192,438,0,0,1,1
5316758,5317189,431,0,0,1,2
5317190,5317204,14,1,0,0,2
5317193,5317199,6,1,0,0,1
5317200,5318703,1503,0,0,1,1
5317205,5318702,1497,0,0,1,2
5318703,5318797,94,1,0,0,2
5318704,5318806,102,1,0,0,1
5318798,5319082,284,0,0,1,2
5318807,5319088,281,0,0,1,1
5319083,5319260,177,1,0,0,2
5319089,5319247,158,1,0,0,1
5319114,5319218,104,0,1,0,2
5319116,5319198,82,0,1,0,1
5319248,5319897,649,0,0,1,1
5319261,5319896,635,0,0,1,2
5319897,5319956,59,1,0,0,2
5319898,5319959,61,1,0,0,1
5319957,5320264,307,0,0,1,2
5319960,5320264,304,0,0,1,1
5320265,5320304,39,1,0,0,1
5320265,5320307,42,1,0,0,2
5320305,5320551,246,0,0,1,1
5320308,5320553,245,0,0,1,2
5320552,5320744,192,1,0,0,1
5320554,5320740,186,1,0,0,2
5320575,5320714,139,0,1,0,1
5320579,5320708,129,0,1,0,2
5320741,5321185,444,0,0,1,2
5320745,5321186,441,0,0,1,1
5321186,5321236,50,1,0,0,2
5321187,5321237,50,1,0,0,1
5321237,5321437,200,0,0,1,2
5321238,5321437,199,0,0,1,1
5321438,5321475,37,1,0,0,1
5321438,5321487,49,1,0,0,2
5321476,5321742,266,0,0,1,1
5321488,5321743,255,0,0,1,2
5321743,5321799,56,1,0,0,1
5321744,5321785,41,1,0,0,2
5321786,5322031,245,0,0,1,2
5321800,5322031,231,0,0,1,1
5322032,5322057,25,1,0,0,2
5322032,5322080,48,1,0,0,1
5322058,5322358,300,0,0,1,2
5322081,5322396,315,0,0,1,1
5322359,5322370,11,1,0,0,2
5322371,5322412,41,0,0,1,2
5322407,5325878,3471,0,1,0,1
5322413,5325878,3465,1,0,0,2
5322490,5325878,3388,0,1,0,2
5325877,5325878,1,1,0,0,1
5391001,5391238,237,0,0,1,2
5391001,5391239,238,0,0,1,1
5391239,5391321,82,1,0,0,2
5391240,5391307,67,1,0,0,1
5391308,5391404,96,0,0,1,1
5391322,5391403,81,0,0,1,2
5391404,5391448,44,1,0,0,2
5391405,5391435,30,1,0,0,1
5391436,5393069,1633,0,0,1,1
5391449,5391628,179,0,0,1,2
5391629,5391641,12,1,0,0,2
5391642,5393067,1425,0,0,1,2
5393068,5393136,68,1,0,0,2
5393070,5393129,59,1,0,0,1
5393130,5393266,136,0,0,1,1
5393137,5393265,128,0,0,1,2
5393266,5393296,30,1,0,0,2
5393267,5393296,29,1,0,0,1
5393297,5394694,1397,0,0,1,2
5393297,5394695,1398,0,0,1,1
5394695,5394789,94,1,0,0,2
5394696,5394789,93,1,0,0,1
5394790,5394852,62,0,0,1,1
5394790,5394853,63,0,0,1,2
5394853,5394891,38,1,0,0,1
5394854,5394891,37,1,0,0,2
5394892,5394962,70,0,0,1,1
5394892,5394963,71,0,0,1,2
5394963,5395001,38,1,0,0,1
5394964,5395012,48,1,0,0,2
5395002,5396308,1306,0,0,1,1
5395013,5396308,1295,0,0,1,2
5396309,5396386,77,1,0,0,2
5396309,5396389,80,1,0,0,1
5396387,5396521,134,0,0,1,2
5396390,5396521,131,0,0,1,1
5396522,5396561,39,1,0,0,2
5396522,5396575,53,1,0,0,1
5396562,5397883,1321,0,0,1,2
5396576,5397884,1308,0,0,1,1
5397884,5397993,109,1,0,0,2
5397885,5397984,99,1,0,0,1
5397985,5398135,150,0,0,1,1
5397994,5398135,141,0,0,1,2
5398136,5398167,31,1,0,0,1
5398136,5398167,31,1,0,0,2
5398168,5399462,1294,0,0,1,1
5398168,5399463,1295,0,0,1,2
5399463,5399522,59,1,0,0,1
5399464,5399521,57,1,0,0,2
5399522,5401045,1523,0,0,1,2
5399523,5401047,1524,0,0,1,1
5401046,5401114,68,1,0,0,2
5401048,5401112,64,1,0,0,1
5401113,5401198,85,0,0,1,1
5401115,5401196,81,0,0,1,2
5401197,5401242,45,1,0,0,2
5401199,5401244,45,1,0,0,1
5401243,5401314,71,0,0,1,2
5401245,5401314,69,0,0,1,1
5401315,5401353,38,1,0,0,1
5401315,5401362,47,1,0,0,2
5401354,5401552,198,0,0,1,1
5401363,5401551,188,0,0,1,2
5401552,5401585,33,1,0,0,2
5401553,5401587,34,1,0,0,1
5401586,5402629,1043,0,0,1,2
5401588,5402630,1042,0,0,1,1
5402630,5402733,103,1,0,0,2
5402631,5402745,114,1,0,0,1
5402734,5402817,83,0,0,1,2
5402746,5402818,72,0,0,1,1
5402818,5402854,36,1,0,0,2
5402819,5402856,37,1,0,0,1
5402855,5403182,327,0,0,1,2
5402857,5403178,321,0,0,1,1
5403179,5403199,20,1,0,0,1
5403183,5403196,13,1,0,0,2
5403197,5404291,1094,0,0,1,2
5403200,5404292,1092,0,0,1,1
5404292,5404368,76,1,0,0,2
5404293,5404393,100,1,0,0,1
5404369,5404443,74,0,0,1,2
5404394,5404444,50,0,0,1,1
5404444,5404487,43,1,0,0,2
5404445,5404481,36,1,0,0,1
5404482,5405979,1497,0,0,1,1
5404488,5405980,1492,0,0,1,2
5405980,5406055,75,1,0,0,1
5405981,5406062,81,1,0,0,2
5406056,5406209,153,0,0,1,1
5406063,5406205,142,0,0,1,2
5406206,5406247,41,1,0,0,2
5406210,5406234,24,1,0,0,1
5406235,5407584,1349,0,0,1,1
5406248,5407582,1334,0,0,1,2
5407583,5407703,120,1,0,0,2
5407585,5407710,125,1,0,0,1
5407704,5407794,90,0,0,1,2
5407711,5407794,83,0,0,1,1
5407795,5407831,36,1,0,0,2
5407795,5407835,40,1,0,0,1
5407832,5409104,1272,0,0,1,2
5407836,5408350,514,0,0,1,1
5408351,5408369,18,1,0,0,1
5408370,5409102,732,0,0,1,1
5409103,5409175,72,1,0,0,1
5409105,5409171,66,1,0,0,2
5409172,5409265,93,0,0,1,2
5409176,5409264,88,0,0,1,1
5409265,5409309,44,1,0,0,1
5409266,5409298,32,1,0,0,2
5409299,5409477,178,0,0,1,2
5409310,5409476,166,0,0,1,1
5409477,5409514,37,1,0,0,1
5409478,5409508,30,1,0,0,2
5409509,5410775,1266,0,0,1,2
5409515,5410774,1259,0,0,1,1
5410775,5410862,87,1,0,0,1
5410776,5410864,88,1,0,0,2
5410863,5410951,88,0,0,1,1
5410865,5410951,86,0,0,1,2
5410952,5410988,36,1,0,0,1
5410952,5410990,38,1,0,0,2
5410989,5412399,1410,0,0,1,1
5410991,5412398,1407,0,0,1,2
5412399,5412463,64,1,0,0,2
5412400,5412465,65,1,0,0,1
5412464,5412718,254,0,0,1,2
5412466,5412721,255,0,0,1,1
5412719,5412733,14,1,0,0,2
5412722,5412732,10,1,0,0,1
5412733,5414014,1281,0,0,1,1
5412734,5414014,1280,0,0,1,2
5414015,5414112,97,1,0,0,1
5414015,5414112,97,1,0,0,2
5414113,5414215,102,0,0,1,1
5414113,5414215,102,0,0,1,2
5414216,5414252,36,1,0,0,1
5414216,5414253,37,1,0,0,2
5414253,5414436,183,0,0,1,1
5414254,5414436,182,0,0,1,2
5414437,5414450,13,1,0,0,1
5414437,5414451,14,1,0,0,2
5414451,5415631,1180,0,0,1,1
5414452,5415631,1179,0,0,1,2
5415632,5415721,89,1,0,0,2
5415632,5415725,93,1,0,0,1
5415722,5415850,128,0,0,1,2
5415726,5415850,124,0,0,1,1
5415851,5415885,34,1,0,0,1
5415851,5415889,38,1,0,0,2
5415886,5417228,1342,0,0,1,1
5415890,5417227,1337,0,0,1,2
5417228,5417307,79,1,0,0,2
5417229,5417306,77,1,0,0,1
5417307,5417394,87,0,0,1,1
5417308,5417397,89,0,0,1,2
5417395,5417430,35,1,0,0,1
5417398,5417425,27,1,0,0,2
5417426,5417634,208,0,0,1,2
5417431,5417629,198,0,0,1,1
5417630,5417648,18,1,0,0,1
5417635,5417646,11,1,0,0,2
5417647,5418762,1115,0,0,1,2
5417649,5418763,1114,0,0,1,1
5418763,5418865,102,1,0,0,2
5418764,5418854,90,1,0,0,1
5418855,5420414,1559,0,0,1,1
5418866,5419012,146,0,0,1,2
5419013,5419046,33,1,0,0,2
5419047,5420413,1366,0,0,1,2
5420414,5420474,60,1,0,0,2
5420415,5420504,89,1,0,0,1
5420475,5420573,98,0,0,1,2
5420505,5420570,65,0,0,1,1
5420571,5420605,34,1,0,0,1
5420574,5420606,32,1,0,0,2
5420606,5420754,148,0,0,1,1
5420607,5420755,148,0,0,1,2
5420755,5420777,22,1,0,0,1
5420756,5420775,19,1,0,0,2
5420776,5421944,1168,0,0,1,2
5420778,5421943,1165,0,0,1,1
5421944,5422031,87,1,0,0,1
5421945,5422032,87,1,0,0,2
5422032,5422121,89,0,0,1,1
5422033,5422121,88,0,0,1,2
5422122,5422160,38,1,0,0,2
5422122,5422165,43,1,0,0,1
5422161,5423601,1440,0,0,1,2
5422166,5423601,1435,0,0,1,1
5423602,5423671,69,1,0,0,1
5423602,5423687,85,1,0,0,2
5423672,5423836,164,0,0,1,1
5423688,5423830,142,0,0,1,2
5423831,5423858,27,1,0,0,2
5423837,5423851,14,1,0,0,1
5423852,5425163,1311,0,0,1,1
5423859,5425163,1304,0,0,1,2
5425164,5425213,49,1,0,0,2
5425164,5425216,52,1,0,0,1
5425214,5426741,1527,0,0,1,2
5425217,5426743,1526,0,0,1,1
5426742,5426843,101,1,0,0,2
5426744,5426854,110,1,0,0,1
5426844,5426897,53,0,0,1,2
5426855,5426897,42,0,0,1,1
5426898,5426938,40,1,0,0,1
5426898,5426947,49,1,0,0,2
5426939,5427086,147,0,0,1,1
5426948,5427084,136,0,0,1,2
5427085,5427119,34,1,0,0,2
5427087,5427108,21,1,0,0,1
5427109,5428422,1313,0,0,1,1
5427120,5428422,1302,0,0,1,2
5428423,5428490,67,1,0,0,2
5428423,5428493,70,1,0,0,1
5428491,5428637,146,0,0,1,2
5428494,5428640,146,0,0,1,1
5428638,5428667,29,1,0,0,2
5428641,5428671,30,1,0,0,1
5428668,5429985,1317,0,0,1,2
5428672,5429986,1314,0,0,1,1
5429986,5430061,75,1,0,0,2
5429987,5430061,74,1,0,0,1
5430062,5430178,116,0,0,1,1
5430062,5430178,116,0,0,1,2
5430179,5430224,45,1,0,0,1
5430179,5430225,46,1,0,0,2
5430225,5431677,1452,0,0,1,1
5430226,5431679,1453,0,0,1,2
5431678,5431743,65,1,0,0,1
5431680,5431738,58,1,0,0,2
5431739,5431930,191,0,0,1,2
5431744,5431927,183,0,0,1,1
5431928,5431944,16,1,0,0,1
5431931,5431945,14,1,0,0,2
5431945,5433175,1230,0,0,1,1
5431946,5433176,1230,0,0,1,2
5433176,5433234,58,1,0,0,1
5433177,5433236,59,1,0,0,2
5433235,5433362,127,0,0,1,1
5433237,5433362,125,0,0,1,2
5433363,5433391,28,1,0,0,2
5433363,5433394,31,1,0,0,1
5433392,5434680,1288,0,0,1,2
5433395,5434681,1286,0,0,1,1
5434681,5434732,51,1,0,0,2
5434682,5434734,52,1,0,0,1
5434733,5436176,1443,0,0,1,2
5434735,5436177,1442,0,0,1,1
5436177,5436243,66,1,0,0,2
5436178,5436241,63,1,0,0,1
5436242,5436377,135,0,0,1,1
5436244,5436375,131,0,0,1,2
5436376,5436391,15,1,0,0,2
5436378,5436391,13,1,0,0,1
5436392,5436527,135,0,0,1,2
5436392,5436531,139,0,0,1,1
5436528,5436546,18,1,0,0,2
5436532,5436550,18,1,0,0,1
5436547,5436764,217,0,0,1,2
5436551,5437823,1272,0,0,1,1
5436765,5436780,15,1,0,0,2
5436781,5437822,1041,0,0,1,2
5437823,5437890,67,1,0,0,2
5437824,5437892,68,1,0,0,1
5437891,5437960,69,0,0,1,2
5437893,5437959,66,0,0,1,1
5437960,5437998,38,1,0,0,1
5437961,5437995,34,1,0,0,2
5437996,5438125,129,0,0,1,2
5437999,5438125,126,0,0,1,1
5438126,5438157,31,1,0,0,2
5438126,5438159,33,1,0,0,1
5438158,5438338,180,0,0,1,2
5438160,5438342,182,0,0,1,1
5438339,5438360,21,1,0,0,2
5438343,5438354,11,1,0,0,1
5438355,5439157,802,0,0,1,1
5438361,5439169,808,0,0,1,2
5439158,5439365,207,1,0,0,1
5439170,5439273,103,1,0,0,2
5439182,5439317,135,0,1,0,1
5439274,5439463,189,0,0,1,2
5439366,5439465,99,0,0,1,1
5439464,5439560,96,1,0,0,2
5439466,5439562,96,1,0,0,1
5439561,5439687,126,0,0,1,2
5439563,5439686,123,0,0,1,1
5439687,5439722,35,1,0,0,1
5439688,5439722,34,1,0,0,2
5439723,5441180,1457,0,0,1,1
5439723,5441181,1458,0,0,1,2
5441181,5441279,98,1,0,0,1
5441182,5441262,80,1,0,0,2
5441263,5441338,75,0,0,1,2
5441280,5441340,60,0,0,1,1
5441339,5441377,38,1,0,0,2
5441341,5441385,44,1,0,0,1
5441378,5442781,1403,0,0,1,2
5441386,5442783,1397,0,0,1,1
5442782,5442834,52,1,0,0,2
5442784,5442835,51,1,0,0,1
5442835,5444359,1524,0,0,1,2
5442836,5444359,1523,0,0,1,1
5444360,5444439,79,1,0,0,1
5444360,5444439,79,1,0,0,2
5444440,5444559,119,0,0,1,2
5444440,5444560,120,0,0,1,1
5444560,5444597,37,1,0,0,2
5444561,5444591,30,1,0,0,1
5444592,5446036,1444,0,0,1,1
5444598,5446036,1438,0,0,1,2
5446037,5446132,95,1,0,0,2
5446037,5446154,117,1,0,0,1
5446133,5446294,161,0,0,1,2
5446155,5446292,137,0,0,1,1
5446293,5446333,40,1,0,0,1
5446295,5446342,47,1,0,0,2
5446334,5446513,179,0,0,1,1
5446343,5446513,170,0,0,1,2
5446514,5446543,29,1,0,0,2
5446514,5446544,30,1,0,0,1
5446544,5447659,1115,0,0,1,2
5446545,5447659,1114,0,0,1,1
5447660,5447726,66,1,0,0,1
5447660,5447735,75,1,0,0,2
5447727,5447979,252,0,0,1,1
5447736,5447977,241,0,0,1,2
5447978,5448009,31,1,0,0,2
5447980,5448008,28,1,0,0,1
5448009,5449290,1281,0,0,1,1
5448010,5449289,1279,0,0,1,2
5449290,5449405,115,1,0,0,2
5449291,5449415,124,1,0,0,1
5449406,5449528,122,0,0,1,2
5449416,5449531,115,0,0,1,1
5449529,5449564,35,1,0,0,2
5449532,5449552,20,1,0,0,1
5449553,5450925,1372,0,0,1,1
5449565,5449724,159,0,0,1,2
5449725,5449757,32,1,0,0,2
5449758,5450920,1162,0,0,1,2
5450921,5450984,63,1,0,0,2
5450926,5450984,58,1,0,0,1
5450985,5451065,80,0,0,1,2
5450985,5451066,81,0,0,1,1
5451066,5451100,34,1,0,0,2
5451067,5451117,50,1,0,0,1
5451101,5451268,167,0,0,1,2
5451118,5452512,1394,0,0,1,1
5451269,5451293,24,1,0,0,2
5451294,5452512,1218,0,0,1,2
5452513,5452574,61,1,0,0,2
5452513,5452588,75,1,0,0,1
5452575,5452739,164,0,0,1,2
5452589,5452740,151,0,0,1,1
5452740,5452760,20,1,0,0,2
5452741,5452770,29,1,0,0,1
5452761,5454160,1399,0,0,1,2
5452771,5454162,1391,0,0,1,1
5454161,5454245,84,1,0,0,2
5454163,5454236,73,1,0,0,1
5454237,5454341,104,0,0,1,1
5454246,5454343,97,0,0,1,2
5454342,5454377,35,1,0,0,1
5454344,5454378,34,1,0,0,2
5454378,5455941,1563,0,0,1,1
5454379,5455942,1563,0,0,1,2
5455942,5456037,95,1,0,0,1
5455943,5456046,103,1,0,0,2
5456038,5456121,83,0,0,1,1
5456047,5456120,73,0,0,1,2
5456121,5456162,41,1,0,0,2
5456122,5456159,37,1,0,0,1
5456160,5457717,1557,0,0,1,1
5456163,5457717,1554,0,0,1,2
5457718,5457831,113,1,0,0,2
5457718,5457834,116,1,0,0,1
5457832,5457945,113,0,0,1,2
5457835,5457945,110,0,0,1,1
5457946,5457990,44,1,0,0,2
5457946,5458007,61,1,0,0,1
5457991,5459272,1281,0,0,1,2
5458008,5459273,1265,0,0,1,1
5459273,5459345,72,1,0,0,2
5459274,5459346,72,1,0,0,1
5459346,5459412,66,0,0,1,2
5459347,5459413,66,0,0,1,1
5459413,5459454,41,1,0,0,2
5459414,5459459,45,1,0,0,1
5459455,5460782,1327,0,0,1,2
5459460,5460640,1180,0,0,1,1
5460641,5460647,6,1,0,0,1
5460648,5460783,135,0,0,1,1
5460783,5460832,49,1,0,0,2
5460784,5460827,43,1,0,0,1
5460828,5460999,171,0,0,1,1
5460833,5461003,170,0,0,1,2
5461000,5461032,32,1,0,0,1
5461004,5461033,29,1,0,0,2
5461033,5462330,1297,0,0,1,1
5461034,5462330,1296,0,0,1,2
5462331,5462411,80,1,0,0,1
5462331,5462416,85,1,0,0,2
5462412,5462489,77,0,0,1,1
5462417,5462488,71,0,0,1,2
5462489,5462531,42,1,0,0,2
5462490,5462538,48,1,0,0,1
5462532,5462596,64,0,0,1,2
5462539,5462597,58,0,0,1,1
5462597,5462632,35,1,0,0,2
5462598,5462634,36,1,0,0,1
5462633,5462811,178,0,0,1,2
5462635,5462809,174,0,0,1,1
5462810,5462838,28,1,0,0,1
5462812,5462840,28,1,0,0,2
5462839,5463500,661,0,0,1,1
5462841,5464096,1255,0,0,1,2
5463501,5463524,23,1,0,0,1
5463525,5463899,374,0,0,1,1
5463900,5463914,14,1,0,0,1
5463915,5463939,24,0,0,1,1
5463940,5463996,56,1,0,0,1
5463997,5464092,95,0,0,1,1
5464093,5464201,108,1,0,0,1
5464097,5464178,81,1,0,0,2
5464179,5464266,87,0,0,1,2
5464202,5464267,65,0,0,1,1
5464267,5464307,40,1,0,0,2
5464268,5464311,43,1,0,0,1
5464308,5465707,1399,0,0,1,2
5464312,5464482,170,0,0,1,1
5464483,5464507,24,1,0,0,1
5464508,5465706,1198,0,0,1,1
5465707,5465771,64,1,0,0,1
5465708,5465768,60,1,0,0,2
5465769,5465925,156,0,0,1,2
5465772,5465926,154,0,0,1,1
5465926,5465957,31,1,0,0,2
5465927,5465957,30,1,0,0,1
5465958,5467306,1348,0,0,1,1
5465958,5467306,1348,0,0,1,2
5467307,5467375,68,1,0,0,2
5467307,5467386,79,1,0,0,1
5467376,5467482,106,0,0,1,2
5467387,5467482,95,0,0,1,1
5467483,5467503,20,1,0,0,2
5467483,5467514,31,1,0,0,1
5467504,5469142,1638,0,0,1,2
5467515,5469141,1626,0,0,1,1
5469142,5469221,79,1,0,0,1
5469143,5469229,86,1,0,0,2
5469222,5469369,147,0,0,1,1
5469230,5469366,136,0,0,1,2
5469367,5469402,35,1,0,0,2
5469370,5469395,25,1,0,0,1
5469396,5472600,3204,0,0,1,1
5469403,5472600,3197,0,0,1,2
5472601,5472659,58,1,0,0,2
5472601,5472660,59,1,0,0,1
5472660,5472757,97,0,0,1,2
5472661,5472754,93,0,0,1,1
5472755,5472798,43,1,0,0,1
5472758,5472789,31,1,0,0,2
5472790,5472942,152,0,0,1,2
5472799,5472939,140,0,0,1,1
5472940,5472969,29,1,0,0,1
5472943,5472959,16,1,0,0,2
5472960,5474713,1753,0,0,1,2
5472970,5475380,2410,0,0,1,1
5474714,5474719,5,1,0,0,2
5474720,5475379,659,0,0,1,2
5475380,5475435,55,1,0,0,2
5475381,5475438,57,1,0,0,1
5475436,5475716,280,0,0,1,2
5475439,5475717,278,0,0,1,1
5475717,5475779,62,1,0,0,2
5475718,5475781,63,1,0,0,1
5475780,5475912,132,0,0,1,2
5475782,5475905,123,0,0,1,1
5475906,5476067,161,1,0,0,1
5475913,5476031,118,1,0,0,2
5475924,5476037,113,0,1,0,1
5475945,5475977,32,0,1,0,2
5476032,5476380,348,0,0,1,2
5476068,5476381,313,0,0,1,1
5476381,5476445,64,1,0,0,2
5476382,5476445,63,1,0,0,1
5476446,5476607,161,0,0,1,1
5476446,5476607,161,0,0,1,2
5476608,5476684,76,1,0,0,1
5476608,5476692,84,1,0,0,2
5476685,5476800,115,0,0,1,1
5476693,5476798,105,0,0,1,2
5476799,5476834,35,1,0,0,2
5476801,5476823,22,1,0,0,1
5476824,5478366,1542,0,0,1,1
5476835,5478367,1532,0,0,1,2
5478367,5478427,60,1,0,0,1
5478368,5478427,59,1,0,0,2
5478428,5480544,2116,0,0,1,2
5478428,5480546,2118,0,0,1,1
5480545,5480727,182,1,0,0,2
5480547,5480746,199,1,0,0,1
5480574,5480719,145,0,1,0,1
5480580,5480680,100,0,1,0,2
5480728,5481290,562,0,0,1,2
5480747,5481290,543,0,0,1,1
5481291,5481345,54,1,0,0,1
5481291,5481345,54,1,0,0,2
5481346,5481946,600,0,0,1,2
5481346,5481947,601,0,0,1,1
5481947,5482010,63,1,0,0,2
5481948,5481999,51,1,0,0,1
5482000,5482211,211,0,0,1,1
5482011,5482213,202,0,0,1,2
5482212,5482402,190,1,0,0,1
5482214,5482351,137,1,0,0,2
5482230,5482368,138,0,1,0,1
5482249,5482281,32,0,1,0,2
5482352,5482486,134,0,0,1,2
5482403,5482486,83,0,0,1,1
5482487,5482522,35,1,0,0,1
5482487,5482523,36,1,0,0,2
5482523,5483950,1427,0,0,1,1
5482524,5483950,1426,0,0,1,2
5483951,5484000,49,1,0,0,1
5483951,5484005,54,1,0,0,2
5484001,5486088,2087,0,0,1,1
5484006,5486084,2078,0,0,1,2
5486085,5486286,201,1,0,0,2
5486089,5486302,213,1,0,0,1
5486111,5486275,164,0,1,0,1
5486112,5486244,132,0,1,0,2
5486287,5486679,392,0,0,1,2
5486303,5486678,375,0,0,1,1
5486679,5486747,68,1,0,0,1
5486680,5486746,66,1,0,0,2
5486747,5487584,837,0,0,1,2
5486748,5487585,837,0,0,1,1
5487585,5487664,79,1,0,0,2
5487586,5487667,81,1,0,0,1
5487665,5487793,128,0,0,1,2
5487668,5487794,126,0,0,1,1
5487794,5487825,31,1,0,0,2
5487795,5487827,32,1,0,0,1
5487826,5489313,1487,0,0,1,2
5487828,5489313,1485,0,0,1,1
5489314,5489381,67,1,0,0,1
5489314,5489387,73,1,0,0,2
5489382,5491493,2111,0,0,1,1
5489388,5491490,2102,0,0,1,2
5491491,5491669,178,1,0,0,2
5491494,5491683,189,1,0,0,1
5491526,5491617,91,0,1,0,2
5491529,5491641,112,0,1,0,1
5491670,5492409,739,0,0,1,2
5491684,5492409,725,0,0,1,1
5492410,5492431,21,1,0,0,2
5492410,5492444,34,1,0,0,1
5492432,5493121,689,0,0,1,2
5492445,5493123,678,0,0,1,1
5493122,5493194,72,1,0,0,2
5493124,5493187,63,1,0,0,1
5493188,5493309,121,0,0,1,1
5493195,5493308,113,0,0,1,2
5493309,5493341,32,1,0,0,2
5493310,5493341,31,1,0,0,1
5493342,5494810,1468,0,0,1,1
5493342,5494810,1468,0,0,1,2
5494811,5494883,72,1,0,0,2
5494811,5494885,74,1,0,0,1
5494884,5496950,2066,0,0,1,2
5494886,5496950,2064,0,0,1,1
5496951,5497194,243,1,0,0,2
5496951,5497230,279,1,0,0,1
5497000,5497173,173,0,1,0,1
5497002,5497139,137,0,1,0,2
5497195,5498499,1304,0,0,1,2
5497231,5498497,1266,0,0,1,1
5498498,5498559,61,1,0,0,1
5498500,5498560,60,1,0,0,2
5498560,5498902,342,0,0,1,1
5498561,5498900,339,0,0,1,2
5498901,5498918,17,1,0,0,2
5498903,5498907,4,1,0,0,1
5498908,5500080,1172,0,0,1,1
5498919,5500079,1160,0,0,1,2
5500080,5500142,62,1,0,0,2
5500081,5500151,70,1,0,0,1
5500143,5500662,519,0,0,1,2
5500152,5500664,512,0,0,1,1
5500663,5500685,22,1,0,0,2
5500665,5500692,27,1,0,0,1
5500686,5502215,1529,0,0,1,2
5500693,5502216,1523,0,0,1,1
5502216,5502551,335,1,0,0,2
5502217,5502587,370,1,0,0,1
5502245,5502541,296,0,1,0,1
5502249,5502504,255,0,1,0,2
5502552,5503112,560,0,0,1,2
5502588,5503110,522,0,0,1,1
5503111,5503149,38,1,0,0,1
5503113,5503151,38,1,0,0,2
5503150,5503742,592,0,0,1,1
5503152,5503741,589,0,0,1,2
5503742,5503821,79,1,0,0,2
5503743,5503823,80,1,0,0,1
5503822,5503911,89,0,0,1,2
5503824,5503911,87,0,0,1,1
5503912,5503949,37,1,0,0,2
5503912,5503955,43,1,0,0,1
5503950,5504122,172,0,0,1,2
5503956,5504121,165,0,0,1,1
5504122,5504155,33,1,0,0,1
5504123,5504153,30,1,0,0,2
5504154,5505336,1182,0,0,1,2
5504156,5505336,1180,0,0,1,1
5505337,5505390,53,1,0,0,1
5505337,5505393,56,1,0,0,2
5505391,5507460,2069,0,0,1,1
5505394,5507458,2064,0,0,1,2
5507459,5507633,174,1,0,0,2
5507461,5507619,158,1,0,0,1
5507499,5507572,73,0,1,0,1
5507510,5507551,41,0,1,0,2
5507620,5508161,541,0,0,1,1
5507634,5508161,527,0,0,1,2
5508162,5508228,66,1,0,0,1
5508162,5508236,74,1,0,0,2
5508229,5508790,561,0,0,1,1
5508237,5508788,551,0,0,1,2
5508789,5508860,71,1,0,0,2
5508791,5508862,71,1,0,0,1
5508861,5509195,334,0,0,1,2
5508863,5509194,331,0,0,1,1
5509195,5509298,103,1,0,0,1
5509196,5509303,107,1,0,0,2
5509299,5509404,105,0,0,1,1
5509304,5509404,100,0,0,1,2
5509405,5509427,22,1,0,0,1
5509405,5509441,36,1,0,0,2
5509428,5510705,1277,0,0,1,1
5509442,5510705,1263,0,0,1,2
5510706,5510767,61,1,0,0,1
5510706,5510767,61,1,0,0,2
5510768,5512840,2072,0,0,1,1
5510768,5512842,2074,0,0,1,2
5512841,5513064,223,1,0,0,1
5512843,5513058,215,1,0,0,2
5512900,5513005,105,0,1,0,2
5512901,5513016,115,0,1,0,1
5513059,5513431,372,0,0,1,2
5513065,5513432,367,0,0,1,1
5513432,5513508,76,1,0,0,2
5513433,5513510,77,1,0,0,1
5513509,5513879,370,0,0,1,2
5513511,5513879,368,0,0,1,1
5513880,5513940,60,1,0,0,1
5513880,5513940,60,1,0,0,2
5513941,5514157,216,0,0,1,1
5513941,5514158,217,0,0,1,2
5514158,5514221,63,1,0,0,1
5514159,5514227,68,1,0,0,2
5514222,5514384,162,0,0,1,1
5514228,5514384,156,0,0,1,2
5514385,5514452,67,1,0,0,1
5514385,5514452,67,1,0,0,2
5514453,5514571,118,0,0,1,1
5514453,5514572,119,0,0,1,2
5514572,5514602,30,1,0,0,1
5514573,5514607,34,1,0,0,2
5514603,5515443,840,0,0,1,1
5514608,5515442,834,0,0,1,2
5515443,5515494,51,1,0,0,2
5515444,5515495,51,1,0,0,1
5515495,5517557,2062,0,0,1,2
5515496,5517557,2061,0,0,1,1
5517558,5517772,214,1,0,0,2
5517558,5517792,234,1,0,0,1
5517592,5517745,153,0,1,0,1
5517596,5517715,119,0,1,0,2
5517773,5518710,937,0,0,1,2
5517793,5518709,916,0,0,1,1
5518710,5518763,53,1,0,0,1
5518711,5518775,64,1,0,0,2
5518764,5519101,337,0,0,1,1
5518776,5518950,174,0,0,1,2
5518951,5518975,24,1,0,0,2
5518976,5520035,1059,0,0,1,2
5519102,5519119,17,1,0,0,1
5519120,5520034,914,0,0,1,1
5520035,5520099,64,1,0,0,1
5520036,5520093,57,1,0,0,2
5520094,5522221,2127,0,0,1,2
5520100,5522220,2120,0,0,1,1
5522221,5522418,197,1,0,0,1
5522222,5522397,175,1,0,0,2
5522245,5522376,131,0,1,0,1
5522249,5522353,104,0,1,0,2
5522398,5523259,861,0,0,1,2
5522419,5523259,840,0,0,1,1
5523260,5523284,24,1,0,0,1
5523260,5523285,25,1,0,0,2
5523285,5523722,437,0,0,1,1
5523286,5523723,437,0,0,1,2
5523723,5523794,71,1,0,0,1
5523724,5523794,70,1,0,0,2
5523795,5523888,93,0,0,1,2
5523795,5523889,94,0,0,1,1
5523889,5523926,37,1,0,0,2
5523890,5523933,43,1,0,0,1
5523927,5524152,225,0,0,1,2
5523934,5524152,218,0,0,1,1
5524153,5524184,31,1,0,0,2
5524153,5524187,34,1,0,0,1
5524185,5525298,1113,0,0,1,2
5524188,5525300,1112,0,0,1,1
5525299,5525355,56,1,0,0,2
5525301,5525365,64,1,0,0,1
5525356,5525495,139,0,0,1,2
5525366,5525495,129,0,0,1,1
5525496,5525532,36,1,0,0,1
5525496,5525541,45,1,0,0,2
5525533,5525639,106,0,0,1,1
5525542,5525639,97,0,0,1,2
5525640,5525673,33,1,0,0,2
5525640,5525683,43,1,0,0,1
5525674,5527486,1812,0,0,1,2
5525684,5527489,1805,0,0,1,1
5527487,5527655,168,1,0,0,2
5527490,5527638,148,1,0,0,1
5527521,5527592,71,0,1,0,1
5527526,5527581,55,0,1,0,2
5527639,5529087,1448,0,0,1,1
5527656,5529086,1430,0,0,1,2
5529087,5529146,59,1,0,0,2
5529088,5529147,59,1,0,0,1
5529147,5529283,136,0,0,1,2
5529148,5529281,133,0,0,1,1
5529282,5529329,47,1,0,0,1
5529284,5529318,34,1,0,0,2
5529319,5531001,1682,0,0,1,2
5529330,5531001,1671,0,0,1,1
5531002,5531070,68,1,0,0,2
5531002,5531075,73,1,0,0,1
5531071,5533247,2176,0,0,1,2
5531076,5533250,2174,0,0,1,1
5533248,5533440,192,1,0,0,2
5533251,5533439,188,1,0,0,1
5533295,5533361,66,0,1,0,2
5533299,5533357,58,0,1,0,1
5533440,5535065,1625,0,0,1,1
5533441,5535068,1627,0,0,1,2
5535066,5535132,66,1,0,0,1
5535069,5535132,63,1,0,0,2
5535133,5535349,216,0,0,1,2
5535133,5535353,220,0,0,1,1
5535350,5535366,16,1,0,0,2
5535354,5535368,14,1,0,0,1
5535367,5536936,1569,0,0,1,2
5535369,5536937,1568,0,0,1,1
5536937,5536997,60,1,0,0,2
5536938,5537004,66,1,0,0,1
5536998,5539096,2098,0,0,1,2
5537005,5539094,2089,0,0,1,1
5539095,5539469,374,1,0,0,1
5539097,5539472,375,1,0,0,2
5539146,5539420,274,0,1,0,1
5539147,5539404,257,0,1,0,2
5539470,5540855,1385,0,0,1,1
5539473,5540857,1384,0,0,1,2
5540856,5540918,62,1,0,0,1
5540858,5540925,67,1,0,0,2
5540919,5541009,90,0,0,1,1
5540926,5541010,84,0,0,1,2
5541010,5541056,46,1,0,0,1
5541011,5541045,34,1,0,0,2
5541046,5541196,150,0,0,1,2
5541057,5541197,140,0,0,1,1
5541197,5541228,31,1,0,0,2
5541198,5541229,31,1,0,0,1
5541229,5542554,1325,0,0,1,2
5541230,5542554,1324,0,0,1,1
5542555,5542589,34,1,0,0,1
5542555,5542590,35,1,0,0,2
5542590,5542731,141,0,0,1,1
5542591,5542729,138,0,0,1,2
5542730,5542763,33,1,0,0,2
5542732,5542764,32,1,0,0,1
5542764,5544648,1884,0,0,1,2
5542765,5544648,1883,0,0,1,1
5544649,5544824,175,1,0,0,1
5544649,5544827,178,1,0,0,2
5544692,5544785,93,0,1,0,1
5544695,5544762,67,0,1,0,2
5544825,5545310,485,0,0,1,1
5544828,5545309,481,0,0,1,2
5545310,5545348,38,1,0,0,2
5545311,5545353,42,1,0,0,1
5545349,5546389,1040,0,0,1,2
5545354,5546388,1034,0,0,1,1
5546389,5546477,88,1,0,0,1
5546390,5546474,84,1,0,0,2
5546475,5546619,144,0,0,1,2
5546478,5546614,136,0,0,1,1
5546615,5546633,18,1,0,0,1
5546620,5546635,15,1,0,0,2
5546634,5547796,1162,0,0,1,1
5546636,5547795,1159,0,0,1,2
5547796,5547851,55,1,0,0,2
5547797,5547848,51,1,0,0,1
5547849,5549876,2027,0,0,1,1
5547852,5549877,2025,0,0,1,2
5549877,5550061,184,1,0,0,1
5549878,5550043,165,1,0,0,2
5549922,5550011,89,0,1,0,1
5549925,5549994,69,0,1,0,2
5550044,5550497,453,0,0,1,2
5550062,5550497,435,0,0,1,1
5550498,5550564,66,1,0,0,1
5550498,5550565,67,1,0,0,2
5550565,5550839,274,0,0,1,1
5550566,5550838,272,0,0,1,2
5550839,5550907,68,1,0,0,2
5550840,5550907,67,1,0,0,1
5550908,5551286,378,0,0,1,1
5550908,5551287,379,0,0,1,2
5551287,5551360,73,1,0,0,1
5551288,5551374,86,1,0,0,2
5551361,5551421,60,0,0,1,1
5551375,5551418,43,0,0,1,2
5551419,5551455,36,1,0,0,2
5551422,5551457,35,1,0,0,1
5551456,5551497,41,0,0,1,2
5551458,5551497,39,0,0,1,1
5551498,5551549,51,1,0,0,1
5551498,5551551,53,1,0,0,2
5551550,5551666,116,0,0,1,1
5551552,5551664,112,0,0,1,2
5551665,5551700,35,1,0,0,2
5551667,5551690,23,1,0,0,1
5551691,5553280,1589,0,0,1,1
5551701,5553281,1580,0,0,1,2
5553281,5553340,59,1,0,0,1
5553282,5553341,59,1,0,0,2
5553341,5554070,729,0,0,1,1
5553342,5554068,726,0,0,1,2
5554069,5554087,18,1,0,0,2
5554071,5554102,31,1,0,0,1
5554088,5555580,1492,0,0,1,2
5554103,5555581,1478,0,0,1,1
5555581,5555808,227,1,0,0,2
5555582,5555832,250,1,0,0,1
5555613,5555792,179,0,1,0,1
5555616,5555768,152,0,1,0,2
5555809,5556134,325,0,0,1,2
5555833,5556134,301,0,0,1,1
5556135,5556187,52,1,0,0,1
5556135,5556187,52,1,0,0,2
5556188,5556403,215,0,0,1,2
5556188,5556404,216,0,0,1,1
5556404,5556425,21,1,0,0,2
5556405,5556426,21,1,0,0,1
5556426,5557357,931,0,0,1,2
5556427,5557357,930,0,0,1,1
5557358,5557422,64,1,0,0,1
5557358,5557429,71,1,0,0,2
5557423,5559068,1645,0,0,1,1
5557430,5559068,1638,0,0,1,2
5559069,5559119,50,1,0,0,2
5559069,5559127,58,1,0,0,1
5559120,5559306,186,0,0,1,2
5559128,5559308,180,0,0,1,1
5559307,5559340,33,1,0,0,2
5559309,5559336,27,1,0,0,1
5559337,5560156,819,0,0,1,1
5559341,5560146,805,0,0,1,2
5560147,5560162,15,1,0,0,2
5560157,5560161,4,1,0,0,1
5560162,5560867,705,0,0,1,1
5560163,5561193,1030,0,0,1,2
5560868,5560891,23,1,0,0,1
5560892,5561193,301,0,0,1,1
5561194,5561419,225,1,0,0,2
5561194,5561421,227,1,0,0,1
5561220,5561374,154,0,1,0,2
5561220,5561386,166,0,1,0,1
5561420,5561753,333,0,0,1,2
5561422,5561755,333,0,0,1,1
5561754,5561795,41,1,0,0,2
5561756,5561801,45,1,0,0,1
5561796,5563018,1222,0,0,1,2
5561802,5563018,1216,0,0,1,1
5563019,5563062,43,1,0,0,2
5563019,5563063,44,1,0,0,1
5563063,5563208,145,0,0,1,2
5563064,5563211,147,0,0,1,1
5563209,5563223,14,1,0,0,2
5563212,5563224,12,1,0,0,1
5563224,5564170,946,0,0,1,2
5563225,5564171,946,0,0,1,1
5564171,5564233,62,1,0,0,2
5564172,5564234,62,1,0,0,1
5564234,5564267,33,0,0,1,2
5564235,5564269,34,0,0,1,1
5564268,5564315,47,1,0,0,2
5564270,5564306,36,1,0,0,1
5564307,5564608,301,0,0,1,1
5564316,5564605,289,0,0,1,2
5564606,5564644,38,1,0,0,2
5564609,5564643,34,1,0,0,1
5564644,5566319,1675,0,0,1,1
5564645,5566314,1669,0,0,1,2
5566315,5566621,306,1,0,0,2
5566320,5566636,316,1,0,0,1
5566351,5566594,243,0,1,0,1
5566354,5566587,233,0,1,0,2
5566622,5566752,130,0,0,1,2
5566637,5566796,159,0,0,1,1
5566753,5566945,192,1,0,0,2
5566797,5566957,160,1,0,0,1
5566815,5566934,119,0,1,0,1
5566821,5566911,90,0,1,0,2
5566946,5567141,195,0,0,1,2
5566958,5567142,184,0,0,1,1
5567142,5567260,118,1,0,0,2
5567143,5567277,134,1,0,0,1
5567159,5567248,89,0,1,0,1
5567169,5567226,57,0,1,0,2
5567261,5567470,209,0,0,1,2
5567278,5567471,193,0,0,1,1
5567471,5567535,64,1,0,0,2
5567472,5567547,75,1,0,0,1
5567536,5567677,141,0,0,1,2
5567548,5567676,128,0,0,1,1
5567677,5567707,30,1,0,0,1
5567678,5567700,22,1,0,0,2
5567701,5568992,1291,0,0,1,2
5567708,5568990,1282,0,0,1,1
5568991,5569056,65,1,0,0,1
5568993,5569045,52,1,0,0,2
5569046,5571112,2066,0,0,1,2
5569057,5571111,2054,0,0,1,1
5571112,5571440,328,1,0,0,1
5571113,5571429,316,1,0,0,2
5571158,5571381,223,0,1,0,2
5571159,5571399,240,0,1,0,1
5571430,5571901,471,0,0,1,2
5571441,5571900,459,0,0,1,1
5571901,5571970,69,1,0,0,1
5571902,5571962,60,1,0,0,2
5571963,5572388,425,0,0,1,2
5571971,5572387,416,0,0,1,1
5572388,5572502,114,1,0,0,1
5572389,5572502,113,1,0,0,2
5572503,5572622,119,0,0,1,1
5572503,5572623,120,0,0,1,2
5572623,5572670,47,1,0,0,1
5572624,5572658,34,1,0,0,2
5572659,5573051,392,0,0,1,2
5572671,5573049,378,0,0,1,1
5573050,5573077,27,1,0,0,1
5573052,5573076,24,1,0,0,2
5573077,5574236,1159,0,0,1,2
5573078,5574237,1159,0,0,1,1
5574237,5574302,65,1,0,0,2
5574238,5574329,91,1,0,0,1
5574303,5576388,2085,0,0,1,2
5574330,5576379,2049,0,0,1,1
5576380,5576693,313,1,0,0,1
5576389,5576680,291,1,0,0,2
5576429,5576651,222,0,1,0,1
5576431,5576634,203,0,1,0,2
5576681,5577319,638,0,0,1,2
5576694,5577318,624,0,0,1,1
5577319,5577361,42,1,0,0,1
5577320,5577361,41,1,0,0,2
5577362,5578179,817,0,0,1,1
5577362,5578179,817,0,0,1,2
5578180,5578237,57,1,0,0,2
5578180,5578241,61,1,0,0,1
5578238,5578427,189,0,0,1,2
5578242,5578427,185,0,0,1,1
5578428,5578443,15,1,0,0,2
5578428,5578445,17,1,0,0,1
5578444,5579703,1259,0,0,1,2
5578446,5579705,1259,0,0,1,1
5579704,5579759,55,1,0,0,2
5579706,5579765,59,1,0,0,1
5579760,5581793,2033,0,0,1,2
5579766,5581799,2033,0,0,1,1
5581794,5582121,327,1,0,0,2
5581800,5581811,11,1,0,0,1
5581812,5581834,22,0,0,1,1
5581835,5582136,301,1,0,0,1
5581863,5582077,214,0,1,0,2
5581867,5582094,227,0,1,0,1
5582122,5582503,381,0,0,1,2
5582137,5582503,366,0,0,1,1
5582504,5582549,45,1,0,0,1
5582504,5582559,55,1,0,0,2
5582550,5582945,395,0,0,1,1
5582560,5582945,385,0,0,1,2
5582946,5583006,60,1,0,0,1
5582946,5583006,60,1,0,0,2
5583007,5583371,364,0,0,1,1
5583007,5583371,364,0,0,1,2
5583372,5583430,58,1,0,0,2
5583372,5583432,60,1,0,0,1
5583431,5585088,1657,0,0,1,2
5583433,5583626,193,0,0,1,1
5583627,5583645,18,1,0,0,1
5583646,5585088,1442,0,0,1,1
5585089,5585136,47,1,0,0,1
5585089,5585140,51,1,0,0,2
5585137,5585272,135,0,0,1,1
5585141,5585274,133,0,0,1,2
5585273,5585303,30,1,0,0,1
5585275,5585302,27,1,0,0,2
5585303,5585417,114,0,0,1,2
5585304,5585413,109,0,0,1,1
5585414,5585441,27,1,0,0,1
5585418,5585442,24,1,0,0,2
5585442,5587274,1832,0,0,1,1
5585443,5587273,1830,0,0,1,2
5587274,5587623,349,1,0,0,2
5587275,5587651,376,1,0,0,1
5587309,5587603,294,0,1,0,1
5587312,5587579,267,0,1,0,2
5587624,5587933,309,0,0,1,2
5587652,5587934,282,0,0,1,1
5587934,5587964,30,1,0,0,2
5587935,5587982,47,1,0,0,1
5587965,5588836,871,0,0,1,2
5587983,5588836,853,0,0,1,1
5588837,5588887,50,1,0,0,1
5588837,5588887,50,1,0,0,2
5588888,5589104,216,0,0,1,1
5588888,5589105,217,0,0,1,2
5589105,5589186,81,1,0,0,1
5589106,5589175,69,1,0,0,2
5589176,5589211,35,0,0,1,2
5589187,5589210,23,0,0,1,1
5589211,5589252,41,1,0,0,1
5589212,5589256,44,1,0,0,2
5589253,5589431,178,0,0,1,1
5589257,5589430,173,0,0,1,2
5589431,5589448,17,1,0,0,2
5589432,5589460,28,1,0,0,1
5589449,5590856,1407,0,0,1,2
5589461,5590855,1394,0,0,1,1
5590856,5590918,62,1,0,0,1
5590857,5590905,48,1,0,0,2
5590906,5593024,2118,0,0,1,2
5590919,5593038,2119,0,0,1,1
5593025,5593301,276,1,0,0,2
5593039,5593312,273,1,0,0,1
5593079,5593239,160,0,1,0,1
5593085,5593192,107,0,1,0,2
5593302,5593714,412,0,0,1,2
5593313,5593713,400,0,0,1,1
5593714,5593769,55,1,0,0,1
5593715,5593762,47,1,0,0,2
5593763,5594532,769,0,0,1,2
5593770,5594531,761,0,0,1,1
5594532,5594604,72,1,0,0,1
5594533,5594605,72,1,0,0,2
5594605,5594712,107,0,0,1,1
5594606,5594714,108,0,0,1,2
5594713,5594752,39,1,0,0,1
5594715,5594748,33,1,0,0,2
5594749,5596415,1666,0,0,1,2
5594753,5596418,1665,0,0,1,1
5596416,5596462,46,1,0,0,2
5596419,5596473,54,1,0,0,1
5596463,5598677,2214,0,0,1,2
5596474,5598675,2201,0,0,1,1
5598676,5598911,235,1,0,0,1
5598678,5598882,204,1,0,0,2
5598713,5598855,142,0,1,0,1
5598718,5598816,98,0,1,0,2
5598883,5599759,876,0,0,1,2
5598912,5599759,847,0,0,1,1
5599760,5599825,65,1,0,0,2
5599760,5599826,66,1,0,0,1
5599826,5600318,492,0,0,1,2
5599827,5600317,490,0,0,1,1
5600318,5600387,69,1,0,0,1
5600319,5600398,79,1,0,0,2
5600388,5600484,96,0,0,1,1
5600399,5600484,85,0,0,1,2
5600485,5600522,37,1,0,0,2
5600485,5600534,49,1,0,0,1
5600523,5601700,1177,0,0,1,2
5600535,5600719,184,0,0,1,1
5600720,5600738,18,1,0,0,1
5600739,5601701,962,0,0,1,1
5601701,5601757,56,1,0,0,2
5601702,5601759,57,1,0,0,1
5601758,5602119,361,0,0,1,2
5601760,5602118,358,0,0,1,1
5602119,5602141,22,1,0,0,1
5602120,5602141,21,1,0,0,2
5602142,5603828,1686,0,0,1,2
5602142,5603836,1694,0,0,1,1
5603829,5603990,161,1,0,0,2
5603837,5604005,168,1,0,0,1
5603858,5603964,106,0,1,0,1
5603862,5603936,74,0,1,0,2
5603991,5604663,672,0,0,1,2
5604006,5604664,658,0,0,1,1
5604664,5604725,61,1,0,0,2
5604665,5604736,71,1,0,0,1
5604726,5605094,368,0,0,1,2
5604737,5605094,357,0,0,1,1
5605095,5605133,38,1,0,0,2
5605095,5605138,43,1,0,0,1
5605134,5605317,183,0,0,1,2
5605139,5605313,174,0,0,1,1
5605314,5605340,26,1,0,0,1
5605318,5605338,20,1,0,0,2
5605339,5606862,1523,0,0,1,2
5605341,5606862,1521,0,0,1,1
5606863,5606914,51,1,0,0,2
5606863,5606921,58,1,0,0,1
5606915,5610691,3776,0,0,1,2
5606922,5610691,3769,0,0,1,1
5610692,5610777,85,1,0,0,1
5610692,5610777,85,1,0,0,2
5610778,5610873,95,0,0,1,2
5610778,5610876,98,0,0,1,1
5610874,5610938,64,1,0,0,2
5610877,5610938,61,1,0,0,1
5610939,5611015,76,0,0,1,1
5610939,5611016,77,0,0,1,2
5611016,5611059,43,1,0,0,1
5611017,5611050,33,1,0,0,2
5611051,5612085,1034,0,0,1,2
5611060,5612085,1025,0,0,1,1
5612086,5612148,62,1,0,0,2
5612086,5612154,68,1,0,0,1
5612149,5612282,133,0,0,1,2
5612155,5612282,127,0,0,1,1
5612283,5612314,31,1,0,0,1
5612283,5612314,31,1,0,0,2
5612315,5614197,1882,0,0,1,1
5612315,5614197,1882,0,0,1,2
5614198,5614362,164,1,0,0,2
5614198,5614393,195,1,0,0,1
5614231,5614335,104,0,1,0,1
5614240,5614307,67,0,1,0,2
5614363,5615418,1055,0,0,1,2
5614394,5615419,1025,0,0,1,1
5615419,5615492,73,1,0,0,2
5615420,5615492,72,1,0,0,1
5615493,5615596,103,0,0,1,1
5615493,5615596,103,0,0,1,2
5615597,5615633,36,1,0,0,2
5615597,5615635,38,1,0,0,1
5615634,5615861,227,0,0,1,2
5615636,5617249,1613,0,0,1,1
5615862,5615883,21,1,0,0,2
5615884,5617249,1365,0,0,1,2
5617250,5617318,68,1,0,0,2
5617250,5617327,77,1,0,0,1
5617319,5619614,2295,0,0,1,2
5617328,5619606,2278,0,0,1,1
5619607,5619834,227,1,0,0,1
5619615,5619813,198,1,0,0,2
5619647,5619789,142,0,1,0,1
5619652,5619750,98,0,1,0,2
5619814,5621271,1457,0,0,1,2
5619835,5621272,1437,0,0,1,1
5621272,5621306,34,1,0,0,2
5621273,5621321,48,1,0,0,1
5621307,5621711,404,0,0,1,2
5621322,5621711,389,0,0,1,1
5621712,5621740,28,1,0,0,2
5621712,5621745,33,1,0,0,1
5621741,5621951,210,0,0,1,2
5621746,5621951,205,0,0,1,1
5672522,5672729,207,0,0,1,1
5672522,5672730,208,0,0,1,2
5672730,5672788,58,1,0,0,1
5672731,5672787,56,1,0,0,2
5672788,5672931,143,0,0,1,2
5672789,5672930,141,0,0,1,1
5672931,5672966,35,1,0,0,1
5672932,5672963,31,1,0,0,2
5672964,5674882,1918,0,0,1,2
5672967,5674882,1915,0,0,1,1
5674883,5674969,86,1,0,0,1
5674883,5674982,99,1,0,0,2
5674970,5675075,105,0,0,1,1
5674983,5675073,90,0,0,1,2
5675074,5675109,35,1,0,0,2
5675076,5675105,29,1,0,0,1
5675106,5676910,1804,0,0,1,1
5675110,5676911,1801,0,0,1,2
5676911,5676970,59,1,0,0,1
5676912,5676969,57,1,0,0,2
5676970,5677082,112,0,0,1,2
5676971,5677083,112,0,0,1,1
5677083,5677114,31,1,0,0,2
5677084,5677121,37,1,0,0,1
5677115,5678466,1351,0,0,1,2
5677122,5678465,1343,0,0,1,1
5678466,5678539,73,1,0,0,1
5678467,5678549,82,1,0,0,2
5678540,5678635,95,0,0,1,1
5678550,5678635,85,0,0,1,2
5678636,5678666,30,1,0,0,2
5678636,5678676,40,1,0,0,1
5678667,5680104,1437,0,0,1,2
5678677,5680104,1427,0,0,1,1
5680105,5680256,151,1,0,0,2
5680105,5680341,236,1,0,0,1
5680257,5680290,33,0,0,1,2
5680291,5680341,50,1,0,0,2
5680342,5680447,105,0,0,1,1
5680342,5680447,105,0,0,1,2
5680448,5680479,31,1,0,0,2
5680448,5680490,42,1,0,0,1
5680480,5681683,1203,0,0,1,2
5680491,5681038,547,0,0,1,1
5681039,5681149,110,1,0,0,1
5681150,5681211,61,0,0,1,1
5681212,5681269,57,1,0,0,1
5681270,5681520,250,0,0,1,1
5681521,5681554,33,1,0,0,1
5681555,5681618,63,0,0,1,1
5681619,5681775,156,1,0,0,1
5681684,5681759,75,1,0,0,2
5681760,5681858,98,0,0,1,2
5681776,5681823,47,0,0,1,1
5681824,5681906,82,1,0,0,1
5681859,5681896,37,1,0,0,2
5681897,5683182,1285,0,0,1,2
5681907,5683182,1275,0,0,1,1
5683183,5683256,73,1,0,0,2
5683183,5683381,198,1,0,0,1
5683257,5683349,92,0,0,1,2
5683350,5683386,36,1,0,0,2
5683382,5683589,207,0,0,1,1
5683387,5684650,1263,0,0,1,2
5683590,5683594,4,1,0,0,1
5683595,5684650,1055,0,0,1,1
5684651,5684724,73,1,0,0,1
5684651,5684728,77,1,0,0,2
5684725,5684865,140,0,0,1,1
5684729,5684864,135,0,0,1,2
5684865,5684895,30,1,0,0,2
5684866,5684895,29,1,0,0,1
5684896,5686478,1582,0,0,1,1
5684896,5686478,1582,0,0,1,2
5686479,5686569,90,1,0,0,2
5686479,5686643,164,1,0,0,1
5686570,5686590,20,0,0,1,2
5686591,5686627,36,1,0,0,2
5686628,5686726,98,0,0,1,2
5686644,5686726,82,0,0,1,1
5686727,5686760,33,1,0,0,2
5686727,5686791,64,1,0,0,1
5686761,5688127,1366,0,0,1,2
5686792,5687899,1107,0,0,1,1
5687900,5687908,8,1,0,0,1
5687909,5688127,218,0,0,1,1
5688128,5688223,95,1,0,0,2
5688128,5688226,98,1,0,0,1
5688224,5688356,132,0,0,1,2
5688227,5688360,133,0,0,1,1
5688357,5688395,38,1,0,0,2
5688361,5688393,32,1,0,0,1
5688394,5688463,69,0,0,1,1
5688396,5689709,1313,0,0,1,2
5688464,5688496,32,1,0,0,1
5688497,5689363,866,0,0,1,1
5689364,5689465,101,1,0,0,1
5689466,5689710,244,0,0,1,1
5689710,5689783,73,1,0,0,2
5689711,5689916,205,1,0,0,1
5689784,5689866,82,0,0,1,2
5689867,5689907,40,1,0,0,2
5689908,5690045,137,0,0,1,2
5689917,5690039,122,0,0,1,1
5690040,5690078,38,1,0,0,1
5690046,5690075,29,1,0,0,2
5690076,5691334,1258,0,0,1,2
5690079,5690342,263,0,0,1,1
5690343,5690375,32,1,0,0,1
5690376,5691335,959,0,0,1,1
5691335,5691408,73,1,0,0,2
5691336,5691435,99,1,0,0,1
5691409,5691502,93,0,0,1,2
5691436,5691501,65,0,0,1,1
5691502,5691600,98,1,0,0,1
5691503,5691551,48,1,0,0,2
5691552,5692903,1351,0,0,1,2
5691601,5691725,124,0,0,1,1
5691726,5691790,64,1,0,0,1
5691791,5692022,231,0,0,1,1
5692023,5692035,12,1,0,0,1
5692036,5692386,350,0,0,1,1
5692387,5692423,36,1,0,0,1
5692424,5692791,367,0,0,1,1
5692792,5692830,38,1,0,0,1
5692831,5692899,68,0,0,1,1
5692900,5693014,114,1,0,0,1
5692904,5693019,115,1,0,0,2
5693015,5693087,72,0,0,1,1
5693020,5693087,67,0,0,1,2
5693088,5693130,42,1,0,0,2
5693088,5693135,47,1,0,0,1
5693131,5693175,44,0,0,1,2
5693136,5693175,39,0,0,1,1
5693176,5693214,38,1,0,0,1
5693176,5693223,47,1,0,0,2
5693215,5693374,159,0,0,1,1
5693224,5693370,146,0,0,1,2
5693371,5693388,17,1,0,0,2
5693375,5693387,12,1,0,0,1
5693388,5694778,1390,0,0,1,1
5693389,5694777,1388,0,0,1,2
5694778,5694840,62,1,0,0,2
5694779,5694840,61,1,0,0,1
5694841,5694986,145,0,0,1,1
5694841,5694986,145,0,0,1,2
5694987,5695007,20,1,0,0,1
5694987,5695018,31,1,0,0,2
5695008,5696413,1405,0,0,1,1
5695019,5696413,1394,0,0,1,2
5696414,5696482,68,1,0,0,2
5696414,5696484,70,1,0,0,1
5696483,5698088,1605,0,0,1,2
5696485,5698087,1602,0,0,1,1
5698088,5698137,49,1,0,0,1
5698089,5698137,48,1,0,0,2
5698138,5699608,1470,0,0,1,1
5698138,5699608,1470,0,0,1,2
5699609,5699679,70,1,0,0,2
5699609,5699681,72,1,0,0,1
5699680,5699806,126,0,0,1,2
5699682,5699807,125,0,0,1,1
5699807,5699828,21,1,0,0,2
5699808,5699829,21,1,0,0,1
5699829,5701303,1474,0,0,1,2
5699830,5701303,1473,0,0,1,1
5701304,5701351,47,1,0,0,1
5701304,5701360,56,1,0,0,2
5701352,5701470,118,0,0,1,1
5701361,5701470,109,0,0,1,2
5701471,5701492,21,1,0,0,1
5701471,5701500,29,1,0,0,2
5701493,5702928,1435,0,0,1,1
5701501,5702928,1427,0,0,1,2
5702929,5702996,67,1,0,0,2
5702929,5703028,99,1,0,0,1
5702997,5703078,81,0,0,1,2
5703029,5703078,49,0,0,1,1
5703079,5703114,35,1,0,0,2
5703079,5703116,37,1,0,0,1
5703115,5704677,1562,0,0,1,2
5703117,5704678,1561,0,0,1,1
5704678,5704778,100,1,0,0,2
5704679,5704795,116,1,0,0,1
5704779,5704865,86,0,0,1,2
5704796,5704865,69,0,0,1,1
5704866,5704910,44,1,0,0,2
5704866,5704940,74,1,0,0,1
5704911,5706401,1490,0,0,1,2
5704941,5706402,1461,0,0,1,1
5706402,5706472,70,1,0,0,2
5706403,5706474,71,1,0,0,1
5706473,5706565,92,0,0,1,2
5706475,5706565,90,0,0,1,1
5706566,5706603,37,1,0,0,2
5706566,5706615,49,1,0,0,1
5706604,5707950,1346,0,0,1,2
5706616,5707421,805,0,0,1,1
5707422,5707468,46,1,0,0,1
5707469,5707951,482,0,0,1,1
5707951,5708037,86,1,0,0,2
5707952,5708043,91,1,0,0,1
5708038,5708120,82,0,0,1,2
5708044,5708122,78,0,0,1,1
5708121,5708167,46,1,0,0,2
5708123,5708165,42,1,0,0,1
5708166,5709580,1414,0,0,1,1
5708168,5709623,1455,0,0,1,2
5709581,5709727,146,1,0,0,1
5709624,5709723,99,1,0,0,2
5709724,5709822,98,0,0,1,2
5709728,5709823,95,0,0,1,1
5709823,5709862,39,1,0,0,2
5709824,5709863,39,1,0,0,1
5709863,5711275,1412,0,0,1,2
5709864,5711274,1410,0,0,1,1
5711275,5711371,96,1,0,0,1
5711276,5711373,97,1,0,0,2
5711372,5711458,86,0,0,1,1
5711374,5711460,86,0,0,1,2
5711459,5711500,41,1,0,0,1
5711461,5711504,43,1,0,0,2
5711501,5711654,153,0,0,1,1
5711505,5711653,148,0,0,1,2
5711654,5711672,18,1,0,0,2
5711655,5711684,29,1,0,0,1
5711673,5712759,1086,0,0,1,2
5711685,5712761,1076,0,0,1,1
5712760,5712853,93,1,0,0,2
5712762,5712853,91,1,0,0,1
5712854,5712908,54,0,0,1,1
5712854,5712909,55,0,0,1,2
5712909,5713000,91,1,0,0,1
5712910,5712995,85,1,0,0,2
5712996,5713087,91,0,0,1,2
5713001,5713088,87,0,0,1,1
5713088,5713125,37,1,0,0,2
5713089,5713136,47,1,0,0,1
5713126,5713237,111,0,0,1,2
5713137,5713237,100,0,0,1,1
5713238,5713270,32,1,0,0,2
5713238,5713273,35,1,0,0,1
5713271,5714521,1250,0,0,1,2
5713274,5714521,1247,0,0,1,1
5714522,5714578,56,1,0,0,2
5714522,5714582,60,1,0,0,1
5714579,5716011,1432,0,0,1,2
5714583,5715381,798,0,0,1,1
5715382,5715418,36,1,0,0,1
5715419,5716012,593,0,0,1,1
5716012,5716074,62,1,0,0,2
5716013,5716109,96,1,0,0,1
5716075,5716133,58,0,0,1,2
5716110,5716135,25,0,0,1,1
5716134,5716180,46,1,0,0,2
5716136,5716220,84,1,0,0,1
5716181,5717487,1306,0,0,1,2
5716221,5717353,1132,0,0,1,1
5717354,5717362,8,1,0,0,1
5717363,5717488,125,0,0,1,1
5717488,5717564,76,1,0,0,2
5717489,5717564,75,1,0,0,1
5717565,5717661,96,0,0,1,1
5717565,5717662,97,0,0,1,2
5717662,5717699,37,1,0,0,1
5717663,5717696,33,1,0,0,2
5717697,5719107,1410,0,0,1,2
5717700,5719106,1406,0,0,1,1
5719107,5719178,71,1,0,0,1
5719108,5719188,80,1,0,0,2
5719179,5719286,107,0,0,1,1
5719189,5719286,97,0,0,1,2
5719287,5719326,39,1,0,0,2
5719287,5719329,42,1,0,0,1
5719327,5720749,1422,0,0,1,2
5719330,5720749,1419,0,0,1,1
5720750,5720791,41,1,0,0,1
5720750,5720800,50,1,0,0,2
5720792,5720957,165,0,0,1,1
5720801,5720954,153,0,0,1,2
5720955,5720968,13,1,0,0,2
5720958,5720985,27,1,0,0,1
5720969,5722385,1416,0,0,1,2
5720986,5722386,1400,0,0,1,1
5722386,5722483,97,1,0,0,2
5722387,5722482,95,1,0,0,1
5722483,5722584,101,0,0,1,1
5722484,5722586,102,0,0,1,2
5722585,5722620,35,1,0,0,1
5722587,5722622,35,1,0,0,2
5722621,5724249,1628,0,0,1,1
5722623,5724250,1627,0,0,1,2
5724250,5724342,92,1,0,0,1
5724251,5724346,95,1,0,0,2
5724343,5724455,112,0,0,1,1
5724347,5724454,107,0,0,1,2
5724455,5724480,25,1,0,0,2
5724456,5724481,25,1,0,0,1
5724481,5725877,1396,0,0,1,2
5724482,5725878,1396,0,0,1,1
5725878,5725952,74,1,0,0,2
5725879,5725965,86,1,0,0,1
5725953,5726095,142,0,0,1,2
5725966,5726090,124,0,0,1,1
5726091,5726112,21,1,0,0,1
5726096,5726114,18,1,0,0,2
5726113,5726249,136,0,0,1,1
5726115,5726248,133,0,0,1,2
5726249,5726266,17,1,0,0,2
5726250,5726265,15,1,0,0,1
5726266,5727460,1194,0,0,1,1
5726267,5727461,1194,0,0,1,2
5727461,5727523,62,1,0,0,1
5727462,5727534,72,1,0,0,2
5727524,5727867,343,0,0,1,1
5727535,5727862,327,0,0,1,2
5727863,5727891,28,1,0,0,2
5727868,5727891,23,1,0,0,1
5727892,5729003,1111,0,0,1,1
5727892,5729116,1224,0,0,1,2
5729004,5729011,7,1,0,0,1
5729012,5729117,105,0,0,1,1
5729117,5729173,56,1,0,0,2
5729118,5729172,54,1,0,0,1
5729173,5729324,151,0,0,1,1
5729174,5729328,154,0,0,1,2
5729325,5729346,21,1,0,0,1
5729329,5729347,18,1,0,0,2
5729347,5730644,1297,0,0,1,1
5729348,5730645,1297,0,0,1,2
5730645,5730791,146,1,0,0,1
5730646,5730787,141,1,0,0,2
5730788,5730945,157,0,0,1,2
5730792,5730946,154,0,0,1,1
5730946,5730994,48,1,0,0,2
5730947,5731023,76,1,0,0,1
5730995,5731990,995,0,0,1,2
5731024,5731998,974,0,0,1,1
5731991,5732137,146,1,0,0,2
5731999,5732208,209,1,0,0,1
5732039,5732114,75,0,1,0,1
5732052,5732086,34,0,1,0,2
5732138,5732276,138,0,0,1,2
5732209,5732275,66,0,0,1,1
5732276,5732336,60,1,0,0,1
5732277,5732347,70,1,0,0,2
5732337,5732566,229,0,0,1,1
5732348,5732565,217,0,0,1,2
5732566,5732593,27,1,0,0,2
5732567,5732595,28,1,0,0,1
5732594,5733453,859,0,0,1,2
5732596,5732873,277,0,0,1,1
5732874,5732890,16,1,0,0,1
5732891,5733439,548,0,0,1,1
5733440,5733606,166,1,0,0,1
5733454,5733601,147,1,0,0,2
5733495,5733553,58,0,1,0,1
5733513,5733534,21,0,1,0,2
5733602,5733862,260,0,0,1,2
5733607,5733862,255,0,0,1,1
5733863,5733947,84,1,0,0,2
5733863,5733948,85,1,0,0,1
5733948,5734027,79,0,0,1,2
5733949,5734027,78,0,0,1,1
5734028,5734063,35,1,0,0,2
5734028,5734066,38,1,0,0,1
5734064,5734281,217,0,0,1,2
5734067,5734278,211,0,0,1,1
5734279,5734291,12,1,0,0,1
5734282,5734291,9,1,0,0,2
5734292,5735518,1226,0,0,1,2
5734292,5735519,1227,0,0,1,1
5735519,5735586,67,1,0,0,2
5735520,5735587,67,1,0,0,1
5735587,5735640,53,0,0,1,2
5735588,5735637,49,0,0,1,1
5735638,5735676,38,1,0,0,1
5735641,5735675,34,1,0,0,2
5735676,5737137,1461,0,0,1,2
5735677,5737136,1459,0,0,1,1
5737137,5737210,73,1,0,0,1
5737138,5737226,88,1,0,0,2
5737211,5737292,81,0,0,1,1
5737227,5737292,65,0,0,1,2
5737293,5737351,58,1,0,0,2
5737293,5737353,60,1,0,0,1
5737352,5737478,126,0,0,1,2
5737354,5737478,124,0,0,1,1
5737479,5737506,27,1,0,0,2
5737479,5737510,31,1,0,0,1
5737507,5738888,1381,0,0,1,2
5737511,5738887,1376,0,0,1,1
5738888,5739046,158,1,0,0,1
5738889,5739045,156,1,0,0,2
5739046,5739079,33,0,0,1,2
5739047,5739079,32,0,0,1,1
5739080,5739124,44,1,0,0,2
5739080,5739125,45,1,0,0,1
5739125,5739235,110,0,0,1,2
5739126,5739231,105,0,0,1,1
5739232,5739309,77,1,0,0,1
5739236,5739283,47,1,0,0,2
5739284,5739616,332,0,0,1,2
5739310,5739626,316,0,0,1,1
5739617,5739653,36,1,0,0,2
5739627,5739638,11,1,0,0,1
5739639,5739706,67,0,0,1,1
5739654,5740550,896,0,0,1,2
5739707,5739711,4,1,0,0,1
5739712,5740549,837,0,0,1,1
5740550,5740659,109,1,0,0,1
5740551,5740658,107,1,0,0,2
5740659,5740701,42,0,0,1,2
5740660,5740703,43,0,0,1,1
5740702,5740771,69,1,0,0,2
5740704,5740768,64,1,0,0,1
5740769,5740880,111,0,0,1,1
5740772,5740877,105,0,0,1,2
5740878,5740910,32,1,0,0,2
5740881,5740901,20,1,0,0,1
5740902,5742131,1229,0,0,1,1
5740911,5742132,1221,0,0,1,2
5742132,5742198,66,1,0,0,1
5742133,5742191,58,1,0,0,2
5742192,5742334,142,0,0,1,2
5742199,5742333,134,0,0,1,1
5742334,5742385,51,1,0,0,1
5742335,5742396,61,1,0,0,2
5742386,5742508,122,0,0,1,1
5742397,5742506,109,0,0,1,2
5742507,5742545,38,1,0,0,2
5742509,5742545,36,1,0,0,1
5742546,5742964,418,0,0,1,1
5742546,5742967,421,0,0,1,2
5742965,5742981,16,1,0,0,1
5742968,5742980,12,1,0,0,2
5742981,5743933,952,0,0,1,2
5742982,5743932,950,0,0,1,1
5743933,5744024,91,1,0,0,1
5743934,5744002,68,1,0,0,2
5744003,5744057,54,0,0,1,2
5744025,5744055,30,0,0,1,1
5744056,5744095,39,1,0,0,1
5744058,5744095,37,1,0,0,2
5744096,5744218,122,0,0,1,1
5744096,5744218,122,0,0,1,2
5744219,5744249,30,1,0,0,2
5744219,5744250,31,1,0,0,1
5744250,5745522,1272,0,0,1,2
5744251,5745522,1271,0,0,1,1
5745523,5745576,53,1,0,0,1
5745523,5745576,53,1,0,0,2
5745577,5745713,136,0,0,1,2
5745577,5745714,137,0,0,1,1
5745714,5745736,22,1,0,0,2
5745715,5745740,25,1,0,0,1
5745737,5747142,1405,0,0,1,2
5745741,5747140,1399,0,0,1,1
5747141,5747201,60,1,0,0,1
5747143,5747200,57,1,0,0,2
5747201,5747333,132,0,0,1,2
5747202,5747334,132,0,0,1,1
5747334,5747355,21,1,0,0,2
5747335,5747364,29,1,0,0,1
5747356,5748886,1530,0,0,1,2
5747365,5748887,1522,0,0,1,1
5748887,5748965,78,1,0,0,2
5748888,5749038,150,1,0,0,1
5748966,5748993,27,0,0,1,2
5748994,5749019,25,1,0,0,2
5749020,5749087,67,0,0,1,2
5749039,5749088,49,0,0,1,1
5749088,5749128,40,1,0,0,2
5749089,5749126,37,1,0,0,1
5749127,5750636,1509,0,0,1,1
5749129,5750636,1507,0,0,1,2
5750637,5750745,108,1,0,0,1
5750637,5750748,111,1,0,0,2
5750746,5750829,83,0,0,1,1
5750749,5750827,78,0,0,1,2
5750828,5750870,42,1,0,0,2
5750830,5750867,37,1,0,0,1
5750868,5750995,127,0,0,1,1
5750871,5750991,120,0,0,1,2
5750992,5751024,32,1,0,0,2
5750996,5751022,26,1,0,0,1
5751023,5752262,1239,0,0,1,1
5751025,5752262,1237,0,0,1,2
5752263,5752319,56,1,0,0,1
5752263,5752323,60,1,0,0,2
5752320,5752483,163,0,0,1,1
5752324,5752475,151,0,0,1,2
5752476,5752497,21,1,0,0,2
5752484,5752494,10,1,0,0,1
5752495,5754003,1508,0,0,1,1
5752498,5754002,1504,0,0,1,2
5754003,5754068,65,1,0,0,2
5754004,5754078,74,1,0,0,1
5754069,5754162,93,0,0,1,2
5754079,5754163,84,0,0,1,1
5754163,5754189,26,1,0,0,2
5754164,5754199,35,1,0,0,1
5754190,5754410,220,0,0,1,2
5754200,5755580,1380,0,0,1,1
5754411,5754444,33,1,0,0,2
5754445,5755579,1134,0,0,1,2
5755580,5755642,62,1,0,0,2
5755581,5755668,87,1,0,0,1
5755643,5755803,160,0,0,1,2
5755669,5755802,133,0,0,1,1
5755803,5755837,34,1,0,0,1
5755804,5755836,32,1,0,0,2
5755837,5756088,251,0,0,1,2
5755838,5756091,253,0,0,1,1
5756089,5756109,20,1,0,0,2
5756092,5756108,16,1,0,0,1
5756109,5757619,1510,0,0,1,1
5756110,5757740,1630,0,0,1,2
5757620,5757625,5,1,0,0,1
5757626,5757709,83,0,0,1,1
5757710,5757975,265,1,0,0,1
5757741,5757923,182,1,0,0,2
5757779,5757911,132,0,1,0,1
5757789,5757860,71,0,1,0,2
5757924,5758260,336,0,0,1,2
5757976,5758260,284,0,0,1,1
5758261,5758302,41,1,0,0,1
5758261,5758312,51,1,0,0,2
5758303,5758767,464,0,0,1,1
5758313,5758769,456,0,0,1,2
5758768,5758816,48,1,0,0,1
5758770,5758815,45,1,0,0,2
5758816,5759004,188,0,0,1,2
5758817,5759005,188,0,0,1,1
5759005,5759078,73,1,0,0,2
5759006,5759070,64,1,0,0,1
5759071,5759126,55,0,0,1,1
5759079,5759126,47,0,0,1,2
5759127,5759205,78,1,0,0,2
5759127,5759212,85,1,0,0,1
5759206,5759233,27,0,0,1,2
5759213,5759233,20,0,0,1,1
5759234,5759280,46,1,0,0,2
5759234,5759294,60,1,0,0,1
5759281,5759363,82,0,0,1,2
5759295,5759363,68,0,0,1,1
5759364,5759410,46,1,0,0,2
5759364,5759421,57,1,0,0,1
5759411,5759592,181,0,0,1,2
5759422,5759594,172,0,0,1,1
5759593,5759607,14,1,0,0,2
5759595,5759605,10,1,0,0,1
5759606,5760188,582,0,0,1,1
5759608,5760920,1312,0,0,1,2
5760189,5760204,15,1,0,0,1
5760205,5760919,714,0,0,1,1
5760920,5760985,65,1,0,0,1
5760921,5760990,69,1,0,0,2
5760986,5763016,2030,0,0,1,1
5760991,5763016,2025,0,0,1,2
5763017,5763245,228,1,0,0,2
5763017,5763259,242,1,0,0,1
5763059,5763217,158,0,1,0,1
5763066,5763175,109,0,1,0,2
5763246,5763975,729,0,0,1,2
5763260,5763974,714,0,0,1,1
5763975,5764038,63,1,0,0,1
5763976,5764036,60,1,0,0,2
5764037,5764248,211,0,0,1,2
5764039,5764248,209,0,0,1,1
5764249,5764324,75,1,0,0,2
5764249,5764327,78,1,0,0,1
5764325,5764706,381,0,0,1,2
5764328,5764706,378,0,0,1,1
5764707,5764782,75,1,0,0,2
5764707,5764792,85,1,0,0,1
5764783,5764878,95,0,0,1,2
5764793,5764878,85,0,0,1,1
5764879,5764914,35,1,0,0,1
5764879,5764916,37,1,0,0,2
5764915,5765001,86,0,0,1,1
5764917,5764998,81,0,0,1,2
5764999,5765043,44,1,0,0,2
5765002,5765044,42,1,0,0,1
5765044,5765196,152,0,0,1,2
5765045,5765194,149,0,0,1,1
5765195,5765218,23,1,0,0,1
5765197,5765212,15,1,0,0,2
5765213,5766278,1065,0,0,1,2
5765219,5766279,1060,0,0,1,1
5766279,5766336,57,1,0,0,2
5766280,5766337,57,1,0,0,1
5766337,5766503,166,0,0,1,2
5766338,5766498,160,0,0,1,1
5766499,5766537,38,1,0,0,1
5766504,5766533,29,1,0,0,2
5766534,5768399,1865,0,0,1,2
5766538,5768395,1857,0,0,1,1
5768396,5768732,336,1,0,0,1
5768400,5768685,285,1,0,0,2
5768436,5768649,213,0,1,0,1
5768439,5768580,141,0,1,0,2
5768686,5769130,444,0,0,1,2
5768733,5769129,396,0,0,1,1
5769130,5769178,48,1,0,0,1
5769131,5769178,47,1,0,0,2
5769179,5769678,499,0,0,1,1
5769179,5769680,501,0,0,1,2
5769679,5769749,70,1,0,0,1
5769681,5769749,68,1,0,0,2
5769750,5769947,197,0,0,1,2
5769750,5771631,1881,0,0,1,1
5769948,5769956,8,1,0,0,2
5769957,5771632,1675,0,0,1,2
5771632,5771699,67,1,0,0,1
5771633,5771701,68,1,0,0,2
5771700,5771803,103,0,0,1,1
5771702,5771803,101,0,0,1,2
5771804,5771836,32,1,0,0,2
5771804,5771850,46,1,0,0,1
5771837,5773813,1976,0,0,1,2
5771851,5773814,1963,0,0,1,1
5773814,5773964,150,1,0,0,2
5773815,5773964,149,1,0,0,1
5773847,5773912,65,0,1,0,2
5773849,5773918,69,0,1,0,1
5773965,5775451,1486,0,0,1,1
5773965,5775451,1486,0,0,1,2
5775452,5775525,73,1,0,0,2
5775452,5775526,74,1,0,0,1
5775526,5775656,130,0,0,1,2
5775527,5775657,130,0,0,1,1
5775657,5775728,71,1,0,0,2
5775658,5775734,76,1,0,0,1
5775729,5775840,111,0,0,1,2
5775735,5775841,106,0,0,1,1
5775841,5775872,31,1,0,0,2
5775842,5775879,37,1,0,0,1
5775873,5777022,1149,0,0,1,2
5775880,5777021,1141,0,0,1,1
5777022,5777085,63,1,0,0,1
5777023,5777078,55,1,0,0,2
5777079,5779196,2117,0,0,1,2
5777086,5779184,2098,0,0,1,1
5779185,5779425,240,1,0,0,1
5779197,5779414,217,1,0,0,2
5779235,5779380,145,0,1,0,1
5779239,5779341,102,0,1,0,2
5779415,5780007,592,0,0,1,2
5779426,5780007,581,0,0,1,1
5780008,5780062,54,1,0,0,2
5780008,5780063,55,1,0,0,1
5780063,5780453,390,0,0,1,2
5780064,5780452,388,0,0,1,1
5780453,5780528,75,1,0,0,1
5780454,5780536,82,1,0,0,2
5780529,5782309,1780,0,0,1,1
5780537,5782308,1771,0,0,1,2
5782309,5782370,61,1,0,0,2
5782310,5782362,52,1,0,0,1
5782363,5783285,922,0,0,1,1
5782371,5783280,909,0,0,1,2
5783281,5783296,15,1,0,0,2
5783286,5783295,9,1,0,0,1
5783296,5784394,1098,0,0,1,1
5783297,5784394,1097,0,0,1,2
5784395,5784820,425,1,0,0,2
5784395,5784835,440,1,0,0,1
5784439,5784810,371,0,1,0,2
5784439,5784824,385,0,1,0,1
5784821,5785073,252,0,0,1,2
5784836,5785073,237,0,0,1,1
5785074,5785225,151,1,0,0,2
5785074,5785255,181,1,0,0,1
5785090,5785214,124,0,1,0,1
5785098,5785193,95,0,1,0,2
5785226,5785504,278,0,0,1,2
5785256,5785501,245,0,0,1,1
5785502,5785665,163,1,0,0,1
5785505,5785638,133,1,0,0,2
5785524,5785638,114,0,1,0,1
5785546,5785601,55,0,1,0,2
5785639,5785893,254,0,0,1,2
5785666,5785891,225,0,0,1,1
5785892,5785985,93,1,0,0,1
5785894,5785982,88,1,0,0,2
5785983,5786285,302,0,0,1,2
5785986,5786284,298,0,0,1,1
5786285,5786362,77,1,0,0,1
5786286,5786361,75,1,0,0,2
5786362,5786431,69,0,0,1,2
5786363,5786431,68,0,0,1,1
5786432,5786477,45,1,0,0,1
5786432,5786479,47,1,0,0,2
5786478,5786597,119,0,0,1,1
5786480,5786595,115,0,0,1,2
5786596,5786635,39,1,0,0,2
5786598,5786632,34,1,0,0,1
5786633,5788052,1419,0,0,1,1
5786636,5788053,1417,0,0,1,2
5788053,5788103,50,1,0,0,1
5788054,5788104,50,1,0,0,2
5788104,5788240,136,0,0,1,1
5788105,5788240,135,0,0,1,2
5788241,5788271,30,1,0,0,2
5788241,5788275,34,1,0,0,1
5788272,5790300,2028,0,0,1,2
5788276,5790304,2028,0,0,1,1
5790301,5790530,229,1,0,0,2
5790305,5790602,297,1,0,0,1
5790323,5790521,198,0,1,0,1
5790324,5790459,135,0,1,0,2
5790531,5790972,441,0,0,1,2
5790603,5790973,370,0,0,1,1
5790973,5791018,45,1,0,0,2
5790974,5791018,44,1,0,0,1
5791019,5791820,801,0,0,1,1
5791019,5791820,801,0,0,1,2
5791821,5791872,51,1,0,0,1
5791821,5791881,60,1,0,0,2
5791873,5792044,171,0,0,1,1
5791882,5792047,165,0,0,1,2
5792045,5792072,27,1,0,0,1
5792048,5792069,21,1,0,0,2
5792070,5793118,1048,0,0,1,2
5792073,5793118,1045,0,0,1,1
5793119,5793170,51,1,0,0,1
5793119,5793170,51,1,0,0,2
5793171,5795382,2211,0,0,1,1
5793171,5795382,2211,0,0,1,2
5795383,5795553,170,1,0,0,2
5795383,5795592,209,1,0,0,1
5795412,5795518,106,0,1,0,1
5795417,5795493,76,0,1,0,2
5795554,5795742,188,0,0,1,2
5795593,5795683,90,0,0,1,1
5795684,5795710,26,1,0,0,1
5795711,5795742,31,0,0,1,1
5795743,5795805,62,1,0,0,2
5795743,5795816,73,1,0,0,1
5795806,5796393,587,0,0,1,2
5795817,5796394,577,0,0,1,1
5796394,5796471,77,1,0,0,2
5796395,5796497,102,1,0,0,1
5796472,5796580,108,0,0,1,2
5796498,5796583,85,0,0,1,1
5796581,5796622,41,1,0,0,2
5796584,5796699,115,1,0,0,1
5796623,5798236,1613,0,0,1,2
5796700,5798235,1535,0,0,1,1
5798236,5798309,73,1,0,0,1
5798237,5798303,66,1,0,0,2
5798304,5800385,2081,0,0,1,2
5798310,5800386,2076,0,0,1,1
5800386,5800558,172,1,0,0,2
5800387,5800587,200,1,0,0,1
5800417,5800534,117,0,1,0,1
5800418,5800516,98,0,1,0,2
5800559,5800852,293,0,0,1,2
5800588,5800852,264,0,0,1,1
5800853,5800921,68,1,0,0,2
5800853,5800929,76,1,0,0,1
5800922,5801340,418,0,0,1,2
5800930,5801339,409,0,0,1,1
5801340,5801412,72,1,0,0,1
5801341,5801402,61,1,0,0,2
5801403,5801729,326,0,0,1,2
5801413,5801729,316,0,0,1,1
5801730,5801792,62,1,0,0,2
5801730,5801793,63,1,0,0,1
5801793,5802011,218,0,0,1,2
5801794,5802010,216,0,0,1,1
5802011,5802105,94,1,0,0,1
5802012,5802085,73,1,0,0,2
5802086,5802187,101,0,0,1,2
5802106,5802186,80,0,0,1,1
5802187,5802242,55,1,0,0,1
5802188,5802232,44,1,0,0,2
5802233,5803681,1448,0,0,1,2
5802243,5803681,1438,0,0,1,1
5803682,5803730,48,1,0,0,2
5803682,5803735,53,1,0,0,1
5803731,5805928,2197,0,0,1,2
5803736,5805919,2183,0,0,1,1
5805920,5806129,209,1,0,0,1
5805929,5806103,174,1,0,0,2
5805958,5806048,90,0,1,0,2
5805961,5806051,90,0,1,0,1
5806104,5806483,379,0,0,1,2
5806130,5806483,353,0,0,1,1
5806484,5806540,56,1,0,0,2
5806484,5806541,57,1,0,0,1
5806541,5807499,958,0,0,1,2
5806542,5807501,959,0,0,1,1
5807500,5807548,48,1,0,0,2
5807502,5807559,57,1,0,0,1
5807549,5807698,149,0,0,1,2
5807560,5807693,133,0,0,1,1
5807694,5807717,23,1,0,0,1
5807699,5807725,26,1,0,0,2
5807718,5809318,1600,0,0,1,1
5807726,5809317,1591,0,0,1,2
5809318,5809383,65,1,0,0,2
5809319,5809383,64,1,0,0,1
5809384,5809490,106,0,0,1,1
5809384,5809491,107,0,0,1,2
5809491,5809528,37,1,0,0,1
5809492,5809535,43,1,0,0,2
5809529,5809625,96,0,0,1,1
5809536,5809625,89,0,0,1,2
5809626,5809656,30,1,0,0,2
5809626,5809658,32,1,0,0,1
5809657,5809967,310,0,0,1,2
5809659,5809967,308,0,0,1,1
5809968,5809972,4,1,0,0,1
5809968,5809982,14,1,0,0,2
5809973,5811431,1458,0,0,1,1
5809983,5811425,1442,0,0,1,2
5811426,5811597,171,1,0,0,2
5811432,5811609,177,1,0,0,1
5811448,5811581,133,0,1,0,1
5811451,5811555,104,0,1,0,2
5811598,5811848,250,0,0,1,2
5811610,5811848,238,0,0,1,1
5811849,5811900,51,1,0,0,2
5811849,5811902,53,1,0,0,1
5811901,5812238,337,0,0,1,2
5811903,5812237,334,0,0,1,1
5812238,5812277,39,1,0,0,1
5812239,5812276,37,1,0,0,2
5812277,5813231,954,0,0,1,2
5812278,5813232,954,0,0,1,1
5813232,5813269,37,1,0,0,2
5813233,5813271,38,1,0,0,1
5813270,5813417,147,0,0,1,2
5813272,5813430,158,0,0,1,1
5813418,5813433,15,1,0,0,2
5813431,5813458,27,1,0,0,1
5813434,5814765,1331,0,0,1,2
5813459,5814767,1308,0,0,1,1
5814766,5814837,71,1,0,0,2
5814768,5814867,99,1,0,0,1
5814838,5814981,143,0,0,1,2
5814868,5814982,114,0,0,1,1
5814982,5815023,41,1,0,0,2
5814983,5815017,34,1,0,0,1
5815018,5816909,1891,0,0,1,1
5815024,5816898,1874,0,0,1,2
5816899,5817207,308,1,0,0,2
5816910,5817276,366,1,0,0,1
5816939,5817196,257,0,1,0,1
5816941,5817151,210,0,1,0,2
5817208,5817569,361,0,0,1,2
5817277,5817568,291,0,0,1,1
5817569,5817602,33,1,0,0,1
5817570,5817600,30,1,0,0,2
5817601,5817822,221,0,0,1,2
5817603,5817822,219,0,0,1,1
5817823,5817884,61,1,0,0,2
5817823,5817891,68,1,0,0,1
5817885,5818550,665,0,0,1,2
5817892,5818549,657,0,0,1,1
5818550,5818626,76,1,0,0,1
5818551,5818620,69,1,0,0,2
5818621,5818738,117,0,0,1,2
5818627,5818737,110,0,0,1,1
5818738,5818770,32,1,0,0,1
5818739,5818767,28,1,0,0,2
5818768,5820196,1428,0,0,1,2
5818771,5820198,1427,0,0,1,1
5820197,5820259,62,1,0,0,2
5820199,5820270,71,1,0,0,1
5820260,5822407,2147,0,0,1,2
5820271,5822406,2135,0,0,1,1
5822407,5822590,183,1,0,0,1
5822408,5822576,168,1,0,0,2
5822443,5822528,85,0,1,0,2
5822445,5822546,101,0,1,0,1
5822577,5822830,253,0,0,1,2
5822591,5822830,239,0,0,1,1
5822831,5822885,54,1,0,0,2
5822831,5822887,56,1,0,0,1
5822886,5823270,384,0,0,1,2
5822888,5823269,381,0,0,1,1
5823270,5823323,53,1,0,0,1
5823271,5823325,54,1,0,0,2
5823324,5823981,657,0,0,1,1
5823326,5823981,655,0,0,1,2
5823982,5824035,53,1,0,0,1
5823982,5824038,56,1,0,0,2
5824036,5824213,177,0,0,1,1
5824039,5824217,178,0,0,1,2
5824214,5824238,24,1,0,0,1
5824218,5824243,25,1,0,0,2
5824239,5825706,1467,0,0,1,1
5824244,5825707,1463,0,0,1,2
5825707,5825774,67,1,0,0,1
5825708,5825777,69,1,0,0,2
5825775,5825877,102,0,0,1,1
5825778,5825877,99,0,0,1,2
5825878,5825910,32,1,0,0,1
5825878,5825911,33,1,0,0,2
5825911,5827828,1917,0,0,1,1
5825912,5827827,1915,0,0,1,2
5827828,5827883,55,1,0,0,2
5827829,5827900,71,1,0,0,1
5827884,5828022,138,0,0,1,2
5827901,5828024,123,0,0,1,1
5828023,5828176,153,1,0,0,2
5828025,5828205,180,1,0,0,1
5828054,5828160,106,0,1,0,1
5828060,5828122,62,0,1,0,2
5828177,5828660,483,0,0,1,2
5828206,5828659,453,0,0,1,1
5828660,5828688,28,1,0,0,1
5828661,5828693,32,1,0,0,2
5828689,5829652,963,0,0,1,1
5828694,5829653,959,0,0,1,2
5829653,5829746,93,1,0,0,1
5829654,5829725,71,1,0,0,2
5829726,5829901,175,0,0,1,2
5829747,5829772,25,0,0,1,1
5829773,5829811,38,1,0,0,1
5829812,5829899,87,0,0,1,1
5829900,5829998,98,1,0,0,1
5829902,5829933,31,1,0,0,2
5829934,5830842,908,0,0,1,2
5829999,5830194,195,0,0,1,1
5830195,5830235,40,1,0,0,1
5830236,5830455,219,0,0,1,1
5830456,5830460,4,1,0,0,1
5830461,5830840,379,0,0,1,1
5830841,5830908,67,1,0,0,1
5830843,5830896,53,1,0,0,2
5830897,5833026,2129,0,0,1,2
5830909,5833035,2126,0,0,1,1
5833027,5833188,161,1,0,0,2
5833036,5833205,169,1,0,0,1
5833061,5833146,85,0,1,0,1
5833067,5833127,60,0,1,0,2
5833189,5833690,501,0,0,1,2
5833206,5833692,486,0,0,1,1
5833691,5833714,23,1,0,0,2
5833693,5833739,46,1,0,0,1
5833715,5834250,535,0,0,1,2
5833740,5834250,510,0,0,1,1
5834251,5834318,67,1,0,0,2
5834251,5834320,69,1,0,0,1
5834319,5834362,43,0,0,1,2
5834321,5834362,41,0,0,1,1
5834363,5834400,37,1,0,0,2
5834363,5834409,46,1,0,0,1
5834401,5834499,98,0,0,1,2
5834410,5834498,88,0,0,1,1
5834499,5834534,35,1,0,0,1
5834500,5834534,34,1,0,0,2
5834535,5835473,938,0,0,1,1
5834535,5835474,939,0,0,1,2
5835474,5835533,59,1,0,0,1
5835475,5835534,59,1,0,0,2
5835534,5835796,262,0,0,1,1
5835535,5835797,262,0,0,1,2
5835797,5835828,31,1,0,0,1
5835798,5835832,34,1,0,0,2
5835829,5837668,1839,0,0,1,1
5835833,5837666,1833,0,0,1,2
5837667,5837857,190,1,0,0,2
5837669,5837896,227,1,0,0,1
5837706,5837831,125,0,1,0,1
5837713,5837796,83,0,1,0,2
5837858,5838336,478,0,0,1,2
5837897,5838337,440,0,0,1,1
5838337,5838395,58,1,0,0,2
5838338,5838400,62,1,0,0,1
5838396,5838779,383,0,0,1,2
5838401,5838778,377,0,0,1,1
5838779,5838853,74,1,0,0,1
5838780,5838850,70,1,0,0,2
5838851,5838955,104,0,0,1,2
5838854,5838954,100,0,0,1,1
5838955,5838997,42,1,0,0,1
5838956,5838988,32,1,0,0,2
5838989,5840059,1070,0,0,1,2
5838998,5839117,119,0,0,1,1
5839118,5839154,36,1,0,0,1
5839155,5840058,903,0,0,1,1
5840059,5840133,74,1,0,0,1
5840060,5840129,69,1,0,0,2
5840130,5842176,2046,0,0,1,2
5840134,5842164,2030,0,0,1,1
5842165,5842388,223,1,0,0,1
5842177,5842370,193,1,0,0,2
5842209,5842332,123,0,1,0,1
5842214,5842296,82,0,1,0,2
5842371,5842696,325,0,0,1,2
5842389,5842697,308,0,0,1,1
5842697,5842751,54,1,0,0,2
5842698,5842750,52,1,0,0,1
5842751,5843331,580,0,0,1,1
5842752,5843329,577,0,0,1,2
5843330,5843393,63,1,0,0,2
5843332,5843394,62,1,0,0,1
5843394,5843501,107,0,0,1,2
5843395,5843501,106,0,0,1,1
5843502,5843541,39,1,0,0,1
5843502,5843544,42,1,0,0,2
5843542,5844705,1163,0,0,1,1
5843545,5844703,1158,0,0,1,2
5844704,5844774,70,1,0,0,2
5844706,5844770,64,1,0,0,1
5844771,5844892,121,0,0,1,1
5844775,5844890,115,0,0,1,2
5844891,5844914,23,1,0,0,2
5844893,5844925,32,1,0,0,1
5844915,5845298,383,0,0,1,2
5844926,5845300,374,0,0,1,1
5845299,5845320,21,1,0,0,2
5845301,5845319,18,1,0,0,1
5845320,5846977,1657,0,0,1,1
5845321,5846973,1652,0,0,1,2
5846974,5847150,176,1,0,0,2
5846978,5847182,204,1,0,0,1
5846997,5847137,140,0,1,0,1
5846999,5847097,98,0,1,0,2
5847151,5847504,353,0,0,1,2
5847183,5847504,321,0,0,1,1
5847505,5847566,61,1,0,0,2
5847505,5847571,66,1,0,0,1
5847567,5848246,679,0,0,1,2
5847572,5848245,673,0,0,1,1
5848246,5848303,57,1,0,0,1
5848247,5848295,48,1,0,0,2
5848296,5848514,218,0,0,1,2
5848304,5849556,1252,0,0,1,1
5848515,5848531,16,1,0,0,2
5848532,5849556,1024,0,0,1,2
5849557,5849610,53,1,0,0,2
5849557,5849620,63,1,0,0,1
5849611,5851683,2072,0,0,1,2
5849621,5851660,2039,0,0,1,1
5851661,5852070,409,1,0,0,1
5851684,5852002,318,1,0,0,2
5851722,5851996,274,0,1,0,1
5851729,5851941,212,0,1,0,2
5852003,5853097,1094,0,0,1,2
5852071,5853098,1027,0,0,1,1
5853098,5853162,64,1,0,0,2
5853099,5853160,61,1,0,0,1
5853161,5853297,136,0,0,1,1
5853163,5853294,131,0,0,1,2
5853295,5853311,16,1,0,0,2
5853298,5853311,13,1,0,0,1
5853312,5854546,1234,0,0,1,2
5853312,5854547,1235,0,0,1,1
5854547,5854590,43,1,0,0,2
5854548,5854590,42,1,0,0,1
5854591,5854893,302,0,0,1,1
5854591,5854894,303,0,0,1,2
5854894,5854966,72,1,0,0,1
5854895,5854951,56,1,0,0,2
5854952,5857123,2171,0,0,1,2
5854967,5857126,2159,0,0,1,1
5857124,5857336,212,1,0,0,2
5857127,5857337,210,1,0,0,1
5857157,5857298,141,0,1,0,2
5857159,5857299,140,0,1,0,1
5857337,5857714,377,0,0,1,2
5857338,5857714,376,0,0,1,1
5857715,5857739,24,1,0,0,2
5857715,5857746,31,1,0,0,1
5857740,5858960,1220,0,0,1,2
5857747,5858960,1213,0,0,1,1
5858961,5859024,63,1,0,0,1
5858961,5859032,71,1,0,0,2
5859025,5859146,121,0,0,1,1
5859033,5859143,110,0,0,1,2
5859144,5859177,33,1,0,0,2
5859147,5859178,31,1,0,0,1
5859178,5859387,209,0,0,1,2
5859179,5860275,1096,0,0,1,1
5859388,5859400,12,1,0,0,2
5859401,5860276,875,0,0,1,2
5860276,5860328,52,1,0,0,1
5860277,5860336,59,1,0,0,2
5860329,5862416,2087,0,0,1,1
5860337,5862409,2072,0,0,1,2
5862410,5862605,195,1,0,0,2
5862417,5862620,203,1,0,0,1
5862444,5862531,87,0,1,0,2
5862451,5862553,102,0,1,0,1
5862606,5863534,928,0,0,1,2
5862621,5863535,914,0,0,1,1
5863535,5863598,63,1,0,0,2
5863536,5863614,78,1,0,0,1
5863599,5863727,128,0,0,1,2
5863615,5863728,113,0,0,1,1
5863728,5863762,34,1,0,0,2
5863729,5863762,33,1,0,0,1
5863763,5864076,313,0,0,1,1
5863763,5864076,313,0,0,1,2
5864077,5864093,16,1,0,0,1
5864077,5864095,18,1,0,0,2
5864094,5864829,735,0,0,1,1
5864096,5864830,734,0,0,1,2
5864830,5864884,54,1,0,0,1
5864831,5864877,46,1,0,0,2
5864878,5865000,122,0,0,1,2
5864885,5865001,116,0,0,1,1
5865001,5865033,32,1,0,0,2
5865002,5865031,29,1,0,0,1
5865032,5867078,2046,0,0,1,1
5865034,5867077,2043,0,0,1,2
5867078,5867218,140,1,0,0,2
5867079,5867258,179,1,0,0,1
5867105,5867201,96,0,1,0,1
5867111,5867167,56,0,1,0,2
5867219,5867335,116,0,0,1,2
5867259,5867334,75,0,0,1,1
5867335,5867494,159,1,0,0,1
5867336,5867481,145,1,0,0,2
5867363,5867438,75,0,1,0,2
5867364,5867451,87,0,1,0,1
5867482,5868094,612,0,0,1,2
5867495,5868095,600,0,0,1,1
5868095,5868143,48,1,0,0,2
5868096,5868143,47,1,0,0,1
5868144,5869630,1486,0,0,1,1
5868144,5869631,1487,0,0,1,2
5869631,5869695,64,1,0,0,1
5869632,5869694,62,1,0,0,2
5869695,5871811,2116,0,0,1,2
5869696,5871822,2126,0,0,1,1
5871812,5871997,185,1,0,0,2
5871823,5872010,187,1,0,0,1
5871835,5871950,115,0,1,0,2
5871842,5871967,125,0,1,0,1
5871998,5873190,1192,0,0,1,2
5872011,5873190,1179,0,0,1,1
5873191,5873256,65,1,0,0,1
5873191,5873262,71,1,0,0,2
5873257,5873386,129,0,0,1,1
5873263,5873386,123,0,0,1,2
5873387,5873420,33,1,0,0,2
5873387,5873422,35,1,0,0,1
5873421,5874866,1445,0,0,1,2
5873423,5874868,1445,0,0,1,1
5874867,5874919,52,1,0,0,2
5874869,5874929,60,1,0,0,1
5874920,5876958,2038,0,0,1,2
5874930,5876962,2032,0,0,1,1
5876959,5877142,183,1,0,0,2
5876963,5877131,168,1,0,0,1
5876994,5877081,87,0,1,0,1
5876996,5877064,68,0,1,0,2
5877132,5877729,597,0,0,1,1
5877143,5877728,585,0,0,1,2
5877729,5877753,24,1,0,0,2
5877730,5877761,31,1,0,0,1
5877754,5878300,546,0,0,1,2
5877762,5878299,537,0,0,1,1
5878300,5878386,86,1,0,0,1
5878301,5878384,83,1,0,0,2
5878385,5878504,119,0,0,1,2
5878387,5878504,117,0,0,1,1
5878505,5878540,35,1,0,0,1
5878505,5878542,37,1,0,0,2
5878541,5880075,1534,0,0,1,1
5878543,5880076,1533,0,0,1,2
5880076,5880146,70,1,0,0,1
5880077,5880145,68,1,0,0,2
5880146,5880283,137,0,0,1,2
5880147,5880283,136,0,0,1,1
5880284,5880317,33,1,0,0,1
5880284,5880318,34,1,0,0,2
5880318,5882247,1929,0,0,1,1
5880319,5882245,1926,0,0,1,2
5882246,5882406,160,1,0,0,2
5882248,5882406,158,1,0,0,1
5882278,5882353,75,0,1,0,2
5882281,5882362,81,0,1,0,1
5882407,5883105,698,0,0,1,1
5882407,5883106,699,0,0,1,2
5883106,5883164,58,1,0,0,1
5883107,5883164,57,1,0,0,2
5883165,5883735,570,0,0,1,1
5883165,5883735,570,0,0,1,2
5883736,5883796,60,1,0,0,2
5883736,5883797,61,1,0,0,1
5883797,5883951,154,0,0,1,2
5883798,5883945,147,0,0,1,1
5883946,5883968,22,1,0,0,1
5883952,5883968,16,1,0,0,2
5883969,5885320,1351,0,0,1,2
5883969,5885321,1352,0,0,1,1
5885321,5885376,55,1,0,0,2
5885322,5885378,56,1,0,0,1
5885377,5885617,240,0,0,1,2
5885379,5885615,236,0,0,1,1
5885616,5885637,21,1,0,0,1
5885618,5885639,21,1,0,0,2
5885638,5887499,1861,0,0,1,1
5885640,5887495,1855,0,0,1,2
5887496,5887688,192,1,0,0,2
5887500,5887725,225,1,0,0,1
5887519,5887682,163,0,1,0,1
5887522,5887642,120,0,1,0,2
5887689,5888726,1037,0,0,1,2
5887726,5888727,1001,0,0,1,1
5888727,5888807,80,1,0,0,2
5888728,5888809,81,1,0,0,1
5888808,5888954,146,0,0,1,2
5888810,5888952,142,0,0,1,1
5888953,5888998,45,1,0,0,1
5888955,5888997,42,1,0,0,2
5888998,5890016,1018,0,0,1,2
5888999,5890016,1017,0,0,1,1
5890017,5890077,60,1,0,0,2
5890017,5890087,70,1,0,0,1
5890078,5892143,2065,0,0,1,2
5890088,5892137,2049,0,0,1,1
5892138,5892462,324,1,0,0,1
5892144,5892433,289,1,0,0,2
5892187,5892410,223,0,1,0,1
5892188,5892384,196,0,1,0,2
5892434,5892804,370,0,0,1,2
5892463,5892804,341,0,0,1,1
5892805,5892864,59,1,0,0,1
5892805,5892865,60,1,0,0,2
5892865,5893423,558,0,0,1,1
5892866,5893423,557,0,0,1,2
5893424,5893496,72,1,0,0,2
5893424,5893502,78,1,0,0,1
5893497,5893643,146,0,0,1,2
5893503,5893639,136,0,0,1,1
5893640,5893676,36,1,0,0,1
5893644,5893673,29,1,0,0,2
5893674,5894902,1228,0,0,1,2
5893677,5894903,1226,0,0,1,1
5894903,5894960,57,1,0,0,2
5894904,5894956,52,1,0,0,1
5894957,5895374,417,0,0,1,1
5894961,5895374,413,0,0,1,2
5895375,5895412,37,1,0,0,2
5895375,5895423,48,1,0,0,1
5895413,5897022,1609,0,0,1,2
5895424,5897036,1612,0,0,1,1
5897023,5897243,220,1,0,0,2
5897037,5897231,194,1,0,0,1
5897067,5897149,82,0,1,0,2
5897067,5897173,106,0,1,0,1
5897232,5897785,553,0,0,1,1
5897244,5897785,541,0,0,1,2
5897786,5897842,56,1,0,0,2
5897786,5897851,65,1,0,0,1
5897843,5898414,571,0,0,1,2
5897852,5898414,562,0,0,1,1
5898415,5898477,62,1,0,0,1
5898415,5898481,66,1,0,0,2
5898478,5898622,144,0,0,1,1
5898482,5898621,139,0,0,1,2
5898622,5898660,38,1,0,0,2
5898623,5898658,35,1,0,0,1
5898659,5899165,506,0,0,1,1
5898661,5899168,507,0,0,1,2
5899166,5899348,182,1,0,0,1
5899169,5899316,147,1,0,0,2
5899189,5899309,120,0,1,0,1
5899196,5899267,71,0,1,0,2
5899317,5899488,171,0,0,1,2
5899349,5899488,139,0,0,1,1
5949474,5949712,238,0,0,1,2
5949474,5949713,239,0,0,1,1
5949713,5949781,68,1,0,0,2
5949714,5949782,68,1,0,0,1
5949782,5949886,104,0,0,1,2
5949783,5949888,105,0,0,1,1
5949887,5949919,32,1,0,0,2
5949889,5949918,29,1,0,0,1
5949919,5951886,1967,0,0,1,1
5949920,5951887,1967,0,0,1,2
5951887,5952093,206,1,0,0,1
5951888,5951966,78,1,0,0,2
5951967,5952035,68,0,0,1,2
5952036,5952076,40,1,0,0,2
5952077,5952144,67,0,0,1,2
5952094,5952144,50,0,0,1,1
5952145,5952179,34,1,0,0,2
5952145,5952199,54,1,0,0,1
5952180,5952309,129,0,0,1,2
5952200,5952308,108,0,0,1,1
5952309,5952344,35,1,0,0,1
5952310,5952343,33,1,0,0,2
5952344,5953747,1403,0,0,1,2
5952345,5953628,1283,0,0,1,1
5953629,5953637,8,1,0,0,1
5953638,5953747,109,0,0,1,1
5953748,5953864,116,1,0,0,1
5953748,5953875,127,1,0,0,2
5953865,5953942,77,0,0,1,1
5953876,5953942,66,0,0,1,2
5953943,5953978,35,1,0,0,1
5953943,5953979,36,1,0,0,2
5953979,5954031,52,0,0,1,1
5953980,5954030,50,0,0,1,2
5954031,5954075,44,1,0,0,2
5954032,5954065,33,1,0,0,1
5954066,5955535,1469,0,0,1,1
5954076,5955537,1461,0,0,1,2
5955536,5955656,120,1,0,0,1
5955538,5955620,82,1,0,0,2
5955621,5955694,73,0,0,1,2
5955657,5955692,35,0,0,1,1
5955693,5955732,39,1,0,0,1
5955695,5955731,36,1,0,0,2
5955732,5955885,153,0,0,1,2
5955733,5955879,146,0,0,1,1
5955880,5955912,32,1,0,0,1
5955886,5955900,14,1,0,0,2
5955901,5957321,1420,0,0,1,2
5955913,5957322,1409,0,0,1,1
5957322,5957395,73,1,0,0,2
5957323,5957389,66,1,0,0,1
5957390,5957465,75,0,0,1,1
5957396,5957464,68,0,0,1,2
5957465,5957501,36,1,0,0,2
5957466,5957507,41,1,0,0,1
5957502,5958595,1093,0,0,1,2
5957508,5957879,371,0,0,1,1
5957880,5957934,54,1,0,0,1
5957935,5958088,153,0,0,1,1
5958089,5958093,4,1,0,0,1
5958094,5958588,494,0,0,1,1
5958589,5958608,19,1,0,0,1
5958596,5958607,11,1,0,0,2
5958608,5958979,371,0,0,1,2
5958609,5958979,370,0,0,1,1
5958980,5959049,69,1,0,0,2
5958980,5959057,77,1,0,0,1
5959050,5960485,1435,0,0,1,2
5959058,5959476,418,0,0,1,1
5959477,5959481,4,1,0,0,1
5959482,5960485,1003,0,0,1,1
5960486,5960545,59,1,0,0,1
5960486,5960558,72,1,0,0,2
5960546,5960694,148,0,0,1,1
5960559,5960689,130,0,0,1,2
5960690,5960718,28,1,0,0,2
5960695,5960707,12,1,0,0,1
5960708,5962172,1464,0,0,1,1
5960719,5962170,1451,0,0,1,2
5962171,5962287,116,1,0,0,2
5962173,5962314,141,1,0,0,1
5962288,5962338,50,0,0,1,2
5962315,5962338,23,0,0,1,1
5962339,5962400,61,1,0,0,1
5962339,5962400,61,1,0,0,2
5962401,5962534,133,0,0,1,1
5962401,5962535,134,0,0,1,2
5962535,5962555,20,1,0,0,1
5962536,5962566,30,1,0,0,2
5962556,5963955,1399,0,0,1,1
5962567,5963956,1389,0,0,1,2
5963956,5964059,103,1,0,0,1
5963957,5964039,82,1,0,0,2
5964040,5964138,98,0,0,1,2
5964060,5964140,80,0,0,1,1
5964139,5964183,44,1,0,0,2
5964141,5964180,39,1,0,0,1
5964181,5965566,1385,0,0,1,1
5964184,5965567,1383,0,0,1,2
5965567,5965636,69,1,0,0,1
5965568,5965636,68,1,0,0,2
5965637,5965770,133,0,0,1,1
5965637,5965775,138,0,0,1,2
5965771,5965806,35,1,0,0,1
5965776,5965789,13,1,0,0,2
5965790,5967133,1343,0,0,1,2
5965807,5967132,1325,0,0,1,1
5967133,5967224,91,1,0,0,1
5967134,5967205,71,1,0,0,2
5967206,5967277,71,0,0,1,2
5967225,5967277,52,0,0,1,1
5967278,5967314,36,1,0,0,2
5967278,5967368,90,1,0,0,1
5967315,5967411,96,0,0,1,2
5967369,5967401,32,0,0,1,1
5967402,5967457,55,1,0,0,1
5967412,5967456,44,1,0,0,2
5967457,5967635,178,0,0,1,2
5967458,5967633,175,0,0,1,1
5967634,5967671,37,1,0,0,1
5967636,5967669,33,1,0,0,2
5967670,5968692,1022,0,0,1,2
5967672,5968693,1021,0,0,1,1
5968693,5968862,169,1,0,0,2
5968694,5968856,162,1,0,0,1
5968857,5968918,61,0,0,1,1
5968863,5968917,54,0,0,1,2
5968918,5968970,52,1,0,0,2
5968919,5968998,79,1,0,0,1
5968971,5970382,1411,0,0,1,2
5968999,5970381,1382,0,0,1,1
5970382,5970476,94,1,0,0,1
5970383,5970478,95,1,0,0,2
5970477,5970560,83,0,0,1,1
5970479,5970559,80,0,0,1,2
5970560,5970599,39,1,0,0,2
5970561,5970606,45,1,0,0,1
5970600,5971903,1303,0,0,1,2
5970607,5971904,1297,0,0,1,1
5971904,5971955,51,1,0,0,2
5971905,5971956,51,1,0,0,1
5971956,5972046,90,0,0,1,2
5971957,5972046,89,0,0,1,1
5972047,5972081,34,1,0,0,2
5972047,5972082,35,1,0,0,1
5972082,5973487,1405,0,0,1,2
5972083,5973487,1404,0,0,1,1
5973488,5973540,52,1,0,0,2
5973488,5973550,62,1,0,0,1
5973541,5973744,203,0,0,1,2
5973551,5974979,1428,0,0,1,1
5973745,5973751,6,1,0,0,2
5973752,5974979,1227,0,0,1,2
5974980,5975061,81,1,0,0,2
5974980,5975072,92,1,0,0,1
5975062,5975170,108,0,0,1,2
5975073,5975172,99,0,0,1,1
5975171,5975204,33,1,0,0,2
5975173,5975214,41,1,0,0,1
5975205,5976480,1275,0,0,1,2
5975215,5976481,1266,0,0,1,1
5976481,5976558,77,1,0,0,2
5976482,5976552,70,1,0,0,1
5976553,5976653,100,0,0,1,1
5976559,5976653,94,0,0,1,2
5976654,5976687,33,1,0,0,1
5976654,5976689,35,1,0,0,2
5976688,5978021,1333,0,0,1,1
5976690,5978020,1330,0,0,1,2
5978021,5978103,82,1,0,0,2
5978022,5978102,80,1,0,0,1
5978103,5978225,122,0,0,1,1
5978104,5978225,121,0,0,1,2
5978226,5978249,23,1,0,0,1
5978226,5978259,33,1,0,0,2
5978250,5979471,1221,0,0,1,1
5978260,5979471,1211,0,0,1,2
5979472,5979541,69,1,0,0,2
5979472,5979547,75,1,0,0,1
5979542,5979650,108,0,0,1,2
5979548,5979651,103,0,0,1,1
5979651,5979686,35,1,0,0,2
5979652,5979685,33,1,0,0,1
5979686,5980704,1018,0,0,1,1
5979687,5980724,1037,0,0,1,2
5980705,5980895,190,1,0,0,1
5980725,5980828,103,1,0,0,2
5980726,5980839,113,0,1,0,1
5980829,5981039,210,0,0,1,2
5980896,5981040,144,0,0,1,1
5981040,5981110,70,1,0,0,2
5981041,5981112,71,1,0,0,1
5981111,5982524,1413,0,0,1,2
5981113,5982525,1412,0,0,1,1
5982525,5982677,152,1,0,0,2
5982526,5982671,145,1,0,0,1
5982672,5982757,85,0,0,1,1
5982678,5982757,79,0,0,1,2
5982758,5982792,34,1,0,0,2
5982758,5982827,69,1,0,0,1
5982793,5984152,1359,0,0,1,2
5982828,5984152,1324,0,0,1,1
5984153,5984249,96,1,0,0,2
5984153,5984250,97,1,0,0,1
5984250,5984350,100,0,0,1,2
5984251,5984350,99,0,0,1,1
5984351,5984396,45,1,0,0,2
5984351,5984415,64,1,0,0,1
5984397,5985838,1441,0,0,1,2
5984416,5984491,75,0,0,1,1
5984492,5984507,15,1,0,0,1
5984508,5984600,92,0,0,1,1
5984601,5984712,111,1,0,0,1
5984713,5985200,487,0,0,1,1
5985201,5985222,21,1,0,0,1
5985223,5985421,198,0,0,1,1
5985422,5985527,105,1,0,0,1
5985528,5985668,140,0,0,1,1
5985669,5985719,50,1,0,0,1
5985720,5985839,119,0,0,1,1
5985839,5985983,144,1,0,0,2
5985840,5986000,160,1,0,0,1
5985984,5986085,101,0,0,1,2
5986001,5986080,79,0,0,1,1
5986081,5986117,36,1,0,0,1
5986086,5986127,41,1,0,0,2
5986118,5987696,1578,0,0,1,1
5986128,5987698,1570,0,0,1,2
5987697,5987831,134,1,0,0,1
5987699,5987843,144,1,0,0,2
5987832,5987875,43,0,0,1,1
5987844,5987875,31,0,0,1,2
5987876,5987911,35,1,0,0,2
5987876,5987919,43,1,0,0,1
5987912,5987987,75,0,0,1,2
5987920,5987991,71,0,0,1,1
5987988,5988027,39,1,0,0,2
5987992,5988033,41,1,0,0,1
5988028,5989772,1744,0,0,1,2
5988034,5988595,561,0,0,1,1
5988596,5988609,13,1,0,0,1
5988610,5989396,786,0,0,1,1
5989397,5989428,31,1,0,0,1
5989429,5989771,342,0,0,1,1
5989772,5989875,103,1,0,0,1
5989773,5989876,103,1,0,0,2
5989876,5989941,65,0,0,1,1
5989877,5989941,64,0,0,1,2
5989942,5989992,50,1,0,0,2
5989942,5990000,58,1,0,0,1
5989993,5990127,134,0,0,1,2
5990001,5990126,125,0,0,1,1
5990127,5990161,34,1,0,0,1
5990128,5990159,31,1,0,0,2
5990160,5992133,1973,0,0,1,2
5990162,5990322,160,0,0,1,1
5990323,5990333,10,1,0,0,1
5990334,5992135,1801,0,0,1,1
5992134,5992196,62,1,0,0,2
5992136,5992196,60,1,0,0,1
5992197,5994078,1881,0,0,1,2
5992197,5994079,1882,0,0,1,1
5994079,5994135,56,1,0,0,2
5994080,5994134,54,1,0,0,1
5994135,5994308,173,0,0,1,1
5994136,5994308,172,0,0,1,2
5994309,5994349,40,1,0,0,1
5994309,5994349,40,1,0,0,2
5994350,5996653,2303,0,0,1,1
5994350,5996654,2304,0,0,1,2
5996654,5996887,233,1,0,0,1
5996655,5996764,109,1,0,0,2
5996765,5996846,81,0,0,1,2
5996847,5996892,45,1,0,0,2
5996888,5997033,145,0,0,1,1
5996893,5997034,141,0,0,1,2
5997034,5997085,51,1,0,0,1
5997035,5997071,36,1,0,0,2
5997072,5997338,266,0,0,1,2
5997086,5998603,1517,0,0,1,1
5997339,5997344,5,1,0,0,2
5997345,5999162,1817,0,0,1,2
5998604,5998608,4,1,0,0,1
5998609,5999163,554,0,0,1,1
5999163,5999274,111,1,0,0,2
5999164,5999270,106,1,0,0,1
5999271,5999356,85,0,0,1,1
5999275,5999353,78,0,0,1,2
5999354,5999401,47,1,0,0,2
5999357,5999392,35,1,0,0,1
5999393,6001440,2047,0,0,1,1
5999402,6001441,2039,0,0,1,2
6001441,6001515,74,1,0,0,1
6001442,6001509,67,1,0,0,2
6001510,6001648,138,0,0,1,2
6001516,6001647,131,0,0,1,1
6001648,6001678,30,1,0,0,1
6001649,6001677,28,1,0,0,2
6001678,6003394,1716,0,0,1,2
6001679,6003395,1716,0,0,1,1
6003395,6003466,71,1,0,0,2
6003396,6003462,66,1,0,0,1
6003463,6003611,148,0,0,1,1
6003467,6003613,146,0,0,1,2
6003612,6003632,20,1,0,0,1
6003614,6003646,32,1,0,0,2
6003633,6005079,1446,0,0,1,1
6003647,6005079,1432,0,0,1,2
6005080,6005152,72,1,0,0,2
6005080,6005159,79,1,0,0,1
6005153,6005255,102,0,0,1,2
6005160,6005254,94,0,0,1,1
6005255,6005291,36,1,0,0,1
6005256,6005291,35,1,0,0,2
6005292,6005549,257,0,0,1,2
6005292,6005557,265,0,0,1,1
6005550,6005561,11,1,0,0,2
6005558,6005601,43,1,0,0,1
6005562,6006872,1310,0,0,1,2
6005602,6006865,1263,0,0,1,1
6006866,6006934,68,1,0,0,1
6006873,6006938,65,1,0,0,2
6006935,6007013,78,0,0,1,1
6006939,6007013,74,0,0,1,2
6007014,6007046,32,1,0,0,2
6007014,6007049,35,1,0,0,1
6007047,6008582,1535,0,0,1,2
6007050,6008580,1530,0,0,1,1
6008581,6008670,89,1,0,0,1
6008583,6008665,82,1,0,0,2
6008666,6008757,91,0,0,1,2
6008671,6008758,87,0,0,1,1
6008758,6008800,42,1,0,0,2
6008759,6008802,43,1,0,0,1
6008801,6010326,1525,0,0,1,2
6008803,6010325,1522,0,0,1,1
6010326,6010382,56,1,0,0,1
6010327,6010387,60,1,0,0,2
6010383,6012104,1721,0,0,1,1
6010388,6012104,1716,0,0,1,2
6012105,6012179,74,1,0,0,1
6012105,6012183,78,1,0,0,2
6012180,6012265,85,0,0,1,1
6012184,6012264,80,0,0,1,2
6012265,6012302,37,1,0,0,2
6012266,6012312,46,1,0,0,1
6012303,6013910,1607,0,0,1,2
6012313,6013910,1597,0,0,1,1
6013911,6014057,146,1,0,0,2
6013911,6014059,148,1,0,0,1
6014058,6014206,148,0,0,1,2
6014060,6014201,141,0,0,1,1
6014202,6014235,33,1,0,0,1
6014207,6014226,19,1,0,0,2
6014227,6015602,1375,0,0,1,2
6014236,6015602,1366,0,0,1,1
6015603,6015678,75,1,0,0,2
6015603,6015692,89,1,0,0,1
6015679,6015780,101,0,0,1,2
6015693,6015777,84,0,0,1,1
6015778,6015819,41,1,0,0,1
6015781,6015818,37,1,0,0,2
6015819,6017644,1825,0,0,1,2
6015820,6017644,1824,0,0,1,1
6017645,6017739,94,1,0,0,1
6017645,6017739,94,1,0,0,2
6017740,6017820,80,0,0,1,2
6017740,6017821,81,0,0,1,1
6017821,6017867,46,1,0,0,2
6017822,6017865,43,1,0,0,1
6017866,6019720,1854,0,0,1,1
6017868,6019721,1853,0,0,1,2
6019721,6019770,49,1,0,0,1
6019722,6019770,48,1,0,0,2
6019771,6021564,1793,0,0,1,1
6019771,6021564,1793,0,0,1,2
6021565,6021618,53,1,0,0,1
6021565,6021628,63,1,0,0,2
6021619,6021834,215,0,0,1,1
6021629,6021838,209,0,0,1,2
6021835,6021852,17,1,0,0,1
6021839,6021850,11,1,0,0,2
6021851,6023299,1448,0,0,1,2
6021853,6023300,1447,0,0,1,1
6023300,6023377,77,1,0,0,2
6023301,6023382,81,1,0,0,1
6023378,6023477,99,0,0,1,2
6023383,6023478,95,0,0,1,1
6023478,6023514,36,1,0,0,2
6023479,6023512,33,1,0,0,1
6023513,6025445,1932,0,0,1,1
6023515,6025886,2371,0,0,1,2
6025446,6025461,15,1,0,0,1
6025462,6025885,423,0,0,1,1
6025886,6025955,69,1,0,0,1
6025887,6025954,67,1,0,0,2
6025955,6026035,80,0,0,1,2
6025956,6026035,79,0,0,1,1
6026036,6026075,39,1,0,0,1
6026036,6026075,39,1,0,0,2
6026076,6026604,528,0,0,1,2
6026076,6026606,530,0,0,1,1
6026605,6026624,19,1,0,0,2
6026607,6026617,10,1,0,0,1
6026618,6027751,1133,0,0,1,1
6026625,6027751,1126,0,0,1,2
6027752,6027791,39,1,0,0,1
6027752,6027792,40,1,0,0,2
6027792,6028047,255,0,0,1,1
6027793,6028046,253,0,0,1,2
6028047,6028094,47,1,0,0,2
6028048,6028083,35,1,0,0,1
6028084,6028265,181,0,0,1,1
6028095,6028270,175,0,0,1,2
6028266,6028438,172,1,0,0,1
6028271,6028426,155,1,0,0,2
6028286,6028421,135,0,1,0,1
6028293,6028397,104,0,1,0,2
6028427,6028530,103,0,0,1,2
6028439,6028526,87,0,0,1,1
6028527,6028673,146,1,0,0,1
6028531,6028657,126,1,0,0,2
6028543,6028654,111,0,1,0,1
6028550,6028637,87,0,1,0,2
6028658,6030128,1470,0,0,1,2
6028674,6030127,1453,0,0,1,1
6030128,6030179,51,1,0,0,1
6030129,6030177,48,1,0,0,2
6030178,6030349,171,0,0,1,2
6030180,6031957,1777,0,0,1,1
6030350,6030361,11,1,0,0,2
6030362,6031956,1594,0,0,1,2
6031957,6032038,81,1,0,0,2
6031958,6032121,163,1,0,0,1
6032039,6032065,26,0,0,1,2
6032066,6032107,41,1,0,0,2
6032108,6032157,49,0,0,1,2
6032122,6032158,36,0,0,1,1
6032158,6032204,46,1,0,0,2
6032159,6032203,44,1,0,0,1
6032204,6032401,197,0,0,1,1
6032205,6032401,196,0,0,1,2
6032402,6032419,17,1,0,0,1
6032402,6032421,19,1,0,0,2
6032420,6032607,187,0,0,1,1
6032422,6033729,1307,0,0,1,2
6032608,6032640,32,1,0,0,1
6032641,6032899,258,0,0,1,1
6032900,6032909,9,1,0,0,1
6032910,6033729,819,0,0,1,1
6033730,6033793,63,1,0,0,1
6033730,6033801,71,1,0,0,2
6033794,6033893,99,0,0,1,1
6033802,6033891,89,0,0,1,2
6033892,6033932,40,1,0,0,2
6033894,6033924,30,1,0,0,1
6033925,6035209,1284,0,0,1,1
6033933,6035216,1283,0,0,1,2
6035210,6035288,78,1,0,0,1
6035217,6035282,65,1,0,0,2
6035283,6036828,1545,0,0,1,2
6035289,6036829,1540,0,0,1,1
6036829,6036917,88,1,0,0,2
6036830,6036931,101,1,0,0,1
6036918,6037016,98,0,0,1,2
6036932,6037016,84,0,0,1,1
6037017,6037058,41,1,0,0,2
6037017,6037080,63,1,0,0,1
6037059,6037423,364,0,0,1,2
6037081,6037421,340,0,0,1,1
6037422,6037455,33,1,0,0,1
6037424,6037454,30,1,0,0,2
6037455,6038822,1367,0,0,1,2
6037456,6038822,1366,0,0,1,1
6038823,6038902,79,1,0,0,2
6038823,6038919,96,1,0,0,1
6038903,6039001,98,0,0,1,2
6038920,6038999,79,0,0,1,1
6039000,6039068,68,1,0,0,1
6039002,6039072,70,1,0,0,2
6039069,6039176,107,0,0,1,1
6039073,6039174,101,0,0,1,2
6039175,6039213,38,1,0,0,2
6039177,6039208,31,1,0,0,1
6039209,6040310,1101,0,0,1,1
6039214,6040310,1096,0,0,1,2
6040311,6040366,55,1,0,0,1
6040311,6040373,62,1,0,0,2
6040367,6040477,110,0,0,1,1
6040374,6040479,105,0,0,1,2
6040478,6040511,33,1,0,0,1
6040480,6040510,30,1,0,0,2
6040511,6043662,3151,0,0,1,2
6040512,6043662,3150,0,0,1,1
6043663,6043721,58,1,0,0,2
6043663,6043725,62,1,0,0,1
6043722,6043783,61,0,0,1,2
6043726,6043782,56,0,0,1,1
6043783,6043878,95,1,0,0,1
6043784,6043852,68,1,0,0,2
6043853,6044034,181,0,0,1,2
6043879,6044035,156,0,0,1,1
6044035,6044061,26,1,0,0,2
6044036,6044065,29,1,0,0,1
6044062,6044966,904,0,0,1,2
6044066,6044966,900,0,0,1,1
6044967,6045017,50,1,0,0,2
6044967,6045023,56,1,0,0,1
6045018,6047074,2056,0,0,1,2
6045024,6047071,2047,0,0,1,1
6047072,6047238,166,1,0,0,1
6047075,6047236,161,1,0,0,2
6047118,6047178,60,0,1,0,1
6047119,6047161,42,0,1,0,2
6047237,6048203,966,0,0,1,2
6047239,6048203,964,0,0,1,1
6048204,6048268,64,1,0,0,1
6048204,6048269,65,1,0,0,2
6048269,6049830,1561,0,0,1,1
6048270,6049830,1560,0,0,1,2
6049831,6049882,51,1,0,0,2
6049831,6049884,53,1,0,0,1
6049883,6050033,150,0,0,1,2
6049885,6050033,148,0,0,1,1
6050034,6050062,28,1,0,0,1
6050034,6050065,31,1,0,0,2
6050063,6050133,70,0,0,1,1
6050066,6050134,68,0,0,1,2
6050134,6050163,29,1,0,0,1
6050135,6050168,33,1,0,0,2
6050164,6050454,290,0,0,1,1
6050169,6050448,279,0,0,1,2
6050449,6050468,19,1,0,0,2
6050455,6050478,23,1,0,0,1
6050469,6051979,1510,0,0,1,2
6050479,6051978,1499,0,0,1,1
6051979,6052071,92,1,0,0,1
6051980,6052049,69,1,0,0,2
6052050,6053078,1028,0,0,1,2
6052072,6053080,1008,0,0,1,1
6053079,6053126,47,1,0,0,2
6053081,6053127,46,1,0,0,1
6053127,6053496,369,0,0,1,2
6053128,6053497,369,0,0,1,1
6053497,6053546,49,1,0,0,2
6053498,6053548,50,1,0,0,1
6053547,6053717,170,0,0,1,2
6053549,6053719,170,0,0,1,1
6053718,6053726,8,1,0,0,2
6053720,6053730,10,1,0,0,1
6053727,6054909,1182,0,0,1,2
6053731,6054910,1179,0,0,1,1
6054910,6054970,60,1,0,0,2
6054911,6054967,56,1,0,0,1
6054968,6055128,160,0,0,1,1
6054971,6055128,157,0,0,1,2
6055129,6055156,27,1,0,0,1
6055129,6055157,28,1,0,0,2
6055157,6055516,359,0,0,1,1
6055158,6055517,359,0,0,1,2
6055517,6055541,24,1,0,0,1
6055518,6055533,15,1,0,0,2
6055534,6057048,1514,0,0,1,2
6055542,6057047,1505,0,0,1,1
6057048,6057245,197,1,0,0,1
6057049,6057221,172,1,0,0,2
6057082,6057198,116,0,1,0,1
6057083,6057170,87,0,1,0,2
6057222,6058481,1259,0,0,1,2
6057246,6058481,1235,0,0,1,1
6058482,6058572,90,1,0,0,2
6058482,6058581,99,1,0,0,1
6058573,6060137,1564,0,0,1,2
6058582,6060139,1557,0,0,1,1
6060138,6060209,71,1,0,0,2
6060140,6060215,75,1,0,0,1
6060210,6060338,128,0,0,1,2
6060216,6060338,122,0,0,1,1
6060339,6060373,34,1,0,0,2
6060339,6060374,35,1,0,0,1
6060374,6060696,322,0,0,1,2
6060375,6060695,320,0,0,1,1
6060696,6060718,22,1,0,0,1
6060697,6060727,30,1,0,0,2
6060719,6062371,1652,0,0,1,1
6060728,6062356,1628,0,0,1,2
6062357,6062529,172,1,0,0,2
6062372,6062535,163,1,0,0,1
6062394,6062484,90,0,1,0,2
6062395,6062497,102,0,1,0,1
6062530,6063051,521,0,0,1,2
6062536,6063050,514,0,0,1,1
6063051,6063112,61,1,0,0,1
6063052,6063116,64,1,0,0,2
6063113,6063804,691,0,0,1,1
6063117,6063805,688,0,0,1,2
6063805,6063872,67,1,0,0,1
6063806,6063875,69,1,0,0,2
6063873,6065194,1321,0,0,1,1
6063876,6064067,191,0,0,1,2
6064068,6064082,14,1,0,0,2
6064083,6065193,1110,0,0,1,2
6065194,6065248,54,1,0,0,2
6065195,6065253,58,1,0,0,1
6065249,6067388,2139,0,0,1,2
6065254,6067384,2130,0,0,1,1
6067385,6067604,219,1,0,0,1
6067389,6067581,192,1,0,0,2
6067412,6067566,154,0,1,0,1
6067420,6067530,110,0,1,0,2
6067582,6068174,592,0,0,1,2
6067605,6068174,569,0,0,1,1
6068175,6068196,21,1,0,0,1
6068175,6068197,22,1,0,0,2
6068197,6068721,524,0,0,1,1
6068198,6068722,524,0,0,1,2
6068722,6068802,80,1,0,0,1
6068723,6068798,75,1,0,0,2
6068799,6068900,101,0,0,1,2
6068803,6068898,95,0,0,1,1
6068899,6068943,44,1,0,0,1
6068901,6068935,34,1,0,0,2
6068936,6070042,1106,0,0,1,2
6068944,6070038,1094,0,0,1,1
6070039,6070087,48,1,0,0,1
6070043,6070095,52,1,0,0,2
6070088,6070608,520,0,0,1,1
6070096,6070608,512,0,0,1,2
6070609,6070629,20,1,0,0,1
6070609,6070641,32,1,0,0,2
6070630,6072218,1588,0,0,1,1
6070642,6072215,1573,0,0,1,2
6072216,6072446,230,1,0,0,2
6072219,6072457,238,1,0,0,1
6072263,6072367,104,0,1,0,2
6072263,6072394,131,0,1,0,1
6072447,6072889,442,0,0,1,2
6072458,6072886,428,0,0,1,1
6072887,6072944,57,1,0,0,1
6072890,6072954,64,1,0,0,2
6072945,6073477,532,0,0,1,1
6072955,6073477,522,0,0,1,2
6073478,6073552,74,1,0,0,1
6073478,6073556,78,1,0,0,2
6073553,6073686,133,0,0,1,1
6073557,6073685,128,0,0,1,2
6073686,6073712,26,1,0,0,2
6073687,6073713,26,1,0,0,1
6073713,6074904,1191,0,0,1,2
6073714,6074903,1189,0,0,1,1
6074904,6074969,65,1,0,0,1
6074905,6074977,72,1,0,0,2
6074970,6075121,151,0,0,1,1
6074978,6075122,144,0,0,1,2
6075122,6075141,19,1,0,0,1
6075123,6075145,22,1,0,0,2
6075142,6077018,1876,0,0,1,1
6075146,6077016,1870,0,0,1,2
6077017,6077170,153,1,0,0,2
6077019,6077191,172,1,0,0,1
6077044,6077131,87,0,1,0,2
6077045,6077160,115,0,1,0,1
6077171,6077554,383,0,0,1,2
6077192,6077555,363,0,0,1,1
6077555,6077606,51,1,0,0,2
6077556,6077608,52,1,0,0,1
6077607,6078292,685,0,0,1,2
6077609,6078292,683,0,0,1,1
6078293,6078357,64,1,0,0,2
6078293,6078359,66,1,0,0,1
6078358,6078546,188,0,0,1,2
6078360,6078546,186,0,0,1,1
6078547,6078560,13,1,0,0,2
6078547,6078568,21,1,0,0,1
6078561,6080105,1544,0,0,1,2
6078569,6080105,1536,0,0,1,1
6080106,6080158,52,1,0,0,2
6080106,6080168,62,1,0,0,1
6080159,6082206,2047,0,0,1,2
6080169,6082205,2036,0,0,1,1
6082206,6082410,204,1,0,0,1
6082207,6082412,205,1,0,0,2
6082238,6082383,145,0,1,0,1
6082241,6082374,133,0,1,0,2
6082411,6083170,759,0,0,1,1
6082413,6083170,757,0,0,1,2
6083171,6083220,49,1,0,0,2
6083171,6083224,53,1,0,0,1
6083221,6084032,811,0,0,1,2
6083225,6084032,807,0,0,1,1
6084033,6084099,66,1,0,0,1
6084033,6084101,68,1,0,0,2
6084100,6084207,107,0,0,1,1
6084102,6084207,105,0,0,1,2
6084208,6084246,38,1,0,0,1
6084208,6084254,46,1,0,0,2
6084247,6085775,1528,0,0,1,1
6084255,6085774,1519,0,0,1,2
6085775,6085827,52,1,0,0,2
6085776,6085831,55,1,0,0,1
6085828,6085936,108,0,0,1,2
6085832,6085933,101,0,0,1,1
6085934,6085966,32,1,0,0,1
6085937,6085971,34,1,0,0,2
6085967,6088027,2060,0,0,1,1
6085972,6088021,2049,0,0,1,2
6088022,6088199,177,1,0,0,2
6088028,6088216,188,1,0,0,1
6088056,6088163,107,0,1,0,1
6088057,6088144,87,0,1,0,2
6088200,6088568,368,0,0,1,2
6088217,6088568,351,0,0,1,1
6088569,6088618,49,1,0,0,1
6088569,6088618,49,1,0,0,2
6088619,6089569,950,0,0,1,1
6088619,6089569,950,0,0,1,2
6089570,6089649,79,1,0,0,2
6089570,6089669,99,1,0,0,1
6089650,6089756,106,0,0,1,2
6089670,6089757,87,0,0,1,1
6089757,6089798,41,1,0,0,2
6089758,6089789,31,1,0,0,1
6089790,6091134,1344,0,0,1,1
6089799,6091136,1337,0,0,1,2
6091135,6091233,98,1,0,0,1
6091137,6091198,61,1,0,0,2
6091199,6093289,2090,0,0,1,2
6091234,6093279,2045,0,0,1,1
6093280,6093571,291,1,0,0,1
6093290,6093585,295,1,0,0,2
6093331,6093512,181,0,1,0,1
6093333,6093492,159,0,1,0,2
6093572,6094826,1254,0,0,1,1
6093586,6094825,1239,0,0,1,2
6094826,6094916,90,1,0,0,2
6094827,6094910,83,1,0,0,1
6094911,6095041,130,0,0,1,1
6094917,6095040,123,0,0,1,2
6095041,6095076,35,1,0,0,2
6095042,6095062,20,1,0,0,1
6095063,6095323,260,0,0,1,1
6095077,6095314,237,0,0,1,2
6095315,6095340,25,1,0,0,2
6095324,6095338,14,1,0,0,1
6095339,6096860,1521,0,0,1,1
6095341,6096860,1519,0,0,1,2
6096861,6096920,59,1,0,0,1
6096861,6096920,59,1,0,0,2
6096921,6097259,338,0,0,1,1
6096921,6097259,338,0,0,1,2
6097260,6097292,32,1,0,0,1
6097260,6097292,32,1,0,0,2
6097293,6099169,1876,0,0,1,2
6097293,6099170,1877,0,0,1,1
6099170,6099347,177,1,0,0,2
6099171,6099356,185,1,0,0,1
6099192,6099321,129,0,1,0,1
6099195,6099286,91,0,1,0,2
6099348,6099604,256,0,0,1,2
6099357,6099605,248,0,0,1,1
6099605,6099662,57,1,0,0,2
6099606,6099671,65,1,0,0,1
6099663,6100665,1002,0,0,1,2
6099672,6100665,993,0,0,1,1
6100666,6100725,59,1,0,0,2
6100666,6100727,61,1,0,0,1
6100726,6100938,212,0,0,1,2
6100728,6100940,212,0,0,1,1
6100939,6101019,80,1,0,0,2
6100941,6101010,69,1,0,0,1
6101011,6101159,148,0,0,1,1
6101020,6101158,138,0,0,1,2
6101159,6101189,30,1,0,0,2
6101160,6101188,28,1,0,0,1
6101189,6102785,1596,0,0,1,1
6101190,6102785,1595,0,0,1,2
6102786,6102854,68,1,0,0,2
6102786,6102856,70,1,0,0,1
6102855,6103266,411,0,0,1,2
6102857,6103272,415,0,0,1,1
6103267,6103291,24,1,0,0,2
6103273,6103292,19,1,0,0,1
6103292,6104997,1705,0,0,1,2
6103293,6105006,1713,0,0,1,1
6104998,6105172,174,1,0,0,2
6105007,6105192,185,1,0,0,1
6105027,6105126,99,0,1,0,2
6105028,6105149,121,0,1,0,1
6105173,6106727,1554,0,0,1,2
6105193,6106727,1534,0,0,1,1
6106728,6106803,75,1,0,0,2
6106728,6106804,76,1,0,0,1
6106804,6106911,107,0,0,1,2
6106805,6106910,105,0,0,1,1
6106911,6106960,49,1,0,0,1
6106912,6106954,42,1,0,0,2
6106955,6107158,203,0,0,1,2
6106961,6107153,192,0,0,1,1
6107154,6107183,29,1,0,0,1
6107159,6107180,21,1,0,0,2
6107181,6108763,1582,0,0,1,2
6107184,6108763,1579,0,0,1,1
6108764,6108832,68,1,0,0,2
6108764,6108835,71,1,0,0,1
6108833,6111088,2255,0,0,1,2
6108836,6111088,2252,0,0,1,1
6111089,6111151,62,1,0,0,2
6111089,6111445,356,1,0,0,1
6111152,6111194,42,0,0,1,2
6111195,6111385,190,1,0,0,2
6111234,6111366,132,0,1,0,1
6111249,6111327,78,0,1,0,2
6111386,6112449,1063,0,0,1,2
6111446,6112449,1003,0,0,1,1
6112450,6112514,64,1,0,0,2
6112450,6112516,66,1,0,0,1
6112515,6112831,316,0,0,1,2
6112517,6112830,313,0,0,1,1
6112831,6112893,62,1,0,0,1
6112832,6112892,60,1,0,0,2
6112893,6113048,155,0,0,1,2
6112894,6113047,153,0,0,1,1
6113048,6113063,15,1,0,0,1
6113049,6113064,15,1,0,0,2
6113064,6114663,1599,0,0,1,1
6113065,6114662,1597,0,0,1,2
6114663,6114715,52,1,0,0,2
6114664,6114716,52,1,0,0,1
6114716,6116872,2156,0,0,1,2
6114717,6116878,2161,0,0,1,1
6116873,6117034,161,1,0,0,2
6116879,6117060,181,1,0,0,1
6116897,6117024,127,0,1,0,1
6116898,6116989,91,0,1,0,2
6117035,6118457,1422,0,0,1,2
6117061,6118459,1398,0,0,1,1
6118458,6118507,49,1,0,0,2
6118460,6118553,93,1,0,0,1
6118508,6118690,182,0,0,1,2
6118554,6118597,43,0,0,1,1
6118598,6118611,13,1,0,0,1
6118612,6118691,79,0,0,1,1
6118691,6118770,79,1,0,0,2
6118692,6118767,75,1,0,0,1
6118768,6118875,107,0,0,1,1
6118771,6118875,104,0,0,1,2
6118876,6118907,31,1,0,0,2
6118876,6118910,34,1,0,0,1
6118908,6120301,1393,0,0,1,2
6118911,6120302,1391,0,0,1,1
6120302,6120376,74,1,0,0,2
6120303,6120374,71,1,0,0,1
6120375,6120493,118,0,0,1,1
6120377,6120494,117,0,0,1,2
6120494,6120528,34,1,0,0,1
6120495,6120526,31,1,0,0,2
6120527,6120842,315,0,0,1,2
6120529,6120842,313,0,0,1,1
6120843,6120853,10,1,0,0,2
6120843,6120854,11,1,0,0,1
6120854,6122474,1620,0,0,1,2
6120855,6122482,1627,0,0,1,1
6122475,6122637,162,1,0,0,2
6122483,6122653,170,1,0,0,1
6122502,6122619,117,0,1,0,1
6122506,6122591,85,0,1,0,2
6122638,6123731,1093,0,0,1,2
6122654,6123729,1075,0,0,1,1
6123730,6123805,75,1,0,0,1
6123732,6123805,73,1,0,0,2
6123806,6123905,99,0,0,1,1
6123806,6123906,100,0,0,1,2
6123906,6123947,41,1,0,0,1
6123907,6123939,32,1,0,0,2
6123940,6124101,161,0,0,1,2
6123948,6124112,164,0,0,1,1
6124102,6124117,15,1,0,0,2
6124113,6124130,17,1,0,0,1
6124118,6124272,154,0,0,1,2
6124131,6124268,137,0,0,1,1
6124269,6124289,20,1,0,0,1
6124273,6124299,26,1,0,0,2
6124290,6124435,145,0,0,1,1
6124300,6124442,142,0,0,1,2
6124436,6124459,23,1,0,0,1
6124443,6124459,16,1,0,0,2
6124460,6125317,857,0,0,1,1
6124460,6125317,857,0,0,1,2
6125318,6125375,57,1,0,0,2
6125318,6125384,66,1,0,0,1
6125376,6127529,2153,0,0,1,2
6125385,6127531,2146,0,0,1,1
6127530,6127738,208,1,0,0,2
6127532,6127740,208,1,0,0,1
6127563,6127707,144,0,1,0,1
6127566,6127676,110,0,1,0,2
6127739,6129010,1271,0,0,1,2
6127741,6129011,1270,0,0,1,1
6129011,6129085,74,1,0,0,2
6129012,6129130,118,1,0,0,1
6129086,6129186,100,0,0,1,2
6129131,6129185,54,0,0,1,1
6129186,6129229,43,1,0,0,1
6129187,6129222,35,1,0,0,2
6129223,6130741,1518,0,0,1,2
6129230,6130741,1511,0,0,1,1
6130742,6130793,51,1,0,0,2
6130742,6130794,52,1,0,0,1
6130794,6132892,2098,0,0,1,2
6130795,6132900,2105,0,0,1,1
6132893,6133066,173,1,0,0,2
6132901,6133111,210,1,0,0,1
6132931,6133028,97,0,1,0,1
6132937,6133001,64,0,1,0,2
6133067,6134540,1473,0,0,1,2
6133112,6134541,1429,0,0,1,1
6134541,6134612,71,1,0,0,2
6134542,6134612,70,1,0,0,1
6134613,6134751,138,0,0,1,1
6134613,6134752,139,0,0,1,2
6134752,6134785,33,1,0,0,1
6134753,6134781,28,1,0,0,2
6134782,6136596,1814,0,0,1,2
6134786,6136596,1810,0,0,1,1
6136597,6136653,56,1,0,0,2
6136597,6136663,66,1,0,0,1
6136654,6136772,118,0,0,1,2
6136664,6136772,108,0,0,1,1
6136773,6136804,31,1,0,0,2
6136773,6136807,34,1,0,0,1
6136805,6138775,1970,0,0,1,2
6136808,6138778,1970,0,0,1,1
6138776,6138979,203,1,0,0,2
6138779,6139000,221,1,0,0,1
6138802,6138955,153,0,1,0,1
6138806,6138926,120,0,1,0,2
6138980,6139255,275,0,0,1,2
6139001,6139255,254,0,0,1,1
6139256,6139313,57,1,0,0,1
6139256,6139314,58,1,0,0,2
6139314,6139846,532,0,0,1,1
6139315,6139845,530,0,0,1,2
6139846,6139884,38,1,0,0,2
6139847,6139885,38,1,0,0,1
6139885,6140640,755,0,0,1,2
6139886,6140639,753,0,0,1,1
6140640,6140694,54,1,0,0,1
6140641,6140691,50,1,0,0,2
6140692,6140873,181,0,0,1,2
6140695,6140875,180,0,0,1,1
6140874,6140903,29,1,0,0,2
6140876,6140903,27,1,0,0,1
6140904,6142610,1706,0,0,1,2
6140904,6142612,1708,0,0,1,1
6142611,6142674,63,1,0,0,2
6142613,6142677,64,1,0,0,1
6142675,6144832,2157,0,0,1,2
6142678,6144825,2147,0,0,1,1
6144826,6145076,250,1,0,0,1
6144833,6145061,228,1,0,0,2
6144877,6145009,132,0,1,0,2
6144880,6145025,145,0,1,0,1
6145062,6145492,430,0,0,1,2
6145077,6145492,415,0,0,1,1
6145493,6145556,63,1,0,0,1
6145493,6145557,64,1,0,0,2
6145557,6146659,1102,0,0,1,1
6145558,6146659,1101,0,0,1,2
6146660,6146707,47,1,0,0,1
6146660,6146712,52,1,0,0,2
6146708,6148032,1324,0,0,1,1
6146713,6148032,1319,0,0,1,2
6148033,6148103,70,1,0,0,2
6148033,6148105,72,1,0,0,1
6148104,6148234,130,0,0,1,2
6148106,6148235,129,0,0,1,1
6148235,6148269,34,1,0,0,2
6148236,6148266,30,1,0,0,1
6148267,6150202,1935,0,0,1,1
6148270,6150201,1931,0,0,1,2
6150202,6150410,208,1,0,0,2
6150203,6150430,227,1,0,0,1
6150232,6150395,163,0,1,0,1
6150237,6150355,118,0,1,0,2
6150411,6151455,1044,0,0,1,2
6150431,6151457,1026,0,0,1,1
6151456,6151522,66,1,0,0,2
6151458,6151530,72,1,0,0,1
6151523,6151638,115,0,0,1,2
6151531,6151639,108,0,0,1,1
6151639,6151676,37,1,0,0,2
6151640,6151676,36,1,0,0,1
6151677,6152815,1138,0,0,1,1
6151677,6152815,1138,0,0,1,2
6152816,6152865,49,1,0,0,1
6152816,6152873,57,1,0,0,2
6152866,6154973,2107,0,0,1,1
6152874,6154972,2098,0,0,1,2
6154973,6155144,171,1,0,0,2
6154974,6155167,193,1,0,0,1
6155001,6155130,129,0,1,0,1
6155004,6155100,96,0,1,0,2
6155145,6156269,1124,0,0,1,2
6155168,6156269,1101,0,0,1,1
6156270,6156342,72,1,0,0,2
6156270,6156347,77,1,0,0,1
6156343,6156448,105,0,0,1,2
6156348,6156448,100,0,0,1,1
6156449,6156484,35,1,0,0,1
6156449,6156484,35,1,0,0,2
6156485,6156700,215,0,0,1,1
6156485,6157992,1507,0,0,1,2
6156701,6156721,20,1,0,0,1
6156722,6157991,1269,0,0,1,1
6157992,6158057,65,1,0,0,1
6157993,6158054,61,1,0,0,2
6158055,6160103,2048,0,0,1,2
6158058,6160090,2032,0,0,1,1
6160091,6160361,270,1,0,0,1
6160104,6160313,209,1,0,0,2
6160146,6160273,127,0,1,0,1
6160152,6160248,96,0,1,0,2
6160314,6160976,662,0,0,1,2
6160362,6160975,613,0,0,1,1
6160976,6161041,65,1,0,0,1
6160977,6161041,64,1,0,0,2
6161042,6161292,250,0,0,1,1
6161042,6161292,250,0,0,1,2
6161293,6161361,68,1,0,0,2
6161293,6161366,73,1,0,0,1
6161362,6161791,429,0,0,1,2
6161367,6161785,418,0,0,1,1
6161786,6161865,79,1,0,0,1
6161792,6161860,68,1,0,0,2
6161861,6161957,96,0,0,1,2
6161866,6161956,90,0,0,1,1
6161957,6161990,33,1,0,0,1
6161958,6161988,30,1,0,0,2
6161989,6163589,1600,0,0,1,2
6161991,6163588,1597,0,0,1,1
6163589,6163651,62,1,0,0,1
6163590,6163652,62,1,0,0,2
6163652,6164826,1174,0,0,1,1
6163653,6164826,1173,0,0,1,2
6164827,6164838,11,1,0,0,1
6164827,6164839,12,1,0,0,2
6164839,6165821,982,0,0,1,1
6164840,6165822,982,0,0,1,2
6165822,6166090,268,1,0,0,1
6165823,6166073,250,1,0,0,2
6165855,6166049,194,0,1,0,1
6165861,6166002,141,0,1,0,2
6166074,6166317,243,0,0,1,2
6166091,6166314,223,0,0,1,1
6166315,6166346,31,1,0,0,1
6166318,6166347,29,1,0,0,2
6166347,6167635,1288,0,0,1,1
6166348,6167636,1288,0,0,1,2
6167636,6167693,57,1,0,0,1
6167637,6167688,51,1,0,0,2
6167689,6169586,1897,0,0,1,2
6167694,6169585,1891,0,0,1,1
6169586,6169652,66,1,0,0,1
6169587,6169636,49,1,0,0,2
6169637,6169830,193,0,0,1,2
6169653,6169830,177,0,0,1,1
6169831,6169862,31,1,0,0,1
6169831,6169863,32,1,0,0,2
6169863,6170277,414,0,0,1,1
6169864,6170277,413,0,0,1,2
6170278,6170283,5,1,0,0,2
6170278,6170304,26,1,0,0,1
6170284,6171868,1584,0,0,1,2
6170305,6171848,1543,0,0,1,1
6171849,6172145,296,1,0,0,1
6171869,6172132,263,1,0,0,2
6171900,6172102,202,0,1,0,1
6171907,6172066,159,0,1,0,2
6172133,6173650,1517,0,0,1,2
6172146,6173650,1504,0,0,1,1
6173651,6173720,69,1,0,0,2
6173651,6173721,70,1,0,0,1
6173721,6173844,123,0,0,1,2
6173722,6173844,122,0,0,1,1
6173845,6173872,27,1,0,0,2
6173845,6173874,29,1,0,0,1
6173873,6174164,291,0,0,1,2
6173875,6174162,287,0,0,1,1
6174163,6174183,20,1,0,0,1
6174165,6174173,8,1,0,0,2
6174174,6175262,1088,0,0,1,2
6174184,6175262,1078,0,0,1,1
6175263,6175311,48,1,0,0,2
6175263,6175316,53,1,0,0,1
6175312,6175502,190,0,0,1,2
6175317,6175502,185,0,0,1,1
6175503,6175522,19,1,0,0,1
6175503,6175535,32,1,0,0,2
6175523,6177431,1908,0,0,1,1
6175536,6177422,1886,0,0,1,2
6177423,6177624,201,1,0,0,2
6177432,6177642,210,1,0,0,1
6177447,6177600,153,0,1,0,1
6177449,6177566,117,0,1,0,2
6177625,6178609,984,0,0,1,2
6177643,6178609,966,0,0,1,1
6178610,6178716,106,1,0,0,2
6178610,6178730,120,1,0,0,1
6178717,6178850,133,0,0,1,2
6178731,6178844,113,0,0,1,1
6178845,6178894,49,1,0,0,1
6178851,6178892,41,1,0,0,2
6178893,6179084,191,0,0,1,2
6178895,6180426,1531,0,0,1,1
6179085,6179111,26,1,0,0,2
6179112,6180424,1312,0,0,1,2
6180425,6180486,61,1,0,0,2
6180427,6180486,59,1,0,0,1
6180487,6181097,610,0,0,1,2
6180487,6182659,2172,0,0,1,1
6181098,6181103,5,1,0,0,2
6181104,6182655,1551,0,0,1,2
6182656,6182856,200,1,0,0,2
6182660,6182834,174,1,0,0,1
6182698,6182779,81,0,1,0,2
6182700,6182789,89,0,1,0,1
6182835,6184016,1181,0,0,1,1
6182857,6184020,1163,0,0,1,2
6184017,6184089,72,1,0,0,1
6184021,6184085,64,1,0,0,2
6184086,6184253,167,0,0,1,2
6184090,6184255,165,0,0,1,1
6184254,6184275,21,1,0,0,2
6184256,6184273,17,1,0,0,1
6184274,6186073,1799,0,0,1,1
6184276,6186074,1798,0,0,1,2
6186074,6186142,68,1,0,0,1
6186075,6186142,67,1,0,0,2
6186143,6186710,567,0,0,1,1
6186143,6186711,568,0,0,1,2
6186711,6186731,20,1,0,0,1
6186712,6186733,21,1,0,0,2
6186732,6188206,1474,0,0,1,1
6186734,6188203,1469,0,0,1,2
6188204,6188453,249,1,0,0,2
6188207,6188483,276,1,0,0,1
6188238,6188406,168,0,1,0,2
6188238,6188433,195,0,1,0,1
6188454,6188928,474,0,0,1,2
6188484,6188927,443,0,0,1,1
6188928,6188971,43,1,0,0,1
6188929,6188962,33,1,0,0,2
6188963,6190143,1180,0,0,1,2
6188972,6190145,1173,0,0,1,1
6190144,6190176,32,1,0,0,2
6190146,6190178,32,1,0,0,1
6190177,6190525,348,0,0,1,2
6190179,6190526,347,0,0,1,1
6190526,6190550,24,1,0,0,2
6190527,6190561,34,1,0,0,1
6190551,6190912,361,0,0,1,2
6190562,6190912,350,0,0,1,1
6269041,6269251,210,0,0,1,2
6269041,6269252,211,0,0,1,1
6269252,6269307,55,1,0,0,2
6269253,6269319,66,1,0,0,1
6269308,6269431,123,0,0,1,2
6269320,6269430,110,0,0,1,1
6269431,6269452,21,1,0,0,1
6269432,6269456,24,1,0,0,2
6269453,6271430,1977,0,0,1,1
6269457,6271429,1972,0,0,1,2
6271430,6271493,63,1,0,0,2
6271431,6271493,62,1,0,0,1
6271494,6271607,113,0,0,1,1
6271494,6271608,114,0,0,1,2
6271608,6271630,22,1,0,0,1
6271609,6271643,34,1,0,0,2
6271631,6273440,1809,0,0,1,1
6271644,6273440,1796,0,0,1,2
6273441,6273466,25,1,0,0,2
6273441,6273477,36,1,0,0,1
6273467,6273574,107,0,0,1,2
6273478,6273573,95,0,0,1,1
6273574,6273678,104,1,0,0,1
6273575,6273656,81,1,0,0,2
6273657,6273720,63,0,0,1,2
6273679,6273721,42,0,0,1,1
6273721,6273769,48,1,0,0,2
6273722,6273767,45,1,0,0,1
6273768,6273871,103,0,0,1,1
6273770,6273871,101,0,0,1,2
6273872,6273906,34,1,0,0,2
6273872,6273907,35,1,0,0,1
6273907,6275441,1534,0,0,1,2
6273908,6274108,200,0,0,1,1
6274109,6274124,15,1,0,0,1
6274125,6275443,1318,0,0,1,1
6275442,6275556,114,1,0,0,2
6275444,6275557,113,1,0,0,1
6275557,6275647,90,0,0,1,2
6275558,6275648,90,0,0,1,1
6275648,6275691,43,1,0,0,2
6275649,6275692,43,1,0,0,1
6275692,6277075,1383,0,0,1,2
6275693,6277074,1381,0,0,1,1
6277075,6277128,53,1,0,0,1
6277076,6277132,56,1,0,0,2
6277129,6277299,170,0,0,1,1
6277133,6277300,167,0,0,1,2
6277300,6277317,17,1,0,0,1
6277301,6277319,18,1,0,0,2
6277318,6278680,1362,0,0,1,1
6277320,6278680,1360,0,0,1,2
6278681,6278787,106,1,0,0,2
6278681,6278795,114,1,0,0,1
6278788,6278905,117,0,0,1,2
6278796,6278907,111,0,0,1,1
6278906,6278950,44,1,0,0,2
6278908,6278964,56,1,0,0,1
6278951,6280235,1284,0,0,1,2
6278965,6280235,1270,0,0,1,1
6280236,6280283,47,1,0,0,1
6280236,6280285,49,1,0,0,2
6280284,6280987,703,0,0,1,1
6280286,6281633,1347,0,0,1,2
6280988,6281066,78,1,0,0,1
6281067,6281135,68,0,0,1,1
6281136,6281195,59,1,0,0,1
6281196,6281224,28,0,0,1,1
6281225,6281277,52,1,0,0,1
6281278,6281523,245,0,0,1,1
6281524,6281575,51,1,0,0,1
6281576,6281634,58,0,0,1,1
6281634,6281699,65,1,0,0,2
6281635,6281699,64,1,0,0,1
6281700,6281778,78,0,0,1,1
6281700,6281779,79,0,0,1,2
6281779,6281825,46,1,0,0,1
6281780,6281812,32,1,0,0,2
6281813,6283224,1411,0,0,1,2
6281826,6282162,336,0,0,1,1
6282163,6282168,5,1,0,0,1
6282169,6283227,1058,0,0,1,1
6283225,6283382,157,1,0,0,2
6283228,6283386,158,1,0,0,1
6283256,6283357,101,0,1,0,1
6283264,6283328,64,0,1,0,2
6283383,6283664,281,0,0,1,2
6283387,6283665,278,0,0,1,1
6283665,6283739,74,1,0,0,2
6283666,6283742,76,1,0,0,1
6283740,6283842,102,0,0,1,2
6283743,6283844,101,0,0,1,1
6283843,6283877,34,1,0,0,2
6283845,6283881,36,1,0,0,1
6283878,6284083,205,0,0,1,2
6283882,6284081,199,0,0,1,1
6284082,6284099,17,1,0,0,1
6284084,6284112,28,1,0,0,2
6284100,6284898,798,0,0,1,1
6284113,6285342,1229,0,0,1,2
6284899,6284946,47,1,0,0,1
6284947,6285343,396,0,0,1,1
6285343,6285423,80,1,0,0,2
6285344,6285414,70,1,0,0,1
6285415,6285501,86,0,0,1,1
6285424,6285501,77,0,0,1,2
6285502,6285534,32,1,0,0,1
6285502,6285537,35,1,0,0,2
6285535,6286894,1359,0,0,1,1
6285538,6286894,1356,0,0,1,2
6286895,6286961,66,1,0,0,2
6286895,6286964,69,1,0,0,1
6286962,6287061,99,0,0,1,2
6286965,6287061,96,0,0,1,1
6287062,6287098,36,1,0,0,2
6287062,6287104,42,1,0,0,1
6287099,6288537,1438,0,0,1,2
6287105,6288536,1431,0,0,1,1
6288537,6288626,89,1,0,0,1
6288538,6288627,89,1,0,0,2
6288627,6288713,86,0,0,1,1
6288628,6288713,85,0,0,1,2
6288714,6288749,35,1,0,0,2
6288714,6288750,36,1,0,0,1
6288750,6290182,1432,0,0,1,2
6288751,6290183,1432,0,0,1,1
6290183,6290258,75,1,0,0,2
6290184,6290257,73,1,0,0,1
6290258,6290365,107,0,0,1,1
6290259,6290361,102,0,0,1,2
6290362,6290399,37,1,0,0,2
6290366,6290387,21,1,0,0,1
6290388,6291775,1387,0,0,1,1
6290400,6291775,1375,0,0,1,2
6291776,6291834,58,1,0,0,1
6291776,6291847,71,1,0,0,2
6291835,6291978,143,0,0,1,1
6291848,6291982,134,0,0,1,2
6291979,6292008,29,1,0,0,1
6291983,6292011,28,1,0,0,2
6292009,6293361,1352,0,0,1,1
6292012,6293361,1349,0,0,1,2
6293362,6293438,76,1,0,0,2
6293362,6293443,81,1,0,0,1
6293439,6293541,102,0,0,1,2
6293444,6293542,98,0,0,1,1
6293542,6293576,34,1,0,0,2
6293543,6293576,33,1,0,0,1
6293577,6295087,1510,0,0,1,1
6293577,6295089,1512,0,0,1,2
6295088,6295150,62,1,0,0,1
6295090,6295161,71,1,0,0,2
6295151,6295285,134,0,0,1,1
6295162,6295285,123,0,0,1,2
6295286,6295304,18,1,0,0,1
6295286,6295308,22,1,0,0,2
6295305,6296661,1356,0,0,1,1
6295309,6296662,1353,0,0,1,2
6296662,6296809,147,1,0,0,1
6296663,6296807,144,1,0,0,2
6296808,6296839,31,0,0,1,2
6296810,6296840,30,0,0,1,1
6296840,6296880,40,1,0,0,2
6296841,6296877,36,1,0,0,1
6296878,6296970,92,0,0,1,1
6296881,6296970,89,0,0,1,2
6296971,6297016,45,1,0,0,1
6296971,6297016,45,1,0,0,2
6297017,6297199,182,0,0,1,1
6297017,6297203,186,0,0,1,2
6297200,6297216,16,1,0,0,1
6297204,6297228,24,1,0,0,2
6297217,6298477,1260,0,0,1,1
6297229,6298479,1250,0,0,1,2
6298478,6298567,89,1,0,0,1
6298480,6298569,89,1,0,0,2
6298568,6298706,138,0,0,1,1
6298570,6298708,138,0,0,1,2
6298707,6298737,30,1,0,0,1
6298709,6298741,32,1,0,0,2
6298738,6300244,1506,0,0,1,1
6298742,6300244,1502,0,0,1,2
6300245,6300286,41,1,0,0,2
6300245,6300301,56,1,0,0,1
6300287,6300415,128,0,0,1,2
6300302,6300415,113,0,0,1,1
6300416,6300448,32,1,0,0,1
6300416,6300457,41,1,0,0,2
6300449,6300944,495,0,0,1,1
6300458,6300946,488,0,0,1,2
6300945,6300970,25,1,0,0,1
6300947,6300960,13,1,0,0,2
6300961,6301957,996,0,0,1,2
6300971,6301011,40,0,0,1,1
6301012,6301025,13,1,0,0,1
6301026,6301957,931,0,0,1,1
6301958,6302024,66,1,0,0,1
6301958,6302025,67,1,0,0,2
6302025,6302114,89,0,0,1,1
6302026,6302113,87,0,0,1,2
6302114,6302143,29,1,0,0,2
6302115,6302151,36,1,0,0,1
6302144,6302234,90,0,0,1,2
6302152,6302234,82,0,0,1,1
6302235,6302266,31,1,0,0,2
6302235,6302270,35,1,0,0,1
6302267,6303598,1331,0,0,1,2
6302271,6303599,1328,0,0,1,1
6303599,6303655,56,1,0,0,2
6303600,6303663,63,1,0,0,1
6303656,6303819,163,0,0,1,2
6303664,6303819,155,0,0,1,1
6303820,6303839,19,1,0,0,1
6303820,6303842,22,1,0,0,2
6303840,6305295,1455,0,0,1,1
6303843,6305295,1452,0,0,1,2
6305296,6305359,63,1,0,0,2
6305296,6305361,65,1,0,0,1
6305360,6305493,133,0,0,1,2
6305362,6305493,131,0,0,1,1
6305494,6305528,34,1,0,0,2
6305494,6305529,35,1,0,0,1
6305529,6306699,1170,0,0,1,2
6305530,6306699,1169,0,0,1,1
6306700,6306790,90,1,0,0,2
6306700,6306792,92,1,0,0,1
6306791,6306891,100,0,0,1,2
6306793,6306893,100,0,0,1,1
6306892,6306933,41,1,0,0,2
6306894,6306933,39,1,0,0,1
6306934,6308408,1474,0,0,1,2
6306934,6308409,1475,0,0,1,1
6308409,6308468,59,1,0,0,2
6308410,6308470,60,1,0,0,1
6308469,6308615,146,0,0,1,2
6308471,6308614,143,0,0,1,1
6308615,6308643,28,1,0,0,1
6308616,6308646,30,1,0,0,2
6308644,6309960,1316,0,0,1,1
6308647,6309960,1313,0,0,1,2
6309961,6310028,67,1,0,0,1
6309961,6310033,72,1,0,0,2
6310029,6310130,101,0,0,1,1
6310034,6310130,96,0,0,1,2
6310131,6310162,31,1,0,0,1
6310131,6310166,35,1,0,0,2
6310163,6311481,1318,0,0,1,1
6310167,6311480,1313,0,0,1,2
6311481,6311563,82,1,0,0,2
6311482,6311563,81,1,0,0,1
6311564,6311679,115,0,0,1,2
6311564,6311681,117,0,0,1,1
6311680,6311721,41,1,0,0,2
6311682,6311725,43,1,0,0,1
6311722,6313050,1328,0,0,1,2
6311726,6311888,162,0,0,1,1
6311889,6312007,118,1,0,0,1
6312008,6313049,1041,0,0,1,1
6313050,6313132,82,1,0,0,1
6313051,6313134,83,1,0,0,2
6313133,6313242,109,0,0,1,1
6313135,6313241,106,0,0,1,2
6313242,6313276,34,1,0,0,2
6313243,6313274,31,1,0,0,1
6313275,6314648,1373,0,0,1,1
6313277,6314648,1371,0,0,1,2
6314649,6314709,60,1,0,0,2
6314649,6314710,61,1,0,0,1
6314710,6314800,90,0,0,1,2
6314711,6314801,90,0,0,1,1
6314801,6314834,33,1,0,0,2
6314802,6314835,33,1,0,0,1
6314835,6316292,1457,0,0,1,2
6314836,6316292,1456,0,0,1,1
6316293,6316381,88,1,0,0,2
6316293,6316389,96,1,0,0,1
6316382,6316461,79,0,0,1,2
6316390,6316461,71,0,0,1,1
6316462,6316498,36,1,0,0,2
6316462,6316501,39,1,0,0,1
6316499,6316582,83,0,0,1,2
6316502,6316581,79,0,0,1,1
6316582,6316629,47,1,0,0,1
6316583,6316618,35,1,0,0,2
6316619,6316821,202,0,0,1,2
6316630,6316823,193,0,0,1,1
6316822,6316851,29,1,0,0,2
6316824,6316852,28,1,0,0,1
6316852,6318064,1212,0,0,1,2
6316853,6318064,1211,0,0,1,1
6318065,6318152,87,1,0,0,1
6318065,6318163,98,1,0,0,2
6318153,6318264,111,0,0,1,1
6318164,6318263,99,0,0,1,2
6318264,6318305,41,1,0,0,2
6318265,6318308,43,1,0,0,1
6318306,6319701,1395,0,0,1,2
6318309,6319699,1390,0,0,1,1
6319700,6319759,59,1,0,0,1
6319702,6319759,57,1,0,0,2
6319760,6319894,134,0,0,1,2
6319760,6319897,137,0,0,1,1
6319895,6319927,32,1,0,0,2
6319898,6319928,30,1,0,0,1
6319928,6321538,1610,0,0,1,2
6319929,6321536,1607,0,0,1,1
6321537,6321632,95,1,0,0,1
6321539,6321633,94,1,0,0,2
6321633,6321683,50,0,0,1,1
6321634,6321683,49,0,0,1,2
6321684,6321723,39,1,0,0,2
6321684,6321740,56,1,0,0,1
6321724,6321797,73,0,0,1,2
6321741,6321799,58,0,0,1,1
6321798,6321835,37,1,0,0,2
6321800,6321834,34,1,0,0,1
6321835,6323209,1374,0,0,1,1
6321836,6323207,1371,0,0,1,2
6323208,6323283,75,1,0,0,2
6323210,6323296,86,1,0,0,1
6323284,6323419,135,0,0,1,2
6323297,6323422,125,0,0,1,1
6323420,6323458,38,1,0,0,2
6323423,6323529,106,1,0,0,1
6323459,6324809,1350,0,0,1,2
6323530,6323566,36,0,0,1,1
6323567,6323579,12,1,0,0,1
6323580,6324808,1228,0,0,1,1
6324809,6324910,101,1,0,0,1
6324810,6324881,71,1,0,0,2
6324882,6324937,55,0,0,1,2
6324911,6324938,27,0,0,1,1
6324938,6324978,40,1,0,0,2
6324939,6324990,51,1,0,0,1
6324979,6325090,111,0,0,1,2
6324991,6325089,98,0,0,1,1
6325090,6325133,43,1,0,0,1
6325091,6325125,34,1,0,0,2
6325126,6326489,1363,0,0,1,2
6325134,6326491,1357,0,0,1,1
6326490,6326594,104,1,0,0,2
6326492,6326588,96,1,0,0,1
6326589,6326709,120,0,0,1,1
6326595,6326707,112,0,0,1,2
6326708,6326746,38,1,0,0,2
6326710,6326730,20,1,0,0,1
6326731,6328121,1390,0,0,1,1
6326747,6328122,1375,0,0,1,2
6328122,6328184,62,1,0,0,1
6328123,6328196,73,1,0,0,2
6328185,6329914,1729,0,0,1,1
6328197,6329914,1717,0,0,1,2
6329915,6330034,119,1,0,0,1
6329915,6330034,119,1,0,0,2
6330035,6330166,131,0,0,1,1
6330035,6330168,133,0,0,1,2
6330167,6330206,39,1,0,0,1
6330169,6330206,37,1,0,0,2
6330207,6331539,1332,0,0,1,2
6330207,6331541,1334,0,0,1,1
6331540,6331629,89,1,0,0,2
6331542,6331630,88,1,0,0,1
6331630,6331723,93,0,0,1,2
6331631,6331722,91,0,0,1,1
6331723,6331772,49,1,0,0,1
6331724,6331770,46,1,0,0,2
6331771,6331900,129,0,0,1,2
6331773,6331901,128,0,0,1,1
6331901,6331931,30,1,0,0,2
6331902,6331932,30,1,0,0,1
6331932,6333229,1297,0,0,1,2
6331933,6333229,1296,0,0,1,1
6333230,6333297,67,1,0,0,1
6333230,6333300,70,1,0,0,2
6333298,6333404,106,0,0,1,1
6333301,6333405,104,0,0,1,2
6333405,6333438,33,1,0,0,1
6333406,6333445,39,1,0,0,2
6333439,6334485,1046,0,0,1,1
6333446,6334478,1032,0,0,1,2
6334479,6334685,206,1,0,0,2
6334486,6334638,152,1,0,0,1
6334516,6334616,100,0,1,0,2
6334533,6334587,54,0,1,0,1
6334639,6334810,171,0,0,1,1
6334686,6334811,125,0,0,1,2
6334811,6334874,63,1,0,0,1
6334812,6334884,72,1,0,0,2
6334875,6335007,132,0,0,1,1
6334885,6335007,122,0,0,1,2
6335008,6335036,28,1,0,0,2
6335008,6335038,30,1,0,0,1
6335037,6336446,1409,0,0,1,2
6335039,6336446,1407,0,0,1,1
6336447,6336527,80,1,0,0,1
6336447,6336529,82,1,0,0,2
6336528,6336598,70,0,0,1,1
6336530,6336597,67,0,0,1,2
6336598,6336638,40,1,0,0,2
6336599,6336637,38,1,0,0,1
6336638,6336939,301,0,0,1,1
6336639,6336937,298,0,0,1,2
6336938,6336957,19,1,0,0,2
6336940,6336966,26,1,0,0,1
6336958,6338069,1111,0,0,1,2
6336967,6338070,1103,0,0,1,1
6338070,6338182,112,1,0,0,2
6338071,6338184,113,1,0,0,1
6338183,6338208,25,0,0,1,2
6338185,6338208,23,0,0,1,1
6338209,6338303,94,1,0,0,2
6338209,6338307,98,1,0,0,1
6338304,6338431,127,0,0,1,2
6338308,6338432,124,0,0,1,1
6338432,6338466,34,1,0,0,2
6338433,6338469,36,1,0,0,1
6338467,6339822,1355,0,0,1,2
6338470,6339533,1063,0,0,1,1
6339534,6339540,6,1,0,0,1
6339541,6339821,280,0,0,1,1
6339822,6339918,96,1,0,0,1
6339823,6339920,97,1,0,0,2
6339919,6340015,96,0,0,1,1
6339921,6340015,94,0,0,1,2
6340016,6340058,42,1,0,0,1
6340016,6340067,51,1,0,0,2
6340059,6341527,1468,0,0,1,1
6340068,6341527,1459,0,0,1,2
6341528,6341635,107,1,0,0,1
6341528,6341636,108,1,0,0,2
6341636,6341725,89,0,0,1,1
6341637,6341728,91,0,0,1,2
6341726,6341758,32,1,0,0,1
6341729,6341750,21,1,0,0,2
6341751,6341877,126,0,0,1,2
6341759,6341879,120,0,0,1,1
6341878,6341896,18,1,0,0,2
6341880,6341909,29,1,0,0,1
6341897,6343156,1259,0,0,1,2
6341910,6343155,1245,0,0,1,1
6343156,6343243,87,1,0,0,1
6343157,6343240,83,1,0,0,2
6343241,6343357,116,0,0,1,2
6343244,6343356,112,0,0,1,1
6343357,6343395,38,1,0,0,1
6343358,6343393,35,1,0,0,2
6343394,6344804,1410,0,0,1,2
6343396,6344804,1408,0,0,1,1
6344805,6344889,84,1,0,0,2
6344805,6344899,94,1,0,0,1
6344890,6344989,99,0,0,1,2
6344900,6344988,88,0,0,1,1
6344989,6345032,43,1,0,0,1
6344990,6345029,39,1,0,0,2
6345030,6345207,177,0,0,1,2
6345033,6345214,181,0,0,1,1
6345208,6345229,21,1,0,0,2
6345215,6345225,10,1,0,0,1
6345226,6346196,970,0,0,1,1
6345230,6346195,965,0,0,1,2
6346196,6346282,86,1,0,0,2
6346197,6346284,87,1,0,0,1
6346283,6346485,202,0,0,1,2
6346285,6346487,202,0,0,1,1
6346486,6346563,77,1,0,0,2
6346488,6346578,90,1,0,0,1
6346564,6346610,46,0,0,1,2
6346579,6346606,27,0,0,1,1
6346607,6346651,44,1,0,0,1
6346611,6346651,40,1,0,0,2
6346652,6346811,159,0,0,1,1
6346652,6346817,165,0,0,1,2
6346812,6346833,21,1,0,0,1
6346818,6346828,10,1,0,0,2
6346829,6348130,1301,0,0,1,2
6346834,6347796,962,0,0,1,1
6347797,6347812,15,1,0,0,1
6347813,6348129,316,0,0,1,1
6348130,6348216,86,1,0,0,1
6348131,6348213,82,1,0,0,2
6348214,6348268,54,0,0,1,2
6348217,6348269,52,0,0,1,1
6348269,6348307,38,1,0,0,2
6348270,6348321,51,1,0,0,1
6348308,6348407,99,0,0,1,2
6348322,6348404,82,0,0,1,1
6348405,6348442,37,1,0,0,1
6348408,6348441,33,1,0,0,2
6348442,6348662,220,0,0,1,2
6348443,6348658,215,0,0,1,1
6348659,6348689,30,1,0,0,1
6348663,6348687,24,1,0,0,2
6348688,6349347,659,0,0,1,2
6348690,6349348,658,0,0,1,1
6349348,6349527,179,1,0,0,2
6349349,6349518,169,1,0,0,1
6349387,6349468,81,0,1,0,1
6349395,6349444,49,0,1,0,2
6349519,6349739,220,0,0,1,1
6349528,6349738,210,0,0,1,2
6349739,6349815,76,1,0,0,2
6349740,6349804,64,1,0,0,1
6349805,6349898,93,0,0,1,1
6349816,6349897,81,0,0,1,2
6349898,6349945,47,1,0,0,2
6349899,6349937,38,1,0,0,1
6349938,6350226,288,0,0,1,1
6349946,6350202,256,0,0,1,2
6350203,6350215,12,1,0,0,2
6350216,6350952,736,0,0,1,2
6350227,6350284,57,1,0,0,1
6350285,6350962,677,0,0,1,1
6350953,6351118,165,1,0,0,2
6350963,6351112,149,1,0,0,1
6350999,6351058,59,0,1,0,1
6351006,6351040,34,0,1,0,2
6351113,6351458,345,0,0,1,1
6351119,6351458,339,0,0,1,2
6351459,6351548,89,1,0,0,1
6351459,6351558,99,1,0,0,2
6351549,6351676,127,0,0,1,1
6351559,6351676,117,0,0,1,2
6351677,6351713,36,1,0,0,1
6351677,6351714,37,1,0,0,2
6351714,6354822,3108,0,0,1,1
6351715,6351969,254,0,0,1,2
6351970,6351981,11,1,0,0,2
6351982,6354823,2841,0,0,1,2
6354823,6354883,60,1,0,0,1
6354824,6354880,56,1,0,0,2
6354881,6354999,118,0,0,1,2
6354884,6355000,116,0,0,1,1
6355000,6355029,29,1,0,0,2
6355001,6355032,31,1,0,0,1
6355030,6356885,1855,0,0,1,2
6355033,6356890,1857,0,0,1,1
6356886,6356902,16,1,0,0,2
6356891,6356901,10,1,0,0,1
6356902,6356936,34,0,0,1,1
6356903,6356940,37,0,0,1,2
6356937,6357134,197,1,0,0,1
6356941,6357107,166,1,0,0,2
6356964,6357102,138,0,1,0,1
6356972,6357066,94,0,1,0,2
6357108,6357471,363,0,0,1,2
6357135,6357470,335,0,0,1,1
6357471,6357524,53,1,0,0,1
6357472,6357508,36,1,0,0,2
6357509,6358195,686,0,0,1,2
6357525,6358196,671,0,0,1,1
6358196,6358253,57,1,0,0,2
6358197,6358242,45,1,0,0,1
6358243,6358473,230,0,0,1,1
6358254,6358472,218,0,0,1,2
6358473,6358540,67,1,0,0,2
6358474,6358530,56,1,0,0,1
6358531,6358616,85,0,0,1,1
6358541,6358615,74,0,0,1,2
6358616,6358649,33,1,0,0,2
6358617,6358648,31,1,0,0,1
6358649,6358819,170,0,0,1,1
6358650,6358818,168,0,0,1,2
6358819,6358829,10,1,0,0,2
6358820,6358824,4,1,0,0,1
6358825,6359690,865,0,0,1,1
6358830,6359689,859,0,0,1,2
6359690,6359731,41,1,0,0,2
6359691,6359737,46,1,0,0,1
6359732,6360281,549,0,0,1,2
6359738,6360284,546,0,0,1,1
6360282,6360295,13,1,0,0,2
6360285,6360297,12,1,0,0,1
6360296,6361756,1460,0,0,1,2
6360298,6361755,1457,0,0,1,1
6361756,6362016,260,1,0,0,1
6361757,6361967,210,1,0,0,2
6361781,6361960,179,0,1,0,1
6361786,6361916,130,0,1,0,2
6361968,6362478,510,0,0,1,2
6362017,6362478,461,0,0,1,1
6362479,6362515,36,1,0,0,2
6362479,6362517,38,1,0,0,1
6362516,6362926,410,0,0,1,2
6362518,6362927,409,0,0,1,1
6362927,6362992,65,1,0,0,2
6362928,6362997,69,1,0,0,1
6362993,6363176,183,0,0,1,2
6362998,6363172,174,0,0,1,1
6363173,6363189,16,1,0,0,1
6363177,6363186,9,1,0,0,2
6363187,6364799,1612,0,0,1,2
6363190,6364800,1610,0,0,1,1
6364800,6364848,48,1,0,0,2
6364801,6364844,43,1,0,0,1
6364845,6365022,177,0,0,1,1
6364849,6365026,177,0,0,1,2
6365023,6365041,18,1,0,0,1
6365027,6365040,13,1,0,0,2
6365041,6366938,1897,0,0,1,2
6365042,6366939,1897,0,0,1,1
6366939,6367190,251,1,0,0,2
6366940,6367221,281,1,0,0,1
6366970,6367141,171,0,1,0,2
6366971,6367171,200,0,1,0,1
6367191,6368865,1674,0,0,1,2
6367222,6368866,1644,0,0,1,1
6368866,6368924,58,1,0,0,2
6368867,6368925,58,1,0,0,1
6368925,6370313,1388,0,0,1,2
6368926,6370314,1388,0,0,1,1
6370314,6370363,49,1,0,0,2
6370315,6370361,46,1,0,0,1
6370362,6372449,2087,0,0,1,1
6370364,6372445,2081,0,0,1,2
6372446,6372626,180,1,0,0,2
6372450,6372635,185,1,0,0,1
6372485,6372595,110,0,1,0,1
6372486,6372562,76,0,1,0,2
6372627,6372959,332,0,0,1,2
6372636,6372961,325,0,0,1,1
6372960,6373021,61,1,0,0,2
6372962,6373024,62,1,0,0,1
6373022,6373302,280,0,0,1,2
6373025,6373301,276,0,0,1,1
6373302,6373349,47,1,0,0,1
6373303,6373360,57,1,0,0,2
6373350,6373587,237,0,0,1,1
6373361,6373587,226,0,0,1,2
6373588,6373664,76,1,0,0,2
6373588,6373676,88,1,0,0,1
6373665,6373812,147,0,0,1,2
6373677,6373811,134,0,0,1,1
6373812,6373845,33,1,0,0,1
6373813,6373843,30,1,0,0,2
6373844,6375469,1625,0,0,1,2
6373846,6375460,1614,0,0,1,1
6375461,6375543,82,1,0,0,1
6375470,6375541,71,1,0,0,2
6375542,6375678,136,0,0,1,2
6375544,6375678,134,0,0,1,1
6375679,6375697,18,1,0,0,1
6375679,6375711,32,1,0,0,2
6375698,6377550,1852,0,0,1,1
6375712,6377550,1838,0,0,1,2
6377551,6377739,188,1,0,0,2
6377551,6377784,233,1,0,0,1
6377613,6377697,84,0,1,0,1
6377617,6377676,59,0,1,0,2
6377740,6377777,37,0,0,1,2
6377778,6377784,6,1,0,0,2
6377785,6378030,245,0,0,1,1
6377785,6378030,245,0,0,1,2
6378031,6378115,84,1,0,0,1
6378031,6378115,84,1,0,0,2
6378116,6378344,228,0,0,1,2
6378116,6378345,229,0,0,1,1
6378345,6378390,45,1,0,0,2
6378346,6378387,41,1,0,0,1
6378388,6378582,194,0,0,1,1
6378391,6378583,192,0,0,1,2
6378583,6378610,27,1,0,0,1
6378584,6378609,25,1,0,0,2
6378610,6378822,212,0,0,1,2
6378611,6378822,211,0,0,1,1
6378823,6378900,77,1,0,0,1
6378823,6378900,77,1,0,0,2
6378901,6379096,195,0,0,1,2
6378901,6379097,196,0,0,1,1
6379097,6379171,74,1,0,0,2
6379098,6379169,71,1,0,0,1
6379170,6379338,168,0,0,1,1
6379172,6379337,165,0,0,1,2
6379338,6379408,70,1,0,0,2
6379339,6379398,59,1,0,0,1
6379399,6379509,110,0,0,1,1
6379409,6379507,98,0,0,1,2
6379508,6379551,43,1,0,0,2
6379510,6379542,32,1,0,0,1
6379543,6381098,1555,0,0,1,1
6379552,6381099,1547,0,0,1,2
6381099,6381170,71,1,0,0,1
6381100,6381167,67,1,0,0,2
6381168,6383169,2001,0,0,1,2
6381171,6381323,152,0,0,1,1
6381324,6381338,14,1,0,0,1
6381339,6383166,1827,0,0,1,1
6383167,6383191,24,1,0,0,1
6383170,6383182,12,1,0,0,2
6383183,6383294,111,0,0,1,2
6383192,6383291,99,0,0,1,1
6383292,6383466,174,1,0,0,1
6383295,6383445,150,1,0,0,2
6383327,6383393,66,0,1,0,1
6383346,6383366,20,0,1,0,2
6383446,6383591,145,0,0,1,2
6383467,6383591,124,0,0,1,1
6383592,6383753,161,1,0,0,2
6383592,6383800,208,1,0,0,1
6383614,6383743,129,0,1,0,1
6383624,6383700,76,0,1,0,2
6383754,6383902,148,0,0,1,2
6383801,6383900,99,0,0,1,1
6383901,6383964,63,1,0,0,1
6383903,6383964,61,1,0,0,2
6383965,6384115,150,0,0,1,1
6383965,6384115,150,0,0,1,2
6384116,6384168,52,1,0,0,2
6384116,6384179,63,1,0,0,1
6384169,6384607,438,0,0,1,2
6384180,6384607,427,0,0,1,1
6384608,6384646,38,1,0,0,2
6384608,6384657,49,1,0,0,1
6384647,6384740,93,0,0,1,2
6384658,6384741,83,0,0,1,1
6384741,6384828,87,1,0,0,2
6384742,6384821,79,1,0,0,1
6384822,6384949,127,0,0,1,1
6384829,6384947,118,0,0,1,2
6384948,6384988,40,1,0,0,2
6384950,6384978,28,1,0,0,1
6384979,6386735,1756,0,0,1,1
6384989,6386736,1747,0,0,1,2
6386736,6386808,72,1,0,0,1
6386737,6386794,57,1,0,0,2
6386795,6386929,134,0,0,1,2
6386809,6386930,121,0,0,1,1
6386930,6386946,16,1,0,0,2
6386931,6386946,15,1,0,0,1
6386947,6388864,1917,0,0,1,1
6386947,6388864,1917,0,0,1,2
6388865,6389129,264,1,0,0,2
6388865,6389165,300,1,0,0,1
6388913,6389127,214,0,1,0,1
6388916,6389087,171,0,1,0,2
6389130,6389329,199,0,0,1,2
6389166,6389330,164,0,0,1,1
6389330,6389383,53,1,0,0,2
6389331,6389382,51,1,0,0,1
6389383,6389691,308,0,0,1,1
6389384,6389692,308,0,0,1,2
6389692,6389770,78,1,0,0,1
6389693,6389767,74,1,0,0,2
6389768,6390068,300,0,0,1,2
6389771,6390067,296,0,0,1,1
6390068,6390122,54,1,0,0,1
6390069,6390113,44,1,0,0,2
6390114,6390357,243,0,0,1,2
6390123,6390359,236,0,0,1,1
6390358,6390438,80,1,0,0,2
6390360,6390440,80,1,0,0,1
6390439,6390565,126,0,0,1,2
6390441,6390567,126,0,0,1,1
6390566,6390626,60,1,0,0,2
6390568,6390616,48,1,0,0,1
6390617,6390688,71,0,0,1,1
6390627,6390688,61,0,0,1,2
6390689,6390755,66,1,0,0,1
6390689,6390756,67,1,0,0,2
6390756,6390885,129,0,0,1,1
6390757,6390882,125,0,0,1,2
6390883,6390912,29,1,0,0,2
6390886,6390917,31,1,0,0,1
6390913,6392080,1167,0,0,1,2
6390918,6392081,1163,0,0,1,1
6392081,6392136,55,1,0,0,2
6392082,6392139,57,1,0,0,1
6392137,6394141,2004,0,0,1,2
6392140,6394142,2002,0,0,1,1
6394142,6394457,315,1,0,0,2
6394143,6394477,334,1,0,0,1
6394199,6394445,246,0,1,0,1
6394204,6394403,199,0,1,0,2
6394458,6394897,439,0,0,1,2
6394478,6394898,420,0,0,1,1
6394898,6394951,53,1,0,0,2
6394899,6394951,52,1,0,0,1
6394952,6395083,131,0,0,1,1
6394952,6395086,134,0,0,1,2
6395084,6395122,38,1,0,0,1
6395087,6395102,15,1,0,0,2
6395103,6395234,131,0,0,1,2
6395123,6395455,332,0,0,1,1
6395235,6395252,17,1,0,0,2
6395253,6395453,200,0,0,1,2
6395454,6395513,59,1,0,0,2
6395456,6395522,66,1,0,0,1
6395514,6395619,105,0,0,1,2
6395523,6395620,97,0,0,1,1
6395620,6395659,39,1,0,0,2
6395621,6395669,48,1,0,0,1
6395660,6395910,250,0,0,1,2
6395670,6395907,237,0,0,1,1
6395908,6395927,19,1,0,0,1
6395911,6395930,19,1,0,0,2
6395928,6396764,836,0,0,1,1
6395931,6396765,834,0,0,1,2
6396765,6396833,68,1,0,0,1
6396766,6396827,61,1,0,0,2
6396828,6396988,160,0,0,1,2
6396834,6396988,154,0,0,1,1
6396989,6397018,29,1,0,0,1
6396989,6397024,35,1,0,0,2
6397019,6397108,89,0,0,1,1
6397025,6397111,86,0,0,1,2
6397109,6397144,35,1,0,0,1
6397112,6397138,26,1,0,0,2
6397139,6397432,293,0,0,1,2
6397145,6397429,284,0,0,1,1
6397430,6397448,18,1,0,0,1
6397433,6397445,12,1,0,0,2
6397446,6398020,574,0,0,1,2
6397449,6398018,569,0,0,1,1
6398019,6398033,14,1,0,0,1
6398021,6398034,13,1,0,0,2
6398034,6398981,947,0,0,1,1
6398035,6398988,953,0,0,1,2
6398982,6399141,159,1,0,0,1
6398989,6399152,163,1,0,0,2
6399025,6399096,71,0,1,0,1
6399032,6399079,47,0,1,0,2
6399142,6399999,857,0,0,1,1
6399153,6399999,846,0,0,1,2
6400000,6400071,71,1,0,0,1
6400000,6400074,74,1,0,0,2
6400072,6400157,85,0,0,1,1
6400075,6400158,83,0,0,1,2
6400158,6400196,38,1,0,0,1
6400159,6400193,34,1,0,0,2
6400194,6400409,215,0,0,1,2
6400197,6400408,211,0,0,1,1
6400409,6400430,21,1,0,0,1
6400410,6400431,21,1,0,0,2
6400431,6401857,1426,0,0,1,1
6400432,6401856,1424,0,0,1,2
6401857,6401908,51,1,0,0,2
6401858,6401917,59,1,0,0,1
6401909,6404047,2138,0,0,1,2
6401918,6404060,2142,0,0,1,1
6404048,6404218,170,1,0,0,2
6404061,6404215,154,1,0,0,1
6404086,6404166,80,0,1,0,2
6404088,6404167,79,0,1,0,1
6404216,6405457,1241,0,0,1,1
6404219,6405457,1238,0,0,1,2
6405458,6405534,76,1,0,0,2
6405458,6405582,124,1,0,0,1
6405535,6405671,136,0,0,1,2
6405583,6405669,86,0,0,1,1
6405670,6405713,43,1,0,0,1
6405672,6405711,39,1,0,0,2
6405712,6405925,213,0,0,1,2
6405714,6405933,219,0,0,1,1
6405926,6405938,12,1,0,0,2
6405934,6405938,4,1,0,0,1
6405939,6407143,1204,0,0,1,2
6405939,6407144,1205,0,0,1,1
6407144,6407192,48,1,0,0,2
6407145,6407196,51,1,0,0,1
6407193,6409330,2137,0,0,1,2
6407197,6409340,2143,0,0,1,1
6409331,6409535,204,1,0,0,2
6409341,6409556,215,1,0,0,1
6409379,6409509,130,0,1,0,1
6409382,6409477,95,0,1,0,2
6409536,6410663,1127,0,0,1,2
6409557,6410663,1106,0,0,1,1
6410664,6410725,61,1,0,0,1
6410664,6410727,63,1,0,0,2
6410726,6410890,164,0,0,1,1
6410728,6410893,165,0,0,1,2
6410891,6410957,66,1,0,0,1
6410894,6410922,28,1,0,0,2
6410923,6412178,1255,0,0,1,2
6410958,6411416,458,0,0,1,1
6411417,6411433,16,1,0,0,1
6411434,6412179,745,0,0,1,1
6412179,6412241,62,1,0,0,2
6412180,6412242,62,1,0,0,1
6412242,6414433,2191,0,0,1,2
6412243,6414431,2188,0,0,1,1
6414432,6414671,239,1,0,0,1
6414434,6414627,193,1,0,0,2
6414459,6414625,166,0,1,0,1
6414465,6414579,114,0,1,0,2
6414628,6415248,620,0,0,1,2
6414672,6415249,577,0,0,1,1
6415249,6415277,28,1,0,0,2
6415250,6415271,21,1,0,0,1
6415272,6415721,449,0,0,1,1
6415278,6415722,444,0,0,1,2
6415722,6415788,66,1,0,0,1
6415723,6415793,70,1,0,0,2
6415789,6416031,242,0,0,1,1
6415794,6416032,238,0,0,1,2
6416032,6416044,12,1,0,0,1
6416033,6416044,11,1,0,0,2
6416045,6416306,261,0,0,1,2
6416045,6417829,1784,0,0,1,1
6416307,6416315,8,1,0,0,2
6416316,6417828,1512,0,0,1,2
6417829,6417877,48,1,0,0,2
6417830,6417880,50,1,0,0,1
6417878,6420047,2169,0,0,1,2
6417881,6420044,2163,0,0,1,1
6420045,6420249,204,1,0,0,1
6420048,6420224,176,1,0,0,2
6420068,6420209,141,0,1,0,1
6420071,6420172,101,0,1,0,2
6420225,6421373,1148,0,0,1,2
6420250,6421374,1124,0,0,1,1
6421374,6421428,54,1,0,0,2
6421375,6421428,53,1,0,0,1
6421429,6421698,269,0,0,1,1
6421429,6421698,269,0,0,1,2
6421699,6421703,4,1,0,0,2
6421699,6421704,5,1,0,0,1
6421704,6423231,1527,0,0,1,2
6421705,6423232,1527,0,0,1,1
6423232,6423302,70,1,0,0,2
6423233,6423303,70,1,0,0,1
6423303,6423400,97,0,0,1,2
6423304,6423399,95,0,0,1,1
6423400,6423437,37,1,0,0,1
6423401,6423438,37,1,0,0,2
6423438,6425345,1907,0,0,1,1
6423439,6425342,1903,0,0,1,2
6425343,6425533,190,1,0,0,2
6425346,6425545,199,1,0,0,1
6425390,6425469,79,0,1,0,1
6425393,6425460,67,0,1,0,2
6425534,6426323,789,0,0,1,2
6425546,6426324,778,0,0,1,1
6426324,6426387,63,1,0,0,2
6426325,6426387,62,1,0,0,1
6426388,6427015,627,0,0,1,1
6426388,6427015,627,0,0,1,2
6427016,6427082,66,1,0,0,2
6427016,6427092,76,1,0,0,1
6427083,6427236,153,0,0,1,2
6427093,6427235,142,0,0,1,1
6427236,6427298,62,1,0,0,1
6427237,6427296,59,1,0,0,2
6427297,6427485,188,0,0,1,2
6427299,6428652,1353,0,0,1,1
6427486,6427497,11,1,0,0,2
6427498,6428652,1154,0,0,1,2
6428653,6428703,50,1,0,0,1
6428653,6428708,55,1,0,0,2
6428704,6430839,2135,0,0,1,1
6428709,6430830,2121,0,0,1,2
6430831,6431005,174,1,0,0,2
6430840,6431036,196,1,0,0,1
6430858,6430963,105,0,1,0,2
6430859,6430992,133,0,1,0,1
6431006,6432115,1109,0,0,1,2
6431037,6432116,1079,0,0,1,1
6432116,6432197,81,1,0,0,2
6432117,6432215,98,1,0,0,1
6432198,6432296,98,0,0,1,2
6432216,6432295,79,0,0,1,1
6432296,6432333,37,1,0,0,1
6432297,6432332,35,1,0,0,2
6432333,6432528,195,0,0,1,2
6432334,6432524,190,0,0,1,1
6432525,6432558,33,1,0,0,1
6432529,6432556,27,1,0,0,2
6432557,6433707,1150,0,0,1,2
6432559,6433169,610,0,0,1,1
6433170,6433179,9,1,0,0,1
6433180,6433706,526,0,0,1,1
6433707,6433773,66,1,0,0,1
6433708,6433774,66,1,0,0,2
6433774,6433942,168,0,0,1,1
6433775,6433946,171,0,0,1,2
6433943,6433963,20,1,0,0,1
6433947,6433961,14,1,0,0,2
6433962,6435836,1874,0,0,1,2
6433964,6435837,1873,0,0,1,1
6435837,6436010,173,1,0,0,2
6435838,6436045,207,1,0,0,1
6435873,6435981,108,0,1,0,1
6435880,6435955,75,0,1,0,2
6436011,6436329,318,0,0,1,2
6436046,6436329,283,0,0,1,1
6436330,6436393,63,1,0,0,1
6436330,6436393,63,1,0,0,2
6436394,6437267,873,0,0,1,1
6436394,6437269,875,0,0,1,2
6437268,6437373,105,1,0,0,1
6437270,6437346,76,1,0,0,2
6437347,6437634,287,0,0,1,2
6437374,6437624,250,0,0,1,1
6437625,6437663,38,1,0,0,1
6437635,6437657,22,1,0,0,2
6437658,6438737,1079,0,0,1,2
6437664,6438741,1077,0,0,1,1
6438738,6438807,69,1,0,0,2
6438742,6438824,82,1,0,0,1
6438808,6438947,139,0,0,1,2
6438825,6438945,120,0,0,1,1
6438946,6438982,36,1,0,0,1
6438948,6438980,32,1,0,0,2
6438981,6440835,1854,0,0,1,2
6438983,6440835,1852,0,0,1,1
6440836,6441050,214,1,0,0,2
6440836,6441069,233,1,0,0,1
6440870,6440986,116,0,1,0,2
6440875,6441022,147,0,1,0,1
6441051,6441449,398,0,0,1,2
6441070,6441449,379,0,0,1,1
6441450,6441480,30,1,0,0,2
6441450,6441483,33,1,0,0,1
6441481,6442293,812,0,0,1,2
6441484,6442294,810,0,0,1,1
6442294,6442358,64,1,0,0,2
6442295,6442361,66,1,0,0,1
6442359,6442488,129,0,0,1,2
6442362,6442488,126,0,0,1,1
6442489,6442512,23,1,0,0,1
6442489,6442524,35,1,0,0,2
6442513,6444226,1713,0,0,1,1
6442525,6444226,1701,0,0,1,2
6444227,6444284,57,1,0,0,2
6444227,6444294,67,1,0,0,1
6444285,6446449,2164,0,0,1,2
6444295,6446452,2157,0,0,1,1
6446450,6446655,205,1,0,0,2
6446453,6446694,241,1,0,0,1
6446480,6446657,177,0,1,0,1
6446484,6446597,113,0,1,0,2
6446656,6447297,641,0,0,1,2
6446695,6447298,603,0,0,1,1
6447298,6447342,44,1,0,0,2
6447299,6447343,44,1,0,0,1
6447343,6448287,944,0,0,1,2
6447344,6448288,944,0,0,1,1
6448288,6448354,66,1,0,0,2
6448289,6448357,68,1,0,0,1
6448355,6448460,105,0,0,1,2
6448358,6448461,103,0,0,1,1
6448461,6448499,38,1,0,0,2
6448462,6448497,35,1,0,0,1
6448498,6448748,250,0,0,1,1
6448500,6448749,249,0,0,1,2
6448749,6448758,9,1,0,0,1
6448750,6448756,6,1,0,0,2
6448757,6450026,1269,0,0,1,2
6448759,6450027,1268,0,0,1,1
6450027,6450076,49,1,0,0,2
6450028,6450087,59,1,0,0,1
6450077,6452249,2172,0,0,1,2
6450088,6452255,2167,0,0,1,1
6452250,6452461,211,1,0,0,2
6452256,6452498,242,1,0,0,1
6452276,6452408,132,0,1,0,2
6452276,6452440,164,0,1,0,1
6452462,6453952,1490,0,0,1,2
6452499,6453953,1454,0,0,1,1
6453953,6454015,62,1,0,0,2
6453954,6454032,78,1,0,0,1
6454016,6454195,179,0,0,1,2
6454033,6454190,157,0,0,1,1
6454191,6454233,42,1,0,0,1
6454196,6454224,28,1,0,0,2
6454225,6456161,1936,0,0,1,2
6454234,6456161,1927,0,0,1,1
6456162,6456230,68,1,0,0,2
6456162,6456233,71,1,0,0,1
6456231,6458372,2141,0,0,1,2
6456234,6458374,2140,0,0,1,1
6458373,6458537,164,1,0,0,2
6458375,6458525,150,1,0,0,1
6458420,6458464,44,0,1,0,1
6458426,6458455,29,0,1,0,2
6458526,6460264,1738,0,0,1,1
6458538,6460263,1725,0,0,1,2
6460264,6460329,65,1,0,0,2
6460265,6460369,104,1,0,0,1
6460330,6460476,146,0,0,1,2
6460370,6460476,106,0,0,1,1
6460477,6460507,30,1,0,0,1
6460477,6460507,30,1,0,0,2
6460508,6462348,1840,0,0,1,2
6460508,6462349,1841,0,0,1,1
6462349,6462398,49,1,0,0,2
6462350,6462416,66,1,0,0,1
6462399,6462711,312,0,0,1,2
6462417,6462713,296,0,0,1,1
6462712,6462733,21,1,0,0,2
6462714,6462741,27,1,0,0,1
6462734,6465424,2690,0,0,1,2
6462742,6465441,2699,0,0,1,1
6465425,6465597,172,1,0,0,2
6465442,6465593,151,1,0,0,1
6465465,6465557,92,0,1,0,1
6465466,6465543,77,0,1,0,2
6465594,6466018,424,0,0,1,1
6465598,6466017,419,0,0,1,2
6466018,6466076,58,1,0,0,2
6466019,6466077,58,1,0,0,1
6466077,6467649,1572,0,0,1,2
6466078,6467650,1572,0,0,1,1
6467650,6467708,58,1,0,0,2
6467651,6467718,67,1,0,0,1
6467709,6469847,2138,0,0,1,2
6467719,6469848,2129,0,0,1,1
6469848,6470003,155,1,0,0,2
6469849,6469995,146,1,0,0,1
6469882,6469951,69,0,1,0,1
6469886,6469937,51,0,1,0,2
6469996,6471370,1374,0,0,1,1
6470004,6471368,1364,0,0,1,2
6471369,6471454,85,1,0,0,2
6471371,6471440,69,1,0,0,1
6471441,6471541,100,0,0,1,1
6471455,6471541,86,0,0,1,2
6471542,6471565,23,1,0,0,1
6471542,6471579,37,1,0,0,2
6471566,6471723,157,0,0,1,1
6471580,6471722,142,0,0,1,2
6471723,6471756,33,1,0,0,2
6471724,6471746,22,1,0,0,1
6471747,6473196,1449,0,0,1,1
6471757,6473197,1440,0,0,1,2
6473197,6473248,51,1,0,0,1
6473198,6473252,54,1,0,0,2
6473249,6473376,127,0,0,1,1
6473253,6473375,122,0,0,1,2
6473376,6473402,26,1,0,0,2
6473377,6473400,23,1,0,0,1
6473401,6475310,1909,0,0,1,1
6473403,6475309,1906,0,0,1,2
6475310,6475482,172,1,0,0,2
6475311,6475502,191,1,0,0,1
6475342,6475442,100,0,1,0,2
6475343,6475465,122,0,1,0,1
6475483,6476206,723,0,0,1,2
6475503,6476206,703,0,0,1,1
6476207,6476240,33,1,0,0,2
6476207,6476249,42,1,0,0,1
6476241,6477019,778,0,0,1,2
6476250,6477020,770,0,0,1,1
6477020,6477138,118,1,0,0,2
6477021,6477139,118,1,0,0,1
6477139,6477277,138,0,0,1,2
6477140,6477278,138,0,0,1,1
6477278,6477299,21,1,0,0,2
6477279,6477315,36,1,0,0,1
6477300,6477473,173,0,0,1,2
6477316,6477471,155,0,0,1,1
6477472,6477499,27,1,0,0,1
6477474,6477489,15,1,0,0,2
6477490,6478362,872,0,0,1,2
6477500,6478361,861,0,0,1,1
6478362,6478426,64,1,0,0,1
6478363,6478424,61,1,0,0,2
6478425,6479384,959,0,0,1,2
6478427,6479385,958,0,0,1,1
6479385,6479396,11,1,0,0,2
6479386,6479412,26,1,0,0,1
6479397,6480460,1063,0,0,1,2
6479413,6480439,1026,0,0,1,1
6480440,6480677,237,1,0,0,1
6480461,6480650,189,1,0,0,2
6480494,6480637,143,0,1,0,1
6480496,6480606,110,0,1,0,2
6480651,6481358,707,0,0,1,2
6480678,6481358,680,0,0,1,1
6481359,6481409,50,1,0,0,2
6481359,6481412,53,1,0,0,1
6481410,6481782,372,0,0,1,2
6481413,6481782,369,0,0,1,1
6481783,6481848,65,1,0,0,2
6481783,6481864,81,1,0,0,1
6481849,6481981,132,0,0,1,2
6481865,6481982,117,0,0,1,1
6481982,6482016,34,1,0,0,2
6481983,6482014,31,1,0,0,1
6482015,6483185,1170,0,0,1,1
6482017,6483185,1168,0,0,1,2
6483186,6483253,67,1,0,0,1
6483186,6483256,70,1,0,0,2
6483254,6485520,2266,0,0,1,1
6483257,6485521,2264,0,0,1,2
6485521,6485694,173,1,0,0,1
6485522,6485671,149,1,0,0,2
6485546,6485648,102,0,1,0,1
6485553,6485620,67,0,1,0,2
6485672,6486288,616,0,0,1,2
6485695,6486288,593,0,0,1,1
6486289,6486348,59,1,0,0,1
6486289,6486359,70,1,0,0,2
6486349,6486756,407,0,0,1,1
6486360,6486757,397,0,0,1,2
6486757,6486840,83,1,0,0,1
6486758,6486826,68,1,0,0,2
6486827,6487034,207,0,0,1,2
6486841,6487033,192,0,0,1,1
6487034,6487062,28,1,0,0,1
6487035,6487061,26,1,0,0,2
6487062,6488277,1215,0,0,1,2
6487063,6488279,1216,0,0,1,1
6488278,6488332,54,1,0,0,2
6488280,6488340,60,1,0,0,1
6488333,6490429,2096,0,0,1,2
6488341,6490429,2088,0,0,1,1
6490430,6490640,210,1,0,0,1
6490430,6490657,227,1,0,0,2
6490475,6490572,97,0,1,0,2
6490477,6490584,107,0,1,0,1
6490641,6491047,406,0,0,1,1
6490658,6491048,390,0,0,1,2
6491048,6491114,66,1,0,0,1
6491049,6491111,62,1,0,0,2
6491112,6491983,871,0,0,1,2
6491115,6491984,869,0,0,1,1
6491984,6492058,74,1,0,0,2
6491985,6492065,80,1,0,0,1
6492059,6492220,161,0,0,1,2
6492066,6492217,151,0,0,1,1
6492218,6492247,29,1,0,0,1
6492221,6492235,14,1,0,0,2
6492236,6493286,1050,0,0,1,2
6492248,6493287,1039,0,0,1,1
6493287,6493350,63,1,0,0,2
6493288,6493350,62,1,0,0,1
6493351,6495446,2095,0,0,1,2
6493351,6495453,2102,0,0,1,1
6495447,6495707,260,1,0,0,2
6495454,6495746,292,1,0,0,1
6495474,6495684,210,0,1,0,1
6495475,6495656,181,0,1,0,2
6495708,6496315,607,0,0,1,2
6495747,6496315,568,0,0,1,1
6496316,6496368,52,1,0,0,1
6496316,6496374,58,1,0,0,2
6496369,6496552,183,0,0,1,1
6496375,6496553,178,0,0,1,2
6496553,6496601,48,1,0,0,1
6496554,6496598,44,1,0,0,2
6496599,6496784,185,0,0,1,2
6496602,6496784,182,0,0,1,1
6496785,6496797,12,1,0,0,1
6496785,6496797,12,1,0,0,2
6496798,6498090,1292,0,0,1,1
6496798,6498090,1292,0,0,1,2
6498091,6498150,59,1,0,0,1
6498091,6498154,63,1,0,0,2
6498151,6498654,503,0,0,1,1
6498155,6498653,498,0,0,1,2
6498654,6498675,21,1,0,0,2
6498655,6498674,19,1,0,0,1
6498675,6500199,1524,0,0,1,1
6498676,6500197,1521,0,0,1,2
6500198,6500439,241,1,0,0,2
6500200,6500430,230,1,0,0,1
6500234,6500395,161,0,1,0,1
6500235,6500374,139,0,1,0,2
6500431,6500575,144,0,0,1,1
6500440,6500574,134,0,0,1,2
6500575,6500643,68,1,0,0,2
6500576,6500644,68,1,0,0,1
6500644,6500973,329,0,0,1,2
6500645,6500972,327,0,0,1,1
6500973,6501038,65,1,0,0,1
6500974,6501048,74,1,0,0,2
6501039,6501628,589,0,0,1,1
6501049,6501628,579,0,0,1,2
