start,end,duration,saccade,blink,fixation,eye
2598279,2598677,398,0,0,1,2
2598279,2598678,399,0,0,1,1
2598678,2598721,43,1,0,0,2
2598679,2598722,43,1,0,0,1
2598722,2598863,141,0,0,1,2
2598723,2598862,139,0,0,1,1
2598863,2598931,68,1,0,0,1
2598864,2598938,74,1,0,0,2
2598932,2599026,94,0,0,1,1
2598939,2599028,89,0,0,1,2
2599027,2599051,24,1,0,0,1
2599029,2599053,24,1,0,0,2
2599052,2599360,308,0,0,1,1
2599054,2599363,309,0,0,1,2
2599361,2599550,189,1,0,0,1
2599364,2599533,169,1,0,0,2
2599378,2599486,108,0,1,0,1
2599389,2599510,121,0,1,0,2
2599511,2599536,25,0,1,0,1
2599534,2600047,513,0,0,1,2
2599551,2600046,495,0,0,1,1
2600047,2600078,31,1,0,0,1
2600048,2600078,30,1,0,0,2
2600079,2600260,181,0,0,1,2
2600079,2600261,182,0,0,1,1
2600261,2600272,11,1,0,0,2
2600262,2600273,11,1,0,0,1
2600273,2602155,1882,0,0,1,2
2600274,2602154,1880,0,0,1,1
2602155,2602189,34,1,0,0,1
2602156,2602190,34,1,0,0,2
2602190,2602407,217,0,0,1,1
2602191,2603405,1214,0,0,1,2
2602408,2602412,4,1,0,0,1
2602413,2603402,989,0,0,1,1
2603403,2603675,272,1,0,0,1
2603406,2603651,245,1,0,0,2
2603421,2603634,213,0,1,0,2
2603422,2603653,231,0,1,0,1
2603652,2603782,130,0,0,1,2
2603676,2603783,107,0,0,1,1
2603783,2603812,29,1,0,0,2
2603784,2603802,18,1,0,0,1
2603803,2604033,230,0,0,1,1
2603813,2604033,220,0,0,1,2
2604034,2604060,26,1,0,0,2
2604034,2604062,28,1,0,0,1
2604061,2604345,284,0,0,1,2
2604063,2604345,282,0,0,1,1
2604346,2604361,15,1,0,0,2
2604346,2604366,20,1,0,0,1
2604362,2604853,491,0,0,1,2
2604367,2604851,484,0,0,1,1
2604852,2604878,26,1,0,0,1
2604854,2604879,25,1,0,0,2
2604879,2606460,1581,0,0,1,1
2604880,2606466,1586,0,0,1,2
2606461,2606837,376,1,0,0,1
2606467,2606766,299,1,0,0,2
2606483,2606784,301,0,1,0,1
2606486,2606748,262,0,1,0,2
2606767,2606818,51,0,0,1,2
2606819,2606837,18,1,0,0,2
2606838,2607654,816,0,0,1,1
2606838,2607661,823,0,0,1,2
2607655,2607672,17,1,0,0,1
2607662,2607672,10,1,0,0,2
2607673,2607821,148,0,0,1,1
2607673,2608653,980,0,0,1,2
2607822,2607833,11,1,0,0,1
2607834,2608653,819,0,0,1,1
2608654,2608672,18,1,0,0,2
2608654,2608673,19,1,0,0,1
2608673,2608861,188,0,0,1,2
2608674,2608855,181,0,0,1,1
2608856,2608875,19,1,0,0,1
2608862,2608875,13,1,0,0,2
2608876,2609178,302,0,0,1,1
2608876,2609179,303,0,0,1,2
2609179,2609199,20,1,0,0,1
2609180,2609197,17,1,0,0,2
2609198,2609370,172,0,0,1,2
2609200,2609367,167,0,0,1,1
2609368,2609754,386,1,0,0,1
2609371,2609732,361,1,0,0,2
2609386,2609724,338,0,1,0,1
2609387,2609721,334,0,1,0,2
2609733,2611231,1498,0,0,1,2
2609755,2611232,1477,0,0,1,1
2611232,2611831,599,1,0,0,2
2611233,2611935,702,1,0,0,1
2611250,2611818,568,0,1,0,2
2611251,2611419,168,0,1,0,1
2611442,2611885,443,0,1,0,1
2611832,2611897,65,0,0,1,2
2611898,2611902,4,1,0,0,2
2611903,2612688,785,0,0,1,2
2611936,2612683,747,0,0,1,1
2612684,2613455,771,1,0,0,1
2612689,2613446,757,1,0,0,2
2612700,2613407,707,0,1,0,1
2612704,2613408,704,0,1,0,2
2613447,2613621,174,0,0,1,2
2613456,2613620,164,0,0,1,1
2613621,2613637,16,1,0,0,1
2613622,2613632,10,1,0,0,2
2613633,2614273,640,0,0,1,2
2613638,2614275,637,0,0,1,1
2614274,2614304,30,1,0,0,2
2614276,2614311,35,1,0,0,1
2614305,2614490,185,0,0,1,2
2614312,2614484,172,0,0,1,1
2614485,2614805,320,1,0,0,1
2614491,2614722,231,1,0,0,2
2614504,2614676,172,0,1,0,1
2614506,2614709,203,0,1,0,2
2614697,2614746,49,0,1,0,1
2614723,2614780,57,0,0,1,2
2614781,2614797,16,1,0,0,2
2614798,2616017,1219,0,0,1,2
2614806,2616010,1204,0,0,1,1
2616011,2616037,26,1,0,0,1
2616018,2616035,17,1,0,0,2
2616036,2616272,236,0,0,1,2
2616038,2616273,235,0,0,1,1
2616273,2616295,22,1,0,0,2
2616274,2616295,21,1,0,0,1
2616296,2616582,286,0,0,1,1
2616296,2616582,286,0,0,1,2
2616583,2616611,28,1,0,0,2
2616583,2616612,29,1,0,0,1
2616612,2616885,273,0,0,1,2
2616613,2616886,273,0,0,1,1
2616886,2617193,307,1,0,0,2
2616887,2617274,387,1,0,0,1
2616903,2617182,279,0,1,0,2
2616903,2617258,355,0,1,0,1
2617194,2617216,22,0,0,1,2
2617217,2617240,23,1,0,0,2
2617241,2617861,620,0,0,1,2
2617275,2617859,584,0,0,1,1
2617860,2617881,21,1,0,0,1
2617862,2617887,25,1,0,0,2
2617882,2618645,763,0,0,1,1
2617888,2618644,756,0,0,1,2
2618645,2618687,42,1,0,0,2
2618646,2618679,33,1,0,0,1
2618680,2618813,133,0,0,1,1
2618688,2618813,125,0,0,1,2
2618814,2618838,24,1,0,0,1
2618814,2618839,25,1,0,0,2
2618839,2619662,823,0,0,1,1
2618840,2619663,823,0,0,1,2
2619663,2619734,71,1,0,0,1
2619664,2619743,79,1,0,0,2
2619735,2619845,110,0,0,1,1
2619744,2619846,102,0,0,1,2
2619846,2619921,75,1,0,0,1
2619847,2619921,74,1,0,0,2
2619922,2620065,143,0,0,1,1
2619922,2620065,143,0,0,1,2
2620066,2620092,26,1,0,0,1
2620066,2620092,26,1,0,0,2
2620093,2620650,557,0,0,1,2
2620093,2620651,558,0,0,1,1
2620651,2620679,28,1,0,0,2
2620652,2620672,20,1,0,0,1
2620673,2620818,145,0,0,1,1
2620680,2620818,138,0,0,1,2
2620819,2620824,5,1,0,0,2
2620819,2620828,9,1,0,0,1
2620825,2621080,255,0,0,1,2
2620829,2621075,246,0,0,1,1
2621076,2621399,323,1,0,0,1
2621081,2621336,255,1,0,0,2
2621093,2621314,221,0,1,0,1
2621095,2621312,217,0,1,0,2
2621337,2621379,42,0,0,1,2
2621338,2621379,41,0,1,0,1
2621380,2621397,17,1,0,0,2
2621398,2622447,1049,0,0,1,2
2621400,2622446,1046,0,0,1,1
2622447,2622458,11,1,0,0,1
2622448,2622458,10,1,0,0,2
2622459,2623565,1106,0,0,1,2
2622459,2623569,1110,0,0,1,1
2623566,2623581,15,1,0,0,2
2623570,2623582,12,1,0,0,1
2623582,2623992,410,0,0,1,2
2623583,2623991,408,0,0,1,1
2623992,2624339,347,1,0,0,1
2623993,2624268,275,1,0,0,2
2624003,2624154,151,0,1,0,1
2624006,2624241,235,0,1,0,2
2624175,2624237,62,0,1,0,1
2624262,2624320,58,0,1,0,1
2624269,2624410,141,0,0,1,2
2624340,2624409,69,0,0,1,1
2624410,2624426,16,1,0,0,1
2624411,2624426,15,1,0,0,2
2624427,2624934,507,0,0,1,2
2624427,2624938,511,0,0,1,1
2624935,2624954,19,1,0,0,2
2624939,2624954,15,1,0,0,1
2624955,2625596,641,0,0,1,1
2624955,2625596,641,0,0,1,2
2625597,2625673,76,1,0,0,1
2625597,2625676,79,1,0,0,2
2625674,2625812,138,0,0,1,1
2625677,2625812,135,0,0,1,2
2625813,2625890,77,1,0,0,1
2625813,2625890,77,1,0,0,2
2625891,2626009,118,0,0,1,1
2625891,2626010,119,0,0,1,2
2626010,2626045,35,1,0,0,1
2626011,2626044,33,1,0,0,2
2626045,2626454,409,0,0,1,2
2626046,2626454,408,0,0,1,1
2626455,2626513,58,1,0,0,1
2626455,2626513,58,1,0,0,2
2626514,2626612,98,0,0,1,2
2626514,2626613,99,0,0,1,1
2626613,2626669,56,1,0,0,2
2626614,2626666,52,1,0,0,1
2626667,2626810,143,0,0,1,1
2626670,2626810,140,0,0,1,2
2626811,2626829,18,1,0,0,2
2626811,2626837,26,1,0,0,1
2626830,2627493,663,0,0,1,2
2626838,2627494,656,0,0,1,1
2627494,2627527,33,1,0,0,2
2627495,2627534,39,1,0,0,1
2627528,2627661,133,0,0,1,2
2627535,2627661,126,0,0,1,1
2627662,2627679,17,1,0,0,2
2627662,2627680,18,1,0,0,1
2627680,2628892,1212,0,0,1,2
2627681,2628342,661,0,0,1,1
2628343,2628347,4,1,0,0,1
2628348,2628893,545,0,0,1,1
2628893,2628920,27,1,0,0,2
2628894,2628920,26,1,0,0,1
2628921,2629161,240,0,0,1,1
2628921,2629161,240,0,0,1,2
2629162,2629166,4,1,0,0,2
2629162,2629170,8,1,0,0,1
2629167,2629475,308,0,0,1,2
2629171,2629475,304,0,0,1,1
2629476,2629769,293,1,0,0,2
2629476,2629843,367,1,0,0,1
2629488,2629654,166,0,1,0,1
2629490,2629743,253,0,1,0,2
2629680,2629743,63,0,1,0,1
2629765,2629832,67,0,1,0,1
2629770,2629922,152,0,0,1,2
2629844,2629921,77,0,0,1,1
2629922,2629950,28,1,0,0,1
2629923,2629949,26,1,0,0,2
2629950,2630243,293,0,0,1,2
2629951,2630242,291,0,0,1,1
2630243,2630276,33,1,0,0,1
2630244,2630277,33,1,0,0,2
2630277,2630424,147,0,0,1,1
2630278,2630424,146,0,0,1,2
2630425,2630448,23,1,0,0,1
2630425,2630449,24,1,0,0,2
2630449,2630727,278,0,0,1,1
2630450,2630726,276,0,0,1,2
2630727,2630742,15,1,0,0,2
2630728,2630747,19,1,0,0,1
2630743,2631138,395,0,0,1,2
2630748,2631137,389,0,0,1,1
2631138,2631202,64,1,0,0,1
2631139,2631205,66,1,0,0,2
2631203,2631323,120,0,0,1,1
2631206,2631322,116,0,0,1,2
2631323,2631391,68,1,0,0,2
2631324,2631391,67,1,0,0,1
2631392,2631609,217,0,0,1,2
2631392,2631614,222,0,0,1,1
2631610,2631626,16,1,0,0,2
2631615,2631624,9,1,0,0,1
2631625,2632008,383,0,0,1,1
2631627,2632016,389,0,0,1,2
2632009,2632033,24,1,0,0,1
2632017,2632031,14,1,0,0,2
2632032,2632517,485,0,0,1,2
2632034,2632520,486,0,0,1,1
2632518,2632829,311,1,0,0,2
2632531,2632709,178,0,1,0,1
2632534,2632817,283,0,1,0,2
2632719,2632964,245,1,0,0,1
2632736,2632820,84,0,1,0,1
2632830,2632949,119,0,0,1,2
2632845,2632939,94,0,1,0,1
2632950,2632965,15,1,0,0,2
2632965,2633225,260,0,0,1,1
2632966,2633225,259,0,0,1,2
2633226,2633507,281,1,0,0,2
2633236,2633634,398,0,1,0,1
2633244,2633497,253,0,1,0,2
2633508,2633604,96,0,0,1,2
2633605,2633618,13,1,0,0,2
2633619,2633813,194,0,0,1,2
2633644,2633645,1,1,0,0,1
2633646,2633808,162,0,0,1,1
2633809,2634210,401,1,0,0,1
2633814,2634065,251,1,0,0,2
2633823,2634180,357,0,1,0,1
2633834,2634042,208,0,1,0,2
2634066,2634674,608,0,0,1,2
2634211,2634667,456,0,0,1,1
2634668,2635066,398,1,0,0,1
2634675,2634935,260,1,0,0,2
2634686,2635033,347,0,1,0,1
2634694,2634909,215,0,1,0,2
2634936,2634995,59,0,0,1,2
2634996,2635014,18,1,0,0,2
2635015,2635730,715,0,0,1,2
2635067,2635727,660,0,0,1,1
2635731,2636008,277,1,0,0,2
2635738,2636125,387,0,1,0,1
2635744,2635979,235,0,1,0,2
2636009,2636158,149,0,0,1,2
2636135,2636135,0,1,0,0,1
2636136,2636161,25,0,0,1,1
2636159,2636192,33,1,0,0,2
2636162,2636191,29,1,0,0,1
2636192,2636304,112,0,0,1,1
2636193,2636305,112,0,0,1,2
2636305,2636326,21,1,0,0,1
2636306,2636326,20,1,0,0,2
2636327,2636759,432,0,0,1,1
2636327,2636759,432,0,0,1,2
2636760,2636787,27,1,0,0,1
2636760,2636787,27,1,0,0,2
2636788,2637228,440,0,0,1,2
2636788,2637463,675,0,0,1,1
2637229,2637243,14,1,0,0,2
2637244,2637464,220,0,0,1,2
2637464,2637484,20,1,0,0,1
2637465,2637477,12,1,0,0,2
2637478,2637929,451,0,0,1,2
2637485,2637928,443,0,0,1,1
2637929,2639052,1123,1,0,0,1
2637930,2638046,116,1,0,0,2
2638013,2639042,1029,0,1,0,1
2638047,2638178,131,0,0,1,2
2638179,2638249,70,1,0,0,2
2638250,2638365,115,0,0,1,2
2638366,2638717,351,1,0,0,2
2638417,2638625,208,0,1,0,2
2638718,2638901,183,0,0,1,2
2638902,2639064,162,1,0,0,2
2638923,2639007,84,0,1,0,2
2639053,2639177,124,0,0,1,1
2639065,2639178,113,0,0,1,2
2639178,2639221,43,1,0,0,1
2639179,2639236,57,1,0,0,2
2639222,2639354,132,0,0,1,1
2639237,2639355,118,0,0,1,2
2639355,2639425,70,1,0,0,1
2639356,2639436,80,1,0,0,2
2639426,2639654,228,0,0,1,1
2639437,2639654,217,0,0,1,2
2639655,2639907,252,1,0,0,2
2639655,2639917,262,1,0,0,1
2639690,2639891,201,0,1,0,2
2639693,2639902,209,0,1,0,1
2639908,2639968,60,0,0,1,2
2639918,2639968,50,0,0,1,1
2639969,2639993,24,1,0,0,2
2639969,2639994,25,1,0,0,1
2639994,2640257,263,0,0,1,2
2639995,2640262,267,0,0,1,1
2640258,2640277,19,1,0,0,2
2640263,2640284,21,1,0,0,1
2640278,2640788,510,0,0,1,2
2640285,2640788,503,0,0,1,1
2640789,2641009,220,1,0,0,2
2640799,2641064,265,0,1,0,1
2640802,2640994,192,0,1,0,2
2641010,2641160,150,0,0,1,2
2641074,2641075,1,1,0,0,1
2641076,2641159,83,0,0,1,1
2641160,2641214,54,1,0,0,1
2641161,2641215,54,1,0,0,2
2641215,2641391,176,0,0,1,1
2641216,2641391,175,0,0,1,2
2641392,2641448,56,1,0,0,1
2641392,2641448,56,1,0,0,2
2641449,2641868,419,0,0,1,2
2641449,2641871,422,0,0,1,1
2641869,2642091,222,1,0,0,2
2641872,2642204,332,1,0,0,1
2641887,2642068,181,0,1,0,2
2641887,2642129,242,0,1,0,1
2642092,2642149,57,0,0,1,2
2642150,2642201,51,1,0,0,2
2642202,2642406,204,0,0,1,2
2642205,2642407,202,0,0,1,1
2642407,2642434,27,1,0,0,2
2642408,2642433,25,1,0,0,1
2642434,2643414,980,0,0,1,1
2642435,2643415,980,0,0,1,2
2643415,2643449,34,1,0,0,1
2643416,2643447,31,1,0,0,2
2643448,2643613,165,0,0,1,2
2643450,2643615,165,0,0,1,1
2643614,2643631,17,1,0,0,2
2643616,2643633,17,1,0,0,1
2643632,2644161,529,0,0,1,2
2643634,2644164,530,0,0,1,1
2644162,2644429,267,1,0,0,2
2644165,2644543,378,1,0,0,1
2644177,2644534,357,0,1,0,1
2644179,2644414,235,0,1,0,2
2644430,2644504,74,0,0,1,2
2644505,2644521,16,1,0,0,2
2644522,2644879,357,0,0,1,2
2644544,2645210,666,0,0,1,1
2644880,2644886,6,1,0,0,2
2644887,2645208,321,0,0,1,2
2645209,2645233,24,1,0,0,2
2645211,2645233,22,1,0,0,1
2645234,2645465,231,0,0,1,1
2645234,2645470,236,0,0,1,2
2645466,2645480,14,1,0,0,1
2645471,2645484,13,1,0,0,2
2645481,2645918,437,0,0,1,1
2645485,2645919,434,0,0,1,2
2645919,2645944,25,1,0,0,1
2645920,2645944,24,1,0,0,2
2645945,2646282,337,0,0,1,1
2645945,2646288,343,0,0,1,2
2646283,2646310,27,1,0,0,1
2646289,2646299,10,1,0,0,2
2646300,2646810,510,0,0,1,2
2646311,2646742,431,0,0,1,1
2646743,2646767,24,1,0,0,1
2646768,2646808,40,0,0,1,1
2646809,2647162,353,1,0,0,1
2646811,2647101,290,1,0,0,2
2646824,2647137,313,0,1,0,1
2646826,2647044,218,0,1,0,2
2647102,2648246,1144,0,0,1,2
2647163,2648245,1082,0,0,1,1
2648246,2648262,16,1,0,0,1
2648247,2648255,8,1,0,0,2
2648256,2648672,416,0,0,1,2
2648263,2649102,839,0,0,1,1
2648673,2648694,21,1,0,0,2
2648695,2649102,407,0,0,1,2
2649103,2649398,295,1,0,0,2
2649103,2649430,327,1,0,0,1
2649118,2649387,269,0,1,0,1
2649119,2649331,212,0,1,0,2
2649399,2650828,1429,0,0,1,2
2649431,2650822,1391,0,0,1,1
2650823,2650849,26,1,0,0,1
2650829,2650848,19,1,0,0,2
2650849,2652450,1601,0,0,1,2
2650850,2651088,238,0,0,1,1
2651089,2651098,9,1,0,0,1
2651099,2652450,1351,0,0,1,1
2652451,2652499,48,1,0,0,1
2652451,2652508,57,1,0,0,2
2652500,2652637,137,0,0,1,1
2652509,2652639,130,0,0,1,2
2652638,2652714,76,1,0,0,1
2652640,2652717,77,1,0,0,2
2652715,2652841,126,0,0,1,1
2652718,2652841,123,0,0,1,2
2652842,2652869,27,1,0,0,2
2652842,2652870,28,1,0,0,1
2652870,2653112,242,0,0,1,2
2652871,2653116,245,0,0,1,1
2653113,2653138,25,1,0,0,2
2653117,2653138,21,1,0,0,1
2653139,2655314,2175,0,0,1,2
2653139,2655316,2177,0,0,1,1
2655315,2655415,100,1,0,0,2
2655317,2655424,107,1,0,0,1
2655416,2655511,95,0,0,1,2
2655425,2655512,87,0,0,1,1
2655512,2655544,32,1,0,0,2
2655513,2655547,34,1,0,0,1
2655545,2655718,173,0,0,1,2
2655548,2655717,169,0,0,1,1
2655718,2655745,27,1,0,0,1
2655719,2655746,27,1,0,0,2
2655746,2656116,370,0,0,1,1
2655747,2656116,369,0,0,1,2
2656117,2656141,24,1,0,0,1
2656117,2656143,26,1,0,0,2
2656142,2656417,275,0,0,1,1
2656144,2657688,1544,0,0,1,2
2656418,2656435,17,1,0,0,1
2656436,2657498,1062,0,0,1,1
2657499,2657511,12,1,0,0,1
2657512,2657691,179,0,0,1,1
2657689,2657768,79,1,0,0,2
2657692,2657769,77,1,0,0,1
2657769,2657838,69,0,0,1,2
2657770,2657838,68,0,0,1,1
2657839,2657913,74,1,0,0,1
2657839,2657978,139,1,0,0,2
2657877,2657887,10,0,1,0,1
2657880,2657880,0,0,1,0,2
2657913,2657925,12,0,1,0,2
2657914,2658018,104,0,0,1,1
2657979,2658018,39,0,0,1,2
2658019,2658046,27,1,0,0,2
2658019,2658047,28,1,0,0,1
2658047,2658205,158,0,0,1,2
2658048,2658205,157,0,0,1,1
2658206,2658517,311,1,0,0,1
2658206,2658544,338,1,0,0,2
2658220,2658459,239,0,1,0,2
2658222,2658495,273,0,1,0,1
2658491,2658507,16,0,1,0,2
2658518,2658935,417,0,0,1,1
2658545,2658583,38,0,0,1,2
2658584,2658600,16,1,0,0,2
2658601,2659147,546,0,0,1,2
2658936,2658944,8,1,0,0,1
2658945,2659145,200,0,0,1,1
2659146,2659173,27,1,0,0,1
2659148,2659172,24,1,0,0,2
2659173,2660740,1567,0,0,1,2
2659174,2659281,107,0,0,1,1
2659282,2659326,44,1,0,0,1
2659327,2660739,1412,0,0,1,1
2660740,2660816,76,1,0,0,1
2660741,2660817,76,1,0,0,2
2660817,2661007,190,0,0,1,1
2660818,2661007,189,0,0,1,2
2661008,2661098,90,1,0,0,1
2661008,2661098,90,1,0,0,2
2661099,2661194,95,0,0,1,1
2661099,2661194,95,0,0,1,2
2661195,2661226,31,1,0,0,1
2661195,2661229,34,1,0,0,2
2661227,2661401,174,0,0,1,1
2661230,2661407,177,0,0,1,2
2661402,2661426,24,1,0,0,1
2661408,2661423,15,1,0,0,2
2661424,2661606,182,0,0,1,2
2661427,2661605,178,0,0,1,1
2661606,2661623,17,1,0,0,1
2661607,2661622,15,1,0,0,2
2661623,2663605,1982,0,0,1,2
2661624,2661757,133,0,0,1,1
2661758,2661768,10,1,0,0,1
2661769,2661946,177,0,0,1,1
2661947,2661957,10,1,0,0,1
2661958,2663608,1650,0,0,1,1
2663606,2663735,129,1,0,0,2
2663609,2663713,104,1,0,0,1
2663657,2663665,8,0,1,0,1
2663661,2663668,7,0,1,0,2
2663714,2663798,84,0,0,1,1
2663736,2663800,64,0,0,1,2
2663799,2663830,31,1,0,0,1
2663801,2663830,29,1,0,0,2
2663831,2663937,106,0,0,1,1
2663831,2663937,106,0,0,1,2
2663938,2663959,21,1,0,0,2
2663938,2663970,32,1,0,0,1
2663960,2665970,2010,0,0,1,2
2663971,2664452,481,0,0,1,1
2664453,2664466,13,1,0,0,1
2664467,2665972,1505,0,0,1,1
2665971,2666069,98,1,0,0,2
2665973,2666053,80,1,0,0,1
2666054,2666125,71,0,0,1,1
2666070,2666125,55,0,0,1,2
2666126,2666159,33,1,0,0,2
2666126,2666164,38,1,0,0,1
2666160,2666245,85,0,0,1,2
2666165,2666243,78,0,0,1,1
2666244,2666277,33,1,0,0,1
2666246,2666266,20,1,0,0,2
2666267,2666479,212,0,0,1,2
2666278,2666477,199,0,0,1,1
2666478,2666491,13,1,0,0,1
2666480,2666496,16,1,0,0,2
2666492,2668032,1540,0,0,1,1
2666497,2668033,1536,0,0,1,2
2668033,2668089,56,1,0,0,1
2668034,2668088,54,1,0,0,2
2668089,2668119,30,0,0,1,2
2668090,2668118,28,0,0,1,1
2668119,2668197,78,1,0,0,1
2668120,2668191,71,1,0,0,2
2668192,2668270,78,0,0,1,2
2668198,2668269,71,0,0,1,1
2668270,2668310,40,1,0,0,1
2668271,2668318,47,1,0,0,2
2668311,2668463,152,0,0,1,1
2668319,2668467,148,0,0,1,2
2668464,2668488,24,1,0,0,1
2668468,2668487,19,1,0,0,2
2668488,2669933,1445,0,0,1,2
2668489,2669932,1443,0,0,1,1
2669933,2670004,71,1,0,0,1
2669934,2670001,67,1,0,0,2
2670002,2670146,144,0,0,1,2
2670005,2670145,140,0,0,1,1
2670146,2670232,86,1,0,0,1
2670147,2670232,85,1,0,0,2
2670233,2670304,71,0,0,1,1
2670233,2670305,72,0,0,1,2
2670305,2670323,18,1,0,0,1
2670306,2670333,27,1,0,0,2
2670324,2670425,101,0,0,1,1
2670334,2670426,92,0,0,1,2
2670426,2670455,29,1,0,0,1
2670427,2670457,30,1,0,0,2
2670456,2670663,207,0,0,1,1
2670458,2670659,201,0,0,1,2
2670660,2670684,24,1,0,0,2
2670664,2670684,20,1,0,0,1
2670685,2672410,1725,0,0,1,1
2670685,2672412,1727,0,0,1,2
2672411,2672521,110,1,0,0,1
2672413,2672511,98,1,0,0,2
2672436,2672488,52,0,1,0,1
2672512,2672616,104,0,0,1,2
2672522,2672616,94,0,0,1,1
2672617,2672830,213,1,0,0,2
2672617,2672842,225,1,0,0,1
2672640,2672807,167,0,1,0,1
2672646,2672794,148,0,1,0,2
2672831,2672920,89,0,0,1,2
2672843,2672920,77,0,0,1,1
2672921,2672949,28,1,0,0,2
2672921,2672952,31,1,0,0,1
2672950,2673583,633,0,0,1,2
2672953,2673665,712,0,0,1,1
2673584,2673621,37,1,0,0,2
2673622,2673654,32,0,0,1,2
2673655,2673676,21,1,0,0,2
2673666,2673670,4,1,0,0,1
2673671,2673769,98,0,0,1,1
2673677,2674998,1321,0,0,1,2
2673770,2673786,16,1,0,0,1
2673787,2673913,126,0,0,1,1
2673914,2673919,5,1,0,0,1
2673920,2673950,30,0,0,1,1
2673951,2673966,15,1,0,0,1
2673967,2674310,343,0,0,1,1
2674311,2674334,23,1,0,0,1
2674335,2674998,663,0,0,1,1
2674999,2675057,58,1,0,0,1
2674999,2675057,58,1,0,0,2
2675058,2675160,102,0,0,1,1
2675058,2675160,102,0,0,1,2
2675161,2675183,22,1,0,0,1
2675161,2675190,29,1,0,0,2
2675184,2677087,1903,0,0,1,1
2675191,2677088,1897,0,0,1,2
2677088,2677127,39,1,0,0,1
2677089,2677126,37,1,0,0,2
2677127,2677819,692,0,0,1,2
2677128,2677818,690,0,0,1,1
2677819,2677846,27,1,0,0,1
2677820,2677845,25,1,0,0,2
2677846,2678962,1116,0,0,1,2
2677847,2678960,1113,0,0,1,1
2678961,2679055,94,1,0,0,1
2678963,2679049,86,1,0,0,2
2679050,2679124,74,0,0,1,2
2679056,2679124,68,0,0,1,1
2679125,2679152,27,1,0,0,2
2679125,2679153,28,1,0,0,1
2679153,2679437,284,0,0,1,2
2679154,2679429,275,0,0,1,1
2679430,2679735,305,1,0,0,1
2679438,2679648,210,1,0,0,2
2679450,2679626,176,0,1,0,2
2679450,2679704,254,0,1,0,1
2679649,2681367,1718,0,0,1,2
2679736,2681367,1631,0,0,1,1
2681368,2681479,111,1,0,0,2
2681368,2681480,112,1,0,0,1
2681480,2681860,380,0,0,1,2
2681481,2681859,378,0,0,1,1
2681860,2681980,120,1,0,0,1
2681861,2681972,111,1,0,0,2
2681973,2682055,82,0,0,1,2
2681981,2682055,74,0,0,1,1
2682056,2682095,39,1,0,0,1
2682056,2682095,39,1,0,0,2
2682096,2682229,133,0,0,1,2
2682096,2682231,135,0,0,1,1
2682230,2682248,18,1,0,0,2
2682232,2682253,21,1,0,0,1
2682249,2682570,321,0,0,1,2
2682254,2683763,1509,0,0,1,1
2682571,2682585,14,1,0,0,2
2682586,2683761,1175,0,0,1,2
2683762,2683845,83,1,0,0,2
2683764,2683854,90,1,0,0,1
2683846,2683951,105,0,0,1,2
2683855,2683950,95,0,0,1,1
2683951,2684013,62,1,0,0,1
2683952,2684006,54,1,0,0,2
2684007,2684103,96,0,0,1,2
2684014,2684102,88,0,0,1,1
2684103,2684152,49,1,0,0,1
2684104,2684155,51,1,0,0,2
2684153,2686260,2107,0,0,1,1
2684156,2684346,190,0,0,1,2
2684347,2684356,9,1,0,0,2
2684357,2686259,1902,0,0,1,2
2686260,2686343,83,1,0,0,2
2686261,2686333,72,1,0,0,1
2686334,2686443,109,0,0,1,1
2686344,2686441,97,0,0,1,2
2686442,2686490,48,1,0,0,2
2686444,2686483,39,1,0,0,1
2686484,2687624,1140,0,0,1,1
2686491,2687612,1121,0,0,1,2
2687613,2687956,343,1,0,0,2
2687625,2687905,280,1,0,0,1
2687722,2687857,135,0,1,0,2
2687728,2687860,132,0,1,0,1
2687906,2688022,116,0,0,1,1
2687957,2688021,64,0,0,1,2
2688022,2688083,61,1,0,0,2
2688023,2688075,52,1,0,0,1
2688076,2688207,131,0,0,1,1
2688084,2688209,125,0,0,1,2
2688208,2688289,81,1,0,0,1
2688210,2688288,78,1,0,0,2
2688289,2688381,92,0,0,1,2
2688290,2688381,91,0,0,1,1
2688382,2688420,38,1,0,0,2
2688382,2688422,40,1,0,0,1
2688421,2689092,671,0,0,1,2
2688423,2689091,668,0,0,1,1
2689092,2689123,31,1,0,0,1
2689093,2689121,28,1,0,0,2
2689122,2690549,1427,0,0,1,2
2689124,2690548,1424,0,0,1,1
2690549,2690619,70,1,0,0,1
2690550,2690619,69,1,0,0,2
2690620,2690699,79,0,0,1,2
2690620,2690701,81,0,0,1,1
2690700,2690729,29,1,0,0,2
2690702,2690730,28,1,0,0,1
2690730,2692041,1311,0,0,1,2
2690731,2690942,211,0,0,1,1
2690943,2690956,13,1,0,0,1
2690957,2692040,1083,0,0,1,1
2692041,2692071,30,1,0,0,1
2692042,2692068,26,1,0,0,2
2692069,2692502,433,0,0,1,2
2692072,2692502,430,0,0,1,1
2692503,2692602,99,1,0,0,1
2692503,2692603,100,1,0,0,2
2692603,2692674,71,0,0,1,1
2692604,2692674,70,0,0,1,2
2692675,2692715,40,1,0,0,1
2692675,2692716,41,1,0,0,2
2692716,2694238,1522,0,0,1,1
2692717,2694238,1521,0,0,1,2
2694239,2694285,46,1,0,0,1
2694239,2694286,47,1,0,0,2
2694286,2694350,64,0,0,1,1
2694287,2694350,63,0,0,1,2
2694351,2694432,81,1,0,0,2
2694351,2694433,82,1,0,0,1
2694433,2694504,71,0,0,1,2
2694434,2694503,69,0,0,1,1
2694504,2694536,32,1,0,0,1
2694505,2694536,31,1,0,0,2
2694537,2696470,1933,0,0,1,2
2694537,2696471,1934,0,0,1,1
2696471,2696542,71,1,0,0,2
2696472,2696532,60,1,0,0,1
2696533,2696633,100,0,0,1,1
2696543,2696634,91,0,0,1,2
2696634,2696653,19,1,0,0,1
2696635,2696662,27,1,0,0,2
2696654,2696838,184,0,0,1,1
2696663,2696842,179,0,0,1,2
2696839,2696855,16,1,0,0,1
2696843,2696857,14,1,0,0,2
2696856,2698452,1596,0,0,1,1
2696858,2698453,1595,0,0,1,2
2698453,2698535,82,1,0,0,1
2698454,2698535,81,1,0,0,2
2698536,2698653,117,0,0,1,2
2698536,2698655,119,0,0,1,1
2698654,2698686,32,1,0,0,2
2698656,2698686,30,1,0,0,1
2698687,2698796,109,0,0,1,1
2698687,2698797,110,0,0,1,2
2698797,2699014,217,1,0,0,1
2698798,2699014,216,1,0,0,2
2698814,2698976,162,0,1,0,1
2698817,2698957,140,0,1,0,2
2699015,2699155,140,0,0,1,2
2699015,2699159,144,0,0,1,1
2699156,2699181,25,1,0,0,2
2699160,2699172,12,1,0,0,1
2699173,2700815,1642,0,0,1,1
2699182,2700816,1634,0,0,1,2
2700816,2700877,61,1,0,0,1
2700817,2700877,60,1,0,0,2
2700878,2700965,87,0,0,1,2
2700878,2700966,88,0,0,1,1
2700966,2701007,41,1,0,0,2
2700967,2701002,35,1,0,0,1
2701003,2701097,94,0,0,1,1
2701008,2701097,89,0,0,1,2
2701098,2701118,20,1,0,0,2
2701098,2701120,22,1,0,0,1
2701119,2702744,1625,0,0,1,2
2701121,2702745,1624,0,0,1,1
2702745,2702834,89,1,0,0,2
2702746,2702826,80,1,0,0,1
2702827,2702925,98,0,0,1,1
2702835,2702925,90,0,0,1,2
2702926,2702952,26,1,0,0,2
2702926,2702955,29,1,0,0,1
2702953,2703133,180,0,0,1,2
2702956,2703132,176,0,0,1,1
2703133,2703147,14,1,0,0,1
2703134,2703148,14,1,0,0,2
2703148,2704787,1639,0,0,1,1
2703149,2704786,1637,0,0,1,2
2704787,2704879,92,1,0,0,2
2704788,2704882,94,1,0,0,1
2704880,2704963,83,0,0,1,2
2704883,2704963,80,0,0,1,1
2704964,2705002,38,1,0,0,1
2704964,2705011,47,1,0,0,2
2705003,2706561,1558,0,0,1,1
2705012,2706563,1551,0,0,1,2
2706562,2706616,54,1,0,0,1
2706564,2706618,54,1,0,0,2
2706617,2706820,203,0,0,1,1
2706619,2706819,200,0,0,1,2
2706820,2706868,48,1,0,0,2
2706821,2706867,46,1,0,0,1
2706868,2707007,139,0,0,1,1
2706869,2707010,141,0,0,1,2
2707008,2707027,19,1,0,0,1
2707011,2707036,25,1,0,0,2
2707028,2708279,1251,0,0,1,1
2707037,2708288,1251,0,0,1,2
2708280,2708441,161,1,0,0,1
2708289,2708453,164,1,0,0,2
2708308,2708388,80,0,1,0,1
2708308,2708388,80,0,1,0,2
2708442,2708668,226,0,0,1,1
2708454,2708666,212,0,0,1,2
2708667,2708801,134,1,0,0,2
2708669,2708732,63,1,0,0,1
2708733,2708759,26,0,0,1,1
2708760,2708792,32,1,0,0,1
2708793,2708824,31,0,0,1,1
2708802,2708834,32,0,0,1,2
2708825,2708850,25,1,0,0,1
2708835,2708843,8,1,0,0,2
2708844,2709026,182,0,0,1,2
2708851,2709026,175,0,0,1,1
2709027,2709038,11,1,0,0,1
2709027,2709045,18,1,0,0,2
2709039,2710648,1609,0,0,1,1
2709046,2710648,1602,0,0,1,2
2710649,2710726,77,1,0,0,2
2710649,2710736,87,1,0,0,1
2710727,2710811,84,0,0,1,2
2710737,2710812,75,0,0,1,1
2710812,2710858,46,1,0,0,2
2710813,2710857,44,1,0,0,1
2710858,2710941,83,0,0,1,1
2710859,2710941,82,0,0,1,2
2710942,2710971,29,1,0,0,1
2710942,2710973,31,1,0,0,2
2710972,2712329,1357,0,0,1,1
2710974,2712329,1355,0,0,1,2
2712330,2712412,82,1,0,0,1
2712330,2712412,82,1,0,0,2
2712413,2712594,181,0,0,1,1
2712413,2712596,183,0,0,1,2
2712595,2712674,79,1,0,0,1
2712597,2712674,77,1,0,0,2
2712675,2712752,77,0,0,1,1
2712675,2712754,79,0,0,1,2
2712753,2712782,29,1,0,0,1
2712755,2712782,27,1,0,0,2
2712783,2712927,144,0,0,1,1
2712783,2712929,146,0,0,1,2
2712928,2712944,16,1,0,0,1
2712930,2712941,11,1,0,0,2
2712942,2713211,269,0,0,1,2
2712945,2714725,1780,0,0,1,1
2713212,2713231,19,1,0,0,2
2713232,2714726,1494,0,0,1,2
2714726,2714819,93,1,0,0,1
2714727,2714818,91,1,0,0,2
2714819,2714893,74,0,0,1,2
2714820,2714895,75,0,0,1,1
2714894,2714922,28,1,0,0,2
2714896,2714938,42,1,0,0,1
2714923,2716733,1810,0,0,1,2
2714939,2715093,154,0,0,1,1
2715094,2715105,11,1,0,0,1
2715106,2716734,1628,0,0,1,1
2716734,2716896,162,1,0,0,2
2716735,2716815,80,1,0,0,1
2716816,2716847,31,0,0,1,1
2716848,2716892,44,1,0,0,1
2716893,2716935,42,0,0,1,1
2716897,2716936,39,0,0,1,2
2716936,2716978,42,1,0,0,1
2716937,2716981,44,1,0,0,2
2716979,2717081,102,0,0,1,1
2716982,2717079,97,0,0,1,2
2717080,2717108,28,1,0,0,2
2717082,2717107,25,1,0,0,1
2717108,2717306,198,0,0,1,1
2717109,2718699,1590,0,0,1,2
2717307,2717322,15,1,0,0,1
2717323,2718697,1374,0,0,1,1
2718698,2718744,46,1,0,0,1
2718700,2718749,49,1,0,0,2
2718745,2718895,150,0,0,1,1
2718750,2718894,144,0,0,1,2
2718895,2718914,19,1,0,0,2
2718896,2718912,16,1,0,0,1
2718913,2719076,163,0,0,1,1
2718915,2719079,164,0,0,1,2
2719077,2719093,16,1,0,0,1
2719080,2719094,14,1,0,0,2
2719094,2719364,270,0,0,1,1
2719095,2719365,270,0,0,1,2
2719365,2719380,15,1,0,0,1
2719366,2719388,22,1,0,0,2
2719381,2720380,999,0,0,1,1
2719389,2720382,993,0,0,1,2
2720381,2720485,104,1,0,0,1
2720383,2720487,104,1,0,0,2
2720486,2720546,60,0,0,1,1
2720488,2720546,58,0,0,1,2
2720547,2720597,50,1,0,0,2
2720547,2720601,54,1,0,0,1
2720598,2720662,64,0,0,1,2
2720602,2720663,61,0,0,1,1
2720663,2720689,26,1,0,0,2
2720664,2720698,34,1,0,0,1
2720690,2721266,576,0,0,1,2
2720699,2721272,573,0,0,1,1
2721267,2721288,21,1,0,0,2
2721273,2721288,15,1,0,0,1
2721289,2722487,1198,0,0,1,2
2721289,2722488,1199,0,0,1,1
2722488,2722629,141,1,0,0,2
2722489,2722618,129,1,0,0,1
2722619,2722682,63,0,0,1,1
2722630,2722683,53,0,0,1,2
2722683,2722714,31,1,0,0,1
2722684,2722728,44,1,0,0,2
2722715,2722887,172,0,0,1,1
2722729,2722889,160,0,0,1,2
2722888,2722909,21,1,0,0,1
2722890,2722908,18,1,0,0,2
2722909,2724121,1212,0,0,1,2
2722910,2724135,1225,0,0,1,1
2724122,2724378,256,1,0,0,2
2724136,2724351,215,1,0,0,1
2724165,2724313,148,0,1,0,2
2724166,2724311,145,0,1,0,1
2724352,2724610,258,0,0,1,1
2724379,2724604,225,0,0,1,2
2724605,2724795,190,1,0,0,2
2724611,2724807,196,1,0,0,1
2724630,2724766,136,0,1,0,1
2724631,2724746,115,0,1,0,2
2724796,2724876,80,0,0,1,2
2724808,2724876,68,0,0,1,1
2724877,2724911,34,1,0,0,1
2724877,2724914,37,1,0,0,2
2724912,2725080,168,0,0,1,1
2724915,2725081,166,0,0,1,2
2725081,2725098,17,1,0,0,1
2725082,2725098,16,1,0,0,2
2725099,2726857,1758,0,0,1,1
2725099,2726857,1758,0,0,1,2
2726858,2726918,60,1,0,0,1
2726858,2726926,68,1,0,0,2
2726919,2727018,99,0,0,1,1
2726927,2727018,91,0,0,1,2
2727019,2727049,30,1,0,0,2
2727019,2727051,32,1,0,0,1
2727050,2728926,1876,0,0,1,2
2727052,2728926,1874,0,0,1,1
2728927,2729029,102,1,0,0,1
2728927,2729030,103,1,0,0,2
2729030,2729109,79,0,0,1,1
2729031,2729110,79,0,0,1,2
2729110,2729150,40,1,0,0,1
2729111,2729160,49,1,0,0,2
2729151,2729296,145,0,0,1,1
2729161,2729297,136,0,0,1,2
2729297,2729324,27,1,0,0,1
2729298,2729325,27,1,0,0,2
2729325,2730607,1282,0,0,1,1
2729326,2730608,1282,0,0,1,2
2730608,2730706,98,1,0,0,1
2730609,2730705,96,1,0,0,2
2730706,2730969,263,0,0,1,2
2730707,2730969,262,0,0,1,1
2730970,2731022,52,1,0,0,2
2730970,2731031,61,1,0,0,1
2731023,2731143,120,0,0,1,2
2731032,2731142,110,0,0,1,1
2731143,2731172,29,1,0,0,1
2731144,2731180,36,1,0,0,2
2731173,2731515,342,0,0,1,1
2731181,2733107,1926,0,0,1,2
2731516,2731527,11,1,0,0,1
2731528,2733105,1577,0,0,1,1
2733106,2733159,53,1,0,0,1
2733108,2733167,59,1,0,0,2
2733160,2733210,50,0,0,1,1
2733168,2733211,43,0,0,1,2
2733211,2733284,73,1,0,0,1
2733212,2733278,66,1,0,0,2
2733279,2733354,75,0,0,1,2
2733285,2733353,68,0,0,1,1
2733354,2733398,44,1,0,0,1
2733355,2733398,43,1,0,0,2
2733399,2733487,88,0,0,1,1
2733399,2733487,88,0,0,1,2
2733488,2733518,30,1,0,0,2
2733488,2733520,32,1,0,0,1
2733519,2735090,1571,0,0,1,2
2733521,2735090,1569,0,0,1,1
2735091,2735142,51,1,0,0,2
2735091,2735150,59,1,0,0,1
2735143,2735254,111,0,0,1,2
2735151,2735255,104,0,0,1,1
2735255,2735364,109,1,0,0,2
2735256,2735355,99,1,0,0,1
2735356,2735459,103,0,0,1,1
2735365,2735459,94,0,0,1,2
2735460,2735528,68,1,0,0,2
2735460,2735529,69,1,0,0,1
2735529,2735664,135,0,0,1,2
2735530,2735670,140,0,0,1,1
2735665,2735683,18,1,0,0,2
2735671,2735684,13,1,0,0,1
2735684,2735822,138,0,0,1,2
2735685,2735821,136,0,0,1,1
2735822,2735833,11,1,0,0,1
2735823,2735838,15,1,0,0,2
2735834,2737074,1240,0,0,1,1
2735839,2737074,1235,0,0,1,2
2737075,2737091,16,1,0,0,1
2737075,2737092,17,1,0,0,2
2737092,2737513,421,0,0,1,1
2737093,2737512,419,0,0,1,2
2737513,2737611,98,1,0,0,2
2737514,2737613,99,1,0,0,1
2737612,2737695,83,0,0,1,2
2737614,2737694,80,0,0,1,1
2737695,2737737,42,1,0,0,1
2737696,2737728,32,1,0,0,2
2737729,2738002,273,0,0,1,2
2737738,2737995,257,0,0,1,1
2737996,2738031,35,1,0,0,1
2738003,2738023,20,1,0,0,2
2738024,2738332,308,0,0,1,2
2738032,2738327,295,0,0,1,1
2738328,2738348,20,1,0,0,1
2738333,2738343,10,1,0,0,2
2738344,2739467,1123,0,0,1,2
2738349,2739465,1116,0,0,1,1
2739466,2739553,87,1,0,0,1
2739468,2739553,85,1,0,0,2
2739554,2739857,303,0,0,1,1
2739554,2739857,303,0,0,1,2
2739858,2739934,76,1,0,0,2
2739858,2739937,79,1,0,0,1
2739935,2740005,70,0,0,1,2
2739938,2740004,66,0,0,1,1
2740005,2740052,47,1,0,0,1
2740006,2740053,47,1,0,0,2
2740053,2740153,100,0,0,1,1
2740054,2740153,99,0,0,1,2
2740154,2740183,29,1,0,0,2
2740154,2740186,32,1,0,0,1
2740184,2740633,449,0,0,1,2
2740187,2740424,237,0,0,1,1
2740425,2740445,20,1,0,0,1
2740446,2740632,186,0,0,1,1
2740633,2740653,20,1,0,0,1
2740634,2740648,14,1,0,0,2
2740649,2741761,1112,0,0,1,2
2740654,2741761,1107,0,0,1,1
2741762,2741880,118,1,0,0,1
2741762,2741882,120,1,0,0,2
2741881,2742158,277,0,0,1,1
2741883,2742158,275,0,0,1,2
2742159,2742239,80,1,0,0,2
2742159,2742240,81,1,0,0,1
2742240,2742361,121,0,0,1,2
2742241,2742357,116,0,0,1,1
2742358,2742387,29,1,0,0,1
2742362,2742386,24,1,0,0,2
2742387,2742767,380,0,0,1,2
2742388,2742775,387,0,0,1,1
2742768,2742963,195,1,0,0,2
2742776,2742933,157,1,0,0,1
2742795,2742895,100,0,1,0,2
2742801,2742892,91,0,1,0,1
2742934,2743088,154,0,0,1,1
2742964,2743086,122,0,0,1,2
2743087,2743115,28,1,0,0,2
2743089,2743108,19,1,0,0,1
2743109,2744824,1715,0,0,1,1
2743116,2744824,1708,0,0,1,2
2744825,2744930,105,1,0,0,1
2744825,2744936,111,1,0,0,2
2744931,2744991,60,0,0,1,1
2744937,2744992,55,0,0,1,2
2744992,2745037,45,1,0,0,1
2744993,2745037,44,1,0,0,2
2745038,2745098,60,0,0,1,1
2745038,2745099,61,0,0,1,2
2745099,2745133,34,1,0,0,1
2745100,2745142,42,1,0,0,2
2745134,2745438,304,0,0,1,1
2745143,2745437,294,0,0,1,2
2745438,2745464,26,1,0,0,2
2745439,2745465,26,1,0,0,1
2745465,2746479,1014,0,0,1,2
2745466,2746479,1013,0,0,1,1
2746480,2746531,51,1,0,0,2
2746480,2746532,52,1,0,0,1
2746532,2746724,192,0,0,1,2
2746533,2746724,191,0,0,1,1
2746725,2746775,50,1,0,0,1
2746725,2746775,50,1,0,0,2
2746776,2746900,124,0,0,1,1
2746776,2746901,125,0,0,1,2
2746901,2746977,76,1,0,0,1
2746902,2746966,64,1,0,0,2
2746967,2747073,106,0,0,1,2
2746978,2747070,92,0,0,1,1
2747071,2747099,28,1,0,0,1
2747074,2747099,25,1,0,0,2
2747100,2747267,167,0,0,1,1
2747100,2747267,167,0,0,1,2
2747268,2747294,26,1,0,0,2
2747268,2747295,27,1,0,0,1
2747295,2747886,591,0,0,1,2
2747296,2747885,589,0,0,1,1
2747886,2747914,28,1,0,0,1
2747887,2747913,26,1,0,0,2
2747914,2748683,769,0,0,1,2
2747915,2748684,769,0,0,1,1
2748684,2748765,81,1,0,0,2
2748685,2748766,81,1,0,0,1
2748766,2749120,354,0,0,1,2
2748767,2749120,353,0,0,1,1
2749121,2749194,73,1,0,0,1
2749121,2749204,83,1,0,0,2
2749195,2749283,88,0,0,1,1
2749205,2749284,79,0,0,1,2
2749284,2749317,33,1,0,0,1
2749285,2749308,23,1,0,0,2
2749309,2749561,252,0,0,1,2
2749318,2749566,248,0,0,1,1
2749562,2749587,25,1,0,0,2
2749567,2749587,20,1,0,0,1
2749588,2750905,1317,0,0,1,2
2749588,2751310,1722,0,0,1,1
2750906,2750910,4,1,0,0,2
2750911,2751311,400,0,0,1,2
2751311,2751410,99,1,0,0,1
2751312,2751412,100,1,0,0,2
2751411,2751476,65,0,0,1,1
2751413,2751475,62,0,0,1,2
2751476,2751804,328,1,0,0,2
2751477,2751778,301,1,0,0,1
2751568,2751727,159,0,1,0,2
2751569,2751743,174,0,1,0,1
2751779,2751872,93,0,0,1,1
2751805,2751871,66,0,0,1,2
2751872,2751893,21,1,0,0,2
2751873,2751901,28,1,0,0,1
2751894,2752215,321,0,0,1,2
2751902,2752212,310,0,0,1,1
2752213,2752233,20,1,0,0,1
2752216,2752233,17,1,0,0,2
2752234,2752416,182,0,0,1,2
2752234,2752419,185,0,0,1,1
2752417,2752430,13,1,0,0,2
2752420,2752435,15,1,0,0,1
2752431,2754104,1673,0,0,1,2
2752436,2752881,445,0,0,1,1
2752882,2752902,20,1,0,0,1
2752903,2754103,1200,0,0,1,1
2754104,2754192,88,1,0,0,1
2754105,2754191,86,1,0,0,2
2754192,2754270,78,0,0,1,2
2754193,2754272,79,0,0,1,1
2754271,2754315,44,1,0,0,2
2754273,2754317,44,1,0,0,1
2754316,2754788,472,0,0,1,2
2754318,2754509,191,0,0,1,1
2754510,2754516,6,1,0,0,1
2754517,2755001,484,0,0,1,1
2754789,2754797,8,1,0,0,2
2754798,2754996,198,0,0,1,2
2754997,2755025,28,1,0,0,2
2755002,2755025,23,1,0,0,1
2755026,2756012,986,0,0,1,1
2755026,2756012,986,0,0,1,2
2756013,2756108,95,1,0,0,1
2756013,2756108,95,1,0,0,2
2756109,2756268,159,0,0,1,1
2756109,2756268,159,0,0,1,2
2756269,2756316,47,1,0,0,2
2756269,2756319,50,1,0,0,1
2756317,2756439,122,0,0,1,2
2756320,2756436,116,0,0,1,1
2756437,2756458,21,1,0,0,1
2756440,2756450,10,1,0,0,2
2756451,2756829,378,0,0,1,2
2756459,2756823,364,0,0,1,1
2756824,2756853,29,1,0,0,1
2756830,2756854,24,1,0,0,2
2756854,2757068,214,0,0,1,1
2756855,2757069,214,0,0,1,2
2757069,2757091,22,1,0,0,1
2757070,2757091,21,1,0,0,2
2757092,2757224,132,0,0,1,1
2757092,2758001,909,0,0,1,2
2757225,2757232,7,1,0,0,1
2757233,2758000,767,0,0,1,1
2758001,2758019,18,1,0,0,1
2758002,2758017,15,1,0,0,2
2758018,2758664,646,0,0,1,2
2758020,2758663,643,0,0,1,1
2758664,2758711,47,1,0,0,1
2758665,2758713,48,1,0,0,2
2758712,2759100,388,0,0,1,1
2758714,2759093,379,0,0,1,2
2759094,2759295,201,1,0,0,2
2759101,2759285,184,1,0,0,1
2759117,2759249,132,0,1,0,2
2759118,2759251,133,0,1,0,1
2759286,2759816,530,0,0,1,1
2759296,2759815,519,0,0,1,2
2759816,2759835,19,1,0,0,2
2759817,2759840,23,1,0,0,1
2759836,2760412,576,0,0,1,2
2759841,2760414,573,0,0,1,1
2760413,2760443,30,1,0,0,2
2760415,2760448,33,1,0,0,1
2760444,2760924,480,0,0,1,2
2760449,2760924,475,0,0,1,1
2760925,2761099,174,1,0,0,1
2760925,2761105,180,1,0,0,2
2760944,2761061,117,0,1,0,1
2760946,2761057,111,0,1,0,2
2761100,2761473,373,0,0,1,1
2761106,2761474,368,0,0,1,2
2761474,2761713,239,1,0,0,1
2761475,2761677,202,1,0,0,2
2761493,2761668,175,0,1,0,1
2761499,2761648,149,0,1,0,2
2761678,2763074,1396,0,0,1,2
2761714,2763073,1359,0,0,1,1
2763074,2763098,24,1,0,0,1
2763075,2763099,24,1,0,0,2
2763099,2763467,368,0,0,1,1
2763100,2763765,665,0,0,1,2
2763468,2763478,10,1,0,0,1
2763479,2763765,286,0,0,1,1
2763766,2763795,29,1,0,0,2
2763766,2763796,30,1,0,0,1
2763796,2764055,259,0,0,1,2
2763797,2764058,261,0,0,1,1
2764056,2764260,204,1,0,0,2
2764059,2764283,224,1,0,0,1
2764075,2764245,170,0,1,0,1
2764076,2764228,152,0,1,0,2
2764261,2764516,255,0,0,1,2
2764284,2764515,231,0,0,1,1
2764516,2764563,47,1,0,0,1
2764517,2764562,45,1,0,0,2
2764563,2764856,293,0,0,1,2
2764564,2764855,291,0,0,1,1
2764856,2764895,39,1,0,0,1
2764857,2764903,46,1,0,0,2
2764896,2765439,543,0,0,1,1
2764904,2765439,535,0,0,1,2
2765440,2765472,32,1,0,0,1
2765440,2765474,34,1,0,0,2
2765473,2765742,269,0,0,1,1
2765475,2765742,267,0,0,1,2
2765743,2765764,21,1,0,0,2
2765743,2765765,22,1,0,0,1
2765765,2766397,632,0,0,1,2
2765766,2766397,631,0,0,1,1
2766398,2766418,20,1,0,0,1
2766398,2766419,21,1,0,0,2
2766419,2767026,607,0,0,1,1
2766420,2767026,606,0,0,1,2
2767027,2767045,18,1,0,0,2
2767027,2767058,31,1,0,0,1
2767046,2767301,255,0,0,1,2
2767059,2767299,240,0,0,1,1
2767300,2767529,229,1,0,0,1
2767302,2767501,199,1,0,0,2
2767318,2767484,166,0,1,0,1
2767322,2767461,139,0,1,0,2
2767502,2767721,219,0,0,1,2
2767530,2767716,186,0,0,1,1
2767717,2767749,32,1,0,0,1
2767722,2767749,27,1,0,0,2
2767750,2768068,318,0,0,1,2
2767750,2768070,320,0,0,1,1
2768069,2768100,31,1,0,0,2
2768071,2768102,31,1,0,0,1
2768101,2768591,490,0,0,1,2
2768103,2768590,487,0,0,1,1
2768591,2768618,27,1,0,0,1
2768592,2768618,26,1,0,0,2
2768619,2768878,259,0,0,1,1
2768619,2768878,259,0,0,1,2
2768879,2768930,51,1,0,0,1
2768879,2768932,53,1,0,0,2
2768931,2769251,320,0,0,1,1
2768933,2769255,322,0,0,1,2
2769252,2769302,50,1,0,0,1
2769256,2769302,46,1,0,0,2
2769303,2769652,349,0,0,1,1
2769303,2769652,349,0,0,1,2
2769653,2769681,28,1,0,0,1
2769653,2769682,29,1,0,0,2
2769682,2769995,313,0,0,1,1
2769683,2769995,312,0,0,1,2
2769996,2770046,50,1,0,0,1
2769996,2770047,51,1,0,0,2
2770047,2770733,686,0,0,1,1
2770048,2770730,682,0,0,1,2
2770731,2770937,206,1,0,0,2
2770734,2770971,237,1,0,0,1
2770748,2770905,157,0,1,0,2
2770749,2770930,181,0,1,0,1
2770938,2771361,423,0,0,1,2
2770972,2771360,388,0,0,1,1
2771361,2771395,34,1,0,0,1
2771362,2771382,20,1,0,0,2
2771383,2772094,711,0,0,1,2
2771396,2772095,699,0,0,1,1
2772095,2772126,31,1,0,0,2
2772096,2772120,24,1,0,0,1
2772121,2772520,399,0,0,1,1
2772127,2772522,395,0,0,1,2
2772521,2772550,29,1,0,0,1
2772523,2772540,17,1,0,0,2
2772541,2773384,843,0,0,1,2
2772551,2773383,832,0,0,1,1
2773384,2773407,23,1,0,0,1
2773385,2773408,23,1,0,0,2
2773408,2774464,1056,0,0,1,1
2773409,2774461,1052,0,0,1,2
2774462,2774679,217,1,0,0,2
2774465,2774705,240,1,0,0,1
2774480,2774671,191,0,1,0,1
2774482,2774646,164,0,1,0,2
2774680,2775462,782,0,0,1,2
2774706,2775462,756,0,0,1,1
2775463,2775494,31,1,0,0,1
2775463,2775501,38,1,0,0,2
2775495,2776007,512,0,0,1,1
2775502,2776007,505,0,0,1,2
2776008,2776030,22,1,0,0,2
2776008,2776031,23,1,0,0,1
2776031,2776860,829,0,0,1,2
2776032,2776863,831,0,0,1,1
2776861,2776882,21,1,0,0,2
2776864,2776885,21,1,0,0,1
2776883,2777991,1108,0,0,1,2
2776886,2777990,1104,0,0,1,1
2777991,2778027,36,1,0,0,1
2777992,2778021,29,1,0,0,2
2778022,2778248,226,0,0,1,2
2778028,2778251,223,0,0,1,1
2778249,2778455,206,1,0,0,2
2778252,2778475,223,1,0,0,1
2778268,2778419,151,0,1,0,2
2778268,2778431,163,0,1,0,1
2778456,2778640,184,0,0,1,2
2778476,2778639,163,0,0,1,1
2778640,2778693,53,1,0,0,1
2778641,2778691,50,1,0,0,2
2778692,2778923,231,0,0,1,2
2778694,2778922,228,0,0,1,1
2778923,2778971,48,1,0,0,1
2778924,2778971,47,1,0,0,2
2778972,2779488,516,0,0,1,1
2778972,2779488,516,0,0,1,2
2779489,2779522,33,1,0,0,2
2779489,2779523,34,1,0,0,1
2779523,2779745,222,0,0,1,2
2779524,2779745,221,0,0,1,1
2779746,2779954,208,1,0,0,2
2779746,2779998,252,1,0,0,1
2779762,2779953,191,0,1,0,1
2779766,2779922,156,0,1,0,2
2779955,2780267,312,0,0,1,2
2779999,2780266,267,0,0,1,1
2780267,2780302,35,1,0,0,1
2780268,2780303,35,1,0,0,2
2780303,2780571,268,0,0,1,1
2780304,2780571,267,0,0,1,2
2780572,2780620,48,1,0,0,2
2780572,2780621,49,1,0,0,1
2780621,2781049,428,0,0,1,2
2780622,2781049,427,0,0,1,1
2781050,2781071,21,1,0,0,2
2781050,2781073,23,1,0,0,1
2781072,2781418,346,0,0,1,2
2781074,2781418,344,0,0,1,1
2781419,2781632,213,1,0,0,2
2781419,2781665,246,1,0,0,1
2781435,2781621,186,0,1,0,1
2781439,2781598,159,0,1,0,2
2781633,2783010,1377,0,0,1,2
2781666,2783010,1344,0,0,1,1
2783011,2783239,228,1,0,0,2
2783011,2783269,258,1,0,0,1
2783029,2783225,196,0,1,0,1
2783031,2783203,172,0,1,0,2
2783240,2783564,324,0,0,1,2
2783270,2783564,294,0,0,1,1
2783565,2783635,70,1,0,0,1
2783565,2783635,70,1,0,0,2
2783636,2783857,221,0,0,1,1
2783636,2783858,222,0,0,1,2
2783858,2783927,69,1,0,0,1
2783859,2783927,68,1,0,0,2
2783928,2784251,323,0,0,1,1
2783928,2784251,323,0,0,1,2
2784252,2784333,81,1,0,0,2
2784252,2784334,82,1,0,0,1
2784334,2784728,394,0,0,1,2
2784335,2784727,392,0,0,1,1
2784728,2784797,69,1,0,0,1
2784729,2784798,69,1,0,0,2
2784798,2785093,295,0,0,1,1
2784799,2785088,289,0,0,1,2
2785089,2785268,179,1,0,0,2
2785094,2785273,179,1,0,0,1
2785108,2785228,120,0,1,0,2
2785108,2785237,129,0,1,0,1
2785269,2785442,173,0,0,1,2
2785274,2785440,166,0,0,1,1
2785441,2785497,56,1,0,0,1
2785443,2785494,51,1,0,0,2
2785495,2785814,319,0,0,1,2
2785498,2785814,316,0,0,1,1
2785815,2786550,735,1,0,0,2
2785815,2786615,800,1,0,0,1
2785872,2786539,667,0,1,0,2
2785873,2786566,693,0,1,0,1
2786551,2786917,366,0,0,1,2
2786616,2786916,300,0,0,1,1
2786917,2786971,54,1,0,0,1
2786918,2786966,48,1,0,0,2
2786967,2787370,403,0,0,1,2
2786972,2787370,398,0,0,1,1
2787371,2787527,156,1,0,0,2
2787371,2787550,179,1,0,0,1
2787391,2787493,102,0,1,0,2
2787391,2787515,124,0,1,0,1
2787528,2787818,290,0,0,1,2
2787551,2787816,265,0,0,1,1
2787817,2787842,25,1,0,0,1
2787819,2787840,21,1,0,0,2
2787841,2788323,482,0,0,1,2
2787843,2788322,479,0,0,1,1
2788323,2788402,79,1,0,0,1
2788324,2788402,78,1,0,0,2
2788403,2788521,118,0,0,1,1
2788403,2788521,118,0,0,1,2
2788522,2788545,23,1,0,0,1
2788522,2788548,26,1,0,0,2
2788546,2788980,434,0,0,1,1
2788549,2788978,429,0,0,1,2
2788979,2788994,15,1,0,0,2
2788981,2788991,10,1,0,0,1
2788992,2789630,638,0,0,1,1
2788995,2789630,635,0,0,1,2
2789631,2789658,27,1,0,0,2
2789631,2789659,28,1,0,0,1
2789659,2791032,1373,0,0,1,2
2789660,2791587,1927,0,0,1,1
2791033,2791042,9,1,0,0,2
2791043,2791593,550,0,0,1,2
2791588,2791893,305,1,0,0,1
2791594,2791792,198,1,0,0,2
2791605,2791815,210,0,1,0,1
2791607,2791763,156,0,1,0,2
2791793,2791864,71,0,0,1,2
2791865,2791891,26,1,0,0,2
2791892,2792238,346,0,0,1,2
2791894,2792232,338,0,0,1,1
2792233,2792572,339,1,0,0,1
2792239,2792452,213,1,0,0,2
2792251,2792479,228,0,1,0,1
2792255,2792427,172,0,1,0,2
2792453,2792546,93,0,0,1,2
2792547,2792564,17,1,0,0,2
2792565,2793776,1211,0,0,1,2
2792573,2793775,1202,0,0,1,1
2793776,2793803,27,1,0,0,1
2793777,2793804,27,1,0,0,2
2793804,2794348,544,0,0,1,1
2793805,2794349,544,0,0,1,2
2794349,2794414,65,1,0,0,1
2794350,2794415,65,1,0,0,2
2794415,2794661,246,0,0,1,1
2794416,2795052,636,0,0,1,2
2794662,2794679,17,1,0,0,1
2794680,2795053,373,0,0,1,1
2795053,2795072,19,1,0,0,2
2795054,2795064,10,1,0,0,1
2795065,2797087,2022,0,0,1,1
2795073,2797088,2015,0,0,1,2
2797088,2797346,258,1,0,0,1
2797089,2797332,243,1,0,0,2
2797104,2797313,209,0,1,0,1
2797105,2797280,175,0,1,0,2
2797333,2797692,359,0,0,1,2
2797347,2797691,344,0,0,1,1
2797692,2797751,59,1,0,0,1
2797693,2797752,59,1,0,0,2
2797752,2798097,345,0,0,1,1
2797753,2798096,343,0,0,1,2
2798097,2798262,165,1,0,0,2
2798098,2798251,153,1,0,0,1
2798116,2798219,103,0,1,0,1
2798117,2798212,95,0,1,0,2
2798252,2798302,50,0,0,1,1
2798263,2798301,38,0,0,1,2
2798302,2798351,49,1,0,0,2
2798303,2798343,40,1,0,0,1
2798344,2798420,76,0,0,1,1
2798352,2798419,67,0,0,1,2
2798420,2798455,35,1,0,0,2
2798421,2798457,36,1,0,0,1
2798456,2798568,112,0,0,1,2
2798458,2798569,111,0,0,1,1
2798569,2798596,27,1,0,0,2
2798570,2798611,41,1,0,0,1
2798597,2798817,220,0,0,1,2
2798612,2798812,200,0,0,1,1
2798813,2798830,17,1,0,0,1
2798818,2798837,19,1,0,0,2
2798831,2800908,2077,0,0,1,1
2798838,2800906,2068,0,0,1,2
2800907,2800915,8,1,0,0,2
2800909,2800919,10,1,0,0,1
2800916,2801078,162,0,0,1,2
2800920,2801078,158,0,0,1,1
2801079,2801149,70,1,0,0,1
2801079,2801150,71,1,0,0,2
2801150,2801365,215,0,0,1,1
2801151,2801365,214,0,0,1,2
2801366,2801395,29,1,0,0,2
2801366,2801399,33,1,0,0,1
2801396,2802375,979,0,0,1,2
2801400,2802375,975,0,0,1,1
2802376,2802398,22,1,0,0,1
2802376,2802406,30,1,0,0,2
2802399,2803395,996,0,0,1,1
2802407,2803394,987,0,0,1,2
2803395,2803496,101,1,0,0,2
2803396,2803495,99,1,0,0,1
2803496,2804827,1331,0,0,1,1
2803497,2804828,1331,0,0,1,2
2804828,2804869,41,1,0,0,1
2804829,2804867,38,1,0,0,2
2804868,2805029,161,0,0,1,2
2804870,2805029,159,0,0,1,1
2805030,2805090,60,1,0,0,1
2805030,2805093,63,1,0,0,2
2805091,2805249,158,0,0,1,1
2805094,2805250,156,0,0,1,2
2805250,2805271,21,1,0,0,1
2805251,2805261,10,1,0,0,2
2805262,2806148,886,0,0,1,2
2805272,2806149,877,0,0,1,1
2806149,2806165,16,1,0,0,2
2806150,2806171,21,1,0,0,1
2806166,2806971,805,0,0,1,2
2806172,2806970,798,0,0,1,1
2806971,2807034,63,1,0,0,1
2806972,2807027,55,1,0,0,2
2807028,2807299,271,0,0,1,2
2807035,2807298,263,0,0,1,1
2807299,2807342,43,1,0,0,1
2807300,2807323,23,1,0,0,2
2807324,2809277,1953,0,0,1,2
2807343,2809277,1934,0,0,1,1
2809278,2809514,236,1,0,0,1
2809278,2809526,248,1,0,0,2
2809311,2809466,155,0,1,0,2
2809311,2809469,158,0,1,0,1
2809515,2810239,724,0,0,1,1
2809527,2810239,712,0,0,1,2
2810240,2810280,40,1,0,0,1
2810240,2810282,42,1,0,0,2
2810281,2810435,154,0,0,1,1
2810283,2810435,152,0,0,1,2
2810436,2810454,18,1,0,0,2
2810436,2810455,19,1,0,0,1
2810455,2812135,1680,0,0,1,2
2810456,2812135,1679,0,0,1,1
2812136,2812208,72,1,0,0,2
2812136,2812213,77,1,0,0,1
2812209,2812303,94,0,0,1,2
2812214,2812303,89,0,0,1,1
2812304,2812326,22,1,0,0,2
2812304,2812334,30,1,0,0,1
2812327,2814507,2180,0,0,1,2
2812335,2814507,2172,0,0,1,1
2814508,2814569,61,1,0,0,2
2814508,2814570,62,1,0,0,1
2814570,2815907,1337,0,0,1,2
2814571,2815908,1337,0,0,1,1
2815908,2815989,81,1,0,0,2
2815909,2815988,79,1,0,0,1
2815989,2816118,129,0,0,1,1
2815990,2816117,127,0,0,1,2
2816118,2816141,23,1,0,0,2
2816119,2816148,29,1,0,0,1
2816142,2816361,219,0,0,1,2
2816149,2816358,209,0,0,1,1
2816359,2816489,130,1,0,0,1
2816362,2816496,134,1,0,0,2
2816378,2816450,72,0,1,0,1
2816382,2816444,62,0,1,0,2
2816490,2817831,1341,0,0,1,1
2816497,2817832,1335,0,0,1,2
2817832,2817919,87,1,0,0,1
2817833,2817908,75,1,0,0,2
2817909,2818096,187,0,0,1,2
2817920,2818095,175,0,0,1,1
2818096,2818118,22,1,0,0,1
2818097,2818119,22,1,0,0,2
2818119,2818366,247,0,0,1,1
2818120,2818368,248,0,0,1,2
2818367,2818388,21,1,0,0,1
2818369,2818386,17,1,0,0,2
2818387,2820296,1909,0,0,1,2
2818389,2820295,1906,0,0,1,1
2820296,2820319,23,1,0,0,1
2820297,2820328,31,1,0,0,2
2820320,2820617,297,0,0,1,1
2820329,2820616,287,0,0,1,2
2820617,2820692,75,1,0,0,2
2820618,2820693,75,1,0,0,1
2820693,2821487,794,0,0,1,2
2820694,2821485,791,0,0,1,1
2821486,2821689,203,1,0,0,1
2821488,2821673,185,1,0,0,2
2821502,2821642,140,0,1,0,1
2821505,2821626,121,0,1,0,2
2821674,2821819,145,0,0,1,2
2821690,2821819,129,0,0,1,1
2821820,2821895,75,1,0,0,1
2821820,2821904,84,1,0,0,2
2821896,2821997,101,0,0,1,1
2821905,2821996,91,0,0,1,2
2821997,2822037,40,1,0,0,2
2821998,2822034,36,1,0,0,1
2822035,2824207,2172,0,0,1,1
2822038,2824206,2168,0,0,1,2
2824207,2824258,51,1,0,0,2
2824208,2824249,41,1,0,0,1
2824250,2824518,268,0,0,1,1
2824259,2824525,266,0,0,1,2
2824519,2824541,22,1,0,0,1
2824526,2824541,15,1,0,0,2
2824542,2826718,2176,0,0,1,1
2824542,2826719,2177,0,0,1,2
2826719,2826876,157,1,0,0,1
2826720,2826862,142,1,0,0,2
2826785,2826835,50,0,1,0,1
2826863,2827885,1022,0,0,1,2
2826877,2827885,1008,0,0,1,1
2827886,2827961,75,1,0,0,2
2827886,2827969,83,1,0,0,1
2827962,2828070,108,0,0,1,2
2827970,2828067,97,0,0,1,1
2828068,2828194,126,1,0,0,1
2828071,2828090,19,1,0,0,2
2828091,2829440,1349,0,0,1,2
2828195,2828396,201,0,0,1,1
2828397,2828455,58,1,0,0,1
2828456,2829439,983,0,0,1,1
2829440,2829508,68,1,0,0,1
2829441,2829502,61,1,0,0,2
2829503,2829623,120,0,0,1,2
2829509,2829622,113,0,0,1,1
2829623,2829643,20,1,0,0,1
2829624,2829642,18,1,0,0,2
2829643,2829758,115,0,0,1,2
2829644,2829768,124,0,0,1,1
2829759,2830013,254,1,0,0,2
2829769,2829995,226,1,0,0,1
2829784,2829962,178,0,1,0,2
2829785,2829954,169,0,1,0,1
2829996,2830088,92,0,0,1,1
2830014,2830089,75,0,0,1,2
2830089,2830109,20,1,0,0,1
2830090,2830106,16,1,0,0,2
2830107,2832291,2184,0,0,1,2
2830110,2832289,2179,0,0,1,1
2832290,2832373,83,1,0,0,1
2832292,2832376,84,1,0,0,2
2832374,2832703,329,0,0,1,1
2832377,2832702,325,0,0,1,2
2832703,2832762,59,1,0,0,2
2832704,2832769,65,1,0,0,1
2832763,2832871,108,0,0,1,2
2832770,2832872,102,0,0,1,1
2832872,2832890,18,1,0,0,2
2832873,2832900,27,1,0,0,1
2832891,2833694,803,0,0,1,2
2832901,2833693,792,0,0,1,1
2833694,2833753,59,1,0,0,1
2833695,2833747,52,1,0,0,2
2833748,2834028,280,0,0,1,2
2833754,2834027,273,0,0,1,1
2834028,2834087,59,1,0,0,1
2834029,2834077,48,1,0,0,2
2834078,2834662,584,0,0,1,2
2834088,2834664,576,0,0,1,1
2834663,2834701,38,1,0,0,2
2834665,2834701,36,1,0,0,1
2834702,2834874,172,0,0,1,2
2834702,2834875,173,0,0,1,1
2834875,2834901,26,1,0,0,2
2834876,2834902,26,1,0,0,1
2834902,2836846,1944,0,0,1,2
2834903,2836849,1946,0,0,1,1
2836847,2837051,204,1,0,0,2
2836850,2837071,221,1,0,0,1
2836865,2837027,162,0,1,0,2
2836865,2837028,163,0,1,0,1
2837052,2837559,507,0,0,1,2
2837072,2837559,487,0,0,1,1
2837560,2837595,35,1,0,0,2
2837560,2837596,36,1,0,0,1
2837596,2838587,991,0,0,1,2
2837597,2838586,989,0,0,1,1
2838587,2838655,68,1,0,0,1
2838588,2838657,69,1,0,0,2
2838656,2840140,1484,0,0,1,1
2838658,2840140,1482,0,0,1,2
2840141,2840186,45,1,0,0,2
2840141,2840187,46,1,0,0,1
2840187,2840335,148,0,0,1,2
2840188,2840336,148,0,0,1,1
2840336,2840356,20,1,0,0,2
2840337,2840358,21,1,0,0,1
2840357,2842655,2298,0,0,1,2
2840359,2842656,2297,0,0,1,1
2842656,2842719,63,1,0,0,2
2842657,2842719,62,1,0,0,1
2842720,2843941,1221,0,0,1,1
2842720,2843941,1221,0,0,1,2
2843942,2843988,46,1,0,0,1
2843942,2843988,46,1,0,0,2
2843989,2844135,146,0,0,1,1
2843989,2844136,147,0,0,1,2
2844136,2844146,10,1,0,0,1
2844137,2844147,10,1,0,0,2
2844147,2845501,1354,0,0,1,1
2844148,2845502,1354,0,0,1,2
2845502,2845574,72,1,0,0,1
2845503,2845572,69,1,0,0,2
2845573,2845756,183,0,0,1,2
2845575,2845752,177,0,0,1,1
2845753,2845769,16,1,0,0,1
2845757,2845769,12,1,0,0,2
2845770,2847628,1858,0,0,1,2
2845770,2847633,1863,0,0,1,1
2847629,2847887,258,1,0,0,2
2847634,2847928,294,1,0,0,1
2847667,2847886,219,0,1,0,1
2847670,2847858,188,0,1,0,2
2847888,2847961,73,0,0,1,2
2847929,2847961,32,0,0,1,1
2847962,2847989,27,1,0,0,2
2847962,2847999,37,1,0,0,1
2847990,2848174,184,0,0,1,2
2848000,2848171,171,0,0,1,1
2848172,2848206,34,1,0,0,1
2848175,2848205,30,1,0,0,2
2848206,2849250,1044,0,0,1,2
2848207,2849250,1043,0,0,1,1
2849251,2849325,74,1,0,0,2
2849251,2849326,75,1,0,0,1
2849326,2849450,124,0,0,1,2
2849327,2849449,122,0,0,1,1
2849450,2849475,25,1,0,0,1
2849451,2849477,26,1,0,0,2
2849476,2849688,212,0,0,1,1
2849478,2849690,212,0,0,1,2
2849689,2849716,27,1,0,0,1
2849691,2849716,25,1,0,0,2
2849717,2851238,1521,0,0,1,1
2849717,2851240,1523,0,0,1,2
2851239,2851306,67,1,0,0,1
2851241,2851308,67,1,0,0,2
2851307,2851425,118,0,0,1,1
2851309,2851426,117,0,0,1,2
2851426,2851453,27,1,0,0,1
2851427,2851456,29,1,0,0,2
2851454,2851686,232,0,0,1,1
2851457,2851689,232,0,0,1,2
2851687,2851707,20,1,0,0,1
2851690,2851706,16,1,0,0,2
2851707,2853580,1873,0,0,1,2
2851708,2853580,1872,0,0,1,1
2853581,2853825,244,1,0,0,1
2853581,2853826,245,1,0,0,2
2853610,2853781,171,0,1,0,1
2853612,2853770,158,0,1,0,2
2853826,2854435,609,0,0,1,1
2853827,2854436,609,0,0,1,2
2854436,2854495,59,1,0,0,1
2854437,2854493,56,1,0,0,2
2854494,2854704,210,0,0,1,2
2854496,2854704,208,0,0,1,1
2854705,2854785,80,1,0,0,2
2854705,2854786,81,1,0,0,1
2854786,2854889,103,0,0,1,2
2854787,2854889,102,0,0,1,1
2854890,2854932,42,1,0,0,1
2854890,2854933,43,1,0,0,2
2854933,2855652,719,0,0,1,1
2854934,2855651,717,0,0,1,2
2855652,2855668,16,1,0,0,2
2855653,2855668,15,1,0,0,1
2855669,2857414,1745,0,0,1,1
2855669,2857416,1747,0,0,1,2
2857415,2857475,60,1,0,0,1
2857417,2857476,59,1,0,0,2
2857476,2857633,157,0,0,1,1
2857477,2857635,158,0,0,1,2
2857634,2857666,32,1,0,0,1
2857636,2857656,20,1,0,0,2
2857657,2859608,1951,0,0,1,2
2857667,2859607,1940,0,0,1,1
2859608,2859848,240,1,0,0,1
2859609,2859867,258,1,0,0,2
2859672,2859806,134,0,1,0,1
2859672,2859806,134,0,1,0,2
2859849,2860482,633,0,0,1,1
2859868,2860482,614,0,0,1,2
2860483,2860540,57,1,0,0,1
2860483,2860540,57,1,0,0,2
2860541,2861291,750,0,0,1,1
2860541,2861292,751,0,0,1,2
2861292,2861338,46,1,0,0,1
2861293,2861326,33,1,0,0,2
2861327,2861483,156,0,0,1,2
2861339,2861483,144,0,0,1,1
2861484,2861500,16,1,0,0,1
2861484,2861510,26,1,0,0,2
2861501,2862659,1158,0,0,1,1
2861511,2861747,236,0,0,1,2
2861748,2861762,14,1,0,0,2
2861763,2862660,897,0,0,1,2
2862660,2862684,24,1,0,0,1
2862661,2862684,23,1,0,0,2
2862685,2862913,228,0,0,1,1
2862685,2862914,229,0,0,1,2
2862914,2862991,77,1,0,0,1
2862915,2862981,66,1,0,0,2
2862982,2863082,100,0,0,1,2
2862992,2863081,89,0,0,1,1
2863082,2863126,44,1,0,0,1
2863083,2863125,42,1,0,0,2
2863126,2864978,1852,0,0,1,2
2863127,2865124,1997,0,0,1,1
2864979,2864993,14,1,0,0,2
2864994,2865124,130,0,0,1,2
2865125,2865342,217,1,0,0,2
2865125,2865382,257,1,0,0,1
2865144,2865353,209,0,1,0,1
2865146,2865321,175,0,1,0,2
2865343,2865368,25,0,0,1,2
2865369,2865373,4,1,0,0,2
2865374,2865541,167,0,0,1,2
2865383,2865543,160,0,0,1,1
2865542,2865566,24,1,0,0,2
2865544,2865566,22,1,0,0,1
2865567,2865998,431,0,0,1,2
2865567,2865999,432,0,0,1,1
2865999,2866044,45,1,0,0,2
2866000,2866052,52,1,0,0,1
2866045,2866274,229,0,0,1,2
2866053,2866274,221,0,0,1,1
2866275,2866346,71,1,0,0,2
2866275,2866348,73,1,0,0,1
2866347,2866394,47,0,0,1,2
2866349,2866394,45,0,0,1,1
2866395,2866440,45,1,0,0,2
2866395,2866442,47,1,0,0,1
2866441,2866566,125,0,0,1,2
2866443,2866565,122,0,0,1,1
2866566,2866597,31,1,0,0,1
2866567,2866590,23,1,0,0,2
2866591,2867614,1023,0,0,1,2
2866598,2867612,1014,0,0,1,1
2867613,2867641,28,1,0,0,1
2867615,2867641,26,1,0,0,2
2867642,2868167,525,0,0,1,1
2867642,2868167,525,0,0,1,2
2868168,2868239,71,1,0,0,1
2868168,2868240,72,1,0,0,2
2868240,2868399,159,0,0,1,1
2868241,2868398,157,0,0,1,2
2868399,2868435,36,1,0,0,2
2868400,2868439,39,1,0,0,1
2868436,2870308,1872,0,0,1,2
2868440,2870309,1869,0,0,1,1
2870309,2870318,9,1,0,0,2
2870310,2870316,6,1,0,0,1
2870317,2870399,82,0,0,1,1
2870319,2870397,78,0,0,1,2
2870398,2870579,181,1,0,0,2
2870400,2870584,184,1,0,0,1
2870428,2870543,115,0,1,0,2
2870431,2870540,109,0,1,0,1
2870580,2870808,228,0,0,1,2
2870585,2870808,223,0,0,1,1
2870809,2870842,33,1,0,0,1
2870809,2870842,33,1,0,0,2
2870843,2871082,239,0,0,1,2
2870843,2871084,241,0,0,1,1
2871083,2871132,49,1,0,0,2
2871085,2871132,47,1,0,0,1
2871133,2871892,759,0,0,1,1
2871133,2871894,761,0,0,1,2
2871893,2871973,80,1,0,0,1
2871895,2871977,82,1,0,0,2
2871974,2872121,147,0,0,1,1
2871978,2872119,141,0,0,1,2
2872120,2872138,18,1,0,0,2
2872122,2872126,4,1,0,0,1
2872127,2872482,355,0,0,1,1
2872139,2872477,338,0,0,1,2
2872478,2872488,10,1,0,0,2
2872483,2872488,5,1,0,0,1
2872489,2873267,778,0,0,1,1
2872489,2873267,778,0,0,1,2
2873268,2873345,77,1,0,0,2
2873268,2873347,79,1,0,0,1
2873346,2873520,174,0,0,1,2
2873348,2873520,172,0,0,1,1
2873521,2873565,44,1,0,0,2
2873521,2873566,45,1,0,0,1
2873566,2873871,305,0,0,1,2
2873567,2873869,302,0,0,1,1
2873870,2873893,23,1,0,0,1
2873872,2873903,31,1,0,0,2
2873894,2876278,2384,0,0,1,1
2873904,2876278,2374,0,0,1,2
2876279,2876483,204,1,0,0,1
2876279,2876486,207,1,0,0,2
2876306,2876446,140,0,1,0,1
2876307,2876434,127,0,1,0,2
2876484,2876649,165,0,0,1,1
2876487,2876649,162,0,0,1,2
2876650,2876683,33,1,0,0,1
2876650,2876683,33,1,0,0,2
2876684,2877044,360,0,0,1,1
2876684,2877047,363,0,0,1,2
2877045,2877137,92,1,0,0,1
2877048,2877139,91,1,0,0,2
2877138,2877371,233,0,0,1,1
2877140,2877371,231,0,0,1,2
2877372,2877423,51,1,0,0,2
2877372,2877425,53,1,0,0,1
2877424,2877658,234,0,0,1,2
2877426,2877659,233,0,0,1,1
2877659,2877737,78,1,0,0,2
2877660,2877737,77,1,0,0,1
2877738,2877855,117,0,0,1,1
2877738,2877856,118,0,0,1,2
2877856,2877878,22,1,0,0,1
2877857,2877886,29,1,0,0,2
2877879,2878136,257,0,0,1,1
2877887,2878131,244,0,0,1,2
2878132,2878147,15,1,0,0,2
2878137,2878142,5,1,0,0,1
2878143,2879721,1578,0,0,1,1
2878148,2879722,1574,0,0,1,2
2879722,2879785,63,1,0,0,1
2879723,2879779,56,1,0,0,2
2879780,2879943,163,0,0,1,2
2879786,2879943,157,0,0,1,1
2879944,2879974,30,1,0,0,1
2879944,2879974,30,1,0,0,2
2879975,2881841,1866,0,0,1,2
2879975,2881842,1867,0,0,1,1
2881842,2881880,38,1,0,0,2
2881843,2881859,16,1,0,0,1
2881860,2881970,110,0,0,1,1
2881881,2881972,91,0,0,1,2
2881971,2882228,257,1,0,0,1
2881973,2882225,252,1,0,0,2
2882003,2882179,176,0,1,0,1
2882004,2882165,161,0,1,0,2
2882226,2882626,400,0,0,1,2
2882229,2882625,396,0,0,1,1
2882626,2882662,36,1,0,0,1
2882627,2882662,35,1,0,0,2
2882663,2883793,1130,0,0,1,1
2882663,2883793,1130,0,0,1,2
2883794,2883820,26,1,0,0,2
2883794,2883830,36,1,0,0,1
2883821,2884021,200,0,0,1,2
2883831,2884021,190,0,0,1,1
2884022,2884036,14,1,0,0,2
2884022,2884037,15,1,0,0,1
2884037,2884991,954,0,0,1,2
2884038,2884985,947,0,0,1,1
2884986,2885006,20,1,0,0,1
2884992,2885006,14,1,0,0,2
2885007,2885133,126,0,0,1,1
2885007,2885134,127,0,0,1,2
2885134,2885201,67,1,0,0,1
2885135,2885200,65,1,0,0,2
2885201,2885307,106,0,0,1,2
2885202,2885307,105,0,0,1,1
2885308,2885341,33,1,0,0,1
2885308,2885345,37,1,0,0,2
2885342,2887373,2031,0,0,1,1
2885346,2887372,2026,0,0,1,2
2887373,2887636,263,1,0,0,2
2887374,2887650,276,1,0,0,1
2887408,2887582,174,0,1,0,2
2887408,2887601,193,0,1,0,1
2887637,2887820,183,0,0,1,2
2887651,2887821,170,0,0,1,1
2887821,2887878,57,1,0,0,2
2887822,2887871,49,1,0,0,1
2887872,2888140,268,0,0,1,1
2887879,2888141,262,0,0,1,2
2888141,2888184,43,1,0,0,1
2888142,2888187,45,1,0,0,2
2888185,2888438,253,0,0,1,1
2888188,2888438,250,0,0,1,2
2888439,2888506,67,1,0,0,2
2888439,2888513,74,1,0,0,1
2888507,2888669,162,0,0,1,2
2888514,2889007,493,0,0,1,1
2888670,2888689,19,1,0,0,2
2888690,2889005,315,0,0,1,2
2889006,2889031,25,1,0,0,2
2889008,2889021,13,1,0,0,1
2889022,2890513,1491,0,0,1,1
2889032,2890513,1481,0,0,1,2
2890514,2890586,72,1,0,0,2
2890514,2890594,80,1,0,0,1
2890587,2890698,111,0,0,1,2
2890595,2890697,102,0,0,1,1
2890698,2890730,32,1,0,0,1
2890699,2890722,23,1,0,0,2
2890723,2891494,771,0,0,1,2
2890731,2891501,770,0,0,1,1
2891495,2891706,211,1,0,0,2
2891502,2891673,171,1,0,0,1
2891520,2891631,111,0,1,0,1
2891521,2891635,114,0,1,0,2
2891674,2893045,1371,0,0,1,1
2891707,2893045,1338,0,0,1,2
2893046,2893101,55,1,0,0,1
2893046,2893107,61,1,0,0,2
2893102,2893499,397,0,0,1,1
2893108,2893498,390,0,0,1,2
2893499,2893723,224,1,0,0,2
2893500,2893699,199,1,0,0,1
2893526,2893659,133,0,1,0,2
2893531,2893653,122,0,1,0,1
2893700,2894530,830,0,0,1,1
2893724,2894530,806,0,0,1,2
2894531,2894621,90,1,0,0,1
2894531,2894625,94,1,0,0,2
2894622,2894711,89,0,0,1,1
2894626,2894712,86,0,0,1,2
2894712,2894746,34,1,0,0,1
2894713,2894745,32,1,0,0,2
2894746,2894889,143,0,0,1,2
2894747,2894888,141,0,0,1,1
2894889,2894917,28,1,0,0,1
2894890,2894915,25,1,0,0,2
2894916,2895030,114,0,0,1,2
2894918,2895032,114,0,0,1,1
2895031,2895405,374,1,0,0,2
2895033,2895411,378,1,0,0,1
2895053,2895305,252,0,1,0,2
2895053,2895330,277,0,1,0,1
2895406,2895670,264,0,0,1,2
2895412,2895667,255,0,0,1,1
2895668,2895689,21,1,0,0,1
2895671,2895689,18,1,0,0,2
2895690,2896246,556,0,0,1,1
2895690,2896246,556,0,0,1,2
2896247,2896266,19,1,0,0,2
2896247,2896269,22,1,0,0,1
2896267,2897491,1224,0,0,1,2
2896270,2896976,706,0,0,1,1
2896977,2896992,15,1,0,0,1
2896993,2897492,499,0,0,1,1
2897492,2897540,48,1,0,0,2
2897493,2897542,49,1,0,0,1
2897541,2897677,136,0,0,1,2
2897543,2897678,135,0,0,1,1
2897678,2897700,22,1,0,0,2
2897679,2897718,39,1,0,0,1
2897701,2899704,2003,0,0,1,2
2897719,2899705,1986,0,0,1,1
2899705,2899966,261,1,0,0,2
2899706,2899970,264,1,0,0,1
2899730,2899906,176,0,1,0,2
2899731,2899933,202,0,1,0,1
2899967,2900342,375,0,0,1,2
2899971,2900341,370,0,0,1,1
2900342,2900386,44,1,0,0,1
2900343,2900387,44,1,0,0,2
2900387,2901020,633,0,0,1,1
2900388,2901019,631,0,0,1,2
2901020,2901105,85,1,0,0,2
2901021,2901104,83,1,0,0,1
2901105,2901209,104,0,0,1,1
2901106,2901209,103,0,0,1,2
2901210,2901239,29,1,0,0,2
2901210,2901240,30,1,0,0,1
2901240,2901464,224,0,0,1,2
2901241,2901459,218,0,0,1,1
2901460,2901477,17,1,0,0,1
2901465,2901481,16,1,0,0,2
2901478,2901689,211,0,0,1,1
2901482,2901689,207,0,0,1,2
2901690,2901709,19,1,0,0,2
2901690,2901711,21,1,0,0,1
2901710,2901995,285,0,0,1,2
2901712,2901987,275,0,0,1,1
2901988,2902023,35,1,0,0,1
2901996,2902018,22,1,0,0,2
2902019,2902773,754,0,0,1,2
2902024,2902286,262,0,0,1,1
2902287,2902296,9,1,0,0,1
2902297,2902772,475,0,0,1,1
2902773,2902827,54,1,0,0,1
2902774,2902825,51,1,0,0,2
2902826,2902960,134,0,0,1,2
2902828,2902961,133,0,0,1,1
2902961,2902988,27,1,0,0,2
2902962,2902991,29,1,0,0,1
2902989,2903252,263,0,0,1,2
2902992,2903253,261,0,0,1,1
2903253,2903279,26,1,0,0,2
2903254,2903278,24,1,0,0,1
2903279,2905107,1828,0,0,1,1
2903280,2905100,1820,0,0,1,2
2905101,2905329,228,1,0,0,2
2905108,2905318,210,1,0,0,1
2905129,2905262,133,0,1,0,2
2905130,2905269,139,0,1,0,1
2905319,2905394,75,0,0,1,1
2905330,2905394,64,0,0,1,2
2905395,2905413,18,1,0,0,1
2905395,2905416,21,1,0,0,2
2905414,2905896,482,0,0,1,1
2905417,2905897,480,0,0,1,2
2905897,2905956,59,1,0,0,1
2905898,2905953,55,1,0,0,2
2905954,2906204,250,0,0,1,2
2905957,2906205,248,0,0,1,1
2906205,2906277,72,1,0,0,2
2906206,2906273,67,1,0,0,1
2906274,2906359,85,0,0,1,1
2906278,2906346,68,0,0,1,2
2906347,2906637,290,1,0,0,2
2906360,2906554,194,1,0,0,1
2906380,2906518,138,0,1,0,2
2906381,2906507,126,0,1,0,1
2906555,2906608,53,0,0,1,1
2906609,2906646,37,1,0,0,1
2906638,2907731,1093,0,0,1,2
2906647,2907732,1085,0,0,1,1
2907732,2907763,31,1,0,0,2
2907733,2907771,38,1,0,0,1
2907764,2907935,171,0,0,1,2
2907772,2907945,173,0,0,1,1
2907936,2908151,215,1,0,0,2
2907946,2908134,188,1,0,0,1
2907960,2908096,136,0,1,0,2
2907965,2908077,112,0,1,0,1
2908135,2908229,94,0,0,1,1
2908152,2908229,77,0,0,1,2
2908230,2908256,26,1,0,0,1
2908230,2908256,26,1,0,0,2
2908257,2908462,205,0,0,1,1
2908257,2908463,206,0,0,1,2
2908463,2908514,51,1,0,0,1
2908464,2908507,43,1,0,0,2
2908508,2908709,201,0,0,1,2
2908515,2908704,189,0,0,1,1
2908705,2908732,27,1,0,0,1
2908710,2908722,12,1,0,0,2
2908723,2910571,1848,0,0,1,2
2908733,2910573,1840,0,0,1,1
2910572,2910838,266,1,0,0,2
2910574,2910812,238,1,0,0,1
2910597,2910759,162,0,1,0,2
2910599,2910764,165,0,1,0,1
2910813,2911418,605,0,0,1,1
2910839,2911419,580,0,0,1,2
2911419,2911470,51,1,0,0,1
2911420,2911471,51,1,0,0,2
2911471,2911669,198,0,0,1,1
2911472,2911662,190,0,0,1,2
2911663,2911902,239,1,0,0,2
2911670,2911870,200,1,0,0,1
2911683,2911828,145,0,1,0,2
2911687,2911830,143,0,1,0,1
2911871,2912381,510,0,0,1,1
2911903,2912380,477,0,0,1,2
2912381,2912448,67,1,0,0,2
2912382,2912449,67,1,0,0,1
2912449,2912625,176,0,0,1,2
2912450,2912625,175,0,0,1,1
2912626,2912663,37,1,0,0,1
2912626,2912664,38,1,0,0,2
2912664,2913074,410,0,0,1,1
2912665,2913080,415,0,0,1,2
2913075,2913329,254,1,0,0,1
2913081,2913359,278,1,0,0,2
2913104,2913283,179,0,1,0,2
2913107,2913280,173,0,1,0,1
2913330,2913528,198,0,0,1,1
2913360,2913529,169,0,0,1,2
2913529,2913551,22,1,0,0,1
2913530,2913550,20,1,0,0,2
2913551,2913758,207,0,0,1,2
2913552,2913757,205,0,0,1,1
2913758,2913785,27,1,0,0,1
2913759,2913785,26,1,0,0,2
2913786,2914492,706,0,0,1,1
2913786,2914498,712,0,0,1,2
2914493,2914519,26,1,0,0,1
2914499,2914503,4,1,0,0,2
2914504,2914813,309,0,0,1,2
2914520,2914812,292,0,0,1,1
2914813,2914867,54,1,0,0,1
2914814,2914858,44,1,0,0,2
2914859,2915023,164,0,0,1,2
2914868,2915021,153,0,0,1,1
2915022,2915049,27,1,0,0,1
2915024,2915041,17,1,0,0,2
2915042,2917867,2825,0,0,1,2
2915050,2917870,2820,0,0,1,1
2917868,2918019,151,1,0,0,2
2917871,2917969,98,1,0,0,1
2917896,2917936,40,0,1,0,2
2917898,2917917,19,0,1,0,1
2917970,2918274,304,0,0,1,1
2918020,2918275,255,0,0,1,2
2918275,2918368,93,1,0,0,1
2918276,2918372,96,1,0,0,2
2918369,2918449,80,0,0,1,1
2918373,2918447,74,0,0,1,2
2918448,2918481,33,1,0,0,2
2918450,2918479,29,1,0,0,1
2918480,2918664,184,0,0,1,1
2918482,2918668,186,0,0,1,2
2918665,2918689,24,1,0,0,1
2918669,2918688,19,1,0,0,2
2918689,2919735,1046,0,0,1,2
2918690,2919738,1048,0,0,1,1
2919736,2919759,23,1,0,0,2
2919739,2919755,16,1,0,0,1
2919756,2920460,704,0,0,1,1
2919760,2920460,700,0,0,1,2
2920461,2920508,47,1,0,0,1
2920461,2920510,49,1,0,0,2
2920509,2920591,82,0,0,1,1
2920511,2920591,80,0,0,1,2
2920592,2920613,21,1,0,0,2
2920592,2920619,27,1,0,0,1
2920614,2922609,1995,0,0,1,2
2920620,2920792,172,0,0,1,1
2920793,2920809,16,1,0,0,1
2920810,2922617,1807,0,0,1,1
2922610,2922823,213,1,0,0,2
2922618,2922843,225,1,0,0,1
2922632,2922788,156,0,1,0,2
2922635,2922800,165,0,1,0,1
2922824,2923215,391,0,0,1,2
2922844,2923215,371,0,0,1,1
2923216,2923288,72,1,0,0,2
2923216,2923290,74,1,0,0,1
2923289,2923736,447,0,0,1,2
2923291,2923736,445,0,0,1,1
2923737,2923989,252,1,0,0,1
2923737,2923998,261,1,0,0,2
2923752,2923926,174,0,1,0,2
2923754,2923936,182,0,1,0,1
2923990,2924205,215,0,0,1,1
2923999,2924205,206,0,0,1,2
2924206,2924290,84,1,0,0,1
2924206,2924293,87,1,0,0,2
2924291,2924482,191,0,0,1,1
2924294,2924482,188,0,0,1,2
2924483,2924514,31,1,0,0,2
2924483,2924515,32,1,0,0,1
2924515,2924655,140,0,0,1,2
2924516,2924655,139,0,0,1,1
2924656,2924673,17,1,0,0,2
2924656,2924682,26,1,0,0,1
2924674,2924759,85,0,0,1,2
2924683,2924760,77,0,0,1,1
2924760,2925069,309,1,0,0,2
2924761,2925055,294,1,0,0,1
2924779,2925007,228,0,1,0,2
2924782,2925015,233,0,1,0,1
2925056,2925498,442,0,0,1,1
2925070,2925126,56,0,0,1,2
2925127,2925136,9,1,0,0,2
2925137,2925497,360,0,0,1,2
2925498,2925522,24,1,0,0,2
2925499,2925513,14,1,0,0,1
2925514,2926371,857,0,0,1,1
2925523,2926372,849,0,0,1,2
2926372,2926396,24,1,0,0,1
2926373,2926396,23,1,0,0,2
2926397,2926545,148,0,0,1,1
2926397,2926547,150,0,0,1,2
2926546,2926607,61,1,0,0,1
2926548,2926617,69,1,0,0,2
2926608,2926741,133,0,0,1,1
2926618,2926742,124,0,0,1,2
2926742,2926777,35,1,0,0,1
2926743,2926781,38,1,0,0,2
2926778,2927354,576,0,0,1,1
2926782,2927353,571,0,0,1,2
2927354,2927640,286,1,0,0,2
2927355,2927680,325,1,0,0,1
2927369,2927611,242,0,1,0,2
2927373,2927666,293,0,1,0,1
2927641,2928589,948,0,0,1,2
2927681,2928590,909,0,0,1,1
2928590,2928609,19,1,0,0,2
2928591,2928616,25,1,0,0,1
2928610,2928777,167,0,0,1,2
2928617,2928774,157,0,0,1,1
2928775,2928890,115,1,0,0,1
2928778,2928913,135,1,0,0,2
2928803,2928848,45,0,1,0,2
2928803,2928851,48,0,1,0,1
2928891,2928994,103,0,0,1,1
2928914,2928993,79,0,0,1,2
2928994,2929256,262,1,0,0,2
2928995,2929231,236,1,0,0,1
2929011,2929184,173,0,1,0,2
2929013,2929185,172,0,1,0,1
2929232,2929790,558,0,0,1,1
2929257,2929791,534,0,0,1,2
2929791,2929968,177,1,0,0,1
2929792,2930006,214,1,0,0,2
2929831,2929937,106,0,1,0,2
2929836,2929933,97,0,1,0,1
2929969,2930072,103,0,0,1,1
2930007,2930073,66,0,0,1,2
2930073,2930109,36,1,0,0,1
2930074,2930105,31,1,0,0,2
2930106,2930378,272,0,0,1,2
2930110,2930378,268,0,0,1,1
2930379,2930394,15,1,0,0,2
2930379,2930395,16,1,0,0,1
2930395,2930621,226,0,0,1,2
2930396,2930621,225,0,0,1,1
2930622,2930642,20,1,0,0,2
2930622,2930643,21,1,0,0,1
2930643,2930817,174,0,0,1,2
2930644,2930819,175,0,0,1,1
2930818,2930845,27,1,0,0,2
2930820,2930845,25,1,0,0,1
2930846,2932202,1356,0,0,1,1
2930846,2932203,1357,0,0,1,2
2932203,2932273,70,1,0,0,1
2932204,2932282,78,1,0,0,2
2932274,2932461,187,0,0,1,1
2932283,2932461,178,0,0,1,2
2932462,2932495,33,1,0,0,1
2932462,2932504,42,1,0,0,2
2932496,2934491,1995,0,0,1,1
2932505,2934491,1986,0,0,1,2
2934492,2934714,222,1,0,0,1
2934492,2934756,264,1,0,0,2
2934521,2934680,159,0,1,0,2
2934522,2934677,155,0,1,0,1
2934715,2934947,232,0,0,1,1
2934757,2934947,190,0,0,1,2
2934948,2934997,49,1,0,0,2
2934948,2935000,52,1,0,0,1
2934998,2935279,281,0,0,1,2
2935001,2935278,277,0,0,1,1
2935279,2935344,65,1,0,0,1
2935280,2935345,65,1,0,0,2
2935345,2936022,677,0,0,1,1
2935346,2936021,675,0,0,1,2
2936022,2936119,97,1,0,0,2
2936023,2936361,338,1,0,0,1
2936120,2936150,30,0,0,1,2
2936151,2936402,251,1,0,0,2
2936179,2936329,150,0,1,0,2
2936182,2936322,140,0,1,0,1
2936362,2936500,138,0,0,1,1
2936403,2936501,98,0,0,1,2
2936501,2936531,30,1,0,0,1
2936502,2936530,28,1,0,0,2
2936531,2938347,1816,0,0,1,2
2936532,2938346,1814,0,0,1,1
2938347,2938411,64,1,0,0,1
2938348,2938399,51,1,0,0,2
2938400,2938532,132,0,0,1,2
2938412,2938532,120,0,0,1,1
2938533,2938557,24,1,0,0,2
2938533,2938563,30,1,0,0,1
2938558,2939787,1229,0,0,1,2
2938564,2939797,1233,0,0,1,1
2939788,2940048,260,1,0,0,2
2939798,2940017,219,1,0,0,1
2939813,2939970,157,0,1,0,2
2939817,2939968,151,0,1,0,1
2940018,2940240,222,0,0,1,1
2940049,2940844,795,0,0,1,2
2940241,2940250,9,1,0,0,1
2940251,2940843,592,0,0,1,1
2940844,2941083,239,1,0,0,1
2940845,2941102,257,1,0,0,2
2940873,2941022,149,0,1,0,2
2940876,2941026,150,0,1,0,1
2941084,2941342,258,0,0,1,1
2941103,2941337,234,0,0,1,2
2941338,2941573,235,1,0,0,2
2941343,2941554,211,1,0,0,1
2941366,2941500,134,0,1,0,2
2941368,2941501,133,0,1,0,1
2941555,2941731,176,0,0,1,1
2941574,2941732,158,0,0,1,2
2941732,2941799,67,1,0,0,1
2941733,2941800,67,1,0,0,2
2941800,2941936,136,0,0,1,1
2941801,2941937,136,0,0,1,2
2941937,2941985,48,1,0,0,1
2941938,2941982,44,1,0,0,2
2941983,2942069,86,0,0,1,2
2941986,2942069,83,0,0,1,1
2942070,2942100,30,1,0,0,1
2942070,2942103,33,1,0,0,2
2942101,2942256,155,0,0,1,1
2942104,2942256,152,0,0,1,2
2942257,2942274,17,1,0,0,1
2942257,2942274,17,1,0,0,2
2942275,2943411,1136,0,0,1,1
2942275,2943411,1136,0,0,1,2
2943412,2943460,48,1,0,0,1
2943412,2943462,50,1,0,0,2
2943461,2943699,238,0,0,1,1
2943463,2943694,231,0,0,1,2
2943695,2943895,200,1,0,0,2
2943700,2943879,179,1,0,0,1
2943724,2943832,108,0,1,0,2
2943726,2943832,106,0,1,0,1
2943880,2945607,1727,0,0,1,1
2943896,2945607,1711,0,0,1,2
2945608,2945642,34,1,0,0,2
2945608,2945644,36,1,0,0,1
2945643,2945953,310,0,0,1,2
2945645,2945952,307,0,0,1,1
2945953,2946187,234,1,0,0,1
2945954,2946197,243,1,0,0,2
2945991,2946134,143,0,1,0,2
2945992,2946130,138,0,1,0,1
2946188,2946307,119,0,0,1,1
2946198,2946308,110,0,0,1,2
2946308,2946352,44,1,0,0,1
2946309,2946359,50,1,0,0,2
2946353,2946649,296,0,0,1,1
2946360,2946649,289,0,0,1,2
2946650,2946689,39,1,0,0,1
2946650,2946700,50,1,0,0,2
2946690,2946912,222,0,0,1,1
2946701,2946912,211,0,0,1,2
2946913,2946988,75,1,0,0,2
2946913,2946989,76,1,0,0,1
2946989,2947087,98,0,0,1,2
2946990,2947087,97,0,0,1,1
2947088,2947118,30,1,0,0,1
2947088,2947120,32,1,0,0,2
2947119,2947367,248,0,0,1,1
2947121,2948537,1416,0,0,1,2
2947368,2947373,5,1,0,0,1
2947374,2948537,1163,0,0,1,1
2948538,2948587,49,1,0,0,2
2948538,2948593,55,1,0,0,1
2948588,2948808,220,0,0,1,2
2948594,2948807,213,0,0,1,1
2948808,2948980,172,1,0,0,1
2948809,2948986,177,1,0,0,2
2948826,2948941,115,0,1,0,2
2948830,2948929,99,0,1,0,1
2948981,2950391,1410,0,0,1,1
2948987,2950387,1400,0,0,1,2
2950388,2950416,28,1,0,0,2
2950392,2950409,17,1,0,0,1
2950410,2951260,850,0,0,1,1
2950417,2951260,843,0,0,1,2
2951261,2951483,222,1,0,0,1
2951261,2951513,252,1,0,0,2
2951289,2951436,147,0,1,0,2
2951294,2951418,124,0,1,0,1
2951484,2951721,237,0,0,1,1
2951514,2951722,208,0,0,1,2
2951722,2951770,48,1,0,0,1
2951723,2951768,45,1,0,0,2
2951769,2951929,160,0,0,1,2
2951771,2951928,157,0,0,1,1
2951929,2951992,63,1,0,0,1
2951930,2951995,65,1,0,0,2
2951993,2952116,123,0,0,1,1
2951996,2952116,120,0,0,1,2
2952117,2952202,85,1,0,0,1
2952117,2952206,89,1,0,0,2
2952203,2952361,158,0,0,1,1
2952207,2952361,154,0,0,1,2
2952362,2952410,48,1,0,0,2
2952362,2952412,50,1,0,0,1
2952411,2952553,142,0,0,1,2
2952413,2952552,139,0,0,1,1
2952553,2952573,20,1,0,0,1
2952554,2952569,15,1,0,0,2
2952570,2952842,272,0,0,1,2
2952574,2952841,267,0,0,1,1
2952842,2952869,27,1,0,0,1
2952843,2952869,26,1,0,0,2
2952870,2953052,182,0,0,1,1
2952870,2953052,182,0,0,1,2
2953053,2953076,23,1,0,0,2
2953053,2953083,30,1,0,0,1
2953077,2953235,158,0,0,1,2
2953084,2953234,150,0,0,1,1
2953235,2953263,28,1,0,0,1
2953236,2953269,33,1,0,0,2
2953264,2953465,201,0,0,1,1
2953270,2953692,422,0,0,1,2
2953466,2953474,8,1,0,0,1
2953475,2953692,217,0,0,1,1
2953693,2953741,48,1,0,0,2
2953693,2953743,50,1,0,0,1
2953742,2954005,263,0,0,1,2
2953744,2954004,260,0,0,1,1
2954005,2954035,30,1,0,0,1
2954006,2954036,30,1,0,0,2
2954036,2954178,142,0,0,1,1
2954037,2954176,139,0,0,1,2
2954177,2954407,230,1,0,0,2
2954179,2954393,214,1,0,0,1
2954197,2954355,158,0,1,0,1
2954199,2954343,144,0,1,0,2
2954394,2954592,198,0,0,1,1
2954408,2954783,375,0,0,1,2
2954593,2954614,21,1,0,0,1
2954615,2954782,167,0,0,1,1
2954783,2954816,33,1,0,0,1
2954784,2954815,31,1,0,0,2
2954816,2955033,217,0,0,1,2
2954817,2955032,215,0,0,1,1
2955033,2955055,22,1,0,0,1
2955034,2955053,19,1,0,0,2
2955054,2955137,83,0,0,1,2
2955056,2955140,84,0,0,1,1
2955138,2955380,242,1,0,0,2
2955141,2955356,215,1,0,0,1
2955156,2955302,146,0,1,0,2
2955160,2955307,147,0,1,0,1
2955357,2955584,227,0,0,1,1
2955381,2955584,203,0,0,1,2
2955585,2955608,23,1,0,0,1
2955585,2955608,23,1,0,0,2
2955609,2955954,345,0,0,1,2
2955609,2955959,350,0,0,1,1
2955955,2956208,253,1,0,0,2
2955960,2956183,223,1,0,0,1
2955980,2956142,162,0,1,0,1
2955982,2956132,150,0,1,0,2
2956184,2956579,395,0,0,1,1
2956209,2956580,371,0,0,1,2
2956580,2956613,33,1,0,0,1
2956581,2956612,31,1,0,0,2
2956613,2956828,215,0,0,1,2
2956614,2956828,214,0,0,1,1
2956829,2956850,21,1,0,0,1
2956829,2956850,21,1,0,0,2
2956851,2956967,116,0,0,1,2
2956851,2956971,120,0,0,1,1
2956968,2957229,261,1,0,0,2
2956972,2957203,231,1,0,0,1
2956990,2957144,154,0,1,0,2
2956990,2957162,172,0,1,0,1
2957204,2957991,787,0,0,1,1
2957230,2957993,763,0,0,1,2
2957992,2958240,248,1,0,0,1
2957994,2958239,245,1,0,0,2
2958013,2958180,167,0,1,0,1
2958016,2958169,153,0,1,0,2
2958240,2958482,242,0,0,1,2
2958241,2958486,245,0,0,1,1
2958483,2958741,258,1,0,0,2
2958487,2958729,242,1,0,0,1
2958511,2958694,183,0,1,0,1
2958512,2958673,161,0,1,0,2
2958730,2958896,166,0,0,1,1
2958742,2958892,150,0,0,1,2
2958893,2958919,26,1,0,0,2
2958897,2958911,14,1,0,0,1
2958912,2959398,486,0,0,1,1
2958920,2959186,266,0,0,1,2
2959187,2959206,19,1,0,0,2
2959207,2959399,192,0,0,1,2
2959399,2959427,28,1,0,0,1
2959400,2959426,26,1,0,0,2
2959427,2959612,185,0,0,1,2
2959428,2959613,185,0,0,1,1
2959613,2959637,24,1,0,0,2
2959614,2959637,23,1,0,0,1
2959638,2959889,251,0,0,1,1
2959638,2959889,251,0,0,1,2
2959890,2959913,23,1,0,0,1
2959890,2959914,24,1,0,0,2
2959914,2960168,254,0,0,1,1
2959915,2960168,253,0,0,1,2
2960169,2960193,24,1,0,0,1
2960169,2960200,31,1,0,0,2
2960194,2960688,494,0,0,1,1
2960201,2961049,848,0,0,1,2
2960689,2960694,5,1,0,0,1
2960695,2961048,353,0,0,1,1
2961049,2961079,30,1,0,0,1
2961050,2961079,29,1,0,0,2
2961080,2961204,124,0,0,1,2
2961080,2961208,128,0,0,1,1
2961205,2961412,207,1,0,0,2
2961209,2961443,234,1,0,0,1
2961223,2961377,154,0,1,0,2
2961225,2961389,164,0,1,0,1
2961413,2961448,35,0,0,1,2
2961444,2961573,129,0,0,1,1
2961449,2961453,4,1,0,0,2
2961454,2961573,119,0,0,1,2
2961574,2961590,16,1,0,0,2
2961574,2961592,18,1,0,0,1
2961591,2961978,387,0,0,1,2
2961593,2961978,385,0,0,1,1
2961979,2962015,36,1,0,0,2
2961979,2962017,38,1,0,0,1
2962016,2962292,276,0,0,1,2
2962018,2962292,274,0,0,1,1
2962293,2962313,20,1,0,0,1
2962293,2962314,21,1,0,0,2
2962314,2962452,138,0,0,1,1
2962315,2962447,132,0,0,1,2
2962448,2962667,219,1,0,0,2
2962453,2962641,188,1,0,0,1
2962469,2962595,126,0,1,0,1
2962470,2962592,122,0,1,0,2
2962642,2962900,258,0,0,1,1
2962668,2962901,233,0,0,1,2
2962901,2962933,32,1,0,0,1
2962902,2962934,32,1,0,0,2
2962934,2963185,251,0,0,1,1
2962935,2963185,250,0,0,1,2
2963186,2963242,56,1,0,0,1
2963186,2963250,64,1,0,0,2
2963243,2963782,539,0,0,1,1
2963251,2963782,531,0,0,1,2
3059040,3059259,219,0,0,1,1
3059040,3059259,219,0,0,1,2
3059260,3059318,58,1,0,0,2
3059260,3059329,69,1,0,0,1
3059319,3059421,102,0,0,1,2
3059330,3059418,88,0,0,1,1
3059419,3059454,35,1,0,0,1
3059422,3059452,30,1,0,0,2
3059453,3059693,240,0,0,1,2
3059455,3059691,236,0,0,1,1
3059692,3059766,74,1,0,0,1
3059694,3059714,20,1,0,0,2
3059715,3060029,314,0,0,1,2
3059767,3059789,22,0,0,1,1
3059790,3059908,118,1,0,0,1
3059909,3060029,120,0,0,1,1
3060030,3060287,257,1,0,0,1
3060030,3060292,262,1,0,0,2
3060052,3060204,152,0,1,0,2
3060054,3060205,151,0,1,0,1
3060288,3060457,169,0,0,1,1
3060293,3060465,172,0,0,1,2
3060458,3060482,24,1,0,0,1
3060466,3060481,15,1,0,0,2
3060482,3060771,289,0,0,1,2
3060483,3060769,286,0,0,1,1
3060770,3060799,29,1,0,0,1
3060772,3060799,27,1,0,0,2
3060800,3060889,89,0,0,1,1
3060800,3060890,90,0,0,1,2
3060890,3061094,204,1,0,0,1
3060891,3061132,241,1,0,0,2
3060912,3061052,140,0,1,0,1
3060913,3061053,140,0,1,0,2
3061095,3061235,140,0,0,1,1
3061133,3061542,409,0,0,1,2
3061236,3061508,272,1,0,0,1
3061509,3061544,35,0,0,1,1
3061543,3061788,245,1,0,0,2
3061545,3061933,388,1,0,0,1
3061569,3061709,140,0,1,0,2
3061569,3061715,146,0,1,0,1
3061789,3061904,115,0,0,1,2
3061905,3061931,26,1,0,0,2
3061932,3062100,168,0,0,1,2
3061934,3062094,160,0,0,1,1
3062095,3062138,43,1,0,0,1
3062101,3062116,15,1,0,0,2
3062117,3062561,444,0,0,1,2
3062139,3062318,179,0,0,1,1
3062319,3063151,832,1,0,0,1
3062562,3062574,12,1,0,0,2
3062575,3063847,1272,0,0,1,2
3063152,3063842,690,0,0,1,1
3063843,3063878,35,1,0,0,1
3063848,3063861,13,1,0,0,2
3063862,3064102,240,0,0,1,2
3063879,3064101,222,0,0,1,1
3064102,3064171,69,1,0,0,1
3064103,3064172,69,1,0,0,2
3064172,3064283,111,0,0,1,1
3064173,3064282,109,0,0,1,2
3064283,3064306,23,1,0,0,2
3064284,3064301,17,1,0,0,1
3064302,3064559,257,0,0,1,1
3064307,3064564,257,0,0,1,2
3064560,3064586,26,1,0,0,1
3064565,3064585,20,1,0,0,2
3064586,3064816,230,0,0,1,2
3064587,3064811,224,0,0,1,1
3064812,3064834,22,1,0,0,1
3064817,3064832,15,1,0,0,2
3064833,3064976,143,0,0,1,2
3064835,3064971,136,0,0,1,1
3064972,3064986,14,1,0,0,1
3064977,3064981,4,1,0,0,2
3064982,3066746,1764,0,0,1,2
3064987,3066746,1759,0,0,1,1
3066747,3066791,44,1,0,0,2
3066747,3066793,46,1,0,0,1
3066792,3066846,54,0,0,1,2
3066794,3066846,52,0,0,1,1
3066847,3066878,31,1,0,0,1
3066847,3066879,32,1,0,0,2
3066879,3066995,116,0,0,1,1
3066880,3066996,116,0,0,1,2
3066996,3067013,17,1,0,0,1
3066997,3067011,14,1,0,0,2
3067012,3069210,2198,0,0,1,2
3067014,3069210,2196,0,0,1,1
3069211,3069278,67,1,0,0,2
3069211,3069280,69,1,0,0,1
3069279,3069387,108,0,0,1,2
3069281,3069386,105,0,0,1,1
3069387,3069412,25,1,0,0,1
3069388,3069415,27,1,0,0,2
3069413,3069598,185,0,0,1,1
3069416,3071443,2027,0,0,1,2
3069599,3069610,11,1,0,0,1
3069611,3071450,1839,0,0,1,1
3071444,3071678,234,1,0,0,2
3071451,3071700,249,1,0,0,1
3071478,3071634,156,0,1,0,2
3071482,3071653,171,0,1,0,1
3071679,3071701,22,0,0,1,2
3071701,3071735,34,0,0,1,1
3071702,3071707,5,1,0,0,2
3071708,3071734,26,0,0,1,2
3071735,3071789,54,1,0,0,2
3071736,3071790,54,1,0,0,1
3071790,3071931,141,0,0,1,2
3071791,3071928,137,0,0,1,1
3071929,3071949,20,1,0,0,1
3071932,3071947,15,1,0,0,2
3071948,3072938,990,0,0,1,2
3071950,3072933,983,0,0,1,1
3072934,3072954,20,1,0,0,1
3072939,3072956,17,1,0,0,2
3072955,3073711,756,0,0,1,1
3072957,3073712,755,0,0,1,2
3073712,3073807,95,1,0,0,1
3073713,3073801,88,1,0,0,2
3073802,3074091,289,0,0,1,2
3073808,3074090,282,0,0,1,1
3074091,3074161,70,1,0,0,1
3074092,3074147,55,1,0,0,2
3074148,3074264,116,0,0,1,2
3074162,3074263,101,0,0,1,1
3074264,3074297,33,1,0,0,1
3074265,3074295,30,1,0,0,2
3074296,3074486,190,0,0,1,2
3074298,3074486,188,0,0,1,1
3074487,3074506,19,1,0,0,1
3074487,3074510,23,1,0,0,2
3074507,3076026,1519,0,0,1,1
3074511,3076026,1515,0,0,1,2
3076027,3076098,71,1,0,0,2
3076027,3076105,78,1,0,0,1
3076099,3076409,310,0,0,1,2
3076106,3076408,302,0,0,1,1
3076409,3076500,91,1,0,0,1
3076410,3076489,79,1,0,0,2
3076490,3076574,84,0,0,1,2
3076501,3076574,73,0,0,1,1
3076575,3076599,24,1,0,0,2
3076575,3076607,32,1,0,0,1
3076600,3076825,225,0,0,1,2
3076608,3076824,216,0,0,1,1
3076825,3076853,28,1,0,0,1
3076826,3076849,23,1,0,0,2
3076850,3078791,1941,0,0,1,2
3076854,3078790,1936,0,0,1,1
3078791,3078841,50,1,0,0,1
3078792,3078844,52,1,0,0,2
3078842,3078950,108,0,0,1,1
3078845,3078951,106,0,0,1,2
3078951,3078976,25,1,0,0,1
3078952,3078976,24,1,0,0,2
3078977,3079358,381,0,0,1,2
3078977,3079362,385,0,0,1,1
3079359,3079387,28,1,0,0,2
3079363,3079386,23,1,0,0,1
3079387,3081002,1615,0,0,1,1
3079388,3081002,1614,0,0,1,2
3081003,3081130,127,1,0,0,1
3081003,3081171,168,1,0,0,2
3081086,3081091,5,0,1,0,2
3081131,3081244,113,0,0,1,1
3081172,3081240,68,0,0,1,2
3081241,3081609,368,1,0,0,2
3081245,3081616,371,1,0,0,1
3081273,3081600,327,0,1,0,1
3081275,3081568,293,0,1,0,2
3081599,3081599,0,0,1,0,2
3081610,3081641,31,0,0,1,2
3081617,3081869,252,0,0,1,1
3081642,3081648,6,1,0,0,2
3081649,3081868,219,0,0,1,2
3081869,3081893,24,1,0,0,2
3081870,3081894,24,1,0,0,1
3081894,3082424,530,0,0,1,2
3081895,3082421,526,0,0,1,1
3082422,3082444,22,1,0,0,1
3082425,3082443,18,1,0,0,2
3082444,3083132,688,0,0,1,2
3082445,3083132,687,0,0,1,1
3083133,3083225,92,1,0,0,2
3083133,3083228,95,1,0,0,1
3083226,3083565,339,0,0,1,2
3083229,3083564,335,0,0,1,1
3083565,3083643,78,1,0,0,1
3083566,3083633,67,1,0,0,2
3083634,3083731,97,0,0,1,2
3083644,3083731,87,0,0,1,1
3083732,3083766,34,1,0,0,2
3083732,3083775,43,1,0,0,1
3083767,3083971,204,0,0,1,2
3083776,3083971,195,0,0,1,1
3083972,3083996,24,1,0,0,2
3083972,3083997,25,1,0,0,1
3083997,3085344,1347,0,0,1,2
3083998,3085344,1346,0,0,1,1
3085345,3085475,130,1,0,0,2
3085345,3085476,131,1,0,0,1
3085476,3085772,296,0,0,1,2
3085477,3085772,295,0,0,1,1
3085773,3085860,87,1,0,0,2
3085773,3085869,96,1,0,0,1
3085861,3085931,70,0,0,1,2
3085870,3085930,60,0,0,1,1
3085931,3085972,41,1,0,0,1
3085932,3085960,28,1,0,0,2
3085961,3086221,260,0,0,1,2
3085973,3086216,243,0,0,1,1
3086217,3086243,26,1,0,0,1
3086222,3086242,20,1,0,0,2
3086243,3088067,1824,0,0,1,2
3086244,3088067,1823,0,0,1,1
3088068,3088165,97,1,0,0,1
3088068,3088166,98,1,0,0,2
3088166,3088263,97,0,0,1,1
3088167,3088263,96,0,0,1,2
3088264,3088293,29,1,0,0,2
3088264,3088295,31,1,0,0,1
3088294,3088656,362,0,0,1,2
3088296,3088653,357,0,0,1,1
3088654,3088674,20,1,0,0,1
3088657,3088673,16,1,0,0,2
3088674,3088846,172,0,0,1,2
3088675,3088841,166,0,0,1,1
3088842,3088870,28,1,0,0,1
3088847,3088864,17,1,0,0,2
3088865,3089733,868,0,0,1,2
3088871,3089733,862,0,0,1,1
3089734,3089801,67,1,0,0,2
3089734,3089811,77,1,0,0,1
3089802,3090150,348,0,0,1,2
3089812,3090150,338,0,0,1,1
3090151,3090237,86,1,0,0,2
3090151,3090238,87,1,0,0,1
3090238,3090357,119,0,0,1,2
3090239,3090359,120,0,0,1,1
3090358,3090389,31,1,0,0,2
3090360,3090405,45,1,0,0,1
3090390,3090789,399,0,0,1,2
3090406,3090793,387,0,0,1,1
3090790,3090812,22,1,0,0,2
3090794,3090814,20,1,0,0,1
3090813,3091902,1089,0,0,1,2
3090815,3091902,1087,0,0,1,1
3091903,3092004,101,1,0,0,1
3091903,3092004,101,1,0,0,2
3092005,3092398,393,0,0,1,2
3092005,3092399,394,0,0,1,1
3092399,3092501,102,1,0,0,2
3092400,3092503,103,1,0,0,1
3092502,3092609,107,0,0,1,2
3092504,3092608,104,0,0,1,1
3092609,3092640,31,1,0,0,1
3092610,3092640,30,1,0,0,2
3092641,3092967,326,0,0,1,2
3092641,3092968,327,0,0,1,1
3092968,3092991,23,1,0,0,2
3092969,3092990,21,1,0,0,1
3092991,3093934,943,0,0,1,1
3092992,3093934,942,0,0,1,2
3093935,3094024,89,1,0,0,1
3093935,3094026,91,1,0,0,2
3094025,3094430,405,0,0,1,1
3094027,3094429,402,0,0,1,2
3094430,3094509,79,1,0,0,2
3094431,3094505,74,1,0,0,1
3094506,3094587,81,0,0,1,1
3094510,3094587,77,0,0,1,2
3094588,3094624,36,1,0,0,2
3094588,3094625,37,1,0,0,1
3094625,3094696,71,0,0,1,2
3094626,3094698,72,0,0,1,1
3094697,3094818,121,1,0,0,2
3094699,3094793,94,1,0,0,1
3094794,3094943,149,0,0,1,1
3094819,3094937,118,0,0,1,2
3094938,3095197,259,1,0,0,2
3094944,3095200,256,1,0,0,1
3094965,3095161,196,0,1,0,2
3094967,3095153,186,0,1,0,1
3095198,3095467,269,0,0,1,2
3095201,3095471,270,0,0,1,1
3095468,3095485,17,1,0,0,2
3095472,3095482,10,1,0,0,1
3095483,3095750,267,0,0,1,1
3095486,3095756,270,0,0,1,2
3095751,3095769,18,1,0,0,1
3095757,3095767,10,1,0,0,2
3095768,3096562,794,0,0,1,2
3095770,3096562,792,0,0,1,1
3096563,3096652,89,1,0,0,2
3096563,3096656,93,1,0,0,1
3096653,3097052,399,0,0,1,2
3096657,3097053,396,0,0,1,1
3097053,3097155,102,1,0,0,2
3097054,3097156,102,1,0,0,1
3097156,3097234,78,0,0,1,2
3097157,3097234,77,0,0,1,1
3097235,3097267,32,1,0,0,2
3097235,3097269,34,1,0,0,1
3097268,3098651,1383,0,0,1,2
3097270,3098651,1381,0,0,1,1
3098652,3098722,70,1,0,0,2
3098652,3098727,75,1,0,0,1
3098723,3098938,215,0,0,1,2
3098728,3098938,210,0,0,1,1
3098939,3099013,74,1,0,0,2
3098939,3099026,87,1,0,0,1
3099014,3099165,151,0,0,1,2
3099027,3099166,139,0,0,1,1
3099166,3099178,12,1,0,0,2
3099167,3099417,250,1,0,0,1
3099179,3099391,212,0,0,1,2
3099392,3099413,21,1,0,0,2
3099414,3099680,266,0,0,1,2
3099418,3099492,74,0,0,1,1
3099493,3099497,4,1,0,0,1
3099498,3099544,46,0,0,1,1
3099545,3099655,110,1,0,0,1
3099656,3099680,24,0,0,1,1
3099681,3099711,30,1,0,0,2
3099681,3099767,86,1,0,0,1
3099712,3100034,322,0,0,1,2
3099768,3099790,22,0,0,1,1
3099791,3099853,62,1,0,0,1
3099854,3099898,44,0,0,1,1
3099899,3099934,35,1,0,0,1
3099935,3099988,53,0,0,1,1
3099989,3100313,324,1,0,0,1
3100035,3100050,15,1,0,0,2
3100051,3100956,905,0,0,1,2
3100314,3100344,30,0,0,1,1
3100345,3100387,42,1,0,0,1
3100388,3100410,22,0,0,1,1
3100411,3100643,232,1,0,0,1
3100644,3100802,158,0,0,1,1
3100803,3100818,15,1,0,0,1
3100819,3100889,70,0,0,1,1
3100890,3100920,30,1,0,0,1
3100921,3100956,35,0,0,1,1
3100957,3101340,383,1,0,0,2
3100957,3101464,507,1,0,0,1
3101019,3101436,417,0,1,0,1
3101027,3101271,244,0,1,0,2
3101341,3101565,224,0,0,1,2
3101465,3101565,100,0,0,1,1
3101566,3101574,8,1,0,0,2
3101566,3101580,14,1,0,0,1
3101575,3102014,439,0,0,1,2
3101581,3102015,434,0,0,1,1
3102015,3102026,11,1,0,0,2
3102016,3102036,20,1,0,0,1
3102027,3103010,983,0,0,1,2
3102037,3103011,974,0,0,1,1
3103011,3103088,77,1,0,0,2
3103012,3103100,88,1,0,0,1
3103089,3103481,392,0,0,1,2
3103101,3103481,380,0,0,1,1
3103482,3103557,75,1,0,0,2
3103482,3103567,85,1,0,0,1
3103558,3103610,52,0,0,1,2
3103568,3103610,42,0,0,1,1
3103611,3103663,52,1,0,0,2
3103611,3103702,91,1,0,0,1
3103664,3103789,125,0,0,1,2
3103703,3103790,87,0,0,1,1
3103790,3103815,25,1,0,0,2
3103791,3103817,26,1,0,0,1
3103816,3104370,554,0,0,1,2
3103818,3104056,238,0,0,1,1
3104057,3104073,16,1,0,0,1
3104074,3104336,262,0,0,1,1
3104337,3104349,12,1,0,0,1
3104350,3104370,20,0,0,1,1
3104371,3104397,26,1,0,0,2
3104371,3104405,34,1,0,0,1
3104398,3105547,1149,0,0,1,2
3104406,3105173,767,0,0,1,1
3105174,3105183,9,1,0,0,1
3105184,3105546,362,0,0,1,1
3105547,3105645,98,1,0,0,1
3105548,3105647,99,1,0,0,2
3105646,3105707,61,0,0,1,1
3105648,3105707,59,0,0,1,2
3105708,3105754,46,1,0,0,1
3105708,3105754,46,1,0,0,2
3105755,3107556,1801,0,0,1,1
3105755,3107556,1801,0,0,1,2
3107557,3107607,50,1,0,0,2
3107557,3107608,51,1,0,0,1
3107608,3107723,115,0,0,1,2
3107609,3107721,112,0,0,1,1
3107722,3107749,27,1,0,0,1
3107724,3107751,27,1,0,0,2
3107750,3109187,1437,0,0,1,1
3107752,3109188,1436,0,0,1,2
3109188,3109294,106,1,0,0,1
3109189,3109293,104,1,0,0,2
3109294,3109352,58,0,0,1,2
3109295,3109353,58,0,0,1,1
3109353,3109392,39,1,0,0,2
3109354,3109388,34,1,0,0,1
3109389,3109483,94,0,0,1,1
3109393,3109482,89,0,0,1,2
3109483,3109505,22,1,0,0,2
3109484,3109602,118,1,0,0,1
3109506,3109679,173,0,0,1,2
3109603,3110267,664,0,0,1,1
3109680,3109704,24,1,0,0,2
3109705,3110268,563,0,0,1,2
3110268,3110357,89,1,0,0,1
3110269,3110361,92,1,0,0,2
3110358,3110815,457,0,0,1,1
3110362,3110814,452,0,0,1,2
3110815,3110889,74,1,0,0,2
3110816,3110891,75,1,0,0,1
3110890,3110977,87,0,0,1,2
3110892,3110975,83,0,0,1,1
3110976,3111010,34,1,0,0,1
3110978,3111011,33,1,0,0,2
3111011,3111138,127,0,0,1,1
3111012,3111143,131,0,0,1,2
3111139,3111164,25,1,0,0,1
3111144,3111161,17,1,0,0,2
3111162,3112397,1235,0,0,1,2
3111165,3111443,278,0,0,1,1
3111444,3111452,8,1,0,0,1
3111453,3112397,944,0,0,1,1
3112398,3112462,64,1,0,0,1
3112398,3112468,70,1,0,0,2
3112463,3112794,331,0,0,1,1
3112469,3112794,325,0,0,1,2
3112795,3112865,70,1,0,0,2
3112795,3112876,81,1,0,0,1
3112866,3112950,84,0,0,1,2
3112877,3112951,74,0,0,1,1
3112951,3112983,32,1,0,0,2
3112952,3112983,31,1,0,0,1
3112984,3114347,1363,0,0,1,1
3112984,3114347,1363,0,0,1,2
3114348,3114425,77,1,0,0,1
3114348,3114426,78,1,0,0,2
3114426,3114713,287,0,0,1,1
3114427,3114713,286,0,0,1,2
3114714,3114789,75,1,0,0,2
3114714,3114790,76,1,0,0,1
3114790,3114901,111,0,0,1,2
3114791,3114902,111,0,0,1,1
3114902,3114935,33,1,0,0,2
3114903,3114934,31,1,0,0,1
3114935,3116293,1358,0,0,1,1
3114936,3116295,1359,0,0,1,2
3116294,3116390,96,1,0,0,1
3116296,3116399,103,1,0,0,2
3116391,3116606,215,0,0,1,1
3116400,3116608,208,0,0,1,2
3116607,3116696,89,1,0,0,1
3116609,3116695,86,1,0,0,2
3116696,3116784,88,0,0,1,2
3116697,3116784,87,0,0,1,1
3116785,3116810,25,1,0,0,2
3116785,3116813,28,1,0,0,1
3116811,3118019,1208,0,0,1,2
3116814,3118020,1206,0,0,1,1
3118020,3118109,89,1,0,0,2
3118021,3118116,95,1,0,0,1
3118110,3118519,409,0,0,1,2
3118117,3118518,401,0,0,1,1
3118519,3118570,51,1,0,0,1
3118520,3118580,60,1,0,0,2
3118571,3118704,133,0,0,1,1
3118581,3118703,122,0,0,1,2
3118704,3118723,19,1,0,0,2
3118705,3118723,18,1,0,0,1
3118724,3120135,1411,0,0,1,2
3118724,3120137,1413,0,0,1,1
3120136,3120267,131,1,0,0,2
3120138,3120268,130,1,0,0,1
3120268,3120375,107,0,0,1,2
3120269,3120376,107,0,0,1,1
3120376,3120397,21,1,0,0,2
3120377,3120404,27,1,0,0,1
3120398,3120435,37,0,0,1,2
3120405,3120434,29,0,0,1,1
3120435,3120727,292,1,0,0,1
3120436,3120679,243,1,0,0,2
3120455,3120682,227,0,1,0,1
3120456,3120647,191,0,1,0,2
3120680,3121923,1243,0,0,1,2
3120728,3121075,347,0,0,1,1
3121076,3121087,11,1,0,0,1
3121088,3121921,833,0,0,1,1
3121922,3122010,88,1,0,0,1
3121924,3122004,80,1,0,0,2
3122005,3122385,380,0,0,1,2
3122011,3122384,373,0,0,1,1
3122385,3122417,32,1,0,0,1
3122386,3122415,29,1,0,0,2
3122416,3122587,171,0,0,1,2
3122418,3122581,163,0,0,1,1
3122582,3122608,26,1,0,0,1
3122588,3122601,13,1,0,0,2
3122602,3123671,1069,0,0,1,2
3122609,3123672,1063,0,0,1,1
3123672,3123728,56,1,0,0,2
3123673,3123727,54,1,0,0,1
3123728,3124018,290,0,0,1,1
3123729,3124020,291,0,0,1,2
3124019,3124116,97,1,0,0,1
3124021,3124108,87,1,0,0,2
3124109,3124202,93,0,0,1,2
3124117,3124201,84,0,0,1,1
3124202,3124233,31,1,0,0,1
3124203,3124236,33,1,0,0,2
3124234,3125632,1398,0,0,1,1
3124237,3125632,1395,0,0,1,2
3125633,3125719,86,1,0,0,2
3125633,3125720,87,1,0,0,1
3125720,3126117,397,0,0,1,2
3125721,3126117,396,0,0,1,1
3126118,3126193,75,1,0,0,2
3126118,3126200,82,1,0,0,1
3126194,3126288,94,0,0,1,2
3126201,3126287,86,0,0,1,1
3126288,3126321,33,1,0,0,1
3126289,3126340,51,1,0,0,2
3126322,3127648,1326,0,0,1,1
3126341,3127649,1308,0,0,1,2
3127649,3127806,157,1,0,0,1
3127650,3127796,146,1,0,0,2
3127797,3128201,404,0,0,1,2
3127807,3128201,394,0,0,1,1
3128202,3128277,75,1,0,0,1
3128202,3128286,84,1,0,0,2
3128278,3128385,107,0,0,1,1
3128287,3128386,99,0,0,1,2
3128386,3128415,29,1,0,0,1
3128387,3128417,30,1,0,0,2
3128416,3128848,432,0,0,1,1
3128418,3129997,1579,0,0,1,2
3128849,3128858,9,1,0,0,1
3128859,3129615,756,0,0,1,1
3129616,3129620,4,1,0,0,1
3129621,3129998,377,0,0,1,1
3129998,3130110,112,1,0,0,2
3129999,3130106,107,1,0,0,1
3130107,3130149,42,0,0,1,1
3130111,3130150,39,0,0,1,2
3130150,3130186,36,1,0,0,1
3130151,3130186,35,1,0,0,2
3130187,3130265,78,0,0,1,2
3130187,3130266,79,0,0,1,1
3130266,3130298,32,1,0,0,2
3130267,3130298,31,1,0,0,1
3130299,3130531,232,0,0,1,1
3130299,3130536,237,0,0,1,2
3130532,3130553,21,1,0,0,1
3130537,3130553,16,1,0,0,2
3130554,3131722,1168,0,0,1,2
3130554,3131723,1169,0,0,1,1
3131723,3131804,81,1,0,0,2
3131724,3131804,80,1,0,0,1
3131805,3131939,134,0,0,1,1
3131805,3131940,135,0,0,1,2
3131940,3132036,96,1,0,0,1
3131941,3132038,97,1,0,0,2
3132037,3132137,100,0,0,1,1
3132039,3132136,97,0,0,1,2
3132137,3132169,32,1,0,0,2
3132138,3132170,32,1,0,0,1
3132170,3133331,1161,0,0,1,2
3132171,3133330,1159,0,0,1,1
3133331,3133499,168,1,0,0,1
3133332,3133518,186,1,0,0,2
3133371,3133446,75,0,1,0,2
3133375,3133443,68,0,1,0,1
3133500,3133767,267,0,0,1,1
3133519,3133768,249,0,0,1,2
3133768,3134261,493,1,0,0,1
3133769,3133857,88,1,0,0,2
3133858,3133879,21,0,0,1,2
3133880,3134210,330,1,0,0,2
3133898,3134224,326,0,1,0,1
3133900,3134170,270,0,1,0,2
3134211,3134238,27,0,0,1,2
3134239,3134256,17,1,0,0,2
3134257,3134429,172,0,0,1,2
3134262,3134429,167,0,0,1,1
3134430,3134448,18,1,0,0,2
3134430,3134456,26,1,0,0,1
3134449,3135459,1010,0,0,1,2
3134457,3135458,1001,0,0,1,1
3135459,3135549,90,1,0,0,1
3135460,3135548,88,1,0,0,2
3135549,3135947,398,0,0,1,2
3135550,3135947,397,0,0,1,1
3135948,3136017,69,1,0,0,2
3135948,3136025,77,1,0,0,1
3136018,3136085,67,0,0,1,2
3136026,3136085,59,0,0,1,1
3136086,3136108,22,1,0,0,2
3136086,3136110,24,1,0,0,1
3136109,3136185,76,0,0,1,2
3136111,3136185,74,0,0,1,1
3136186,3136214,28,1,0,0,1
3136186,3136217,31,1,0,0,2
3136215,3137398,1183,0,0,1,1
3136218,3137398,1180,0,0,1,2
3137399,3137458,59,1,0,0,1
3137399,3137459,60,1,0,0,2
3137459,3137864,405,0,0,1,1
3137460,3137863,403,0,0,1,2
3137864,3137911,47,1,0,0,2
3137865,3137910,45,1,0,0,1
3137911,3138011,100,0,0,1,1
3137912,3138013,101,0,0,1,2
3138012,3138041,29,1,0,0,1
3138014,3138035,21,1,0,0,2
3138036,3138214,178,0,0,1,2
3138042,3138210,168,0,0,1,1
3138211,3138228,17,1,0,0,1
3138215,3138227,12,1,0,0,2
3138228,3139410,1182,0,0,1,2
3138229,3138513,284,0,0,1,1
3138514,3138528,14,1,0,0,1
3138529,3139416,887,0,0,1,1
3139411,3139684,273,1,0,0,2
3139417,3139662,245,1,0,0,1
3139433,3139636,203,0,1,0,2
3139437,3139572,135,0,1,0,1
3139595,3139606,11,0,1,0,1
3139663,3139792,129,0,0,1,1
3139685,3139794,109,0,0,1,2
3139793,3139869,76,1,0,0,1
3139795,3139878,83,1,0,0,2
3139870,3139974,104,0,0,1,1
3139879,3139975,96,0,0,1,2
3139975,3140006,31,1,0,0,1
3139976,3139999,23,1,0,0,2
3140000,3140207,207,0,0,1,2
3140007,3141751,1744,0,0,1,1
3140208,3140223,15,1,0,0,2
3140224,3141751,1527,0,0,1,2
3141752,3141803,51,1,0,0,2
3141752,3141811,59,1,0,0,1
3141804,3142081,277,0,0,1,2
3141812,3142080,268,0,0,1,1
3142081,3142385,304,1,0,0,1
3142082,3142434,352,1,0,0,2
3142176,3142346,170,0,1,0,2
3142180,3142345,165,0,1,0,1
3142386,3142494,108,0,0,1,1
3142435,3142495,60,0,0,1,2
3142495,3142537,42,1,0,0,1
3142496,3142518,22,1,0,0,2
3142519,3142827,308,0,0,1,2
3142538,3142826,288,0,0,1,1
3142827,3142858,31,1,0,0,1
3142828,3142857,29,1,0,0,2
3142858,3144011,1153,0,0,1,2
3142859,3144010,1151,0,0,1,1
3144011,3144091,80,1,0,0,1
3144012,3144092,80,1,0,0,2
3144092,3144149,57,0,0,1,1
3144093,3144149,56,0,0,1,2
3144150,3144239,89,1,0,0,2
3144150,3144248,98,1,0,0,1
3144240,3144334,94,0,0,1,2
3144249,3144333,84,0,0,1,1
3144334,3144365,31,1,0,0,1
3144335,3144367,32,1,0,0,2
3144366,3144578,212,0,0,1,1
3144368,3144587,219,0,0,1,2
3144579,3144966,387,1,0,0,1
3144588,3144896,308,1,0,0,2
3144599,3144956,357,0,1,0,1
3144601,3144829,228,0,1,0,2
3144897,3145997,1100,0,0,1,2
3144967,3145997,1030,0,0,1,1
3145998,3146058,60,1,0,0,1
3145998,3146059,61,1,0,0,2
3146059,3146250,191,0,0,1,1
3146060,3146251,191,0,0,1,2
3146251,3146355,104,1,0,0,1
3146252,3146357,105,1,0,0,2
3146356,3146428,72,0,0,1,1
3146358,3146428,70,0,0,1,2
3146429,3146459,30,1,0,0,2
3146429,3146463,34,1,0,0,1
3146460,3146663,203,0,0,1,2
3146464,3146663,199,0,0,1,1
3146664,3146680,16,1,0,0,2
3146664,3146681,17,1,0,0,1
3146681,3146947,266,0,0,1,2
3146682,3146945,263,0,0,1,1
3146946,3146957,11,1,0,0,1
3146948,3146952,4,1,0,0,2
3146953,3147570,617,0,0,1,2
3146958,3147570,612,0,0,1,1
3147571,3147621,50,1,0,0,1
3147571,3147623,52,1,0,0,2
3147622,3148041,419,0,0,1,1
3147624,3148041,417,0,0,1,2
3148042,3148111,69,1,0,0,2
3148042,3148114,72,1,0,0,1
3148112,3148250,138,0,0,1,2
3148115,3148249,134,0,0,1,1
3148250,3148276,26,1,0,0,1
3148251,3148267,16,1,0,0,2
3148268,3149391,1123,0,0,1,2
3148277,3149391,1114,0,0,1,1
3149392,3149415,23,1,0,0,1
3149392,3149422,30,1,0,0,2
3149416,3149821,405,0,0,1,1
3149423,3149822,399,0,0,1,2
3149822,3149871,49,1,0,0,1
3149823,3149872,49,1,0,0,2
3149872,3151608,1736,0,0,1,1
3149873,3151601,1728,0,0,1,2
3151602,3151840,238,1,0,0,2
3151609,3151781,172,1,0,0,1
3151625,3151745,120,0,1,0,2
3151633,3151716,83,0,1,0,1
3151782,3151926,144,0,0,1,1
3151841,3151926,85,0,0,1,2
3151927,3152018,91,1,0,0,2
3151927,3152031,104,1,0,0,1
3152019,3152128,109,0,0,1,2
3152032,3152128,96,0,0,1,1
3152129,3152148,19,1,0,0,2
3152129,3152159,30,1,0,0,1
3152149,3152349,200,0,0,1,2
3152160,3152348,188,0,0,1,1
3152349,3152375,26,1,0,0,1
3152350,3152376,26,1,0,0,2
3152376,3153602,1226,0,0,1,1
3152377,3152617,240,0,0,1,2
3152618,3152622,4,1,0,0,2
3152623,3153603,980,0,0,1,2
3153603,3153722,119,1,0,0,1
3153604,3153728,124,1,0,0,2
3153723,3153850,127,0,0,1,1
3153729,3153852,123,0,0,1,2
3153851,3153929,78,1,0,0,1
3153853,3153931,78,1,0,0,2
3153930,3154072,142,0,0,1,1
3153932,3154072,140,0,0,1,2
3154073,3154101,28,1,0,0,1
3154073,3154101,28,1,0,0,2
3154102,3155276,1174,0,0,1,1
3154102,3155276,1174,0,0,1,2
3155277,3155325,48,1,0,0,1
3155277,3155329,52,1,0,0,2
3155326,3155668,342,0,0,1,1
3155330,3155669,339,0,0,1,2
3155669,3155762,93,1,0,0,1
3155670,3155769,99,1,0,0,2
3155763,3155822,59,0,0,1,1
3155770,3155824,54,0,0,1,2
3155823,3155865,42,1,0,0,1
3155825,3155863,38,1,0,0,2
3155864,3156046,182,0,0,1,2
3155866,3156050,184,0,0,1,1
3156047,3156071,24,1,0,0,2
3156051,3156061,10,1,0,0,1
3156062,3156512,450,0,0,1,1
3156072,3156508,436,0,0,1,2
3156509,3156528,19,1,0,0,2
3156513,3156529,16,1,0,0,1
3156529,3157586,1057,0,0,1,2
3156530,3157586,1056,0,0,1,1
3157587,3157850,263,1,0,0,1
3157587,3157885,298,1,0,0,2
3157619,3157836,217,0,1,0,2
3157623,3157836,213,0,1,0,1
3157851,3157937,86,0,0,1,1
3157886,3157937,51,0,0,1,2
3157938,3157996,58,1,0,0,2
3157938,3158003,65,1,0,0,1
3157997,3158056,59,0,0,1,2
3158004,3158055,51,0,0,1,1
3158056,3158096,40,1,0,0,1
3158057,3158092,35,1,0,0,2
3158093,3158236,143,0,0,1,2
3158097,3158236,139,0,0,1,1
3158237,3158255,18,1,0,0,1
3158237,3158255,18,1,0,0,2
3158256,3158714,458,0,0,1,1
3158256,3158716,460,0,0,1,2
3158715,3158745,30,1,0,0,1
3158717,3158744,27,1,0,0,2
3158745,3159802,1057,0,0,1,2
3158746,3159802,1056,0,0,1,1
3159803,3159887,84,1,0,0,1
3159803,3159894,91,1,0,0,2
3159888,3159987,99,0,0,1,1
3159895,3159989,94,0,0,1,2
3159988,3160014,26,1,0,0,1
3159990,3160031,41,1,0,0,2
3160015,3160259,244,0,0,1,1
3160032,3160258,226,0,0,1,2
3160259,3160282,23,1,0,0,2
3160260,3160277,17,1,0,0,1
3160278,3160563,285,0,0,1,1
3160283,3161348,1065,0,0,1,2
3160564,3160591,27,1,0,0,1
3160592,3161348,756,0,0,1,1
3161349,3161432,83,1,0,0,1
3161349,3161435,86,1,0,0,2
3161433,3161751,318,0,0,1,1
3161436,3161751,315,0,0,1,2
3161752,3161844,92,1,0,0,2
3161752,3161845,93,1,0,0,1
3161845,3161910,65,0,0,1,2
3161846,3161912,66,0,0,1,1
3161911,3161968,57,1,0,0,2
3161913,3161946,33,1,0,0,1
3161947,3162046,99,0,0,1,1
3161969,3162047,78,0,0,1,2
3162047,3162079,32,1,0,0,1
3162048,3162069,21,1,0,0,2
3162070,3163043,973,0,0,1,2
3162080,3163043,963,0,0,1,1
3163044,3163070,26,1,0,0,2
3163044,3163082,38,1,0,0,1
3163071,3163160,89,0,0,1,2
3163083,3163161,78,0,0,1,1
3163161,3163228,67,1,0,0,2
3163162,3163243,81,1,0,0,1
3163229,3163438,209,0,0,1,2
3163244,3163439,195,0,0,1,1
3163439,3163496,57,1,0,0,2
3163440,3163497,57,1,0,0,1
3163497,3163670,173,0,0,1,2
3163498,3163670,172,0,0,1,1
3163671,3163738,67,1,0,0,2
3163671,3163752,81,1,0,0,1
3163739,3163875,136,0,0,1,2
3163753,3163873,120,0,0,1,1
3163874,3163894,20,1,0,0,1
3163876,3163892,16,1,0,0,2
3163893,3164437,544,0,0,1,2
3163895,3164436,541,0,0,1,1
3164437,3164686,249,1,0,0,1
3164438,3164655,217,1,0,0,2
3164453,3164651,198,0,1,0,1
3164454,3164624,170,0,1,0,2
3164656,3164775,119,0,0,1,2
3164687,3164710,23,0,0,1,1
3164711,3164715,4,1,0,0,1
3164716,3164770,54,0,0,1,1
3164771,3164788,17,1,0,0,1
3164776,3164786,10,1,0,0,2
3164787,3165018,231,0,0,1,2
3164789,3165006,217,0,0,1,1
3165007,3165288,281,1,0,0,1
3165019,3165274,255,1,0,0,2
3165034,3165264,230,0,1,0,1
3165035,3165221,186,0,1,0,2
3165275,3167414,2139,0,0,1,2
3165289,3166321,1032,0,0,1,1
3166322,3166326,4,1,0,0,1
3166327,3167414,1087,0,0,1,1
3167415,3167483,68,1,0,0,2
3167415,3167484,69,1,0,0,1
3167484,3167732,248,0,0,1,2
3167485,3167732,247,0,0,1,1
3167733,3167756,23,1,0,0,1
3167733,3167756,23,1,0,0,2
3167757,3168895,1138,0,0,1,1
3167757,3168895,1138,0,0,1,2
3168896,3168922,26,1,0,0,1
3168896,3168929,33,1,0,0,2
3168923,3169792,869,0,0,1,1
3168930,3169794,864,0,0,1,2
3169793,3169832,39,1,0,0,1
3169795,3169839,44,1,0,0,2
3169833,3169977,144,0,0,1,1
3169840,3169974,134,0,0,1,2
3169975,3170169,194,1,0,0,2
3169978,3170182,204,1,0,0,1
3169994,3170139,145,0,1,0,2
3169994,3170146,152,0,1,0,1
3170170,3170935,765,0,0,1,2
3170183,3170933,750,0,0,1,1
3170934,3171014,80,1,0,0,1
3170936,3171007,71,1,0,0,2
3171008,3171113,105,0,0,1,2
3171015,3171113,98,0,0,1,1
3171114,3171136,22,1,0,0,2
3171114,3171142,28,1,0,0,1
3171137,3172150,1013,0,0,1,2
3171143,3171307,164,0,0,1,1
3171308,3171326,18,1,0,0,1
3171327,3171602,275,0,0,1,1
3171603,3171620,17,1,0,0,1
3171621,3171912,291,0,0,1,1
3171913,3171923,10,1,0,0,1
3171924,3172155,231,0,0,1,1
3172151,3172160,9,1,0,0,2
3172156,3172169,13,1,0,0,1
3172161,3173138,977,0,0,1,2
3172170,3172398,228,0,0,1,1
3172399,3172413,14,1,0,0,1
3172414,3173139,725,0,0,1,1
3173139,3173154,15,1,0,0,2
3173140,3173154,14,1,0,0,1
3173155,3173409,254,0,0,1,1
3173155,3173409,254,0,0,1,2
3173410,3173448,38,1,0,0,2
3173410,3173450,40,1,0,0,1
3173449,3173703,254,0,0,1,2
3173451,3173702,251,0,0,1,1
3173703,3173732,29,1,0,0,1
3173704,3173732,28,1,0,0,2
3173733,3174126,393,0,0,1,1
3173733,3174126,393,0,0,1,2
3174127,3174161,34,1,0,0,2
3174127,3174162,35,1,0,0,1
3174162,3174316,154,0,0,1,2
3174163,3174316,153,0,0,1,1
3174317,3174336,19,1,0,0,2
3174317,3174346,29,1,0,0,1
3174337,3175496,1159,0,0,1,2
3174347,3175497,1150,0,0,1,1
3175497,3175528,31,1,0,0,2
3175498,3175529,31,1,0,0,1
3175529,3175614,85,0,0,1,2
3175530,3175613,83,0,0,1,1
3175614,3175878,264,1,0,0,1
3175615,3175853,238,1,0,0,2
3175636,3175844,208,0,1,0,1
3175638,3175825,187,0,1,0,2
3175854,3176819,965,0,0,1,2
3175879,3176819,940,0,0,1,1
3176820,3176899,79,1,0,0,2
3176820,3176909,89,1,0,0,1
3176900,3177008,108,0,0,1,2
3176910,3177007,97,0,0,1,1
3177008,3177041,33,1,0,0,1
3177009,3177039,30,1,0,0,2
3177040,3177229,189,0,0,1,2
3177042,3177222,180,0,0,1,1
3177223,3177250,27,1,0,0,1
3177230,3177245,15,1,0,0,2
3177246,3177479,233,0,0,1,2
3177251,3177473,222,0,0,1,1
3177474,3177489,15,1,0,0,1
3177480,3177495,15,1,0,0,2
3177490,3178270,780,0,0,1,1
3177496,3178270,774,0,0,1,2
3178271,3178281,10,1,0,0,2
3178271,3178285,14,1,0,0,1
3178282,3179161,879,0,0,1,2
3178286,3179160,874,0,0,1,1
3179161,3179228,67,1,0,0,1
3179162,3179243,81,1,0,0,2
3179229,3179369,140,0,0,1,1
3179244,3179368,124,0,0,1,2
3179369,3179393,24,1,0,0,2
3179370,3179407,37,1,0,0,1
3179394,3179582,188,0,0,1,2
3179408,3179437,29,0,0,1,1
3179438,3179635,197,1,0,0,1
3179583,3179616,33,1,0,0,2
3179617,3179742,125,0,0,1,2
3179636,3180091,455,0,0,1,1
3179743,3179766,23,1,0,0,2
3179767,3179884,117,0,0,1,2
3179885,3179906,21,1,0,0,2
3179907,3181479,1572,0,0,1,2
3180092,3180446,354,1,0,0,1
3180447,3180479,32,0,0,1,1
3180480,3180565,85,1,0,0,1
3180566,3180825,259,0,0,1,1
3180826,3181091,265,1,0,0,1
3181092,3181171,79,0,0,1,1
3181172,3181235,63,1,0,0,1
3181236,3181500,264,0,0,1,1
3181480,3181738,258,1,0,0,2
3181501,3181763,262,1,0,0,1
3181517,3181707,190,0,1,0,2
3181522,3181717,195,0,1,0,1
3181739,3183226,1487,0,0,1,2
3181764,3183226,1462,0,0,1,1
3183227,3183297,70,1,0,0,2
3183227,3183307,80,1,0,0,1
3183298,3183420,122,0,0,1,2
3183308,3183419,111,0,0,1,1
3183420,3183449,29,1,0,0,1
3183421,3183438,17,1,0,0,2
3183439,3184096,657,0,0,1,2
3183450,3183588,138,0,0,1,1
3183589,3183607,18,1,0,0,1
3183608,3183769,161,0,0,1,1
3183770,3183781,11,1,0,0,1
3183782,3184629,847,0,0,1,1
3184097,3184106,9,1,0,0,2
3184107,3184627,520,0,0,1,2
3184628,3184648,20,1,0,0,2
3184630,3184643,13,1,0,0,1
3184644,3185300,656,0,0,1,1
3184649,3185300,651,0,0,1,2
3185301,3185344,43,1,0,0,2
3185301,3185355,54,1,0,0,1
3185345,3185495,150,0,0,1,2
3185356,3185494,138,0,0,1,1
3185495,3185515,20,1,0,0,1
3185496,3185512,16,1,0,0,2
3185513,3187673,2160,0,0,1,2
3185516,3187674,2158,0,0,1,1
3187674,3187904,230,1,0,0,2
3187675,3187913,238,1,0,0,1
3187705,3187869,164,0,1,0,2
3187708,3187863,155,0,1,0,1
3187905,3188453,548,0,0,1,2
3187914,3188452,538,0,0,1,1
3188453,3188497,44,1,0,0,1
3188454,3188507,53,1,0,0,2
3188498,3189242,744,0,0,1,1
3188508,3189241,733,0,0,1,2
3189242,3189341,99,1,0,0,2
3189243,3189336,93,1,0,0,1
3189337,3189413,76,0,0,1,1
3189342,3189412,70,0,0,1,2
3189413,3189465,52,1,0,0,2
3189414,3189467,53,1,0,0,1
3189466,3190735,1269,0,0,1,2
3189468,3190735,1267,0,0,1,1
3190736,3190786,50,1,0,0,2
3190736,3190802,66,1,0,0,1
3190787,3192668,1881,0,0,1,2
3190803,3192661,1858,0,0,1,1
3192662,3192676,14,1,0,0,1
3192669,3192676,7,1,0,0,2
3192677,3192968,291,0,0,1,2
3192677,3192969,292,0,0,1,1
3192969,3193223,254,1,0,0,2
3192970,3193236,266,1,0,0,1
3193002,3193189,187,0,1,0,2
3193005,3193195,190,0,1,0,1
3193224,3193666,442,0,0,1,2
3193237,3193667,430,0,0,1,1
3193667,3193725,58,1,0,0,2
3193668,3193723,55,1,0,0,1
3193724,3193980,256,0,0,1,1
3193726,3193980,254,0,0,1,2
3193981,3194017,36,1,0,0,2
3193981,3194019,38,1,0,0,1
3194018,3194217,199,0,0,1,2
3194020,3194217,197,0,0,1,1
3194218,3194269,51,1,0,0,1
3194218,3194271,53,1,0,0,2
3194270,3194397,127,0,0,1,1
3194272,3194398,126,0,0,1,2
3194398,3194420,22,1,0,0,1
3194399,3194421,22,1,0,0,2
3194421,3194565,144,0,0,1,1
3194422,3194882,460,0,0,1,2
3194566,3194576,10,1,0,0,1
3194577,3194882,305,0,0,1,1
3194883,3194897,14,1,0,0,2
3194883,3194901,18,1,0,0,1
3194898,3195823,925,0,0,1,2
3194902,3195277,375,0,0,1,1
3195278,3195287,9,1,0,0,1
3195288,3195822,534,0,0,1,1
3195823,3195900,77,1,0,0,1
3195824,3195891,67,1,0,0,2
3195892,3196482,590,0,0,1,2
3195901,3196482,581,0,0,1,1
3196483,3196542,59,1,0,0,1
3196483,3196544,61,1,0,0,2
3196543,3196819,276,0,0,1,1
3196545,3196819,274,0,0,1,2
3196820,3196831,11,1,0,0,2
3196820,3196833,13,1,0,0,1
3196832,3198719,1887,0,0,1,2
3196834,3198716,1882,0,0,1,1
3198717,3199001,284,1,0,0,1
3198720,3198964,244,1,0,0,2
3198738,3198938,200,0,1,0,2
3198739,3198951,212,0,1,0,1
3198965,3200529,1564,0,0,1,2
3199002,3200528,1526,0,0,1,1
3200529,3200628,99,1,0,0,1
3200530,3200618,88,1,0,0,2
3200619,3200701,82,0,0,1,2
3200629,3200700,71,0,0,1,1
3200701,3200734,33,1,0,0,1
3200702,3200730,28,1,0,0,2
3200731,3200931,200,0,0,1,2
3200735,3200927,192,0,0,1,1
3200928,3200951,23,1,0,0,1
3200932,3200945,13,1,0,0,2
3200946,3202060,1114,0,0,1,2
3200952,3201508,556,0,0,1,1
3201509,3201513,4,1,0,0,1
3201514,3202056,542,0,0,1,1
3202057,3202065,8,1,0,0,1
3202061,3202075,14,1,0,0,2
3202066,3202434,368,0,0,1,1
3202076,3202435,359,0,0,1,2
3202435,3202528,93,1,0,0,1
3202436,3202502,66,1,0,0,2
3202503,3202555,52,0,0,1,2
3202529,3202555,26,0,0,1,1
3202556,3202584,28,1,0,0,2
3202556,3202589,33,1,0,0,1
3202585,3203056,471,0,0,1,2
3202590,3203053,463,0,0,1,1
3203054,3203075,21,1,0,0,1
3203057,3203068,11,1,0,0,2
3203069,3204473,1404,0,0,1,2
3203076,3204473,1397,0,0,1,1
3204474,3204483,9,1,0,0,2
3204474,3204484,10,1,0,0,1
3204484,3204619,135,0,0,1,2
3204485,3204629,144,0,0,1,1
3204620,3204889,269,1,0,0,2
3204630,3204896,266,1,0,0,1
3204660,3204837,177,0,1,0,2
3204663,3204835,172,0,1,0,1
3204890,3205347,457,0,0,1,2
3204897,3205346,449,0,0,1,1
3205347,3205408,61,1,0,0,1
3205348,3205408,60,1,0,0,2
3205409,3205638,229,0,0,1,1
3205409,3205644,235,0,0,1,2
3205639,3205662,23,1,0,0,1
3205645,3205664,19,1,0,0,2
3205663,3205845,182,0,0,1,1
3205665,3205846,181,0,0,1,2
3205846,3205906,60,1,0,0,1
3205847,3205906,59,1,0,0,2
3205907,3206086,179,0,0,1,1
3205907,3206652,745,0,0,1,2
3206087,3206094,7,1,0,0,1
3206095,3206652,557,0,0,1,1
3206653,3206668,15,1,0,0,2
3206653,3206673,20,1,0,0,1
3206669,3207062,393,0,0,1,2
3206674,3207062,388,0,0,1,1
3207063,3207073,10,1,0,0,2
3207063,3207077,14,1,0,0,1
3207074,3208067,993,0,0,1,2
3207078,3208067,989,0,0,1,1
3208068,3208126,58,1,0,0,2
3208068,3208128,60,1,0,0,1
3208127,3208279,152,0,0,1,2
3208129,3208278,149,0,0,1,1
3208279,3208349,70,1,0,0,1
3208280,3208349,69,1,0,0,2
3208350,3208537,187,0,0,1,1
3208350,3208538,188,0,0,1,2
3208538,3208571,33,1,0,0,1
3208539,3208568,29,1,0,0,2
3208569,3210441,1872,0,0,1,2
3208572,3210440,1868,0,0,1,1
3210441,3210462,21,1,0,0,1
3210442,3210461,19,1,0,0,2
3210462,3210965,503,0,0,1,2
3210463,3210965,502,0,0,1,1
3210966,3211205,239,1,0,0,2
3210966,3211238,272,1,0,0,1
3210981,3211202,221,0,1,0,1
3210983,3211180,197,0,1,0,2
3211206,3211683,477,0,0,1,2
3211239,3211683,444,0,0,1,1
3211684,3211730,46,1,0,0,1
3211684,3211730,46,1,0,0,2
3211731,3211999,268,0,0,1,1
3211731,3211999,268,0,0,1,2
3212000,3212097,97,1,0,0,2
3212000,3212100,100,1,0,0,1
3212098,3212209,111,0,0,1,2
3212101,3212209,108,0,0,1,1
3212210,3212243,33,1,0,0,1
3212210,3212253,43,1,0,0,2
3212244,3212456,212,0,0,1,1
3212254,3212855,601,0,0,1,2
3212457,3212472,15,1,0,0,1
3212473,3212860,387,0,0,1,1
3212856,3212872,16,1,0,0,2
3212861,3212877,16,1,0,0,1
3212873,3214381,1508,0,0,1,2
3212878,3214381,1503,0,0,1,1
3214382,3214463,81,1,0,0,2
3214382,3214465,83,1,0,0,1
3214464,3214549,85,0,0,1,2
3214466,3214548,82,0,0,1,1
3214549,3214591,42,1,0,0,1
3214550,3214569,19,1,0,0,2
3214570,3215333,763,0,0,1,2
3214592,3215016,424,0,0,1,1
3215017,3215052,35,1,0,0,1
3215053,3215165,112,0,0,1,1
3215166,3215328,162,1,0,0,1
3215329,3215411,82,0,0,1,1
3215334,3215369,35,1,0,0,2
3215370,3215647,277,0,0,1,2
3215412,3215429,17,1,0,0,1
3215430,3215539,109,0,0,1,1
3215540,3215554,14,1,0,0,1
3215555,3215602,47,0,0,1,1
3215603,3215785,182,1,0,0,1
3215648,3215681,33,1,0,0,2
3215682,3216694,1012,0,0,1,2
3215786,3215927,141,0,0,1,1
3215928,3215943,15,1,0,0,1
3215944,3216241,297,0,0,1,1
3216242,3216300,58,1,0,0,1
3216301,3216392,91,0,0,1,1
3216393,3216909,516,1,0,0,1
3216695,3216904,209,1,0,0,2
3216729,3216845,116,0,1,0,2
3216731,3216841,110,0,1,0,1
3216905,3217114,209,0,0,1,2
3216910,3217114,204,0,0,1,1
3217115,3217178,63,1,0,0,1
3217115,3217178,63,1,0,0,2
3217179,3218304,1125,0,0,1,1
3217179,3218304,1125,0,0,1,2
3218305,3218376,71,1,0,0,2
3218305,3218387,82,1,0,0,1
3218377,3218494,117,0,0,1,2
3218388,3218495,107,0,0,1,1
3218495,3218528,33,1,0,0,2
3218496,3218530,34,1,0,0,1
3218529,3218969,440,0,0,1,2
3218531,3218717,186,0,0,1,1
3218718,3218740,22,1,0,0,1
3218741,3220635,1894,0,0,1,1
3218970,3218985,15,1,0,0,2
3218986,3220634,1648,0,0,1,2
3220635,3220712,77,1,0,0,2
3220636,3220713,77,1,0,0,1
3220713,3220851,138,0,0,1,2
3220714,3220850,136,0,0,1,1
3220851,3220878,27,1,0,0,1
3220852,3220875,23,1,0,0,2
3220876,3221282,406,0,0,1,2
3220879,3221286,407,0,0,1,1
3221283,3221298,15,1,0,0,2
3221287,3221299,12,1,0,0,1
3221299,3224582,3283,0,0,1,2
3221300,3224581,3281,0,0,1,1
3224582,3224658,76,1,0,0,1
3224583,3224659,76,1,0,0,2
3224659,3224751,92,0,0,1,1
3224660,3224752,92,0,0,1,2
3224752,3224785,33,1,0,0,1
3224753,3224785,32,1,0,0,2
3224786,3224999,213,0,0,1,2
3224786,3226890,2104,0,0,1,1
3225000,3225015,15,1,0,0,2
3225016,3226890,1874,0,0,1,2
3226891,3226964,73,1,0,0,2
3226891,3226967,76,1,0,0,1
3226965,3227052,87,0,0,1,2
3226968,3227051,83,0,0,1,1
3227052,3227080,28,1,0,0,1
3227053,3227072,19,1,0,0,2
3227073,3228955,1882,0,0,1,2
3227081,3228954,1873,0,0,1,1
3228955,3229217,262,1,0,0,1
3228956,3229231,275,1,0,0,2
3228992,3229187,195,0,1,0,2
3228999,3229165,166,0,1,0,1
3229218,3229317,99,0,0,1,1
3229232,3229253,21,0,0,1,2
3229254,3229572,318,1,0,0,2
3229318,3229534,216,1,0,0,1
3229337,3229483,146,0,1,0,2
3229337,3229495,158,0,1,0,1
3229535,3229818,283,0,0,1,1
3229573,3229818,245,0,0,1,2
3229819,3229894,75,1,0,0,2
3229819,3229895,76,1,0,0,1
3229895,3230957,1062,0,0,1,2
3229896,3230957,1061,0,0,1,1
3230958,3231025,67,1,0,0,2
3230958,3231027,69,1,0,0,1
3231026,3231141,115,0,0,1,2
3231028,3231143,115,0,0,1,1
3231142,3231460,318,1,0,0,2
3231144,3231460,316,1,0,0,1
3231165,3231428,263,0,1,0,2
3231166,3231446,280,0,1,0,1
3231461,3231482,21,0,0,1,2
3231461,3233277,1816,0,0,1,1
3231483,3231489,6,1,0,0,2
3231490,3233277,1787,0,0,1,2
3233278,3233337,59,1,0,0,2
3233278,3233344,66,1,0,0,1
3233338,3233518,180,0,0,1,2
3233345,3233515,170,0,0,1,1
3233516,3233555,39,1,0,0,1
3233519,3233549,30,1,0,0,2
3233550,3234927,1377,0,0,1,2
3233556,3234926,1370,0,0,1,1
3234927,3234959,32,1,0,0,1
3234928,3234958,30,1,0,0,2
3234959,3235578,619,0,0,1,2
3234960,3235577,617,0,0,1,1
3235578,3235870,292,1,0,0,1
3235579,3235853,274,1,0,0,2
3235601,3235796,195,0,1,0,2
3235603,3235813,210,0,1,0,1
3235854,3236079,225,0,0,1,2
3235871,3236079,208,0,0,1,1
3236080,3236118,38,1,0,0,2
3236080,3236126,46,1,0,0,1
3236119,3236456,337,0,0,1,2
3236127,3236455,328,0,0,1,1
3236456,3236480,24,1,0,0,1
3236457,3236480,23,1,0,0,2
3236481,3236930,449,0,0,1,1
3236481,3236930,449,0,0,1,2
3236931,3236949,18,1,0,0,2
3236931,3236960,29,1,0,0,1
3236950,3237153,203,0,0,1,2
3236961,3237152,191,0,0,1,1
3237153,3237238,85,1,0,0,1
3237154,3237231,77,1,0,0,2
3237232,3237655,423,0,0,1,2
3237239,3237429,190,0,0,1,1
3237430,3237434,4,1,0,0,1
3237435,3237651,216,0,0,1,1
3237652,3237675,23,1,0,0,1
3237656,3237676,20,1,0,0,2
3237676,3238173,497,0,0,1,1
3237677,3237943,266,0,0,1,2
3237944,3237952,8,1,0,0,2
3237953,3238178,225,0,0,1,2
3238174,3238194,20,1,0,0,1
3238179,3238198,19,1,0,0,2
3238195,3238785,590,0,0,1,1
3238199,3238784,585,0,0,1,2
3238785,3238846,61,1,0,0,2
3238786,3238847,61,1,0,0,1
3238847,3239149,302,0,0,1,2
3238848,3239149,301,0,0,1,1
3239150,3239196,46,1,0,0,1
3239150,3239197,47,1,0,0,2
3239197,3239337,140,0,0,1,1
3239198,3239336,138,0,0,1,2
3239337,3239358,21,1,0,0,2
3239338,3239358,20,1,0,0,1
3239359,3239643,284,0,0,1,2
3239359,3239649,290,0,0,1,1
3239644,3239660,16,1,0,0,2
3239650,3239662,12,1,0,0,1
3239661,3240467,806,0,0,1,2
3239663,3240102,439,0,0,1,1
3240103,3240118,15,1,0,0,1
3240119,3240463,344,0,0,1,1
3240464,3240491,27,1,0,0,1
3240468,3240491,23,1,0,0,2
3240492,3240978,486,0,0,1,1
3240492,3241442,950,0,0,1,2
3240979,3240990,11,1,0,0,1
3240991,3241442,451,0,0,1,1
3241443,3241732,289,1,0,0,2
3241443,3241752,309,1,0,0,1
3241472,3241704,232,0,1,0,2
3241472,3241710,238,0,1,0,1
3241733,3242155,422,0,0,1,2
3241753,3242155,402,0,0,1,1
3242156,3242186,30,1,0,0,2
3242156,3242194,38,1,0,0,1
3242187,3242807,620,0,0,1,2
3242195,3242806,611,0,0,1,1
3242807,3242879,72,1,0,0,1
3242808,3242878,70,1,0,0,2
3242879,3242975,96,0,0,1,2
3242880,3242973,93,0,0,1,1
3242974,3243009,35,1,0,0,1
3242976,3243008,32,1,0,0,2
3243009,3243171,162,0,0,1,2
3243010,3243166,156,0,0,1,1
3243167,3243191,24,1,0,0,1
3243172,3243191,19,1,0,0,2
3243192,3244238,1046,0,0,1,1
3243192,3245167,1975,0,0,1,2
3244239,3244246,7,1,0,0,1
3244247,3245167,920,0,0,1,1
3245168,3245229,61,1,0,0,2
3245168,3245237,69,1,0,0,1
3245230,3245311,81,0,0,1,2
3245238,3245312,74,0,0,1,1
3245312,3245365,53,1,0,0,2
3245313,3245375,62,1,0,0,1
3245366,3247363,1997,0,0,1,2
3245376,3245536,160,0,0,1,1
3245537,3245554,17,1,0,0,1
3245555,3247357,1802,0,0,1,1
3247358,3247384,26,1,0,0,1
3247364,3247377,13,1,0,0,2
3247378,3247444,66,0,0,1,2
3247385,3247447,62,0,0,1,1
3247445,3247700,255,1,0,0,2
3247448,3247715,267,1,0,0,1
3247471,3247654,183,0,1,0,2
3247471,3247665,194,0,1,0,1
3247701,3247727,26,0,0,1,2
3247716,3248719,1003,0,0,1,1
3247728,3247742,14,1,0,0,2
3247743,3248719,976,0,0,1,2
3248720,3248809,89,1,0,0,1
3248720,3248810,90,1,0,0,2
3248810,3248917,107,0,0,1,1
3248811,3248917,106,0,0,1,2
3248918,3248947,29,1,0,0,2
3248918,3248967,49,1,0,0,1
3248948,3249273,325,0,0,1,2
3248968,3249273,305,0,0,1,1
3249274,3249305,31,1,0,0,2
3249274,3249306,32,1,0,0,1
3249306,3249508,202,0,0,1,2
3249307,3249510,203,0,0,1,1
3249509,3249536,27,1,0,0,2
3249511,3249537,26,1,0,0,1
3249537,3251348,1811,0,0,1,2
3249538,3251349,1811,0,0,1,1
3251349,3251430,81,1,0,0,2
3251350,3251422,72,1,0,0,1
3251423,3251641,218,0,0,1,1
3251431,3251640,209,0,0,1,2
3251641,3251673,32,1,0,0,2
3251642,3251680,38,1,0,0,1
3251674,3253476,1802,0,0,1,2
3251681,3253478,1797,0,0,1,1
3253477,3253790,313,1,0,0,2
3253479,3253759,280,1,0,0,1
3253519,3253712,193,0,1,0,2
3253521,3253711,190,0,1,0,1
3253760,3255048,1288,0,0,1,1
3253791,3255050,1259,0,0,1,2
3255049,3255135,86,1,0,0,1
3255051,3255135,84,1,0,0,2
3255136,3255297,161,0,0,1,2
3255136,3255298,162,0,0,1,1
3255298,3255326,28,1,0,0,2
3255299,3255327,28,1,0,0,1
3255327,3257738,2411,0,0,1,2
3255328,3257736,2408,0,0,1,1
3257737,3257790,53,1,0,0,1
3257739,3257792,53,1,0,0,2
3257791,3258087,296,0,0,1,1
3257793,3258087,294,0,0,1,2
3258088,3258117,29,1,0,0,2
3258088,3258118,30,1,0,0,1
3258118,3260146,2028,0,0,1,2
3258119,3260147,2028,0,0,1,1
3260147,3260167,20,1,0,0,2
3260148,3260167,19,1,0,0,1
3260168,3260238,70,0,0,1,2
3260168,3260239,71,0,0,1,1
3260239,3260465,226,1,0,0,2
3260240,3260459,219,1,0,0,1
3260260,3260411,151,0,1,0,1
3260261,3260407,146,0,1,0,2
3260460,3261378,918,0,0,1,1
3260466,3261378,912,0,0,1,2
3261379,3261432,53,1,0,0,1
3261379,3261432,53,1,0,0,2
3261433,3261793,360,0,0,1,1
3261433,3261794,361,0,0,1,2
3261794,3261850,56,1,0,0,1
3261795,3261851,56,1,0,0,2
3261851,3261981,130,0,0,1,1
3261852,3261981,129,0,0,1,2
3261982,3261998,16,1,0,0,2
3261982,3262009,27,1,0,0,1
3261999,3262245,246,0,0,1,2
3262010,3262599,589,0,0,1,1
3262246,3262260,14,1,0,0,2
3262261,3262597,336,0,0,1,2
3262598,3262626,28,1,0,0,2
3262600,3262627,27,1,0,0,1
3262627,3264002,1375,0,0,1,2
3262628,3264001,1373,0,0,1,1
3264002,3264064,62,1,0,0,1
3264003,3264064,61,1,0,0,2
3264065,3264187,122,0,0,1,2
3264065,3264189,124,0,0,1,1
3264188,3264215,27,1,0,0,2
3264190,3264217,27,1,0,0,1
3264216,3266426,2210,0,0,1,2
3264218,3266431,2213,0,0,1,1
3266427,3266440,13,1,0,0,2
3266432,3266460,28,1,0,0,1
3266441,3266618,177,0,0,1,2
3266461,3266618,157,0,0,1,1
3266619,3266854,235,1,0,0,2
3266619,3266872,253,1,0,0,1
3266649,3266831,182,0,1,0,1
3266650,3266819,169,0,1,0,2
3266855,3267817,962,0,0,1,2
3266873,3267816,943,0,0,1,1
3267817,3267904,87,1,0,0,1
3267818,3267901,83,1,0,0,2
3267902,3267989,87,0,0,1,2
3267905,3267989,84,0,0,1,1
3267990,3268024,34,1,0,0,1
3267990,3268025,35,1,0,0,2
3268025,3268173,148,0,0,1,1
3268026,3268176,150,0,0,1,2
3268174,3268200,26,1,0,0,1
3268177,3268200,23,1,0,0,2
3268201,3268867,666,0,0,1,2
3268201,3269649,1448,0,0,1,1
3268868,3268881,13,1,0,0,2
3268882,3269647,765,0,0,1,2
3269648,3269702,54,1,0,0,2
3269650,3269713,63,1,0,0,1
3269703,3270188,485,0,0,1,2
3269714,3270187,473,0,0,1,1
3270188,3270223,35,1,0,0,1
3270189,3270212,23,1,0,0,2
3270213,3270460,247,0,0,1,2
3270224,3270456,232,0,0,1,1
3270457,3270483,26,1,0,0,1
3270461,3270482,21,1,0,0,2
3270483,3270733,250,0,0,1,2
3270484,3270733,249,0,0,1,1
3270734,3270744,10,1,0,0,2
3270734,3270745,11,1,0,0,1
3270745,3271527,782,0,0,1,2
3270746,3271528,782,0,0,1,1
3271528,3271542,14,1,0,0,2
3271529,3271541,12,1,0,0,1
3271542,3271881,339,0,0,1,1
3271543,3271880,337,0,0,1,2
3271881,3271892,11,1,0,0,2
3271882,3271892,10,1,0,0,1
3271893,3272512,619,0,0,1,1
3271893,3272512,619,0,0,1,2
3272513,3272752,239,1,0,0,2
3272513,3272818,305,1,0,0,1
3272531,3272763,232,0,1,0,1
3272533,3272730,197,0,1,0,2
3272753,3273448,695,0,0,1,2
3272819,3273448,629,0,0,1,1
3273449,3273473,24,1,0,0,1
3273449,3273474,25,1,0,0,2
3273474,3273959,485,0,0,1,1
3273475,3273958,483,0,0,1,2
3273959,3274046,87,1,0,0,2
3273960,3274048,88,1,0,0,1
3274047,3274238,191,0,0,1,2
3274049,3274240,191,0,0,1,1
3274239,3274266,27,1,0,0,2
3274241,3274268,27,1,0,0,1
3274267,3274413,146,0,0,1,2
3274269,3274419,150,0,0,1,1
3274414,3274439,25,1,0,0,2
3274420,3274441,21,1,0,0,1
3274440,3274840,400,0,0,1,2
3274442,3275122,680,0,0,1,1
3274841,3274851,10,1,0,0,2
3274852,3275125,273,0,0,1,2
3275123,3275147,24,1,0,0,1
3275126,3275139,13,1,0,0,2
3275140,3276679,1539,0,0,1,2
3275148,3276677,1529,0,0,1,1
3276678,3276761,83,1,0,0,1
3276680,3276753,73,1,0,0,2
3276754,3276945,191,0,0,1,2
3276762,3276947,185,0,0,1,1
3276946,3276973,27,1,0,0,2
3276948,3276969,21,1,0,0,1
3276970,3277217,247,0,0,1,1
3276974,3278979,2005,0,0,1,2
3277218,3277295,77,1,0,0,1
3277296,3277355,59,0,0,1,1
3277356,3277386,30,1,0,0,1
3277387,3277957,570,0,0,1,1
3277958,3277976,18,1,0,0,1
3277977,3278407,430,0,0,1,1
3278408,3278422,14,1,0,0,1
3278423,3278973,550,0,0,1,1
3278974,3279252,278,1,0,0,1
3278980,3279294,314,1,0,0,2
3279006,3279207,201,0,1,0,1
3279007,3279217,210,0,1,0,2
3279253,3279481,228,0,0,1,1
3279295,3279481,186,0,0,1,2
3279482,3279531,49,1,0,0,2
3279482,3279533,51,1,0,0,1
3279532,3279787,255,0,0,1,2
3279534,3279786,252,0,0,1,1
3279787,3279836,49,1,0,0,1
3279788,3279833,45,1,0,0,2
3279834,3280556,722,0,0,1,2
3279837,3280556,719,0,0,1,1
3280557,3280596,39,1,0,0,2
3280557,3280605,48,1,0,0,1
3280597,3280783,186,0,0,1,2
3280606,3280783,177,0,0,1,1
3280784,3280858,74,1,0,0,2
3280784,3280860,76,1,0,0,1
3280859,3280961,102,0,0,1,2
3280861,3280960,99,0,0,1,1
3280961,3281000,39,1,0,0,1
3280962,3281001,39,1,0,0,2
3281001,3281204,203,0,0,1,1
3281002,3281203,201,0,0,1,2
3281204,3281225,21,1,0,0,2
3281205,3281246,41,1,0,0,1
3281226,3282688,1462,0,0,1,2
3281247,3281357,110,0,0,1,1
3281358,3281418,60,1,0,0,1
3281419,3282687,1268,0,0,1,1
3282688,3282749,61,1,0,0,1
3282689,3282748,59,1,0,0,2
3282749,3282893,144,0,0,1,2
3282750,3282892,142,0,0,1,1
3282893,3282923,30,1,0,0,1
3282894,3282922,28,1,0,0,2
3282923,3285265,2342,0,0,1,2
3282924,3285265,2341,0,0,1,1
3285266,3285514,248,1,0,0,1
3285266,3285519,253,1,0,0,2
3285290,3285453,163,0,1,0,2
3285294,3285454,160,0,1,0,1
3285515,3286334,819,0,0,1,1
3285520,3286333,813,0,0,1,2
3286334,3286361,27,1,0,0,2
3286335,3286361,26,1,0,0,1
3286362,3286440,78,0,0,1,1
3286362,3286440,78,0,0,1,2
3286441,3286463,22,1,0,0,2
3286441,3286472,31,1,0,0,1
3286464,3286963,499,0,0,1,2
3286473,3286695,222,0,0,1,1
3286696,3286710,14,1,0,0,1
3286711,3286959,248,0,0,1,1
3286960,3286984,24,1,0,0,1
3286964,3286983,19,1,0,0,2
3286984,3287488,504,0,0,1,2
3286985,3287483,498,0,0,1,1
3287484,3287499,15,1,0,0,1
3287489,3287493,4,1,0,0,2
3287494,3288455,961,0,0,1,2
3287500,3288454,954,0,0,1,1
3288455,3288525,70,1,0,0,1
3288456,3288515,59,1,0,0,2
3288516,3288622,106,0,0,1,2
3288526,3288621,95,0,0,1,1
3288622,3288670,48,1,0,0,1
3288623,3288649,26,1,0,0,2
3288650,3288863,213,0,0,1,2
3288671,3288864,193,0,0,1,1
3288864,3288895,31,1,0,0,2
3288865,3288883,18,1,0,0,1
3288884,3289857,973,0,0,1,1
3288896,3290768,1872,0,0,1,2
3289858,3289866,8,1,0,0,1
3289867,3290777,910,0,0,1,1
3290769,3290991,222,1,0,0,2
3290778,3291003,225,1,0,0,1
3290800,3290938,138,0,1,0,2
3290801,3290934,133,0,1,0,1
3290992,3291013,21,0,0,1,2
3291004,3291322,318,0,0,1,1
3291014,3291025,11,1,0,0,2
3291026,3291322,296,0,0,1,2
3291323,3291377,54,1,0,0,1
3291323,3291377,54,1,0,0,2
3291378,3291719,341,0,0,1,1
3291378,3291719,341,0,0,1,2
3291720,3291773,53,1,0,0,1
3291720,3291774,54,1,0,0,2
3291774,3292006,232,0,0,1,1
3291775,3292006,231,0,0,1,2
3292007,3292093,86,1,0,0,2
3292007,3292095,88,1,0,0,1
3292094,3292139,45,0,0,1,2
3292096,3292140,44,0,0,1,1
3292140,3292176,36,1,0,0,2
3292141,3292177,36,1,0,0,1
3292177,3292391,214,0,0,1,2
3292178,3292391,213,0,0,1,1
3292392,3292419,27,1,0,0,1
3292392,3292419,27,1,0,0,2
3292420,3293239,819,0,0,1,1
3292420,3293893,1473,0,0,1,2
3293240,3293254,14,1,0,0,1
3293255,3293892,637,0,0,1,1
3293893,3293950,57,1,0,0,1
3293894,3293955,61,1,0,0,2
3293951,3294086,135,0,0,1,1
3293956,3294085,129,0,0,1,2
3294086,3294111,25,1,0,0,2
3294087,3294104,17,1,0,0,1
3294105,3294790,685,0,0,1,1
3294112,3294790,678,0,0,1,2
3294791,3294805,14,1,0,0,2
3294791,3294812,21,1,0,0,1
3294806,3295988,1182,0,0,1,2
3294813,3295990,1177,0,0,1,1
3295989,3295993,4,1,0,0,2
3295991,3296000,9,1,0,0,1
3295994,3296505,511,0,0,1,2
3296001,3296507,506,0,0,1,1
3296506,3296795,289,1,0,0,2
3296508,3296800,292,1,0,0,1
3296535,3296775,240,0,1,0,1
3296538,3296765,227,0,1,0,2
3296796,3297676,880,0,0,1,2
3296801,3297676,875,0,0,1,1
3297677,3297765,88,1,0,0,2
3297677,3297767,90,1,0,0,1
3297766,3297909,143,0,0,1,2
3297768,3297908,140,0,0,1,1
3297909,3297930,21,1,0,0,1
3297910,3297925,15,1,0,0,2
3297926,3298224,298,0,0,1,2
3297931,3298219,288,0,0,1,1
3298220,3298237,17,1,0,0,1
3298225,3298236,11,1,0,0,2
3298237,3298580,343,0,0,1,2
3298238,3298579,341,0,0,1,1
3298580,3298619,39,1,0,0,1
3298581,3298612,31,1,0,0,2
3298613,3298783,170,0,0,1,2
3298620,3298781,161,0,0,1,1
3298782,3298807,25,1,0,0,1
3298784,3298808,24,1,0,0,2
3298808,3299123,315,0,0,1,1
3298809,3299123,314,0,0,1,2
3299124,3299128,4,1,0,0,1
3299124,3299134,10,1,0,0,2
3299129,3300237,1108,0,0,1,1
3299135,3300238,1103,0,0,1,2
3300238,3300308,70,1,0,0,1
3300239,3300305,66,1,0,0,2
3300306,3300465,159,0,0,1,2
3300309,3300464,155,0,0,1,1
3300465,3300497,32,1,0,0,1
3300466,3300496,30,1,0,0,2
3300497,3300869,372,0,0,1,2
3300498,3300869,371,0,0,1,1
3300870,3300905,35,1,0,0,1
3300870,3300906,36,1,0,0,2
3300906,3301212,306,0,0,1,1
3300907,3301213,306,0,0,1,2
3301213,3301236,23,1,0,0,1
3301214,3301235,21,1,0,0,2
3301236,3302804,1568,0,0,1,2
3301237,3302806,1569,0,0,1,1
3302805,3303043,238,1,0,0,2
3302807,3303052,245,1,0,0,1
3302827,3302997,170,0,1,0,1
3302828,3302969,141,0,1,0,2
3303044,3303539,495,0,0,1,2
3303053,3303538,485,0,0,1,1
3303539,3303617,78,1,0,0,1
3303540,3303617,77,1,0,0,2
3303618,3303748,130,0,0,1,1
3303618,3303749,131,0,0,1,2
3303749,3303780,31,1,0,0,1
3303750,3303779,29,1,0,0,2
3303780,3304691,911,0,0,1,2
3303781,3304686,905,0,0,1,1
3304687,3304701,14,1,0,0,1
3304692,3304702,10,1,0,0,2
3304702,3304904,202,0,0,1,1
3304703,3304905,202,0,0,1,2
3304905,3304928,23,1,0,0,1
3304906,3304916,10,1,0,0,2
3304917,3305777,860,0,0,1,2
3304929,3305777,848,0,0,1,1
3305778,3305852,74,1,0,0,1
3305778,3305852,74,1,0,0,2
3305853,3305961,108,0,0,1,1
3305853,3305961,108,0,0,1,2
3305962,3305982,20,1,0,0,2
3305962,3306022,60,1,0,0,1
3305983,3308251,2268,0,0,1,2
3306023,3308251,2228,0,0,1,1
3308252,3308456,204,1,0,0,1
3308252,3308541,289,1,0,0,2
3308297,3308437,140,0,1,0,2
3308302,3308416,114,0,1,0,1
3308457,3309243,786,0,0,1,1
3308542,3309243,701,0,0,1,2
3309244,3309303,59,1,0,0,2
3309244,3309319,75,1,0,0,1
3309304,3309422,118,0,0,1,2
3309320,3309422,102,0,0,1,1
3309423,3309465,42,1,0,0,1
3309423,3309476,53,1,0,0,2
3309466,3309620,154,0,0,1,1
3309477,3309624,147,0,0,1,2
3309621,3309646,25,1,0,0,1
3309625,3309635,10,1,0,0,2
3309636,3312027,2391,0,0,1,2
3309647,3312027,2380,0,0,1,1
3312028,3312076,48,1,0,0,2
3312028,3312080,52,1,0,0,1
3312077,3312204,127,0,0,1,2
3312081,3312202,121,0,0,1,1
3312203,3312234,31,1,0,0,1
3312205,3312225,20,1,0,0,2
3312226,3314297,2071,0,0,1,2
3312235,3314300,2065,0,0,1,1
3314298,3314545,247,1,0,0,2
3314301,3314504,203,1,0,0,1
3314326,3314467,141,0,1,0,2
3314330,3314457,127,0,1,0,1
3314505,3314751,246,0,0,1,1
3314546,3314752,206,0,0,1,2
3314752,3314796,44,1,0,0,1
3314753,3314802,49,1,0,0,2
3314797,3316090,1293,0,0,1,1
3314803,3316090,1287,0,0,1,2
3316091,3316172,81,1,0,0,2
3316091,3316180,89,1,0,0,1
3316173,3316277,104,0,0,1,2
3316181,3316275,94,0,0,1,1
3316276,3316318,42,1,0,0,1
3316278,3316310,32,1,0,0,2
3316311,3316466,155,0,0,1,2
3316319,3316460,141,0,0,1,1
3316461,3316489,28,1,0,0,1
3316467,3316480,13,1,0,0,2
3316481,3316725,244,0,0,1,2
3316490,3316724,234,0,0,1,1
3316725,3316746,21,1,0,0,1
3316726,3316742,16,1,0,0,2
3316743,3318048,1305,0,0,1,2
3316747,3318048,1301,0,0,1,1
3318049,3318121,72,1,0,0,2
3318049,3318125,76,1,0,0,1
3318122,3318241,119,0,0,1,2
3318126,3318242,116,0,0,1,1
3318242,3318272,30,1,0,0,2
3318243,3318272,29,1,0,0,1
3318273,3319023,750,0,0,1,1
3318273,3319029,756,0,0,1,2
3319024,3319040,16,1,0,0,1
3319030,3319040,10,1,0,0,2
3319041,3320347,1306,0,0,1,2
3319041,3320349,1308,0,0,1,1
3320348,3320560,212,1,0,0,2
3320350,3320575,225,1,0,0,1
3320371,3320515,144,0,1,0,2
3320372,3320521,149,0,1,0,1
3320561,3320583,22,0,0,1,2
3320576,3321378,802,0,0,1,1
3320584,3320600,16,1,0,0,2
3320601,3321378,777,0,0,1,2
3321379,3321423,44,1,0,0,1
3321379,3321424,45,1,0,0,2
3321424,3321570,146,0,0,1,1
3321425,3321574,149,0,0,1,2
3321571,3321588,17,1,0,0,1
3321575,3321581,6,1,0,0,2
3321582,3321921,339,0,0,1,2
3321589,3321919,330,0,0,1,1
3321920,3321942,22,1,0,0,1
3321922,3321942,20,1,0,0,2
3321943,3322158,215,0,0,1,2
3321943,3322163,220,0,0,1,1
3322159,3322178,19,1,0,0,2
3322164,3322185,21,1,0,0,1
3322179,3322418,239,0,0,1,2
3322186,3322414,228,0,0,1,1
3322415,3322435,20,1,0,0,1
3322419,3322435,16,1,0,0,2
3322436,3322651,215,0,0,1,2
3322436,3324298,1862,0,0,1,1
3322652,3322668,16,1,0,0,2
3322669,3324298,1629,0,0,1,2
3324299,3324358,59,1,0,0,2
3324299,3324366,67,1,0,0,1
3324359,3324537,178,0,0,1,2
3324367,3324538,171,0,0,1,1
3324538,3324566,28,1,0,0,2
3324539,3324567,28,1,0,0,1
3324567,3324809,242,0,0,1,2
3324568,3324808,240,0,0,1,1
3324809,3324840,31,1,0,0,1
3324810,3324837,27,1,0,0,2
3324838,3325076,238,0,0,1,2
3324841,3325076,235,0,0,1,1
3325077,3325107,30,1,0,0,2
3325077,3325108,31,1,0,0,1
3325108,3326356,1248,0,0,1,2
3325109,3326354,1245,0,0,1,1
3326355,3326364,9,1,0,0,1
3326357,3326367,10,1,0,0,2
3326365,3326586,221,0,0,1,1
3326368,3326585,217,0,0,1,2
3326586,3326872,286,1,0,0,2
3326587,3326849,262,1,0,0,1
3326616,3326796,180,0,1,0,1
3326617,3326788,171,0,1,0,2
3326850,3327768,918,0,0,1,1
3326873,3327768,895,0,0,1,2
3327769,3327793,24,1,0,0,2
3327769,3327804,35,1,0,0,1
3327794,3328222,428,0,0,1,2
3327805,3328221,416,0,0,1,1
3328222,3328293,71,1,0,0,1
3328223,3328295,72,1,0,0,2
3328294,3328388,94,0,0,1,1
3328296,3328388,92,0,0,1,2
3328389,3328421,32,1,0,0,2
3328389,3328432,43,1,0,0,1
3328422,3328603,181,0,0,1,2
3328433,3328601,168,0,0,1,1
3328602,3328634,32,1,0,0,1
3328604,3328627,23,1,0,0,2
3328628,3328825,197,0,0,1,2
3328635,3328820,185,0,0,1,1
3328821,3328850,29,1,0,0,1
3328826,3328851,25,1,0,0,2
3328851,3329047,196,0,0,1,1
3328852,3329046,194,0,0,1,2
3329047,3329078,31,1,0,0,2
3329048,3329077,29,1,0,0,1
3329078,3329286,208,0,0,1,1
3329079,3329285,206,0,0,1,2
3329286,3329302,16,1,0,0,2
3329287,3329301,14,1,0,0,1
3329302,3329578,276,0,0,1,1
3329303,3329577,274,0,0,1,2
3329578,3329603,25,1,0,0,2
3329579,3329603,24,1,0,0,1
3329604,3330584,980,0,0,1,1
3329604,3330584,980,0,0,1,2
3330585,3330643,58,1,0,0,2
3330585,3330651,66,1,0,0,1
3330644,3330766,122,0,0,1,2
3330652,3330766,114,0,0,1,1
3330767,3330789,22,1,0,0,2
3330767,3330807,40,1,0,0,1
3330790,3330943,153,0,0,1,2
3330808,3330942,134,0,0,1,1
3330943,3330968,25,1,0,0,1
3330944,3330963,19,1,0,0,2
3330964,3332773,1809,0,0,1,2
3330969,3332771,1802,0,0,1,1
3332772,3332800,28,1,0,0,1
3332774,3332803,29,1,0,0,2
3332801,3333411,610,0,0,1,1
3332804,3333411,607,0,0,1,2
3333412,3333445,33,1,0,0,1
3333412,3333446,34,1,0,0,2
3333446,3333886,440,0,0,1,1
3333447,3333888,441,0,0,1,2
3333887,3333975,88,1,0,0,1
3333889,3333967,78,1,0,0,2
3333968,3334071,103,0,0,1,2
3333976,3334070,94,0,0,1,1
3334071,3334120,49,1,0,0,1
3334072,3334122,50,1,0,0,2
3334121,3334728,607,0,0,1,1
3334123,3334720,597,0,0,1,2
3334721,3334995,274,1,0,0,2
3334729,3335012,283,1,0,0,1
3334762,3334958,196,0,1,0,1
3334763,3334944,181,0,1,0,2
3334996,3335183,187,0,0,1,2
3335013,3335184,171,0,0,1,1
3335184,3335224,40,1,0,0,2
3335185,3335207,22,1,0,0,1
3335208,3335286,78,0,0,1,1
3335225,3335285,60,0,0,1,2
3335286,3335528,242,1,0,0,2
3335287,3335572,285,1,0,0,1
3335309,3335501,192,0,1,0,1
3335311,3335481,170,0,1,0,2
3335529,3335642,113,0,0,1,2
3335573,3335649,76,0,0,1,1
3335643,3335660,17,1,0,0,2
3335650,3335671,21,1,0,0,1
3335661,3335849,188,0,0,1,2
3335672,3335842,170,0,0,1,1
3335843,3336104,261,1,0,0,1
3335850,3336088,238,1,0,0,2
3335875,3336040,165,0,1,0,2
3335878,3336059,181,0,1,0,1
3336089,3336190,101,0,0,1,2
3336105,3336162,57,0,0,1,1
3336163,3341314,5151,1,0,0,1
3336191,3341255,5064,1,0,0,2
3336226,3341303,5077,0,1,0,1
3336231,3341044,4813,0,1,0,2
3341085,3341229,144,0,1,0,2
3341256,3341629,373,0,0,1,2
3341315,3341495,180,0,0,1,1
3341496,3341504,8,1,0,0,1
3341505,3341616,111,0,0,1,1
3341617,3342013,396,1,0,0,1
3341630,3341977,347,1,0,0,2
3341647,3341974,327,0,1,0,1
3341655,3341933,278,0,1,0,2
3341978,3342159,181,0,0,1,2
3342014,3342158,144,0,0,1,1
3342159,3342185,26,1,0,0,1
3342160,3342184,24,1,0,0,2
3342185,3342523,338,0,0,1,2
3342186,3342516,330,0,0,1,1
3342517,3342969,452,1,0,0,1
3342524,3342937,413,1,0,0,2
3342539,3342956,417,0,1,0,1
3342545,3342702,157,0,1,0,2
3342762,3342895,133,0,1,0,2
3342938,3343449,511,0,0,1,2
3342970,3343451,481,0,0,1,1
3343450,3343661,211,1,0,0,2
3343452,3343688,236,1,0,0,1
3343468,3343645,177,0,1,0,1
3343472,3343606,134,0,1,0,2
3343662,3343802,140,0,0,1,2
3343689,3343801,112,0,0,1,1
3343802,3343815,13,1,0,0,1
3343803,3343819,16,1,0,0,2
3343816,3344102,286,0,0,1,1
3343820,3344099,279,0,0,1,2
3344100,3344115,15,1,0,0,2
3344103,3344116,13,1,0,0,1
3344116,3344292,176,0,0,1,2
3344117,3344294,177,0,0,1,1
3344293,3345214,921,1,0,0,2
3344295,3345239,944,1,0,0,1
3344313,3345225,912,0,1,0,1
3344314,3345203,889,0,1,0,2
3345215,3345315,100,0,0,1,2
3345240,3345314,74,0,0,1,1
3345315,3345333,18,1,0,0,1
3345316,3345343,27,1,0,0,2
3345334,3345536,202,0,0,1,1
3345344,3345536,192,0,0,1,2
3345537,3345562,25,1,0,0,2
3345537,3345567,30,1,0,0,1
3345563,3345849,286,0,0,1,2
3345568,3345851,283,0,0,1,1
3345850,3346101,251,1,0,0,2
3345852,3346111,259,1,0,0,1
3345866,3346027,161,0,1,0,2
3345867,3346047,180,0,1,0,1
3346102,3346300,198,0,0,1,2
3346112,3346300,188,0,0,1,1
3346301,3346320,19,1,0,0,1
3346301,3346322,21,1,0,0,2
3346321,3346543,222,0,0,1,1
3346323,3346545,222,0,0,1,2
3346544,3346571,27,1,0,0,1
3346546,3346563,17,1,0,0,2
3346564,3346845,281,0,0,1,2
3346572,3346844,272,0,0,1,1
3346845,3346871,26,1,0,0,1
3346846,3346872,26,1,0,0,2
3346872,3347111,239,0,0,1,1
3346873,3347111,238,0,0,1,2
3347112,3347131,19,1,0,0,2
3347112,3347132,20,1,0,0,1
3347132,3347705,573,0,0,1,2
3347133,3347705,572,0,0,1,1
3394547,3394569,22,0,0,1,1
3394547,3394571,24,0,0,1,2
3394570,3394593,23,1,0,0,1
3394572,3394592,20,1,0,0,2
3394593,3394925,332,0,0,1,2
3394594,3394924,330,0,0,1,1
3394925,3395018,93,1,0,0,1
3394926,3395017,91,1,0,0,2
3395018,3395124,106,0,0,1,2
3395019,3395124,105,0,0,1,1
3395125,3395157,32,1,0,0,1
3395125,3395157,32,1,0,0,2
3395158,3395353,195,0,0,1,1
3395158,3395358,200,0,0,1,2
3395354,3395373,19,1,0,0,1
3395359,3395378,19,1,0,0,2
3395374,3396030,656,0,0,1,1
3395379,3396037,658,0,0,1,2
3396031,3396050,19,1,0,0,1
3396038,3396046,8,1,0,0,2
3396047,3396330,283,0,0,1,2
3396051,3396326,275,0,0,1,1
3396327,3396336,9,1,0,0,1
3396331,3396339,8,1,0,0,2
3396337,3396558,221,0,0,1,1
3396340,3396563,223,0,0,1,2
3396559,3396576,17,1,0,0,1
3396564,3396576,12,1,0,0,2
3396577,3396849,272,0,0,1,2
3396577,3396850,273,0,0,1,1
3396850,3396859,9,1,0,0,2
3396851,3396867,16,1,0,0,1
3396860,3397105,245,0,0,1,2
3396868,3397106,238,0,0,1,1
3397106,3397117,11,1,0,0,2
3397107,3397126,19,1,0,0,1
3397118,3397563,445,0,0,1,2
3397127,3397561,434,0,0,1,1
3397562,3397584,22,1,0,0,1
3397564,3397588,24,1,0,0,2
3397585,3398119,534,0,0,1,1
3397589,3398125,536,0,0,1,2
3398120,3398141,21,1,0,0,1
3398126,3398135,9,1,0,0,2
3398136,3398482,346,0,0,1,2
3398142,3398482,340,0,0,1,1
3398483,3398492,9,1,0,0,1
3398483,3398494,11,1,0,0,2
3398493,3399792,1299,0,0,1,1
3398495,3399793,1298,0,0,1,2
3399793,3399890,97,1,0,0,1
3399794,3399878,84,1,0,0,2
3399879,3400012,133,0,0,1,2
3399891,3400012,121,0,0,1,1
3400013,3400033,20,1,0,0,2
3400013,3400040,27,1,0,0,1
3400034,3400221,187,0,0,1,2
3400041,3400221,180,0,0,1,1
3400222,3400238,16,1,0,0,2
3400222,3400245,23,1,0,0,1
3400239,3401672,1433,0,0,1,2
3400246,3401671,1425,0,0,1,1
3401672,3401690,18,1,0,0,1
3401673,3401689,16,1,0,0,2
3401690,3402067,377,0,0,1,2
3401691,3402068,377,0,0,1,1
3402068,3402121,53,1,0,0,2
3402069,3402120,51,1,0,0,1
3402121,3402225,104,0,0,1,1
3402122,3402228,106,0,0,1,2
3402226,3402292,66,1,0,0,1
3402229,3402251,22,1,0,0,2
3402252,3402580,328,0,0,1,2
3402293,3402358,65,0,0,1,1
3402359,3402419,60,1,0,0,1
3402420,3402555,135,0,0,1,1
3402556,3402603,47,1,0,0,1
3402581,3402590,9,1,0,0,2
3402591,3404496,1905,0,0,1,2
3402604,3402819,215,0,0,1,1
3402820,3402837,17,1,0,0,1
3402838,3402920,82,0,0,1,1
3402921,3402940,19,1,0,0,1
3402941,3402992,51,0,0,1,1
3402993,3403101,108,1,0,0,1
3403102,3404494,1392,0,0,1,1
3404495,3404544,49,1,0,0,1
3404497,3404546,49,1,0,0,2
3404545,3404709,164,0,0,1,1
3404547,3404712,165,0,0,1,2
3404710,3404732,22,1,0,0,1
3404713,3404725,12,1,0,0,2
3404726,3404799,73,0,0,1,2
3404733,3404810,77,0,0,1,1
3404800,3405089,289,1,0,0,2
3404811,3405073,262,1,0,0,1
3404830,3405013,183,0,1,0,1
3404830,3405027,197,0,1,0,2
3405074,3405111,37,0,0,1,1
3405090,3406101,1011,0,0,1,2
3405112,3405130,18,1,0,0,1
3405131,3406101,970,0,0,1,1
3406102,3406119,17,1,0,0,2
3406102,3406130,28,1,0,0,1
3406120,3407302,1182,0,0,1,2
3406131,3407303,1172,0,0,1,1
3407303,3407387,84,1,0,0,2
3407304,3407402,98,1,0,0,1
3407388,3407473,85,0,0,1,2
3407403,3407473,70,0,0,1,1
3407474,3407512,38,1,0,0,2
3407474,3407517,43,1,0,0,1
3407513,3407774,261,0,0,1,2
3407518,3407769,251,0,0,1,1
3407770,3407796,26,1,0,0,1
3407775,3407786,11,1,0,0,2
3407787,3408364,577,0,0,1,2
3407797,3408358,561,0,0,1,1
3408359,3408374,15,1,0,0,1
3408365,3408374,9,1,0,0,2
3408375,3409236,861,0,0,1,1
3408375,3409236,861,0,0,1,2
3409237,3409295,58,1,0,0,2
3409237,3409306,69,1,0,0,1
3409296,3409520,224,0,0,1,2
3409307,3409518,211,0,0,1,1
3409519,3409607,88,1,0,0,1
3409521,3409615,94,1,0,0,2
3409608,3409707,99,0,0,1,1
3409616,3409706,90,0,0,1,2
3409707,3409737,30,1,0,0,2
3409708,3409738,30,1,0,0,1
3409738,3409852,114,0,0,1,2
3409739,3409850,111,0,0,1,1
3409851,3409880,29,1,0,0,1
3409853,3409871,18,1,0,0,2
3409872,3410195,323,0,0,1,2
3409881,3410197,316,0,0,1,1
3410196,3410210,14,1,0,0,2
3410198,3410215,17,1,0,0,1
3410211,3410456,245,0,0,1,2
3410216,3410451,235,0,0,1,1
3410452,3410473,21,1,0,0,1
3410457,3410466,9,1,0,0,2
3410467,3411673,1206,0,0,1,2
3410474,3411673,1199,0,0,1,1
3411674,3411725,51,1,0,0,2
3411674,3411726,52,1,0,0,1
3411726,3411865,139,0,0,1,2
3411727,3411864,137,0,0,1,1
3411865,3411943,78,1,0,0,1
3411866,3411932,66,1,0,0,2
3411933,3412029,96,0,0,1,2
3411944,3412028,84,0,0,1,1
3412029,3412060,31,1,0,0,1
3412030,3412062,32,1,0,0,2
3412061,3412235,174,0,0,1,1
3412063,3412236,173,0,0,1,2
3412236,3412262,26,1,0,0,1
3412237,3412255,18,1,0,0,2
3412256,3413665,1409,0,0,1,2
3412263,3413664,1401,0,0,1,1
3413665,3413719,54,1,0,0,1
3413666,3413719,53,1,0,0,2
3413720,3414091,371,0,0,1,1
3413720,3414091,371,0,0,1,2
3414092,3414173,81,1,0,0,2
3414092,3414175,83,1,0,0,1
3414174,3414256,82,0,0,1,2
3414176,3414256,80,0,0,1,1
3414257,3414290,33,1,0,0,1
3414257,3414297,40,1,0,0,2
3414291,3415908,1617,0,0,1,1
3414298,3415898,1600,0,0,1,2
3415899,3416106,207,1,0,0,2
3415909,3416075,166,1,0,0,1
3415928,3416055,127,0,1,0,2
3415929,3416029,100,0,1,0,1
3416076,3416296,220,0,0,1,1
3416107,3416135,28,0,0,1,2
3416136,3416154,18,1,0,0,2
3416155,3416297,142,0,0,1,2
3416297,3416353,56,1,0,0,1
3416298,3416356,58,1,0,0,2
3416354,3416448,94,0,0,1,1
3416357,3416449,92,0,0,1,2
3416449,3416487,38,1,0,0,1
3416450,3416467,17,1,0,0,2
3416468,3416658,190,0,0,1,2
3416488,3416653,165,0,0,1,1
3416654,3416691,37,1,0,0,1
3416659,3416683,24,1,0,0,2
3416684,3417482,798,0,0,1,2
3416692,3417482,790,0,0,1,1
3417483,3417500,17,1,0,0,1
3417483,3417502,19,1,0,0,2
3417501,3417740,239,0,0,1,1
3417503,3417741,238,0,0,1,2
3417741,3417770,29,1,0,0,1
3417742,3417762,20,1,0,0,2
3417763,3418815,1052,0,0,1,2
3417771,3418812,1041,0,0,1,1
3418813,3418885,72,1,0,0,1
3418816,3418875,59,1,0,0,2
3418876,3418968,92,0,0,1,2
3418886,3418968,82,0,0,1,1
3418969,3419010,41,1,0,0,1
3418969,3419010,41,1,0,0,2
3419011,3419128,117,0,0,1,1
3419011,3419129,118,0,0,1,2
3419129,3419149,20,1,0,0,1
3419130,3419148,18,1,0,0,2
3419149,3420696,1547,0,0,1,2
3419150,3420697,1547,0,0,1,1
3420697,3420743,46,1,0,0,2
3420698,3420744,46,1,0,0,1
3420744,3421132,388,0,0,1,2
3420745,3421132,387,0,0,1,1
3421133,3421200,67,1,0,0,1
3421133,3421204,71,1,0,0,2
3421201,3421290,89,0,0,1,1
3421205,3421289,84,0,0,1,2
3421290,3421311,21,1,0,0,2
3421291,3421328,37,1,0,0,1
3421312,3421875,563,0,0,1,2
3421329,3421581,252,0,0,1,1
3421582,3421601,19,1,0,0,1
3421602,3422160,558,0,0,1,1
3421876,3421890,14,1,0,0,2
3421891,3422159,268,0,0,1,2
3422160,3422184,24,1,0,0,2
3422161,3422185,24,1,0,0,1
3422185,3422978,793,0,0,1,2
3422186,3422979,793,0,0,1,1
3422979,3423003,24,1,0,0,2
3422980,3423002,22,1,0,0,1
3423003,3423479,476,0,0,1,1
3423004,3423478,474,0,0,1,2
3423479,3423593,114,1,0,0,2
3423480,3423591,111,1,0,0,1
3423592,3423666,74,0,0,1,1
3423594,3423668,74,0,0,1,2
3423667,3423713,46,1,0,0,1
3423669,3423852,183,1,0,0,2
3423714,3423895,181,0,0,1,1
3423853,3424168,315,0,0,1,2
3423896,3423941,45,1,0,0,1
3423942,3424087,145,0,0,1,1
3424088,3424182,94,1,0,0,1
3424169,3424173,4,1,0,0,2
3424174,3425609,1435,0,0,1,2
3424183,3424336,153,0,0,1,1
3424337,3424502,165,1,0,0,1
3424503,3424593,90,0,0,1,1
3424594,3424691,97,1,0,0,1
3424692,3425087,395,0,0,1,1
3425088,3425102,14,1,0,0,1
3425103,3425180,77,0,0,1,1
3425181,3425192,11,1,0,0,1
3425193,3425270,77,0,0,1,1
3425271,3425279,8,1,0,0,1
3425280,3425420,140,0,0,1,1
3425421,3425707,286,1,0,0,1
3425610,3425706,96,1,0,0,2
3425707,3425794,87,0,0,1,2
3425708,3425792,84,0,0,1,1
3425793,3425827,34,1,0,0,1
3425795,3425827,32,1,0,0,2
3425828,3426094,266,0,0,1,1
3425828,3426094,266,0,0,1,2
3426095,3426111,16,1,0,0,1
3426095,3426112,17,1,0,0,2
3426112,3426299,187,0,0,1,1
3426113,3426294,181,0,0,1,2
3426295,3426316,21,1,0,0,2
3426300,3426322,22,1,0,0,1
3426317,3427427,1110,0,0,1,2
3426323,3427427,1104,0,0,1,1
3427428,3427495,67,1,0,0,2
3427428,3427496,68,1,0,0,1
3427496,3427817,321,0,0,1,2
3427497,3427816,319,0,0,1,1
3427817,3427910,93,1,0,0,1
3427818,3427903,85,1,0,0,2
3427904,3428023,119,0,0,1,2
3427911,3428019,108,0,0,1,1
3428020,3428042,22,1,0,0,1
3428024,3428045,21,1,0,0,2
3428043,3428358,315,0,0,1,1
3428046,3428689,643,0,0,1,2
3428359,3428369,10,1,0,0,1
3428370,3428691,321,0,0,1,1
3428690,3428710,20,1,0,0,2
3428692,3428709,17,1,0,0,1
3428710,3429595,885,0,0,1,1
3428711,3429592,881,0,0,1,2
3429593,3429616,23,1,0,0,2
3429596,3429615,19,1,0,0,1
3429616,3430042,426,0,0,1,1
3429617,3430042,425,0,0,1,2
3430043,3430122,79,1,0,0,2
3430043,3430123,80,1,0,0,1
3430123,3430185,62,0,0,1,2
3430124,3430186,62,0,0,1,1
3430186,3430229,43,1,0,0,2
3430187,3430242,55,1,0,0,1
3430230,3430438,208,0,0,1,2
3430243,3430438,195,0,0,1,1
3430439,3430449,10,1,0,0,2
3430439,3430452,13,1,0,0,1
3430450,3430737,287,0,0,1,2
3430453,3430731,278,0,0,1,1
3430732,3430751,19,1,0,0,1
3430738,3430752,14,1,0,0,2
3430752,3430984,232,0,0,1,1
3430753,3430995,242,0,0,1,2
3430985,3431013,28,1,0,0,1
3430996,3431010,14,1,0,0,2
3431011,3431827,816,0,0,1,2
3431014,3431824,810,0,0,1,1
3431825,3431866,41,1,0,0,1
3431828,3431864,36,1,0,0,2
3431865,3432022,157,0,0,1,2
3431867,3432030,163,0,0,1,1
3432023,3432310,287,1,0,0,2
3432031,3432275,244,1,0,0,1
3432047,3432250,203,0,1,0,2
3432050,3432221,171,0,1,0,1
3432276,3432359,83,0,0,1,1
3432311,3432360,49,0,0,1,2
3432360,3432433,73,1,0,0,1
3432361,3432435,74,1,0,0,2
3432434,3432511,77,0,0,1,1
3432436,3432512,76,0,0,1,2
3432512,3432553,41,1,0,0,1
3432513,3432553,40,1,0,0,2
3432554,3432694,140,0,0,1,1
3432554,3432695,141,0,0,1,2
3432695,3432712,17,1,0,0,1
3432696,3432712,16,1,0,0,2
3432713,3434039,1326,0,0,1,1
3432713,3434041,1328,0,0,1,2
3434040,3434095,55,1,0,0,1
3434042,3434085,43,1,0,0,2
3434086,3434139,53,0,0,1,2
3434096,3434139,43,0,0,1,1
3434140,3434251,111,1,0,0,1
3434140,3434277,137,1,0,0,2
3434252,3434458,206,0,0,1,1
3434278,3434459,181,0,0,1,2
3434459,3434507,48,1,0,0,1
3434460,3434505,45,1,0,0,2
3434506,3434653,147,0,0,1,2
3434508,3434648,140,0,0,1,1
3434649,3434666,17,1,0,0,1
3434654,3434665,11,1,0,0,2
3434666,3435154,488,0,0,1,2
3434667,3435148,481,0,0,1,1
3435149,3435176,27,1,0,0,1
3435155,3435170,15,1,0,0,2
3435171,3436416,1245,0,0,1,2
3435177,3436420,1243,0,0,1,1
3436417,3436435,18,1,0,0,2
3436421,3436436,15,1,0,0,1
3436436,3436792,356,0,0,1,2
3436437,3436792,355,0,0,1,1
3436793,3436855,62,1,0,0,2
3436793,3436856,63,1,0,0,1
3436856,3436938,82,0,0,1,2
3436857,3436938,81,0,0,1,1
3436939,3436960,21,1,0,0,2
3436939,3436961,22,1,0,0,1
3436961,3438412,1451,0,0,1,2
3436962,3438412,1450,0,0,1,1
3438413,3438432,19,1,0,0,2
3438413,3438443,30,1,0,0,1
3438433,3438887,454,0,0,1,2
3438444,3438888,444,0,0,1,1
3438888,3438960,72,1,0,0,2
3438889,3438962,73,1,0,0,1
3438961,3439066,105,0,0,1,2
3438963,3439065,102,0,0,1,1
3439066,3439090,24,1,0,0,1
3439067,3439099,32,1,0,0,2
3439091,3441206,2115,0,0,1,1
3439100,3441207,2107,0,0,1,2
3441207,3441369,162,1,0,0,1
3441208,3441358,150,1,0,0,2
3441359,3441970,611,0,0,1,2
3441370,3441966,596,0,0,1,1
3441967,3441987,20,1,0,0,1
3441971,3441987,16,1,0,0,2
3441988,3442162,174,0,0,1,2
3441988,3442166,178,0,0,1,1
3442163,3442180,17,1,0,0,2
3442167,3442181,14,1,0,0,1
3442181,3442997,816,0,0,1,2
3442182,3442996,814,0,0,1,1
3442997,3443071,74,1,0,0,1
3442998,3443072,74,1,0,0,2
3443072,3443445,373,0,0,1,1
3443073,3443446,373,0,0,1,2
3443446,3443549,103,1,0,0,1
3443447,3443548,101,1,0,0,2
3443549,3443621,72,0,0,1,2
3443550,3443622,72,0,0,1,1
3443622,3443644,22,1,0,0,2
3443623,3443674,51,1,0,0,1
3443645,3443939,294,0,0,1,2
3443675,3443941,266,0,0,1,1
3443940,3444146,206,1,0,0,2
3443942,3444146,204,1,0,0,1
3443964,3444095,131,0,1,0,2
3443967,3444098,131,0,1,0,1
3444147,3444324,177,0,0,1,1
3444147,3444329,182,0,0,1,2
3444325,3444363,38,1,0,0,1
3444330,3444349,19,1,0,0,2
3444350,3444626,276,0,0,1,2
3444364,3444625,261,0,0,1,1
3444626,3444657,31,1,0,0,1
3444627,3444654,27,1,0,0,2
3444655,3446062,1407,0,0,1,2
3444658,3446061,1403,0,0,1,1
3446062,3446117,55,1,0,0,1
3446063,3446120,57,1,0,0,2
3446118,3446209,91,0,0,1,1
3446121,3446210,89,0,0,1,2
3446210,3446243,33,1,0,0,1
3446211,3446231,20,1,0,0,2
3446232,3447637,1405,0,0,1,2
3446244,3446484,240,0,0,1,1
3446485,3446489,4,1,0,0,1
3446490,3447638,1148,0,0,1,1
3447638,3447663,25,1,0,0,2
3447639,3447661,22,1,0,0,1
3447662,3448109,447,0,0,1,1
3447664,3448111,447,0,0,1,2
3448110,3448243,133,1,0,0,1
3448112,3448243,131,1,0,0,2
3448244,3448329,85,0,0,1,1
3448244,3448329,85,0,0,1,2
3448330,3448353,23,1,0,0,2
3448330,3448358,28,1,0,0,1
3448354,3448528,174,0,0,1,2
3448359,3448527,168,0,0,1,1
3448528,3448556,28,1,0,0,1
3448529,3448554,25,1,0,0,2
3448555,3449791,1236,0,0,1,2
3448557,3449791,1234,0,0,1,1
3449792,3449872,80,1,0,0,1
3449792,3449874,82,1,0,0,2
3449873,3450234,361,0,0,1,1
3449875,3450233,358,0,0,1,2
3450234,3450312,78,1,0,0,2
3450235,3450314,79,1,0,0,1
3450313,3450473,160,0,0,1,2
3450315,3450472,157,0,0,1,1
3450473,3450498,25,1,0,0,1
3450474,3450502,28,1,0,0,2
3450499,3451649,1150,0,0,1,1
3450503,3451650,1147,0,0,1,2
3451650,3451685,35,1,0,0,1
3451651,3451674,23,1,0,0,2
3451675,3451979,304,0,0,1,2
3451686,3451977,291,0,0,1,1
3451978,3452041,63,1,0,0,1
3451980,3452041,61,1,0,0,2
3452042,3452179,137,0,0,1,1
3452042,3452179,137,0,0,1,2
3452180,3452203,23,1,0,0,2
3452180,3452205,25,1,0,0,1
3452204,3454043,1839,0,0,1,2
3452206,3454043,1837,0,0,1,1
3454044,3454194,150,1,0,0,1
3454044,3454236,192,1,0,0,2
3454103,3454155,52,0,1,0,2
3454195,3454283,88,0,0,1,1
3454237,3454284,47,0,0,1,2
3454284,3454313,29,1,0,0,1
3454285,3454307,22,1,0,0,2
3454308,3455745,1437,0,0,1,2
3454314,3455752,1438,0,0,1,1
3455746,3455763,17,1,0,0,2
3455753,3455761,8,1,0,0,1
3455762,3456088,326,0,0,1,1
3455764,3456088,324,0,0,1,2
3456089,3456171,82,1,0,0,1
3456089,3456172,83,1,0,0,2
3456172,3456228,56,0,0,1,1
3456173,3456229,56,0,0,1,2
3456229,3456322,93,1,0,0,1
3456230,3456312,82,1,0,0,2
3456313,3456413,100,0,0,1,2
3456323,3456412,89,0,0,1,1
3456413,3456444,31,1,0,0,1
3456414,3456437,23,1,0,0,2
3456438,3457826,1388,0,0,1,2
3456445,3457826,1381,0,0,1,1
3457827,3457924,97,1,0,0,1
3457827,3457932,105,1,0,0,2
3457925,3458034,109,0,0,1,1
3457933,3458033,100,0,0,1,2
3458034,3458056,22,1,0,0,2
3458035,3458063,28,1,0,0,1
3458057,3458567,510,0,0,1,2
3458064,3458565,501,0,0,1,1
3458566,3458580,14,1,0,0,1
3458568,3458577,9,1,0,0,2
3458578,3459343,765,0,0,1,2
3458581,3459343,762,0,0,1,1
3459344,3459362,18,1,0,0,2
3459344,3459376,32,1,0,0,1
3459363,3459815,452,0,0,1,2
3459377,3459815,438,0,0,1,1
3459816,3459902,86,1,0,0,1
3459816,3459904,88,1,0,0,2
3459903,3459983,80,0,0,1,1
3459905,3459984,79,0,0,1,2
3459984,3460010,26,1,0,0,1
3459985,3460009,24,1,0,0,2
3460010,3460198,188,0,0,1,2
3460011,3460194,183,0,0,1,1
3460195,3460205,10,1,0,0,1
3460199,3460210,11,1,0,0,2
3460206,3460467,261,0,0,1,1
3460211,3461498,1287,0,0,1,2
3460468,3460478,10,1,0,0,1
3460479,3461504,1025,0,0,1,1
3461499,3461740,241,1,0,0,2
3461505,3461688,183,1,0,0,1
3461520,3461662,142,0,1,0,2
3461527,3461641,114,0,1,0,1
3461689,3462041,352,0,0,1,1
3461741,3462042,301,0,0,1,2
3462042,3462158,116,1,0,0,1
3462043,3462149,106,1,0,0,2
3462150,3462247,97,0,0,1,2
3462159,3462246,87,0,0,1,1
3462247,3462321,74,1,0,0,1
3462248,3462321,73,1,0,0,2
3462322,3462493,171,0,0,1,1
3462322,3462496,174,0,0,1,2
3462494,3462524,30,1,0,0,1
3462497,3462523,26,1,0,0,2
3462524,3463869,1345,0,0,1,2
3462525,3463302,777,0,0,1,1
3463303,3463318,15,1,0,0,1
3463319,3463867,548,0,0,1,1
3463868,3463903,35,1,0,0,1
3463870,3463907,37,1,0,0,2
3463904,3464006,102,0,0,1,1
3463908,3464007,99,0,0,1,2
3464007,3464083,76,1,0,0,1
3464008,3464083,75,1,0,0,2
3464084,3464300,216,0,0,1,1
3464084,3464301,217,0,0,1,2
3464301,3464355,54,1,0,0,1
3464302,3464366,64,1,0,0,2
3464356,3464472,116,0,0,1,1
3464367,3464472,105,0,0,1,2
3464473,3464491,18,1,0,0,2
3464473,3464494,21,1,0,0,1
3464492,3464690,198,0,0,1,2
3464495,3464688,193,0,0,1,1
3464689,3464699,10,1,0,0,1
3464691,3464699,8,1,0,0,2
3464700,3465490,790,0,0,1,1
3464700,3465491,791,0,0,1,2
3465491,3465518,27,1,0,0,1
3465492,3465511,19,1,0,0,2
3465512,3466151,639,0,0,1,2
3465519,3466151,632,0,0,1,1
3466152,3466216,64,1,0,0,2
3466152,3466217,65,1,0,0,1
3466217,3466448,231,0,0,1,2
3466218,3466447,229,0,0,1,1
3466448,3466529,81,1,0,0,1
3466449,3466518,69,1,0,0,2
3466519,3466645,126,0,0,1,2
3466530,3466645,115,0,0,1,1
3466646,3466675,29,1,0,0,1
3466646,3466676,30,1,0,0,2
3466676,3467170,494,0,0,1,1
3466677,3467170,493,0,0,1,2
3467171,3467181,10,1,0,0,2
3467171,3467186,15,1,0,0,1
3467182,3467893,711,0,0,1,2
3467187,3468537,1350,0,0,1,1
3467894,3467898,4,1,0,0,2
3467899,3468538,639,0,0,1,2
3468538,3468642,104,1,0,0,1
3468539,3468635,96,1,0,0,2
3468636,3468729,93,0,0,1,2
3468643,3468729,86,0,0,1,1
3468730,3468752,22,1,0,0,2
3468730,3468764,34,1,0,0,1
3468753,3469121,368,0,0,1,2
3468765,3469117,352,0,0,1,1
3469118,3469139,21,1,0,0,1
3469122,3469138,16,1,0,0,2
3469139,3470681,1542,0,0,1,2
3469140,3470682,1542,0,0,1,1
3470682,3470739,57,1,0,0,2
3470683,3470739,56,1,0,0,1
3470740,3470832,92,0,0,1,1
3470740,3470832,92,0,0,1,2
3470833,3470905,72,1,0,0,2
3470833,3470910,77,1,0,0,1
3470906,3471012,106,0,0,1,2
3470911,3471012,101,0,0,1,1
3471013,3471033,20,1,0,0,2
3471013,3471044,31,1,0,0,1
3471034,3472935,1901,0,0,1,2
3471045,3472936,1891,0,0,1,1
3472936,3473082,146,1,0,0,2
3472937,3473085,148,1,0,0,1
3473083,3473182,99,0,0,1,2
3473086,3473176,90,0,0,1,1
3473177,3473635,458,1,0,0,1
3473183,3473506,323,1,0,0,2
3473212,3473569,357,0,1,0,1
3473219,3473480,261,0,1,0,2
3473507,3473611,104,0,0,1,2
3473612,3473634,22,1,0,0,2
3473635,3475003,1368,0,0,1,2
3473636,3475003,1367,0,0,1,1
3475004,3475043,39,1,0,0,1
3475004,3475043,39,1,0,0,2
3475044,3475168,124,0,0,1,1
3475044,3475169,125,0,0,1,2
3475169,3475256,87,1,0,0,1
3475170,3475241,71,1,0,0,2
3475242,3475403,161,0,0,1,2
3475257,3475403,146,0,0,1,1
3475404,3475481,77,1,0,0,2
3475404,3475482,78,1,0,0,1
3475482,3475598,116,0,0,1,2
3475483,3475597,114,0,0,1,1
3475598,3475616,18,1,0,0,1
3475599,3475615,16,1,0,0,2
3475616,3476000,384,0,0,1,2
3475617,3475994,377,0,0,1,1
3475995,3476014,19,1,0,0,1
3476001,3476014,13,1,0,0,2
3476015,3477466,1451,0,0,1,1
3476015,3477467,1452,0,0,1,2
3477467,3477529,62,1,0,0,1
3477468,3477529,61,1,0,0,2
3477530,3477675,145,0,0,1,2
3477530,3477676,146,0,0,1,1
3477676,3477701,25,1,0,0,2
3477677,3477703,26,1,0,0,1
3477702,3477945,243,0,0,1,2
3477704,3477939,235,0,0,1,1
3477940,3477966,26,1,0,0,1
3477946,3477956,10,1,0,0,2
3477957,3478233,276,0,0,1,2
3477967,3478234,267,0,0,1,1
3478234,3478255,21,1,0,0,2
3478235,3478248,13,1,0,0,1
3478249,3478903,654,0,0,1,1
3478256,3479347,1091,0,0,1,2
3478904,3478909,5,1,0,0,1
3478910,3479347,437,0,0,1,1
3479348,3479422,74,1,0,0,2
3479348,3479433,85,1,0,0,1
3479423,3479510,87,0,0,1,2
3479434,3479508,74,0,0,1,1
3479509,3479541,32,1,0,0,1
3479511,3479553,42,1,0,0,2
3479542,3479769,227,0,0,1,1
3479554,3479772,218,0,0,1,2
3479770,3479787,17,1,0,0,1
3479773,3479788,15,1,0,0,2
3479788,3480021,233,0,0,1,1
3479789,3480022,233,0,0,1,2
3480022,3480050,28,1,0,0,1
3480023,3480041,18,1,0,0,2
3480042,3480254,212,0,0,1,2
3480051,3480241,190,0,0,1,1
3480242,3480259,17,1,0,0,1
3480255,3480259,4,1,0,0,2
3480260,3481026,766,0,0,1,1
3480260,3481026,766,0,0,1,2
3481027,3481083,56,1,0,0,1
3481027,3481090,63,1,0,0,2
3481084,3481244,160,0,0,1,1
3481091,3481244,153,0,0,1,2
3481245,3481314,69,1,0,0,1
3481245,3481327,82,1,0,0,2
3481315,3483103,1788,0,0,1,1
3481328,3483103,1775,0,0,1,2
3483104,3483136,32,1,0,0,2
3483104,3483141,37,1,0,0,1
3483137,3483311,174,0,0,1,2
3483142,3483311,169,0,0,1,1
3483312,3483421,109,1,0,0,2
3483312,3483432,120,1,0,0,1
3483422,3483557,135,0,0,1,2
3483433,3483557,124,0,0,1,1
3483558,3483611,53,1,0,0,1
3483558,3483614,56,1,0,0,2
3483612,3483784,172,0,0,1,1
3483615,3485856,2241,0,0,1,2
3483785,3483797,12,1,0,0,1
3483798,3484061,263,0,0,1,1
3484062,3484072,10,1,0,0,1
3484073,3485857,1784,0,0,1,1
3485857,3486011,154,1,0,0,2
3485858,3485990,132,1,0,0,1
3485991,3486069,78,0,0,1,1
3486012,3486070,58,0,0,1,2
3486070,3486116,46,1,0,0,1
3486071,3486136,65,1,0,0,2
3486117,3486213,96,0,0,1,1
3486137,3486220,83,0,0,1,2
3486214,3486235,21,1,0,0,1
3486221,3486282,61,1,0,0,2
3486236,3486806,570,0,0,1,1
3486283,3486713,430,0,0,1,2
3486714,3486743,29,1,0,0,2
3486744,3486816,72,0,0,1,2
3486807,3486852,45,1,0,0,1
3486817,3486837,20,1,0,0,2
3486838,3486874,36,0,0,1,2
3486853,3487240,387,0,0,1,1
3486875,3486984,109,1,0,0,2
3486985,3487024,39,0,0,1,2
3487025,3487120,95,1,0,0,2
3487121,3487325,204,0,0,1,2
3487241,3487267,26,1,0,0,1
3487268,3487858,590,0,0,1,1
3487326,3487468,142,1,0,0,2
3487469,3487576,107,0,0,1,2
3487577,3487603,26,1,0,0,2
3487604,3487683,79,0,0,1,2
3487684,3487896,212,1,0,0,2
3487859,3487894,35,1,0,0,1
3487895,3488296,401,0,0,1,1
3487897,3488296,399,0,0,1,2
3488297,3488394,97,1,0,0,1
3488297,3488394,97,1,0,0,2
3488395,3488485,90,0,0,1,1
3488395,3488485,90,0,0,1,2
3488486,3488532,46,1,0,0,1
3488486,3488542,56,1,0,0,2
3488533,3488773,240,0,0,1,1
3488543,3488777,234,0,0,1,2
3488774,3488791,17,1,0,0,1
3488778,3488791,13,1,0,0,2
3488792,3489245,453,0,0,1,1
3488792,3489246,454,0,0,1,2
3489246,3489272,26,1,0,0,1
3489247,3489260,13,1,0,0,2
3489261,3489540,279,0,0,1,2
3489273,3489534,261,0,0,1,1
3489535,3489551,16,1,0,0,1
3489541,3489553,12,1,0,0,2
3489552,3490650,1098,0,0,1,1
3489554,3490652,1098,0,0,1,2
3490651,3490966,315,1,0,0,1
3490653,3490917,264,1,0,0,2
3490686,3490879,193,0,1,0,2
3490687,3490906,219,0,1,0,1
3490918,3490996,78,0,0,1,2
3490967,3490996,29,0,0,1,1
3490997,3491015,18,1,0,0,1
3490997,3491017,20,1,0,0,2
3491016,3491353,337,0,0,1,1
3491018,3491356,338,0,0,1,2
3491354,3491378,24,1,0,0,1
3491357,3491376,19,1,0,0,2
3491377,3492370,993,0,0,1,2
3491379,3493552,2173,0,0,1,1
3492371,3492375,4,1,0,0,2
3492376,3493552,1176,0,0,1,2
3493553,3493604,51,1,0,0,1
3493553,3493605,52,1,0,0,2
3493605,3493703,98,0,0,1,1
3493606,3493703,97,0,0,1,2
3493704,3493742,38,1,0,0,2
3493704,3493752,48,1,0,0,1
3493743,3493928,185,0,0,1,2
3493753,3494288,535,0,0,1,1
3493929,3493938,9,1,0,0,2
3493939,3494286,347,0,0,1,2
3494287,3494303,16,1,0,0,2
3494289,3494298,9,1,0,0,1
3494299,3495683,1384,0,0,1,1
3494304,3495683,1379,0,0,1,2
3495684,3495806,122,1,0,0,2
3495684,3495807,123,1,0,0,1
3495807,3495888,81,0,0,1,2
3495808,3495887,79,0,0,1,1
3495888,3495913,25,1,0,0,1
3495889,3495915,26,1,0,0,2
3495914,3496134,220,0,0,1,1
3495916,3496134,218,0,0,1,2
3496135,3496144,9,1,0,0,2
3496135,3496155,20,1,0,0,1
3496145,3497814,1669,0,0,1,2
3496156,3496444,288,0,0,1,1
3496445,3496453,8,1,0,0,1
3496454,3497814,1360,0,0,1,1
3497815,3497932,117,1,0,0,1
3497815,3497935,120,1,0,0,2
3497933,3497983,50,0,0,1,1
3497936,3497982,46,0,0,1,2
3497983,3498030,47,1,0,0,2
3497984,3498032,48,1,0,0,1
3498031,3498084,53,0,0,1,2
3498033,3498085,52,0,0,1,1
3498085,3498119,34,1,0,0,2
3498086,3498121,35,1,0,0,1
3498120,3498294,174,0,0,1,2
3498122,3498291,169,0,0,1,1
3498292,3498309,17,1,0,0,1
3498295,3498314,19,1,0,0,2
3498310,3499436,1126,0,0,1,1
3498315,3499443,1128,0,0,1,2
3499437,3499452,15,1,0,0,1
3499444,3499450,6,1,0,0,2
3499451,3499903,452,0,0,1,2
3499453,3499901,448,0,0,1,1
3499902,3499980,78,1,0,0,1
3499904,3499979,75,1,0,0,2
3499980,3500129,149,0,0,1,2
3499981,3500129,148,0,0,1,1
3500130,3500149,19,1,0,0,1
3500130,3500159,29,1,0,0,2
3500150,3500363,213,0,0,1,1
3500160,3500363,203,0,0,1,2
3500364,3500373,9,1,0,0,2
3500364,3500379,15,1,0,0,1
3500374,3501086,712,0,0,1,2
3500380,3501090,710,0,0,1,1
3501087,3501103,16,1,0,0,2
3501091,3501101,10,1,0,0,1
3501102,3502141,1039,0,0,1,1
3501104,3502140,1036,0,0,1,2
3502141,3502186,45,1,0,0,2
3502142,3502189,47,1,0,0,1
3502187,3502308,121,0,0,1,2
3502190,3502308,118,0,0,1,1
3502309,3502404,95,1,0,0,2
3502309,3502405,96,1,0,0,1
3502405,3502516,111,0,0,1,2
3502406,3502515,109,0,0,1,1
3502516,3502546,30,1,0,0,1
3502517,3502546,29,1,0,0,2
3502547,3502851,304,0,0,1,2
3502547,3502855,308,0,0,1,1
3502852,3502874,22,1,0,0,2
3502856,3502881,25,1,0,0,1
3502875,3504504,1629,0,0,1,2
3502882,3504348,1466,0,0,1,1
3504349,3504360,11,1,0,0,1
3504361,3504503,142,0,0,1,1
3504504,3504754,250,1,0,0,1
3504505,3504783,278,1,0,0,2
3504536,3504693,157,0,1,0,2
3504539,3504690,151,0,1,0,1
3504755,3504836,81,0,0,1,1
3504784,3504835,51,0,0,1,2
3504836,3504885,49,1,0,0,2
3504837,3504900,63,1,0,0,1
3504886,3504988,102,0,0,1,2
3504901,3504988,87,0,0,1,1
3504989,3505006,17,1,0,0,2
3504989,3505009,20,1,0,0,1
3505007,3505209,202,0,0,1,2
3505010,3505204,194,0,0,1,1
3505205,3505224,19,1,0,0,1
3505210,3505230,20,1,0,0,2
3505225,3505283,58,0,0,1,1
3505231,3505605,374,0,0,1,2
3505284,3505294,10,1,0,0,1
3505295,3506785,1490,0,0,1,1
3505606,3505618,12,1,0,0,2
3505619,3506981,1362,0,0,1,2
3506786,3506801,15,1,0,0,1
3506802,3507350,548,0,0,1,1
3506982,3506986,4,1,0,0,2
3506987,3507352,365,0,0,1,2
3507351,3507450,99,1,0,0,1
3507353,3507451,98,1,0,0,2
3507451,3507663,212,0,0,1,1
3507452,3507664,212,0,0,1,2
3507664,3507734,70,1,0,0,1
3507665,3507736,71,1,0,0,2
3507735,3507773,38,0,0,1,1
3507737,3507787,50,0,0,1,2
3507774,3508653,879,1,0,0,1
3507788,3508219,431,1,0,0,2
3507801,3508209,408,0,1,0,2
3507802,3508577,775,0,1,0,1
3508220,3508250,30,0,0,1,2
3508251,3508522,271,1,0,0,2
3508267,3508506,239,0,1,0,2
3508523,3508605,82,0,0,1,2
3508606,3508622,16,1,0,0,2
3508623,3510618,1995,0,0,1,2
3508654,3508919,265,0,0,1,1
3508920,3508925,5,1,0,0,1
3508926,3510618,1692,0,0,1,1
3510619,3510664,45,1,0,0,2
3510619,3510666,47,1,0,0,1
3510665,3510884,219,0,0,1,2
3510667,3510884,217,0,0,1,1
3510885,3510908,23,1,0,0,1
3510885,3510909,24,1,0,0,2
3510909,3513269,2360,0,0,1,1
3510910,3513269,2359,0,0,1,2
3513270,3513331,61,1,0,0,1
3513270,3513331,61,1,0,0,2
3513332,3514247,915,0,0,1,1
3513332,3514248,916,0,0,1,2
3514248,3514308,60,1,0,0,1
3514249,3514286,37,1,0,0,2
3514287,3514425,138,0,0,1,2
3514309,3514427,118,0,0,1,1
3514426,3514449,23,1,0,0,2
3514428,3514457,29,1,0,0,1
3514450,3514715,265,0,0,1,2
3514458,3514726,268,0,0,1,1
3514716,3514731,15,1,0,0,2
3514727,3514741,14,1,0,0,1
3514732,3516891,2159,0,0,1,2
3514742,3516890,2148,0,0,1,1
3516891,3516945,54,1,0,0,1
3516892,3516938,46,1,0,0,2
3516939,3517073,134,0,0,1,2
3516946,3517074,128,0,0,1,1
3517074,3517096,22,1,0,0,2
3517075,3517104,29,1,0,0,1
3517097,3517213,116,0,0,1,2
3517105,3517215,110,0,0,1,1
3517214,3517454,240,1,0,0,2
3517216,3517484,268,1,0,0,1
3517233,3517423,190,0,1,0,2
3517235,3517429,194,0,1,0,1
3517455,3517642,187,0,0,1,2
3517485,3517640,155,0,0,1,1
3517641,3517662,21,1,0,0,1
3517643,3517660,17,1,0,0,2
3517661,3520655,2994,0,0,1,2
3517663,3520656,2993,0,0,1,1
3520656,3520712,56,1,0,0,2
3520657,3520710,53,1,0,0,1
3520711,3520888,177,0,0,1,1
3520713,3520889,176,0,0,1,2
3520889,3520960,71,1,0,0,1
3520890,3520958,68,1,0,0,2
3520959,3521023,64,0,0,1,2
3520961,3521023,62,0,0,1,1
3521024,3521057,33,1,0,0,2
3521024,3521068,44,1,0,0,1
3521058,3521151,93,0,0,1,2
3521069,3521152,83,0,0,1,1
3521152,3521176,24,1,0,0,2
3521153,3521186,33,1,0,0,1
3521177,3523689,2512,0,0,1,2
3521187,3523688,2501,0,0,1,1
3523689,3523736,47,1,0,0,1
3523690,3523742,52,1,0,0,2
3523737,3523980,243,0,0,1,1
3523743,3523985,242,0,0,1,2
3523981,3523998,17,1,0,0,1
3523986,3523996,10,1,0,0,2
3523997,3525981,1984,0,0,1,2
3523999,3525983,1984,0,0,1,1
3525982,3526194,212,1,0,0,2
3525984,3526216,232,1,0,0,1
3526002,3526158,156,0,1,0,2
3526004,3526159,155,0,1,0,1
3526195,3526216,21,0,0,1,2
3526217,3526225,8,1,0,0,2
3526217,3526706,489,0,0,1,1
3526226,3526706,480,0,0,1,2
3526707,3526750,43,1,0,0,2
3526707,3526756,49,1,0,0,1
3526751,3527348,597,0,0,1,2
3526757,3527349,592,0,0,1,1
3527349,3527391,42,1,0,0,2
3527350,3527392,42,1,0,0,1
3527392,3527518,126,0,0,1,2
3527393,3527517,124,0,0,1,1
3527518,3527546,28,1,0,0,1
3527519,3527546,27,1,0,0,2
3527547,3527767,220,0,0,1,1
3527547,3527775,228,0,0,1,2
3527768,3527792,24,1,0,0,1
3527776,3527785,9,1,0,0,2
3527786,3528125,339,0,0,1,2
3527793,3528120,327,0,0,1,1
3528121,3528143,22,1,0,0,1
3528126,3528139,13,1,0,0,2
3528140,3529266,1126,0,0,1,2
3528144,3529268,1124,0,0,1,1
3529267,3529281,14,1,0,0,2
3529269,3529287,18,1,0,0,1
3529282,3530012,730,0,0,1,2
3529288,3530012,724,0,0,1,1
3530013,3530075,62,1,0,0,1
3530013,3530082,69,1,0,0,2
3530076,3530183,107,0,0,1,1
3530083,3530183,100,0,0,1,2
3530184,3530205,21,1,0,0,2
3530184,3530216,32,1,0,0,1
3530206,3530357,151,0,0,1,2
3530217,3530356,139,0,0,1,1
3530357,3530384,27,1,0,0,1
3530358,3530371,13,1,0,0,2
3530372,3532350,1978,0,0,1,2
3530385,3530897,512,0,0,1,1
3530898,3530909,11,1,0,0,1
3530910,3532351,1441,0,0,1,1
3532351,3532412,61,1,0,0,2
3532352,3532412,60,1,0,0,1
3532413,3532491,78,0,0,1,2
3532413,3532493,80,0,0,1,1
3532492,3532655,163,1,0,0,2
3532494,3532657,163,1,0,0,1
3532513,3532616,103,0,1,0,1
3532514,3532616,102,0,1,0,2
3532656,3534005,1349,0,0,1,2
3532658,3534004,1346,0,0,1,1
3534005,3534077,72,1,0,0,1
3534006,3534076,70,1,0,0,2
3534077,3534154,77,0,0,1,2
3534078,3534155,77,0,0,1,1
3534155,3534174,19,1,0,0,2
3534156,3534188,32,1,0,0,1
3534175,3534293,118,0,0,1,2
3534189,3534295,106,0,0,1,1
3534294,3534315,21,1,0,0,2
3534296,3534325,29,1,0,0,1
3534316,3536286,1970,0,0,1,2
3534326,3536285,1959,0,0,1,1
3536286,3536329,43,1,0,0,1
3536287,3536330,43,1,0,0,2
3536330,3536467,137,0,0,1,1
3536331,3536466,135,0,0,1,2
3536467,3536488,21,1,0,0,2
3536468,3536489,21,1,0,0,1
3536489,3536677,188,0,0,1,2
3536490,3538579,2089,0,0,1,1
3536678,3536688,10,1,0,0,2
3536689,3538578,1889,0,0,1,2
3538579,3538864,285,1,0,0,2
3538580,3538873,293,1,0,0,1
3538603,3538797,194,0,1,0,2
3538605,3538804,199,0,1,0,1
3538865,3539278,413,0,0,1,2
3538874,3539278,404,0,0,1,1
3539279,3539317,38,1,0,0,2
3539279,3539325,46,1,0,0,1
3539318,3539931,613,0,0,1,2
3539326,3539929,603,0,0,1,1
3539930,3540012,82,1,0,0,1
3539932,3540001,69,1,0,0,2
3540002,3540111,109,0,0,1,2
3540013,3540111,98,0,0,1,1
3540112,3540151,39,1,0,0,1
3540112,3540152,40,1,0,0,2
3540152,3540243,91,0,0,1,1
3540153,3540244,91,0,0,1,2
3540244,3540274,30,1,0,0,1
3540245,3540269,24,1,0,0,2
3540270,3540870,600,0,0,1,2
3540275,3540871,596,0,0,1,1
3540871,3540891,20,1,0,0,2
3540872,3540892,20,1,0,0,1
3540892,3543559,2667,0,0,1,2
3540893,3543559,2666,0,0,1,1
3543560,3543607,47,1,0,0,1
3543560,3543611,51,1,0,0,2
3543608,3543745,137,0,0,1,1
3543612,3543743,131,0,0,1,2
3543744,3543765,21,1,0,0,2
3543746,3543766,20,1,0,0,1
3543766,3545385,1619,0,0,1,2
3543767,3545385,1618,0,0,1,1
3545386,3545429,43,1,0,0,2
3545386,3545430,44,1,0,0,1
3545430,3545840,410,0,0,1,2
3545431,3545652,221,0,0,1,1
3545653,3545662,9,1,0,0,1
3545663,3545838,175,0,0,1,1
3545839,3546201,362,1,0,0,1
3545841,3546137,296,1,0,0,2
3545866,3546162,296,0,1,0,1
3545867,3546118,251,0,1,0,2
3546138,3547678,1540,0,0,1,2
3546202,3547679,1477,0,0,1,1
3547679,3547748,69,1,0,0,2
3547680,3547747,67,1,0,0,1
3547748,3547853,105,0,0,1,1
3547749,3547855,106,0,0,1,2
3547854,3547887,33,1,0,0,1
3547856,3547890,34,1,0,0,2
3547888,3548091,203,0,0,1,1
3547891,3548091,200,0,0,1,2
3548092,3548102,10,1,0,0,2
3548092,3548105,13,1,0,0,1
3548103,3549854,1751,0,0,1,2
3548106,3549853,1747,0,0,1,1
3549854,3549909,55,1,0,0,1
3549855,3549898,43,1,0,0,2
3549899,3550262,363,0,0,1,2
3549910,3550262,352,0,0,1,1
3550263,3550292,29,1,0,0,2
3550263,3550294,31,1,0,0,1
3550293,3552175,1882,0,0,1,2
3550295,3552172,1877,0,0,1,1
3552173,3552412,239,1,0,0,1
3552176,3552383,207,1,0,0,2
3552197,3552352,155,0,1,0,2
3552199,3552350,151,0,1,0,1
3552384,3552927,543,0,0,1,2
3552413,3552927,514,0,0,1,1
3552928,3552986,58,1,0,0,2
3552928,3552987,59,1,0,0,1
3552987,3553514,527,0,0,1,2
3552988,3553516,528,0,0,1,1
3553515,3553560,45,1,0,0,2
3553517,3553564,47,1,0,0,1
3553561,3553753,192,0,0,1,2
3553565,3553753,188,0,0,1,1
3553754,3553768,14,1,0,0,2
3553754,3553770,16,1,0,0,1
3553769,3553947,178,0,0,1,2
3553771,3553946,175,0,0,1,1
3553947,3553976,29,1,0,0,1
3553948,3553975,27,1,0,0,2
3553976,3555353,1377,0,0,1,2
3553977,3555354,1377,0,0,1,1
3555354,3555405,51,1,0,0,2
3555355,3555408,53,1,0,0,1
3555406,3555617,211,0,0,1,2
3555409,3555616,207,0,0,1,1
3555617,3555647,30,1,0,0,1
3555618,3555658,40,1,0,0,2
3555648,3555866,218,0,0,1,1
3555659,3555867,208,0,0,1,2
3555867,3555897,30,1,0,0,1
3555868,3555896,28,1,0,0,2
3555897,3556104,207,0,0,1,2
3555898,3556100,202,0,0,1,1
3556101,3556126,25,1,0,0,1
3556105,3556114,9,1,0,0,2
3556115,3557499,1384,0,0,1,2
3556127,3557501,1374,0,0,1,1
3557500,3557749,249,1,0,0,2
3557502,3557798,296,1,0,0,1
3557518,3557740,222,0,1,0,1
3557519,3557719,200,0,1,0,2
3557750,3558478,728,0,0,1,2
3557799,3558478,679,0,0,1,1
3558479,3558504,25,1,0,0,1
3558479,3558506,27,1,0,0,2
3558505,3558643,138,0,0,1,1
3558507,3558642,135,0,0,1,2
3558643,3558711,68,1,0,0,2
3558644,3558720,76,1,0,0,1
3558712,3558792,80,0,0,1,2
3558721,3558792,71,0,0,1,1
3558793,3558814,21,1,0,0,2
3558793,3558826,33,1,0,0,1
3558815,3558936,121,0,0,1,2
3558827,3558935,108,0,0,1,1
3558936,3558962,26,1,0,0,1
3558937,3558961,24,1,0,0,2
3558962,3561235,2273,0,0,1,2
3558963,3561234,2271,0,0,1,1
3561235,3561283,48,1,0,0,1
3561236,3561282,46,1,0,0,2
3561283,3561443,160,0,0,1,2
3561284,3561444,160,0,0,1,1
3561444,3561463,19,1,0,0,2
3561445,3561471,26,1,0,0,1
3561464,3563325,1861,0,0,1,2
3561472,3563320,1848,0,0,1,1
3563321,3563332,11,1,0,0,1
3563326,3563331,5,1,0,0,2
3563332,3563484,152,0,0,1,2
3563333,3563484,151,0,0,1,1
3563485,3563819,334,1,0,0,2
3563485,3563848,363,1,0,0,1
3563510,3563780,270,0,1,0,2
3563513,3563782,269,0,1,0,1
3563820,3564034,214,0,0,1,2
3563849,3564035,186,0,0,1,1
3564035,3564059,24,1,0,0,2
3564036,3564077,41,1,0,0,1
3564060,3564520,460,0,0,1,2
3564078,3564520,442,0,0,1,1
3564521,3564556,35,1,0,0,2
3564521,3564557,36,1,0,0,1
3564557,3565155,598,0,0,1,2
3564558,3565154,596,0,0,1,1
3565155,3565220,65,1,0,0,1
3565156,3565207,51,1,0,0,2
3565208,3565922,714,0,0,1,2
3565221,3565937,716,0,0,1,1
3565923,3565949,26,1,0,0,2
3565938,3565948,10,1,0,0,1
3565949,3566614,665,0,0,1,1
3565950,3566614,664,0,0,1,2
3566615,3566630,15,1,0,0,1
3566615,3566630,15,1,0,0,2
3566631,3568207,1576,0,0,1,1
3566631,3568207,1576,0,0,1,2
3568208,3568251,43,1,0,0,2
3568208,3568253,45,1,0,0,1
3568252,3568375,123,0,0,1,2
3568254,3568372,118,0,0,1,1
3568373,3568394,21,1,0,0,1
3568376,3568393,17,1,0,0,2
3568394,3568620,226,0,0,1,2
3568395,3568614,219,0,0,1,1
3568615,3568633,18,1,0,0,1
3568621,3568629,8,1,0,0,2
3568630,3571093,2463,0,0,1,2
3568634,3571093,2459,0,0,1,1
3571094,3571147,53,1,0,0,2
3571094,3571151,57,1,0,0,1
3571148,3571515,367,0,0,1,2
3571152,3571517,365,0,0,1,1
3571516,3571747,231,1,0,0,2
3571518,3571760,242,1,0,0,1
3571536,3571699,163,0,1,0,2
3571538,3571704,166,0,1,0,1
3571748,3572000,252,0,0,1,2
3571761,3572000,239,0,0,1,1
3572001,3572036,35,1,0,0,2
3572001,3572045,44,1,0,0,1
3572037,3572225,188,0,0,1,2
3572046,3572226,180,0,0,1,1
3572226,3572308,82,1,0,0,2
3572227,3572306,79,1,0,0,1
3572307,3572395,88,0,0,1,1
3572309,3572394,85,0,0,1,2
3572395,3572428,33,1,0,0,2
3572396,3572432,36,1,0,0,1
3572429,3572730,301,0,0,1,2
3572433,3572731,298,0,0,1,1
3572731,3572756,25,1,0,0,2
3572732,3572758,26,1,0,0,1
3572757,3573020,263,0,0,1,2
3572759,3573019,260,0,0,1,1
3573020,3573050,30,1,0,0,1
3573021,3573049,28,1,0,0,2
3573050,3573292,242,0,0,1,2
3573051,3573287,236,0,0,1,1
3573288,3573319,31,1,0,0,1
3573293,3573306,13,1,0,0,2
3573307,3574317,1010,0,0,1,2
3573320,3573558,238,0,0,1,1
3573559,3573563,4,1,0,0,1
3573564,3574316,752,0,0,1,1
3574317,3574336,19,1,0,0,1
3574318,3574338,20,1,0,0,2
3574337,3574910,573,0,0,1,1
3574339,3574910,571,0,0,1,2
3574911,3574985,74,1,0,0,1
3574911,3574985,74,1,0,0,2
3574986,3575107,121,0,0,1,1
3574986,3575107,121,0,0,1,2
3575108,3575130,22,1,0,0,2
3575108,3575139,31,1,0,0,1
3575131,3575885,754,0,0,1,2
3575140,3575886,746,0,0,1,1
3575886,3575914,28,1,0,0,2
3575887,3575917,30,1,0,0,1
3575915,3576950,1035,0,0,1,2
3575918,3576954,1036,0,0,1,1
3576951,3576972,21,1,0,0,2
3576955,3576978,23,1,0,0,1
3576973,3578299,1326,0,0,1,2
3576979,3578299,1320,0,0,1,1
3578300,3578335,35,1,0,0,2
3578300,3578343,43,1,0,0,1
3578336,3578526,190,0,0,1,2
3578344,3578526,182,0,0,1,1
3578527,3578714,187,1,0,0,1
3578527,3578734,207,1,0,0,2
3578600,3578678,78,0,1,0,2
3578604,3578662,58,0,1,0,1
3578715,3578826,111,0,0,1,1
3578735,3578779,44,0,0,1,2
3578780,3578797,17,1,0,0,2
3578798,3578824,26,0,0,1,2
3578825,3578845,20,1,0,0,2
3578827,3578854,27,1,0,0,1
3578846,3581851,3005,0,0,1,2
3578855,3581851,2996,0,0,1,1
3581852,3581920,68,1,0,0,2
3581852,3581926,74,1,0,0,1
3581921,3582094,173,0,0,1,2
3581927,3582096,169,0,0,1,1
3582095,3582128,33,1,0,0,2
3582097,3582120,23,1,0,0,1
3582121,3583735,1614,0,0,1,1
3582129,3583735,1606,0,0,1,2
3583736,3583767,31,1,0,0,1
3583736,3583767,31,1,0,0,2
3583768,3584122,354,0,0,1,2
3583768,3584124,356,0,0,1,1
3584123,3584335,212,1,0,0,2
3584125,3584365,240,1,0,0,1
3584146,3584300,154,0,1,0,2
3584148,3584301,153,0,1,0,1
3584336,3584365,29,0,0,1,2
3584366,3584382,16,1,0,0,2
3584366,3584514,148,0,0,1,1
3584383,3584506,123,0,0,1,2
3584507,3584742,235,1,0,0,2
3584515,3584732,217,1,0,0,1
3584537,3584674,137,0,1,0,2
3584538,3584683,145,0,1,0,1
3584733,3585369,636,0,0,1,1
3584743,3585370,627,0,0,1,2
3585370,3585425,55,1,0,0,1
3585371,3585417,46,1,0,0,2
3585418,3585734,316,0,0,1,2
3585426,3585734,308,0,0,1,1
3585735,3585786,51,1,0,0,2
3585735,3585790,55,1,0,0,1
3585787,3585848,61,0,0,1,2
3585791,3585848,57,0,0,1,1
3585849,3585913,64,1,0,0,1
3585849,3585918,69,1,0,0,2
3585914,3586019,105,0,0,1,1
3585919,3586019,100,0,0,1,2
3586020,3586054,34,1,0,0,2
3586020,3586063,43,1,0,0,1
3586055,3586541,486,0,0,1,2
3586064,3586315,251,0,0,1,1
3586316,3586324,8,1,0,0,1
3586325,3586539,214,0,0,1,1
3586540,3586559,19,1,0,0,1
3586542,3586553,11,1,0,0,2
3586554,3588308,1754,0,0,1,2
3586560,3588309,1749,0,0,1,1
3588309,3588374,65,1,0,0,2
3588310,3588358,48,1,0,0,1
3588359,3590551,2192,0,0,1,1
3588375,3590549,2174,0,0,1,2
3590550,3590743,193,1,0,0,2
3590552,3590747,195,1,0,0,1
3590570,3590698,128,0,1,0,2
3590573,3590690,117,0,1,0,1
3590744,3590773,29,0,0,1,2
3590748,3591533,785,0,0,1,1
3590774,3590793,19,1,0,0,2
3590794,3591533,739,0,0,1,2
3591534,3591602,68,1,0,0,1
3591534,3591604,70,1,0,0,2
3591603,3591716,113,0,0,1,1
3591605,3591717,112,0,0,1,2
3591717,3591739,22,1,0,0,1
3591718,3591750,32,1,0,0,2
3591740,3593914,2174,0,0,1,1
3591751,3593914,2163,0,0,1,2
3593915,3593967,52,1,0,0,1
3593915,3593968,53,1,0,0,2
3593968,3594172,204,0,0,1,1
3593969,3594173,204,0,0,1,2
3594173,3594199,26,1,0,0,1
3594174,3594197,23,1,0,0,2
3594198,3594377,179,0,0,1,2
3594200,3594372,172,0,0,1,1
3594373,3594398,25,1,0,0,1
3594378,3594395,17,1,0,0,2
3594396,3596094,1698,0,0,1,2
3594399,3596094,1695,0,0,1,1
3596095,3596342,247,1,0,0,2
3596095,3596352,257,1,0,0,1
3596123,3596299,176,0,1,0,2
3596124,3596308,184,0,1,0,1
3596343,3597288,945,0,0,1,2
3596353,3597288,935,0,0,1,1
3597289,3597358,69,1,0,0,1
3597289,3597359,70,1,0,0,2
3597359,3597462,103,0,0,1,1
3597360,3597463,103,0,0,1,2
3597463,3597505,42,1,0,0,1
3597464,3597504,40,1,0,0,2
3597505,3597818,313,0,0,1,2
3597506,3597823,317,0,0,1,1
3597819,3597834,15,1,0,0,2
3597824,3597833,9,1,0,0,1
3597834,3599504,1670,0,0,1,1
3597835,3599825,1990,0,0,1,2
3599505,3599522,17,1,0,0,1
3599523,3599825,302,0,0,1,1
3599826,3599873,47,1,0,0,1
3599826,3599882,56,1,0,0,2
3599874,3600177,303,0,0,1,1
3599883,3600177,294,0,0,1,2
3600178,3600203,25,1,0,0,2
3600178,3600206,28,1,0,0,1
3600204,3601411,1207,0,0,1,2
3600207,3601411,1204,0,0,1,1
3601412,3601431,19,1,0,0,1
3601412,3601432,20,1,0,0,2
3601432,3602213,781,0,0,1,1
3601433,3602211,778,0,0,1,2
3602212,3602477,265,1,0,0,2
3602214,3602473,259,1,0,0,1
3602237,3602421,184,0,1,0,2
3602240,3602420,180,0,1,0,1
3602474,3603125,651,0,0,1,1
3602478,3603124,646,0,0,1,2
3603125,3603141,16,1,0,0,2
3603126,3603143,17,1,0,0,1
3603142,3603326,184,0,0,1,2
3603144,3603326,182,0,0,1,1
3603327,3603370,43,1,0,0,1
3603327,3603372,45,1,0,0,2
3603371,3603497,126,0,0,1,1
3603373,3603497,124,0,0,1,2
3603498,3603518,20,1,0,0,2
3603498,3603530,32,1,0,0,1
3603519,3603809,290,0,0,1,2
3603531,3603808,277,0,0,1,1
3603809,3603825,16,1,0,0,1
3603810,3603822,12,1,0,0,2
3603823,3604398,575,0,0,1,2
3603826,3604400,574,0,0,1,1
3604399,3604427,28,1,0,0,2
3604401,3604427,26,1,0,0,1
3604428,3604679,251,0,0,1,1
3604428,3604679,251,0,0,1,2
3604680,3604702,22,1,0,0,2
3604680,3604703,23,1,0,0,1
3604703,3605247,544,0,0,1,2
3604704,3605247,543,0,0,1,1
3605248,3605264,16,1,0,0,2
3605248,3605265,17,1,0,0,1
3605265,3605470,205,0,0,1,2
3605266,3605469,203,0,0,1,1
3605470,3605515,45,1,0,0,1
3605471,3605515,44,1,0,0,2
3605516,3605611,95,0,0,1,1
3605516,3605611,95,0,0,1,2
3605612,3605635,23,1,0,0,2
3605612,3605646,34,1,0,0,1
3605636,3607821,2185,0,0,1,2
3605647,3607825,2178,0,0,1,1
3607822,3608043,221,1,0,0,2
3607826,3608044,218,1,0,0,1
3607843,3608000,157,0,1,0,2
3607849,3607990,141,0,1,0,1
3608044,3608447,403,0,0,1,2
3608045,3608447,402,0,0,1,1
3608448,3608514,66,1,0,0,1
3608448,3608516,68,1,0,0,2
3608515,3608947,432,0,0,1,1
3608517,3608947,430,0,0,1,2
3608948,3609009,61,1,0,0,1
3608948,3609009,61,1,0,0,2
3609010,3609196,186,0,0,1,1
3609010,3609197,187,0,0,1,2
3609197,3609223,26,1,0,0,1
3609198,3609223,25,1,0,0,2
3609224,3609749,525,0,0,1,1
3609224,3610122,898,0,0,1,2
3609750,3609754,4,1,0,0,1
3609755,3610122,367,0,0,1,1
3610123,3610150,27,1,0,0,2
3610123,3610151,28,1,0,0,1
3610151,3611065,914,0,0,1,2
3610152,3611060,908,0,0,1,1
3611061,3611090,29,1,0,0,1
3611066,3611083,17,1,0,0,2
3611084,3612643,1559,0,0,1,2
3611091,3612643,1552,0,0,1,1
3612644,3612694,50,1,0,0,2
3612644,3612699,55,1,0,0,1
3612695,3612837,142,0,0,1,2
3612700,3612833,133,0,0,1,1
3612834,3612850,16,1,0,0,1
3612838,3612847,9,1,0,0,2
3612848,3615131,2283,0,0,1,2
3612851,3615130,2279,0,0,1,1
3615131,3615358,227,1,0,0,1
3615132,3615363,231,1,0,0,2
3615175,3615286,111,0,1,0,2
3615180,3615239,59,0,1,0,1
3615266,3615276,10,0,1,0,1
3615359,3616293,934,0,0,1,1
3615364,3616294,930,0,0,1,2
3616294,3616339,45,1,0,0,1
3616295,3616340,45,1,0,0,2
3616340,3616486,146,0,0,1,1
3616341,3616489,148,0,0,1,2
3616487,3616514,27,1,0,0,1
3616490,3616506,16,1,0,0,2
3616507,3618365,1858,0,0,1,2
3616515,3617675,1160,0,0,1,1
3617676,3617684,8,1,0,0,1
3617685,3618360,675,0,0,1,1
3618361,3618390,29,1,0,0,1
3618366,3618391,25,1,0,0,2
3618391,3618511,120,0,0,1,1
3618392,3618512,120,0,0,1,2
3618512,3618563,51,1,0,0,1
3618513,3618557,44,1,0,0,2
3618558,3618672,114,0,0,1,2
3618564,3618672,108,0,0,1,1
3618673,3618705,32,1,0,0,2
3618673,3618707,34,1,0,0,1
3618706,3621585,2879,0,0,1,2
3618708,3621586,2878,0,0,1,1
3621586,3621813,227,1,0,0,2
3621587,3621813,226,1,0,0,1
3621607,3621762,155,0,1,0,1
3621608,3621754,146,0,1,0,2
3621814,3621943,129,0,0,1,2
3621814,3621944,130,0,0,1,1
3621944,3622003,59,1,0,0,2
3621945,3622003,58,1,0,0,1
3622004,3622111,107,0,0,1,2
3622004,3622113,109,0,0,1,1
3622112,3622139,27,1,0,0,2
3622114,3622138,24,1,0,0,1
3622139,3623365,1226,0,0,1,1
3622140,3623362,1222,0,0,1,2
3623363,3623378,15,1,0,0,2
3623366,3623382,16,1,0,0,1
3623379,3624643,1264,0,0,1,2
3623383,3624642,1259,0,0,1,1
3624643,3624711,68,1,0,0,1
3624644,3624703,59,1,0,0,2
3624704,3624809,105,0,0,1,2
3624712,3624811,99,0,0,1,1
3624810,3624839,29,1,0,0,2
3624812,3624841,29,1,0,0,1
3624840,3626828,1988,0,0,1,2
3624842,3626827,1985,0,0,1,1
3626828,3627122,294,1,0,0,1
3626829,3627098,269,1,0,0,2
3626854,3627057,203,0,1,0,1
3626855,3627050,195,0,1,0,2
3627099,3628168,1069,0,0,1,2
3627123,3628167,1044,0,0,1,1
3628168,3628256,88,1,0,0,1
3628169,3628248,79,1,0,0,2
3628249,3628364,115,0,0,1,2
3628257,3628363,106,0,0,1,1
3628364,3628397,33,1,0,0,1
3628365,3628396,31,1,0,0,2
3628397,3628677,280,0,0,1,2
3628398,3628677,279,0,0,1,1
3628678,3628701,23,1,0,0,1
3628678,3628702,24,1,0,0,2
3628702,3628905,203,0,0,1,1
3628703,3628907,204,0,0,1,2
3628906,3628934,28,1,0,0,1
3628908,3628927,19,1,0,0,2
3628928,3630518,1590,0,0,1,2
3628935,3629491,556,0,0,1,1
3629492,3629507,15,1,0,0,1
3629508,3630518,1010,0,0,1,1
3630519,3630574,55,1,0,0,2
3630519,3630575,56,1,0,0,1
3630575,3630716,141,0,0,1,2
3630576,3630715,139,0,0,1,1
3630716,3630746,30,1,0,0,1
3630717,3630746,29,1,0,0,2
3630747,3631082,335,0,0,1,2
3630747,3631085,338,0,0,1,1
3631083,3631099,16,1,0,0,2
3631086,3631108,22,1,0,0,1
3631100,3632920,1820,0,0,1,2
3631109,3631318,209,0,0,1,1
3631319,3631330,11,1,0,0,1
3631331,3632921,1590,0,0,1,1
3632921,3632970,49,1,0,0,2
3632922,3632970,48,1,0,0,1
3632971,3633316,345,0,0,1,1
3632971,3633317,346,0,0,1,2
3633317,3633580,263,1,0,0,1
3633318,3633547,229,1,0,0,2
3633333,3633513,180,0,1,0,2
3633336,3633518,182,0,1,0,1
3633548,3633945,397,0,0,1,2
3633581,3633945,364,0,0,1,1
3633946,3634004,58,1,0,0,1
3633946,3634006,60,1,0,0,2
3634005,3634123,118,0,0,1,1
3634007,3634123,116,0,0,1,2
3634124,3634150,26,1,0,0,1
3634124,3634152,28,1,0,0,2
3634151,3634369,218,0,0,1,1
3634153,3634652,499,0,0,1,2
3634370,3634384,14,1,0,0,1
3634385,3634651,266,0,0,1,1
3634652,3634674,22,1,0,0,1
3634653,3634673,20,1,0,0,2
3634674,3634891,217,0,0,1,2
3634675,3634887,212,0,0,1,1
3634888,3634913,25,1,0,0,1
3634892,3634913,21,1,0,0,2
3634914,3635766,852,0,0,1,2
3634914,3635770,856,0,0,1,1
3635767,3635789,22,1,0,0,2
3635771,3635788,17,1,0,0,1
3635789,3636340,551,0,0,1,1
3635790,3636341,551,0,0,1,2
3636341,3636426,85,1,0,0,1
3636342,3636414,72,1,0,0,2
3636415,3636550,135,0,0,1,2
3636427,3636549,122,0,0,1,1
3636550,3636579,29,1,0,0,1
3636551,3636576,25,1,0,0,2
3636577,3638592,2015,0,0,1,2
3636580,3638595,2015,0,0,1,1
3638593,3638846,253,1,0,0,2
3638596,3638850,254,1,0,0,1
3638616,3638811,195,0,1,0,2
3638624,3638796,172,0,1,0,1
3638847,3638887,40,0,0,1,2
3638851,3639303,452,0,0,1,1
3638888,3638902,14,1,0,0,2
3638903,3639302,399,0,0,1,2
3639303,3639363,60,1,0,0,2
3639304,3639363,59,1,0,0,1
3639364,3640026,662,0,0,1,2
3639364,3640027,663,0,0,1,1
3640027,3640109,82,1,0,0,2
3640028,3640108,80,1,0,0,1
3640109,3640216,107,0,0,1,1
3640110,3640216,106,0,0,1,2
3640217,3640238,21,1,0,0,2
3640217,3640244,27,1,0,0,1
3640239,3640424,185,0,0,1,2
3640245,3640424,179,0,0,1,1
3640425,3640451,26,1,0,0,2
3640425,3640457,32,1,0,0,1
3640452,3642252,1800,0,0,1,2
3640458,3642252,1794,0,0,1,1
3642253,3642265,12,1,0,0,1
3642253,3642269,16,1,0,0,2
3642266,3643196,930,0,0,1,1
3642270,3643197,927,0,0,1,2
3643197,3643237,40,1,0,0,1
3643198,3643240,42,1,0,0,2
3643238,3643368,130,0,0,1,1
3643241,3643368,127,0,0,1,2
3643369,3643388,19,1,0,0,1
3643369,3643390,21,1,0,0,2
3643389,3644195,806,0,0,1,1
3643391,3644191,800,0,0,1,2
3644192,3644206,14,1,0,0,2
3644196,3644206,10,1,0,0,1
3644207,3645724,1517,0,0,1,1
3644207,3645725,1518,0,0,1,2
3645725,3645776,51,1,0,0,1
3645726,3645773,47,1,0,0,2
3645774,3646450,676,0,0,1,2
3645777,3646449,672,0,0,1,1
3646450,3646497,47,1,0,0,1
3646451,3646494,43,1,0,0,2
3646495,3647233,738,0,0,1,2
3646498,3647233,735,0,0,1,1
3647234,3647317,83,1,0,0,2
3647234,3647325,91,1,0,0,1
3647318,3647421,103,0,0,1,2
3647326,3647422,96,0,0,1,1
3647422,3647452,30,1,0,0,2
3647423,3647452,29,1,0,0,1
3647453,3648168,715,0,0,1,1
3647453,3648168,715,0,0,1,2
3648169,3648179,10,1,0,0,2
3648169,3648185,16,1,0,0,1
3648180,3648386,206,0,0,1,2
3648186,3648383,197,0,0,1,1
3648384,3648397,13,1,0,0,1
3648387,3648397,10,1,0,0,2
3648398,3649777,1379,0,0,1,1
3648398,3649777,1379,0,0,1,2
3649778,3649822,44,1,0,0,2
3649778,3649833,55,1,0,0,1
3649823,3649978,155,0,0,1,2
3649834,3649949,115,0,0,1,1
3649950,3650380,430,1,0,0,1
3649979,3650283,304,1,0,0,2
3649999,3650254,255,0,1,0,2
3650002,3650285,283,0,1,0,1
3650284,3650486,202,0,0,1,2
3650381,3650486,105,0,0,1,1
3650487,3650504,17,1,0,0,1
3650487,3650504,17,1,0,0,2
3650505,3650953,448,0,0,1,1
3650505,3650955,450,0,0,1,2
3650954,3650985,31,1,0,0,1
3650956,3650976,20,1,0,0,2
3650977,3652796,1819,0,0,1,2
3650986,3652791,1805,0,0,1,1
3652792,3653088,296,1,0,0,1
3652797,3653056,259,1,0,0,2
3652816,3653032,216,0,1,0,1
3652820,3653012,192,0,1,0,2
3653057,3653233,176,0,0,1,2
3653089,3653233,144,0,0,1,1
3653234,3653274,40,1,0,0,2
3653234,3653284,50,1,0,0,1
3653275,3653378,103,0,0,1,2
3653285,3653378,93,0,0,1,1
3653379,3653443,64,1,0,0,2
3653379,3653449,70,1,0,0,1
3653444,3653570,126,0,0,1,2
3653450,3653570,120,0,0,1,1
3653571,3653591,20,1,0,0,1
3653571,3653598,27,1,0,0,2
3653592,3654753,1161,0,0,1,1
3653599,3654754,1155,0,0,1,2
3654754,3654780,26,1,0,0,1
3654755,3654781,26,1,0,0,2
3654781,3655000,219,0,0,1,1
3654782,3655001,219,0,0,1,2
3655001,3655011,10,1,0,0,1
3655002,3655012,10,1,0,0,2
3655012,3657033,2021,0,0,1,1
3655013,3657032,2019,0,0,1,2
3657033,3657103,70,1,0,0,2
3657034,3657101,67,1,0,0,1
3657102,3657223,121,0,0,1,1
3657104,3657224,120,0,0,1,2
3657224,3657265,41,1,0,0,1
3657225,3657255,30,1,0,0,2
3657256,3657498,242,0,0,1,2
3657266,3657498,232,0,0,1,1
3657499,3657526,27,1,0,0,1
3657499,3657528,29,1,0,0,2
3657527,3659108,1581,0,0,1,1
3657529,3659107,1578,0,0,1,2
3659108,3659495,387,1,0,0,2
3659109,3659496,387,1,0,0,1
3659149,3659429,280,0,1,0,2
3659153,3659443,290,0,1,0,1
3659496,3659568,72,0,0,1,2
3659497,3659579,82,0,0,1,1
3659569,3659805,236,1,0,0,2
3659580,3659818,238,1,0,0,1
3659601,3659767,166,0,1,0,2
3659604,3659774,170,0,1,0,1
3659806,3660154,348,0,0,1,2
3659819,3660156,337,0,0,1,1
3660155,3660428,273,1,0,0,2
3660157,3660463,306,1,0,0,1
3660173,3660396,223,0,1,0,2
3660176,3660407,231,0,1,0,1
3660429,3660732,303,0,0,1,2
3660464,3660733,269,0,0,1,1
3660733,3660792,59,1,0,0,2
3660734,3660794,60,1,0,0,1
3660793,3661130,337,0,0,1,2
3660795,3661130,335,0,0,1,1
3661131,3661203,72,1,0,0,1
3661131,3661204,73,1,0,0,2
3661204,3661311,107,0,0,1,1
3661205,3661311,106,0,0,1,2
3661312,3661346,34,1,0,0,1
3661312,3661355,43,1,0,0,2
3661347,3661539,192,0,0,1,1
3661356,3661638,282,0,0,1,2
3661540,3661548,8,1,0,0,1
3661549,3661641,92,0,0,1,1
3661639,3661859,220,1,0,0,2
3661642,3661839,197,1,0,0,1
3661657,3661797,140,0,1,0,2
3661661,3661799,138,0,1,0,1
3661840,3662525,685,0,0,1,1
3661860,3662524,664,0,0,1,2
3662525,3662546,21,1,0,0,2
3662526,3662540,14,1,0,0,1
3662541,3663230,689,0,0,1,1
3662547,3664203,1656,0,0,1,2
3663231,3663235,4,1,0,0,1
3663236,3664203,967,0,0,1,1
3664204,3664253,49,1,0,0,1
3664204,3664255,51,1,0,0,2
3664254,3664375,121,0,0,1,1
3664256,3664375,119,0,0,1,2
3664376,3664396,20,1,0,0,2
3664376,3664404,28,1,0,0,1
3664397,3665287,890,0,0,1,2
3664405,3665281,876,0,0,1,1
3665282,3665293,11,1,0,0,1
3665288,3665292,4,1,0,0,2
3665293,3666305,1012,0,0,1,2
3665294,3666304,1010,0,0,1,1
3666305,3666332,27,1,0,0,1
3666306,3666319,13,1,0,0,2
3666320,3666375,55,0,0,1,2
3666333,3666374,41,0,0,1,1
3666375,3666922,547,1,0,0,1
3666376,3666898,522,1,0,0,2
3666397,3666581,184,0,1,0,2
3666402,3666580,178,0,1,0,1
3666701,3666861,160,0,1,0,2
3666702,3666869,167,0,1,0,1
3666899,3667240,341,0,0,1,2
3666923,3667239,316,0,0,1,1
3667240,3667290,50,1,0,0,1
3667241,3667293,52,1,0,0,2
3667291,3667458,167,0,0,1,1
3667294,3667458,164,0,0,1,2
3667459,3667666,207,1,0,0,2
3667459,3667669,210,1,0,0,1
3667481,3667610,129,0,1,0,2
3667482,3667615,133,0,1,0,1
3667667,3667805,138,0,0,1,2
3667670,3667807,137,0,0,1,1
3667806,3667889,83,1,0,0,2
3667808,3667888,80,1,0,0,1
3667889,3667986,97,0,0,1,1
3667890,3667986,96,0,0,1,2
3667987,3668018,31,1,0,0,1
3667987,3668019,32,1,0,0,2
3668019,3668293,274,0,0,1,1
3668020,3668288,268,0,0,1,2
3668289,3668539,250,1,0,0,2
3668294,3668545,251,1,0,0,1
3668308,3668488,180,0,1,0,2
3668313,3668489,176,0,1,0,1
3668540,3668651,111,0,0,1,2
3668546,3668650,104,0,0,1,1
3668651,3668672,21,1,0,0,1
3668652,3668664,12,1,0,0,2
3668665,3669415,750,0,0,1,2
3668673,3669420,747,0,0,1,1
3669416,3669430,14,1,0,0,2
3669421,3669431,10,1,0,0,1
3669431,3670150,719,0,0,1,2
3669432,3670146,714,0,0,1,1
3670147,3670173,26,1,0,0,1
3670151,3670175,24,1,0,0,2
3670174,3670338,164,0,0,1,1
3670176,3670338,162,0,0,1,2
3670339,3670408,69,1,0,0,2
3670339,3670410,71,1,0,0,1
3670409,3670532,123,0,0,1,2
3670411,3670532,121,0,0,1,1
3670533,3670553,20,1,0,0,2
3670533,3670574,41,1,0,0,1
3670554,3672400,1846,0,0,1,2
3670575,3672399,1824,0,0,1,1
3672400,3672654,254,1,0,0,1
3672401,3672645,244,1,0,0,2
3672436,3672610,174,0,1,0,1
3672437,3672601,164,0,1,0,2
3672646,3672693,47,0,0,1,2
3672655,3672699,44,0,0,1,1
3672694,3672973,279,1,0,0,2
3672700,3672998,298,1,0,0,1
3672723,3672944,221,0,1,0,1
3672725,3672929,204,0,1,0,2
3672974,3673192,218,0,0,1,2
3672999,3673192,193,0,0,1,1
3673193,3673435,242,1,0,0,2
3673193,3673448,255,1,0,0,1
3673212,3673394,182,0,1,0,2
3673219,3673397,178,0,1,0,1
3673436,3673654,218,0,0,1,2
3673449,3673655,206,0,0,1,1
3673655,3673742,87,1,0,0,2
3673656,3673743,87,1,0,0,1
3673743,3673836,93,0,0,1,2
3673744,3673836,92,0,0,1,1
3673837,3673872,35,1,0,0,2
3673837,3673911,74,1,0,0,1
3673873,3674006,133,0,0,1,2
3673912,3674012,100,0,0,1,1
3674007,3674483,476,1,0,0,2
3674013,3674417,404,1,0,0,1
3674027,3674398,371,0,1,0,2
3674030,3674309,279,0,1,0,1
3674418,3674454,36,0,0,1,1
3674455,3674497,42,1,0,0,1
3674484,3674863,379,0,0,1,2
3674498,3674857,359,0,0,1,1
3674858,3674886,28,1,0,0,1
3674864,3674887,23,1,0,0,2
3674887,3675156,269,0,0,1,1
3674888,3675156,268,0,0,1,2
3675157,3675181,24,1,0,0,2
3675157,3675190,33,1,0,0,1
3675182,3676475,1293,0,0,1,2
3675191,3675345,154,0,0,1,1
3675346,3675360,14,1,0,0,1
3675361,3676475,1114,0,0,1,1
3676476,3676513,37,1,0,0,1
3676476,3676514,38,1,0,0,2
3676514,3676699,185,0,0,1,1
3676515,3676701,186,0,0,1,2
3676700,3676735,35,1,0,0,1
3676702,3676734,32,1,0,0,2
3676735,3676908,173,0,0,1,2
3676736,3676907,171,0,0,1,1
3676908,3676939,31,1,0,0,1
3676909,3676939,30,1,0,0,2
3676940,3677189,249,0,0,1,1
3676940,3677192,252,0,0,1,2
3677190,3677214,24,1,0,0,1
3677193,3677212,19,1,0,0,2
3677213,3677386,173,0,0,1,2
3677215,3677384,169,0,0,1,1
3677385,3677413,28,1,0,0,1
3677387,3677403,16,1,0,0,2
3677404,3677987,583,0,0,1,2
3677414,3677986,572,0,0,1,1
3677987,3678008,21,1,0,0,1
3677988,3678011,23,1,0,0,2
3678009,3678397,388,0,0,1,1
3678012,3678397,385,0,0,1,2
3678398,3678422,24,1,0,0,1
3678398,3678423,25,1,0,0,2
3678423,3678686,263,0,0,1,1
3678424,3678687,263,0,0,1,2
3678687,3679014,327,1,0,0,1
3678688,3678981,293,1,0,0,2
3678718,3678943,225,0,1,0,2
3678718,3678959,241,0,1,0,1
3678982,3679282,300,0,0,1,2
3679015,3679282,267,0,0,1,1
3679283,3679328,45,1,0,0,2
3679283,3679329,46,1,0,0,1
3679329,3679667,338,0,0,1,2
3679330,3679665,335,0,0,1,1
3679666,3679717,51,1,0,0,1
3679668,3679717,49,1,0,0,2
3679718,3680021,303,0,0,1,1
3679718,3680023,305,0,0,1,2
3680022,3680117,95,1,0,0,1
3680024,3680116,92,1,0,0,2
3680117,3680207,90,0,0,1,2
3680118,3680205,87,0,0,1,1
3680206,3680244,38,1,0,0,1
3680208,3680247,39,1,0,0,2
3680245,3680381,136,0,0,1,1
3680248,3680382,134,0,0,1,2
3680382,3680406,24,1,0,0,1
3680383,3680397,14,1,0,0,2
3680398,3680667,269,0,0,1,2
3680407,3680668,261,0,0,1,1
3680668,3680703,35,1,0,0,2
3680669,3680695,26,1,0,0,1
3680696,3682429,1733,0,0,1,1
3680704,3682428,1724,0,0,1,2
3682429,3682469,40,1,0,0,2
3682430,3682478,48,1,0,0,1
3682470,3682622,152,0,0,1,2
3682479,3682623,144,0,0,1,1
3682623,3682651,28,1,0,0,2
3682624,3682655,31,1,0,0,1
3682652,3684408,1756,0,0,1,2
3682656,3684407,1751,0,0,1,1
3684408,3684435,27,1,0,0,1
3684409,3684437,28,1,0,0,2
3684436,3684552,116,0,0,1,1
3684438,3684555,117,0,0,1,2
3684553,3684855,302,1,0,0,1
3684556,3684814,258,1,0,0,2
3684581,3684795,214,0,1,0,1
3684582,3684783,201,0,1,0,2
3684815,3685097,282,0,0,1,2
3684856,3685097,241,0,0,1,1
3685098,3685158,60,1,0,0,1
3685098,3685158,60,1,0,0,2
3685159,3685961,802,0,0,1,1
3685159,3685961,802,0,0,1,2
3685962,3686009,47,1,0,0,1
3685962,3686020,58,1,0,0,2
3686010,3686188,178,0,0,1,1
3686021,3686188,167,0,0,1,2
3686189,3686225,36,1,0,0,1
3686189,3686226,37,1,0,0,2
3686226,3686396,170,0,0,1,1
3686227,3686395,168,0,0,1,2
3686396,3686432,36,1,0,0,2
3686397,3686447,50,1,0,0,1
3686433,3686578,145,0,0,1,2
3686448,3686581,133,0,0,1,1
3686579,3686863,284,1,0,0,2
3686582,3686888,306,1,0,0,1
3686602,3686831,229,0,1,0,1
3686605,3686816,211,0,1,0,2
3686864,3686919,55,0,0,1,2
3686889,3686915,26,0,0,1,1
3686916,3687180,264,1,0,0,1
3686920,3687147,227,1,0,0,2
3686945,3687126,181,0,1,0,1
3686948,3687109,161,0,1,0,2
3687148,3687311,163,0,0,1,2
3687181,3687312,131,0,0,1,1
3687312,3687794,482,1,0,0,2
3687313,3694794,7481,1,0,0,1
3687337,3694522,7185,0,1,0,1
3687338,3687746,408,0,1,0,2
3687795,3688183,388,0,0,1,2
3688184,3694512,6328,1,0,0,2
3688209,3694502,6293,0,1,0,2
3694513,3694546,33,0,0,1,2
3694547,3694754,207,1,0,0,2
3694566,3694737,171,0,1,0,1
3694576,3694707,131,0,1,0,2
3694755,3695081,326,0,0,1,2
3694795,3695064,269,0,0,1,1
3695065,3695558,493,1,0,0,1
3695082,3695297,215,1,0,0,2
3695104,3695304,200,0,1,0,1
3695111,3695255,144,0,1,0,2
3695298,3695323,25,0,0,1,2
3695324,3695534,210,1,0,0,2
3695325,3695511,186,0,1,0,1
3695346,3695517,171,0,1,0,2
3695535,3695754,219,0,0,1,2
3695559,3695755,196,0,0,1,1
3695755,3695793,38,1,0,0,2
3695756,3695794,38,1,0,0,1
3695794,3695985,191,0,0,1,2
3695795,3695982,187,0,0,1,1
3695983,3696000,17,1,0,0,1
3695986,3695992,6,1,0,0,2
3695993,3696196,203,0,0,1,2
3696001,3696198,197,0,0,1,1
3696197,3696588,391,1,0,0,2
3696199,3696620,421,1,0,0,1
3696216,3696603,387,0,1,0,1
3696218,3696547,329,0,1,0,2
3696589,3696736,147,0,0,1,2
3696621,3696738,117,0,0,1,1
3696737,3696756,19,1,0,0,2
3696739,3696754,15,1,0,0,1
3696755,3697046,291,0,0,1,1
3696757,3697050,293,0,0,1,2
3697047,3697311,264,1,0,0,1
3697051,3697266,215,1,0,0,2
3697070,3697216,146,0,1,0,2
3697070,3697228,158,0,1,0,1
3697267,3697485,218,0,0,1,2
3697312,3697485,173,0,0,1,1
3697486,3697517,31,1,0,0,1
3697486,3697518,32,1,0,0,2
3697518,3697810,292,0,0,1,1
3697519,3697809,290,0,0,1,2
3697810,3698034,224,1,0,0,2
3697811,3698064,253,1,0,0,1
3697834,3697998,164,0,1,0,2
3697834,3698021,187,0,1,0,1
3698035,3698167,132,0,0,1,2
3698065,3698166,101,0,0,1,1
3698167,3698188,21,1,0,0,1
3698168,3698184,16,1,0,0,2
3698185,3698449,264,0,0,1,2
3698189,3698449,260,0,0,1,1
3698450,3698500,50,1,0,0,1
3698450,3698500,50,1,0,0,2
3698501,3698725,224,0,0,1,1
3698501,3698725,224,0,0,1,2
3698726,3698755,29,1,0,0,1
3698726,3698757,31,1,0,0,2
3698756,3698881,125,0,0,1,1
3698758,3698882,124,0,0,1,2
3698882,3698916,34,1,0,0,1
3698883,3698915,32,1,0,0,2
3698916,3699169,253,0,0,1,2
3698917,3699169,252,0,0,1,1
3699170,3699190,20,1,0,0,1
3699170,3699192,22,1,0,0,2
3699191,3699411,220,0,0,1,1
3699193,3699411,218,0,0,1,2
3699412,3699429,17,1,0,0,2
3699412,3699430,18,1,0,0,1
3699430,3699606,176,0,0,1,2
3699431,3699605,174,0,0,1,1
3699606,3699640,34,1,0,0,1
3699607,3699644,37,1,0,0,2
3699641,3699925,284,0,0,1,1
3699645,3699925,280,0,0,1,2
3743137,3743221,84,0,0,1,2
3743137,3743222,85,0,0,1,1
3743222,3743260,38,1,0,0,2
3743223,3743260,37,1,0,0,1
3743261,3743370,109,0,0,1,1
3743261,3743370,109,0,0,1,2
3743371,3743448,77,1,0,0,2
3743371,3743450,79,1,0,0,1
3743449,3743536,87,0,0,1,2
3743451,3743537,86,0,0,1,1
3743537,3743562,25,1,0,0,2
3743538,3743561,23,1,0,0,1
3743562,3743875,313,0,0,1,1
3743563,3743881,318,0,0,1,2
3743876,3743886,10,1,0,0,1
3743882,3743893,11,1,0,0,2
3743887,3744680,793,0,0,1,1
3743894,3744664,770,0,0,1,2
3744665,3744933,268,1,0,0,2
3744681,3744867,186,1,0,0,1
3744696,3744831,135,0,1,0,2
3744704,3744822,118,0,1,0,1
3744868,3745123,255,0,0,1,1
3744934,3745123,189,0,0,1,2
3745124,3746301,1177,1,0,0,1
3745124,3746302,1178,1,0,0,2
3745194,3746287,1093,0,1,0,1
3745195,3746269,1074,0,1,0,2
3746302,3746396,94,0,0,1,1
3746303,3746396,93,0,0,1,2
3746397,3746430,33,1,0,0,2
3746397,3746438,41,1,0,0,1
3746431,3746526,95,0,0,1,2
3746439,3746526,87,0,0,1,1
3746527,3746548,21,1,0,0,2
3746527,3746557,30,1,0,0,1
3746549,3746851,302,0,0,1,2
3746558,3746850,292,0,0,1,1
3746851,3746867,16,1,0,0,1
3746852,3746870,18,1,0,0,2
3746868,3747044,176,0,0,1,1
3746871,3747043,172,0,0,1,2
3747044,3747071,27,1,0,0,2
3747045,3747070,25,1,0,0,1
3747071,3747275,204,0,0,1,1
3747072,3747540,468,0,0,1,2
3747276,3747296,20,1,0,0,1
3747297,3747535,238,0,0,1,1
3747536,3747573,37,1,0,0,1
3747541,3747555,14,1,0,0,2
3747556,3748773,1217,0,0,1,2
3747574,3747626,52,0,0,1,1
3747627,3747631,4,1,0,0,1
3747632,3747795,163,0,0,1,1
3747796,3747813,17,1,0,0,1
3747814,3748172,358,0,0,1,1
3748173,3748182,9,1,0,0,1
3748183,3748450,267,0,0,1,1
3748451,3748460,9,1,0,0,1
3748461,3748768,307,0,0,1,1
3748769,3748785,16,1,0,0,1
3748774,3748786,12,1,0,0,2
3748786,3750263,1477,0,0,1,1
3748787,3750263,1476,0,0,1,2
3750264,3750533,269,1,0,0,2
3750264,3750561,297,1,0,0,1
3750343,3750506,163,0,1,0,1
3750345,3750490,145,0,1,0,2
3750534,3750615,81,0,0,1,2
3750562,3750614,52,0,0,1,1
3750615,3750643,28,1,0,0,1
3750616,3750644,28,1,0,0,2
3750644,3750778,134,0,0,1,1
3750645,3750777,132,0,0,1,2
3750778,3750803,25,1,0,0,2
3750779,3750802,23,1,0,0,1
3750803,3751083,280,0,0,1,1
3750804,3751083,279,0,0,1,2
3751084,3751103,19,1,0,0,1
3751084,3751103,19,1,0,0,2
3751104,3751727,623,0,0,1,1
3751104,3751730,626,0,0,1,2
3751728,3751743,15,1,0,0,1
3751731,3751744,13,1,0,0,2
3751744,3752721,977,0,0,1,1
3751745,3752721,976,0,0,1,2
3752722,3752790,68,1,0,0,1
3752722,3752790,68,1,0,0,2
3752791,3753149,358,0,0,1,1
3752791,3753150,359,0,0,1,2
3753150,3753245,95,1,0,0,1
3753151,3753241,90,1,0,0,2
3753242,3753318,76,0,0,1,2
3753246,3753318,72,0,0,1,1
3753319,3753353,34,1,0,0,2
3753319,3753359,40,1,0,0,1
3753354,3753794,440,0,0,1,2
3753360,3754362,1002,0,0,1,1
3753795,3753799,4,1,0,0,2
3753800,3754363,563,0,0,1,2
3754363,3754374,11,1,0,0,1
3754364,3754380,16,1,0,0,2
3754375,3754600,225,0,0,1,1
3754381,3754600,219,0,0,1,2
3754601,3754620,19,1,0,0,2
3754601,3754621,20,1,0,0,1
3754621,3755962,1341,0,0,1,2
3754622,3755963,1341,0,0,1,1
3755963,3756062,99,1,0,0,2
3755964,3756057,93,1,0,0,1
3756058,3756102,44,0,0,1,1
3756063,3756103,40,0,0,1,2
3756103,3756163,60,1,0,0,1
3756104,3756163,59,1,0,0,2
3756164,3756315,151,0,0,1,1
3756164,3756317,153,0,0,1,2
3756316,3756335,19,1,0,0,1
3756318,3756332,14,1,0,0,2
3756333,3756968,635,0,0,1,2
3756336,3756968,632,0,0,1,1
3756969,3756996,27,1,0,0,2
3756969,3756997,28,1,0,0,1
3756997,3758426,1429,0,0,1,2
3756998,3758426,1428,0,0,1,1
3758427,3758482,55,1,0,0,2
3758427,3758485,58,1,0,0,1
3758483,3758675,192,0,0,1,2
3758486,3758670,184,0,0,1,1
3758671,3758854,183,1,0,0,1
3758676,3758945,269,1,0,0,2
3758691,3758816,125,0,1,0,1
3758697,3758815,118,0,1,0,2
3758855,3758911,56,0,0,1,1
3758912,3758951,39,1,0,0,1
3758946,3759159,213,0,0,1,2
3758952,3759147,195,0,0,1,1
3759148,3759175,27,1,0,0,1
3759160,3759175,15,1,0,0,2
3759176,3759254,78,0,0,1,2
3759176,3759259,83,0,0,1,1
3759255,3759554,299,1,0,0,2
3759260,3759519,259,1,0,0,1
3759280,3759468,188,0,1,0,2
3759283,3759466,183,0,1,0,1
3759520,3759698,178,0,0,1,1
3759555,3759701,146,0,0,1,2
3759699,3759729,30,1,0,0,1
3759702,3759726,24,1,0,0,2
3759727,3759916,189,0,0,1,2
3759730,3759920,190,0,0,1,1
3759917,3759928,11,1,0,0,2
3759921,3759926,5,1,0,0,1
3759927,3761372,1445,0,0,1,1
3759929,3761373,1444,0,0,1,2
3761373,3761484,111,1,0,0,1
3761374,3761483,109,1,0,0,2
3761484,3761749,265,0,0,1,2
3761485,3761747,262,0,0,1,1
3761748,3761828,80,1,0,0,1
3761750,3761822,72,1,0,0,2
3761823,3762171,348,0,0,1,2
3761829,3762167,338,0,0,1,1
3762168,3762192,24,1,0,0,1
3762172,3762183,11,1,0,0,2
3762184,3762767,583,0,0,1,2
3762193,3762765,572,0,0,1,1
3762766,3762784,18,1,0,0,1
3762768,3762784,16,1,0,0,2
3762785,3762946,161,0,0,1,1
3762785,3762948,163,0,0,1,2
3762947,3762959,12,1,0,0,1
3762949,3762957,8,1,0,0,2
3762958,3763955,997,0,0,1,2
3762960,3763955,995,0,0,1,1
3763956,3764063,107,1,0,0,1
3763956,3764095,139,1,0,0,2
3764064,3764091,27,0,0,1,1
3764092,3764097,5,1,0,0,1
3764096,3764359,263,0,0,1,2
3764098,3764359,261,0,0,1,1
3764360,3764436,76,1,0,0,2
3764360,3764444,84,1,0,0,1
3764437,3764528,91,0,0,1,2
3764445,3764527,82,0,0,1,1
3764528,3764562,34,1,0,0,1
3764529,3764554,25,1,0,0,2
3764555,3765131,576,0,0,1,2
3764563,3765140,577,0,0,1,1
3765132,3765355,223,1,0,0,2
3765141,3765334,193,1,0,0,1
3765161,3765289,128,0,1,0,1
3765162,3765293,131,0,1,0,2
3765335,3766892,1557,0,0,1,1
3765356,3766893,1537,0,0,1,2
3766893,3766958,65,1,0,0,1
3766894,3766953,59,1,0,0,2
3766954,3767036,82,0,0,1,2
3766959,3767036,77,0,0,1,1
3767037,3767077,40,1,0,0,1
3767037,3767078,41,1,0,0,2
3767078,3767280,202,0,0,1,1
3767079,3767280,201,0,0,1,2
3767281,3767334,53,1,0,0,2
3767281,3767339,58,1,0,0,1
3767335,3767526,191,0,0,1,2
3767340,3767523,183,0,0,1,1
3767524,3767545,21,1,0,0,1
3767527,3767537,10,1,0,0,2
3767538,3767920,382,0,0,1,2
3767546,3767921,375,0,0,1,1
3767921,3767935,14,1,0,0,2
3767922,3767936,14,1,0,0,1
3767936,3769191,1255,0,0,1,2
3767937,3769192,1255,0,0,1,1
3769192,3769210,18,1,0,0,2
3769193,3769207,14,1,0,0,1
3769208,3769513,305,0,0,1,1
3769211,3769512,301,0,0,1,2
3769513,3769754,241,1,0,0,2
3769514,3769714,200,1,0,0,1
3769617,3769680,63,0,1,0,2
3769624,3769673,49,0,1,0,1
3769715,3769831,116,0,0,1,1
3769755,3769831,76,0,0,1,2
3769832,3769860,28,1,0,0,2
3769832,3769861,29,1,0,0,1
3769861,3770495,634,0,0,1,2
3769862,3770491,629,0,0,1,1
3770492,3770511,19,1,0,0,1
3770496,3770506,10,1,0,0,2
3770507,3771038,531,0,0,1,2
3770512,3771037,525,0,0,1,1
3771038,3771057,19,1,0,0,1
3771039,3771055,16,1,0,0,2
3771056,3772029,973,0,0,1,2
3771058,3772026,968,0,0,1,1
3772027,3772061,34,1,0,0,1
3772030,3772070,40,1,0,0,2
3772062,3772141,79,0,0,1,1
3772071,3772140,69,0,0,1,2
3772141,3772223,82,1,0,0,2
3772142,3772223,81,1,0,0,1
3772224,3772489,265,0,0,1,1
3772224,3772491,267,0,0,1,2
3772490,3772573,83,1,0,0,1
3772492,3772570,78,1,0,0,2
3772571,3772650,79,0,0,1,2
3772574,3772649,75,0,0,1,1
3772650,3772704,54,1,0,0,1
3772651,3772696,45,1,0,0,2
3772697,3772841,144,0,0,1,2
3772705,3772833,128,0,0,1,1
3772834,3773394,560,1,0,0,1
3772842,3773145,303,1,0,0,2
3772857,3773325,468,0,1,0,1
3772858,3773091,233,0,1,0,2
3773146,3773180,34,0,0,1,2
3773181,3773195,14,1,0,0,2
3773196,3773536,340,0,0,1,2
3773395,3773469,74,0,0,1,1
3773470,3773586,116,1,0,0,1
3773537,3773551,14,1,0,0,2
3773552,3774087,535,0,0,1,2
3773587,3773846,259,0,0,1,1
3773847,3773860,13,1,0,0,1
3773861,3774092,231,0,0,1,1
3774088,3774109,21,1,0,0,2
3774093,3774099,6,1,0,0,1
3774100,3775070,970,0,0,1,1
3774110,3775069,959,0,0,1,2
3775070,3775161,91,1,0,0,2
3775071,3775160,89,1,0,0,1
3775161,3775531,370,0,0,1,1
3775162,3775531,369,0,0,1,2
3775532,3775594,62,1,0,0,2
3775532,3775640,108,1,0,0,1
3775595,3775680,85,0,0,1,2
3775641,3775681,40,0,0,1,1
3775681,3775721,40,1,0,0,2
3775682,3775746,64,1,0,0,1
3775722,3776082,360,0,0,1,2
3775747,3775977,230,0,0,1,1
3775978,3776007,29,1,0,0,1
3776008,3776065,57,0,0,1,1
3776066,3776446,380,1,0,0,1
3776083,3776463,380,1,0,0,2
3776107,3776390,283,0,1,0,1
3776108,3776443,335,0,1,0,2
3776447,3776470,23,0,0,1,1
3776464,3778041,1577,0,0,1,2
3776471,3776490,19,1,0,0,1
3776491,3776724,233,0,0,1,1
3776725,3776807,82,1,0,0,1
3776808,3776870,62,0,0,1,1
3776871,3776897,26,1,0,0,1
3776898,3777024,126,0,0,1,1
3777025,3777066,41,1,0,0,1
3777067,3777121,54,0,0,1,1
3777122,3777146,24,1,0,0,1
3777147,3777386,239,0,0,1,1
3777387,3777464,77,1,0,0,1
3777465,3777593,128,0,0,1,1
3777594,3777665,71,1,0,0,1
3777666,3777801,135,0,0,1,1
3777802,3777903,101,1,0,0,1
3777904,3777929,25,0,0,1,1
3777930,3778080,150,1,0,0,1
3778042,3778077,35,1,0,0,2
3778078,3778427,349,0,0,1,2
3778081,3778423,342,0,0,1,1
3778424,3778533,109,1,0,0,1
3778428,3778533,105,1,0,0,2
3778534,3778576,42,0,0,1,1
3778534,3778576,42,0,0,1,2
3778577,3778646,69,1,0,0,1
3778577,3778648,71,1,0,0,2
3778647,3778713,66,0,0,1,1
3778649,3778714,65,0,0,1,2
3778714,3778750,36,1,0,0,1
3778715,3778745,30,1,0,0,2
3778746,3779016,270,0,0,1,2
3778751,3779016,265,0,0,1,1
3779017,3779027,10,1,0,0,1
3779017,3779028,11,1,0,0,2
3779028,3780524,1496,0,0,1,1
3779029,3780525,1496,0,0,1,2
3780525,3780610,85,1,0,0,1
3780526,3780604,78,1,0,0,2
3780605,3780676,71,0,0,1,2
3780611,3780685,74,0,0,1,1
3780677,3781002,325,1,0,0,2
3780686,3780982,296,1,0,0,1
3780731,3780940,209,0,1,0,2
3780739,3780939,200,0,1,0,1
3780983,3781051,68,0,0,1,1
3781003,3781052,49,0,0,1,2
3781052,3781133,81,1,0,0,1
3781053,3781128,75,1,0,0,2
3781129,3781196,67,0,0,1,2
3781134,3781195,61,0,0,1,1
3781196,3781239,43,1,0,0,1
3781197,3781234,37,1,0,0,2
3781235,3782901,1666,0,0,1,2
3781240,3783348,2108,0,0,1,1
3782902,3782906,4,1,0,0,2
3782907,3783349,442,0,0,1,2
3783349,3783423,74,1,0,0,1
3783350,3783424,74,1,0,0,2
3783424,3783513,89,0,0,1,1
3783425,3783513,88,0,0,1,2
3783514,3783539,25,1,0,0,1
3783514,3783547,33,1,0,0,2
3783540,3783742,202,0,0,1,1
3783548,3783745,197,0,0,1,2
3783743,3783751,8,1,0,0,1
3783746,3783759,13,1,0,0,2
3783752,3785695,1943,0,0,1,1
3783760,3785696,1936,0,0,1,2
3785696,3785835,139,1,0,0,1
3785697,3786217,520,1,0,0,2
3785787,3785788,1,0,1,0,2
3785836,3785873,37,0,0,1,1
3785874,3786203,329,1,0,0,1
3785887,3786149,262,0,1,0,2
3785890,3786149,259,0,1,0,1
3786204,3787484,1280,0,0,1,1
3786218,3787485,1267,0,0,1,2
3787485,3787514,29,1,0,0,1
3787486,3787540,54,1,0,0,2
3787515,3787633,118,0,0,1,1
3787541,3787634,93,0,0,1,2
3787634,3787675,41,1,0,0,1
3787635,3787674,39,1,0,0,2
3787675,3787951,276,0,0,1,2
3787676,3787950,274,0,0,1,1
3787951,3788012,61,1,0,0,1
3787952,3788011,59,1,0,0,2
3788012,3788114,102,0,0,1,2
3788013,3788114,101,0,0,1,1
3788115,3788131,16,1,0,0,1
3788115,3788132,17,1,0,0,2
3788132,3788360,228,0,0,1,1
3788133,3788359,226,0,0,1,2
3788360,3788374,14,1,0,0,2
3788361,3788371,10,1,0,0,1
3788372,3789476,1104,0,0,1,1
3788375,3789483,1108,0,0,1,2
3789477,3789488,11,1,0,0,1
3789484,3789491,7,1,0,0,2
3789489,3789655,166,0,0,1,1
3789492,3789656,164,0,0,1,2
3789656,3789678,22,1,0,0,1
3789657,3789677,20,1,0,0,2
3789678,3789919,241,0,0,1,2
3789679,3789918,239,0,0,1,1
3789919,3789958,39,1,0,0,1
3789920,3789952,32,1,0,0,2
3789953,3790132,179,0,0,1,2
3789959,3790132,173,0,0,1,1
3790133,3790143,10,1,0,0,1
3790133,3790143,10,1,0,0,2
3790144,3790452,308,0,0,1,1
3790144,3791621,1477,0,0,1,2
3790453,3790457,4,1,0,0,1
3790458,3791619,1161,0,0,1,1
3791620,3791648,28,1,0,0,1
3791622,3791637,15,1,0,0,2
3791638,3792007,369,0,0,1,2
3791649,3792007,358,0,0,1,1
3792008,3792047,39,1,0,0,1
3792008,3792055,47,1,0,0,2
3792048,3792222,174,0,0,1,1
3792056,3792595,539,0,0,1,2
3792223,3792232,9,1,0,0,1
3792233,3792595,362,0,0,1,1
3792596,3792621,25,1,0,0,1
3792596,3792624,28,1,0,0,2
3792622,3792914,292,0,0,1,1
3792625,3792913,288,0,0,1,2
3792914,3792926,12,1,0,0,2
3792915,3792927,12,1,0,0,1
3792927,3793314,387,0,0,1,2
3792928,3793310,382,0,0,1,1
3793311,3793330,19,1,0,0,1
3793315,3793325,10,1,0,0,2
3793326,3793762,436,0,0,1,2
3793331,3793762,431,0,0,1,1
3793763,3793781,18,1,0,0,1
3793763,3793781,18,1,0,0,2
3793782,3794257,475,0,0,1,1
3793782,3794257,475,0,0,1,2
3794258,3794357,99,1,0,0,2
3794258,3794358,100,1,0,0,1
3794358,3794457,99,0,0,1,2
3794359,3794456,97,0,0,1,1
3794457,3794482,25,1,0,0,1
3794458,3794499,41,1,0,0,2
3794483,3795010,527,0,0,1,1
3794500,3795002,502,0,0,1,2
3795003,3795268,265,1,0,0,2
3795011,3795227,216,1,0,0,1
3795030,3795191,161,0,1,0,2
3795034,3795188,154,0,1,0,1
3795228,3795371,143,0,0,1,1
3795269,3795370,101,0,0,1,2
3795371,3795389,18,1,0,0,2
3795372,3795386,14,1,0,0,1
3795387,3795823,436,0,0,1,1
3795390,3795820,430,0,0,1,2
3795821,3795832,11,1,0,0,2
3795824,3795838,14,1,0,0,1
3795833,3796921,1088,0,0,1,2
3795839,3796920,1081,0,0,1,1
3796921,3797609,688,1,0,0,1
3796922,3797399,477,1,0,0,2
3797002,3797388,386,0,1,0,1
3797009,3797380,371,0,1,0,2
3797400,3797422,22,0,0,1,2
3797421,3797497,76,0,1,0,1
3797423,3797442,19,1,0,0,2
3797443,3797842,399,0,0,1,2
3797610,3797657,47,0,0,1,1
3797658,3797670,12,1,0,0,1
3797671,3797844,173,0,0,1,1
3797843,3797870,27,1,0,0,2
3797845,3797870,25,1,0,0,1
3797871,3799251,1380,0,0,1,1
3797871,3799251,1380,0,0,1,2
3799252,3799332,80,1,0,0,1
3799252,3799332,80,1,0,0,2
3799333,3799483,150,0,0,1,1
3799333,3799484,151,0,0,1,2
3799484,3799570,86,1,0,0,1
3799485,3799574,89,1,0,0,2
3799571,3801489,1918,0,0,1,1
3799575,3801490,1915,0,0,1,2
3801490,3801600,110,1,0,0,1
3801491,3801592,101,1,0,0,2
3801593,3801702,109,0,0,1,2
3801601,3801700,99,0,0,1,1
3801701,3801725,24,1,0,0,1
3801703,3801729,26,1,0,0,2
3801726,3801904,178,0,0,1,1
3801730,3801904,174,0,0,1,2
3801905,3801919,14,1,0,0,1
3801905,3801920,15,1,0,0,2
3801920,3802157,237,0,0,1,1
3801921,3802160,239,0,0,1,2
3802158,3802179,21,1,0,0,1
3802161,3802178,17,1,0,0,2
3802179,3802562,383,0,0,1,2
3802180,3802557,377,0,0,1,1
3802558,3802578,20,1,0,0,1
3802563,3802579,16,1,0,0,2
3802579,3802888,309,0,0,1,1
3802580,3802891,311,0,0,1,2
3802889,3802905,16,1,0,0,1
3802892,3802902,10,1,0,0,2
3802903,3803458,555,0,0,1,2
3802906,3803460,554,0,0,1,1
3803459,3803482,23,1,0,0,2
3803461,3803493,32,1,0,0,1
3803483,3803939,456,0,0,1,2
3803494,3803939,445,0,0,1,1
3803940,3804032,92,1,0,0,2
3803940,3804037,97,1,0,0,1
3804033,3804144,111,0,0,1,2
3804038,3804145,107,0,0,1,1
3804145,3804187,42,1,0,0,2
3804146,3804177,31,1,0,0,1
3804178,3804440,262,0,0,1,1
3804188,3804431,243,0,0,1,2
3804432,3804648,216,1,0,0,2
3804441,3804629,188,1,0,0,1
3804458,3804586,128,0,1,0,2
3804461,3804584,123,0,1,0,1
3804630,3804840,210,0,0,1,1
3804649,3804848,199,0,0,1,2
3804841,3804855,14,1,0,0,1
3804849,3804863,14,1,0,0,2
3804856,3806385,1529,0,0,1,1
3804864,3806385,1521,0,0,1,2
3806386,3806466,80,1,0,0,1
3806386,3806467,81,1,0,0,2
3806467,3806532,65,0,0,1,1
3806468,3806533,65,0,0,1,2
3806533,3806575,42,1,0,0,1
3806534,3806577,43,1,0,0,2
3806576,3806703,127,0,0,1,1
3806578,3806703,125,0,0,1,2
3806704,3806732,28,1,0,0,2
3806704,3806733,29,1,0,0,1
3806733,3807228,495,0,0,1,2
3806734,3807227,493,0,0,1,1
3807228,3807236,8,1,0,0,1
3807229,3807239,10,1,0,0,2
3807237,3808634,1397,0,0,1,1
3807240,3808634,1394,0,0,1,2
3808635,3808786,151,1,0,0,2
3808635,3808791,156,1,0,0,1
3808712,3808729,17,0,1,0,2
3808751,3808757,6,0,1,0,2
3808787,3808849,62,0,0,1,2
3808792,3808848,56,0,0,1,1
3808849,3808884,35,1,0,0,1
3808850,3808884,34,1,0,0,2
3808885,3809068,183,0,0,1,1
3808885,3809070,185,0,0,1,2
3809069,3809493,424,1,0,0,1
3809071,3809469,398,1,0,0,2
3809087,3809458,371,0,1,0,2
3809089,3809474,385,0,1,0,1
3809470,3809709,239,0,0,1,2
3809494,3809708,214,0,0,1,1
3809709,3809713,4,1,0,0,1
3809710,3809734,24,1,0,0,2
3809714,3811034,1320,0,0,1,1
3809735,3811034,1299,0,0,1,2
3811035,3811084,49,1,0,0,2
3811035,3811090,55,1,0,0,1
3811085,3811320,235,0,0,1,2
3811091,3811320,229,0,0,1,1
3811321,3811379,58,1,0,0,2
3811321,3811392,71,1,0,0,1
3811380,3811511,131,0,0,1,2
3811393,3811512,119,0,0,1,1
3811512,3811573,61,1,0,0,2
3811513,3811575,62,1,0,0,1
3811574,3811656,82,0,0,1,2
3811576,3811656,80,0,0,1,1
3811657,3811678,21,1,0,0,2
3811657,3811687,30,1,0,0,1
3811679,3811968,289,0,0,1,2
3811688,3811963,275,0,0,1,1
3811964,3811989,25,1,0,0,1
3811969,3811983,14,1,0,0,2
3811984,3812365,381,0,0,1,2
3811990,3812360,370,0,0,1,1
3812361,3812387,26,1,0,0,1
3812366,3812387,21,1,0,0,2
3812388,3813086,698,0,0,1,1
3812388,3813086,698,0,0,1,2
3813087,3813107,20,1,0,0,2
3813087,3813109,22,1,0,0,1
3813108,3813512,404,0,0,1,2
3813110,3813513,403,0,0,1,1
3813513,3813583,70,1,0,0,2
3813514,3813583,69,1,0,0,1
3813584,3813666,82,0,0,1,2
3813584,3813667,83,0,0,1,1
3813667,3813707,40,1,0,0,2
3813668,3813714,46,1,0,0,1
3813708,3813934,226,0,0,1,2
3813715,3813946,231,0,0,1,1
3813935,3814312,377,1,0,0,2
3813947,3814274,327,1,0,0,1
3813956,3814291,335,0,1,0,2
3813962,3814233,271,0,1,0,1
3814275,3816017,1742,0,0,1,1
3814313,3816017,1704,0,0,1,2
3816018,3816118,100,1,0,0,2
3816018,3816119,101,1,0,0,1
3816119,3816247,128,0,0,1,2
3816120,3816249,129,0,0,1,1
3816248,3816281,33,1,0,0,2
3816250,3816281,31,1,0,0,1
3816282,3816659,377,0,0,1,1
3816282,3816659,377,0,0,1,2
3816660,3816668,8,1,0,0,1
3816660,3816668,8,1,0,0,2
3816669,3818131,1462,0,0,1,2
3816669,3818154,1485,0,0,1,1
3818132,3818431,299,1,0,0,2
3818155,3818423,268,1,0,0,1
3818175,3818359,184,0,1,0,2
3818176,3818365,189,0,1,0,1
3818424,3818678,254,0,0,1,1
3818432,3818678,246,0,0,1,2
3818679,3818732,53,1,0,0,1
3818679,3818732,53,1,0,0,2
3818733,3818876,143,0,0,1,1
3818733,3818876,143,0,0,1,2
3818877,3818895,18,1,0,0,1
3818877,3818896,19,1,0,0,2
3818896,3820823,1927,0,0,1,1
3818897,3820823,1926,0,0,1,2
3820824,3820905,81,1,0,0,2
3820824,3820906,82,1,0,0,1
3820906,3820991,85,0,0,1,2
3820907,3820989,82,0,0,1,1
3820990,3821022,32,1,0,0,1
3820992,3821021,29,1,0,0,2
3821022,3821141,119,0,0,1,2
3821023,3821152,129,0,0,1,1
3821142,3821415,273,1,0,0,2
3821153,3821406,253,1,0,0,1
3821166,3821363,197,0,1,0,2
3821171,3821358,187,0,1,0,1
3821407,3821595,188,0,0,1,1
3821416,3821446,30,0,0,1,2
3821447,3821451,4,1,0,0,2
3821452,3821591,139,0,0,1,2
3821592,3821614,22,1,0,0,2
3821596,3821619,23,1,0,0,1
3821615,3821924,309,0,0,1,2
3821620,3821926,306,0,0,1,1
3821925,3821948,23,1,0,0,2
3821927,3821951,24,1,0,0,1
3821949,3822167,218,0,0,1,2
3821952,3822161,209,0,0,1,1
3822162,3822190,28,1,0,0,1
3822168,3822178,10,1,0,0,2
3822179,3822605,426,0,0,1,2
3822191,3822605,414,0,0,1,1
3822606,3822642,36,1,0,0,1
3822606,3822642,36,1,0,0,2
3822643,3822991,348,0,0,1,1
3822643,3822991,348,0,0,1,2
3822992,3823069,77,1,0,0,2
3822992,3823083,91,1,0,0,1
3823070,3823182,112,0,0,1,2
3823084,3823182,98,0,0,1,1
3823183,3823203,20,1,0,0,2
3823183,3823212,29,1,0,0,1
3823204,3823885,681,0,0,1,2
3823213,3823884,671,0,0,1,1
3823885,3823899,14,1,0,0,1
3823886,3823896,10,1,0,0,2
3823897,3824913,1016,0,0,1,2
3823900,3824913,1013,0,0,1,1
3824914,3824976,62,1,0,0,2
3824914,3824977,63,1,0,0,1
3824977,3825116,139,0,0,1,2
3824978,3825108,130,0,0,1,1
3825109,3825129,20,1,0,0,1
3825117,3825127,10,1,0,0,2
3825128,3827025,1897,0,0,1,2
3825130,3827024,1894,0,0,1,1
3827025,3827075,50,1,0,0,1
3827026,3827080,54,1,0,0,2
3827076,3827193,117,0,0,1,1
3827081,3827193,112,0,0,1,2
3827194,3827217,23,1,0,0,1
3827194,3827222,28,1,0,0,2
3827218,3827391,173,0,0,1,1
3827223,3827391,168,0,0,1,2
3827392,3827403,11,1,0,0,2
3827392,3827415,23,1,0,0,1
3827404,3828462,1058,0,0,1,2
3827416,3827722,306,0,0,1,1
3827723,3827733,10,1,0,0,1
3827734,3828462,728,0,0,1,1
3828463,3828484,21,1,0,0,2
3828463,3828487,24,1,0,0,1
3828485,3828845,360,0,0,1,2
3828488,3828844,356,0,0,1,1
3828845,3828900,55,1,0,0,1
3828846,3828900,54,1,0,0,2
3828901,3829041,140,0,0,1,1
3828901,3829043,142,0,0,1,2
3829042,3829070,28,1,0,0,1
3829044,3829062,18,1,0,0,2
3829063,3829535,472,0,0,1,2
3829071,3829306,235,0,0,1,1
3829307,3829334,27,1,0,0,1
3829335,3829960,625,0,0,1,1
3829536,3829554,18,1,0,0,2
3829555,3830188,633,0,0,1,2
3829961,3830004,43,1,0,0,1
3830005,3830699,694,0,0,1,1
3830189,3830203,14,1,0,0,2
3830204,3830696,492,0,0,1,2
3830697,3830923,226,1,0,0,2
3830700,3830921,221,1,0,0,1
3830719,3830888,169,0,1,0,2
3830722,3830880,158,0,1,0,1
3830922,3831122,200,0,0,1,1
3830924,3831122,198,0,0,1,2
3831123,3831194,71,1,0,0,2
3831123,3831195,72,1,0,0,1
3831195,3831273,78,0,0,1,2
3831196,3831273,77,0,0,1,1
3831274,3831308,34,1,0,0,1
3831274,3831310,36,1,0,0,2
3831309,3831489,180,0,0,1,1
3831311,3831489,178,0,0,1,2
3831490,3831508,18,1,0,0,2
3831490,3831514,24,1,0,0,1
3831509,3833385,1876,0,0,1,2
3831515,3833385,1870,0,0,1,1
3833386,3833411,25,1,0,0,1
3833386,3833423,37,1,0,0,2
3833412,3833830,418,0,0,1,1
3833424,3833830,406,0,0,1,2
3833831,3833923,92,1,0,0,2
3833831,3833924,93,1,0,0,1
3833924,3833992,68,0,0,1,2
3833925,3833991,66,0,0,1,1
3833992,3834042,50,1,0,0,1
3833993,3834045,52,1,0,0,2
3834043,3834155,112,0,0,1,1
3834046,3834160,114,0,0,1,2
3834156,3834168,12,1,0,0,1
3834161,3834180,19,1,0,0,2
3834169,3834354,185,0,0,1,1
3834181,3834866,685,0,0,1,2
3834355,3834369,14,1,0,0,1
3834370,3834866,496,0,0,1,1
3834867,3834889,22,1,0,0,2
3834867,3834901,34,1,0,0,1
3834890,3835567,677,0,0,1,2
3834902,3835052,150,0,0,1,1
3835053,3835068,15,1,0,0,1
3835069,3835565,496,0,0,1,1
3835566,3835618,52,1,0,0,1
3835568,3835607,39,1,0,0,2
3835608,3835941,333,0,0,1,2
3835619,3835940,321,0,0,1,1
3835941,3835996,55,1,0,0,1
3835942,3835996,54,1,0,0,2
3835997,3836135,138,0,0,1,1
3835997,3836141,144,0,0,1,2
3836136,3836161,25,1,0,0,1
3836142,3836160,18,1,0,0,2
3836161,3837426,1265,0,0,1,2
3836162,3837421,1259,0,0,1,1
3837422,3837483,61,1,0,0,1
3837427,3837436,9,1,0,0,2
3837437,3837869,432,0,0,1,2
3837484,3837869,385,0,0,1,1
3837870,3837915,45,1,0,0,1
3837870,3837916,46,1,0,0,2
3837916,3839766,1850,0,0,1,1
3837917,3839767,1850,0,0,1,2
3839767,3839827,60,1,0,0,1
3839768,3839828,60,1,0,0,2
3839828,3839924,96,0,0,1,1
3839829,3839924,95,0,0,1,2
3839925,3839947,22,1,0,0,2
3839925,3839954,29,1,0,0,1
3839948,3840137,189,0,0,1,2
3839955,3840138,183,0,0,1,1
3840138,3840150,12,1,0,0,2
3840139,3840149,10,1,0,0,1
3840150,3841974,1824,0,0,1,1
3840151,3841973,1822,0,0,1,2
3841974,3842098,124,1,0,0,2
3841975,3842099,124,1,0,0,1
3842099,3842147,48,0,0,1,2
3842100,3842147,47,0,0,1,1
3842148,3842213,65,1,0,0,1
3842148,3842214,66,1,0,0,2
3842214,3842406,192,0,0,1,1
3842215,3842401,186,0,0,1,2
3842402,3842674,272,1,0,0,2
3842407,3842653,246,1,0,0,1
3842428,3842607,179,0,1,0,2
3842434,3842604,170,0,1,0,1
3842654,3842806,152,0,0,1,1
3842675,3842805,130,0,0,1,2
3842806,3842822,16,1,0,0,2
3842807,3842823,16,1,0,0,1
3842823,3843055,232,0,0,1,2
3842824,3843055,231,0,0,1,1
3843056,3843083,27,1,0,0,1
3843056,3843086,30,1,0,0,2
3843084,3843390,306,0,0,1,1
3843087,3843608,521,0,0,1,2
3843391,3843395,4,1,0,0,1
3843396,3843604,208,0,0,1,1
3843605,3843633,28,1,0,0,1
3843609,3843632,23,1,0,0,2
3843633,3844643,1010,0,0,1,2
3843634,3844651,1017,0,0,1,1
3844644,3844976,332,1,0,0,2
3844652,3845054,402,1,0,0,1
3844691,3844928,237,0,1,0,2
3844699,3844941,242,0,1,0,1
3844977,3845003,26,0,0,1,2
3845004,3845046,42,1,0,0,2
3845047,3845156,109,0,0,1,2
3845055,3845157,102,0,0,1,1
3845157,3845178,21,1,0,0,2
3845158,3845178,20,1,0,0,1
3845179,3845438,259,0,0,1,2
3845179,3845439,260,0,0,1,1
3845439,3845773,334,1,0,0,2
3845440,3845810,370,1,0,0,1
3845457,3845725,268,0,1,0,2
3845458,3845748,290,0,1,0,1
3845774,3845872,98,0,0,1,2
3845811,3845876,65,0,0,1,1
3845873,3845887,14,1,0,0,2
3845877,3845887,10,1,0,0,1
3845888,3847301,1413,0,0,1,1
3845888,3847791,1903,0,0,1,2
3847302,3847319,17,1,0,0,1
3847320,3847792,472,0,0,1,1
3847792,3847874,82,1,0,0,2
3847793,3847883,90,1,0,0,1
3847875,3847982,107,0,0,1,2
3847884,3847985,101,0,0,1,1
3847983,3848016,33,1,0,0,2
3847986,3848028,42,1,0,0,1
3848017,3848182,165,0,0,1,2
3848029,3848178,149,0,0,1,1
3848179,3848205,26,1,0,0,1
3848183,3848203,20,1,0,0,2
3848204,3848526,322,0,0,1,2
3848206,3848522,316,0,0,1,1
3848523,3848559,36,1,0,0,1
3848527,3848550,23,1,0,0,2
3848551,3850315,1764,0,0,1,2
3848560,3848971,411,0,0,1,1
3848972,3849014,42,1,0,0,1
3849015,3849198,183,0,0,1,1
3849199,3849242,43,1,0,0,1
3849243,3849324,81,0,0,1,1
3849325,3849361,36,1,0,0,1
3849362,3849720,358,0,0,1,1
3849721,3849752,31,1,0,0,1
3849753,3849785,32,0,0,1,1
3849786,3849833,47,1,0,0,1
3849834,3850313,479,0,0,1,1
3850314,3850432,118,1,0,0,1
3850316,3850439,123,1,0,0,2
3850433,3850513,80,0,0,1,1
3850440,3850512,72,0,0,1,2
3850513,3850559,46,1,0,0,2
3850514,3850567,53,1,0,0,1
3850560,3850717,157,0,0,1,2
3850568,3850716,148,0,0,1,1
3850717,3850728,11,1,0,0,1
3850718,3850728,10,1,0,0,2
3850729,3850972,243,0,0,1,1
3850729,3850976,247,0,0,1,2
3850973,3850991,18,1,0,0,1
3850977,3850998,21,1,0,0,2
3850992,3852377,1385,0,0,1,1
3850999,3851281,282,0,0,1,2
3851282,3851286,4,1,0,0,2
3851287,3852376,1089,0,0,1,2
3852377,3852514,137,1,0,0,2
3852378,3852512,134,1,0,0,1
3852513,3852605,92,0,0,1,1
3852515,3852606,91,0,0,1,2
3852606,3852670,64,1,0,0,1
3852607,3852658,51,1,0,0,2
3852659,3852720,61,0,0,1,2
3852671,3852730,59,0,0,1,1
3852721,3853087,366,1,0,0,2
3852731,3852995,264,1,0,0,1
3852747,3852947,200,0,1,0,2
3852750,3852940,190,0,1,0,1
3852996,3853066,70,0,0,1,1
3853067,3853094,27,1,0,0,1
3853088,3854179,1091,0,0,1,2
3853095,3854176,1081,0,0,1,1
3854177,3854209,32,1,0,0,1
3854180,3854207,27,1,0,0,2
3854208,3854518,310,0,0,1,2
3854210,3854518,308,0,0,1,1
3854519,3854537,18,1,0,0,2
3854519,3854540,21,1,0,0,1
3854538,3854988,450,0,0,1,2
3854541,3854989,448,0,0,1,1
3854989,3855071,82,1,0,0,2
3854990,3855072,82,1,0,0,1
3855072,3855143,71,0,0,1,2
3855073,3855143,70,0,0,1,1
3855144,3855178,34,1,0,0,2
3855144,3855180,36,1,0,0,1
3855179,3855952,773,0,0,1,2
3855181,3855399,218,0,0,1,1
3855400,3855415,15,1,0,0,1
3855416,3855951,535,0,0,1,1
3855952,3855969,17,1,0,0,1
3855953,3855968,15,1,0,0,2
3855969,3857060,1091,0,0,1,2
3855970,3857059,1089,0,0,1,1
3857060,3857119,59,1,0,0,1
3857061,3857120,59,1,0,0,2
3857120,3857259,139,0,0,1,1
3857121,3857260,139,0,0,1,2
3857260,3857286,26,1,0,0,1
3857261,3857277,16,1,0,0,2
3857278,3857744,466,0,0,1,2
3857287,3857750,463,0,0,1,1
3857745,3858036,291,1,0,0,2
3857751,3858039,288,1,0,0,1
3857766,3857990,224,0,1,0,2
3857769,3857994,225,0,1,0,1
3858037,3859698,1661,0,0,1,2
3858040,3859698,1658,0,0,1,1
3859699,3859770,71,1,0,0,1
3859699,3859771,72,1,0,0,2
3859771,3859853,82,0,0,1,1
3859772,3859853,81,0,0,1,2
3859854,3859881,27,1,0,0,2
3859854,3859903,49,1,0,0,1
3859882,3860082,200,0,0,1,2
3859904,3860069,165,0,0,1,1
3860070,3860091,21,1,0,0,1
3860083,3860093,10,1,0,0,2
3860092,3860523,431,0,0,1,1
3860094,3860519,425,0,0,1,2
3860520,3860552,32,1,0,0,2
3860524,3860552,28,1,0,0,1
3860553,3861460,907,0,0,1,1
3860553,3861461,908,0,0,1,2
3861461,3861488,27,1,0,0,1
3861462,3861477,15,1,0,0,2
3861478,3861893,415,0,0,1,2
3861489,3861892,403,0,0,1,1
3861893,3861945,52,1,0,0,1
3861894,3861946,52,1,0,0,2
3861946,3862095,149,0,0,1,1
3861947,3862094,147,0,0,1,2
3862095,3862118,23,1,0,0,2
3862096,3862116,20,1,0,0,1
3862117,3863818,1701,0,0,1,1
3862119,3863818,1699,0,0,1,2
3863819,3863930,111,1,0,0,1
3863819,3863978,159,1,0,0,2
3863931,3864072,141,0,0,1,1
3863979,3864072,93,0,0,1,2
3864073,3864295,222,1,0,0,1
3864073,3864342,269,1,0,0,2
3864123,3864258,135,0,1,0,2
3864126,3864258,132,0,1,0,1
3864296,3864434,138,0,0,1,1
3864343,3864431,88,0,0,1,2
3864432,3864449,17,1,0,0,2
3864435,3864451,16,1,0,0,1
3864450,3865287,837,0,0,1,2
3864452,3865274,822,0,0,1,1
3865275,3865303,28,1,0,0,1
3865288,3865297,9,1,0,0,2
3865298,3865792,494,0,0,1,2
3865304,3865792,488,0,0,1,1
3865793,3865886,93,1,0,0,2
3865793,3865887,94,1,0,0,1
3865887,3866341,454,0,0,1,2
3865888,3866343,455,0,0,1,1
3866342,3866418,76,1,0,0,2
3866344,3866418,74,1,0,0,1
3866419,3866540,121,0,0,1,1
3866419,3866540,121,0,0,1,2
3866541,3866563,22,1,0,0,1
3866541,3866565,24,1,0,0,2
3866564,3866628,64,0,0,1,1
3866566,3866616,50,0,0,1,2
3866617,3867327,710,1,0,0,2
3866629,3867411,782,1,0,0,1
3866641,3867308,667,0,1,0,2
3866643,3867350,707,0,1,0,1
3867328,3867393,65,0,0,1,2
3867394,3867410,16,1,0,0,2
3867411,3868341,930,0,0,1,2
3867412,3868015,603,0,0,1,1
3868016,3868021,5,1,0,0,1
3868022,3868331,309,0,0,1,1
3868332,3868354,22,1,0,0,1
3868342,3868355,13,1,0,0,2
3868355,3869337,982,0,0,1,1
3868356,3869339,983,0,0,1,2
3869338,3869391,53,1,0,0,1
3869340,3869389,49,1,0,0,2
3869390,3871771,2381,0,0,1,2
3869392,3871770,2378,0,0,1,1
3871771,3871832,61,1,0,0,1
3871772,3871832,60,1,0,0,2
3871833,3872649,816,0,0,1,1
3871833,3872649,816,0,0,1,2
3872650,3872707,57,1,0,0,2
3872650,3872716,66,1,0,0,1
3872708,3872829,121,0,0,1,2
3872717,3872828,111,0,0,1,1
3872829,3872857,28,1,0,0,1
3872830,3872851,21,1,0,0,2
3872852,3874904,2052,0,0,1,2
3872858,3874904,2046,0,0,1,1
3874905,3874956,51,1,0,0,1
3874905,3874966,61,1,0,0,2
3874957,3875071,114,0,0,1,1
3874967,3875073,106,0,0,1,2
3875072,3875097,25,1,0,0,1
3875074,3875112,38,1,0,0,2
3875098,3877085,1987,0,0,1,1
3875113,3877084,1971,0,0,1,2
3877085,3877388,303,1,0,0,2
3877086,3877348,262,1,0,0,1
3877111,3877306,195,0,1,0,2
3877115,3877300,185,0,1,0,1
3877349,3878798,1449,0,0,1,1
3877389,3878799,1410,0,0,1,2
3878799,3878826,27,1,0,0,1
3878800,3878824,24,1,0,0,2
3878825,3879002,177,0,0,1,2
3878827,3880529,1702,0,0,1,1
3879003,3879012,9,1,0,0,2
3879013,3880529,1516,0,0,1,2
3880530,3880577,47,1,0,0,2
3880530,3880579,49,1,0,0,1
3880578,3882899,2321,0,0,1,2
3880580,3880808,228,0,0,1,1
3880809,3880823,14,1,0,0,1
3880824,3882896,2072,0,0,1,1
3882897,3883168,271,1,0,0,1
3882900,3883173,273,1,0,0,2
3882930,3883116,186,0,1,0,2
3882930,3883122,192,0,1,0,1
3883169,3884317,1148,0,0,1,1
3883174,3884319,1145,0,0,1,2
3884318,3884393,75,1,0,0,1
3884320,3884396,76,1,0,0,2
3884394,3884505,111,0,0,1,1
3884397,3884505,108,0,0,1,2
3884506,3884527,21,1,0,0,1
3884506,3884527,21,1,0,0,2
3884528,3884734,206,0,0,1,1
3884528,3884734,206,0,0,1,2
3884735,3884754,19,1,0,0,2
3884735,3884756,21,1,0,0,1
3884755,3885857,1102,0,0,1,2
3884757,3885857,1100,0,0,1,1
3885858,3885912,54,1,0,0,2
3885858,3885917,59,1,0,0,1
3885913,3886108,195,0,0,1,2
3885918,3886109,191,0,0,1,1
3886109,3886132,23,1,0,0,2
3886110,3886132,22,1,0,0,1
3886133,3888347,2214,0,0,1,1
3886133,3888348,2215,0,0,1,2
3888348,3888415,67,1,0,0,1
3888349,3888419,70,1,0,0,2
3888416,3889280,864,0,0,1,1
3888420,3889279,859,0,0,1,2
3889280,3889357,77,1,0,0,2
3889281,3889356,75,1,0,0,1
3889357,3889425,68,0,0,1,1
3889358,3889415,57,0,0,1,2
3889416,3889710,294,1,0,0,2
3889426,3889762,336,1,0,0,1
3889441,3889672,231,0,1,0,2
3889442,3889671,229,0,1,0,1
3889711,3889841,130,0,0,1,2
3889763,3889844,81,0,0,1,1
3889842,3889854,12,1,0,0,2
3889845,3889860,15,1,0,0,1
3889855,3891263,1408,0,0,1,2
3889861,3890058,197,0,0,1,1
3890059,3890174,115,1,0,0,1
3890175,3890712,537,0,0,1,1
3890713,3890724,11,1,0,0,1
3890725,3891262,537,0,0,1,1
3891263,3891301,38,1,0,0,1
3891264,3891298,34,1,0,0,2
3891299,3893570,2271,0,0,1,2
3891302,3893573,2271,0,0,1,1
3893571,3893862,291,1,0,0,2
3893574,3893865,291,1,0,0,1
3893597,3893817,220,0,1,0,2
3893599,3893826,227,0,1,0,1
3893863,3894693,830,0,0,1,2
3893866,3894692,826,0,0,1,1
3894693,3894766,73,1,0,0,1
3894694,3894775,81,1,0,0,2
3894767,3894894,127,0,0,1,1
3894776,3894894,118,0,0,1,2
3894895,3894924,29,1,0,0,1
3894895,3894925,30,1,0,0,2
3894925,3895188,263,0,0,1,1
3894926,3895187,261,0,0,1,2
3895188,3895200,12,1,0,0,2
3895189,3895207,18,1,0,0,1
3895201,3896213,1012,0,0,1,2
3895208,3896213,1005,0,0,1,1
3896214,3896271,57,1,0,0,2
3896214,3896282,68,1,0,0,1
3896272,3896483,211,0,0,1,2
3896283,3896483,200,0,0,1,1
3896484,3896514,30,1,0,0,2
3896484,3896517,33,1,0,0,1
3896515,3898653,2138,0,0,1,2
3896518,3898651,2133,0,0,1,1
3898652,3898726,74,1,0,0,1
3898654,3898716,62,1,0,0,2
3898717,3899519,802,0,0,1,2
3898727,3899518,791,0,0,1,1
3899519,3899734,215,1,0,0,1
3899520,3899751,231,1,0,0,2
3899577,3899688,111,0,1,0,2
3899578,3899689,111,0,1,0,1
3899735,3899825,90,0,0,1,1
3899752,3899824,72,0,0,1,2
3899825,3899843,18,1,0,0,2
3899826,3899846,20,1,0,0,1
3899844,3900361,517,0,0,1,2
3899847,3900360,513,0,0,1,1
3900361,3900388,27,1,0,0,1
3900362,3900391,29,1,0,0,2
3900389,3901241,852,0,0,1,1
3900392,3901243,851,0,0,1,2
3901242,3901326,84,1,0,0,1
3901244,3901315,71,1,0,0,2
3901316,3901431,115,0,0,1,2
3901327,3901434,107,0,0,1,1
3901432,3901469,37,1,0,0,2
3901435,3901457,22,1,0,0,1
3901458,3901660,202,0,0,1,1
3901470,3901662,192,0,0,1,2
3901661,3901694,33,1,0,0,1
3901663,3901693,30,1,0,0,2
3901694,3903483,1789,0,0,1,2
3901695,3903368,1673,0,0,1,1
3903369,3903380,11,1,0,0,1
3903381,3903485,104,0,0,1,1
3903484,3903816,332,1,0,0,2
3903486,3903787,301,1,0,0,1
3903512,3903737,225,0,1,0,2
3903516,3903741,225,0,1,0,1
3903788,3904902,1114,0,0,1,1
3903817,3904902,1085,0,0,1,2
3904903,3904959,56,1,0,0,2
3904903,3904962,59,1,0,0,1
3904960,3905076,116,0,0,1,2
3904963,3905074,111,0,0,1,1
3905075,3905120,45,1,0,0,1
3905077,3905096,19,1,0,0,2
3905097,3905362,265,0,0,1,2
3905121,3906181,1060,0,0,1,1
3905363,3905372,9,1,0,0,2
3905373,3906182,809,0,0,1,2
3906182,3906251,69,1,0,0,1
3906183,3906252,69,1,0,0,2
3906252,3906396,144,0,0,1,1
3906253,3906396,143,0,0,1,2
3906397,3906436,39,1,0,0,1
3906397,3906437,40,1,0,0,2
3906437,3908045,1608,0,0,1,1
3906438,3908046,1608,0,0,1,2
3908046,3908076,30,1,0,0,1
3908047,3908077,30,1,0,0,2
3908077,3908416,339,0,0,1,1
3908078,3908414,336,0,0,1,2
3908415,3908683,268,1,0,0,2
3908417,3908699,282,1,0,0,1
3908434,3908643,209,0,1,0,2
3908437,3908646,209,0,1,0,1
3908684,3909473,789,0,0,1,2
3908700,3909472,772,0,0,1,1
3909473,3909543,70,1,0,0,1
3909474,3909544,70,1,0,0,2
3909544,3909674,130,0,0,1,1
3909545,3909673,128,0,0,1,2
3909674,3909702,28,1,0,0,2
3909675,3909702,27,1,0,0,1
3909703,3909995,292,0,0,1,2
3909703,3910002,299,0,0,1,1
3909996,3910023,27,1,0,0,2
3910003,3910023,20,1,0,0,1
3910024,3911081,1057,0,0,1,1
3910024,3911083,1059,0,0,1,2
3911082,3911111,29,1,0,0,1
3911084,3911101,17,1,0,0,2
3911102,3911293,191,0,0,1,2
3911112,3911294,182,0,0,1,1
3911294,3911364,70,1,0,0,2
3911295,3911364,69,1,0,0,1
3911365,3911573,208,0,0,1,1
3911365,3911575,210,0,0,1,2
3911574,3911600,26,1,0,0,1
3911576,3911601,25,1,0,0,2
3911601,3913377,1776,0,0,1,1
3911602,3913377,1775,0,0,1,2
3913378,3913679,301,1,0,0,2
3913378,3913704,326,1,0,0,1
3913407,3913641,234,0,1,0,2
3913412,3913659,247,0,1,0,1
3913680,3914827,1147,0,0,1,2
3913705,3914826,1121,0,0,1,1
3914827,3914896,69,1,0,0,1
3914828,3914897,69,1,0,0,2
3914897,3914993,96,0,0,1,1
3914898,3914993,95,0,0,1,2
3914994,3915023,29,1,0,0,2
3914994,3915024,30,1,0,0,1
3915024,3915185,161,0,0,1,2
3915025,3915185,160,0,0,1,1
3915186,3915196,10,1,0,0,2
3915186,3915198,12,1,0,0,1
3915197,3916047,850,0,0,1,2
3915199,3916046,847,0,0,1,1
3916047,3916071,24,1,0,0,1
3916048,3916063,15,1,0,0,2
3916064,3916233,169,0,0,1,2
3916072,3916233,161,0,0,1,1
3916234,3916304,70,1,0,0,2
3916234,3916308,74,1,0,0,1
3916305,3916485,180,0,0,1,2
3916309,3916485,176,0,0,1,1
3916486,3916515,29,1,0,0,1
3916486,3916527,41,1,0,0,2
3916516,3917632,1116,0,0,1,1
3916528,3917632,1104,0,0,1,2
3917633,3917666,33,1,0,0,1
3917633,3917666,33,1,0,0,2
3917667,3918760,1093,0,0,1,2
3917667,3918767,1100,0,0,1,1
3918761,3918993,232,1,0,0,2
3918768,3918983,215,1,0,0,1
3918780,3918954,174,0,1,0,2
3918787,3918933,146,0,1,0,1
3918984,3919504,520,0,0,1,1
3918994,3919505,511,0,0,1,2
3919505,3919593,88,1,0,0,1
3919506,3919592,86,1,0,0,2
3919593,3919708,115,0,0,1,2
3919594,3919707,113,0,0,1,1
3919708,3919734,26,1,0,0,1
3919709,3919739,30,1,0,0,2
3919735,3919887,152,0,0,1,1
3919740,3919892,152,0,0,1,2
3919888,3919913,25,1,0,0,1
3919893,3919911,18,1,0,0,2
3919912,3921464,1552,0,0,1,2
3919914,3921465,1551,0,0,1,1
3921465,3921539,74,1,0,0,2
3921466,3921541,75,1,0,0,1
3921540,3923722,2182,0,0,1,2
3921542,3923726,2184,0,0,1,1
3923723,3924021,298,1,0,0,2
3923727,3924048,321,1,0,0,1
3923769,3923986,217,0,1,0,2
3923770,3923998,228,0,1,0,1
3924022,3924544,522,0,0,1,2
3924049,3924544,495,0,0,1,1
3924545,3924597,52,1,0,0,1
3924545,3924598,53,1,0,0,2
3924598,3925393,795,0,0,1,1
3924599,3925393,794,0,0,1,2
3925394,3925468,74,1,0,0,1
3925394,3925469,75,1,0,0,2
3925469,3925569,100,0,0,1,1
3925470,3925570,100,0,0,1,2
3925570,3925601,31,1,0,0,1
3925571,3925600,29,1,0,0,2
3925601,3927980,2379,0,0,1,2
3925602,3925898,296,0,0,1,1
3925899,3925919,20,1,0,0,1
3925920,3927980,2060,0,0,1,1
3927981,3928025,44,1,0,0,2
3927981,3928031,50,1,0,0,1
3928026,3928171,145,0,0,1,2
3928032,3928170,138,0,0,1,1
3928171,3928200,29,1,0,0,1
3928172,3928189,17,1,0,0,2
3928190,3930438,2248,0,0,1,2
3928201,3930445,2244,0,0,1,1
3930439,3930767,328,1,0,0,2
3930446,3930730,284,1,0,0,1
3930466,3930686,220,0,1,0,2
3930474,3930664,190,0,1,0,1
3930731,3931894,1163,0,0,1,1
3930768,3931894,1126,0,0,1,2
3931895,3931943,48,1,0,0,2
3931895,3931954,59,1,0,0,1
3931944,3932061,117,0,0,1,2
3931955,3932059,104,0,0,1,1
3932060,3932090,30,1,0,0,1
3932062,3932080,18,1,0,0,2
3932081,3933978,1897,0,0,1,2
3932091,3932282,191,0,0,1,1
3932283,3932301,18,1,0,0,1
3932302,3933977,1675,0,0,1,1
3933978,3934021,43,1,0,0,1
3933979,3934027,48,1,0,0,2
3934022,3934104,82,0,0,1,1
3934028,3934104,76,0,0,1,2
3934105,3934132,27,1,0,0,2
3934105,3934138,33,1,0,0,1
3934133,3936237,2104,0,0,1,2
3934139,3934290,151,0,0,1,1
3934291,3934303,12,1,0,0,1
3934304,3936240,1936,0,0,1,1
3936238,3936637,399,1,0,0,2
3936241,3936639,398,1,0,0,1
3936258,3936546,288,0,1,0,2
3936262,3936589,327,0,1,0,1
3936638,3937429,791,0,0,1,2
3936640,3937426,786,0,0,1,1
3937427,3937778,351,1,0,0,1
3937430,3937797,367,1,0,0,2
3937449,3937719,270,0,1,0,1
3937449,3937722,273,0,1,0,2
3937779,3937885,106,0,0,1,1
3937798,3937884,86,0,0,1,2
3937885,3937944,59,1,0,0,2
3937886,3937943,57,1,0,0,1
3937944,3938051,107,0,0,1,1
3937945,3938051,106,0,0,1,2
3938052,3938073,21,1,0,0,1
3938052,3938082,30,1,0,0,2
3938074,3938167,93,0,0,1,1
3938083,3940163,2080,0,0,1,2
3938168,3938186,18,1,0,0,1
3938187,3938350,163,0,0,1,1
3938351,3938405,54,1,0,0,1
3938406,3938447,41,0,0,1,1
3938448,3938476,28,1,0,0,1
3938477,3940162,1685,0,0,1,1
3940163,3940243,80,1,0,0,1
3940164,3940232,68,1,0,0,2
3940233,3940365,132,0,0,1,2
3940244,3940366,122,0,0,1,1
3940366,3940402,36,1,0,0,2
3940367,3940396,29,1,0,0,1
3940397,3940471,74,0,0,1,1
3940403,3940473,70,0,0,1,2
3940472,3940506,34,1,0,0,1
3940474,3940495,21,1,0,0,2
3940496,3942363,1867,0,0,1,2
3940507,3942372,1865,0,0,1,1
3942364,3942694,330,1,0,0,2
3942373,3942674,301,1,0,0,1
3942403,3942639,236,0,1,0,2
3942407,3942620,213,0,1,0,1
3942675,3942951,276,0,0,1,1
3942695,3942749,54,0,0,1,2
3942750,3942758,8,1,0,0,2
3942759,3942953,194,0,0,1,2
3942952,3942991,39,1,0,0,1
3942954,3942991,37,1,0,0,2
3942992,3943786,794,0,0,1,1
3942992,3943786,794,0,0,1,2
3943787,3943876,89,1,0,0,2
3943787,3943881,94,1,0,0,1
3943877,3944015,138,0,0,1,2
3943882,3944018,136,0,0,1,1
3944016,3944032,16,1,0,0,2
3944019,3944030,11,1,0,0,1
3944031,3944762,731,0,0,1,1
3944033,3944761,728,0,0,1,2
3944762,3944776,14,1,0,0,2
3944763,3944778,15,1,0,0,1
3944777,3945425,648,0,0,1,2
3944779,3945421,642,0,0,1,1
3945422,3945440,18,1,0,0,1
3945426,3945438,12,1,0,0,2
3945439,3945871,432,0,0,1,2
3945441,3945870,429,0,0,1,1
3945871,3945907,36,1,0,0,1
3945872,3945909,37,1,0,0,2
3945908,3946168,260,0,0,1,1
3945910,3946169,259,0,0,1,2
3946169,3946187,18,1,0,0,1
3946170,3946193,23,1,0,0,2
3946188,3948210,2022,0,0,1,1
3946194,3948209,2015,0,0,1,2
3948210,3948451,241,1,0,0,2
3948211,3948482,271,1,0,0,1
3948237,3948416,179,0,1,0,2
3948238,3948423,185,0,1,0,1
3948452,3949437,985,0,0,1,2
3948483,3949437,954,0,0,1,1
3949438,3949523,85,1,0,0,2
3949438,3949532,94,1,0,0,1
3949524,3949622,98,0,0,1,2
3949533,3949622,89,0,0,1,1
3949623,3949657,34,1,0,0,2
3949623,3949665,42,1,0,0,1
3949658,3949819,161,0,0,1,2
3949666,3949819,153,0,0,1,1
3949820,3949847,27,1,0,0,1
3949820,3949849,29,1,0,0,2
3949848,3951604,1756,0,0,1,1
3949850,3951605,1755,0,0,1,2
3951605,3951675,70,1,0,0,1
3951606,3951663,57,1,0,0,2
3951664,3951911,247,0,0,1,2
3951676,3951908,232,0,0,1,1
3951909,3951923,14,1,0,0,1
3951912,3951922,10,1,0,0,2
3951923,3954103,2180,0,0,1,2
3951924,3954111,2187,0,0,1,1
3954104,3954353,249,1,0,0,2
3954112,3954340,228,1,0,0,1
3954132,3954289,157,0,1,0,2
3954135,3954287,152,0,1,0,1
3954341,3954618,277,0,0,1,1
3954354,3954618,264,0,0,1,2
3954619,3954681,62,1,0,0,1
3954619,3954681,62,1,0,0,2
3954682,3955426,744,0,0,1,2
3954682,3955427,745,0,0,1,1
3955427,3955502,75,1,0,0,2
3955428,3955509,81,1,0,0,1
3955503,3955641,138,0,0,1,2
3955510,3955646,136,0,0,1,1
3955642,3955659,17,1,0,0,2
3955647,3955683,36,1,0,0,1
3955660,3956008,348,0,0,1,2
3955684,3956008,324,0,0,1,1
3956009,3956036,27,1,0,0,2
3956009,3956073,64,1,0,0,1
3956037,3956217,180,0,0,1,2
3956074,3957151,1077,0,0,1,1
3956218,3956226,8,1,0,0,2
3956227,3957151,924,0,0,1,2
3957152,3957198,46,1,0,0,1
3957152,3957206,54,1,0,0,2
3957199,3959368,2169,0,0,1,1
3957207,3959369,2162,0,0,1,2
3959369,3959696,327,1,0,0,1
3959370,3959707,337,1,0,0,2
3959430,3959652,222,0,1,0,1
3959436,3959653,217,0,1,0,2
3959697,3960427,730,0,0,1,1
3959708,3960427,719,0,0,1,2
3960428,3960486,58,1,0,0,1
3960428,3960488,60,1,0,0,2
3960487,3960592,105,0,0,1,1
3960489,3960595,106,0,0,1,2
3960593,3960637,44,1,0,0,1
3960596,3960614,18,1,0,0,2
3960615,3962258,1643,0,0,1,2
3960638,3961701,1063,0,0,1,1
3961702,3961771,69,1,0,0,1
3961772,3962258,486,0,0,1,1
3962259,3962320,61,1,0,0,2
3962259,3962322,63,1,0,0,1
3962321,3962429,108,0,0,1,2
3962323,3962429,106,0,0,1,1
3962430,3962452,22,1,0,0,1
3962430,3962452,22,1,0,0,2
3962453,3964471,2018,0,0,1,2
3962453,3964477,2024,0,0,1,1
3964472,3964779,307,1,0,0,2
3964478,3964784,306,1,0,0,1
3964494,3964735,241,0,1,0,2
3964498,3964743,245,0,1,0,1
3964780,3965945,1165,0,0,1,2
3964785,3965946,1161,0,0,1,1
3965946,3966022,76,1,0,0,2
3965947,3966023,76,1,0,0,1
3966023,3966206,183,0,0,1,2
3966024,3966202,178,0,0,1,1
3966203,3966220,17,1,0,0,1
3966207,3966216,9,1,0,0,2
3966217,3967093,876,0,0,1,2
3966221,3967093,872,0,0,1,1
3967094,3967117,23,1,0,0,1
3967094,3967118,24,1,0,0,2
3967118,3967306,188,0,0,1,1
3967119,3967301,182,0,0,1,2
3967302,3967311,9,1,0,0,2
3967307,3967312,5,1,0,0,1
3967312,3967831,519,0,0,1,2
3967313,3967831,518,0,0,1,1
3967832,3967873,41,1,0,0,1
3967832,3967875,43,1,0,0,2
3967874,3968062,188,0,0,1,1
3967876,3970022,2146,0,0,1,2
3968063,3968077,14,1,0,0,1
3968078,3970025,1947,0,0,1,1
3970023,3970363,340,1,0,0,2
3970026,3970391,365,1,0,0,1
3970055,3970316,261,0,1,0,2
3970056,3970329,273,0,1,0,1
3970364,3970442,78,0,0,1,2
3970392,3970440,48,0,0,1,1
3970441,3970490,49,1,0,0,1
3970443,3970489,46,1,0,0,2
3970490,3970770,280,0,0,1,2
3970491,3970770,279,0,0,1,1
3970771,3970808,37,1,0,0,2
3970771,3970817,46,1,0,0,1
3970809,3971496,687,0,0,1,2
3970818,3971496,678,0,0,1,1
3971497,3971568,71,1,0,0,2
3971497,3971569,72,1,0,0,1
3971569,3971688,119,0,0,1,2
3971570,3971688,118,0,0,1,1
3971689,3971712,23,1,0,0,2
3971689,3971713,24,1,0,0,1
3971713,3971862,149,0,0,1,2
3971714,3971853,139,0,0,1,1
3971854,3971879,25,1,0,0,1
3971863,3971873,10,1,0,0,2
3971874,3973211,1337,0,0,1,2
3971880,3972090,210,0,0,1,1
3972091,3972111,20,1,0,0,1
3972112,3973209,1097,0,0,1,1
3973210,3973256,46,1,0,0,1
3973212,3973254,42,1,0,0,2
3973255,3973396,141,0,0,1,2
3973257,3973395,138,0,0,1,1
3973396,3973422,26,1,0,0,1
3973397,3973411,14,1,0,0,2
3973412,3973621,209,0,0,1,2
3973423,3973620,197,0,0,1,1
3973621,3973626,5,1,0,0,1
3973622,3973635,13,1,0,0,2
3973627,3974308,681,0,0,1,1
3973636,3974311,675,0,0,1,2
3974309,3974338,29,1,0,0,1
3974312,3974334,22,1,0,0,2
3974335,3975347,1012,0,0,1,2
3974339,3975348,1009,0,0,1,1
3975348,3975389,41,1,0,0,2
3975349,3975380,31,1,0,0,1
3975381,3975533,152,0,0,1,1
3975390,3975533,143,0,0,1,2
3975534,3975780,246,1,0,0,2
3975534,3975795,261,1,0,0,1
3975551,3975735,184,0,1,0,2
3975554,3975737,183,0,1,0,1
3975781,3975854,73,0,0,1,2
3975796,3975856,60,0,0,1,1
3975855,3975895,40,1,0,0,2
3975857,3975894,37,1,0,0,1
3975895,3976771,876,0,0,1,1
3975896,3976770,874,0,0,1,2
3976771,3976836,65,1,0,0,2
3976772,3976845,73,1,0,0,1
3976837,3976978,141,0,0,1,2
3976846,3976972,126,0,0,1,1
3976973,3977000,27,1,0,0,1
3976979,3976995,16,1,0,0,2
3976996,3977267,271,0,0,1,2
3977001,3977263,262,0,0,1,1
3977264,3977290,26,1,0,0,1
3977268,3977290,22,1,0,0,2
3977291,3978581,1290,0,0,1,2
3977291,3979007,1716,0,0,1,1
3978582,3978591,9,1,0,0,2
3978592,3978658,66,0,0,1,2
3978659,3978673,14,1,0,0,2
3978674,3978701,27,0,0,1,2
3978702,3978726,24,1,0,0,2
3978727,3978974,247,0,0,1,2
3978975,3979051,76,1,0,0,2
3979008,3979047,39,1,0,0,1
3979048,3979160,112,0,0,1,1
3979052,3979158,106,0,0,1,2
3979159,3979184,25,1,0,0,2
3979161,3979183,22,1,0,0,1
3979184,3979450,266,0,0,1,1
3979185,3981095,1910,0,0,1,2
3979451,3979460,9,1,0,0,1
3979461,3981095,1634,0,0,1,1
3981096,3981129,33,1,0,0,1
3981096,3981136,40,1,0,0,2
3981130,3981278,148,0,0,1,1
3981137,3981274,137,0,0,1,2
3981275,3981626,351,1,0,0,2
3981279,3981613,334,1,0,0,1
3981300,3981519,219,0,1,0,2
3981302,3981522,220,0,1,0,1
3981614,3983068,1454,0,0,1,1
3981627,3983069,1442,0,0,1,2
3983069,3983156,87,1,0,0,1
3983070,3983166,96,1,0,0,2
3983157,3983284,127,0,0,1,1
3983167,3983283,116,0,0,1,2
3983284,3983311,27,1,0,0,2
3983285,3983317,32,1,0,0,1
3983312,3985619,2307,0,0,1,2
3983318,3985619,2301,0,0,1,1
3985620,3985657,37,1,0,0,2
3985620,3985667,47,1,0,0,1
3985658,3987736,2078,0,0,1,2
3985668,3987736,2068,0,0,1,1
3987737,3988273,536,1,0,0,2
3987737,3988331,594,1,0,0,1
3987760,3987970,210,0,1,0,2
3987764,3987976,212,0,1,0,1
3988033,3988274,241,0,1,0,1
3988034,3988242,208,0,1,0,2
3988274,3988521,247,0,0,1,2
3988332,3988521,189,0,0,1,1
3988522,3988563,41,1,0,0,1
3988522,3988564,42,1,0,0,2
3988564,3989597,1033,0,0,1,1
3988565,3989599,1034,0,0,1,2
3989598,3989687,89,1,0,0,1
3989600,3989678,78,1,0,0,2
3989679,3989774,95,0,0,1,2
3989688,3989774,86,0,0,1,1
3989775,3989801,26,1,0,0,2
3989775,3989808,33,1,0,0,1
3989802,3989954,152,0,0,1,2
3989809,3989947,138,0,0,1,1
3989948,3989976,28,1,0,0,1
3989955,3989972,17,1,0,0,2
3989973,3990467,494,0,0,1,2
3989977,3990467,490,0,0,1,1
3990468,3990489,21,1,0,0,2
3990468,3990490,22,1,0,0,1
3990490,3991721,1231,0,0,1,2
3990491,3991721,1230,0,0,1,1
3991722,3991785,63,1,0,0,2
3991722,3991795,73,1,0,0,1
3991786,3991929,143,0,0,1,2
3991796,3991929,133,0,0,1,1
3991930,3991960,30,1,0,0,2
3991930,3991961,31,1,0,0,1
3991961,3993808,1847,0,0,1,2
3991962,3993812,1850,0,0,1,1
3993809,3993828,19,1,0,0,2
3993813,3993826,13,1,0,0,1
3993827,3993946,119,0,0,1,1
3993829,3993952,123,0,0,1,2
3993947,3994304,357,1,0,0,1
3993953,3994189,236,1,0,0,2
3993970,3994223,253,0,1,0,1
3993972,3994174,202,0,1,0,2
3994190,3994414,224,0,0,1,2
3994305,3994416,111,0,0,1,1
3994415,3994496,81,1,0,0,2
3994417,3994498,81,1,0,0,1
3994497,3995603,1106,0,0,1,2
3994499,3995602,1103,0,0,1,1
3995603,3995651,48,1,0,0,1
3995604,3995649,45,1,0,0,2
3995650,3995848,198,0,0,1,2
3995652,3995847,195,0,0,1,1
3995848,3995946,98,1,0,0,1
3995849,3995938,89,1,0,0,2
3995939,3996073,134,0,0,1,2
3995947,3996074,127,0,0,1,1
3996074,3996109,35,1,0,0,2
3996075,3996103,28,1,0,0,1
3996104,3996350,246,0,0,1,1
3996110,3996355,245,0,0,1,2
3996351,3996374,23,1,0,0,1
3996356,3996373,17,1,0,0,2
3996374,3996625,251,0,0,1,2
3996375,3996621,246,0,0,1,1
3996622,3996648,26,1,0,0,1
3996626,3996648,22,1,0,0,2
3996649,3997310,661,0,0,1,1
3996649,3997310,661,0,0,1,2
3997311,3997376,65,1,0,0,1
3997311,3997377,66,1,0,0,2
3997377,3997502,125,0,0,1,1
3997378,3997501,123,0,0,1,2
3997502,3997543,41,1,0,0,2
3997503,3997535,32,1,0,0,1
3997536,3999702,2166,0,0,1,1
3997544,3999697,2153,0,0,1,2
3999698,3999883,185,1,0,0,2
3999703,3999936,233,1,0,0,1
3999737,3999846,109,0,1,0,1
3999739,3999830,91,0,1,0,2
3999884,3999920,36,0,0,1,2
3999921,3999926,5,1,0,0,2
3999927,4000608,681,0,0,1,2
3999937,4000607,670,0,0,1,1
4000608,4000656,48,1,0,0,1
4000609,4000661,52,1,0,0,2
4000657,4000787,130,0,0,1,1
4000662,4000787,125,0,0,1,2
4000788,4000868,80,1,0,0,2
4000788,4000870,82,1,0,0,1
4000869,4001039,170,0,0,1,2
4000871,4001038,167,0,0,1,1
4001039,4001062,23,1,0,0,1
4001040,4001062,22,1,0,0,2
4001063,4001303,240,0,0,1,2
4001063,4001306,243,0,0,1,1
4001304,4001322,18,1,0,0,2
4001307,4001329,22,1,0,0,1
4001323,4001789,466,0,0,1,2
4001330,4002327,997,0,0,1,1
4001790,4001802,12,1,0,0,2
4001803,4002326,523,0,0,1,2
4002327,4002352,25,1,0,0,2
4002328,4002347,19,1,0,0,1
4002348,4003263,915,0,0,1,1
4002353,4003262,909,0,0,1,2
4003263,4003319,56,1,0,0,2
4003264,4003319,55,1,0,0,1
4003320,4003470,150,0,0,1,1
4003320,4003472,152,0,0,1,2
4003471,4003492,21,1,0,0,1
4003473,4003490,17,1,0,0,2
4003491,4004047,556,0,0,1,2
4003493,4004048,555,0,0,1,1
4004048,4004079,31,1,0,0,2
4004049,4004081,32,1,0,0,1
4004080,4004189,109,0,0,1,2
4004082,4004188,106,0,0,1,1
4004189,4004204,15,1,0,0,1
4004190,4004204,14,1,0,0,2
4004205,4004706,501,0,0,1,1
4004205,4004707,502,0,0,1,2
4004707,4004729,22,1,0,0,1
4004708,4004728,20,1,0,0,2
4004729,4005482,753,0,0,1,2
4004730,4005478,748,0,0,1,1
4005479,4005789,310,1,0,0,1
4005483,4005758,275,1,0,0,2
4005501,4005726,225,0,1,0,2
4005505,4005744,239,0,1,0,1
4005759,4006106,347,0,0,1,2
4005790,4006105,315,0,0,1,1
4006106,4006127,21,1,0,0,1
4006107,4006126,19,1,0,0,2
4006127,4006714,587,0,0,1,2
4006128,4006713,585,0,0,1,1
4006714,4006777,63,1,0,0,1
4006715,4006779,64,1,0,0,2
4006778,4007358,580,0,0,1,1
4006780,4007357,577,0,0,1,2
4007358,4007422,64,1,0,0,2
4007359,4007419,60,1,0,0,1
4007420,4007553,133,0,0,1,1
4007423,4007554,131,0,0,1,2
4007554,4007585,31,1,0,0,1
4007555,4007586,31,1,0,0,2
4007586,4008235,649,0,0,1,1
4007587,4008242,655,0,0,1,2
4008236,4008253,17,1,0,0,1
4008243,4008254,11,1,0,0,2
4008254,4008743,489,0,0,1,1
4008255,4009180,925,0,0,1,2
4008744,4008754,10,1,0,0,1
4008755,4009180,425,0,0,1,1
4009181,4009227,46,1,0,0,2
4009181,4009249,68,1,0,0,1
4009228,4009526,298,0,0,1,2
4009250,4009525,275,0,0,1,1
4009526,4009571,45,1,0,0,1
4009527,4009548,21,1,0,0,2
4009549,4009864,315,0,0,1,2
4009572,4009863,291,0,0,1,1
4009864,4009899,35,1,0,0,1
4009865,4009898,33,1,0,0,2
4009899,4011495,1596,0,0,1,2
4009900,4011499,1599,0,0,1,1
4011496,4011751,255,1,0,0,2
4011500,4011712,212,1,0,0,1
4011518,4011671,153,0,1,0,2
4011527,4011666,139,0,1,0,1
4011713,4011978,265,0,0,1,1
4011752,4011977,225,0,0,1,2
4011978,4012039,61,1,0,0,2
4011979,4012040,61,1,0,0,1
4012040,4012193,153,0,0,1,2
4012041,4012192,151,0,0,1,1
4012193,4012234,41,1,0,0,1
4012194,4012245,51,1,0,0,2
4012235,4012733,498,0,0,1,1
4012246,4012733,487,0,0,1,2
4012734,4012804,70,1,0,0,2
4012734,4012808,74,1,0,0,1
4012805,4012898,93,0,0,1,2
4012809,4012897,88,0,0,1,1
4012898,4012933,35,1,0,0,1
4012899,4012931,32,1,0,0,2
4012932,4013603,671,0,0,1,2
4012934,4013188,254,0,0,1,1
4013189,4013207,18,1,0,0,1
4013208,4013628,420,0,0,1,1
4013604,4013645,41,1,0,0,2
4013629,4013678,49,1,0,0,1
4013646,4013776,130,0,0,1,2
4013679,4014606,927,0,0,1,1
4013777,4013836,59,1,0,0,2
4013837,4014606,769,0,0,1,2
4014607,4014652,45,1,0,0,1
4014607,4014652,45,1,0,0,2
4014653,4014802,149,0,0,1,1
4014653,4014805,152,0,0,1,2
4014803,4014828,25,1,0,0,1
4014806,4014829,23,1,0,0,2
4014829,4015645,816,0,0,1,1
4014830,4015647,817,0,0,1,2
4015646,4015680,34,1,0,0,1
4015648,4015680,32,1,0,0,2
4015681,4016858,1177,0,0,1,1
4015681,4016861,1180,0,0,1,2
4016859,4017169,310,1,0,0,1
4016862,4017151,289,1,0,0,2
4016944,4017104,160,0,1,0,1
4016946,4017101,155,0,1,0,2
4017152,4017181,29,0,0,1,2
4017170,4018215,1045,0,0,1,1
4017182,4017199,17,1,0,0,2
4017200,4018216,1016,0,0,1,2
4018216,4018310,94,1,0,0,1
4018217,4018316,99,1,0,0,2
4018311,4018412,101,0,0,1,1
4018317,4018413,96,0,0,1,2
4018413,4018446,33,1,0,0,1
4018414,4018453,39,1,0,0,2
4018447,4018634,187,0,0,1,1
4018454,4018636,182,0,0,1,2
4018635,4018648,13,1,0,0,1
4018637,4018650,13,1,0,0,2
4018649,4018840,191,0,0,1,1
4018651,4018840,189,0,0,1,2
4018841,4018859,18,1,0,0,1
4018841,4018859,18,1,0,0,2
4018860,4019633,773,0,0,1,1
4018860,4019634,774,0,0,1,2
4019634,4019687,53,1,0,0,1
4019635,4019690,55,1,0,0,2
4019688,4021741,2053,0,0,1,1
4019691,4019869,178,0,0,1,2
4019870,4019878,8,1,0,0,2
4019879,4021742,1863,0,0,1,2
4021742,4021980,238,1,0,0,1
4021743,4021988,245,1,0,0,2
4021772,4021907,135,0,1,0,2
4021773,4021914,141,0,1,0,1
4021981,4022484,503,0,0,1,1
4021989,4022481,492,0,0,1,2
4022482,4022549,67,1,0,0,2
4022485,4022549,64,1,0,0,1
4022550,4022932,382,0,0,1,2
4022550,4022933,383,0,0,1,1
4022933,4022992,59,1,0,0,2
4022934,4022992,58,1,0,0,1
4022993,4023131,138,0,0,1,1
4022993,4023131,138,0,0,1,2
4023132,4023160,28,1,0,0,1
4023132,4023161,29,1,0,0,2
4023161,4023388,227,0,0,1,1
4023162,4023389,227,0,0,1,2
4023389,4023416,27,1,0,0,1
4023390,4023415,25,1,0,0,2
4023416,4023532,116,0,0,1,2
4023417,4023536,119,0,0,1,1
4023533,4023769,236,1,0,0,2
4023537,4024131,594,1,0,0,1
4023555,4023740,185,0,1,0,2
4023557,4023747,190,0,1,0,1
4023770,4023815,45,0,0,1,2
4023816,4024131,315,1,0,0,2
4023836,4024031,195,0,1,0,2
4023836,4024047,211,0,1,0,1
4024132,4024300,168,0,0,1,2
4024132,4024309,177,0,0,1,1
4024301,4024512,211,1,0,0,2
4024310,4024535,225,1,0,0,1
4024333,4024479,146,0,1,0,2
4024336,4024485,149,0,1,0,1
4024513,4024669,156,0,0,1,2
4024536,4024669,133,0,0,1,1
4024670,4024682,12,1,0,0,1
4024670,4024682,12,1,0,0,2
4024683,4024894,211,0,0,1,1
4024683,4024899,216,0,0,1,2
4024895,4024921,26,1,0,0,1
4024900,4024909,9,1,0,0,2
4024910,4025552,642,0,0,1,2
4024922,4025551,629,0,0,1,1
4025552,4025584,32,1,0,0,1
4025553,4025585,32,1,0,0,2
4025585,4025856,271,0,0,1,1
4025586,4025859,273,0,0,1,2
4025857,4025876,19,1,0,0,1
4025860,4025891,31,1,0,0,2
4025877,4026187,310,0,0,1,1
4025892,4026188,296,0,0,1,2
4026188,4026426,238,1,0,0,1
4026189,4026423,234,1,0,0,2
4026208,4026377,169,0,1,0,1
4026210,4026369,159,0,1,0,2
4026424,4026560,136,0,0,1,2
4026427,4026557,130,0,0,1,1
4026558,4026573,15,1,0,0,1
4026561,4026571,10,1,0,0,2
4026572,4026879,307,0,0,1,2
4026574,4026878,304,0,0,1,1
4026879,4026899,20,1,0,0,1
4026880,4026909,29,1,0,0,2
4026900,4027125,225,0,0,1,1
4026910,4027125,215,0,0,1,2
4068379,4068431,52,0,1,0,1
4068379,4068437,58,0,1,0,2
4068379,4068487,108,1,0,0,1
4068379,4068488,109,1,0,0,2
4068488,4068637,149,0,0,1,1
4068489,4068637,148,0,0,1,2
4068638,4068723,85,1,0,0,1
4068638,4068725,87,1,0,0,2
4068724,4068794,70,0,0,1,1
4068726,4068794,68,0,0,1,2
4068795,4068832,37,1,0,0,1
4068795,4068832,37,1,0,0,2
4068833,4069507,674,0,0,1,2
4068833,4069518,685,0,0,1,1
4069508,4069745,237,1,0,0,2
4069519,4069702,183,1,0,0,1
4069534,4069665,131,0,1,0,2
4069540,4069658,118,0,1,0,1
4069703,4069880,177,0,0,1,1
4069746,4069880,134,0,0,1,2
4069881,4071197,1316,1,0,0,1
4069881,4071225,1344,1,0,0,2
4069947,4071206,1259,0,1,0,2
4069952,4071185,1233,0,1,0,1
4071198,4071268,70,0,0,1,1
4071226,4071267,41,0,0,1,2
4071268,4071366,98,1,0,0,2
4071269,4071379,110,1,0,0,1
4071367,4071488,121,0,0,1,2
4071380,4071485,105,0,0,1,1
4071486,4071518,32,1,0,0,1
4071489,4071516,27,1,0,0,2
4071517,4072056,539,0,0,1,2
4071519,4071794,275,0,0,1,1
4071795,4071816,21,1,0,0,1
4071817,4072069,252,0,0,1,1
4072057,4072291,234,1,0,0,2
4072070,4072228,158,1,0,0,1
4072087,4072202,115,0,1,0,2
4072092,4072191,99,0,1,0,1
4072229,4072462,233,0,0,1,1
4072292,4072464,172,0,0,1,2
4072463,4072492,29,1,0,0,1
4072465,4072490,25,1,0,0,2
4072491,4074342,1851,0,0,1,2
4072493,4074340,1847,0,0,1,1
4074341,4074450,109,1,0,0,1
4074343,4074440,97,1,0,0,2
4074441,4074519,78,0,0,1,2
4074451,4074519,68,0,0,1,1
4074520,4074548,28,1,0,0,2
4074520,4074568,48,1,0,0,1
4074549,4074753,204,0,0,1,2
4074569,4074753,184,0,0,1,1
4074754,4074763,9,1,0,0,2
4074754,4074767,13,1,0,0,1
4074764,4076413,1649,0,0,1,2
4074768,4075876,1108,0,0,1,1
4075877,4075881,4,1,0,0,1
4075882,4076821,939,0,0,1,1
4076414,4076418,4,1,0,0,2
4076419,4076822,403,0,0,1,2
4076822,4076921,99,1,0,0,1
4076823,4076920,97,1,0,0,2
4076921,4077065,144,0,0,1,2
4076922,4077065,143,0,0,1,1
4077066,4077084,18,1,0,0,2
4077066,4077096,30,1,0,0,1
4077085,4077299,214,0,0,1,2
4077097,4077295,198,0,0,1,1
4077296,4077320,24,1,0,0,1
4077300,4077312,12,1,0,0,2
4077313,4078566,1253,0,0,1,2
4077321,4078565,1244,0,0,1,1
4078566,4078705,139,1,0,0,1
4078567,4078730,163,1,0,0,2
4078706,4078931,225,0,0,1,1
4078731,4078930,199,0,0,1,2
4078931,4079012,81,1,0,0,2
4078932,4079003,71,1,0,0,1
4079004,4079078,74,0,0,1,1
4079013,4079078,65,0,0,1,2
4079079,4079112,33,1,0,0,2
4079079,4079113,34,1,0,0,1
4079113,4079220,107,0,0,1,2
4079114,4079221,107,0,0,1,1
4079221,4079241,20,1,0,0,2
4079222,4079251,29,1,0,0,1
4079242,4079505,263,0,0,1,2
4079252,4079500,248,0,0,1,1
4079501,4079528,27,1,0,0,1
4079506,4079526,20,1,0,0,2
4079527,4079700,173,0,0,1,2
4079529,4079699,170,0,0,1,1
4079700,4079714,14,1,0,0,1
4079701,4079705,4,1,0,0,2
4079706,4080563,857,0,0,1,2
4079715,4080562,847,0,0,1,1
4080563,4080638,75,1,0,0,1
4080564,4080640,76,1,0,0,2
4080639,4080986,347,0,0,1,1
4080641,4080988,347,0,0,1,2
4080987,4081018,31,1,0,0,1
4080989,4081031,42,1,0,0,2
4081019,4081491,472,0,0,1,1
4081032,4081174,142,0,0,1,2
4081175,4081183,8,1,0,0,2
4081184,4081483,299,0,0,1,2
4081484,4081495,11,1,0,0,2
4081492,4081496,4,1,0,0,1
4081496,4082736,1240,0,0,1,2
4081497,4082736,1239,0,0,1,1
4082737,4082781,44,1,0,0,1
4082737,4082781,44,1,0,0,2
4082782,4082985,203,0,0,1,1
4082782,4082987,205,0,0,1,2
4082986,4083026,40,1,0,0,1
4082988,4083032,44,1,0,0,2
4083027,4083151,124,0,0,1,1
4083033,4083152,119,0,0,1,2
4083152,4083224,72,1,0,0,1
4083153,4083214,61,1,0,0,2
4083215,4083336,121,0,0,1,2
4083225,4083337,112,0,0,1,1
4083337,4083364,27,1,0,0,2
4083338,4083364,26,1,0,0,1
4083365,4084627,1262,0,0,1,1
4083365,4084629,1264,0,0,1,2
4084628,4084684,56,1,0,0,1
4084630,4084666,36,1,0,0,2
4084667,4085144,477,0,0,1,2
4084685,4085145,460,0,0,1,1
4085145,4085220,75,1,0,0,2
4085146,4085221,75,1,0,0,1
4085221,4085300,79,0,0,1,2
4085222,4085301,79,0,0,1,1
4085301,4085335,34,1,0,0,2
4085302,4085344,42,1,0,0,1
4085336,4085934,598,0,0,1,2
4085345,4085934,589,0,0,1,1
4085935,4085955,20,1,0,0,2
4085935,4085962,27,1,0,0,1
4085956,4086243,287,0,0,1,2
4085963,4086239,276,0,0,1,1
4086240,4086253,13,1,0,0,1
4086244,4086254,10,1,0,0,2
4086254,4087307,1053,0,0,1,1
4086255,4087308,1053,0,0,1,2
4087308,4087360,52,1,0,0,1
4087309,4087368,59,1,0,0,2
4087361,4087564,203,0,0,1,1
4087369,4087563,194,0,0,1,2
4087564,4088111,547,1,0,0,2
4087565,4088060,495,1,0,0,1
4087668,4088039,371,0,1,0,2
4087673,4088030,357,0,1,0,1
4088061,4088382,321,0,0,1,1
4088112,4088384,272,0,0,1,2
4088383,4088401,18,1,0,0,1
4088385,4088400,15,1,0,0,2
4088401,4088613,212,0,0,1,2
4088402,4088616,214,0,0,1,1
4088614,4088624,10,1,0,0,2
4088617,4088641,24,1,0,0,1
4088625,4089509,884,0,0,1,2
4088642,4089248,606,0,0,1,1
4089249,4089253,4,1,0,0,1
4089254,4089519,265,0,0,1,1
4089510,4089618,108,1,0,0,2
4089520,4089618,98,1,0,0,1
4089550,4089560,10,0,1,0,2
4089619,4090077,458,0,0,1,1
4089619,4090079,460,0,0,1,2
4090078,4090151,73,1,0,0,1
4090080,4090155,75,1,0,0,2
4090152,4091565,1413,0,0,1,1
4090156,4091565,1409,0,0,1,2
4091566,4091580,14,1,0,0,1
4091566,4091583,17,1,0,0,2
4091581,4092035,454,0,0,1,1
4091584,4092035,451,0,0,1,2
4092036,4092123,87,1,0,0,2
4092036,4092130,94,1,0,0,1
4092124,4092231,107,0,0,1,2
4092131,4092232,101,0,0,1,1
4092232,4092250,18,1,0,0,2
4092233,4092257,24,1,0,0,1
4092251,4093600,1349,0,0,1,2
4092258,4093601,1343,0,0,1,1
4093601,4093621,20,1,0,0,2
4093602,4093623,21,1,0,0,1
4093622,4093927,305,0,0,1,2
4093624,4093925,301,0,0,1,1
4093926,4093981,55,1,0,0,1
4093928,4093979,51,1,0,0,2
4093980,4094018,38,0,0,1,2
4093982,4094018,36,0,0,1,1
4094019,4094076,57,1,0,0,2
4094019,4094077,58,1,0,0,1
4094077,4094177,100,0,0,1,2
4094078,4094176,98,0,0,1,1
4094177,4094224,47,1,0,0,1
4094178,4094211,33,1,0,0,2
4094212,4094453,241,0,0,1,2
4094225,4094456,231,0,0,1,1
4094454,4094474,20,1,0,0,2
4094457,4094479,22,1,0,0,1
4094475,4095625,1150,0,0,1,2
4094480,4095635,1155,0,0,1,1
4095626,4095908,282,1,0,0,2
4095636,4095885,249,1,0,0,1
4095654,4095857,203,0,1,0,2
4095660,4095829,169,0,1,0,1
4095886,4095980,94,0,0,1,1
4095909,4095980,71,0,0,1,2
4095981,4096053,72,1,0,0,2
4095981,4096057,76,1,0,0,1
4096054,4096114,60,0,0,1,2
4096058,4096114,56,0,0,1,1
4096115,4096143,28,1,0,0,2
4096115,4096145,30,1,0,0,1
4096144,4096190,46,0,0,1,2
4096146,4096188,42,0,0,1,1
4096189,4096224,35,1,0,0,1
4096191,4096225,34,1,0,0,2
4096225,4096386,161,0,0,1,1
4096226,4096386,160,0,0,1,2
4096387,4096404,17,1,0,0,2
4096387,4096416,29,1,0,0,1
4096405,4096886,481,0,0,1,2
4096417,4096884,467,0,0,1,1
4096885,4096912,27,1,0,0,1
4096887,4096913,26,1,0,0,2
4096913,4097523,610,0,0,1,1
4096914,4097523,609,0,0,1,2
4097524,4097585,61,1,0,0,1
4097524,4097585,61,1,0,0,2
4097586,4097996,410,0,0,1,1
4097586,4097996,410,0,0,1,2
4097997,4098077,80,1,0,0,1
4097997,4098079,82,1,0,0,2
4098078,4098155,77,0,0,1,1
4098080,4098156,76,0,0,1,2
4098156,4098188,32,1,0,0,1
4098157,4098187,30,1,0,0,2
4098188,4098418,230,0,0,1,2
4098189,4098416,227,0,0,1,1
4098417,4098441,24,1,0,0,1
4098419,4098432,13,1,0,0,2
4098433,4099862,1429,0,0,1,2
4098442,4099862,1420,0,0,1,1
4099863,4099922,59,1,0,0,2
4099863,4099932,69,1,0,0,1
4099923,4100015,92,0,0,1,2
4099933,4100013,80,0,0,1,1
4100014,4100036,22,1,0,0,1
4100016,4100046,30,1,0,0,2
4100037,4101497,1460,0,0,1,1
4100047,4101495,1448,0,0,1,2
4101496,4101514,18,1,0,0,2
4101498,4101514,16,1,0,0,1
4101515,4101961,446,0,0,1,1
4101515,4101961,446,0,0,1,2
4101962,4102374,412,1,0,0,2
4101962,4102503,541,1,0,0,1
4101992,4102319,327,0,1,0,1
4101992,4102363,371,0,1,0,2
4102363,4102447,84,0,1,0,1
4102375,4103790,1415,0,0,1,2
4102504,4102538,34,0,0,1,1
4102539,4102574,35,1,0,0,1
4102575,4103788,1213,0,0,1,1
4103789,4103879,90,1,0,0,1
4103791,4103878,87,1,0,0,2
4103879,4104227,348,0,0,1,2
4103880,4104227,347,0,0,1,1
4104228,4104303,75,1,0,0,1
4104228,4104306,78,1,0,0,2
4104304,4104430,126,0,0,1,1
4104307,4104432,125,0,0,1,2
4104431,4104459,28,1,0,0,1
4104433,4104457,24,1,0,0,2
4104458,4104982,524,0,0,1,2
4104460,4104980,520,0,0,1,1
4104981,4104999,18,1,0,0,1
4104983,4105010,27,1,0,0,2
4105000,4105859,859,0,0,1,1
4105011,4105862,851,0,0,1,2
4105860,4105876,16,1,0,0,1
4105863,4105877,14,1,0,0,2
4105877,4106296,419,0,0,1,1
4105878,4106296,418,0,0,1,2
4106297,4106380,83,1,0,0,2
4106297,4106381,84,1,0,0,1
4106381,4106461,80,0,0,1,2
4106382,4106461,79,0,0,1,1
4106462,4106500,38,1,0,0,2
4106462,4106501,39,1,0,0,1
4106501,4106974,473,0,0,1,2
4106502,4106656,154,0,0,1,1
4106657,4106667,10,1,0,0,1
4106668,4106978,310,0,0,1,1
4106975,4106994,19,1,0,0,2
4106979,4106999,20,1,0,0,1
4106995,4107978,983,0,0,1,2
4107000,4107977,977,0,0,1,1
4107978,4108048,70,1,0,0,1
4107979,4108048,69,1,0,0,2
4108049,4108446,397,0,0,1,1
4108049,4108447,398,0,0,1,2
4108447,4108537,90,1,0,0,1
4108448,4108549,101,1,0,0,2
4108538,4108643,105,0,0,1,1
4108550,4108646,96,0,0,1,2
4108644,4108679,35,1,0,0,1
4108647,4108667,20,1,0,0,2
4108668,4108839,171,0,0,1,2
4108680,4108834,154,0,0,1,1
4108835,4108852,17,1,0,0,1
4108840,4108850,10,1,0,0,2
4108851,4110165,1314,0,0,1,2
4108853,4110152,1299,0,0,1,1
4110153,4110390,237,1,0,0,1
4110166,4110384,218,1,0,0,2
4110190,4110343,153,0,1,0,1
4110195,4110348,153,0,1,0,2
4110385,4110448,63,0,0,1,2
4110391,4110459,68,0,0,1,1
4110449,4110829,380,1,0,0,2
4110460,4110822,362,1,0,0,1
4110484,4110818,334,0,1,0,2
4110487,4110778,291,0,1,0,1
4110823,4111078,255,0,0,1,1
4110830,4111079,249,0,0,1,2
4111079,4111100,21,1,0,0,1
4111080,4111095,15,1,0,0,2
4111096,4112866,1770,0,0,1,2
4111101,4112866,1765,0,0,1,1
4112867,4112938,71,1,0,0,2
4112867,4112940,73,1,0,0,1
4112939,4113040,101,0,0,1,2
4112941,4113041,100,0,0,1,1
4113041,4113063,22,1,0,0,2
4113042,4113082,40,1,0,0,1
4113064,4113226,162,0,0,1,2
4113083,4113220,137,0,0,1,1
4113221,4113241,20,1,0,0,1
4113227,4113236,9,1,0,0,2
4113237,4113538,301,0,0,1,2
4113242,4113534,292,0,0,1,1
4113535,4113552,17,1,0,0,1
4113539,4113548,9,1,0,0,2
4113549,4114207,658,0,0,1,2
4113553,4114206,653,0,0,1,1
4114207,4114318,111,1,0,0,1
4114208,4114329,121,1,0,0,2
4114319,4114641,322,0,0,1,1
4114330,4114641,311,0,0,1,2
4114642,4114715,73,1,0,0,1
4114642,4114717,75,1,0,0,2
4114716,4114803,87,0,0,1,1
4114718,4114804,86,0,0,1,2
4114804,4114838,34,1,0,0,1
4114805,4114837,32,1,0,0,2
4114838,4116114,1276,0,0,1,2
4114839,4116113,1274,0,0,1,1
4116114,4116156,42,1,0,0,1
4116115,4116133,18,1,0,0,2
4116134,4116567,433,0,0,1,2
4116157,4116566,409,0,0,1,1
4116567,4116672,105,1,0,0,1
4116568,4116671,103,1,0,0,2
4116672,4116745,73,0,0,1,2
4116673,4116744,71,0,0,1,1
4116745,4116780,35,1,0,0,1
4116746,4116783,37,1,0,0,2
4116781,4116939,158,0,0,1,1
4116784,4116939,155,0,0,1,2
4116940,4116965,25,1,0,0,2
4116940,4116967,27,1,0,0,1
4116966,4117897,931,0,0,1,2
4116968,4117898,930,0,0,1,1
4117898,4117951,53,1,0,0,2
4117899,4117947,48,1,0,0,1
4117948,4118335,387,0,0,1,1
4117952,4118335,383,0,0,1,2
4118336,4118409,73,1,0,0,2
4118336,4118419,83,1,0,0,1
4118410,4118517,107,0,0,1,2
4118420,4118516,96,0,0,1,1
4118517,4118550,33,1,0,0,1
4118518,4118547,29,1,0,0,2
4118548,4118736,188,0,0,1,2
4118551,4118742,191,0,0,1,1
4118737,4118746,9,1,0,0,2
4118743,4118759,16,1,0,0,1
4118747,4120172,1425,0,0,1,2
4118760,4120171,1411,0,0,1,1
4120172,4120260,88,1,0,0,1
4120173,4120238,65,1,0,0,2
4120239,4120334,95,0,0,1,2
4120261,4120332,71,0,0,1,1
4120333,4120374,41,1,0,0,1
4120335,4120354,19,1,0,0,2
4120355,4120505,150,0,0,1,2
4120375,4120500,125,0,0,1,1
4120501,4120519,18,1,0,0,1
4120506,4120511,5,1,0,0,2
4120512,4122040,1528,0,0,1,2
4120520,4122041,1521,0,0,1,1
4122041,4122145,104,1,0,0,2
4122042,4122145,103,1,0,0,1
4122146,4122222,76,0,0,1,1
4122146,4122223,77,0,0,1,2
4122223,4122249,26,1,0,0,1
4122224,4122249,25,1,0,0,2
4122250,4122344,94,0,0,1,1
4122250,4122345,95,0,0,1,2
4122345,4122376,31,1,0,0,1
4122346,4122364,18,1,0,0,2
4122365,4122815,450,0,0,1,2
4122377,4122816,439,0,0,1,1
4122816,4122835,19,1,0,0,2
4122817,4122829,12,1,0,0,1
4122830,4122990,160,0,0,1,1
4122836,4122988,152,0,0,1,2
4122989,4123008,19,1,0,0,2
4122991,4123007,16,1,0,0,1
4123008,4123934,926,0,0,1,1
4123009,4123942,933,0,0,1,2
4123935,4124271,336,1,0,0,1
4123943,4124232,289,1,0,0,2
4123964,4124213,249,0,1,0,2
4123965,4124212,247,0,1,0,1
4124233,4124303,70,0,0,1,2
4124272,4124302,30,0,0,1,1
4124303,4124600,297,1,0,0,1
4124304,4124543,239,1,0,0,2
4124324,4124529,205,0,1,0,2
4124325,4124548,223,0,1,0,1
4124544,4124698,154,0,0,1,2
4124601,4124697,96,0,0,1,1
4124698,4124722,24,1,0,0,1
4124699,4124718,19,1,0,0,2
4124719,4125982,1263,0,0,1,2
4124723,4125982,1259,0,0,1,1
4125983,4126032,49,1,0,0,1
4125983,4126032,49,1,0,0,2
4126033,4126345,312,0,0,1,1
4126033,4126345,312,0,0,1,2
4126346,4126424,78,1,0,0,2
4126346,4126425,79,1,0,0,1
4126425,4126526,101,0,0,1,2
4126426,4126525,99,0,0,1,1
4126526,4126568,42,1,0,0,1
4126527,4126558,31,1,0,0,2
4126559,4126694,135,0,0,1,2
4126569,4126693,124,0,0,1,1
4126694,4126730,36,1,0,0,1
4126695,4126719,24,1,0,0,2
4126720,4127805,1085,0,0,1,2
4126731,4127802,1071,0,0,1,1
4127803,4127852,49,1,0,0,1
4127806,4127844,38,1,0,0,2
4127845,4127922,77,0,0,1,2
4127853,4127921,68,0,0,1,1
4127922,4127990,68,1,0,0,1
4127923,4127990,67,1,0,0,2
4127991,4128266,275,0,0,1,1
4127991,4128267,276,0,0,1,2
4128267,4128394,127,1,0,0,1
4128268,4128387,119,1,0,0,2
4128388,4128464,76,0,0,1,2
4128395,4128463,68,0,0,1,1
4128464,4128498,34,1,0,0,1
4128465,4128510,45,1,0,0,2
4128499,4128687,188,0,0,1,1
4128511,4128692,181,0,0,1,2
4128688,4128714,26,1,0,0,1
4128693,4128704,11,1,0,0,2
4128705,4129910,1205,0,0,1,2
4128715,4129911,1196,0,0,1,1
4129911,4129950,39,1,0,0,2
4129912,4129953,41,1,0,0,1
4129951,4130054,103,0,0,1,2
4129954,4130052,98,0,0,1,1
4130053,4130187,134,1,0,0,1
4130055,4130176,121,1,0,0,2
4130177,4130292,115,0,0,1,2
4130188,4130293,105,0,0,1,1
4130293,4130623,330,1,0,0,2
4130294,4130633,339,1,0,0,1
4130399,4130583,184,0,1,0,2
4130401,4130585,184,0,1,0,1
4130624,4130769,145,0,0,1,2
4130634,4130769,135,0,0,1,1
4130770,4130785,15,1,0,0,2
4130770,4130796,26,1,0,0,1
4130786,4131034,248,0,0,1,2
4130797,4131028,231,0,0,1,1
4131029,4131039,10,1,0,0,1
4131035,4131051,16,1,0,0,2
4131040,4132322,1282,0,0,1,1
4131052,4132321,1269,0,0,1,2
4132322,4132394,72,1,0,0,2
4132323,4132386,63,1,0,0,1
4132387,4132505,118,0,0,1,1
4132395,4132507,112,0,0,1,2
4132506,4132526,20,1,0,0,1
4132508,4132529,21,1,0,0,2
4132527,4132737,210,0,0,1,1
4132530,4132742,212,0,0,1,2
4132738,4132762,24,1,0,0,1
4132743,4132756,13,1,0,0,2
4132757,4134343,1586,0,0,1,2
4132763,4134343,1580,0,0,1,1
4134344,4134430,86,1,0,0,1
4134344,4134430,86,1,0,0,2
4134431,4134522,91,0,0,1,1
4134431,4134522,91,0,0,1,2
4134523,4134553,30,1,0,0,1
4134523,4134558,35,1,0,0,2
4134554,4134786,232,0,0,1,1
4134559,4134787,228,0,0,1,2
4134787,4134798,11,1,0,0,1
4134788,4134797,9,1,0,0,2
4134798,4135852,1054,0,0,1,2
4134799,4135854,1055,0,0,1,1
4135853,4135864,11,1,0,0,2
4135855,4135865,10,1,0,0,1
4135865,4135993,128,0,0,1,2
4135866,4135999,133,0,0,1,1
4135994,4136231,237,1,0,0,2
4136000,4136189,189,1,0,0,1
4136018,4136156,138,0,1,0,2
4136022,4136150,128,0,1,0,1
4136190,4136311,121,0,0,1,1
4136232,4136311,79,0,0,1,2
4136312,4136396,84,1,0,0,1
4136312,4136405,93,1,0,0,2
4136397,4136470,73,0,0,1,1
4136406,4136470,64,0,0,1,2
4136471,4136510,39,1,0,0,1
4136471,4136512,41,1,0,0,2
4136511,4136650,139,0,0,1,1
4136513,4136644,131,0,0,1,2
4136645,4136658,13,1,0,0,2
4136651,4136655,4,1,0,0,1
4136656,4136897,241,0,0,1,1
4136659,4136898,239,0,0,1,2
4136898,4136918,20,1,0,0,1
4136899,4136917,18,1,0,0,2
4136918,4137156,238,0,0,1,2
4136919,4137156,237,0,0,1,1
4137157,4137174,17,1,0,0,2
4137157,4137178,21,1,0,0,1
4137175,4137798,623,0,0,1,2
4137179,4137796,617,0,0,1,1
4137797,4137856,59,1,0,0,1
4137799,4137858,59,1,0,0,2
4137857,4138230,373,0,0,1,1
4137859,4138231,372,0,0,1,2
4138231,4138285,54,1,0,0,1
4138232,4138286,54,1,0,0,2
4138286,4139727,1441,0,0,1,1
4138287,4140126,1839,0,0,1,2
4139728,4139752,24,1,0,0,1
4139753,4140127,374,0,0,1,1
4140127,4140219,92,1,0,0,2
4140128,4140226,98,1,0,0,1
4140220,4140275,55,0,0,1,2
4140227,4140275,48,0,0,1,1
4140276,4140318,42,1,0,0,2
4140276,4140398,122,1,0,0,1
4140319,4140521,202,0,0,1,2
4140399,4140521,122,0,0,1,1
4140522,4140540,18,1,0,0,2
4140522,4141039,517,1,0,0,1
4140541,4140818,277,0,0,1,2
4140819,4140835,16,1,0,0,2
4140836,4141522,686,0,0,1,2
4141040,4141118,78,0,0,1,1
4141119,4141187,68,1,0,0,1
4141188,4141355,167,0,0,1,1
4141356,4142264,908,1,0,0,1
4141523,4141552,29,1,0,0,2
4141553,4141793,240,0,0,1,2
4141794,4141804,10,1,0,0,2
4141805,4142201,396,0,0,1,2
4142202,4142261,59,1,0,0,2
4142262,4142327,65,0,0,1,2
4142265,4142326,61,0,0,1,1
4142327,4142382,55,1,0,0,1
4142328,4142371,43,1,0,0,2
4142372,4143559,1187,0,0,1,2
4142383,4142802,419,0,0,1,1
4142803,4142825,22,1,0,0,1
4142826,4143559,733,0,0,1,1
4143560,4143578,18,1,0,0,2
4143560,4143582,22,1,0,0,1
4143579,4144016,437,0,0,1,2
4143583,4144015,432,0,0,1,1
4144016,4144144,128,1,0,0,1
4144017,4144134,117,1,0,0,2
4144135,4144268,133,0,0,1,2
4144145,4144266,121,0,0,1,1
4144267,4144298,31,1,0,0,1
4144269,4144295,26,1,0,0,2
4144296,4144979,683,0,0,1,2
4144299,4144980,681,0,0,1,1
4144980,4144997,17,1,0,0,2
4144981,4144997,16,1,0,0,1
4144998,4145591,593,0,0,1,1
4144998,4145592,594,0,0,1,2
4145592,4145757,165,1,0,0,1
4145593,4145792,199,1,0,0,2
4145669,4145730,61,0,1,0,2
4145758,4145929,171,0,0,1,1
4145793,4145923,130,0,0,1,2
4145924,4146198,274,1,0,0,2
4145930,4146184,254,1,0,0,1
4145949,4146141,192,0,1,0,2
4145951,4146142,191,0,1,0,1
4146185,4146262,77,0,0,1,1
4146199,4146262,63,0,0,1,2
4146263,4146286,23,1,0,0,2
4146263,4146299,36,1,0,0,1
4146287,4147047,760,0,0,1,2
4146300,4147047,747,0,0,1,1
4147048,4147058,10,1,0,0,1
4147048,4147059,11,1,0,0,2
4147059,4147788,729,0,0,1,1
4147060,4148193,1133,0,0,1,2
4147789,4147804,15,1,0,0,1
4147805,4148192,387,0,0,1,1
4148193,4148294,101,1,0,0,1
4148194,4148295,101,1,0,0,2
4148295,4148358,63,0,0,1,1
4148296,4148358,62,0,0,1,2
4148359,4148395,36,1,0,0,1
4148359,4148397,38,1,0,0,2
4148396,4148487,91,0,0,1,1
4148398,4148487,89,0,0,1,2
4148488,4148507,19,1,0,0,2
4148488,4148508,20,1,0,0,1
4148508,4149841,1333,0,0,1,2
4148509,4149839,1330,0,0,1,1
4149840,4149907,67,1,0,0,1
4149842,4149907,65,1,0,0,2
4149908,4150311,403,0,0,1,1
4149908,4150311,403,0,0,1,2
4150312,4150370,58,1,0,0,2
4150312,4150379,67,1,0,0,1
4150371,4150510,139,0,0,1,2
4150380,4150508,128,0,0,1,1
4150509,4150526,17,1,0,0,1
4150511,4150526,15,1,0,0,2
4150527,4151096,569,0,0,1,1
4150527,4151096,569,0,0,1,2
4151097,4151107,10,1,0,0,2
4151097,4151111,14,1,0,0,1
4151108,4152093,985,0,0,1,2
4151112,4152093,981,0,0,1,1
4152094,4152162,68,1,0,0,2
4152094,4152164,70,1,0,0,1
4152163,4152252,89,0,0,1,2
4152165,4152251,86,0,0,1,1
4152252,4152288,36,1,0,0,1
4152253,4152296,43,1,0,0,2
4152289,4152532,243,0,0,1,1
4152297,4152851,554,0,0,1,2
4152533,4152564,31,1,0,0,1
4152565,4152841,276,0,0,1,1
4152842,4152877,35,1,0,0,1
4152852,4152867,15,1,0,0,2
4152868,4153679,811,0,0,1,2
4152878,4153678,800,0,0,1,1
4153679,4153701,22,1,0,0,1
4153680,4153699,19,1,0,0,2
4153700,4153920,220,0,0,1,2
4153702,4153917,215,0,0,1,1
4153918,4153971,53,1,0,0,1
4153921,4153981,60,1,0,0,2
4153972,4154097,125,0,0,1,1
4153982,4154097,115,0,0,1,2
4154098,4154161,63,1,0,0,2
4154098,4154170,72,1,0,0,1
4154162,4154267,105,0,0,1,2
4154171,4154266,95,0,0,1,1
4154267,4154314,47,1,0,0,1
4154268,4154293,25,1,0,0,2
4154294,4155511,1217,0,0,1,2
4154315,4154536,221,0,0,1,1
4154537,4154549,12,1,0,0,1
4154550,4155510,960,0,0,1,1
4155511,4155633,122,1,0,0,1
4155512,4155644,132,1,0,0,2
4155634,4156006,372,0,0,1,1
4155645,4156006,361,0,0,1,2
4156007,4156088,81,1,0,0,1
4156007,4156089,82,1,0,0,2
4156089,4156145,56,0,0,1,1
4156090,4156144,54,0,0,1,2
4156145,4156185,40,1,0,0,2
4156146,4156201,55,1,0,0,1
4156186,4156245,59,0,0,1,2
4156202,4156256,54,0,0,1,1
4156246,4156684,438,1,0,0,2
4156257,4156698,441,1,0,0,1
4156264,4156673,409,0,1,0,2
4156272,4156599,327,0,1,0,1
4156685,4157855,1170,0,0,1,2
4156699,4157850,1151,0,0,1,1
4157851,4157937,86,1,0,0,1
4157856,4157939,83,1,0,0,2
4157938,4158332,394,0,0,1,1
4157940,4158334,394,0,0,1,2
4158333,4158417,84,1,0,0,1
4158335,4158401,66,1,0,0,2
4158402,4158503,101,0,0,1,2
4158418,4158504,86,0,0,1,1
4158504,4158535,31,1,0,0,2
4158505,4158540,35,1,0,0,1
4158536,4159864,1328,0,0,1,2
4158541,4159136,595,0,0,1,1
4159137,4159153,16,1,0,0,1
4159154,4159862,708,0,0,1,1
4159863,4159899,36,1,0,0,1
4159865,4159899,34,1,0,0,2
4159900,4160255,355,0,0,1,2
4159900,4160256,356,0,0,1,1
4160256,4160331,75,1,0,0,2
4160257,4160331,74,1,0,0,1
4160332,4160416,84,0,0,1,2
4160332,4160418,86,0,0,1,1
4160417,4160441,24,1,0,0,2
4160419,4160458,39,1,0,0,1
4160442,4160636,194,0,0,1,2
4160459,4160634,175,0,0,1,1
4160635,4160654,19,1,0,0,1
4160637,4160651,14,1,0,0,2
4160652,4161573,921,0,0,1,2
4160655,4161565,910,0,0,1,1
4161566,4161584,18,1,0,0,1
4161574,4161584,10,1,0,0,2
4161585,4162030,445,0,0,1,1
4161585,4162033,448,0,0,1,2
4162031,4162072,41,1,0,0,1
4162034,4162058,24,1,0,0,2
4162059,4162464,405,0,0,1,2
4162073,4162462,389,0,0,1,1
4162463,4162542,79,1,0,0,1
4162465,4162534,69,1,0,0,2
4162535,4162640,105,0,0,1,2
4162543,4162640,97,0,0,1,1
4162641,4162662,21,1,0,0,1
4162641,4162676,35,1,0,0,2
4162663,4162839,176,0,0,1,1
4162677,4164014,1337,0,0,1,2
4162840,4162864,24,1,0,0,1
4162865,4163596,731,0,0,1,1
4163597,4163694,97,1,0,0,1
4163695,4163752,57,0,0,1,1
4163753,4163761,8,1,0,0,1
4163762,4164010,248,0,0,1,1
4164011,4164085,74,1,0,0,1
4164015,4164033,18,1,0,0,2
4164034,4164457,423,0,0,1,2
4164086,4164331,245,0,0,1,1
4164332,4164347,15,1,0,0,1
4164348,4164456,108,0,0,1,1
4164457,4164546,89,1,0,0,1
4164458,4164546,88,1,0,0,2
4164547,4164593,46,0,0,1,1
4164547,4164593,46,0,0,1,2
4164594,4164671,77,1,0,0,1
4164594,4164672,78,1,0,0,2
4164672,4164841,169,0,0,1,1
4164673,4166416,1743,0,0,1,2
4164842,4164849,7,1,0,0,1
4164850,4165352,502,0,0,1,1
4165353,4165374,21,1,0,0,1
4165375,4166415,1040,0,0,1,1
4166416,4166504,88,1,0,0,1
4166417,4166505,88,1,0,0,2
4166505,4166555,50,0,0,1,1
4166506,4166554,48,0,0,1,2
4166555,4166646,91,1,0,0,2
4166556,4166633,77,1,0,0,1
4166634,4166786,152,0,0,1,1
4166647,4167283,636,0,0,1,2
4166787,4166791,4,1,0,0,1
4166792,4167281,489,0,0,1,1
4167282,4167295,13,1,0,0,1
4167284,4167294,10,1,0,0,2
4167295,4168214,919,0,0,1,2
4167296,4168209,913,0,0,1,1
4168210,4168238,28,1,0,0,1
4168215,4168224,9,1,0,0,2
4168225,4168590,365,0,0,1,2
4168239,4168590,351,0,0,1,1
4168591,4168651,60,1,0,0,2
4168591,4168661,70,1,0,0,1
4168652,4170010,1358,0,0,1,2
4168662,4168863,201,0,0,1,1
4168864,4168878,14,1,0,0,1
4168879,4170004,1125,0,0,1,1
4170005,4170032,27,1,0,0,1
4170011,4170033,22,1,0,0,2
4170033,4170085,52,0,0,1,1
4170034,4170466,432,0,0,1,2
4170086,4170091,5,1,0,0,1
4170092,4170467,375,0,0,1,1
4170467,4170493,26,1,0,0,2
4170468,4170491,23,1,0,0,1
4170492,4170855,363,0,0,1,1
4170494,4170857,363,0,0,1,2
4170856,4170942,86,1,0,0,1
4170858,4170952,94,1,0,0,2
4170943,4171033,90,0,0,1,1
4170953,4171032,79,0,0,1,2
4171033,4171052,19,1,0,0,2
4171034,4171064,30,1,0,0,1
4171053,4171234,181,0,0,1,2
4171065,4171239,174,0,0,1,1
4171235,4171252,17,1,0,0,2
4171240,4171257,17,1,0,0,1
4171253,4172554,1301,0,0,1,2
4171258,4172553,1295,0,0,1,1
4172554,4172579,25,1,0,0,1
4172555,4172570,15,1,0,0,2
4172571,4173097,526,0,0,1,2
4172580,4173098,518,0,0,1,1
4173098,4173154,56,1,0,0,2
4173099,4173162,63,1,0,0,1
4173155,4173293,138,0,0,1,2
4173163,4173292,129,0,0,1,1
4173293,4173314,21,1,0,0,1
4173294,4173321,27,1,0,0,2
4173315,4173477,162,0,0,1,1
4173322,4173478,156,0,0,1,2
4173478,4173733,255,1,0,0,1
4173479,4173726,247,1,0,0,2
4173497,4173689,192,0,1,0,2
4173498,4173694,196,0,1,0,1
4173727,4173817,90,0,0,1,2
4173734,4173813,79,0,0,1,1
4173814,4174024,210,1,0,0,1
4173818,4174009,191,1,0,0,2
4173834,4173987,153,0,1,0,1
4173835,4173977,142,0,1,0,2
4174010,4174191,181,0,0,1,2
4174025,4174189,164,0,0,1,1
4174190,4174204,14,1,0,0,1
4174192,4174204,12,1,0,0,2
4174205,4174460,255,0,0,1,1
4174205,4174460,255,0,0,1,2
4174461,4174470,9,1,0,0,2
4174461,4174482,21,1,0,0,1
4174471,4175099,628,0,0,1,2
4174483,4175316,833,0,0,1,1
4175100,4175107,7,1,0,0,2
4175108,4175317,209,0,0,1,2
4175317,4175346,29,1,0,0,1
4175318,4175335,17,1,0,0,2
4175336,4177500,2164,0,0,1,2
4175347,4177499,2152,0,0,1,1
4177500,4177557,57,1,0,0,1
4177501,4177556,55,1,0,0,2
4177557,4177680,123,0,0,1,2
4177558,4177676,118,0,0,1,1
4177677,4177709,32,1,0,0,1
4177681,4177696,15,1,0,0,2
4177697,4179994,2297,0,0,1,2
4177710,4178010,300,0,0,1,1
4178011,4178039,28,1,0,0,1
4178040,4179988,1948,0,0,1,1
4179989,4180219,230,1,0,0,1
4179995,4180203,208,1,0,0,2
4180013,4180179,166,0,1,0,2
4180015,4180178,163,0,1,0,1
4180204,4181257,1053,0,0,1,2
4180220,4181257,1037,0,0,1,1
4181258,4181336,78,1,0,0,1
4181258,4181345,87,1,0,0,2
4181337,4181416,79,0,0,1,1
4181346,4181418,72,0,0,1,2
4181417,4181457,40,1,0,0,1
4181419,4181455,36,1,0,0,2
4181456,4181963,507,0,0,1,2
4181458,4181604,146,0,0,1,1
4181605,4181619,14,1,0,0,1
4181620,4181962,342,0,0,1,1
4181963,4181974,11,1,0,0,1
4181964,4181976,12,1,0,0,2
4181975,4184024,2049,0,0,1,1
4181977,4184025,2048,0,0,1,2
4184025,4184071,46,1,0,0,1
4184026,4184072,46,1,0,0,2
4184072,4184251,179,0,0,1,1
4184073,4184250,177,0,0,1,2
4184251,4184271,20,1,0,0,2
4184252,4184282,30,1,0,0,1
4184272,4185051,779,0,0,1,2
4184283,4185051,768,0,0,1,1
4185052,4185057,5,1,0,0,1
4185052,4185057,5,1,0,0,2
4185058,4186122,1064,0,0,1,1
4185058,4186123,1065,0,0,1,2
4186123,4186478,355,1,0,0,1
4186124,4186443,319,1,0,0,2
4186157,4186416,259,0,1,0,2
4186163,4186414,251,0,1,0,1
4186444,4186622,178,0,0,1,2
4186479,4186622,143,0,0,1,1
4186623,4186643,20,1,0,0,2
4186623,4186646,23,1,0,0,1
4186644,4186951,307,0,0,1,2
4186647,4186951,304,0,0,1,1
4186952,4186956,4,1,0,0,1
4186952,4186962,10,1,0,0,2
4186957,4188045,1088,0,0,1,1
4186963,4188046,1083,0,0,1,2
4188046,4188102,56,1,0,0,1
4188047,4188125,78,1,0,0,2
4188103,4188273,170,0,0,1,1
4188126,4188277,151,0,0,1,2
4188274,4188292,18,1,0,0,1
4188278,4188293,15,1,0,0,2
4188293,4190053,1760,0,0,1,1
4188294,4190054,1760,0,0,1,2
4190054,4190117,63,1,0,0,1
4190055,4190113,58,1,0,0,2
4190114,4192155,2041,0,0,1,2
4190118,4192154,2036,0,0,1,1
4192155,4192170,15,1,0,0,1
4192156,4192172,16,1,0,0,2
4192171,4192624,453,0,0,1,1
4192173,4192624,451,0,0,1,2
4192625,4192654,29,1,0,0,2
4192625,4192660,35,1,0,0,1
4192655,4193948,1293,0,0,1,2
4192661,4193949,1288,0,0,1,1
4193949,4194032,83,1,0,0,2
4193950,4194029,79,1,0,0,1
4194030,4194130,100,0,0,1,1
4194033,4194130,97,0,0,1,2
4194131,4194152,21,1,0,0,2
4194131,4194162,31,1,0,0,1
4194153,4196293,2140,0,0,1,2
4194163,4196294,2131,0,0,1,1
4196294,4196350,56,1,0,0,2
4196295,4196350,55,1,0,0,1
4196351,4196591,240,0,0,1,1
4196351,4196595,244,0,0,1,2
4196592,4196619,27,1,0,0,1
4196596,4196889,293,1,0,0,2
4196620,4196645,25,0,0,1,1
4196646,4196806,160,1,0,0,1
4196663,4196779,116,0,1,0,2
4196670,4196760,90,0,1,0,1
4196807,4197120,313,0,0,1,1
4196890,4198617,1727,0,0,1,2
4197121,4197129,8,1,0,0,1
4197130,4198613,1483,0,0,1,1
4198614,4198835,221,1,0,0,1
4198618,4198898,280,1,0,0,2
4198644,4198812,168,0,1,0,2
4198652,4198790,138,0,1,0,1
4198836,4200319,1483,0,0,1,1
4198899,4200320,1421,0,0,1,2
4200320,4200418,98,1,0,0,1
4200321,4200418,97,1,0,0,2
4200419,4200502,83,0,0,1,1
4200419,4200503,84,0,0,1,2
4200503,4200530,27,1,0,0,1
4200504,4200529,25,1,0,0,2
4200530,4202481,1951,0,0,1,2
4200531,4200671,140,0,0,1,1
4200672,4200696,24,1,0,0,1
4200697,4202480,1783,0,0,1,1
4202481,4202536,55,1,0,0,1
4202482,4202538,56,1,0,0,2
4202537,4203062,525,0,0,1,1
4202539,4203058,519,0,0,1,2
4203059,4203082,23,1,0,0,2
4203063,4203084,21,1,0,0,1
4203083,4204582,1499,0,0,1,2
4203085,4204581,1496,0,0,1,1
4204582,4204603,21,1,0,0,1
4204583,4204604,21,1,0,0,2
4204604,4204960,356,0,0,1,1
4204605,4204961,356,0,0,1,2
4204961,4204998,37,1,0,0,1
4204962,4204996,34,1,0,0,2
4204997,4205284,287,0,0,1,2
4204999,4205282,283,0,0,1,1
4205283,4205304,21,1,0,0,1
4205285,4205302,17,1,0,0,2
4205303,4205686,383,0,0,1,2
4205305,4205685,380,0,0,1,1
4205686,4205734,48,1,0,0,1
4205687,4205728,41,1,0,0,2
4205729,4206261,532,0,0,1,2
4205735,4206261,526,0,0,1,1
4206262,4206285,23,1,0,0,2
4206262,4206292,30,1,0,0,1
4206286,4206739,453,0,0,1,2
4206293,4206455,162,0,0,1,1
4206456,4206468,12,1,0,0,1
4206469,4206734,265,0,0,1,1
4206735,4206749,14,1,0,0,1
4206740,4206749,9,1,0,0,2
4206750,4208183,1433,0,0,1,1
4206750,4208183,1433,0,0,1,2
4208184,4208245,61,1,0,0,2
4208184,4208257,73,1,0,0,1
4208246,4208417,171,0,0,1,2
4208258,4208417,159,0,0,1,1
4208418,4208437,19,1,0,0,2
4208418,4208445,27,1,0,0,1
4208438,4210297,1859,0,0,1,2
4208446,4210298,1852,0,0,1,1
4210298,4210333,35,1,0,0,2
4210299,4210342,43,1,0,0,1
4210334,4210569,235,0,0,1,2
4210343,4210570,227,0,0,1,1
4210570,4210787,217,1,0,0,2
4210571,4210791,220,1,0,0,1
4210593,4210745,152,0,1,0,1
4210593,4210750,157,0,1,0,2
4210788,4210986,198,0,0,1,2
4210792,4210987,195,0,0,1,1
4210987,4211039,52,1,0,0,2
4210988,4211046,58,1,0,0,1
4211040,4211520,480,0,0,1,2
4211047,4211520,473,0,0,1,1
4211521,4211544,23,1,0,0,2
4211521,4211551,30,1,0,0,1
4211545,4211975,430,0,0,1,2
4211552,4211974,422,0,0,1,1
4211975,4212036,61,1,0,0,1
4211976,4212037,61,1,0,0,2
4212037,4212166,129,0,0,1,1
4212038,4212164,126,0,0,1,2
4212165,4212180,15,1,0,0,2
4212167,4212199,32,1,0,0,1
4212181,4212656,475,0,0,1,2
4212200,4212658,458,0,0,1,1
4212657,4212672,15,1,0,0,2
4212659,4212673,14,1,0,0,1
4212673,4213800,1127,0,0,1,2
4212674,4213800,1126,0,0,1,1
4213801,4213860,59,1,0,0,1
4213801,4213866,65,1,0,0,2
4213861,4213958,97,0,0,1,1
4213867,4213958,91,0,0,1,2
4213959,4213983,24,1,0,0,2
4213959,4213996,37,1,0,0,1
4213984,4216071,2087,0,0,1,2
4213997,4216070,2073,0,0,1,1
4216071,4216334,263,1,0,0,1
4216072,4216352,280,1,0,0,2
4216093,4216278,185,0,1,0,2
4216098,4216266,168,0,1,0,1
4216335,4216754,419,0,0,1,1
4216353,4216754,401,0,0,1,2
4216755,4216778,23,1,0,0,1
4216755,4216790,35,1,0,0,2
4216779,4217027,248,0,0,1,1
4216791,4217027,236,0,0,1,2
4217028,4217065,37,1,0,0,2
4217028,4217067,39,1,0,0,1
4217066,4217530,464,0,0,1,2
4217068,4217530,462,0,0,1,1
4217531,4217586,55,1,0,0,2
4217531,4217596,65,1,0,0,1
4217587,4217671,84,0,0,1,2
4217597,4217671,74,0,0,1,1
4217672,4217730,58,1,0,0,1
4217672,4217734,62,1,0,0,2
4217731,4217826,95,0,0,1,1
4217735,4217826,91,0,0,1,2
4217827,4217851,24,1,0,0,2
4217827,4217858,31,1,0,0,1
4217852,4218300,448,0,0,1,2
4217859,4218294,435,0,0,1,1
4218295,4218314,19,1,0,0,1
4218301,4218305,4,1,0,0,2
4218306,4219499,1193,0,0,1,2
4218315,4219496,1181,0,0,1,1
4219497,4219552,55,1,0,0,1
4219500,4219554,54,1,0,0,2
4219553,4219662,109,0,0,1,1
4219555,4219661,106,0,0,1,2
4219662,4219693,31,1,0,0,2
4219663,4219696,33,1,0,0,1
4219694,4219868,174,0,0,1,2
4219697,4219869,172,0,0,1,1
4219869,4219879,10,1,0,0,2
4219870,4219878,8,1,0,0,1
4219879,4221601,1722,0,0,1,1
4219880,4221602,1722,0,0,1,2
4221602,4221951,349,1,0,0,1
4221603,4221924,321,1,0,0,2
4221624,4221892,268,0,1,0,2
4221632,4221891,259,0,1,0,1
4221925,4222183,258,0,0,1,2
4221952,4222183,231,0,0,1,1
4222184,4222196,12,1,0,0,2
4222184,4222200,16,1,0,0,1
4222197,4222563,366,0,0,1,2
4222201,4222560,359,0,0,1,1
4222561,4222585,24,1,0,0,1
4222564,4222599,35,1,0,0,2
4222586,4223045,459,0,0,1,1
4222600,4223043,443,0,0,1,2
4223044,4223081,37,1,0,0,2
4223046,4223082,36,1,0,0,1
4223082,4223207,125,0,0,1,2
4223083,4223207,124,0,0,1,1
4223208,4223277,69,1,0,0,1
4223208,4223291,83,1,0,0,2
4223278,4223379,101,0,0,1,1
4223292,4223378,86,0,0,1,2
4223379,4223409,30,1,0,0,2
4223380,4223402,22,1,0,0,1
4223403,4223567,164,0,0,1,1
4223410,4225410,2000,0,0,1,2
4223568,4223572,4,1,0,0,1
4223573,4224117,544,0,0,1,1
4224118,4224138,20,1,0,0,1
4224139,4225409,1270,0,0,1,1
4225410,4225490,80,1,0,0,1
4225411,4225490,79,1,0,0,2
4225491,4225600,109,0,0,1,2
4225491,4225601,110,0,0,1,1
4225601,4225620,19,1,0,0,2
4225602,4225622,20,1,0,0,1
4225621,4227029,1408,0,0,1,2
4225623,4227028,1405,0,0,1,1
4227029,4227046,17,1,0,0,1
4227030,4227049,19,1,0,0,2
4227047,4227499,452,0,0,1,1
4227050,4227685,635,0,0,1,2
4227500,4227509,9,1,0,0,1
4227510,4227687,177,0,0,1,1
4227686,4227919,233,1,0,0,2
4227688,4227921,233,1,0,0,1
4227706,4227880,174,0,1,0,2
4227708,4227873,165,0,1,0,1
4227920,4228275,355,0,0,1,2
4227922,4228276,354,0,0,1,1
4228276,4228305,29,1,0,0,2
4228277,4228306,29,1,0,0,1
4228306,4228623,317,0,0,1,2
4228307,4228622,315,0,0,1,1
4228623,4228660,37,1,0,0,1
4228624,4228660,36,1,0,0,2
4228661,4229029,368,0,0,1,1
4228661,4229031,370,0,0,1,2
4229030,4229070,40,1,0,0,1
4229032,4229063,31,1,0,0,2
4229064,4229356,292,0,0,1,2
4229071,4229356,285,0,0,1,1
4229357,4229435,78,1,0,0,2
4229357,4229459,102,1,0,0,1
4229436,4229569,133,0,0,1,2
4229460,4229577,117,0,0,1,1
4229570,4229591,21,1,0,0,2
4229578,4229586,8,1,0,0,1
4229587,4229823,236,0,0,1,1
4229592,4229831,239,0,0,1,2
4229824,4229879,55,1,0,0,1
4229832,4229847,15,1,0,0,2
4229848,4230731,883,0,0,1,2
4229880,4229921,41,0,0,1,1
4229922,4229943,21,1,0,0,1
4229944,4230732,788,0,0,1,1
4230732,4230752,20,1,0,0,2
4230733,4230791,58,1,0,0,1
4230753,4231512,759,0,0,1,2
4230792,4231513,721,0,0,1,1
4231513,4231584,71,1,0,0,2
4231514,4231585,71,1,0,0,1
4231585,4233036,1451,0,0,1,2
4231586,4233036,1450,0,0,1,1
4233037,4233055,18,1,0,0,1
4233037,4233067,30,1,0,0,2
4233056,4233744,688,0,0,1,1
4233068,4233748,680,0,0,1,2
4233745,4233770,25,1,0,0,1
4233749,4233764,15,1,0,0,2
4233765,4233906,141,0,0,1,2
4233771,4233911,140,0,0,1,1
4233907,4234152,245,1,0,0,2
4233912,4234146,234,1,0,0,1
4233931,4234108,177,0,1,0,1
4233931,4234108,177,0,1,0,2
4234147,4235466,1319,0,0,1,1
4234153,4235465,1312,0,0,1,2
4235466,4235563,97,1,0,0,2
4235467,4235568,101,1,0,0,1
4235564,4235648,84,0,0,1,2
4235569,4235650,81,0,0,1,1
4235649,4235684,35,1,0,0,2
4235651,4235692,41,1,0,0,1
4235685,4235895,210,0,0,1,2
4235693,4235901,208,0,0,1,1
4235896,4235911,15,1,0,0,2
4235902,4235912,10,1,0,0,1
4235912,4236725,813,0,0,1,2
4235913,4236723,810,0,0,1,1
4236724,4236759,35,1,0,0,1
4236726,4236751,25,1,0,0,2
4236752,4236897,145,0,0,1,2
4236760,4236898,138,0,0,1,1
4236898,4236921,23,1,0,0,2
4236899,4236931,32,1,0,0,1
4236922,4237028,106,0,0,1,2
4236932,4237027,95,0,0,1,1
4237028,4237090,62,1,0,0,1
4237029,4237082,53,1,0,0,2
4237083,4237259,176,0,0,1,2
4237091,4237258,167,0,0,1,1
4237259,4237292,33,1,0,0,1
4237260,4237280,20,1,0,0,2
4237281,4237689,408,0,0,1,2
4237293,4237684,391,0,0,1,1
4237685,4237715,30,1,0,0,1
4237690,4237701,11,1,0,0,2
4237702,4238955,1253,0,0,1,2
4237716,4238953,1237,0,0,1,1
4238954,4238970,16,1,0,0,1
4238956,4238960,4,1,0,0,2
4238961,4239174,213,0,0,1,2
4238971,4239177,206,0,0,1,1
4239175,4239624,449,1,0,0,2
4239178,4239606,428,1,0,0,1
4239212,4239583,371,0,1,0,2
4239212,4239597,385,0,1,0,1
4239607,4240230,623,0,0,1,1
4239625,4240231,606,0,0,1,2
4240231,4240304,73,1,0,0,1
4240232,4240304,72,1,0,0,2
4240305,4240435,130,0,0,1,2
4240305,4240436,131,0,0,1,1
4240436,4240464,28,1,0,0,2
4240437,4240464,27,1,0,0,1
4240465,4240790,325,0,0,1,1
4240465,4240790,325,0,0,1,2
4240791,4240803,12,1,0,0,1
4240791,4240812,21,1,0,0,2
4240804,4241802,998,0,0,1,1
4240813,4241802,989,0,0,1,2
4241803,4241845,42,1,0,0,2
4241803,4241849,46,1,0,0,1
4241846,4244192,2346,0,0,1,2
4241850,4244186,2336,0,0,1,1
4244187,4244475,288,1,0,0,1
4244193,4244468,275,1,0,0,2
4244211,4244412,201,0,1,0,1
4244211,4244413,202,0,1,0,2
4244469,4245359,890,0,0,1,2
4244476,4245359,883,0,0,1,1
4245360,4245415,55,1,0,0,1
4245360,4245423,63,1,0,0,2
4245416,4245555,139,0,0,1,1
4245424,4245556,132,0,0,1,2
4245556,4245586,30,1,0,0,1
4245557,4245586,29,1,0,0,2
4245587,4245733,146,0,0,1,1
4245587,4245743,156,0,0,1,2
4245734,4245759,25,1,0,0,1
4245744,4245757,13,1,0,0,2
4245758,4247977,2219,0,0,1,2
4245760,4247978,2218,0,0,1,1
4247978,4248038,60,1,0,0,2
4247979,4248050,71,1,0,0,1
4248039,4248250,211,0,0,1,2
4248051,4248251,200,0,0,1,1
4248251,4248273,22,1,0,0,2
4248252,4248264,12,1,0,0,1
4248265,4250059,1794,0,0,1,1
4248274,4250057,1783,0,0,1,2
4250058,4250075,17,1,0,0,2
4250060,4250071,11,1,0,0,1
4250072,4250360,288,0,0,1,1
4250076,4250362,286,0,0,1,2
4250361,4250698,337,1,0,0,1
4250363,4250675,312,1,0,0,2
4250387,4250622,235,0,1,0,2
4250389,4250633,244,0,1,0,1
4250676,4252010,1334,0,0,1,2
4250699,4252010,1311,0,0,1,1
4252011,4252086,75,1,0,0,1
4252011,4252088,77,1,0,0,2
4252087,4252184,97,0,0,1,1
4252089,4252183,94,0,0,1,2
4252184,4252221,37,1,0,0,2
4252185,4252219,34,1,0,0,1
4252220,4252638,418,0,0,1,1
4252222,4252639,417,0,0,1,2
4252639,4252657,18,1,0,0,1
4252640,4252658,18,1,0,0,2
4252658,4252863,205,0,0,1,1
4252659,4252861,202,0,0,1,2
4252862,4252880,18,1,0,0,2
4252864,4252889,25,1,0,0,1
4252881,4253159,278,0,0,1,2
4252890,4254291,1401,0,0,1,1
4253160,4253175,15,1,0,0,2
4253176,4254291,1115,0,0,1,2
4254292,4254366,74,1,0,0,1
4254292,4254366,74,1,0,0,2
4254367,4254453,86,0,0,1,1
4254367,4254453,86,0,0,1,2
4254454,4254474,20,1,0,0,2
4254454,4254484,30,1,0,0,1
4254475,4254617,142,0,0,1,2
4254485,4254617,132,0,0,1,1
4254618,4254632,14,1,0,0,2
4254618,4254634,16,1,0,0,1
4254633,4256404,1771,0,0,1,2
4254635,4256403,1768,0,0,1,1
4256404,4256456,52,1,0,0,1
4256405,4256449,44,1,0,0,2
4256450,4256489,39,0,0,1,2
4256457,4256493,36,0,0,1,1
4256490,4257056,566,1,0,0,2
4256494,4257035,541,1,0,0,1
4256511,4257030,519,0,1,0,2
4256515,4257017,502,0,1,0,1
4257036,4258085,1049,0,0,1,1
4257057,4258085,1028,0,0,1,2
4258086,4258161,75,1,0,0,2
4258086,4258171,85,1,0,0,1
4258162,4258284,122,0,0,1,2
4258172,4258285,113,0,0,1,1
4258285,4258319,34,1,0,0,2
4258286,4258306,20,1,0,0,1
4258307,4258574,267,0,0,1,1
4258320,4258573,253,0,0,1,2
4258574,4258589,15,1,0,0,2
4258575,4258594,19,1,0,0,1
4258590,4260664,2074,0,0,1,2
4258595,4258922,327,0,0,1,1
4258923,4258937,14,1,0,0,1
4258938,4259239,301,0,0,1,1
4259240,4259254,14,1,0,0,1
4259255,4260665,1410,0,0,1,1
4260665,4260719,54,1,0,0,2
4260666,4260731,65,1,0,0,1
4260720,4260837,117,0,0,1,2
4260732,4260837,105,0,0,1,1
4260838,4260878,40,1,0,0,1
4260838,4260878,40,1,0,0,2
4260879,4262902,2023,0,0,1,1
4260879,4263067,2188,0,0,1,2
4262903,4262914,11,1,0,0,1
4262915,4263068,153,0,0,1,1
4263068,4263318,250,1,0,0,2
4263069,4263284,215,1,0,0,1
4263090,4263248,158,0,1,0,2
4263093,4263243,150,0,1,0,1
4263285,4263570,285,0,0,1,1
4263319,4263569,250,0,0,1,2
4263570,4263642,72,1,0,0,2
4263571,4263645,74,1,0,0,1
4263643,4263804,161,0,0,1,2
4263646,4263808,162,0,0,1,1
4263805,4264035,230,1,0,0,2
4263809,4264047,238,1,0,0,1
4263826,4263994,168,0,1,0,2
4263829,4263994,165,0,1,0,1
4264036,4264589,553,0,0,1,2
4264048,4264590,542,0,0,1,1
4264590,4264665,75,1,0,0,2
4264591,4264667,76,1,0,0,1
4264666,4264797,131,0,0,1,2
4264668,4264798,130,0,0,1,1
4264798,4264817,19,1,0,0,2
4264799,4264815,16,1,0,0,1
4264816,4266270,1454,0,0,1,1
4264818,4266272,1454,0,0,1,2
4266271,4266353,82,1,0,0,1
4266273,4266354,81,1,0,0,2
4266354,4266514,160,0,0,1,1
4266355,4266513,158,0,0,1,2
4266514,4266537,23,1,0,0,2
4266515,4266545,30,1,0,0,1
4266538,4268423,1885,0,0,1,2
4266546,4268423,1877,0,0,1,1
4268424,4268445,21,1,0,0,1
4268424,4268447,23,1,0,0,2
4268446,4268580,134,0,0,1,1
4268448,4268576,128,0,0,1,2
4268577,4268890,313,1,0,0,2
4268581,4268850,269,1,0,0,1
4268622,4268798,176,0,1,0,1
4268622,4268808,186,0,1,0,2
4268851,4269251,400,0,0,1,1
4268891,4269252,361,0,0,1,2
4269252,4269304,52,1,0,0,1
4269253,4269302,49,1,0,0,2
4269303,4269859,556,0,0,1,2
4269305,4269859,554,0,0,1,1
4269860,4269944,84,1,0,0,1
4269860,4269953,93,1,0,0,2
4269945,4270041,96,0,0,1,1
4269954,4270041,87,0,0,1,2
4270042,4270063,21,1,0,0,2
4270042,4270074,32,1,0,0,1
4270064,4271047,983,0,0,1,2
4270075,4271326,1251,0,0,1,1
4271048,4271053,5,1,0,0,2
4271054,4271326,272,0,0,1,2
4271327,4271374,47,1,0,0,1
4271327,4271376,49,1,0,0,2
4271375,4271513,138,0,0,1,1
4271377,4271518,141,0,0,1,2
4271514,4271541,27,1,0,0,1
4271519,4271530,11,1,0,0,2
4271531,4273483,1952,0,0,1,2
4271542,4273484,1942,0,0,1,1
4273484,4273808,324,1,0,0,2
4273485,4273847,362,1,0,0,1
4273505,4273739,234,0,1,0,2
4273506,4273769,263,0,1,0,1
4273809,4274770,961,0,0,1,2
4273848,4274770,922,0,0,1,1
4274771,4274837,66,1,0,0,1
4274771,4274838,67,1,0,0,2
4274838,4274962,124,0,0,1,1
4274839,4274961,122,0,0,1,2
4274962,4274991,29,1,0,0,2
4274963,4274994,31,1,0,0,1
4274992,4275279,287,0,0,1,2
4274995,4275279,284,0,0,1,1
4275280,4275301,21,1,0,0,1
4275280,4275301,21,1,0,0,2
4275302,4275612,310,0,0,1,2
4275302,4275613,311,0,0,1,1
4275613,4275635,22,1,0,0,2
4275614,4275631,17,1,0,0,1
4275632,4276528,896,0,0,1,1
4275636,4277227,1591,0,0,1,2
4276529,4276562,33,1,0,0,1
4276563,4277225,662,0,0,1,1
4277226,4277295,69,1,0,0,1
4277228,4277300,72,1,0,0,2
4277296,4278686,1390,0,0,1,1
4277301,4277461,160,0,0,1,2
4277462,4277468,6,1,0,0,2
4277469,4278685,1216,0,0,1,2
4278686,4278704,18,1,0,0,2
4278687,4278704,17,1,0,0,1
4278705,4279444,739,0,0,1,2
4278705,4279446,741,0,0,1,1
4279445,4279686,241,1,0,0,2
4279447,4279698,251,1,0,0,1
4279463,4279655,192,0,1,0,2
4279467,4279654,187,0,1,0,1
4279687,4281022,1335,0,0,1,2
4279699,4281022,1323,0,0,1,1
4281023,4281076,53,1,0,0,1
4281023,4281087,64,1,0,0,2
4281077,4281214,137,0,0,1,1
4281088,4281214,126,0,0,1,2
4281215,4281233,18,1,0,0,2
4281215,4281243,28,1,0,0,1
4281234,4282530,1296,0,0,1,2
4281244,4282529,1285,0,0,1,1
4282530,4282596,66,1,0,0,1
4282531,4282593,62,1,0,0,2
4282594,4282803,209,0,0,1,2
4282597,4282803,206,0,0,1,1
4282804,4282825,21,1,0,0,1
4282804,4282835,31,1,0,0,2
4282826,4284708,1882,0,0,1,1
4282836,4284706,1870,0,0,1,2
4284707,4284932,225,1,0,0,2
4284709,4284942,233,1,0,0,1
4284730,4284880,150,0,1,0,2
4284732,4284872,140,0,1,0,1
4284933,4286045,1112,0,0,1,2
4284943,4286044,1101,0,0,1,1
4286045,4286105,60,1,0,0,1
4286046,4286097,51,1,0,0,2
4286098,4286251,153,0,0,1,2
4286106,4286256,150,0,0,1,1
4286252,4286271,19,1,0,0,2
4286257,4286271,14,1,0,0,1
4286272,4287520,1248,0,0,1,1
4286272,4287521,1249,0,0,1,2
4287521,4287605,84,1,0,0,1
4287522,4287605,83,1,0,0,2
4287606,4287735,129,0,0,1,1
4287606,4287740,134,0,0,1,2
4287736,4287756,20,1,0,0,1
4287741,4287756,15,1,0,0,2
4287757,4289637,1880,0,0,1,1
4287757,4289639,1882,0,0,1,2
4289638,4289669,31,1,0,0,1
4289640,4289668,28,1,0,0,2
4289669,4289731,62,0,0,1,2
4289670,4289728,58,0,0,1,1
4289729,4290011,282,1,0,0,1
4289732,4289952,220,1,0,0,2
4289748,4289949,201,0,1,0,1
4289750,4289926,176,0,1,0,2
4289953,4290141,188,0,0,1,2
4290012,4290139,127,0,0,1,1
4290140,4290164,24,1,0,0,1
4290142,4290161,19,1,0,0,2
4290162,4290369,207,0,0,1,2
4290165,4290368,203,0,0,1,1
4290369,4290418,49,1,0,0,1
4290370,4290428,58,1,0,0,2
4290419,4291097,678,0,0,1,1
4290429,4291097,668,0,0,1,2
4291098,4291185,87,1,0,0,2
4291098,4291195,97,1,0,0,1
4291186,4291292,106,0,0,1,2
4291196,4291292,96,0,0,1,1
4291293,4291323,30,1,0,0,1
4291293,4291324,31,1,0,0,2
4291324,4291488,164,0,0,1,1
4291325,4291488,163,0,0,1,2
4291489,4291519,30,1,0,0,2
4291489,4291526,37,1,0,0,1
4291520,4291715,195,0,0,1,2
4291527,4292498,971,0,0,1,1
4291716,4291726,10,1,0,0,2
4291727,4292499,772,0,0,1,2
4292499,4292524,25,1,0,0,1
4292500,4292518,18,1,0,0,2
4292519,4292705,186,0,0,1,2
4292525,4292706,181,0,0,1,1
4292706,4292776,70,1,0,0,2
4292707,4292778,71,1,0,0,1
4292777,4293068,291,0,0,1,2
4292779,4293066,287,0,0,1,1
4293067,4293089,22,1,0,0,1
4293069,4293102,33,1,0,0,2
4293090,4294413,1323,0,0,1,1
4293103,4294740,1637,0,0,1,2
4294414,4294430,16,1,0,0,1
4294431,4294739,308,0,0,1,1
4294740,4294770,30,1,0,0,1
4294741,4294759,18,1,0,0,2
4294760,4294929,169,0,0,1,2
4294771,4294929,158,0,0,1,1
4294930,4295264,334,1,0,0,1
4294930,4295271,341,1,0,0,2
4294965,4295220,255,0,1,0,2
4294967,4295214,247,0,1,0,1
4295265,4295392,127,0,0,1,1
4295272,4295392,120,0,0,1,2
4295393,4295448,55,1,0,0,2
4295393,4295449,56,1,0,0,1
4295449,4295865,416,0,0,1,2
4295450,4295862,412,0,0,1,1
4295863,4295904,41,1,0,0,1
4295866,4295913,47,1,0,0,2
4295905,4296084,179,0,0,1,1
4295914,4296085,171,0,0,1,2
4296085,4296174,89,1,0,0,1
4296086,4296183,97,1,0,0,2
4296175,4296290,115,0,0,1,1
4296184,4296289,105,0,0,1,2
4296290,4296316,26,1,0,0,2
4296291,4296321,30,1,0,0,1
4296317,4296890,573,0,0,1,2
4296322,4296891,569,0,0,1,1
4296891,4296906,15,1,0,0,2
4296892,4296905,13,1,0,0,1
4296906,4297735,829,0,0,1,1
4296907,4297733,826,0,0,1,2
4297734,4297810,76,1,0,0,2
4297736,4297807,71,1,0,0,1
4297808,4298183,375,0,0,1,1
4297811,4298182,371,0,0,1,2
4298183,4298205,22,1,0,0,2
4298184,4298222,38,1,0,0,1
4298206,4299804,1598,0,0,1,2
4298223,4299342,1119,0,0,1,1
4299343,4299361,18,1,0,0,1
4299362,4299805,443,0,0,1,1
4299805,4300111,306,1,0,0,2
4299806,4300091,285,1,0,0,1
4299849,4300027,178,0,1,0,2
4299854,4300021,167,0,1,0,1
4300092,4301158,1066,0,0,1,1
4300112,4301157,1045,0,0,1,2
4301158,4301241,83,1,0,0,2
4301159,4301283,124,1,0,0,1
4301242,4301423,181,0,0,1,2
4301284,4301418,134,0,0,1,1
4301419,4301429,10,1,0,0,1
4301424,4301428,4,1,0,0,2
4301429,4301612,183,0,0,1,2
4301430,4301617,187,0,0,1,1
4301613,4301623,10,1,0,0,2
4301618,4301634,16,1,0,0,1
4301624,4301897,273,0,0,1,2
4301635,4301892,257,0,0,1,1
4301893,4301912,19,1,0,0,1
4301898,4301902,4,1,0,0,2
4301903,4303326,1423,0,0,1,2
4301913,4303326,1413,0,0,1,1
4303327,4303376,49,1,0,0,2
4303327,4303386,59,1,0,0,1
4303377,4305515,2138,0,0,1,2
4303387,4305515,2128,0,0,1,1
4305516,4305540,24,1,0,0,2
4305516,4305541,25,1,0,0,1
4305541,4305744,203,0,0,1,2
4305542,4305753,211,0,0,1,1
4305745,4306028,283,1,0,0,2
4305754,4305981,227,1,0,0,1
4305774,4305933,159,0,1,0,2
4305776,4305931,155,0,1,0,1
4305982,4306708,726,0,0,1,1
4306029,4306708,679,0,0,1,2
4306709,4306758,49,1,0,0,1
4306709,4306759,50,1,0,0,2
4306759,4307051,292,0,0,1,1
4306760,4307052,292,0,0,1,2
4307052,4307155,103,1,0,0,1
4307053,4307155,102,1,0,0,2
4307156,4307251,95,0,0,1,1
4307156,4307251,95,0,0,1,2
4307252,4307282,30,1,0,0,2
4307252,4307284,32,1,0,0,1
4307283,4307454,171,0,0,1,2
4307285,4307454,169,0,0,1,1
4307455,4307469,14,1,0,0,1
4307455,4307469,14,1,0,0,2
4307470,4307791,321,0,0,1,1
4307470,4307791,321,0,0,1,2
4307792,4307809,17,1,0,0,1
4307792,4307812,20,1,0,0,2
4307810,4309485,1675,0,0,1,1
4307813,4309486,1673,0,0,1,2
4309486,4309536,50,1,0,0,1
4309487,4309531,44,1,0,0,2
4309532,4309754,222,0,0,1,2
4309537,4309753,216,0,0,1,1
4309754,4309785,31,1,0,0,1
4309755,4309777,22,1,0,0,2
4309778,4312077,2299,0,0,1,2
4309786,4312078,2292,0,0,1,1
4312078,4312339,261,1,0,0,2
4312079,4312395,316,1,0,0,1
4312095,4312335,240,0,1,0,1
4312096,4312317,221,0,1,0,2
4312340,4313408,1068,0,0,1,2
4312396,4313407,1011,0,0,1,1
4313408,4313469,61,1,0,0,1
4313409,4313458,49,1,0,0,2
4313459,4313579,120,0,0,1,2
4313470,4313580,110,0,0,1,1
4313580,4313600,20,1,0,0,2
4313581,4313611,30,1,0,0,1
4313601,4313915,314,0,0,1,2
4313612,4313920,308,0,0,1,1
4313916,4313929,13,1,0,0,2
4313921,4313936,15,1,0,0,1
4313930,4314214,284,0,0,1,2
4313937,4314214,277,0,0,1,1
4314215,4314234,19,1,0,0,2
4314215,4314235,20,1,0,0,1
4314235,4315245,1010,0,0,1,2
4314236,4315243,1007,0,0,1,1
4315244,4315314,70,1,0,0,1
4315246,4315314,68,1,0,0,2
4315315,4315422,107,0,0,1,2
4315315,4315423,108,0,0,1,1
4315423,4315449,26,1,0,0,2
4315424,4315451,27,1,0,0,1
4315450,4317415,1965,0,0,1,2
4315452,4317415,1963,0,0,1,1
4317416,4317676,260,1,0,0,2
4317416,4317741,325,1,0,0,1
4317432,4317648,216,0,1,0,2
4317435,4317662,227,0,1,0,1
4317677,4317908,231,0,0,1,2
4317742,4317908,166,0,0,1,1
4317909,4317966,57,1,0,0,2
4317909,4317967,58,1,0,0,1
4317967,4318519,552,0,0,1,2
4317968,4318519,551,0,0,1,1
4318520,4318591,71,1,0,0,1
4318520,4318600,80,1,0,0,2
4318592,4318715,123,0,0,1,1
4318601,4318717,116,0,0,1,2
4318716,4318744,28,1,0,0,1
4318718,4318748,30,1,0,0,2
4318745,4320467,1722,0,0,1,1
4318749,4320468,1719,0,0,1,2
4320468,4320550,82,1,0,0,1
4320469,4320549,80,1,0,0,2
4320550,4320796,246,0,0,1,2
4320551,4320796,245,0,0,1,1
4320797,4320821,24,1,0,0,1
4320797,4320823,26,1,0,0,2
4320822,4322562,1740,0,0,1,1
4320824,4322559,1735,0,0,1,2
4322560,4322571,11,1,0,0,2
4322563,4322574,11,1,0,0,1
4322572,4322809,237,0,0,1,2
4322575,4322808,233,0,0,1,1
4322809,4323052,243,1,0,0,1
4322810,4323009,199,1,0,0,2
4322828,4322986,158,0,1,0,2
4322828,4322999,171,0,1,0,1
4323010,4324010,1000,0,0,1,2
4323053,4324011,958,0,0,1,1
4324011,4324046,35,1,0,0,2
4324012,4324047,35,1,0,0,1
4324047,4324219,172,0,0,1,2
4324048,4324217,169,0,0,1,1
4324218,4324247,29,1,0,0,1
4324220,4324248,28,1,0,0,2
4324248,4324428,180,0,0,1,1
4324249,4324429,180,0,0,1,2
4324429,4324440,11,1,0,0,1
4324430,4324441,11,1,0,0,2
4324441,4324921,480,0,0,1,1
4324442,4324921,479,0,0,1,2
4324922,4324936,14,1,0,0,2
4324922,4324945,23,1,0,0,1
4324937,4325344,407,0,0,1,2
4324946,4325344,398,0,0,1,1
4325345,4325406,61,1,0,0,1
4325345,4325410,65,1,0,0,2
4325407,4325517,110,0,0,1,1
4325411,4325514,103,0,0,1,2
4325515,4325550,35,1,0,0,2
4325518,4325549,31,1,0,0,1
4325550,4325820,270,0,0,1,1
4325551,4325820,269,0,0,1,2
4325821,4325836,15,1,0,0,1
4325821,4325839,18,1,0,0,2
4325837,4326419,582,0,0,1,1
4325840,4326418,578,0,0,1,2
4326419,4326442,23,1,0,0,2
4326420,4326446,26,1,0,0,1
4326443,4327430,987,0,0,1,2
4326447,4327957,1510,0,0,1,1
4327431,4327442,11,1,0,0,2
4327443,4327951,508,0,0,1,2
4327952,4328208,256,1,0,0,2
4327958,4328185,227,1,0,0,1
4327976,4328126,150,0,1,0,2
4327978,4328119,141,0,1,0,1
4328186,4328907,721,0,0,1,1
4328209,4328907,698,0,0,1,2
4328908,4328956,48,1,0,0,1
4328908,4328959,51,1,0,0,2
4328957,4329095,138,0,0,1,1
4328960,4329096,136,0,0,1,2
4329096,4329122,26,1,0,0,1
4329097,4329120,23,1,0,0,2
4329121,4331207,2086,0,0,1,2
4329123,4331209,2086,0,0,1,1
4331208,4331290,82,1,0,0,2
4331210,4331280,70,1,0,0,1
4331281,4331411,130,0,0,1,1
4331291,4331413,122,0,0,1,2
4331412,4331441,29,1,0,0,1
4331414,4331439,25,1,0,0,2
4331440,4331799,359,0,0,1,2
4331442,4331800,358,0,0,1,1
4331800,4331817,17,1,0,0,2
4331801,4331838,37,1,0,0,1
4331818,4333308,1490,0,0,1,2
4331839,4333307,1468,0,0,1,1
4333308,4333611,303,1,0,0,1
4333309,4333617,308,1,0,0,2
4333343,4333562,219,0,1,0,2
4333347,4333565,218,0,1,0,1
4333612,4334097,485,0,0,1,1
4333618,4334097,479,0,0,1,2
4334098,4334148,50,1,0,0,2
4334098,4334150,52,1,0,0,1
4334149,4335094,945,0,0,1,2
4334151,4335094,943,0,0,1,1
