start,end,duration,saccade,blink,fixation,eye
9315193,9315438,245,0,0,1,1
9315193,9315439,246,0,0,1,2
9315439,9315502,63,1,0,0,1
9315440,9315502,62,1,0,0,2
9315503,9315652,149,0,0,1,1
9315503,9315652,149,0,0,1,2
9315653,9315676,23,1,0,0,1
9315653,9315676,23,1,0,0,2
9315677,9316673,996,0,0,1,2
9315677,9316674,997,0,0,1,1
9316674,9316685,11,1,0,0,2
9316675,9316685,10,1,0,0,1
9316686,9316899,213,0,0,1,2
9316686,9317849,1163,0,0,1,1
9316900,9316913,13,1,0,0,2
9316914,9317857,943,0,0,1,2
9317850,9318101,251,1,0,0,1
9317858,9318077,219,1,0,0,2
9317879,9318034,155,0,1,0,2
9317879,9318071,192,0,1,0,1
9318078,9318919,841,0,0,1,2
9318102,9318896,794,0,0,1,1
9318897,9319182,285,1,0,0,1
9318920,9319146,226,1,0,0,2
9318937,9319116,179,0,1,0,1
9318943,9319122,179,0,1,0,2
9319147,9320149,1002,0,0,1,2
9319183,9320138,955,0,0,1,1
9320139,9322957,2818,1,0,0,1
9320150,9322957,2807,1,0,0,2
9320165,9322946,2781,0,1,0,1
9320170,9322946,2776,0,1,0,2
9322958,9323105,147,0,0,1,1
9322958,9323105,147,0,0,1,2
9323106,9323141,35,1,0,0,2
9323106,9323142,36,1,0,0,1
9323142,9324067,925,0,0,1,2
9323143,9323820,677,0,0,1,1
9323821,9323826,5,1,0,0,1
9323827,9324057,230,0,0,1,1
9324058,9324389,331,1,0,0,1
9324068,9324334,266,1,0,0,2
9324084,9324308,224,0,1,0,2
9324087,9324338,251,0,1,0,1
9324335,9324485,150,0,0,1,2
9324390,9324479,89,0,0,1,1
9324480,9324495,15,1,0,0,1
9324486,9324496,10,1,0,0,2
9324496,9325921,1425,0,0,1,1
9324497,9325937,1440,0,0,1,2
9325922,9328405,2483,1,0,0,1
9325938,9328392,2454,1,0,0,2
9325960,9328378,2418,0,1,0,1
9325964,9328362,2398,0,1,0,2
9328393,9328469,76,0,0,1,2
9328406,9328470,64,0,0,1,1
9328470,9328509,39,1,0,0,2
9328471,9328510,39,1,0,0,1
9328510,9328918,408,0,0,1,2
9328511,9328916,405,0,0,1,1
9328917,9328936,19,1,0,0,1
9328919,9328937,18,1,0,0,2
9328937,9329311,374,0,0,1,1
9328938,9329325,387,0,0,1,2
9329312,9329656,344,1,0,0,1
9329326,9329608,282,1,0,0,2
9329341,9329609,268,0,1,0,1
9329352,9329587,235,0,1,0,2
9329609,9329814,205,0,0,1,2
9329657,9329824,167,0,0,1,1
9329815,9329834,19,1,0,0,2
9329825,9329836,11,1,0,0,1
9329835,9330683,848,0,0,1,2
9329837,9330678,841,0,0,1,1
9330679,9331039,360,1,0,0,1
9330684,9330983,299,1,0,0,2
9330701,9330982,281,0,1,0,1
9330708,9330952,244,0,1,0,2
9330984,9331252,268,0,0,1,2
9331040,9331249,209,0,0,1,1
9331250,9331310,60,1,0,0,1
9331253,9331279,26,1,0,0,2
9331280,9331706,426,0,0,1,2
9331311,9331712,401,0,0,1,1
9331707,9331726,19,1,0,0,2
9331713,9331727,14,1,0,0,1
9331727,9332023,296,0,0,1,2
9331728,9332026,298,0,0,1,1
9332024,9332172,148,1,0,0,2
9332027,9332142,115,1,0,0,1
9332073,9332077,4,0,1,0,1
9332106,9332162,56,0,1,0,2
9332143,9332330,187,0,0,1,1
9332173,9332256,83,0,0,1,2
9332257,9332883,626,1,0,0,2
9332331,9333368,1037,1,0,0,1
9332339,9332345,6,0,1,0,2
9332354,9332585,231,0,1,0,1
9332369,9332412,43,0,1,0,2
9332563,9332564,1,0,1,0,2
9332589,9332591,2,0,1,0,2
9332884,9332984,100,0,0,1,2
9332985,9333000,15,1,0,0,2
9333001,9333025,24,0,0,1,2
9333026,9334291,1265,1,0,0,2
9333028,9333329,301,0,1,0,1
9333369,9333512,143,0,0,1,1
9333513,9334828,1315,1,0,0,1
9333525,9334779,1254,0,1,0,1
9333576,9334280,704,0,1,0,2
9334292,9334345,53,0,0,1,2
9334356,9334431,75,0,1,0,2
9334441,9334452,11,1,0,0,2
9334453,9334652,199,0,0,1,2
9334653,9334821,168,1,0,0,2
9334672,9334729,57,0,1,0,2
9334822,9334853,31,0,0,1,2
9334829,9334851,22,0,0,1,1
9334852,9334913,61,1,0,0,1
9334854,9334912,58,1,0,0,2
9334913,9335151,238,0,0,1,2
9334914,9335160,246,0,0,1,1
9335152,9336764,1612,1,0,0,2
9335161,9336766,1605,1,0,0,1
9335190,9336471,1281,0,1,0,2
9335191,9335596,405,0,1,0,1
9335812,9336072,260,0,1,0,1
9336134,9336722,588,0,1,0,1
9336496,9336537,41,0,1,0,2
9336693,9336696,3,0,1,0,2
9336746,9336757,11,0,1,0,1
9336765,9336912,147,0,0,1,2
9336767,9336795,28,0,0,1,1
9336806,9337714,908,0,1,0,1
9336913,9336995,82,1,0,0,2
9336996,9337118,122,0,0,1,2
9337119,9337139,20,1,0,0,2
9337140,9337202,62,0,0,1,2
9337203,9337450,247,1,0,0,2
9337219,9337398,179,0,1,0,2
9337451,9337501,50,0,0,1,2
9337502,9337771,269,1,0,0,2
9337692,9337702,10,0,1,0,2
9337724,9337807,83,1,0,0,1
9337737,9337742,5,0,1,0,1
9337772,9337911,139,0,0,1,2
9337808,9337912,104,0,0,1,1
9337912,9337937,25,1,0,0,2
9337913,9337937,24,1,0,0,1
9337938,9338216,278,0,0,1,2
9337938,9338694,756,0,0,1,1
9338217,9338226,9,1,0,0,2
9338227,9338695,468,0,0,1,2
9338695,9339443,748,1,0,0,1
9338696,9339393,697,1,0,0,2
9338736,9339432,696,0,1,0,1
9338742,9339372,630,0,1,0,2
9339394,9339609,215,0,0,1,2
9339444,9339610,166,0,0,1,1
9339610,9339744,134,1,0,0,2
9339611,9339764,153,1,0,0,1
9339745,9340023,278,0,0,1,2
9339765,9340018,253,0,0,1,1
9340019,9340619,600,1,0,0,1
9340024,9340519,495,1,0,0,2
9340047,9340492,445,0,1,0,2
9340051,9340548,497,0,1,0,1
9340520,9340545,25,0,0,1,2
9340546,9340569,23,1,0,0,2
9340570,9341272,702,0,0,1,2
9340620,9340859,239,0,0,1,1
9340860,9340864,4,1,0,0,1
9340865,9341168,303,0,0,1,1
9341179,9344342,3163,0,1,0,1
9341273,9344192,2919,1,0,0,2
9341288,9344182,2894,0,1,0,2
9344193,9344777,584,0,0,1,2
9344352,9344352,0,1,0,0,1
9344353,9344733,380,0,0,1,1
9344744,9345162,418,0,1,0,1
9344778,9345187,409,1,0,0,2
9344804,9345176,372,0,1,0,2
9345172,9345186,14,1,0,0,1
9345187,9345265,78,0,0,1,1
9345188,9345267,79,0,0,1,2
9345266,9345292,26,1,0,0,1
9345268,9345286,18,1,0,0,2
9345287,9345525,238,0,0,1,2
9345293,9345498,205,0,0,1,1
9345499,9346430,931,1,0,0,1
9345526,9346431,905,1,0,0,2
9345541,9346402,861,0,1,0,1
9345567,9346420,853,0,1,0,2
9346431,9346600,169,0,0,1,1
9346432,9346602,170,0,0,1,2
9346601,9346629,28,1,0,0,1
9346603,9346629,26,1,0,0,2
9346630,9347132,502,0,0,1,1
9346630,9347132,502,0,0,1,2
9347133,9347196,63,1,0,0,2
9347133,9347221,88,1,0,0,1
9347197,9347403,206,0,0,1,2
9347222,9347382,160,0,0,1,1
9347383,9347608,225,1,0,0,1
9347404,9347615,211,1,0,0,2
9347420,9347563,143,0,1,0,1
9347423,9347564,141,0,1,0,2
9347609,9347830,221,0,0,1,1
9347616,9347831,215,0,0,1,2
9347831,9347990,159,1,0,0,1
9347832,9347969,137,1,0,0,2
9347970,9348118,148,0,0,1,2
9347991,9348118,127,0,0,1,1
9348119,9348162,43,1,0,0,2
9348119,9348163,44,1,0,0,1
9348163,9348482,319,0,0,1,2
9348164,9348486,322,0,0,1,1
9348483,9348955,472,1,0,0,2
9348487,9349005,518,1,0,0,1
9348518,9348982,464,0,1,0,1
9348520,9348928,408,0,1,0,2
9348956,9349116,160,0,0,1,2
9349006,9349115,109,0,0,1,1
9349116,9349148,32,1,0,0,1
9349117,9349148,31,1,0,0,2
9349149,9349536,387,0,0,1,2
9349149,9349537,388,0,0,1,1
9349537,9349544,7,1,0,0,2
9349538,9349549,11,1,0,0,1
9349545,9350357,812,0,0,1,2
9349550,9350342,792,0,0,1,1
9350343,9350682,339,1,0,0,1
9350358,9350617,259,1,0,0,2
9350374,9350627,253,0,1,0,1
9350380,9350590,210,0,1,0,2
9350618,9350669,51,0,0,1,2
9350670,9350719,49,1,0,0,2
9350683,9350743,60,0,0,1,1
9350720,9350786,66,0,0,1,2
9350744,9350805,61,1,0,0,1
9350787,9350803,16,1,0,0,2
9350804,9352288,1484,0,0,1,2
9350806,9350859,53,0,0,1,1
9350860,9350900,40,1,0,0,1
9350901,9351925,1024,0,0,1,1
9351926,9351938,12,1,0,0,1
9351939,9352031,92,0,0,1,1
9352032,9352048,16,1,0,0,1
9352049,9352114,65,0,0,1,1
9352115,9352180,65,1,0,0,1
9352181,9352282,101,0,0,1,1
9352283,9352301,18,1,0,0,1
9352289,9352300,11,1,0,0,2
9352301,9354320,2019,0,0,1,2
9352302,9352710,408,0,0,1,1
9352711,9352720,9,1,0,0,1
9352721,9353656,935,0,0,1,1
9353657,9353689,32,1,0,0,1
9353690,9353852,162,0,0,1,1
9353853,9353872,19,1,0,0,1
9353873,9354318,445,0,0,1,1
9354319,9354415,96,1,0,0,1
9354321,9354409,88,1,0,0,2
9354410,9354444,34,0,0,1,2
9354416,9354442,26,0,0,1,1
9354443,9354551,108,1,0,0,1
9354445,9354515,70,1,0,0,2
9354464,9354466,2,0,1,0,1
9354516,9354725,209,0,0,1,2
9354552,9354704,152,0,0,1,1
9354705,9355148,443,1,0,0,1
9354726,9355003,277,1,0,0,2
9354747,9354996,249,0,1,0,1
9354753,9354975,222,0,1,0,2
9355004,9355118,114,0,0,1,2
9355119,9355142,23,1,0,0,2
9355143,9355333,190,0,0,1,2
9355149,9355273,124,0,0,1,1
9355274,9355290,16,1,0,0,1
9355291,9355333,42,0,0,1,1
9355334,9355463,129,1,0,0,2
9355334,9355503,169,1,0,0,1
9355363,9355372,9,0,1,0,1
9355464,9355883,419,0,0,1,2
9355504,9355860,356,0,0,1,1
9355861,9356206,345,1,0,0,1
9355884,9356163,279,1,0,0,2
9355902,9356185,283,0,1,0,1
9355922,9356146,224,0,1,0,2
9356164,9356342,178,0,0,1,2
9356207,9356342,135,0,0,1,1
9356343,9356372,29,1,0,0,1
9356343,9356373,30,1,0,0,2
9356373,9356925,552,0,0,1,1
9356374,9359995,3621,0,0,1,2
9356926,9356938,12,1,0,0,1
9356939,9361693,4754,0,0,1,1
9359996,9360000,4,1,0,0,2
9360001,9361693,1692,0,0,1,2
9361694,9361746,52,1,0,0,2
9361694,9361749,55,1,0,0,1
9361747,9361929,182,0,0,1,2
9361750,9361929,179,0,0,1,1
9361930,9361942,12,1,0,0,1
9361930,9361943,13,1,0,0,2
9361943,9365203,3260,0,0,1,1
9361944,9365210,3266,0,0,1,2
9365204,9365503,299,1,0,0,1
9365211,9365472,261,1,0,0,2
9365235,9365492,257,0,1,0,1
9365236,9365384,148,0,1,0,2
9365473,9365602,129,0,0,1,2
9365504,9365603,99,0,0,1,1
9365603,9365655,52,1,0,0,2
9365604,9365653,49,1,0,0,1
9365654,9365845,191,0,0,1,1
9365656,9365844,188,0,0,1,2
9365845,9365938,93,1,0,0,2
9365846,9365986,140,1,0,0,1
9365939,9366039,100,0,0,1,2
9365987,9366038,51,0,0,1,1
9366039,9366062,23,1,0,0,1
9366040,9366062,22,1,0,0,2
9366063,9368286,2223,0,0,1,1
9366063,9368287,2224,0,0,1,2
9368287,9368354,67,1,0,0,1
9368288,9368355,67,1,0,0,2
9368355,9368742,387,0,0,1,1
9368356,9368741,385,0,0,1,2
9368742,9368797,55,1,0,0,2
9368743,9368803,60,1,0,0,1
9368798,9368966,168,0,0,1,2
9368804,9368966,162,0,0,1,1
9368967,9368985,18,1,0,0,1
9368967,9368985,18,1,0,0,2
9368986,9371263,2277,0,0,1,1
9368986,9371264,2278,0,0,1,2
9371264,9371374,110,1,0,0,1
9371265,9371360,95,1,0,0,2
9371361,9371403,42,0,0,1,2
9371375,9371405,30,0,0,1,1
9371404,9371437,33,1,0,0,2
9371406,9371435,29,1,0,0,1
9371436,9371503,67,0,0,1,1
9371438,9371499,61,0,0,1,2
9371500,9371532,32,1,0,0,2
9371504,9371533,29,1,0,0,1
9371533,9373453,1920,0,0,1,2
9371534,9373452,1918,0,0,1,1
9373453,9373530,77,1,0,0,1
9373454,9373532,78,1,0,0,2
9373531,9373763,232,0,0,1,1
9373533,9373765,232,0,0,1,2
9373764,9373809,45,1,0,0,1
9373766,9373808,42,1,0,0,2
9373809,9373938,129,0,0,1,2
9373810,9373939,129,0,0,1,1
9373939,9373958,19,1,0,0,2
9373940,9373959,19,1,0,0,1
9373959,9374742,783,0,0,1,2
9373960,9374736,776,0,0,1,1
9374737,9374970,233,1,0,0,1
9374743,9374941,198,1,0,0,2
9374760,9374904,144,0,1,0,2
9374763,9374915,152,0,1,0,1
9374942,9375128,186,0,0,1,2
9374971,9375127,156,0,0,1,1
9375128,9375139,11,1,0,0,1
9375129,9375138,9,1,0,0,2
9375139,9376857,1718,0,0,1,2
9375140,9376857,1717,0,0,1,1
9376858,9376916,58,1,0,0,2
9376858,9376917,59,1,0,0,1
9376917,9377045,128,0,0,1,2
9376918,9377045,127,0,0,1,1
9377046,9377064,18,1,0,0,1
9377046,9377065,19,1,0,0,2
9377065,9377134,69,0,0,1,1
9377066,9377134,68,0,0,1,2
9377135,9377146,11,1,0,0,1
9377135,9377149,14,1,0,0,2
9377147,9377318,171,0,0,1,1
9377150,9377640,490,0,0,1,2
9377319,9377328,9,1,0,0,1
9377329,9377634,305,0,0,1,1
9377635,9377884,249,1,0,0,1
9377641,9377854,213,1,0,0,2
9377657,9377820,163,0,1,0,2
9377657,9377847,190,0,1,0,1
9377855,9380077,2222,0,0,1,2
9377885,9380076,2191,0,0,1,1
9380077,9380268,191,1,0,0,1
9380078,9380275,197,1,0,0,2
9380131,9380212,81,0,1,0,1
9380136,9380204,68,0,1,0,2
9380269,9380362,93,0,0,1,1
9380276,9380360,84,0,0,1,2
9380361,9380389,28,1,0,0,2
9380363,9380389,26,1,0,0,1
9380390,9380456,66,0,0,1,1
9380390,9380458,68,0,0,1,2
9380457,9380483,26,1,0,0,1
9380459,9380491,32,1,0,0,2
9380484,9380821,337,0,0,1,1
9380492,9380815,323,0,0,1,2
9380816,9380833,17,1,0,0,2
9380822,9380833,11,1,0,0,1
9380834,9382554,1720,0,0,1,1
9380834,9382558,1724,0,0,1,2
9382555,9382650,95,1,0,0,1
9382559,9382650,91,1,0,0,2
9382651,9382938,287,0,0,1,1
9382651,9382941,290,0,0,1,2
9382939,9383008,69,1,0,0,1
9382942,9383008,66,1,0,0,2
9383009,9383107,98,0,0,1,2
9383009,9383108,99,0,0,1,1
9383108,9383131,23,1,0,0,2
9383109,9383145,36,1,0,0,1
9383132,9385174,2042,0,0,1,2
9383146,9385173,2027,0,0,1,1
9385174,9385223,49,1,0,0,1
9385175,9385223,48,1,0,0,2
9385224,9385339,115,0,0,1,2
9385224,9385340,116,0,0,1,1
9385340,9385363,23,1,0,0,2
9385341,9385365,24,1,0,0,1
9385364,9385606,242,0,0,1,2
9385366,9385604,238,0,0,1,1
9385605,9385792,187,1,0,0,1
9385607,9385777,170,1,0,0,2
9385627,9385726,99,0,1,0,2
9385628,9385743,115,0,1,0,1
9385778,9387945,2167,0,0,1,2
9385793,9387949,2156,0,0,1,1
9387946,9388154,208,1,0,0,2
9387950,9388156,206,1,0,0,1
9387971,9388101,130,0,1,0,2
9387975,9388102,127,0,1,0,1
9388155,9388363,208,0,0,1,2
9388157,9388365,208,0,0,1,1
9388364,9388435,71,1,0,0,2
9388366,9388434,68,1,0,0,1
9388435,9388526,91,0,0,1,1
9388436,9388527,91,0,0,1,2
9388527,9388555,28,1,0,0,1
9388528,9388555,27,1,0,0,2
9388556,9388669,113,0,0,1,1
9388556,9388671,115,0,0,1,2
9388670,9388689,19,1,0,0,1
9388672,9388689,17,1,0,0,2
9388690,9390299,1609,0,0,1,2
9388690,9390308,1618,0,0,1,1
9390300,9390547,247,1,0,0,2
9390309,9390609,300,1,0,0,1
9390344,9390423,79,0,1,0,2
9390348,9390422,74,0,1,0,1
9390548,9391020,472,0,0,1,2
9390610,9391023,413,0,0,1,1
9391021,9391032,11,1,0,0,2
9391024,9391033,9,1,0,0,1
9391033,9391302,269,0,0,1,2
9391034,9392535,1501,0,0,1,1
9391303,9391312,9,1,0,0,2
9391313,9392536,1223,0,0,1,2
9392536,9392578,42,1,0,0,1
9392537,9392577,40,1,0,0,2
9392578,9392706,128,0,0,1,2
9392579,9392710,131,0,0,1,1
9392707,9392728,21,1,0,0,2
9392711,9392728,17,1,0,0,1
9392729,9392865,136,0,0,1,1
9392729,9392868,139,0,0,1,2
9392866,9392877,11,1,0,0,1
9392869,9392879,10,1,0,0,2
9392878,9394617,1739,0,0,1,1
9392880,9394616,1736,0,0,1,2
9394617,9394789,172,1,0,0,2
9394618,9394776,158,1,0,0,1
9394659,9394736,77,0,1,0,1
9394660,9394738,78,0,1,0,2
9394777,9394980,203,0,0,1,1
9394790,9394984,194,0,0,1,2
9394981,9395225,244,1,0,0,1
9394985,9395216,231,1,0,0,2
9395006,9395179,173,0,1,0,1
9395011,9395183,172,0,1,0,2
9395217,9395410,193,0,0,1,2
9395226,9395412,186,0,0,1,1
9395411,9395479,68,1,0,0,2
9395413,9395482,69,1,0,0,1
9395480,9395590,110,0,0,1,2
9395483,9395590,107,0,0,1,1
9395591,9395612,21,1,0,0,1
9395591,9395612,21,1,0,0,2
9395613,9395712,99,0,0,1,2
9395613,9395976,363,0,0,1,1
9395713,9395729,16,1,0,0,2
9395730,9395973,243,0,0,1,2
9395974,9396199,225,1,0,0,2
9395977,9396212,235,1,0,0,1
9395995,9396136,141,0,1,0,2
9395997,9396150,153,0,1,0,1
9396200,9398339,2139,0,0,1,2
9396213,9397620,1407,0,0,1,1
9397621,9397645,24,1,0,0,1
9397646,9397679,33,0,0,1,1
9397680,9397702,22,1,0,0,1
9397703,9398342,639,0,0,1,1
9398340,9398448,108,1,0,0,2
9398343,9398476,133,1,0,0,1
9398371,9398394,23,0,1,0,2
9398373,9398388,15,0,1,0,1
9398449,9398474,25,0,0,1,2
9398475,9398492,17,1,0,0,2
9398477,9398568,91,0,0,1,1
9398493,9398568,75,0,0,1,2
9398569,9398780,211,1,0,0,2
9398569,9398806,237,1,0,0,1
9398599,9398735,136,0,1,0,2
9398606,9398744,138,0,1,0,1
9398781,9398899,118,0,0,1,2
9398807,9398901,94,0,0,1,1
9398900,9398980,80,1,0,0,2
9398902,9398990,88,1,0,0,1
9398981,9399100,119,0,0,1,2
9398991,9399099,108,0,0,1,1
9399100,9399130,30,1,0,0,1
9399101,9399123,22,1,0,0,2
9399124,9399325,201,0,0,1,2
9399131,9399325,194,0,0,1,1
9399326,9399335,9,1,0,0,2
9399326,9399336,10,1,0,0,1
9399336,9401803,2467,0,0,1,2
9399337,9401789,2452,0,0,1,1
9401790,9401949,159,1,0,0,1
9401804,9401950,146,1,0,0,2
9401848,9401894,46,0,1,0,1
9401950,9402253,303,0,0,1,1
9401951,9402254,303,0,0,1,2
9402254,9402293,39,1,0,0,1
9402255,9402292,37,1,0,0,2
9402293,9402427,134,0,0,1,2
9402294,9402423,129,0,0,1,1
9402424,9402446,22,1,0,0,1
9402428,9402446,18,1,0,0,2
9402447,9402620,173,0,0,1,1
9402447,9402620,173,0,0,1,2
9402621,9402630,9,1,0,0,2
9402621,9402632,11,1,0,0,1
9402631,9402695,64,0,0,1,2
9402633,9402695,62,0,0,1,1
9402696,9402922,226,1,0,0,1
9402696,9402928,232,1,0,0,2
9402717,9402888,171,0,1,0,2
9402719,9402897,178,0,1,0,1
9402923,9404648,1725,0,0,1,1
9402929,9404644,1715,0,0,1,2
9404645,9404835,190,1,0,0,2
9404649,9404828,179,1,0,0,1
9404677,9404791,114,0,1,0,1
9404682,9404780,98,0,1,0,2
9404829,9405298,469,0,0,1,1
9404836,9405298,462,0,0,1,2
9405299,9405371,72,1,0,0,2
9405299,9405378,79,1,0,0,1
9405372,9405481,109,0,0,1,2
9405379,9405487,108,0,0,1,1
9405482,9405516,34,1,0,0,2
9405488,9405516,28,1,0,0,1
9405517,9405753,236,0,0,1,2
9405517,9406980,1463,0,0,1,1
9405754,9405759,5,1,0,0,2
9405760,9406993,1233,0,0,1,2
9406981,9407272,291,1,0,0,1
9406994,9407219,225,1,0,0,2
9407007,9407228,221,0,1,0,1
9407010,9407198,188,0,1,0,2
9407220,9407882,662,0,0,1,2
9407273,9407888,615,0,0,1,1
9407883,9408033,150,1,0,0,2
9407889,9408043,154,1,0,0,1
9408034,9408071,37,0,0,1,2
9408044,9408073,29,0,0,1,1
9408072,9408115,43,1,0,0,2
9408074,9408115,41,1,0,0,1
9408116,9408160,44,0,0,1,2
9408116,9408163,47,0,0,1,1
9408161,9408189,28,1,0,0,2
9408164,9408189,25,1,0,0,1
9408190,9408258,68,0,0,1,1
9408190,9408259,69,0,0,1,2
9408259,9408293,34,1,0,0,1
9408260,9408293,33,1,0,0,2
9408294,9408422,128,0,0,1,1
9408294,9408424,130,0,0,1,2
9408423,9408452,29,1,0,0,1
9408425,9408445,20,1,0,0,2
9408446,9410126,1680,0,0,1,2
9408453,9410138,1685,0,0,1,1
9410127,9410371,244,1,0,0,2
9410139,9410374,235,1,0,0,1
9410212,9410330,118,0,1,0,2
9410212,9410336,124,0,1,0,1
9410372,9410566,194,0,0,1,2
9410375,9410569,194,0,0,1,1
9410567,9410620,53,1,0,0,2
9410570,9410622,52,1,0,0,1
9410621,9410746,125,0,0,1,2
9410623,9410748,125,0,0,1,1
9410747,9410770,23,1,0,0,2
9410749,9410769,20,1,0,0,1
9410770,9411122,352,0,0,1,1
9410771,9413292,2521,0,0,1,2
9411123,9411128,5,1,0,0,1
9411129,9413292,2163,0,0,1,1
9413293,9413373,80,1,0,0,2
9413293,9413379,86,1,0,0,1
9413374,9413456,82,0,0,1,2
9413380,9413455,75,0,0,1,1
9413456,9413490,34,1,0,0,1
9413457,9413488,31,1,0,0,2
9413489,9413732,243,0,0,1,2
9413491,9413733,242,0,0,1,1
9413733,9413743,10,1,0,0,2
9413734,9413743,9,1,0,0,1
9413744,9414430,686,0,0,1,2
9413744,9414438,694,0,0,1,1
9414431,9414666,235,1,0,0,2
9414439,9414677,238,1,0,0,1
9414464,9414634,170,0,1,0,1
9414469,9414622,153,0,1,0,2
9414667,9414846,179,0,0,1,2
9414678,9415587,909,0,0,1,1
9414847,9414858,11,1,0,0,2
9414859,9415589,730,0,0,1,2
9415588,9415784,196,1,0,0,1
9415590,9415774,184,1,0,0,2
9415617,9415746,129,0,1,0,1
9415621,9415726,105,0,1,0,2
9415775,9416142,367,0,0,1,2
9415785,9416145,360,0,0,1,1
9416143,9416205,62,1,0,0,2
9416146,9416207,61,1,0,0,1
9416206,9416387,181,0,0,1,2
9416208,9416390,182,0,0,1,1
9416388,9416457,69,1,0,0,2
9416391,9416458,67,1,0,0,1
9416458,9416557,99,0,0,1,2
9416459,9416558,99,0,0,1,1
9416558,9416581,23,1,0,0,2
9416559,9416596,37,1,0,0,1
9416582,9418359,1777,0,0,1,2
9416597,9418356,1759,0,0,1,1
9418357,9418634,277,1,0,0,1
9418360,9418606,246,1,0,0,2
9418389,9418554,165,0,1,0,2
9418389,9418590,201,0,1,0,1
9418607,9418901,294,0,0,1,2
9418635,9418900,265,0,0,1,1
9418901,9419003,102,1,0,0,1
9418902,9418988,86,1,0,0,2
9418989,9419126,137,0,0,1,2
9419004,9419128,124,0,0,1,1
9419127,9419149,22,1,0,0,2
9419129,9419149,20,1,0,0,1
9419150,9420796,1646,0,0,1,2
9419150,9420798,1648,0,0,1,1
9420797,9420894,97,1,0,0,2
9420799,9420903,104,1,0,0,1
9420895,9421112,217,0,0,1,2
9420904,9421115,211,0,0,1,1
9421113,9421347,234,1,0,0,2
9421116,9421359,243,1,0,0,1
9421151,9421278,127,0,1,0,2
9421153,9421324,171,0,1,0,1
9421348,9421494,146,0,0,1,2
9421360,9421494,134,0,0,1,1
9421495,9421569,74,1,0,0,2
9421495,9421577,82,1,0,0,1
9421570,9421662,92,0,0,1,2
9421578,9421662,84,0,0,1,1
9421663,9421687,24,1,0,0,2
9421663,9421688,25,1,0,0,1
9421688,9424098,2410,0,0,1,2
9421689,9424098,2409,0,0,1,1
9424099,9424228,129,1,0,0,1
9424099,9424235,136,1,0,0,2
9424167,9424181,14,0,1,0,2
9424229,9424368,139,0,0,1,1
9424236,9424368,132,0,0,1,2
9424369,9424390,21,1,0,0,1
9424369,9424391,22,1,0,0,2
9424391,9425019,628,0,0,1,1
9424392,9426056,1664,0,0,1,2
9425020,9425033,13,1,0,0,1
9425034,9426060,1026,0,0,1,1
9426057,9426306,249,1,0,0,2
9426061,9426329,268,1,0,0,1
9426119,9426247,128,0,1,0,2
9426123,9426277,154,0,1,0,1
9426307,9426519,212,0,0,1,2
9426330,9426519,189,0,0,1,1
9426520,9426586,66,1,0,0,1
9426520,9426586,66,1,0,0,2
9426587,9426712,125,0,0,1,2
9426587,9426713,126,0,0,1,1
9426713,9426744,31,1,0,0,2
9426714,9426745,31,1,0,0,1
9426745,9427527,782,0,0,1,2
9426746,9427525,779,0,0,1,1
9427526,9427539,13,1,0,0,1
9427528,9427536,8,1,0,0,2
9427537,9428664,1127,0,0,1,2
9427540,9428663,1123,0,0,1,1
9428664,9428871,207,1,0,0,1
9428665,9428855,190,1,0,0,2
9428692,9428825,133,0,1,0,1
9428694,9428810,116,0,1,0,2
9428856,9429104,248,0,0,1,2
9428872,9429104,232,0,0,1,1
9429105,9429147,42,1,0,0,2
9429105,9429148,43,1,0,0,1
9429148,9431134,1986,0,0,1,2
9429149,9431134,1985,0,0,1,1
9431135,9431186,51,1,0,0,1
9431135,9431186,51,1,0,0,2
9431187,9431326,139,0,0,1,2
9431187,9431328,141,0,0,1,1
9431327,9431343,16,1,0,0,2
9431329,9431342,13,1,0,0,1
9431343,9432641,1298,0,0,1,1
9431344,9432641,1297,0,0,1,2
9432642,9432804,162,1,0,0,2
9432642,9432813,171,1,0,0,1
9432669,9432743,74,0,1,0,2
9432677,9432744,67,0,1,0,1
9432805,9433276,471,0,0,1,2
9432814,9433277,463,0,0,1,1
9433277,9433336,59,1,0,0,2
9433278,9433332,54,1,0,0,1
9433333,9433594,261,0,0,1,1
9433337,9433594,257,0,0,1,2
9433595,9433686,91,1,0,0,2
9433595,9433689,94,1,0,0,1
9433687,9433784,97,0,0,1,2
9433690,9433783,93,0,0,1,1
9433784,9433815,31,1,0,0,1
9433785,9433817,32,1,0,0,2
9433816,9434070,254,0,0,1,1
9433818,9434069,251,0,0,1,2
9434070,9434081,11,1,0,0,2
9434071,9434082,11,1,0,0,1
9434082,9435308,1226,0,0,1,2
9434083,9435312,1229,0,0,1,1
9435309,9435539,230,1,0,0,2
9435313,9435549,236,1,0,0,1
9435403,9435498,95,0,1,0,1
9435406,9435470,64,0,1,0,2
9435540,9435815,275,0,0,1,2
9435550,9435815,265,0,0,1,1
9435816,9435880,64,1,0,0,2
9435816,9435882,66,1,0,0,1
9435881,9435970,89,0,0,1,2
9435883,9435970,87,0,0,1,1
9435971,9435995,24,1,0,0,1
9435971,9436002,31,1,0,0,2
9435996,9436334,338,0,0,1,1
9436003,9436333,330,0,0,1,2
9436334,9436343,9,1,0,0,2
9436335,9436346,11,1,0,0,1
9436344,9437979,1635,0,0,1,2
9436347,9437978,1631,0,0,1,1
9437979,9438074,95,1,0,0,1
9437980,9438071,91,1,0,0,2
9438072,9438108,36,0,0,1,2
9438075,9438111,36,0,0,1,1
9438109,9438155,46,1,0,0,2
9438112,9438154,42,1,0,0,1
9438155,9438203,48,0,0,1,1
9438156,9438205,49,0,0,1,2
9438204,9438230,26,1,0,0,1
9438206,9438230,24,1,0,0,2
9438231,9438290,59,0,0,1,1
9438231,9438291,60,0,0,1,2
9438291,9438321,30,1,0,0,1
9438292,9438314,22,1,0,0,2
9438315,9438626,311,0,0,1,2
9438322,9438622,300,0,0,1,1
9438623,9438638,15,1,0,0,1
9438627,9438635,8,1,0,0,2
9438636,9440295,1659,0,0,1,2
9438639,9440275,1636,0,0,1,1
9440276,9440524,248,1,0,0,1
9440296,9440510,214,1,0,0,2
9440345,9440460,115,0,1,0,2
9440345,9440479,134,0,1,0,1
9440511,9440734,223,0,0,1,2
9440525,9440736,211,0,0,1,1
9440735,9440788,53,1,0,0,2
9440737,9440790,53,1,0,0,1
9440789,9440819,30,0,0,1,2
9440791,9440910,119,0,0,1,1
9440820,9440828,8,1,0,0,2
9440829,9440908,79,0,0,1,2
9440909,9440930,21,1,0,0,2
9440911,9440928,17,1,0,0,1
9440929,9442132,1203,0,0,1,1
9440931,9442140,1209,0,0,1,2
9442133,9442547,414,1,0,0,1
9442141,9442523,382,1,0,0,2
9442169,9442534,365,0,1,0,1
9442170,9442504,334,0,1,0,2
9442524,9442806,282,0,0,1,2
9442548,9442589,41,0,0,1,1
9442590,9442604,14,1,0,0,1
9442605,9442627,22,0,0,1,1
9442628,9442644,16,1,0,0,1
9442645,9442808,163,0,0,1,1
9442807,9443053,246,1,0,0,2
9442809,9443070,261,1,0,0,1
9442837,9443026,189,0,1,0,2
9442841,9443034,193,0,1,0,1
9443054,9443244,190,0,0,1,2
9443071,9443129,58,0,0,1,1
9443130,9443149,19,1,0,0,1
9443150,9443243,93,0,0,1,1
9443244,9443333,89,1,0,0,1
9443245,9443331,86,1,0,0,2
9443332,9443525,193,0,0,1,2
9443334,9443526,192,0,0,1,1
9443526,9443546,20,1,0,0,2
9443527,9443543,16,1,0,0,1
9443544,9443991,447,0,0,1,1
9443547,9443987,440,0,0,1,2
9443988,9444004,16,1,0,0,2
9443992,9444004,12,1,0,0,1
9444005,9445052,1047,0,0,1,1
9444005,9445054,1049,0,0,1,2
9445053,9445292,239,1,0,0,1
9445055,9445313,258,1,0,0,2
9445110,9445148,38,0,1,0,2
9445117,9445149,32,0,1,0,1
9445293,9445474,181,0,0,1,1
9445314,9445474,160,0,0,1,2
9445475,9445529,54,1,0,0,1
9445475,9445530,55,1,0,0,2
9445530,9445686,156,0,0,1,1
9445531,9445685,154,0,0,1,2
9445686,9445705,19,1,0,0,2
9445687,9445707,20,1,0,0,1
9445706,9445917,211,0,0,1,2
9445708,9445919,211,0,0,1,1
9445918,9445930,12,1,0,0,2
9445920,9445925,5,1,0,0,1
9445926,9446959,1033,0,0,1,1
9445931,9446966,1035,0,0,1,2
9446960,9447205,245,1,0,0,1
9446967,9447174,207,1,0,0,2
9446990,9447078,88,0,1,0,2
9446994,9447101,107,0,1,0,1
9447175,9447381,206,0,0,1,2
9447206,9447368,162,0,0,1,1
9447369,9447640,271,1,0,0,1
9447382,9447607,225,1,0,0,2
9447406,9447556,150,0,1,0,1
9447409,9447547,138,0,1,0,2
9447608,9447821,213,0,0,1,2
9447641,9447822,181,0,0,1,1
9447822,9447871,49,1,0,0,2
9447823,9447881,58,1,0,0,1
9447872,9447973,101,0,0,1,2
9447882,9447973,91,0,0,1,1
9447974,9447996,22,1,0,0,2
9447974,9447997,23,1,0,0,1
9447997,9448342,345,0,0,1,2
9447998,9448339,341,0,0,1,1
9448340,9448355,15,1,0,0,1
9448343,9448353,10,1,0,0,2
9448354,9449243,889,0,0,1,2
9448356,9449246,890,0,0,1,1
9449244,9449462,218,1,0,0,2
9449247,9449502,255,1,0,0,1
9449277,9449427,150,0,1,0,1
9449279,9449403,124,0,1,0,2
9449463,9450126,663,0,0,1,2
9449503,9450127,624,0,0,1,1
9450127,9450213,86,1,0,0,2
9450128,9450214,86,1,0,0,1
9450214,9450258,44,0,0,1,2
9450215,9450258,43,0,0,1,1
9450259,9450286,27,1,0,0,1
9450259,9450287,28,1,0,0,2
9450287,9450338,51,0,0,1,1
9450288,9450337,49,0,0,1,2
9450338,9450371,33,1,0,0,2
9450339,9450363,24,1,0,0,1
9450364,9450438,74,0,0,1,1
9450372,9450438,66,0,0,1,2
9450439,9450461,22,1,0,0,2
9450439,9450470,31,1,0,0,1
9450462,9450701,239,0,0,1,2
9450471,9450696,225,0,0,1,1
9450697,9450714,17,1,0,0,1
9450702,9450712,10,1,0,0,2
9450713,9451487,774,0,0,1,2
9450715,9451487,772,0,0,1,1
9451488,9451539,51,1,0,0,2
9451488,9451541,53,1,0,0,1
9451540,9451948,408,0,0,1,2
9451542,9451946,404,0,0,1,1
9451947,9452032,85,1,0,0,1
9451949,9452024,75,1,0,0,2
9452025,9452132,107,0,0,1,2
9452033,9452129,96,0,0,1,1
9452130,9452243,113,1,0,0,1
9452133,9452243,110,1,0,0,2
9452165,9452187,22,0,1,0,1
9452244,9452479,235,0,0,1,1
9452244,9452479,235,0,0,1,2
9452480,9452563,83,1,0,0,1
9452480,9452563,83,1,0,0,2
9452564,9452925,361,0,0,1,1
9452564,9452926,362,0,0,1,2
9452926,9452936,10,1,0,0,1
9452927,9452938,11,1,0,0,2
9452937,9454080,1143,0,0,1,1
9452939,9454078,1139,0,0,1,2
9454079,9454137,58,1,0,0,2
9454081,9454144,63,1,0,0,1
9454138,9454524,386,0,0,1,2
9454145,9454524,379,0,0,1,1
9454525,9454595,70,1,0,0,1
9454525,9454597,72,1,0,0,2
9454596,9454816,220,0,0,1,1
9454598,9455732,1134,0,0,1,2
9454817,9454825,8,1,0,0,1
9454826,9455742,916,0,0,1,1
9455733,9455938,205,1,0,0,2
9455743,9455935,192,1,0,0,1
9455782,9455887,105,0,1,0,2
9455783,9455896,113,0,1,0,1
9455936,9456268,332,0,0,1,1
9455939,9456265,326,0,0,1,2
9456266,9456337,71,1,0,0,2
9456269,9456338,69,1,0,0,1
9456338,9456663,325,0,0,1,2
9456339,9456662,323,0,0,1,1
9456663,9456739,76,1,0,0,1
9456664,9456727,63,1,0,0,2
9456728,9456836,108,0,0,1,2
9456740,9456838,98,0,0,1,1
9456837,9456869,32,1,0,0,2
9456839,9456900,61,1,0,0,1
9456870,9457159,289,0,0,1,2
9456901,9457633,732,0,0,1,1
9457160,9457167,7,1,0,0,2
9457168,9458439,1271,0,0,1,2
9457634,9457660,26,1,0,0,1
9457661,9458426,765,0,0,1,1
9458427,9458735,308,1,0,0,1
9458440,9458707,267,1,0,0,2
9458463,9458694,231,0,1,0,1
9458465,9458678,213,0,1,0,2
9458708,9458831,123,0,0,1,2
9458736,9458824,88,0,0,1,1
9458825,9458996,171,1,0,0,1
9458832,9458986,154,1,0,0,2
9458851,9458954,103,0,1,0,2
9458853,9458957,104,0,1,0,1
9458987,9459036,49,0,0,1,2
9458997,9459038,41,0,0,1,1
9459037,9459100,63,1,0,0,2
9459039,9459101,62,1,0,0,1
9459101,9459164,63,0,0,1,2
9459102,9459164,62,0,0,1,1
9459165,9459192,27,1,0,0,1
9459165,9459200,35,1,0,0,2
9459193,9459477,284,0,0,1,1
9459201,9459478,277,0,0,1,2
9459478,9459495,17,1,0,0,1
9459479,9459495,16,1,0,0,2
9459496,9460139,643,0,0,1,1
9459496,9460139,643,0,0,1,2
9460140,9460378,238,1,0,0,2
9460140,9460392,252,1,0,0,1
9460175,9460333,158,0,1,0,1
9460177,9460317,140,0,1,0,2
9460379,9460624,245,0,0,1,2
9460393,9460623,230,0,0,1,1
9460624,9460675,51,1,0,0,1
9460625,9460676,51,1,0,0,2
9460676,9460932,256,0,0,1,1
9460677,9460932,255,0,0,1,2
9460933,9460999,66,1,0,0,1
9460933,9460999,66,1,0,0,2
9461000,9461137,137,0,0,1,2
9461000,9461138,138,0,0,1,1
9461138,9461164,26,1,0,0,2
9461139,9461175,36,1,0,0,1
9461165,9461803,638,0,0,1,2
9461176,9461380,204,0,0,1,1
9461381,9461390,9,1,0,0,1
9461391,9461807,416,0,0,1,1
9461804,9462150,346,1,0,0,2
9461808,9462246,438,1,0,0,1
9461828,9462087,259,0,1,0,2
9461832,9462197,365,0,1,0,1
9462151,9462408,257,0,0,1,2
9462247,9462408,161,0,0,1,1
9462409,9462461,52,1,0,0,1
9462409,9462461,52,1,0,0,2
9462462,9462768,306,0,0,1,2
9462462,9462769,307,0,0,1,1
9462769,9462825,56,1,0,0,2
9462770,9462878,108,1,0,0,1
9462826,9463818,992,0,0,1,2
9462879,9463030,151,0,0,1,1
9463031,9463045,14,1,0,0,1
9463046,9463137,91,0,0,1,1
9463138,9463154,16,1,0,0,1
9463155,9463656,501,0,0,1,1
9463657,9463709,52,1,0,0,1
9463710,9463828,118,0,0,1,1
9463819,9464087,268,1,0,0,2
9463829,9464190,361,1,0,0,1
9463849,9464095,246,0,1,0,1
9463852,9464067,215,0,1,0,2
9464088,9464352,264,0,0,1,2
9464191,9464351,160,0,0,1,1
9464352,9464428,76,1,0,0,1
9464353,9464427,74,1,0,0,2
9464428,9464675,247,0,0,1,2
9464429,9464678,249,0,0,1,1
9464676,9464736,60,1,0,0,2
9464679,9464746,67,1,0,0,1
9464737,9464784,47,0,0,1,2
9464747,9464785,38,0,0,1,1
9464785,9464814,29,1,0,0,2
9464786,9464814,28,1,0,0,1
9464815,9464948,133,0,0,1,2
9464815,9464949,134,0,0,1,1
9464949,9464968,19,1,0,0,2
9464950,9464977,27,1,0,0,1
9464969,9466014,1045,0,0,1,2
9464978,9466006,1028,0,0,1,1
9466007,9466282,275,1,0,0,1
9466015,9466284,269,1,0,0,2
9466034,9466192,158,0,1,0,2
9466037,9466228,191,0,1,0,1
9466283,9466441,158,0,0,1,1
9466285,9466441,156,0,0,1,2
9466442,9466511,69,1,0,0,1
9466442,9466513,71,1,0,0,2
9466512,9466612,100,0,0,1,1
9466514,9466612,98,0,0,1,2
9466613,9466638,25,1,0,0,2
9466613,9466643,30,1,0,0,1
9466639,9466846,207,0,0,1,2
9466644,9466846,202,0,0,1,1
9466847,9466859,12,1,0,0,2
9466847,9466863,16,1,0,0,1
9466860,9467966,1106,0,0,1,2
9466864,9467946,1082,0,0,1,1
9467947,9468274,327,1,0,0,1
9467967,9468211,244,1,0,0,2
9467988,9468133,145,0,1,0,2
9467988,9468163,175,0,1,0,1
9468212,9468414,202,0,0,1,2
9468275,9468412,137,0,0,1,1
9468413,9468468,55,1,0,0,1
9468415,9468470,55,1,0,0,2
9468469,9468561,92,0,0,1,1
9468471,9468560,89,0,0,1,2
9468561,9468586,25,1,0,0,2
9468562,9468584,22,1,0,0,1
9468585,9468786,201,0,0,1,1
9468587,9468786,199,0,0,1,2
9468787,9468794,7,1,0,0,2
9468787,9468797,10,1,0,0,1
9468795,9469868,1073,0,0,1,2
9468798,9469860,1062,0,0,1,1
9469861,9470147,286,1,0,0,1
9469869,9470120,251,1,0,0,2
9469890,9470113,223,0,1,0,1
9469891,9470066,175,0,1,0,2
9470121,9470307,186,0,0,1,2
9470148,9470306,158,0,0,1,1
9470307,9470390,83,1,0,0,1
9470308,9470370,62,1,0,0,2
9470371,9470468,97,0,0,1,2
9470391,9470470,79,0,0,1,1
9470469,9470500,31,1,0,0,2
9470471,9470518,47,1,0,0,1
9470501,9471740,1239,0,0,1,2
9470519,9471043,524,0,0,1,1
9471044,9471048,4,1,0,0,1
9471049,9471137,88,0,0,1,1
9471138,9471180,42,1,0,0,1
9471181,9471204,23,0,0,1,1
9471205,9471251,46,1,0,0,1
9471252,9471277,25,0,0,1,1
9471278,9471295,17,1,0,0,1
9471296,9471359,63,0,0,1,1
9471360,9471569,209,1,0,0,1
9471570,9471607,37,0,0,1,1
9471608,9471612,4,1,0,0,1
9471613,9471659,46,0,0,1,1
9471660,9472121,461,1,0,0,1
9471741,9471988,247,1,0,0,2
9471762,9471947,185,0,1,0,1
9471763,9471926,163,0,1,0,2
9471989,9472223,234,0,0,1,2
9472122,9472224,102,0,0,1,1
9472224,9472299,75,1,0,0,2
9472225,9472297,72,1,0,0,1
9472298,9472382,84,0,0,1,1
9472300,9472383,83,0,0,1,2
9472383,9472411,28,1,0,0,1
9472384,9472417,33,1,0,0,2
9472412,9472548,136,0,0,1,1
9472418,9472547,129,0,0,1,2
9472548,9472569,21,1,0,0,2
9472549,9472569,20,1,0,0,1
9472570,9474111,1541,0,0,1,1
9472570,9474113,1543,0,0,1,2
9474112,9474145,33,1,0,0,1
9474114,9474149,35,1,0,0,2
9474146,9474339,193,0,0,1,1
9474150,9474337,187,0,0,1,2
9474338,9474405,67,1,0,0,2
9474340,9474399,59,1,0,0,1
9474400,9474506,106,0,0,1,1
9474406,9474506,100,0,0,1,2
9474507,9474526,19,1,0,0,2
9474507,9474527,20,1,0,0,1
9474527,9474890,363,0,0,1,2
9474528,9474871,343,0,0,1,1
9474872,9475094,222,1,0,0,1
9474891,9475101,210,1,0,0,2
9474921,9475022,101,0,1,0,2
9474924,9475023,99,0,1,0,1
9475095,9475518,423,0,0,1,1
9475102,9475516,414,0,0,1,2
9475517,9475577,60,1,0,0,2
9475519,9475575,56,1,0,0,1
9475576,9475758,182,0,0,1,1
9475578,9475760,182,0,0,1,2
9475759,9475819,60,1,0,0,1
9475761,9475819,58,1,0,0,2
9475820,9476072,252,0,0,1,1
9475820,9476072,252,0,0,1,2
9476073,9476091,18,1,0,0,2
9476073,9476092,19,1,0,0,1
9476092,9477327,1235,0,0,1,2
9476093,9477328,1235,0,0,1,1
9477328,9477413,85,1,0,0,2
9477329,9477512,183,1,0,0,1
9477414,9477438,24,0,0,1,2
9477439,9477500,61,1,0,0,2
9477501,9477636,135,0,0,1,2
9477513,9477637,124,0,0,1,1
9477637,9477662,25,1,0,0,2
9477638,9477664,26,1,0,0,1
9477663,9477844,181,0,0,1,2
9477665,9477848,183,0,0,1,1
9477845,9477860,15,1,0,0,2
9477849,9477863,14,1,0,0,1
9477861,9478111,250,0,0,1,2
9477864,9478105,241,0,0,1,1
9478106,9478366,260,1,0,0,1
9478112,9478321,209,1,0,0,2
9478141,9478243,102,0,1,0,1
9478144,9478239,95,0,1,0,2
9478322,9478675,353,0,0,1,2
9478367,9478676,309,0,0,1,1
9478676,9479015,339,1,0,0,2
9478677,9479029,352,1,0,0,1
9478700,9478947,247,0,1,0,2
9478700,9478965,265,0,1,0,1
9479016,9479217,201,0,0,1,2
9479030,9479218,188,0,0,1,1
9479218,9479315,97,1,0,0,2
9479219,9479304,85,1,0,0,1
9479305,9479438,133,0,0,1,1
9479316,9479437,121,0,0,1,2
9479438,9479468,30,1,0,0,2
9479439,9479471,32,1,0,0,1
9479469,9479680,211,0,0,1,2
9479472,9480059,587,0,0,1,1
9479681,9479694,13,1,0,0,2
9479695,9480051,356,0,0,1,2
9480052,9480350,298,1,0,0,2
9480060,9480348,288,1,0,0,1
9480088,9480255,167,0,1,0,2
9480088,9480269,181,0,1,0,1
9480349,9480732,383,0,0,1,1
9480351,9480732,381,0,0,1,2
9480733,9480797,64,1,0,0,1
9480733,9480799,66,1,0,0,2
9480798,9481265,467,0,0,1,1
9480800,9481265,465,0,0,1,2
9481266,9481322,56,1,0,0,2
9481266,9481328,62,1,0,0,1
9481323,9481470,147,0,0,1,2
9481329,9481465,136,0,0,1,1
9481466,9481637,171,1,0,0,1
9481471,9481626,155,1,0,0,2
9481490,9481596,106,0,1,0,1
9481491,9481577,86,0,1,0,2
9481627,9481974,347,0,0,1,2
9481638,9481976,338,0,0,1,1
9481975,9482009,34,1,0,0,2
9481977,9482005,28,1,0,0,1
9482006,9482246,240,0,0,1,1
9482010,9482246,236,0,0,1,2
9482247,9482310,63,1,0,0,1
9482247,9482310,63,1,0,0,2
9482311,9482667,356,0,0,1,1
9482311,9482671,360,0,0,1,2
9482668,9482865,197,1,0,0,1
9482672,9482837,165,1,0,0,2
9482693,9482785,92,0,1,0,2
9482697,9482793,96,0,1,0,1
9482838,9483185,347,0,0,1,2
9482866,9483185,319,0,0,1,1
9483186,9483231,45,1,0,0,1
9483186,9483240,54,1,0,0,2
9483232,9483672,440,0,0,1,1
9483241,9483672,431,0,0,1,2
9483673,9483848,175,1,0,0,2
9483673,9483863,190,1,0,0,1
9483693,9483800,107,0,1,0,2
9483696,9483801,105,0,1,0,1
9483849,9484062,213,0,0,1,2
9483864,9484061,197,0,0,1,1
9484062,9484126,64,1,0,0,1
9484063,9484126,63,1,0,0,2
9484127,9484292,165,0,0,1,1
9484127,9484294,167,0,0,1,2
9484293,9484355,62,1,0,0,1
9484295,9484357,62,1,0,0,2
9484356,9484448,92,0,0,1,1
9484358,9484728,370,0,0,1,2
9484459,9484459,0,0,1,0,1
9484469,9484521,52,1,0,0,1
9484483,9484483,0,0,1,0,1
9484509,9484511,2,0,1,0,1
9484522,9484557,35,0,0,1,1
9484568,9484589,21,0,1,0,1
9484598,9484598,0,1,0,0,1
9484599,9484628,29,0,0,1,1
9484639,9484662,23,0,1,0,1
9484672,9484787,115,1,0,0,1
9484684,9484686,2,0,1,0,1
9484708,9484708,0,0,1,0,1
9484729,9484793,64,1,0,0,2
9484788,9485049,261,0,0,1,1
9484794,9485062,268,0,0,1,2
9485050,9485325,275,1,0,0,1
9485063,9485313,250,1,0,0,2
9485080,9485273,193,0,1,0,1
9485085,9485263,178,0,1,0,2
9485314,9485804,490,0,0,1,2
9485326,9485805,479,0,0,1,1
9485805,9485860,55,1,0,0,2
9485806,9485859,53,1,0,0,1
9485860,9486385,525,0,0,1,1
9485861,9486387,526,0,0,1,2
9486386,9486432,46,1,0,0,1
9486388,9486434,46,1,0,0,2
9486433,9486806,373,0,0,1,1
9486435,9486799,364,0,0,1,2
9486800,9487218,418,1,0,0,2
9486807,9487196,389,1,0,0,1
9486830,9487140,310,0,1,0,1
9486835,9486918,83,0,1,0,2
9486981,9487127,146,0,1,0,2
9487197,9488090,893,0,0,1,1
9487219,9488092,873,0,0,1,2
9488091,9488150,59,1,0,0,1
9488093,9488140,47,1,0,0,2
9488141,9488521,380,0,0,1,2
9488151,9488507,356,0,0,1,1
9488508,9488696,188,1,0,0,1
9488522,9488678,156,1,0,0,2
9488538,9488632,94,0,1,0,2
9488541,9488640,99,0,1,0,1
9488679,9489210,531,0,0,1,2
9488697,9489213,516,0,0,1,1
9489211,9489250,39,1,0,0,2
9489214,9489249,35,1,0,0,1
9489250,9490161,911,0,0,1,1
9489251,9490162,911,0,0,1,2
9490162,9490222,60,1,0,0,1
9490163,9490219,56,1,0,0,2
9490220,9490356,136,0,0,1,2
9490223,9490355,132,0,0,1,1
9490356,9490378,22,1,0,0,1
9490357,9490379,22,1,0,0,2
9490379,9490757,378,0,0,1,1
9490380,9490764,384,0,0,1,2
9490758,9490993,235,1,0,0,1
9490765,9490965,200,1,0,0,2
9490781,9490919,138,0,1,0,2
9490782,9490948,166,0,1,0,1
9490966,9491266,300,0,0,1,2
9490994,9491270,276,0,0,1,1
9491267,9491278,11,1,0,0,2
9491271,9491276,5,1,0,0,1
9491277,9491695,418,0,0,1,1
9491279,9491695,416,0,0,1,2
9491696,9491705,9,1,0,0,2
9491696,9491706,10,1,0,0,1
9491706,9493380,1674,0,0,1,2
9491707,9493379,1672,0,0,1,1
9493380,9493578,198,1,0,0,1
9493381,9493551,170,1,0,0,2
9493409,9493550,141,0,1,0,1
9493412,9493506,94,0,1,0,2
9493552,9495094,1542,0,0,1,2
9493579,9495093,1514,0,0,1,1
9495094,9495139,45,1,0,0,1
9495095,9495140,45,1,0,0,2
9495140,9495708,568,0,0,1,1
9495141,9495707,566,0,0,1,2
9495708,9495720,12,1,0,0,2
9495709,9495720,11,1,0,0,1
9495721,9497597,1876,0,0,1,2
9495721,9497599,1878,0,0,1,1
9497598,9497966,368,1,0,0,2
9497600,9497974,374,1,0,0,1
9497626,9497734,108,0,1,0,1
9497627,9497696,69,0,1,0,2
9497778,9497949,171,0,1,0,1
9497804,9497918,114,0,1,0,2
9497967,9498234,267,0,0,1,2
9497975,9498236,261,0,0,1,1
9498235,9498292,57,1,0,0,2
9498237,9498294,57,1,0,0,1
9498293,9498387,94,0,0,1,2
9498295,9498387,92,0,0,1,1
9498388,9498411,23,1,0,0,1
9498388,9498411,23,1,0,0,2
9498412,9498573,161,0,0,1,2
9498412,9498578,166,0,0,1,1
9498574,9498591,17,1,0,0,2
9498579,9498592,13,1,0,0,1
9498592,9501537,2945,0,0,1,2
9498593,9499163,570,0,0,1,1
9499164,9499168,4,1,0,0,1
9499169,9501538,2369,0,0,1,1
9501538,9501580,42,1,0,0,2
9501539,9501581,42,1,0,0,1
9501581,9501836,255,0,0,1,2
9501582,9501835,253,0,0,1,1
9501836,9501850,14,1,0,0,1
9501837,9501850,13,1,0,0,2
9501851,9504715,2864,0,0,1,2
9501851,9504717,2866,0,0,1,1
9504716,9504753,37,1,0,0,2
9504718,9504752,34,1,0,0,1
9504753,9504830,77,0,0,1,1
9504754,9504831,77,0,0,1,2
9504831,9505121,290,1,0,0,1
9504832,9505101,269,1,0,0,2
9504860,9505059,199,0,1,0,2
9504861,9505074,213,0,1,0,1
9505102,9505344,242,0,0,1,2
9505122,9505332,210,0,0,1,1
9505333,9505537,204,1,0,0,1
9505345,9505522,177,1,0,0,2
9505366,9505480,114,0,1,0,2
9505366,9505501,135,0,1,0,1
9505523,9505724,201,0,0,1,2
9505538,9505724,186,0,0,1,1
9505725,9505787,62,1,0,0,1
9505725,9505790,65,1,0,0,2
9505788,9505900,112,0,0,1,1
9505791,9505900,109,0,0,1,2
9505901,9505924,23,1,0,0,1
9505901,9505933,32,1,0,0,2
9505925,9506069,144,0,0,1,1
9505934,9506068,134,0,0,1,2
9506069,9506089,20,1,0,0,2
9506070,9506089,19,1,0,0,1
9506090,9508216,2126,0,0,1,2
9506090,9508219,2129,0,0,1,1
9508217,9508260,43,1,0,0,2
9508220,9508261,41,1,0,0,1
9508261,9508771,510,0,0,1,2
9508262,9508773,511,0,0,1,1
9508772,9508791,19,1,0,0,2
9508774,9508791,17,1,0,0,1
9508792,9510219,1427,0,0,1,1
9508792,9510230,1438,0,0,1,2
9510220,9510676,456,1,0,0,1
9510231,9510649,418,1,0,0,2
9510266,9510638,372,0,1,0,2
9510267,9510632,365,0,1,0,1
9510650,9510844,194,0,0,1,2
9510677,9510842,165,0,0,1,1
9510843,9511046,203,1,0,0,1
9510845,9511034,189,1,0,0,2
9510863,9510998,135,0,1,0,2
9510863,9511009,146,0,1,0,1
9511035,9511377,342,0,0,1,2
9511047,9511379,332,0,0,1,1
9511378,9511432,54,1,0,0,2
9511380,9511429,49,1,0,0,1
9511430,9511697,267,0,0,1,1
9511433,9511697,264,0,0,1,2
9511698,9511720,22,1,0,0,2
9511698,9511730,32,1,0,0,1
9511721,9512100,379,0,0,1,2
9511731,9512099,368,0,0,1,1
9512100,9512111,11,1,0,0,1
9512101,9512112,11,1,0,0,2
9512112,9514061,1949,0,0,1,1
9512113,9514063,1950,0,0,1,2
9514062,9514124,62,1,0,0,1
9514064,9514116,52,1,0,0,2
9514117,9514468,351,0,0,1,2
9514125,9514468,343,0,0,1,1
9514469,9514488,19,1,0,0,1
9514469,9514488,19,1,0,0,2
9514489,9515011,522,0,0,1,1
9514489,9516128,1639,0,0,1,2
9515012,9515023,11,1,0,0,1
9515024,9516121,1097,0,0,1,1
9516122,9516351,229,1,0,0,1
9516129,9516338,209,1,0,0,2
9516165,9516309,144,0,1,0,1
9516167,9516289,122,0,1,0,2
9516339,9517682,1343,0,0,1,2
9516352,9517683,1331,0,0,1,1
9517683,9517744,61,1,0,0,2
9517684,9517750,66,1,0,0,1
9517745,9517796,51,0,0,1,2
9517751,9517797,46,0,0,1,1
9517797,9517824,27,1,0,0,2
9517798,9517824,26,1,0,0,1
9517825,9518029,204,0,0,1,1
9517825,9518030,205,0,0,1,2
9518030,9518047,17,1,0,0,1
9518031,9518047,16,1,0,0,2
9518048,9518470,422,0,0,1,1
9518048,9518475,427,0,0,1,2
9518471,9519032,561,1,0,0,1
9518476,9519012,536,1,0,0,2
9518507,9518613,106,0,1,0,1
9518508,9518591,83,0,1,0,2
9518657,9519021,364,0,1,0,1
9518661,9518995,334,0,1,0,2
9519013,9519192,179,0,0,1,2
9519033,9519193,160,0,0,1,1
9519193,9519214,21,1,0,0,2
9519194,9519213,19,1,0,0,1
9519214,9521581,2367,0,0,1,1
9519215,9519890,675,0,0,1,2
9519891,9519901,10,1,0,0,2
9519902,9521581,1679,0,0,1,2
9521582,9521635,53,1,0,0,2
9521582,9521640,58,1,0,0,1
9521636,9523734,2098,0,0,1,2
9521641,9523732,2091,0,0,1,1
9523733,9523920,187,1,0,0,1
9523735,9523915,180,1,0,0,2
9523769,9523874,105,0,1,0,2
9523774,9523888,114,0,1,0,1
9523916,9525038,1122,0,0,1,2
9523921,9525043,1122,0,0,1,1
9525039,9525091,52,1,0,0,2
9525044,9525088,44,1,0,0,1
9525089,9525353,264,0,0,1,1
9525092,9525353,261,0,0,1,2
9525354,9525567,213,1,0,0,2
9525354,9525592,238,1,0,0,1
9525380,9525507,127,0,1,0,2
9525380,9525536,156,0,1,0,1
9525568,9525781,213,0,0,1,2
9525593,9525784,191,0,0,1,1
9525782,9525854,72,1,0,0,2
9525785,9525849,64,1,0,0,1
9525850,9526049,199,0,0,1,1
9525855,9526043,188,0,0,1,2
9526044,9526061,17,1,0,0,2
9526050,9526062,12,1,0,0,1
9526062,9526643,581,0,0,1,2
9526063,9527319,1256,0,0,1,1
9526644,9526655,11,1,0,0,2
9526656,9527318,662,0,0,1,2
9527319,9527477,158,1,0,0,2
9527320,9527477,157,1,0,0,1
9527361,9527422,61,0,1,0,1
9527362,9527411,49,0,1,0,2
9527478,9528210,732,0,0,1,1
9527478,9528211,733,0,0,1,2
9528211,9528273,62,1,0,0,1
9528212,9528274,62,1,0,0,2
9528274,9528468,194,0,0,1,1
9528275,9528468,193,0,0,1,2
9528469,9528490,21,1,0,0,1
9528469,9528492,23,1,0,0,2
9528491,9530222,1731,0,0,1,1
9528493,9530233,1740,0,0,1,2
9530223,9530428,205,1,0,0,1
9530234,9530435,201,1,0,0,2
9530277,9530347,70,0,1,0,2
9530277,9530350,73,0,1,0,1
9530429,9531161,732,0,0,1,1
9530436,9531161,725,0,0,1,2
9531162,9531226,64,1,0,0,2
9531162,9531231,69,1,0,0,1
9531227,9531421,194,0,0,1,2
9531232,9531422,190,0,0,1,1
9531422,9531596,174,1,0,0,2
9531423,9531586,163,1,0,0,1
9531463,9531475,12,0,1,0,2
9531476,9531508,32,0,1,0,1
9531587,9532233,646,0,0,1,1
9531597,9532234,637,0,0,1,2
9532234,9532304,70,1,0,0,1
9532235,9532296,61,1,0,0,2
9532297,9532581,284,0,0,1,2
9532305,9532580,275,0,0,1,1
9532581,9532601,20,1,0,0,1
9532582,9532599,17,1,0,0,2
9532600,9532652,52,0,0,1,2
9532602,9532657,55,0,0,1,1
9532653,9532988,335,1,0,0,2
9532658,9533012,354,1,0,0,1
9532685,9532952,267,0,1,0,2
9532686,9532960,274,0,1,0,1
9532989,9533126,137,0,0,1,2
9533013,9533127,114,0,0,1,1
9533127,9533155,28,1,0,0,2
9533128,9533154,26,1,0,0,1
9533155,9535421,2266,0,0,1,1
9533156,9535420,2264,0,0,1,2
9535421,9535463,42,1,0,0,2
9535422,9535489,67,1,0,0,1
9535464,9535598,134,0,0,1,2
9535490,9535600,110,0,0,1,1
9535599,9535623,24,1,0,0,2
9535601,9535638,37,1,0,0,1
9535624,9536990,1366,0,0,1,2
9535639,9536987,1348,0,0,1,1
9536988,9537141,153,1,0,0,1
9536991,9537107,116,1,0,0,2
9537030,9537045,15,0,1,0,2
9537108,9538156,1048,0,0,1,2
9537142,9538155,1013,0,0,1,1
9538156,9538219,63,1,0,0,1
9538157,9538219,62,1,0,0,2
9538220,9539385,1165,0,0,1,2
9538220,9539386,1166,0,0,1,1
9539386,9539425,39,1,0,0,2
9539387,9539426,39,1,0,0,1
9539426,9539601,175,0,0,1,2
9539427,9539601,174,0,0,1,1
9539602,9539617,15,1,0,0,2
9539602,9539619,17,1,0,0,1
9539618,9541426,1808,0,0,1,2
9539620,9540630,1010,0,0,1,1
9540631,9540638,7,1,0,0,1
9540639,9540660,21,0,0,1,1
9540661,9540699,38,1,0,0,1
9540700,9540961,261,0,0,1,1
9540962,9540969,7,1,0,0,1
9540970,9541428,458,0,0,1,1
9541427,9541471,44,1,0,0,2
9541429,9541472,43,1,0,0,1
9541472,9541542,70,0,0,1,2
9541473,9541526,53,0,0,1,1
9541527,9541576,49,1,0,0,1
9541543,9541569,26,1,0,0,2
9541570,9543404,1834,0,0,1,2
9541577,9543404,1827,0,0,1,1
9543405,9543647,242,1,0,0,1
9543405,9543647,242,1,0,0,2
9543445,9543614,169,0,1,0,1
9543448,9543600,152,0,1,0,2
9543648,9544181,533,0,0,1,1
9543648,9544182,534,0,0,1,2
9544182,9544416,234,1,0,0,1
9544183,9544412,229,1,0,0,2
9544203,9544376,173,0,1,0,2
9544204,9544386,182,0,1,0,1
9544413,9544806,393,0,0,1,2
9544417,9544806,389,0,0,1,1
9544807,9545018,211,1,0,0,2
9544807,9545101,294,1,0,0,1
9544826,9544985,159,0,1,0,2
9544828,9544985,157,0,1,0,1
9545019,9545073,54,0,0,1,2
9545074,9545103,29,1,0,0,2
9545102,9545245,143,0,0,1,1
9545104,9545239,135,0,0,1,2
9545240,9545256,16,1,0,0,2
9545246,9545258,12,1,0,0,1
9545257,9545466,209,0,0,1,2
9545259,9546829,1570,0,0,1,1
9545467,9545477,10,1,0,0,2
9545478,9546830,1352,0,0,1,2
9546830,9546972,142,1,0,0,1
9546831,9546888,57,1,0,0,2
9546889,9546947,58,0,0,1,2
9546948,9546991,43,1,0,0,2
9546973,9547190,217,0,0,1,1
9546992,9547189,197,0,0,1,2
9547190,9547218,28,1,0,0,2
9547191,9547221,30,1,0,0,1
9547219,9548839,1620,0,0,1,2
9547222,9548834,1612,0,0,1,1
9548835,9549154,319,1,0,0,1
9548840,9549177,337,1,0,0,2
9548861,9549118,257,0,1,0,1
9548862,9549110,248,0,1,0,2
9549155,9549535,380,0,0,1,1
9549178,9549536,358,0,0,1,2
9549536,9549574,38,1,0,0,1
9549537,9549573,36,1,0,0,2
9549574,9550222,648,0,0,1,2
9549575,9550222,647,0,0,1,1
9550223,9550282,59,1,0,0,2
9550223,9550285,62,1,0,0,1
9550283,9550421,138,0,0,1,2
9550286,9550420,134,0,0,1,1
9550421,9550450,29,1,0,0,1
9550422,9550441,19,1,0,0,2
9550442,9550535,93,0,0,1,2
9550451,9550534,83,0,0,1,1
9550535,9550551,16,1,0,0,1
9550536,9550550,14,1,0,0,2
9550551,9552225,1674,0,0,1,2
9550552,9550897,345,0,0,1,1
9550898,9550907,9,1,0,0,1
9550908,9552224,1316,0,0,1,1
9552225,9552284,59,1,0,0,1
9552226,9552284,58,1,0,0,2
9552285,9552434,149,0,0,1,2
9552285,9552435,150,0,0,1,1
9552435,9552457,22,1,0,0,2
9552436,9552453,17,1,0,0,1
9552454,9554669,2215,0,0,1,1
9552458,9554678,2220,0,0,1,2
9554670,9554769,99,1,0,0,1
9554679,9554769,90,1,0,0,2
9554770,9555337,567,0,0,1,2
9554770,9555347,577,0,0,1,1
9555338,9555540,202,1,0,0,2
9555348,9555543,195,1,0,0,1
9555375,9555499,124,0,1,0,1
9555376,9555475,99,0,1,0,2
9555541,9555710,169,0,0,1,2
9555544,9555711,167,0,0,1,1
9555711,9555769,58,1,0,0,2
9555712,9555765,53,1,0,0,1
9555766,9555883,117,0,0,1,1
9555770,9555881,111,0,0,1,2
9555882,9555903,21,1,0,0,2
9555884,9555905,21,1,0,0,1
9555904,9555977,73,0,0,1,2
9555906,9555982,76,0,0,1,1
9555978,9555997,19,1,0,0,2
9555983,9555993,10,1,0,0,1
9555994,9557052,1058,0,0,1,1
9555998,9557057,1059,0,0,1,2
9557053,9557305,252,1,0,0,1
9557058,9557307,249,1,0,0,2
9557084,9557248,164,0,1,0,1
9557090,9557245,155,0,1,0,2
9557306,9557485,179,0,0,1,1
9557308,9557482,174,0,0,1,2
9557483,9557501,18,1,0,0,2
9557486,9557501,15,1,0,0,1
9557502,9557715,213,0,0,1,2
9557502,9557717,215,0,0,1,1
9557716,9557762,46,1,0,0,2
9557718,9557760,42,1,0,0,1
9557761,9557944,183,0,0,1,1
9557763,9557942,179,0,0,1,2
9557943,9557967,24,1,0,0,2
9557945,9557967,22,1,0,0,1
9557968,9558204,236,0,0,1,1
9557968,9558204,236,0,0,1,2
9558205,9558209,4,1,0,0,1
9558205,9558210,5,1,0,0,2
9558210,9559794,1584,0,0,1,1
9558211,9559784,1573,0,0,1,2
9559785,9560091,306,1,0,0,2
9559795,9560067,272,1,0,0,1
9559820,9560010,190,0,1,0,2
9559823,9560026,203,0,1,0,1
9560068,9560923,855,0,0,1,1
9560092,9560923,831,0,0,1,2
9560924,9560967,43,1,0,0,1
9560924,9560967,43,1,0,0,2
9560968,9561518,550,0,0,1,1
9560968,9561519,551,0,0,1,2
9561519,9561576,57,1,0,0,1
9561520,9561574,54,1,0,0,2
9561575,9561684,109,0,0,1,2
9561577,9561688,111,0,0,1,1
9561685,9561703,18,1,0,0,2
9561689,9561707,18,1,0,0,1
9561704,9561811,107,0,0,1,2
9561708,9561812,104,0,0,1,1
9561812,9561825,13,1,0,0,2
9561813,9561824,11,1,0,0,1
9561825,9563039,1214,0,0,1,1
9561826,9563041,1215,0,0,1,2
9563040,9563222,182,1,0,0,1
9563042,9563204,162,1,0,0,2
9563082,9563189,107,0,1,0,1
9563093,9563166,73,0,1,0,2
9563205,9563340,135,0,0,1,2
9563223,9563338,115,0,0,1,1
9563339,9563360,21,1,0,0,1
9563341,9563360,19,1,0,0,2
9563361,9565258,1897,0,0,1,1
9563361,9565263,1902,0,0,1,2
9565259,9565536,277,1,0,0,1
9565264,9565542,278,1,0,0,2
9565301,9565480,179,0,1,0,1
9565303,9565452,149,0,1,0,2
9565537,9566528,991,0,0,1,1
9565543,9566529,986,0,0,1,2
9566529,9566579,50,1,0,0,1
9566530,9566576,46,1,0,0,2
9566577,9566723,146,0,0,1,2
9566580,9566818,238,0,0,1,1
9566724,9566733,9,1,0,0,2
9566734,9566813,79,0,0,1,2
9566814,9566834,20,1,0,0,2
9566819,9566833,14,1,0,0,1
9566834,9567101,267,0,0,1,1
9566835,9567808,973,0,0,1,2
9567102,9567113,11,1,0,0,1
9567114,9567796,682,0,0,1,1
9567797,9568031,234,1,0,0,1
9567809,9568035,226,1,0,0,2
9567834,9567980,146,0,1,0,1
9567839,9567977,138,0,1,0,2
9568032,9568259,227,0,0,1,1
9568036,9568258,222,0,0,1,2
9568259,9568302,43,1,0,0,2
9568260,9568300,40,1,0,0,1
9568301,9568550,249,0,0,1,1
9568303,9568550,247,0,0,1,2
9568551,9568570,19,1,0,0,1
9568551,9568571,20,1,0,0,2
9568571,9570364,1793,0,0,1,1
9568572,9570352,1780,0,0,1,2
9570353,9570688,335,1,0,0,2
9570365,9570670,305,1,0,0,1
9570385,9570609,224,0,1,0,2
9570388,9570609,221,0,1,0,1
9570671,9571518,847,0,0,1,1
9570689,9571517,828,0,0,1,2
9571518,9571567,49,1,0,0,2
9571519,9571566,47,1,0,0,1
9571567,9571813,246,0,0,1,1
9571568,9571810,242,0,0,1,2
9571811,9571875,64,1,0,0,2
9571814,9571884,70,1,0,0,1
9571876,9572045,169,0,0,1,2
9571885,9572045,160,0,0,1,1
9572046,9572068,22,1,0,0,2
9572046,9572079,33,1,0,0,1
9572069,9573040,971,0,0,1,2
9572080,9573047,967,0,0,1,1
9573041,9573244,203,1,0,0,2
9573048,9573294,246,1,0,0,1
9573062,9573220,158,0,1,0,1
9573068,9573214,146,0,1,0,2
9573245,9573505,260,0,0,1,2
9573295,9573504,209,0,0,1,1
9573505,9573545,40,1,0,0,1
9573506,9573548,42,1,0,0,2
9573546,9573778,232,0,0,1,1
9573549,9573777,228,0,0,1,2
9573778,9573787,9,1,0,0,2
9573779,9573789,10,1,0,0,1
9573788,9575847,2059,0,0,1,2
9573790,9575831,2041,0,0,1,1
9575832,9576141,309,1,0,0,1
9575848,9576156,308,1,0,0,2
9575873,9576102,229,0,1,0,1
9575883,9576087,204,0,1,0,2
9576142,9577055,913,0,0,1,1
9576157,9577055,898,0,0,1,2
9577056,9577105,49,1,0,0,2
9577056,9577116,60,1,0,0,1
9577106,9577216,110,0,0,1,2
9577117,9577215,98,0,0,1,1
9577216,9577261,45,1,0,0,1
9577217,9577237,20,1,0,0,2
9577238,9577313,75,0,0,1,2
9577262,9577311,49,0,0,1,1
9577312,9577333,21,1,0,0,1
9577314,9577333,19,1,0,0,2
9577334,9578178,844,0,0,1,2
9577334,9578179,845,0,0,1,1
9578179,9578365,186,1,0,0,2
9578180,9578354,174,1,0,0,1
9578210,9578294,84,0,1,0,2
9578212,9578295,83,0,1,0,1
9578355,9578789,434,0,0,1,1
9578366,9578790,424,0,0,1,2
9578790,9578850,60,1,0,0,1
9578791,9578839,48,1,0,0,2
9578840,9579259,419,0,0,1,2
9578851,9579259,408,0,0,1,1
9579260,9579271,11,1,0,0,1
9579260,9579271,11,1,0,0,2
9579272,9580925,1653,0,0,1,1
9579272,9580925,1653,0,0,1,2
9580926,9581264,338,1,0,0,1
9580926,9581295,369,1,0,0,2
9580951,9581233,282,0,1,0,1
9580957,9581212,255,0,1,0,2
9581265,9581607,342,0,0,1,1
9581296,9581607,311,0,0,1,2
9581608,9581646,38,1,0,0,2
9581608,9581647,39,1,0,0,1
9581647,9582374,727,0,0,1,2
9581648,9582376,728,0,0,1,1
9582375,9582422,47,1,0,0,2
9582377,9582419,42,1,0,0,1
9582420,9582712,292,0,0,1,1
9582423,9582712,289,0,0,1,2
9582713,9582795,82,1,0,0,2
9582713,9582807,94,1,0,0,1
9582796,9583004,208,0,0,1,2
9582808,9583003,195,0,0,1,1
9583004,9583024,20,1,0,0,1
9583005,9583023,18,1,0,0,2
9583024,9583207,183,0,0,1,2
9583025,9583200,175,0,0,1,1
9583201,9583217,16,1,0,0,1
9583208,9583218,10,1,0,0,2
9583218,9584719,1501,0,0,1,1
9583219,9584718,1499,0,0,1,2
9584719,9584770,51,1,0,0,2
9584720,9584796,76,1,0,0,1
9584771,9585062,291,0,0,1,2
9584797,9585066,269,0,0,1,1
9585063,9585080,17,1,0,0,2
9585067,9585083,16,1,0,0,1
9585081,9586704,1623,0,0,1,2
9585084,9586432,1348,0,0,1,1
9586433,9586514,81,1,0,0,1
9586515,9586579,64,0,0,1,1
9586580,9586606,26,1,0,0,1
9586607,9586700,93,0,0,1,1
9586701,9587239,538,1,0,0,1
9586705,9587217,512,1,0,0,2
9586730,9587228,498,0,1,0,1
9586731,9587000,269,0,1,0,2
9587051,9587186,135,0,1,0,2
9587218,9587344,126,0,0,1,2
9587240,9587266,26,0,0,1,1
9587267,9587271,4,1,0,0,1
9587272,9587338,66,0,0,1,1
9587339,9587553,214,1,0,0,1
9587345,9587542,197,1,0,0,2
9587360,9587521,161,0,1,0,1
9587361,9587507,146,0,1,0,2
9587543,9587821,278,0,0,1,2
9587554,9587612,58,0,0,1,1
9587613,9587617,4,1,0,0,1
9587618,9587815,197,0,0,1,1
9587816,9588030,214,1,0,0,1
9587822,9588028,206,1,0,0,2
9587842,9587997,155,0,1,0,1
9587843,9587976,133,0,1,0,2
9588029,9588179,150,0,0,1,2
9588031,9588180,149,0,0,1,1
9588180,9588240,60,1,0,0,2
9588181,9588244,63,1,0,0,1
9588241,9588341,100,0,0,1,2
9588245,9588340,95,0,0,1,1
9588341,9588368,27,1,0,0,1
9588342,9588364,22,1,0,0,2
9588365,9588438,73,0,0,1,2
9588369,9588440,71,0,0,1,1
9588439,9588459,20,1,0,0,2
9588441,9588459,18,1,0,0,1
9588460,9589935,1475,0,0,1,1
9588460,9589936,1476,0,0,1,2
9589936,9590030,94,1,0,0,1
9589937,9589999,62,1,0,0,2
9590000,9590132,132,0,0,1,2
9590031,9590132,101,0,0,1,1
9590133,9590165,32,1,0,0,2
9590133,9590166,33,1,0,0,1
9590166,9592181,2015,0,0,1,2
9590167,9592182,2015,0,0,1,1
9592182,9592233,51,1,0,0,2
9592183,9592232,49,1,0,0,1
9592233,9593448,1215,0,0,1,1
9592234,9593448,1214,0,0,1,2
9593449,9593509,60,1,0,0,2
9593449,9593520,71,1,0,0,1
9593510,9593579,69,0,0,1,2
9593521,9593579,58,0,0,1,1
9593580,9593618,38,1,0,0,1
9593580,9593619,39,1,0,0,2
9593619,9593658,39,0,0,1,1
9593620,9593659,39,0,0,1,2
9593659,9593697,38,1,0,0,1
9593660,9593684,24,1,0,0,2
9593685,9593750,65,0,0,1,2
9593698,9593751,53,0,0,1,1
9593751,9593775,24,1,0,0,2
9593752,9593783,31,1,0,0,1
9593776,9593985,209,0,0,1,2
9593784,9593972,188,0,0,1,1
9593973,9594186,213,1,0,0,1
9593986,9594152,166,1,0,0,2
9593996,9594110,114,0,1,0,1
9593998,9594116,118,0,1,0,2
9594139,9594140,1,0,1,0,1
9594153,9594469,316,0,0,1,2
9594187,9594469,282,0,0,1,1
9594470,9594501,31,1,0,0,1
9594470,9594501,31,1,0,0,2
9594502,9594581,79,0,0,1,2
9594502,9594583,81,0,0,1,1
9594582,9594609,27,1,0,0,2
9594584,9594610,26,1,0,0,1
9594610,9595692,1082,0,0,1,2
9594611,9595677,1066,0,0,1,1
9595678,9595970,292,1,0,0,1
9595693,9595903,210,1,0,0,2
9595703,9595861,158,0,1,0,1
9595708,9595843,135,0,1,0,2
9595904,9596022,118,0,0,1,2
9595971,9596022,51,0,0,1,1
9596023,9596062,39,1,0,0,2
9596023,9596065,42,1,0,0,1
9596063,9596344,281,0,0,1,2
9596066,9596344,278,0,0,1,1
9596345,9596366,21,1,0,0,2
9596345,9596367,22,1,0,0,1
9596367,9598078,1711,0,0,1,2
9596368,9598066,1698,0,0,1,1
9598067,9598539,472,1,0,0,1
9598079,9598444,365,1,0,0,2
9598095,9598528,433,0,1,0,1
9598103,9598411,308,0,1,0,2
9598445,9598668,223,0,0,1,2
9598540,9598668,128,0,0,1,1
9598669,9598721,52,1,0,0,1
9598669,9598721,52,1,0,0,2
9598722,9599191,469,0,0,1,2
9598722,9599193,471,0,0,1,1
9599192,9599246,54,1,0,0,2
9599194,9599245,51,1,0,0,1
9599246,9599416,170,0,0,1,1
9599247,9599414,167,0,0,1,2
9599415,9599461,46,1,0,0,2
9599417,9599464,47,1,0,0,1
9599462,9600775,1313,0,0,1,2
9599465,9600776,1311,0,0,1,1
9600776,9600967,191,1,0,0,2
9600777,9600966,189,1,0,0,1
9600804,9600912,108,0,1,0,2
9600805,9600926,121,0,1,0,1
9600967,9601688,721,0,0,1,1
9600968,9601689,721,0,0,1,2
9601689,9601728,39,1,0,0,1
9601690,9601736,46,1,0,0,2
9601729,9603768,2039,0,0,1,1
9601737,9602176,439,0,0,1,2
9602177,9602182,5,1,0,0,2
9602183,9603773,1590,0,0,1,2
9603769,9604230,461,1,0,0,1
9603774,9604200,426,1,0,0,2
9603811,9604208,397,0,1,0,1
9603815,9604186,371,0,1,0,2
9604201,9605773,1572,0,0,1,2
9604231,9605775,1544,0,0,1,1
9605774,9605833,59,1,0,0,2
9605776,9605835,59,1,0,0,1
9605834,9605984,150,0,0,1,2
9605836,9605983,147,0,0,1,1
9605984,9606003,19,1,0,0,1
9605985,9606002,17,1,0,0,2
9606003,9607364,1361,0,0,1,2
9606004,9607362,1358,0,0,1,1
9607363,9607406,43,1,0,0,1
9607365,9607405,40,1,0,0,2
9607406,9607588,182,0,0,1,2
9607407,9607589,182,0,0,1,1
9607589,9607610,21,1,0,0,2
9607590,9607610,20,1,0,0,1
9607611,9609449,1838,0,0,1,1
9607611,9609451,1840,0,0,1,2
9609450,9609748,298,1,0,0,1
9609452,9609732,280,1,0,0,2
9609475,9609707,232,0,1,0,1
9609478,9609675,197,0,1,0,2
9609733,9610265,532,0,0,1,2
9609749,9610266,517,0,0,1,1
9610266,9610316,50,1,0,0,2
9610267,9610316,49,1,0,0,1
9610317,9611103,786,0,0,1,1
9610317,9611103,786,0,0,1,2
9611104,9611142,38,1,0,0,2
9611104,9611143,39,1,0,0,1
9611143,9611272,129,0,0,1,2
9611144,9611274,130,0,0,1,1
9611273,9611297,24,1,0,0,2
9611275,9611298,23,1,0,0,1
9611298,9611393,95,0,0,1,2
9611299,9611394,95,0,0,1,1
9611394,9611412,18,1,0,0,2
9611395,9611412,17,1,0,0,1
9611413,9612172,759,0,0,1,1
9611413,9612181,768,0,0,1,2
9612173,9612541,368,1,0,0,1
9612182,9612501,319,1,0,0,2
9612199,9612530,331,0,1,0,1
9612204,9612426,222,0,1,0,2
9612502,9612582,80,0,0,1,2
9612542,9612584,42,0,0,1,1
9612583,9612627,44,1,0,0,2
9612585,9612633,48,1,0,0,1
9612628,9614561,1933,0,0,1,2
9612634,9614551,1917,0,0,1,1
9614552,9614890,338,1,0,0,1
9614562,9614855,293,1,0,0,2
9614583,9614795,212,0,1,0,2
9614584,9614814,230,0,1,0,1
9614856,9615179,323,0,0,1,2
9614891,9615178,287,0,0,1,1
9615179,9615230,51,1,0,0,1
9615180,9615230,50,1,0,0,2
9615231,9615621,390,0,0,1,2
9615231,9615622,391,0,0,1,1
9615622,9615663,41,1,0,0,2
9615623,9615667,44,1,0,0,1
9615664,9615761,97,0,0,1,2
9615668,9615761,93,0,0,1,1
9615762,9615785,23,1,0,0,1
9615762,9615794,32,1,0,0,2
9615786,9615989,203,0,0,1,1
9615795,9615990,195,0,0,1,2
9615990,9616006,16,1,0,0,1
9615991,9616007,16,1,0,0,2
9616007,9617207,1200,0,0,1,1
9616008,9617208,1200,0,0,1,2
9617208,9617269,61,1,0,0,1
9617209,9617259,50,1,0,0,2
9617260,9618564,1304,0,0,1,2
9617270,9618558,1288,0,0,1,1
9618559,9618821,262,1,0,0,1
9618565,9618815,250,1,0,0,2
9618591,9618755,164,0,1,0,1
9618593,9618776,183,0,1,0,2
9618816,9619372,556,0,0,1,2
9618822,9619360,538,0,0,1,1
9619361,9619667,306,1,0,0,1
9619373,9619655,282,1,0,0,2
9619392,9619639,247,0,1,0,1
9619396,9619583,187,0,1,0,2
9619656,9620651,995,0,0,1,2
9619668,9620651,983,0,0,1,1
9620652,9620724,72,1,0,0,2
9620652,9620736,84,1,0,0,1
9620725,9620826,101,0,0,1,2
9620737,9620827,90,0,0,1,1
9620827,9620850,23,1,0,0,2
9620828,9620858,30,1,0,0,1
9620851,9620914,63,0,0,1,2
9620859,9620911,52,0,0,1,1
9620912,9620938,26,1,0,0,1
9620915,9620937,22,1,0,0,2
9620938,9622265,1327,0,0,1,2
9620939,9622264,1325,0,0,1,1
9622265,9622323,58,1,0,0,1
9622266,9622327,61,1,0,0,2
9622324,9622504,180,0,0,1,1
9622328,9622502,174,0,0,1,2
9622503,9622524,21,1,0,0,2
9622505,9622527,22,1,0,0,1
9622525,9624405,1880,0,0,1,2
9622528,9624403,1875,0,0,1,1
9624404,9624638,234,1,0,0,1
9624406,9624646,240,1,0,0,2
9624452,9624566,114,0,1,0,2
9624452,9624589,137,0,1,0,1
9624639,9625128,489,0,0,1,1
9624647,9625128,481,0,0,1,2
9625129,9625187,58,1,0,0,1
9625129,9625187,58,1,0,0,2
9625188,9625850,662,0,0,1,1
9625188,9625850,662,0,0,1,2
9625851,9625922,71,1,0,0,1
9625851,9625926,75,1,0,0,2
9625923,9626003,80,0,0,1,1
9625927,9626004,77,0,0,1,2
9626004,9626040,36,1,0,0,1
9626005,9626039,34,1,0,0,2
9626040,9626149,109,0,0,1,2
9626041,9626147,106,0,0,1,1
9626148,9626169,21,1,0,0,1
9626150,9626177,27,1,0,0,2
9626170,9627658,1488,0,0,1,1
9626178,9626343,165,0,0,1,2
9626344,9626354,10,1,0,0,2
9626355,9627658,1303,0,0,1,2
9627659,9627712,53,1,0,0,1
9627659,9627714,55,1,0,0,2
9627713,9627786,73,0,0,1,1
9627715,9627787,72,0,0,1,2
9627787,9627810,23,1,0,0,1
9627788,9627811,23,1,0,0,2
9627811,9628324,513,0,0,1,1
9627812,9628322,510,0,0,1,2
9628323,9628342,19,1,0,0,2
9628325,9628340,15,1,0,0,1
9628341,9629722,1381,0,0,1,1
9628343,9629728,1385,0,0,1,2
9629723,9629985,262,1,0,0,1
9629729,9629961,232,1,0,0,2
9629776,9629930,154,0,1,0,1
9629782,9629898,116,0,1,0,2
9629962,9631639,1677,0,0,1,2
9629986,9631639,1653,0,0,1,1
9631640,9631703,63,1,0,0,1
9631640,9631703,63,1,0,0,2
9631704,9631818,114,0,0,1,1
9631704,9631818,114,0,0,1,2
9631819,9631838,19,1,0,0,2
9631819,9631855,36,1,0,0,1
9631839,9631917,78,0,0,1,2
9631856,9631918,62,0,0,1,1
9631918,9631940,22,1,0,0,2
9631919,9631941,22,1,0,0,1
9631941,9632770,829,0,0,1,2
9631942,9632768,826,0,0,1,1
9632769,9632828,59,1,0,0,1
9632771,9632820,49,1,0,0,2
9632821,9633077,256,0,0,1,2
9632829,9633079,250,0,0,1,1
9633078,9633085,7,1,0,0,2
9633080,9633084,4,1,0,0,1
9633085,9634841,1756,0,0,1,1
9633086,9634853,1767,0,0,1,2
9634842,9635513,671,1,0,0,1
9634854,9635480,626,1,0,0,2
9634876,9635159,283,0,1,0,2
9634877,9635211,334,0,1,0,1
9635260,9635458,198,0,1,0,1
9635274,9635463,189,0,1,0,2
9635481,9635773,292,0,0,1,2
9635514,9635773,259,0,0,1,1
9635774,9635824,50,1,0,0,1
9635774,9635832,58,1,0,0,2
9635825,9636143,318,0,0,1,1
9635833,9636142,309,0,0,1,2
9636143,9636218,75,1,0,0,2
9636144,9636221,77,1,0,0,1
9636219,9636266,47,0,0,1,2
9636222,9636266,44,0,0,1,1
9636267,9636344,77,1,0,0,2
9636267,9636345,78,1,0,0,1
9636345,9636486,141,0,0,1,2
9636346,9636487,141,0,0,1,1
9636487,9636508,21,1,0,0,2
9636488,9636508,20,1,0,0,1
9636509,9637376,867,0,0,1,1
9636509,9637376,867,0,0,1,2
9637377,9637412,35,1,0,0,1
9637377,9637415,38,1,0,0,2
9637413,9639630,2217,0,0,1,1
9637416,9639632,2216,0,0,1,2
9639631,9640172,541,1,0,0,1
9639633,9640178,545,1,0,0,2
9639659,9640155,496,0,1,0,1
9639665,9640147,482,0,1,0,2
9640173,9640684,511,0,0,1,1
9640179,9640683,504,0,0,1,2
9640684,9640745,61,1,0,0,2
9640685,9640750,65,1,0,0,1
9640746,9640845,99,0,0,1,2
9640751,9640847,96,0,0,1,1
9640846,9640869,23,1,0,0,2
9640848,9640871,23,1,0,0,1
9640870,9640941,71,0,0,1,2
9640872,9640938,66,0,0,1,1
9640939,9640963,24,1,0,0,1
9640942,9640962,20,1,0,0,2
9640963,9641114,151,0,0,1,2
9640964,9641116,152,0,0,1,1
9641115,9641134,19,1,0,0,2
9641117,9641134,17,1,0,0,1
9641135,9642149,1014,0,0,1,2
9641135,9642150,1015,0,0,1,1
9642150,9642199,49,1,0,0,2
9642151,9642201,50,1,0,0,1
9642200,9644256,2056,0,0,1,2
9642202,9644232,2030,0,0,1,1
9644233,9644715,482,1,0,0,1
9644257,9644663,406,1,0,0,2
9644272,9644704,432,0,1,0,1
9644277,9644648,371,0,1,0,2
9644664,9645003,339,0,0,1,2
9644716,9645002,286,0,0,1,1
9645003,9645058,55,1,0,0,1
9645004,9645054,50,1,0,0,2
9645055,9645729,674,0,0,1,2
9645059,9645730,671,0,0,1,1
9645730,9645777,47,1,0,0,2
9645731,9645788,57,1,0,0,1
9645778,9645891,113,0,0,1,2
9645789,9645896,107,0,0,1,1
9645892,9645910,18,1,0,0,2
9645897,9645910,13,1,0,0,1
9645911,9647067,1156,0,0,1,2
9645911,9647069,1158,0,0,1,1
9647068,9647130,62,1,0,0,2
9647070,9647128,58,1,0,0,1
9647129,9647461,332,0,0,1,1
9647131,9647461,330,0,0,1,2
9647462,9647490,28,1,0,0,2
9647462,9647492,30,1,0,0,1
9647491,9647549,58,0,0,1,2
9647493,9647549,56,0,0,1,1
9647550,9647574,24,1,0,0,1
9647550,9647594,44,1,0,0,2
9647575,9649150,1575,0,0,1,1
9647595,9649157,1562,0,0,1,2
9649151,9649783,632,1,0,0,1
9649158,9649795,637,1,0,0,2
9649201,9649765,564,0,1,0,1
9649207,9649496,289,0,1,0,2
9649547,9649724,177,0,1,0,2
9649784,9650733,949,0,0,1,1
9649796,9650732,936,0,0,1,2
9650733,9650762,29,1,0,0,2
9650734,9650758,24,1,0,0,1
9650759,9650855,96,0,0,1,1
9650763,9650854,91,0,0,1,2
9650855,9650889,34,1,0,0,2
9650856,9650885,29,1,0,0,1
9650886,9651364,478,0,0,1,1
9650890,9651366,476,0,0,1,2
9651365,9651392,27,1,0,0,1
9651367,9651392,25,1,0,0,2
9651393,9651542,149,0,0,1,2
9651393,9651544,151,0,0,1,1
9651543,9651572,29,1,0,0,2
9651545,9651571,26,1,0,0,1
9651572,9651737,165,0,0,1,1
9651573,9651749,176,0,0,1,2
9651738,9651943,205,1,0,0,1
9651750,9651930,180,1,0,0,2
9651768,9651909,141,0,1,0,1
9651769,9651857,88,0,1,0,2
9651931,9652160,229,0,0,1,2
9651944,9652160,216,0,0,1,1
9779817,9779884,67,0,0,1,2
9779817,9779887,70,0,0,1,1
9779885,9780138,253,1,0,0,2
9779888,9780143,255,1,0,0,1
9779912,9780044,132,0,1,0,2
9779912,9780069,157,0,1,0,1
9780139,9780288,149,0,0,1,2
9780144,9780168,24,0,0,1,1
9780169,9780174,5,1,0,0,1
9780175,9780289,114,0,0,1,1
9780289,9780353,64,1,0,0,2
9780290,9780353,63,1,0,0,1
9780354,9780453,99,0,0,1,2
9780354,9780454,100,0,0,1,1
9780454,9780478,24,1,0,0,2
9780455,9780487,32,1,0,0,1
9780479,9780574,95,0,0,1,2
9780488,9780572,84,0,0,1,1
9780573,9780595,22,1,0,0,1
9780575,9780593,18,1,0,0,2
9780594,9780954,360,0,0,1,2
9780596,9780950,354,0,0,1,1
9780951,9781931,980,1,0,0,1
9780955,9781921,966,1,0,0,2
9781034,9781894,860,0,1,0,2
9781039,9781899,860,0,1,0,1
9781922,9782145,223,0,0,1,2
9781932,9782145,213,0,0,1,1
9782146,9782165,19,1,0,0,1
9782146,9782165,19,1,0,0,2
9782166,9782600,434,0,0,1,1
9782166,9782602,436,0,0,1,2
9782601,9782618,17,1,0,0,1
9782603,9782617,14,1,0,0,2
9782618,9785420,2802,0,0,1,2
9782619,9785420,2801,0,0,1,1
9785421,9785476,55,1,0,0,2
9785421,9785482,61,1,0,0,1
9785477,9785561,84,0,0,1,2
9785483,9785563,80,0,0,1,1
9785562,9785584,22,1,0,0,2
9785564,9785590,26,1,0,0,1
9785585,9785665,80,0,0,1,2
9785591,9785663,72,0,0,1,1
9785664,9785686,22,1,0,0,1
9785666,9785693,27,1,0,0,2
9785687,9785879,192,0,0,1,1
9785694,9785877,183,0,0,1,2
9785878,9785888,10,1,0,0,2
9785880,9785884,4,1,0,0,1
9785885,9787856,1971,0,0,1,1
9785889,9787857,1968,0,0,1,2
9787857,9787895,38,1,0,0,1
9787858,9787893,35,1,0,0,2
9787894,9788067,173,0,0,1,2
9787896,9788067,171,0,0,1,1
9788068,9788077,9,1,0,0,1
9788068,9788081,13,1,0,0,2
9788078,9790592,2514,0,0,1,1
9788082,9788330,248,0,0,1,2
9788331,9788336,5,1,0,0,2
9788337,9790590,2253,0,0,1,2
9790591,9790666,75,1,0,0,2
9790593,9790663,70,1,0,0,1
9790664,9790742,78,0,0,1,1
9790667,9790742,75,0,0,1,2
9790743,9790769,26,1,0,0,2
9790743,9790770,27,1,0,0,1
9790770,9790909,139,0,0,1,2
9790771,9790910,139,0,0,1,1
9790910,9790928,18,1,0,0,2
9790911,9790937,26,1,0,0,1
9790929,9792113,1184,0,0,1,2
9790938,9792105,1167,0,0,1,1
9792106,9792337,231,1,0,0,1
9792114,9792327,213,1,0,0,2
9792173,9792267,94,0,1,0,2
9792174,9792258,84,0,1,0,1
9792328,9792600,272,0,0,1,2
9792338,9792597,259,0,0,1,1
9792598,9792675,77,1,0,0,1
9792601,9792674,73,1,0,0,2
9792675,9792855,180,0,0,1,2
9792676,9792854,178,0,0,1,1
9792855,9792878,23,1,0,0,1
9792856,9792877,21,1,0,0,2
9792878,9794051,1173,0,0,1,2
9792879,9794052,1173,0,0,1,1
9794052,9794116,64,1,0,0,2
9794053,9794117,64,1,0,0,1
9794117,9794419,302,0,0,1,2
9794118,9794420,302,0,0,1,1
9794420,9794465,45,1,0,0,2
9794421,9794466,45,1,0,0,1
9794466,9794565,99,0,0,1,2
9794467,9794566,99,0,0,1,1
9794566,9794629,63,1,0,0,2
9794567,9794630,63,1,0,0,1
9794630,9794782,152,0,0,1,2
9794631,9794782,151,0,0,1,1
9794783,9794809,26,1,0,0,2
9794783,9794818,35,1,0,0,1
9794810,9795525,715,0,0,1,2
9794819,9795516,697,0,0,1,1
9795517,9795828,311,1,0,0,1
9795526,9795747,221,1,0,0,2
9795548,9795736,188,0,1,0,1
9795552,9795694,142,0,1,0,2
9795716,9795720,4,0,1,0,2
9795748,9796008,260,0,0,1,2
9795829,9796007,178,0,0,1,1
9796008,9796073,65,1,0,0,1
9796009,9796074,65,1,0,0,2
9796074,9796251,177,0,0,1,1
9796075,9796248,173,0,0,1,2
9796249,9796325,76,1,0,0,2
9796252,9796318,66,1,0,0,1
9796319,9796346,27,0,0,1,1
9796326,9796347,21,0,0,1,2
9796347,9796424,77,1,0,0,1
9796348,9796417,69,1,0,0,2
9796418,9796501,83,0,0,1,2
9796425,9796500,75,0,0,1,1
9796501,9796530,29,1,0,0,1
9796502,9796533,31,1,0,0,2
9796531,9796780,249,0,0,1,1
9796534,9796781,247,0,0,1,2
9796781,9796790,9,1,0,0,1
9796782,9796793,11,1,0,0,2
9796791,9797211,420,0,0,1,1
9796794,9797605,811,0,0,1,2
9797212,9797242,30,1,0,0,1
9797243,9797595,352,0,0,1,1
9797596,9797884,288,1,0,0,1
9797606,9797845,239,1,0,0,2
9797620,9797810,190,0,1,0,1
9797632,9797787,155,0,1,0,2
9797846,9797991,145,0,0,1,2
9797885,9797993,108,0,0,1,1
9797992,9798036,44,1,0,0,2
9797994,9798036,42,1,0,0,1
9798037,9798142,105,0,0,1,2
9798037,9798143,106,0,0,1,1
9798143,9798202,59,1,0,0,2
9798144,9798202,58,1,0,0,1
9798203,9798270,67,0,0,1,2
9798203,9798271,68,0,0,1,1
9798271,9798303,32,1,0,0,2
9798272,9798303,31,1,0,0,1
9798304,9798428,124,0,0,1,2
9798304,9798430,126,0,0,1,1
9798429,9798447,18,1,0,0,2
9798431,9798450,19,1,0,0,1
9798448,9799414,966,0,0,1,2
9798451,9799415,964,0,0,1,1
9799415,9799456,41,1,0,0,2
9799416,9799457,41,1,0,0,1
9799457,9799746,289,0,0,1,2
9799458,9799747,289,0,0,1,1
9799747,9799794,47,1,0,0,2
9799748,9799797,49,1,0,0,1
9799795,9801147,1352,0,0,1,2
9799798,9801148,1350,0,0,1,1
9801148,9801220,72,1,0,0,2
9801149,9801220,71,1,0,0,1
9801221,9801369,148,0,0,1,1
9801221,9801371,150,0,0,1,2
9801370,9801405,35,1,0,0,1
9801372,9801396,24,1,0,0,2
9801397,9802529,1132,0,0,1,2
9801406,9802532,1126,0,0,1,1
9802530,9802632,102,1,0,0,2
9802533,9802635,102,1,0,0,1
9802633,9802657,24,0,0,1,2
9802636,9802659,23,0,0,1,1
9802658,9802693,35,1,0,0,2
9802660,9802698,38,1,0,0,1
9802694,9803110,416,0,0,1,2
9802699,9803117,418,0,0,1,1
9803111,9803129,18,1,0,0,2
9803118,9803129,11,1,0,0,1
9803130,9803827,697,0,0,1,1
9803130,9803832,702,0,0,1,2
9803828,9803917,89,1,0,0,1
9803833,9803918,85,1,0,0,2
9803918,9804260,342,0,0,1,1
9803919,9804257,338,0,0,1,2
9804258,9804321,63,1,0,0,2
9804261,9804324,63,1,0,0,1
9804322,9804491,169,0,0,1,2
9804325,9804899,574,0,0,1,1
9804492,9804508,16,1,0,0,2
9804509,9804886,377,0,0,1,2
9804887,9805030,143,1,0,0,2
9804900,9805029,129,1,0,0,1
9804931,9804949,18,0,1,0,1
9805030,9805303,273,0,0,1,1
9805031,9805295,264,0,0,1,2
9805296,9805578,282,1,0,0,2
9805304,9805573,269,1,0,0,1
9805319,9805516,197,0,1,0,2
9805323,9805511,188,0,1,0,1
9805574,9805679,105,0,0,1,1
9805579,9805681,102,0,0,1,2
9805680,9805758,78,1,0,0,1
9805682,9805760,78,1,0,0,2
9805759,9805862,103,0,0,1,1
9805761,9805864,103,0,0,1,2
9805863,9805906,43,1,0,0,1
9805865,9805906,41,1,0,0,2
9805907,9805976,69,0,0,1,1
9805907,9805977,70,0,0,1,2
9805977,9806006,29,1,0,0,1
9805978,9806006,28,1,0,0,2
9806007,9806304,297,0,0,1,2
9806007,9806305,298,0,0,1,1
9806305,9806316,11,1,0,0,2
9806306,9806314,8,1,0,0,1
9806315,9806653,338,0,0,1,1
9806317,9806649,332,0,0,1,2
9806650,9806893,243,1,0,0,2
9806654,9806907,253,1,0,0,1
9806677,9806867,190,0,1,0,1
9806678,9806854,176,0,1,0,2
9806894,9807472,578,0,0,1,2
9806908,9807474,566,0,0,1,1
9807473,9807606,133,1,0,0,2
9807475,9807604,129,1,0,0,1
9807605,9807654,49,0,0,1,1
9807607,9807654,47,0,0,1,2
9807655,9807681,26,1,0,0,2
9807655,9807682,27,1,0,0,1
9807682,9808307,625,0,0,1,2
9807683,9808590,907,0,0,1,1
9808308,9808318,10,1,0,0,2
9808319,9808602,283,0,0,1,2
9808591,9808846,255,1,0,0,1
9808603,9808864,261,1,0,0,2
9808629,9808787,158,0,1,0,2
9808629,9808788,159,0,1,0,1
9808847,9809108,261,0,0,1,1
9808865,9809108,243,0,0,1,2
9809109,9809177,68,1,0,0,1
9809109,9809178,69,1,0,0,2
9809178,9809482,304,0,0,1,1
9809179,9809478,299,0,0,1,2
9809479,9809530,51,1,0,0,2
9809483,9809530,47,1,0,0,1
9809531,9810186,655,0,0,1,2
9809531,9810187,656,0,0,1,1
9810187,9810493,306,1,0,0,2
9810188,9810498,310,1,0,0,1
9810221,9810456,235,0,1,0,1
9810224,9810438,214,0,1,0,2
9810494,9810816,322,0,0,1,2
9810499,9810817,318,0,0,1,1
9810817,9810843,26,1,0,0,2
9810818,9810841,23,1,0,0,1
9810842,9811156,314,0,0,1,1
9810844,9811157,313,0,0,1,2
9811157,9811205,48,1,0,0,1
9811158,9811205,47,1,0,0,2
9811206,9811352,146,0,0,1,1
9811206,9811353,147,0,0,1,2
9811353,9811377,24,1,0,0,1
9811354,9811375,21,1,0,0,2
9811376,9812457,1081,0,0,1,2
9811378,9812443,1065,0,0,1,1
9812444,9812835,391,1,0,0,1
9812458,9812807,349,1,0,0,2
9812477,9812808,331,0,1,0,1
9812481,9812722,241,0,1,0,2
9812808,9812943,135,0,0,1,2
9812836,9812946,110,0,0,1,1
9812944,9813018,74,1,0,0,2
9812947,9813031,84,1,0,0,1
9813019,9813055,36,0,0,1,2
9813032,9813055,23,0,0,1,1
9813056,9813082,26,1,0,0,2
9813056,9813087,31,1,0,0,1
9813083,9813127,44,0,0,1,2
9813088,9813128,40,0,0,1,1
9813128,9813159,31,1,0,0,2
9813129,9813160,31,1,0,0,1
9813160,9813319,159,0,0,1,2
9813161,9813319,158,0,0,1,1
9813320,9813336,16,1,0,0,1
9813320,9813338,18,1,0,0,2
9813337,9814706,1369,0,0,1,1
9813339,9814706,1367,0,0,1,2
9814707,9814781,74,1,0,0,1
9814707,9814783,76,1,0,0,2
9814782,9814929,147,0,0,1,1
9814784,9814929,145,0,0,1,2
9814930,9814947,17,1,0,0,1
9814930,9814948,18,1,0,0,2
9814948,9815767,819,0,0,1,1
9814949,9815785,836,0,0,1,2
9815768,9815926,158,1,0,0,1
9815786,9815884,98,1,0,0,2
9815885,9816014,129,0,0,1,2
9815927,9816005,78,0,0,1,1
9816006,9816311,305,1,0,0,1
9816015,9816295,280,1,0,0,2
9816037,9816230,193,0,1,0,2
9816038,9816245,207,0,1,0,1
9816296,9816414,118,0,0,1,2
9816312,9816415,103,0,0,1,1
9816415,9816473,58,1,0,0,2
9816416,9816474,58,1,0,0,1
9816474,9816596,122,0,0,1,2
9816475,9816593,118,0,0,1,1
9816594,9816638,44,1,0,0,1
9816597,9816634,37,1,0,0,2
9816635,9817665,1030,0,0,1,2
9816639,9817644,1005,0,0,1,1
9817645,9817957,312,1,0,0,1
9817666,9817948,282,1,0,0,2
9817681,9817919,238,0,1,0,1
9817692,9817915,223,0,1,0,2
9817949,9818182,233,0,0,1,2
9817958,9818181,223,0,0,1,1
9818182,9818290,108,1,0,0,1
9818183,9818275,92,1,0,0,2
9818276,9818326,50,0,0,1,2
9818291,9818325,34,0,0,1,1
9818326,9818358,32,1,0,0,1
9818327,9818355,28,1,0,0,2
9818356,9818385,29,0,0,1,2
9818359,9818386,27,0,0,1,1
9818386,9818415,29,1,0,0,2
9818387,9818415,28,1,0,0,1
9818416,9818482,66,0,0,1,1
9818416,9818482,66,0,0,1,2
9818483,9818505,22,1,0,0,2
9818483,9818514,31,1,0,0,1
9818506,9818650,144,0,0,1,2
9818515,9818649,134,0,0,1,1
9818650,9818671,21,1,0,0,1
9818651,9818670,19,1,0,0,2
9818671,9819546,875,0,0,1,2
9818672,9819546,874,0,0,1,1
9819547,9819630,83,1,0,0,1
9819547,9819630,83,1,0,0,2
9819631,9819905,274,0,0,1,2
9819631,9819906,275,0,0,1,1
9819906,9819983,77,1,0,0,2
9819907,9819986,79,1,0,0,1
9819984,9820092,108,0,0,1,2
9819987,9820094,107,0,0,1,1
9820093,9820118,25,1,0,0,2
9820095,9820121,26,1,0,0,1
9820119,9821230,1111,0,0,1,2
9820122,9820326,204,0,0,1,1
9820327,9820331,4,1,0,0,1
9820332,9821234,902,0,0,1,1
9821231,9821502,271,1,0,0,2
9821235,9821535,300,1,0,0,1
9821276,9821476,200,0,1,0,2
9821284,9821476,192,0,1,0,1
9821503,9821524,21,0,0,1,2
9821525,9821542,17,1,0,0,2
9821536,9821688,152,0,0,1,1
9821543,9821688,145,0,0,1,2
9821689,9821738,49,1,0,0,2
9821689,9821739,50,1,0,0,1
9821739,9821863,124,0,0,1,2
9821740,9821861,121,0,0,1,1
9821862,9821885,23,1,0,0,1
9821864,9821885,21,1,0,0,2
9821886,9822999,1113,0,0,1,2
9821886,9823001,1115,0,0,1,1
9823000,9823055,55,1,0,0,2
9823002,9823056,54,1,0,0,1
9823056,9823314,258,0,0,1,2
9823057,9823314,257,0,0,1,1
9823315,9823358,43,1,0,0,1
9823315,9823358,43,1,0,0,2
9823359,9823464,105,0,0,1,1
9823359,9823464,105,0,0,1,2
9823465,9823485,20,1,0,0,1
9823465,9823487,22,1,0,0,2
9823486,9824034,548,0,0,1,1
9823488,9824039,551,0,0,1,2
9824035,9824337,302,1,0,0,1
9824040,9824345,305,1,0,0,2
9824064,9824286,222,0,1,0,2
9824068,9824290,222,0,1,0,1
9824338,9824680,342,0,0,1,1
9824346,9824680,334,0,0,1,2
9824681,9824747,66,1,0,0,1
9824681,9824752,71,1,0,0,2
9824748,9824840,92,0,0,1,1
9824753,9824840,87,0,0,1,2
9824841,9824867,26,1,0,0,2
9824841,9824869,28,1,0,0,1
9824868,9826318,1450,0,0,1,2
9824870,9825052,182,0,0,1,1
9825053,9825063,10,1,0,0,1
9825064,9826319,1255,0,0,1,1
9826319,9826377,58,1,0,0,2
9826320,9826392,72,1,0,0,1
9826378,9826464,86,0,0,1,2
9826393,9826466,73,0,0,1,1
9826465,9826488,23,1,0,0,2
9826467,9826486,19,1,0,0,1
9826487,9826650,163,0,0,1,1
9826489,9826652,163,0,0,1,2
9826651,9826670,19,1,0,0,1
9826653,9826669,16,1,0,0,2
9826670,9827931,1261,0,0,1,2
9826671,9827930,1259,0,0,1,1
9827931,9828004,73,1,0,0,1
9827932,9828003,71,1,0,0,2
9828004,9828145,141,0,0,1,2
9828005,9828145,140,0,0,1,1
9828146,9828166,20,1,0,0,2
9828146,9828168,22,1,0,0,1
9828167,9828771,604,0,0,1,2
9828169,9828752,583,0,0,1,1
9828753,9829162,409,1,0,0,1
9828772,9829024,252,1,0,0,2
9828790,9829013,223,0,1,0,1
9828797,9828976,179,0,1,0,2
9829025,9829629,604,0,0,1,2
9829037,9829080,43,0,1,0,1
9829163,9829627,464,0,0,1,1
9829628,9831025,1397,1,0,0,1
9829630,9829672,42,1,0,0,2
9829663,9830976,1313,0,1,0,1
9829673,9830278,605,0,0,1,2
9830279,9830555,276,1,0,0,2
9830307,9830523,216,0,1,0,2
9830556,9830916,360,0,0,1,2
9830917,9831009,92,1,0,0,2
9831010,9831155,145,0,0,1,2
9831026,9831156,130,0,0,1,1
9831156,9831213,57,1,0,0,2
9831157,9831217,60,1,0,0,1
9831214,9831328,114,0,0,1,2
9831218,9831329,111,0,0,1,1
9831329,9831352,23,1,0,0,2
9831330,9831351,21,1,0,0,1
9831352,9831578,226,0,0,1,1
9831353,9831573,220,0,0,1,2
9831574,9831589,15,1,0,0,2
9831579,9831583,4,1,0,0,1
9831584,9832308,724,0,0,1,1
9831590,9832305,715,0,0,1,2
9832306,9832626,320,1,0,0,2
9832309,9832574,265,1,0,0,1
9832336,9832495,159,0,1,0,2
9832341,9832511,170,0,1,0,1
9832575,9832768,193,0,0,1,1
9832627,9832766,139,0,0,1,2
9832767,9832831,64,1,0,0,2
9832769,9832840,71,1,0,0,1
9832832,9832936,104,0,0,1,2
9832841,9832936,95,0,0,1,1
9832937,9832971,34,1,0,0,1
9832937,9832971,34,1,0,0,2
9832972,9833026,54,0,0,1,1
9832972,9833027,55,0,0,1,2
9833027,9833058,31,1,0,0,1
9833028,9833052,24,1,0,0,2
9833053,9833990,937,0,0,1,2
9833059,9833990,931,0,0,1,1
9833991,9834056,65,1,0,0,1
9833991,9834057,66,1,0,0,2
9834057,9834353,296,0,0,1,1
9834058,9834353,295,0,0,1,2
9834354,9834388,34,1,0,0,1
9834354,9834392,38,1,0,0,2
9834389,9834553,164,0,0,1,1
9834393,9834551,158,0,0,1,2
9834552,9834570,18,1,0,0,2
9834554,9834569,15,1,0,0,1
9834570,9835158,588,0,0,1,1
9834571,9835179,608,0,0,1,2
9835159,9835434,275,1,0,0,1
9835180,9835419,239,1,0,0,2
9835224,9835342,118,0,1,0,2
9835227,9835370,143,0,1,0,1
9835420,9835505,85,0,0,1,2
9835435,9835481,46,0,0,1,1
9835482,9835719,237,1,0,0,1
9835506,9835707,201,1,0,0,2
9835537,9835643,106,0,1,0,2
9835537,9835668,131,0,1,0,1
9835708,9835916,208,0,0,1,2
9835720,9835913,193,0,0,1,1
9835914,9836005,91,1,0,0,1
9835917,9835995,78,1,0,0,2
9835996,9836146,150,0,0,1,2
9836006,9836148,142,0,0,1,1
9836147,9836165,18,1,0,0,2
9836149,9836167,18,1,0,0,1
9836166,9837035,869,0,0,1,2
9836168,9837019,851,0,0,1,1
9837020,9837350,330,1,0,0,1
9837036,9837323,287,1,0,0,2
9837041,9837329,288,0,1,0,1
9837065,9837269,204,0,1,0,2
9837324,9837571,247,0,0,1,2
9837351,9837572,221,0,0,1,1
9837572,9837665,93,1,0,0,2
9837573,9837667,94,1,0,0,1
9837666,9837706,40,0,0,1,2
9837668,9837707,39,0,0,1,1
9837707,9837735,28,1,0,0,2
9837708,9837735,27,1,0,0,1
9837736,9837787,51,0,0,1,1
9837736,9837791,55,0,0,1,2
9837788,9837815,27,1,0,0,1
9837792,9837815,23,1,0,0,2
9837816,9837890,74,0,0,1,1
9837816,9837891,75,0,0,1,2
9837891,9837921,30,1,0,0,1
9837892,9837924,32,1,0,0,2
9837922,9838719,797,0,0,1,1
9837925,9838721,796,0,0,1,2
9838720,9838783,63,1,0,0,1
9838722,9838776,54,1,0,0,2
9838777,9839055,278,0,0,1,2
9838784,9839054,270,0,0,1,1
9839055,9839133,78,1,0,0,1
9839056,9839135,79,1,0,0,2
9839134,9839280,146,0,0,1,1
9839136,9839280,144,0,0,1,2
9839281,9839333,52,1,0,0,2
9839281,9839340,59,1,0,0,1
9839334,9840441,1107,0,0,1,2
9839341,9840432,1091,0,0,1,1
9840433,9840739,306,1,0,0,1
9840442,9840735,293,1,0,0,2
9840459,9840684,225,0,1,0,1
9840463,9840690,227,0,1,0,2
9840736,9840813,77,0,0,1,2
9840740,9840813,73,0,0,1,1
9840814,9840931,117,1,0,0,1
9840814,9840942,128,1,0,0,2
9840932,9840973,41,0,0,1,1
9840943,9840972,29,0,0,1,2
9840973,9841006,33,1,0,0,2
9840974,9841014,40,1,0,0,1
9841007,9841065,58,0,0,1,2
9841015,9841066,51,0,0,1,1
9841066,9841090,24,1,0,0,2
9841067,9841091,24,1,0,0,1
9841091,9841203,112,0,0,1,2
9841092,9841202,110,0,0,1,1
9841203,9841224,21,1,0,0,1
9841204,9841224,20,1,0,0,2
9841225,9842112,887,0,0,1,1
9841225,9842112,887,0,0,1,2
9842113,9842170,57,1,0,0,1
9842113,9842172,59,1,0,0,2
9842171,9842273,102,0,0,1,1
9842173,9842275,102,0,0,1,2
9842274,9842324,50,1,0,0,1
9842276,9842332,56,1,0,0,2
9842325,9842495,170,0,0,1,1
9842333,9842495,162,0,0,1,2
9842496,9842616,120,1,0,0,2
9842496,9842619,123,1,0,0,1
9842617,9842660,43,0,0,1,2
9842620,9842658,38,0,0,1,1
9842659,9842686,27,1,0,0,1
9842661,9842686,25,1,0,0,2
9842687,9842742,55,0,0,1,1
9842687,9842746,59,0,0,1,2
9842743,9842776,33,1,0,0,1
9842747,9842776,29,1,0,0,2
9842777,9843782,1005,0,0,1,1
9842777,9843787,1010,0,0,1,2
9843783,9844115,332,1,0,0,1
9843788,9844102,314,1,0,0,2
9843841,9844066,225,0,1,0,2
9843847,9844092,245,0,1,0,1
9844103,9844201,98,0,0,1,2
9844116,9844190,74,0,0,1,1
9844191,9844426,235,1,0,0,1
9844202,9844419,217,1,0,0,2
9844218,9844375,157,0,1,0,1
9844219,9844356,137,0,1,0,2
9844420,9844539,119,0,0,1,2
9844427,9844540,113,0,0,1,1
9844540,9844551,11,1,0,0,2
9844541,9844551,10,1,0,0,1
9844552,9845234,682,0,0,1,1
9844552,9845248,696,0,0,1,2
9845235,9845479,244,1,0,0,1
9845249,9845470,221,1,0,0,2
9845275,9845436,161,0,1,0,1
9845278,9845403,125,0,1,0,2
9845471,9845974,503,0,0,1,2
9845480,9845973,493,0,0,1,1
9845974,9846049,75,1,0,0,1
9845975,9846042,67,1,0,0,2
9846043,9846123,80,0,0,1,2
9846050,9846124,74,0,0,1,1
9846124,9846157,33,1,0,0,2
9846125,9846158,33,1,0,0,1
9846158,9846243,85,0,0,1,2
9846159,9846251,92,0,0,1,1
9846244,9846265,21,1,0,0,2
9846252,9846265,13,1,0,0,1
9846266,9846434,168,0,0,1,2
9846266,9846436,170,0,0,1,1
9846435,9846447,12,1,0,0,2
9846437,9846448,11,1,0,0,1
9846448,9847150,702,0,0,1,2
9846449,9847149,700,0,0,1,1
9847150,9847478,328,1,0,0,1
9847151,9847437,286,1,0,0,2
9847184,9847383,199,0,1,0,2
9847186,9847417,231,0,1,0,1
9847438,9847607,169,0,0,1,2
9847479,9847608,129,0,0,1,1
9847608,9847668,60,1,0,0,2
9847609,9847663,54,1,0,0,1
9847664,9847798,134,0,0,1,1
9847669,9847798,129,0,0,1,2
9847799,9847818,19,1,0,0,1
9847799,9847818,19,1,0,0,2
9847819,9848969,1150,0,0,1,2
9847819,9848975,1156,0,0,1,1
9848970,9849257,287,1,0,0,2
9848976,9849289,313,1,0,0,1
9849011,9849226,215,0,1,0,1
9849012,9849183,171,0,1,0,2
9849258,9849423,165,0,0,1,2
9849290,9849423,133,0,0,1,1
9849424,9849464,40,1,0,0,2
9849424,9849472,48,1,0,0,1
9849465,9849581,116,0,0,1,2
9849473,9849583,110,0,0,1,1
9849582,9849603,21,1,0,0,2
9849584,9849603,19,1,0,0,1
9849604,9850459,855,0,0,1,2
9849604,9850460,856,0,0,1,1
9850460,9850805,345,1,0,0,2
9850461,9850840,379,1,0,0,1
9850484,9850785,301,0,1,0,1
9850486,9850728,242,0,1,0,2
9850806,9850970,164,0,0,1,2
9850841,9850971,130,0,0,1,1
9850971,9851049,78,1,0,0,2
9850972,9851049,77,1,0,0,1
9851050,9851091,41,0,0,1,2
9851050,9851093,43,0,0,1,1
9851092,9851122,30,1,0,0,2
9851094,9851120,26,1,0,0,1
9851121,9851171,50,0,0,1,1
9851123,9851171,48,0,0,1,2
9851172,9851195,23,1,0,0,2
9851172,9851204,32,1,0,0,1
9851196,9851500,304,0,0,1,2
9851205,9851497,292,0,0,1,1
9851498,9851513,15,1,0,0,1
9851501,9851514,13,1,0,0,2
9851514,9852321,807,0,0,1,1
9851515,9852320,805,0,0,1,2
9852321,9852380,59,1,0,0,2
9852322,9852379,57,1,0,0,1
9852380,9852545,165,0,0,1,1
9852381,9852547,166,0,0,1,2
9852546,9852600,54,1,0,0,1
9852548,9852600,52,1,0,0,2
9852601,9852752,151,0,0,1,1
9852601,9852752,151,0,0,1,2
9852753,9852813,60,1,0,0,1
9852753,9852815,62,1,0,0,2
9852814,9852993,179,0,0,1,1
9852816,9852991,175,0,0,1,2
9852992,9853010,18,1,0,0,2
9852994,9853026,32,1,0,0,1
9853011,9853877,866,0,0,1,2
9853027,9853874,847,0,0,1,1
9853875,9854151,276,1,0,0,1
9853878,9854141,263,1,0,0,2
9853908,9854087,179,0,1,0,1
9853914,9854049,135,0,1,0,2
9854142,9854361,219,0,0,1,2
9854152,9854361,209,0,0,1,1
9854362,9854425,63,1,0,0,1
9854362,9854426,64,1,0,0,2
9854426,9854490,64,0,0,1,1
9854427,9854490,63,0,0,1,2
9854491,9854518,27,1,0,0,1
9854491,9854518,27,1,0,0,2
9854519,9854633,114,0,0,1,2
9854519,9854635,116,0,0,1,1
9854634,9854652,18,1,0,0,2
9854636,9854653,17,1,0,0,1
9854653,9854878,225,0,0,1,2
9854654,9855438,784,0,0,1,1
9854879,9854894,15,1,0,0,2
9854895,9855447,552,0,0,1,2
9855439,9855782,343,1,0,0,1
9855448,9855769,321,1,0,0,2
9855466,9855710,244,0,1,0,1
9855481,9855701,220,0,1,0,2
9855770,9855914,144,0,0,1,2
9855783,9855915,132,0,0,1,1
9855915,9855953,38,1,0,0,2
9855916,9855954,38,1,0,0,1
9855954,9855985,31,0,0,1,2
9855955,9855986,31,0,0,1,1
9855986,9856029,43,1,0,0,2
9855987,9856028,41,1,0,0,1
9856029,9856118,89,0,0,1,1
9856030,9856121,91,0,0,1,2
9856119,9856144,25,1,0,0,1
9856122,9856143,21,1,0,0,2
9856144,9857538,1394,0,0,1,2
9856145,9857540,1395,0,0,1,1
9857539,9857615,76,1,0,0,2
9857541,9857616,75,1,0,0,1
9857616,9857696,80,0,0,1,2
9857617,9857698,81,0,0,1,1
9857697,9857731,34,1,0,0,2
9857699,9857727,28,1,0,0,1
9857728,9857839,111,0,0,1,1
9857732,9857842,110,0,0,1,2
9857840,9857859,19,1,0,0,1
9857843,9857858,15,1,0,0,2
9857859,9858007,148,0,0,1,2
9857860,9858008,148,0,0,1,1
9858008,9858013,5,1,0,0,2
9858009,9858018,9,1,0,0,1
9858014,9858581,567,0,0,1,2
9858019,9858574,555,0,0,1,1
9858575,9858976,401,1,0,0,1
9858582,9858906,324,1,0,0,2
9858620,9858828,208,0,1,0,2
9858622,9858842,220,0,1,0,1
9858907,9859009,102,0,0,1,2
9858977,9859006,29,0,0,1,1
9859007,9859108,101,1,0,0,1
9859010,9859085,75,1,0,0,2
9859086,9859168,82,0,0,1,2
9859109,9859169,60,0,0,1,1
9859169,9859250,81,1,0,0,2
9859170,9859249,79,1,0,0,1
9859250,9859292,42,0,0,1,1
9859251,9859292,41,0,0,1,2
9859293,9859319,26,1,0,0,2
9859293,9859320,27,1,0,0,1
9859320,9859407,87,0,0,1,2
9859321,9859406,85,0,0,1,1
9859407,9859438,31,1,0,0,1
9859408,9859446,38,1,0,0,2
9859439,9860318,879,0,0,1,1
9859447,9860292,845,0,0,1,2
9860293,9860561,268,1,0,0,2
9860319,9860556,237,1,0,0,1
9860364,9860461,97,0,1,0,2
9860372,9860479,107,0,1,0,1
9860557,9860729,172,0,0,1,1
9860562,9860731,169,0,0,1,2
9860730,9860801,71,1,0,0,1
9860732,9860800,68,1,0,0,2
9860801,9860909,108,0,0,1,2
9860802,9860909,107,0,0,1,1
9860910,9860932,22,1,0,0,1
9860910,9860932,22,1,0,0,2
9860933,9861095,162,0,0,1,2
9860933,9861097,164,0,0,1,1
9861096,9861112,16,1,0,0,2
9861098,9861113,15,1,0,0,1
9861113,9861855,742,0,0,1,2
9861114,9861842,728,0,0,1,1
9861843,9862207,364,1,0,0,1
9861856,9862163,307,1,0,0,2
9861879,9862097,218,0,1,0,2
9861880,9862100,220,0,1,0,1
9862164,9862315,151,0,0,1,2
9862208,9862315,107,0,0,1,1
9862316,9862373,57,1,0,0,1
9862316,9862374,58,1,0,0,2
9862374,9862498,124,0,0,1,1
9862375,9862498,123,0,0,1,2
9862499,9862521,22,1,0,0,1
9862499,9862529,30,1,0,0,2
9862522,9863591,1069,0,0,1,1
9862530,9863590,1060,0,0,1,2
9863591,9863660,69,1,0,0,2
9863592,9863660,68,1,0,0,1
9863661,9863885,224,0,0,1,1
9863661,9863887,226,0,0,1,2
9863886,9863967,81,1,0,0,1
9863888,9863966,78,1,0,0,2
9863967,9864074,107,0,0,1,2
9863968,9864075,107,0,0,1,1
9864075,9864106,31,1,0,0,2
9864076,9864118,42,1,0,0,1
9864107,9864347,240,0,0,1,2
9864119,9864348,229,0,0,1,1
9864348,9864360,12,1,0,0,2
9864349,9864358,9,1,0,0,1
9864359,9864978,619,0,0,1,1
9864361,9864978,617,0,0,1,2
9864979,9865134,155,1,0,0,2
9864979,9865163,184,1,0,0,1
9865135,9865354,219,0,0,1,2
9865164,9865355,191,0,0,1,1
9865355,9865406,51,1,0,0,2
9865356,9865407,51,1,0,0,1
9865407,9865457,50,0,0,1,2
9865408,9865458,50,0,0,1,1
9865458,9865517,59,1,0,0,2
9865459,9865516,57,1,0,0,1
9865517,9865577,60,0,0,1,1
9865518,9865578,60,0,0,1,2
9865578,9865611,33,1,0,0,1
9865579,9865612,33,1,0,0,2
9865612,9865699,87,0,0,1,1
9865613,9865697,84,0,0,1,2
9865698,9865720,22,1,0,0,2
9865700,9865719,19,1,0,0,1
9865720,9865866,146,0,0,1,1
9865721,9865861,140,0,0,1,2
9865862,9865880,18,1,0,0,2
9865867,9865879,12,1,0,0,1
9865880,9866721,841,0,0,1,1
9865881,9866721,840,0,0,1,2
9866722,9866927,205,1,0,0,2
9866722,9866947,225,1,0,0,1
9866772,9866819,47,0,1,0,2
9866775,9866806,31,0,1,0,1
9866928,9867088,160,0,0,1,2
9866948,9867086,138,0,0,1,1
9867087,9867150,63,1,0,0,1
9867089,9867143,54,1,0,0,2
9867144,9867290,146,0,0,1,2
9867151,9867291,140,0,0,1,1
9867291,9867363,72,1,0,0,2
9867292,9867363,71,1,0,0,1
9867364,9867427,63,0,0,1,1
9867364,9867428,64,0,0,1,2
9867428,9867457,29,1,0,0,1
9867429,9867456,27,1,0,0,2
9867457,9867583,126,0,0,1,2
9867458,9867582,124,0,0,1,1
9867583,9867617,34,1,0,0,1
9867584,9867608,24,1,0,0,2
9867609,9869642,2033,0,0,1,2
9867618,9869642,2024,0,0,1,1
9869643,9869683,40,1,0,0,1
9869643,9869683,40,1,0,0,2
9869684,9871710,2026,0,0,1,1
9869684,9871716,2032,0,0,1,2
9871711,9872039,328,1,0,0,1
9871717,9872032,315,1,0,0,2
9871756,9871971,215,0,1,0,1
9871757,9871978,221,0,1,0,2
9872033,9872259,226,0,0,1,2
9872040,9872071,31,0,0,1,1
9872072,9872095,23,1,0,0,1
9872096,9872129,33,0,0,1,1
9872130,9872139,9,1,0,0,1
9872140,9872249,109,0,0,1,1
9872250,9872492,242,1,0,0,1
9872260,9872481,221,1,0,0,2
9872293,9872440,147,0,1,0,1
9872293,9872442,149,0,1,0,2
9872482,9873670,1188,0,0,1,2
9872493,9872564,71,0,0,1,1
9872565,9872573,8,1,0,0,1
9872574,9873670,1096,0,0,1,1
9873671,9873727,56,1,0,0,1
9873671,9873734,63,1,0,0,2
9873728,9873825,97,0,0,1,1
9873735,9873824,89,0,0,1,2
9873825,9873874,49,1,0,0,2
9873826,9873875,49,1,0,0,1
9873875,9873973,98,0,0,1,2
9873876,9873974,98,0,0,1,1
9873974,9873993,19,1,0,0,2
9873975,9873996,21,1,0,0,1
9873994,9874906,912,0,0,1,2
9873997,9874897,900,0,0,1,1
9874898,9875131,233,1,0,0,1
9874907,9875066,159,1,0,0,2
9874923,9875061,138,0,1,0,1
9874927,9875045,118,0,1,0,2
9875067,9875103,36,0,0,1,2
9875084,9875092,8,0,1,0,1
9875104,9875110,6,1,0,0,2
9875111,9875446,335,0,0,1,2
9875132,9875446,314,0,0,1,1
9875447,9875487,40,1,0,0,2
9875447,9875489,42,1,0,0,1
9875488,9876239,751,0,0,1,2
9875490,9876241,751,0,0,1,1
9876240,9876250,10,1,0,0,2
9876242,9876250,8,1,0,0,1
9876251,9877499,1248,0,0,1,1
9876251,9877503,1252,0,0,1,2
9877500,9877811,311,1,0,0,1
9877504,9877761,257,1,0,0,2
9877522,9877713,191,0,1,0,1
9877529,9877714,185,0,1,0,2
9877743,9877756,13,0,1,0,1
9877762,9878410,648,0,0,1,2
9877812,9878409,597,0,0,1,1
9878410,9878453,43,1,0,0,1
9878411,9878453,42,1,0,0,2
9878454,9879254,800,0,0,1,2
9878454,9879256,802,0,0,1,1
9879255,9879317,62,1,0,0,2
9879257,9879334,77,1,0,0,1
9879318,9879455,137,0,0,1,2
9879335,9879451,116,0,0,1,1
9879452,9879469,17,1,0,0,1
9879456,9879468,12,1,0,0,2
9879469,9880885,1416,0,0,1,2
9879470,9880885,1415,0,0,1,1
9880886,9880934,48,1,0,0,1
9880886,9880935,49,1,0,0,2
9880935,9881120,185,0,0,1,1
9880936,9881119,183,0,0,1,2
9881120,9881141,21,1,0,0,2
9881121,9881142,21,1,0,0,1
9881142,9882959,1817,0,0,1,2
9881143,9882958,1815,0,0,1,1
9882959,9883363,404,1,0,0,1
9882960,9883339,379,1,0,0,2
9882986,9883351,365,0,1,0,1
9882987,9883321,334,0,1,0,2
9883340,9883546,206,0,0,1,2
9883364,9883385,21,0,0,1,1
9883386,9883390,4,1,0,0,1
9883391,9883528,137,0,0,1,1
9883529,9883820,291,1,0,0,1
9883547,9883793,246,1,0,0,2
9883562,9883719,157,0,1,0,1
9883564,9883732,168,0,1,0,2
9883794,9884345,551,0,0,1,2
9883821,9884347,526,0,0,1,1
9884346,9884397,51,1,0,0,2
9884348,9884397,49,1,0,0,1
9884398,9884784,386,0,0,1,1
9884398,9884785,387,0,0,1,2
9884785,9884835,50,1,0,0,1
9884786,9884835,49,1,0,0,2
9884836,9885020,184,0,0,1,1
9884836,9885757,921,0,0,1,2
9885021,9885025,4,1,0,0,1
9885026,9885749,723,0,0,1,1
9885750,9886049,299,1,0,0,1
9885758,9885974,216,1,0,0,2
9885778,9885996,218,0,1,0,1
9885786,9885918,132,0,1,0,2
9885975,9886078,103,0,0,1,2
9886050,9886080,30,0,0,1,1
9886079,9886116,37,1,0,0,2
9886081,9886127,46,1,0,0,1
9886117,9886327,210,0,0,1,2
9886128,9886327,199,0,0,1,1
9886328,9886351,23,1,0,0,1
9886328,9886351,23,1,0,0,2
9886352,9888112,1760,0,0,1,1
9886352,9888124,1772,0,0,1,2
9888113,9888482,369,1,0,0,1
9888125,9888433,308,1,0,0,2
9888145,9888365,220,0,1,0,1
9888147,9888352,205,0,1,0,2
9888434,9889437,1003,0,0,1,2
9888483,9889437,954,0,0,1,1
9889438,9889481,43,1,0,0,2
9889438,9889482,44,1,0,0,1
9889482,9889614,132,0,0,1,2
9889483,9889617,134,0,0,1,1
9889615,9889630,15,1,0,0,2
9889618,9889624,6,1,0,0,1
9889625,9890438,813,0,0,1,1
9889631,9890447,816,0,0,1,2
9890439,9890615,176,1,0,0,1
9890448,9890619,171,1,0,0,2
9890471,9890548,77,0,1,0,1
9890476,9890553,77,0,1,0,2
9890616,9890930,314,0,0,1,1
9890620,9890929,309,0,0,1,2
9890930,9890973,43,1,0,0,2
9890931,9890974,43,1,0,0,1
9890974,9891031,57,0,0,1,2
9890975,9891031,56,0,0,1,1
9891032,9891056,24,1,0,0,1
9891032,9891057,25,1,0,0,2
9891057,9891333,276,0,0,1,1
9891058,9891331,273,0,0,1,2
9891332,9891354,22,1,0,0,2
9891334,9891353,19,1,0,0,1
9891354,9892768,1414,0,0,1,1
9891355,9892767,1412,0,0,1,2
9892768,9892946,178,1,0,0,2
9892769,9893014,245,1,0,0,1
9892808,9892872,64,0,1,0,1
9892811,9892872,61,0,1,0,2
9892947,9893142,195,0,0,1,2
9893015,9893127,112,0,0,1,1
9893128,9893512,384,1,0,0,1
9893143,9893463,320,1,0,0,2
9893179,9893395,216,0,1,0,1
9893183,9893394,211,0,1,0,2
9893464,9894634,1170,0,0,1,2
9893513,9894634,1121,0,0,1,1
9894635,9894699,64,1,0,0,2
9894635,9894702,67,1,0,0,1
9894700,9894833,133,0,0,1,2
9894703,9894835,132,0,0,1,1
9894834,9894854,20,1,0,0,2
9894836,9894855,19,1,0,0,1
9894855,9895432,577,0,0,1,2
9894856,9895418,562,0,0,1,1
9895419,9895725,306,1,0,0,1
9895433,9895705,272,1,0,0,2
9895444,9895659,215,0,1,0,1
9895451,9895647,196,0,1,0,2
9895706,9896170,464,0,0,1,2
9895726,9896171,445,0,0,1,1
9896171,9896221,50,1,0,0,2
9896172,9896224,52,1,0,0,1
9896222,9897015,793,0,0,1,2
9896225,9897012,787,0,0,1,1
9897013,9897035,22,1,0,0,1
9897016,9897032,16,1,0,0,2
9897033,9897711,678,0,0,1,2
9897036,9897710,674,0,0,1,1
9897711,9898105,394,1,0,0,1
9897712,9897850,138,1,0,0,2
9897742,9898086,344,0,1,0,1
9897760,9897821,61,0,1,0,2
9897851,9898209,358,0,0,1,2
9898106,9898207,101,0,0,1,1
9898210,9898800,590,1,0,0,2
9898218,9900235,2017,0,1,0,1
9898233,9898752,519,0,1,0,2
9898801,9899074,273,0,0,1,2
9899085,9899116,31,0,1,0,2
9899126,9899126,0,1,0,0,2
9899127,9899199,72,0,0,1,2
9899200,9899233,33,1,0,0,2
9899234,9900132,898,0,0,1,2
9900133,9900230,97,1,0,0,2
9900231,9900274,43,0,0,1,2
9900245,9900253,8,1,0,0,1
9900254,9900274,20,0,0,1,1
9900275,9900302,27,1,0,0,1
9900275,9900303,28,1,0,0,2
9900303,9900349,46,0,0,1,1
9900304,9900349,45,0,0,1,2
9900350,9900376,26,1,0,0,1
9900350,9900376,26,1,0,0,2
9900377,9900438,61,0,0,1,1
9900377,9900439,62,0,0,1,2
9900439,9900474,35,1,0,0,1
9900440,9900465,25,1,0,0,2
9900466,9902016,1550,0,0,1,2
9900475,9902016,1541,0,0,1,1
9902017,9902056,39,1,0,0,2
9902017,9902057,40,1,0,0,1
9902057,9902148,91,0,0,1,2
9902058,9902148,90,0,0,1,1
9902149,9902171,22,1,0,0,2
9902149,9902172,23,1,0,0,1
9902172,9902935,763,0,0,1,2
9902173,9902936,763,0,0,1,1
9902936,9902947,11,1,0,0,2
9902937,9902948,11,1,0,0,1
9902948,9904090,1142,0,0,1,2
9902949,9904080,1131,0,0,1,1
9904081,9904435,354,1,0,0,1
9904091,9904431,340,1,0,0,2
9904127,9904386,259,0,1,0,1
9904131,9904380,249,0,1,0,2
9904432,9904699,267,0,0,1,2
9904436,9904703,267,0,0,1,1
9904700,9904931,231,1,0,0,2
9904704,9904926,222,1,0,0,1
9904724,9904885,161,0,1,0,2
9904726,9904885,159,0,1,0,1
9904927,9906073,1146,0,0,1,1
9904932,9906072,1140,0,0,1,2
9906073,9906137,64,1,0,0,2
9906074,9906139,65,1,0,0,1
9906138,9906252,114,0,0,1,2
9906140,9906253,113,0,0,1,1
9906253,9906274,21,1,0,0,2
9906254,9906273,19,1,0,0,1
9906274,9906998,724,0,0,1,1
9906275,9907005,730,0,0,1,2
9906999,9907284,285,1,0,0,1
9907006,9907259,253,1,0,0,2
9907025,9907222,197,0,1,0,2
9907025,9907254,229,0,1,0,1
9907260,9907458,198,0,0,1,2
9907285,9907456,171,0,0,1,1
9907457,9907477,20,1,0,0,1
9907459,9907476,17,1,0,0,2
9907477,9907675,198,0,0,1,2
9907478,9907675,197,0,0,1,1
9907676,9907720,44,1,0,0,2
9907676,9907721,45,1,0,0,1
9907721,9908001,280,0,0,1,2
9907722,9907999,277,0,0,1,1
9908000,9908015,15,1,0,0,1
9908002,9908016,14,1,0,0,2
9908016,9909755,1739,0,0,1,1
9908017,9909756,1739,0,0,1,2
9909756,9910181,425,1,0,0,1
9909757,9910159,402,1,0,0,2
9909784,9910149,365,0,1,0,1
9909785,9910119,334,0,1,0,2
9910160,9910395,235,0,0,1,2
9910182,9910392,210,0,0,1,1
9910393,9910444,51,1,0,0,1
9910396,9910446,50,1,0,0,2
9910445,9911459,1014,0,0,1,1
9910447,9911459,1012,0,0,1,2
9911460,9911506,46,1,0,0,1
9911460,9911506,46,1,0,0,2
9911507,9911676,169,0,0,1,2
9911507,9913119,1612,0,0,1,1
9911677,9911690,13,1,0,0,2
9911691,9913119,1428,0,0,1,2
9913120,9913161,41,1,0,0,2
9913120,9913163,43,1,0,0,1
9913162,9913449,287,0,0,1,2
9913164,9913450,286,0,0,1,1
9913450,9913460,10,1,0,0,2
9913451,9913456,5,1,0,0,1
9913457,9915159,1702,0,0,1,1
9913461,9915154,1693,0,0,1,2
9915155,9915623,468,1,0,0,2
9915160,9915698,538,1,0,0,1
9915187,9915595,408,0,1,0,2
9915188,9915619,431,0,1,0,1
9915624,9915902,278,0,0,1,2
9915699,9915901,202,0,0,1,1
9915902,9916166,264,1,0,0,1
9915903,9916144,241,1,0,0,2
9915925,9916101,176,0,1,0,2
9915925,9916111,186,0,1,0,1
9916145,9917044,899,0,0,1,2
9916167,9917044,877,0,0,1,1
9917045,9917113,68,1,0,0,2
9917045,9917123,78,1,0,0,1
9917114,9917268,154,0,0,1,2
9917124,9917275,151,0,0,1,1
9917269,9917287,18,1,0,0,2
9917276,9917287,11,1,0,0,1
9917288,9918726,1438,0,0,1,2
9917288,9918727,1439,0,0,1,1
9918727,9918769,42,1,0,0,2
9918728,9918769,41,1,0,0,1
9918770,9920787,2017,0,0,1,1
9918770,9920803,2033,0,0,1,2
9920788,9921248,460,1,0,0,1
9920804,9921199,395,1,0,0,2
9920836,9920856,20,0,1,0,1
9920843,9921156,313,0,1,0,2
9920902,9921157,255,0,1,0,1
9921200,9921600,400,0,0,1,2
9921249,9921600,351,0,0,1,1
9921601,9921648,47,1,0,0,1
9921601,9921648,47,1,0,0,2
9921649,9921998,349,0,0,1,1
9921649,9921999,350,0,0,1,2
9921999,9922042,43,1,0,0,1
9922000,9922041,41,1,0,0,2
9922042,9922496,454,0,0,1,2
9922043,9922496,453,0,0,1,1
9922497,9922534,37,1,0,0,1
9922497,9922536,39,1,0,0,2
9922535,9922670,135,0,0,1,1
9922537,9922671,134,0,0,1,2
9922671,9922683,12,1,0,0,1
9922672,9922683,11,1,0,0,2
9922684,9923431,747,0,0,1,1
9922684,9923433,749,0,0,1,2
9923432,9923704,272,1,0,0,1
9923434,9923653,219,1,0,0,2
9923462,9923590,128,0,1,0,1
9923463,9923573,110,0,1,0,2
9923654,9923954,300,0,0,1,2
9923705,9923952,247,0,0,1,1
9923953,9924012,59,1,0,0,1
9923955,9924006,51,1,0,0,2
9924007,9925077,1070,0,0,1,2
9924013,9925077,1064,0,0,1,1
9925078,9925098,20,1,0,0,1
9925078,9925100,22,1,0,0,2
9925099,9925822,723,0,0,1,1
9925101,9925839,738,0,0,1,2
9925823,9926309,486,1,0,0,1
9925840,9926272,432,1,0,0,2
9925852,9926276,424,0,1,0,1
9925875,9925939,64,0,1,0,2
9925977,9926197,220,0,1,0,2
9926273,9927617,1344,0,0,1,2
9926310,9926359,49,0,0,1,1
9926360,9926370,10,1,0,0,1
9926371,9927619,1248,0,0,1,1
9927618,9927693,75,1,0,0,2
9927620,9927687,67,1,0,0,1
9927688,9927786,98,0,0,1,1
9927694,9927786,92,0,0,1,2
9927787,9927810,23,1,0,0,1
9927787,9927810,23,1,0,0,2
9927811,9928762,951,0,0,1,2
9927811,9928763,952,0,0,1,1
9928763,9928825,62,1,0,0,2
9928764,9928820,56,1,0,0,1
9928821,9929105,284,0,0,1,1
9928826,9929104,278,0,0,1,2
9929105,9929120,15,1,0,0,2
9929106,9929124,18,1,0,0,1
9929121,9930109,988,0,0,1,2
9929125,9930111,986,0,0,1,1
9930110,9930147,37,1,0,0,2
9930112,9930149,37,1,0,0,1
9930148,9930776,628,0,0,1,2
9930150,9930778,628,0,0,1,1
9930777,9931099,322,1,0,0,2
9930779,9931154,375,1,0,0,1
9930826,9931036,210,0,1,0,1
9930828,9931027,199,0,1,0,2
9931100,9931278,178,0,0,1,2
9931155,9931279,124,0,0,1,1
9931279,9931329,50,1,0,0,2
9931280,9931329,49,1,0,0,1
9931330,9931489,159,0,0,1,1
9931330,9931490,160,0,0,1,2
9931490,9931770,280,1,0,0,1
9931491,9931768,277,1,0,0,2
9931517,9931705,188,0,1,0,1
9931522,9931681,159,0,1,0,2
9931769,9931861,92,0,0,1,2
9931771,9931859,88,0,0,1,1
9931860,9931914,54,1,0,0,1
9931862,9931914,52,1,0,0,2
9931915,9932057,142,0,0,1,1
9931915,9932058,143,0,0,1,2
9932058,9932115,57,1,0,0,1
9932059,9932123,64,1,0,0,2
9932116,9932158,42,0,0,1,1
9932124,9932158,34,0,0,1,2
9932159,9932192,33,1,0,0,2
9932159,9932193,34,1,0,0,1
9932193,9932311,118,0,0,1,2
9932194,9932312,118,0,0,1,1
9932312,9932331,19,1,0,0,2
9932313,9932332,19,1,0,0,1
9932332,9932588,256,0,0,1,2
9932333,9932588,255,0,0,1,1
9932589,9932597,8,1,0,0,1
9932589,9932599,10,1,0,0,2
9932598,9933544,946,0,0,1,1
9932600,9933545,945,0,0,1,2
9933545,9933580,35,1,0,0,1
9933546,9933589,43,1,0,0,2
9933581,9933766,185,0,0,1,1
9933590,9933765,175,0,0,1,2
9933766,9933793,27,1,0,0,2
9933767,9933790,23,1,0,0,1
9933791,9935529,1738,0,0,1,1
9933794,9935528,1734,0,0,1,2
9935529,9936148,619,1,0,0,2
9935530,9936135,605,1,0,0,1
9935577,9936069,492,0,1,0,1
9935578,9935828,250,0,1,0,2
9935874,9936057,183,0,1,0,2
9936136,9936285,149,0,0,1,1
9936149,9936277,128,0,0,1,2
9936278,9936542,264,1,0,0,2
9936286,9936569,283,1,0,0,1
9936304,9936512,208,0,1,0,1
9936305,9936502,197,0,1,0,2
9936543,9936799,256,0,0,1,2
9936570,9936611,41,0,0,1,1
9936612,9936616,4,1,0,0,1
9936617,9936802,185,0,0,1,1
9936800,9936969,169,1,0,0,2
9936803,9936993,190,1,0,0,1
9936830,9936942,112,0,1,0,2
9936830,9936952,122,0,1,0,1
9936970,9937155,185,0,0,1,2
9936994,9937155,161,0,0,1,1
9937156,9937211,55,1,0,0,2
9937156,9937212,56,1,0,0,1
9937212,9937378,166,0,0,1,2
9937213,9937378,165,0,0,1,1
9937379,9937408,29,1,0,0,2
9937379,9937409,30,1,0,0,1
9937409,9938055,646,0,0,1,2
9937410,9938059,649,0,0,1,1
9938056,9938270,214,1,0,0,2
9938060,9938290,230,1,0,0,1
9938099,9938225,126,0,1,0,2
9938100,9938228,128,0,1,0,1
9938271,9938482,211,0,0,1,2
9938291,9938483,192,0,0,1,1
9938483,9938520,37,1,0,0,2
9938484,9938520,36,1,0,0,1
9938521,9940518,1997,0,0,1,1
9938521,9940528,2007,0,0,1,2
9940519,9940998,479,1,0,0,1
9940529,9941005,476,1,0,0,2
9940571,9940980,409,0,1,0,2
9940572,9940970,398,0,1,0,1
9940999,9941417,418,0,0,1,1
9941006,9941419,413,0,0,1,2
9941418,9941457,39,1,0,0,1
9941420,9941457,37,1,0,0,2
9941458,9942068,610,0,0,1,2
9941458,9942069,611,0,0,1,1
9942069,9942129,60,1,0,0,2
9942070,9942139,69,1,0,0,1
9942130,9942241,111,0,0,1,2
9942140,9942242,102,0,0,1,1
9942242,9942275,33,1,0,0,2
9942243,9942275,32,1,0,0,1
9942276,9942351,75,0,0,1,2
9942276,9942352,76,0,0,1,1
9942352,9942364,12,1,0,0,2
9942353,9942358,5,1,0,0,1
9942359,9942974,615,0,0,1,1
9942365,9942989,624,0,0,1,2
9942975,9943237,262,1,0,0,1
9942990,9943199,209,1,0,0,2
9943031,9943136,105,0,1,0,2
9943034,9943147,113,0,1,0,1
9943200,9943543,343,0,0,1,2
9943238,9943544,306,0,0,1,1
9943544,9943599,55,1,0,0,2
9943545,9943599,54,1,0,0,1
9943600,9945563,1963,0,0,1,1
9943600,9945574,1974,0,0,1,2
9945564,9946002,438,1,0,0,1
9945575,9945984,409,1,0,0,2
9945617,9945948,331,0,1,0,1
9945622,9945957,335,0,1,0,2
9945985,9946115,130,0,0,1,2
9946003,9946106,103,0,0,1,1
9946107,9946437,330,1,0,0,1
9946116,9946435,319,1,0,0,2
9946133,9946385,252,0,1,0,1
9946138,9946377,239,0,1,0,2
9946436,9947210,774,0,0,1,2
9946438,9947210,772,0,0,1,1
9947211,9947267,56,1,0,0,2
9947211,9947270,59,1,0,0,1
9947268,9947666,398,0,0,1,2
9947271,9947670,399,0,0,1,1
9947667,9947686,19,1,0,0,2
9947671,9947684,13,1,0,0,1
9947685,9948863,1178,0,0,1,1
9947687,9948863,1176,0,0,1,2
9948864,9948920,56,1,0,0,2
9948864,9948930,66,1,0,0,1
9948921,9949031,110,0,0,1,2
9948931,9949030,99,0,0,1,1
9949031,9949054,23,1,0,0,1
9949032,9949054,22,1,0,0,2
9949055,9949562,507,0,0,1,2
9949055,9949563,508,0,0,1,1
9949563,9949574,11,1,0,0,2
9949564,9949575,11,1,0,0,1
9949575,9950923,1348,0,0,1,2
9949576,9950923,1347,0,0,1,1
9950924,9951239,315,1,0,0,2
9950924,9951244,320,1,0,0,1
9950957,9951202,245,0,1,0,2
9950965,9951212,247,0,1,0,1
9951240,9951284,44,0,0,1,2
9951245,9951279,34,0,0,1,1
9951280,9951497,217,1,0,0,1
9951285,9951492,207,1,0,0,2
9951301,9951459,158,0,1,0,1
9951303,9951459,156,0,1,0,2
9951493,9952952,1459,0,0,1,2
9951498,9952952,1454,0,0,1,1
9952953,9953023,70,1,0,0,2
9952953,9953026,73,1,0,0,1
9953024,9953307,283,0,0,1,2
9953027,9953308,281,0,0,1,1
9953308,9953318,10,1,0,0,2
9953309,9953320,11,1,0,0,1
9953319,9954651,1332,0,0,1,2
9953321,9954650,1329,0,0,1,1
9954651,9954702,51,1,0,0,1
9954652,9954703,51,1,0,0,2
9954703,9955287,584,0,0,1,1
9954704,9955281,577,0,0,1,2
9955282,9955300,18,1,0,0,2
9955288,9955299,11,1,0,0,1
9955300,9956733,1433,0,0,1,1
9955301,9956729,1428,0,0,1,2
9956730,9957349,619,1,0,0,2
9956734,9957347,613,1,0,0,1
9956771,9957304,533,0,1,0,1
9956773,9957014,241,0,1,0,2
9957058,9957263,205,0,1,0,2
9957348,9957933,585,0,0,1,1
9957350,9957933,583,0,0,1,2
9957934,9957976,42,1,0,0,2
9957934,9957977,43,1,0,0,1
9957977,9958489,512,0,0,1,2
9957978,9958491,513,0,0,1,1
9958490,9958552,62,1,0,0,2
9958492,9958546,54,1,0,0,1
9958547,9959381,834,0,0,1,1
9958553,9958860,307,0,0,1,2
9958861,9958870,9,1,0,0,2
9958871,9959383,512,0,0,1,2
9959382,9959641,259,1,0,0,1
9959384,9959661,277,1,0,0,2
9959409,9959572,163,0,1,0,1
9959412,9959568,156,0,1,0,2
9959642,9959929,287,0,0,1,1
9959662,9959928,266,0,0,1,2
9959929,9959956,27,1,0,0,2
9959930,9959955,25,1,0,0,1
9959956,9960232,276,0,0,1,1
9959957,9960232,275,0,0,1,2
9960233,9960276,43,1,0,0,2
9960233,9960277,44,1,0,0,1
9960277,9960438,161,0,0,1,2
9960278,9960439,161,0,0,1,1
9960439,9960461,22,1,0,0,2
9960440,9960462,22,1,0,0,1
9960462,9961228,766,0,0,1,2
9960463,9961221,758,0,0,1,1
9961222,9961418,196,1,0,0,1
9961229,9961445,216,1,0,0,2
9961252,9961360,108,0,1,0,1
9961254,9961350,96,0,1,0,2
9961419,9962310,891,0,0,1,1
9961446,9962312,866,0,0,1,2
9962311,9962767,456,1,0,0,1
9962313,9962782,469,1,0,0,2
9962341,9962706,365,0,1,0,1
9962342,9962714,372,0,1,0,2
9962768,9963608,840,0,0,1,1
9962783,9963609,826,0,0,1,2
9963609,9963657,48,1,0,0,1
9963610,9963656,46,1,0,0,2
9963657,9964122,465,0,0,1,2
9963658,9964124,466,0,0,1,1
9964123,9964182,59,1,0,0,2
9964125,9964184,59,1,0,0,1
9964183,9964278,95,0,0,1,2
9964185,9964277,92,0,0,1,1
9964278,9964308,30,1,0,0,1
9964279,9964310,31,1,0,0,2
9964309,9964383,74,0,0,1,1
9964311,9964382,71,0,0,1,2
9964383,9964413,30,1,0,0,2
9964384,9964412,28,1,0,0,1
9964413,9964564,151,0,0,1,1
9964414,9964567,153,0,0,1,2
9964565,9964580,15,1,0,0,1
9964568,9964582,14,1,0,0,2
9964581,9965262,681,0,0,1,1
9964583,9965282,699,0,0,1,2
9965263,9965568,305,1,0,0,1
9965283,9965543,260,1,0,0,2
9965312,9965478,166,0,1,0,1
9965315,9965472,157,0,1,0,2
9965544,9965572,28,0,0,1,2
9965569,9965775,206,0,0,1,1
9965573,9965581,8,1,0,0,2
9965582,9965777,195,0,0,1,2
9965776,9965839,63,1,0,0,1
9965778,9965839,61,1,0,0,2
9965840,9966016,176,0,0,1,2
9965840,9966021,181,0,0,1,1
9966017,9966033,16,1,0,0,2
9966022,9966031,9,1,0,0,1
9966032,9967369,1337,0,0,1,1
9966034,9967371,1337,0,0,1,2
9967370,9967635,265,1,0,0,1
9967372,9967647,275,1,0,0,2
9967400,9967552,152,0,1,0,1
9967403,9967560,157,0,1,0,2
9967636,9967682,46,0,0,1,1
9967648,9967754,106,0,0,1,2
9967683,9967727,44,1,0,0,1
9967728,9967750,22,0,0,1,1
9967751,9968118,367,1,0,0,1
9967755,9968044,289,1,0,0,2
9967787,9967956,169,0,1,0,1
9967794,9967961,167,0,1,0,2
9968045,9968825,780,0,0,1,2
9968119,9968823,704,0,0,1,1
9968824,9968870,46,1,0,0,1
9968826,9968864,38,1,0,0,2
9968865,9969008,143,0,0,1,2
9968871,9969008,137,0,0,1,1
9969009,9969027,18,1,0,0,1
9969009,9969027,18,1,0,0,2
9969028,9970603,1575,0,0,1,1
9969028,9970604,1576,0,0,1,2
9970604,9970654,50,1,0,0,1
9970605,9970657,52,1,0,0,2
9970655,9970716,61,0,0,1,1
9970658,9970717,59,0,0,1,2
9970717,9970751,34,1,0,0,1
9970718,9970751,33,1,0,0,2
9970752,9971044,292,0,0,1,1
9970752,9971045,293,0,0,1,2
9971045,9971057,12,1,0,0,1
9971046,9971050,4,1,0,0,2
9971051,9972638,1587,0,0,1,2
9971058,9972636,1578,0,0,1,1
9972637,9973035,398,1,0,0,1
9972639,9972969,330,1,0,0,2
9972678,9972926,248,0,1,0,1
9972682,9972896,214,0,1,0,2
9972970,9973374,404,0,0,1,2
9973036,9973374,338,0,0,1,1
9973375,9973419,44,1,0,0,2
9973375,9973420,45,1,0,0,1
9973420,9973761,341,0,0,1,2
9973421,9973748,327,0,0,1,1
9973749,9974037,288,1,0,0,1
9973762,9974024,262,1,0,0,2
9973786,9973977,191,0,1,0,1
9973789,9973964,175,0,1,0,2
9974025,9974373,348,0,0,1,2
9974038,9974374,336,0,0,1,1
9974374,9974423,49,1,0,0,2
9974375,9974436,61,1,0,0,1
9974424,9975569,1145,0,0,1,2
9974437,9975557,1120,0,0,1,1
9975558,9975781,223,1,0,0,1
9975570,9975742,172,1,0,0,2
9975589,9975680,91,0,1,0,2
9975590,9975729,139,0,1,0,1
9975743,9975882,139,0,0,1,2
9975782,9975814,32,0,0,1,1
9975815,9975834,19,1,0,0,1
9975835,9975884,49,0,0,1,1
9975883,9975926,43,1,0,0,2
9975885,9975925,40,1,0,0,1
9975926,9977069,1143,0,0,1,1
9975927,9977156,1229,0,0,1,2
9977070,9977088,18,1,0,0,1
9977089,9977154,65,0,0,1,1
9977155,9977535,380,1,0,0,1
9977157,9977497,340,1,0,0,2
9977189,9977475,286,0,1,0,1
9977264,9977444,180,0,1,0,2
9977498,9977843,345,0,0,1,2
9977536,9977833,297,0,0,1,1
9977834,9978244,410,1,0,0,1
9977844,9978201,357,1,0,0,2
9977872,9978158,286,0,1,0,2
9977872,9978203,331,0,1,0,1
9978202,9978616,414,0,0,1,2
9978245,9978615,370,0,0,1,1
9978616,9978660,44,1,0,0,1
9978617,9978659,42,1,0,0,2
9978660,9978985,325,0,0,1,2
9978661,9978985,324,0,0,1,1
9978986,9979028,42,1,0,0,1
9978986,9979035,49,1,0,0,2
9979029,9979307,278,0,0,1,1
9979036,9979307,271,0,0,1,2
9979308,9979382,74,1,0,0,2
9979308,9979384,76,1,0,0,1
9979383,9979478,95,0,0,1,2
9979385,9979480,95,0,0,1,1
9979479,9979508,29,1,0,0,2
9979481,9979508,27,1,0,0,1
9979509,9980442,933,0,0,1,1
9979509,9980448,939,0,0,1,2
9980443,9980678,235,1,0,0,1
9980449,9980675,226,1,0,0,2
9980471,9980597,126,0,1,0,1
9980473,9980591,118,0,1,0,2
9980676,9980842,166,0,0,1,2
9980679,9980842,163,0,0,1,1
9980843,9980882,39,1,0,0,1
9980843,9980889,46,1,0,0,2
9980883,9981068,185,0,0,1,1
9980890,9981067,177,0,0,1,2
9981068,9981090,22,1,0,0,2
9981069,9981089,20,1,0,0,1
9981090,9982103,1013,0,0,1,1
9981091,9982111,1020,0,0,1,2
9982104,9982419,315,1,0,0,1
9982112,9982431,319,1,0,0,2
9982133,9982314,181,0,1,0,1
9982133,9982326,193,0,1,0,2
9982420,9983086,666,0,0,1,1
9982432,9983094,662,0,0,1,2
9983087,9983375,288,1,0,0,1
9983095,9983368,273,1,0,0,2
9983119,9983274,155,0,1,0,1
9983122,9983266,144,0,1,0,2
9983369,9983532,163,0,0,1,2
9983376,9983531,155,0,0,1,1
9983532,9983583,51,1,0,0,1
9983533,9983584,51,1,0,0,2
9983584,9984425,841,0,0,1,1
9983585,9984425,840,0,0,1,2
9984426,9984482,56,1,0,0,2
9984426,9984493,67,1,0,0,1
9984483,9984651,168,0,0,1,2
9984494,9984650,156,0,0,1,1
9984651,9984679,28,1,0,0,1
9984652,9984670,18,1,0,0,2
9984671,9985364,693,0,0,1,2
9984680,9985343,663,0,0,1,1
9985344,9985812,468,1,0,0,1
9985365,9985677,312,1,0,0,2
9985379,9985666,287,0,1,0,1
9985385,9985626,241,0,1,0,2
9985678,9985760,82,0,0,1,2
9985761,9985778,17,1,0,0,2
9985779,9985940,161,0,0,1,2
9985813,9985939,126,0,0,1,1
9985940,9986009,69,1,0,0,1
9985941,9985984,43,1,0,0,2
9985985,9987261,1276,0,0,1,2
9986010,9987247,1237,0,0,1,1
9987248,9987620,372,1,0,0,1
9987262,9987501,239,1,0,0,2
9987275,9987538,263,0,1,0,1
9987281,9987474,193,0,1,0,2
9987502,9988555,1053,0,0,1,2
9987621,9987726,105,0,0,1,1
9987727,9987766,39,1,0,0,1
9987767,9988556,789,0,0,1,1
9988556,9988613,57,1,0,0,2
9988557,9988615,58,1,0,0,1
9988614,9989613,999,0,0,1,2
9988616,9989612,996,0,0,1,1
9989613,9989657,44,1,0,0,1
9989614,9989654,40,1,0,0,2
9989655,9989818,163,0,0,1,2
9989658,9989812,154,0,0,1,1
9989813,9989838,25,1,0,0,1
9989819,9989830,11,1,0,0,2
9989831,9990570,739,0,0,1,2
9989839,9990553,714,0,0,1,1
9990554,9990903,349,1,0,0,1
9990571,9990835,264,1,0,0,2
9990587,9990866,279,0,1,0,1
9990595,9990772,177,0,1,0,2
9990836,9991138,302,0,0,1,2
9990904,9991139,235,0,0,1,1
9991139,9991191,52,1,0,0,2
9991140,9991216,76,1,0,0,1
9991192,9991274,82,0,0,1,2
9991217,9991279,62,0,0,1,1
9991275,9991296,21,1,0,0,2
9991280,9991295,15,1,0,0,1
9991296,9991461,165,0,0,1,1
9991297,9991460,163,0,0,1,2
9991461,9991480,19,1,0,0,2
9991462,9991481,19,1,0,0,1
9991481,9991790,309,0,0,1,2
9991482,9991789,307,0,0,1,1
9991790,9991806,16,1,0,0,1
9991791,9991808,17,1,0,0,2
9991807,9992593,786,0,0,1,1
9991809,9992602,793,0,0,1,2
9992594,9992882,288,1,0,0,1
9992603,9992858,255,1,0,0,2
9992618,9992808,190,0,1,0,1
9992624,9992792,168,0,1,0,2
9992859,9993281,422,0,0,1,2
9992883,9992916,33,0,0,1,1
9992917,9992977,60,1,0,0,1
9992978,9993267,289,0,0,1,1
9993268,9993669,401,1,0,0,1
9993282,9993597,315,1,0,0,2
9993304,9993517,213,0,1,0,1
9993307,9993504,197,0,1,0,2
9993598,9993621,23,0,0,1,2
9993622,9993627,5,1,0,0,2
9993628,9994195,567,0,0,1,2
9993670,9994193,523,0,0,1,1
9994194,9994236,42,1,0,0,1
9994196,9994234,38,1,0,0,2
9994235,9994847,612,0,0,1,2
9994237,9994848,611,0,0,1,1
9994848,9994916,68,1,0,0,2
9994849,9994916,67,1,0,0,1
9994917,9994994,77,0,0,1,1
9994917,9994996,79,0,0,1,2
9994995,9995019,24,1,0,0,1
9994997,9995019,22,1,0,0,2
9995020,9995162,142,0,0,1,1
9995020,9995164,144,0,0,1,2
9995163,9995181,18,1,0,0,1
9995165,9995180,15,1,0,0,2
9995181,9996208,1027,0,0,1,2
9995182,9996208,1026,0,0,1,1
9996209,9996246,37,1,0,0,2
9996209,9996247,38,1,0,0,1
9996247,9996535,288,0,0,1,2
9996248,9996539,291,0,0,1,1
9996536,9996554,18,1,0,0,2
9996540,9996556,16,1,0,0,1
9996555,9997326,771,0,0,1,2
9996557,9997307,750,0,0,1,1
9997308,9997579,271,1,0,0,1
9997327,9997547,220,1,0,0,2
9997339,9997551,212,0,1,0,1
9997341,9997509,168,0,1,0,2
9997548,9998236,688,0,0,1,2
9997580,9997750,170,0,0,1,1
9997751,9997756,5,1,0,0,1
9997757,9998225,468,0,0,1,1
9998226,9998544,318,1,0,0,1
9998237,9998537,300,1,0,0,2
9998250,9998513,263,0,1,0,1
9998255,9998485,230,0,1,0,2
9998538,9999194,656,0,0,1,2
9998545,9999179,634,0,0,1,1
9999180,9999422,242,1,0,0,1
9999195,9999447,252,1,0,0,2
9999211,9999386,175,0,1,0,1
9999220,9999366,146,0,1,0,2
9999423,9999728,305,0,0,1,1
9999448,9999727,279,0,0,1,2
9999728,9999787,59,1,0,0,2
9999729,9999801,72,1,0,0,1
9999788,9999831,43,0,0,1,2
9999802,9999831,29,0,0,1,1
9999832,9999859,27,1,0,0,1
9999832,9999859,27,1,0,0,2
9999860,9999983,123,0,0,1,2
9999860,9999984,124,0,0,1,1
9999984,10000005,21,1,0,0,2
9999985,10000005,20,1,0,0,1
10000006,10000765,759,0,0,1,1
10000006,10000780,774,0,0,1,2
10000766,10001088,322,1,0,0,1
10000781,10001007,226,1,0,0,2
10000794,10001042,248,0,1,0,1
10000801,10000950,149,0,1,0,2
10001008,10001259,251,0,0,1,2
10001089,10001260,171,0,0,1,1
10001260,10001318,58,1,0,0,2
10001261,10001313,52,1,0,0,1
10001314,10001441,127,0,0,1,1
10001319,10001441,122,0,0,1,2
10001442,10001463,21,1,0,0,2
10001442,10001464,22,1,0,0,1
10001464,10002575,1111,0,0,1,2
10001465,10002570,1105,0,0,1,1
10002571,10002862,291,1,0,0,1
10002576,10002806,230,1,0,0,2
10002596,10002736,140,0,1,0,1
10002598,10002723,125,0,1,0,2
10002807,10003383,576,0,0,1,2
10002863,10003376,513,0,0,1,1
10003377,10003884,507,1,0,0,1
10003384,10003913,529,1,0,0,2
10003407,10003838,431,0,1,0,1
10003410,10003856,446,0,1,0,2
10003885,10003933,48,0,0,1,1
10003914,10004911,997,0,0,1,2
10003934,10003977,43,1,0,0,1
10003978,10004910,932,0,0,1,1
10004911,10004975,64,1,0,0,1
10004912,10004975,63,1,0,0,2
10004976,10005006,30,0,0,1,1
10004976,10005008,32,0,0,1,2
10005007,10005051,44,1,0,0,1
10005009,10005053,44,1,0,0,2
10005052,10005164,112,0,0,1,1
10005054,10005166,112,0,0,1,2
10005165,10005188,23,1,0,0,1
10005167,10005188,21,1,0,0,2
10005189,10005276,87,0,0,1,1
10005189,10005277,88,0,0,1,2
10005277,10005298,21,1,0,0,1
10005278,10005298,20,1,0,0,2
10005299,10005476,177,0,0,1,1
10005299,10005884,585,0,0,1,2
10005477,10005491,14,1,0,0,1
10005492,10005869,377,0,0,1,1
10005870,10006240,370,1,0,0,1
10005885,10006166,281,1,0,0,2
10005907,10006194,287,0,1,0,1
10005912,10006095,183,0,1,0,2
10006167,10006773,606,0,0,1,2
10006241,10006774,533,0,0,1,1
10006774,10006826,52,1,0,0,2
10006775,10006827,52,1,0,0,1
10006827,10007154,327,0,0,1,2
10006828,10007155,327,0,0,1,1
10007155,10007164,9,1,0,0,2
10007156,10007161,5,1,0,0,1
10007162,10007772,610,0,0,1,1
10007165,10007780,615,0,0,1,2
10007773,10008092,319,1,0,0,1
10007781,10008060,279,1,0,0,2
10007802,10008018,216,0,1,0,1
10007804,10008006,202,0,1,0,2
10008061,10008087,26,0,0,1,2
10008088,10008103,15,1,0,0,2
10008093,10008903,810,0,0,1,1
10008104,10008913,809,0,0,1,2
10008904,10009343,439,1,0,0,1
10008914,10009332,418,1,0,0,2
10008935,10009299,364,0,1,0,1
10008939,10009311,372,0,1,0,2
10009333,10010908,1575,0,0,1,2
10009344,10009398,54,0,0,1,1
10009399,10009431,32,1,0,0,1
10009432,10010910,1478,0,0,1,1
10010909,10010970,61,1,0,0,2
10010911,10010971,60,1,0,0,1
10010971,10011161,190,0,0,1,2
10010972,10011162,190,0,0,1,1
10011162,10011178,16,1,0,0,2
10011163,10011178,15,1,0,0,1
10011179,10011797,618,0,0,1,1
10011179,10011806,627,0,0,1,2
10011798,10012218,420,1,0,0,1
10011807,10012100,293,1,0,0,2
10011828,10012030,202,0,1,0,2
10011830,10012161,331,0,1,0,1
10012101,10012146,45,0,0,1,2
10012147,10012196,49,1,0,0,2
10012197,10012403,206,0,0,1,2
10012219,10012402,183,0,0,1,1
10012403,10012480,77,1,0,0,1
10012404,10012465,61,1,0,0,2
10012466,10012628,162,0,0,1,2
10012481,10012630,149,0,0,1,1
10012629,10012649,20,1,0,0,2
10012631,10012650,19,1,0,0,1
10012650,10013171,521,0,0,1,2
10012651,10013167,516,0,0,1,1
10013168,10013563,395,1,0,0,1
10013172,10013490,318,1,0,0,2
10013199,10013487,288,0,1,0,1
10013200,10013435,235,0,1,0,2
10013491,10014459,968,0,0,1,2
10013564,10013663,99,0,0,1,1
10013664,10013690,26,1,0,0,1
10013691,10014457,766,0,0,1,1
10014458,10015041,583,1,0,0,1
10014460,10014993,533,1,0,0,2
10014482,10014979,497,0,1,0,1
10014483,10014965,482,0,1,0,2
10014994,10015483,489,0,0,1,2
10015042,10015124,82,0,0,1,1
10015125,10015159,34,1,0,0,1
10015160,10015484,324,0,0,1,1
10015484,10015546,62,1,0,0,2
10015485,10015545,60,1,0,0,1
10015546,10016046,500,0,0,1,1
10015547,10016046,499,0,0,1,2
10016047,10016070,23,1,0,0,1
10016047,10016073,26,1,0,0,2
10016071,10016181,110,0,0,1,1
10016074,10016181,107,0,0,1,2
10016182,10016208,26,1,0,0,1
10016182,10016208,26,1,0,0,2
10016209,10016536,327,0,0,1,2
10016209,10016537,328,0,0,1,1
10016537,10016574,37,1,0,0,2
10016538,10016574,36,1,0,0,1
10016575,10016828,253,0,0,1,1
10016575,10016828,253,0,0,1,2
10016829,10016849,20,1,0,0,1
10016829,10016851,22,1,0,0,2
10016850,10017060,210,0,0,1,1
10016852,10017055,203,0,0,1,2
10017056,10017083,27,1,0,0,2
10017061,10017083,22,1,0,0,1
10017084,10017289,205,0,0,1,1
10017084,10017289,205,0,0,1,2
10506485,10506744,259,0,0,1,2
10506485,10506746,261,0,0,1,1
10506745,10506804,59,1,0,0,2
10506747,10506801,54,1,0,0,1
10506802,10506895,93,0,0,1,1
10506805,10506897,92,0,0,1,2
10506896,10506919,23,1,0,0,1
10506898,10506918,20,1,0,0,2
10506919,10507371,452,0,0,1,2
10506920,10507351,431,0,0,1,1
10507352,10510758,3406,1,0,0,1
10507372,10510758,3386,1,0,0,2
10507408,10510740,3332,0,1,0,2
10507412,10510747,3335,0,1,0,1
10510759,10510842,83,0,0,1,2
10510759,10510843,84,0,0,1,1
10510843,10510871,28,1,0,0,2
10510844,10510872,28,1,0,0,1
10510872,10511024,152,0,0,1,2
10510873,10511028,155,0,0,1,1
10511025,10511045,20,1,0,0,2
10511029,10511042,13,1,0,0,1
10511043,10513014,1971,0,0,1,1
10511046,10513014,1968,0,0,1,2
10513015,10513087,72,1,0,0,2
10513015,10513089,74,1,0,0,1
10513088,10513151,63,0,0,1,2
10513090,10513150,60,0,0,1,1
10513151,10513202,51,1,0,0,1
10513152,10513201,49,1,0,0,2
10513202,10513356,154,0,0,1,2
10513203,10513358,155,0,0,1,1
10513357,10513378,21,1,0,0,2
10513359,10513378,19,1,0,0,1
10513379,10514561,1182,0,0,1,1
10513379,10514568,1189,0,0,1,2
10514562,10514666,104,1,0,0,1
10514569,10514657,88,1,0,0,2
10514605,10514611,6,0,1,0,2
10514610,10514620,10,0,1,0,1
10514658,10515019,361,0,0,1,2
10514667,10515018,351,0,0,1,1
10515019,10515082,63,1,0,0,1
10515020,10515081,61,1,0,0,2
10515082,10515268,186,0,0,1,2
10515083,10515104,21,0,0,1,1
10515105,10515109,4,1,0,0,1
10515110,10515268,158,0,0,1,1
10515269,10515287,18,1,0,0,2
10515269,10515289,20,1,0,0,1
10515288,10516215,927,0,0,1,2
10515290,10516220,930,0,0,1,1
10516216,10516271,55,1,0,0,2
10516221,10516273,52,1,0,0,1
10516272,10516591,319,0,0,1,2
10516274,10516593,319,0,0,1,1
10516592,10516657,65,1,0,0,2
10516594,10516657,63,1,0,0,1
10516658,10516754,96,0,0,1,2
10516658,10516755,97,0,0,1,1
10516755,10516779,24,1,0,0,2
10516756,10516780,24,1,0,0,1
10516780,10516864,84,0,0,1,2
10516781,10516864,83,0,0,1,1
10516865,10516884,19,1,0,0,2
10516865,10516886,21,1,0,0,1
10516885,10518249,1364,0,0,1,2
10516887,10518248,1361,0,0,1,1
10518249,10518315,66,1,0,0,1
10518250,10518318,68,1,0,0,2
10518316,10518427,111,0,0,1,1
10518319,10518428,109,0,0,1,2
10518428,10518456,28,1,0,0,1
10518429,10518455,26,1,0,0,2
10518456,10519450,994,0,0,1,2
10518457,10519433,976,0,0,1,1
10519434,10519704,270,1,0,0,1
10519451,10519714,263,1,0,0,2
10519471,10519655,184,0,1,0,2
10519472,10519655,183,0,1,0,1
10519705,10520047,342,0,0,1,1
10519715,10520046,331,0,0,1,2
10520047,10520129,82,1,0,0,2
10520048,10520135,87,1,0,0,1
10520130,10520233,103,0,0,1,2
10520136,10520233,97,0,0,1,1
10520234,10520257,23,1,0,0,1
10520234,10520257,23,1,0,0,2
10520258,10520455,197,0,0,1,1
10520258,10520457,199,0,0,1,2
10520456,10520475,19,1,0,0,1
10520458,10520476,18,1,0,0,2
10520476,10521761,1285,0,0,1,1
10520477,10521760,1283,0,0,1,2
10521761,10521831,70,1,0,0,2
10521762,10521832,70,1,0,0,1
10521832,10522049,217,0,0,1,2
10521833,10522046,213,0,0,1,1
10522047,10522062,15,1,0,0,1
10522050,10522063,13,1,0,0,2
10522063,10522550,487,0,0,1,1
10522064,10522566,502,0,0,1,2
10522551,10522738,187,1,0,0,1
10522567,10522731,164,1,0,0,2
10522585,10522695,110,0,1,0,1
10522586,10522689,103,0,1,0,2
10522732,10523020,288,0,0,1,2
10522739,10523020,281,0,0,1,1
10523021,10523072,51,1,0,0,2
10523021,10523073,52,1,0,0,1
10523073,10523288,215,0,0,1,2
10523074,10523288,214,0,0,1,1
10523289,10523328,39,1,0,0,1
10523289,10523329,40,1,0,0,2
10523329,10523467,138,0,0,1,1
10523330,10523465,135,0,0,1,2
10523466,10523518,52,1,0,0,2
10523468,10523520,52,1,0,0,1
10523519,10523638,119,0,0,1,2
10523521,10523637,116,0,0,1,1
10523638,10523657,19,1,0,0,1
10523639,10523656,17,1,0,0,2
10523657,10523741,84,0,0,1,2
10523658,10523743,85,0,0,1,1
10523742,10523758,16,1,0,0,2
10523744,10523757,13,1,0,0,1
10523758,10524607,849,0,0,1,1
10523759,10524601,842,0,0,1,2
10524602,10524824,222,1,0,0,2
10524608,10524856,248,1,0,0,1
10524626,10524783,157,0,1,0,1
10524627,10524785,158,0,1,0,2
10524825,10525028,203,0,0,1,2
10524857,10525028,171,0,0,1,1
10525029,10525095,66,1,0,0,1
10525029,10525096,67,1,0,0,2
10525096,10525147,51,0,0,1,1
10525097,10525147,50,0,0,1,2
10525148,10525175,27,1,0,0,2
10525148,10525176,28,1,0,0,1
10525176,10525241,65,0,0,1,2
10525177,10525242,65,0,0,1,1
10525242,10525262,20,1,0,0,2
10525243,10525261,18,1,0,0,1
10525262,10526169,907,0,0,1,1
10525263,10526204,941,0,0,1,2
10526170,10526420,250,1,0,0,1
10526205,10526418,213,1,0,0,2
10526229,10526370,141,0,1,0,1
10526232,10526357,125,0,1,0,2
10526419,10526634,215,0,0,1,2
10526421,10526635,214,0,0,1,1
10526635,10526695,60,1,0,0,2
10526636,10526692,56,1,0,0,1
10526693,10526784,91,0,0,1,1
10526696,10526786,90,0,0,1,2
10526785,10526809,24,1,0,0,1
10526787,10526809,22,1,0,0,2
10526810,10527966,1156,0,0,1,1
10526810,10527973,1163,0,0,1,2
10527967,10528201,234,1,0,0,1
10527974,10528210,236,1,0,0,2
10528017,10528136,119,0,1,0,1
10528021,10528127,106,0,1,0,2
10528202,10528469,267,0,0,1,1
10528211,10528471,260,0,0,1,2
10528470,10530110,1640,1,0,0,1
10528472,10528544,72,1,0,0,2
10528539,10530099,1560,0,1,0,1
10528545,10528656,111,0,0,1,2
10528657,10528679,22,1,0,0,2
10528680,10529782,1102,0,0,1,2
10529783,10530104,321,1,0,0,2
10529805,10530056,251,0,1,0,2
10530105,10530237,132,0,0,1,2
10530111,10530236,125,0,0,1,1
10530237,10530336,99,1,0,0,1
10530238,10530329,91,1,0,0,2
10530330,10530430,100,0,0,1,2
10530337,10530431,94,0,0,1,1
10530431,10530451,20,1,0,0,2
10530432,10530452,20,1,0,0,1
10530452,10530601,149,0,0,1,2
10530453,10530599,146,0,0,1,1
10530600,10530609,9,1,0,0,1
10530602,10530609,7,1,0,0,2
10530610,10531545,935,0,0,1,1
10530610,10531547,937,0,0,1,2
10531546,10531850,304,1,0,0,1
10531548,10531826,278,1,0,0,2
10531581,10531762,181,0,1,0,2
10531584,10531785,201,0,1,0,1
10531827,10532030,203,0,0,1,2
10531851,10532029,178,0,0,1,1
10532030,10532089,59,1,0,0,1
10532031,10532085,54,1,0,0,2
10532086,10532193,107,0,0,1,2
10532090,10532194,104,0,0,1,1
10532194,10532222,28,1,0,0,2
10532195,10532237,42,1,0,0,1
10532223,10532653,430,0,0,1,2
10532238,10532653,415,0,0,1,1
10532654,10532659,5,1,0,0,2
10532654,10532669,15,1,0,0,1
10532660,10533005,345,0,0,1,2
10532670,10533005,335,0,0,1,1
10533006,10533073,67,1,0,0,1
10533006,10533073,67,1,0,0,2
10533074,10533329,255,0,0,1,1
10533074,10533329,255,0,0,1,2
10533330,10533374,44,1,0,0,2
10533330,10533375,45,1,0,0,1
10533375,10533503,128,0,0,1,2
10533376,10533504,128,0,0,1,1
10533504,10533520,16,1,0,0,2
10533505,10533521,16,1,0,0,1
10533521,10534689,1168,0,0,1,2
10533522,10534690,1168,0,0,1,1
10534690,10534794,104,1,0,0,2
10534691,10534797,106,1,0,0,1
10534795,10534819,24,0,0,1,2
10534798,10534820,22,0,0,1,1
10534820,10534851,31,1,0,0,2
10534821,10534926,105,1,0,0,1
10534852,10534903,51,0,0,1,2
10534904,10534927,23,1,0,0,2
10534927,10535077,150,0,0,1,1
10534928,10535079,151,0,0,1,2
10535078,10535097,19,1,0,0,1
10535080,10535096,16,1,0,0,2
10535097,10535852,755,0,0,1,2
10535098,10535851,753,0,0,1,1
10535852,10535951,99,1,0,0,1
10535853,10535952,99,1,0,0,2
10535952,10536249,297,0,0,1,1
10535953,10536251,298,0,0,1,2
10536250,10536324,74,1,0,0,1
10536252,10536310,58,1,0,0,2
10536311,10536398,87,0,0,1,2
10536325,10536398,73,0,0,1,1
10536399,10536428,29,1,0,0,1
10536399,10536429,30,1,0,0,2
10536429,10536945,516,0,0,1,1
10536430,10536981,551,0,0,1,2
10536946,10536958,12,1,0,0,1
10536959,10536982,23,0,0,1,1
10536982,10537244,262,1,0,0,2
10536983,10537266,283,1,0,0,1
10537020,10537228,208,0,1,0,1
10537045,10537209,164,0,1,0,2
10537245,10537328,83,0,0,1,2
10537267,10537330,63,0,0,1,1
10537329,10537390,61,1,0,0,2
10537331,10537391,60,1,0,0,1
10537391,10537758,367,0,0,1,2
10537392,10537760,368,0,0,1,1
10537759,10537833,74,1,0,0,2
10537761,10537829,68,1,0,0,1
10537830,10537884,54,0,0,1,1
10537834,10537884,50,0,0,1,2
10537885,10537910,25,1,0,0,1
10537885,10537916,31,1,0,0,2
10537911,10538883,972,0,0,1,1
10537917,10538884,967,0,0,1,2
10538884,10538941,57,1,0,0,1
10538885,10538940,55,1,0,0,2
10538941,10539280,339,0,0,1,2
10538942,10539282,340,0,0,1,1
10539281,10539350,69,1,0,0,2
10539283,10539354,71,1,0,0,1
10539351,10539465,114,0,0,1,2
10539355,10539468,113,0,0,1,1
10539466,10539489,23,1,0,0,2
10539469,10539490,21,1,0,0,1
10539490,10540484,994,0,0,1,2
10539491,10540482,991,0,0,1,1
10540483,10540554,71,1,0,0,1
10540485,10540555,70,1,0,0,2
10540555,10540902,347,0,0,1,1
10540556,10540902,346,0,0,1,2
10540903,10540963,60,1,0,0,2
10540903,10540987,84,1,0,0,1
10540964,10541066,102,0,0,1,2
10540988,10541068,80,0,0,1,1
10541067,10541086,19,1,0,0,2
10541069,10541107,38,1,0,0,1
10541087,10541603,516,0,0,1,2
10541108,10541585,477,0,0,1,1
10541586,10541863,277,1,0,0,1
10541604,10541817,213,1,0,0,2
10541622,10541718,96,0,1,0,1
10541626,10541706,80,0,1,0,2
10541746,10541746,0,0,1,0,2
10541818,10541946,128,0,0,1,2
10541864,10542061,197,0,0,1,1
10541947,10541963,16,1,0,0,2
10541964,10542077,113,0,0,1,2
10542062,10542288,226,1,0,0,1
10542078,10542276,198,1,0,0,2
10542100,10542242,142,0,1,0,1
10542104,10542234,130,0,1,0,2
10542277,10542523,246,0,0,1,2
10542289,10542524,235,0,0,1,1
10542524,10542592,68,1,0,0,2
10542525,10542599,74,1,0,0,1
10542593,10542653,60,0,0,1,2
10542600,10542656,56,0,0,1,1
10542654,10542680,26,1,0,0,2
10542657,10542686,29,1,0,0,1
10542681,10543763,1082,0,0,1,2
10542687,10543769,1082,0,0,1,1
10543764,10543847,83,1,0,0,2
10543770,10543850,80,1,0,0,1
10543848,10544203,355,0,0,1,2
10543851,10544206,355,0,0,1,1
10544204,10544243,39,1,0,0,2
10544207,10544244,37,1,0,0,1
10544244,10544363,119,0,0,1,2
10544245,10544362,117,0,0,1,1
10544363,10544381,18,1,0,0,1
10544364,10544383,19,1,0,0,2
10544382,10545178,796,0,0,1,1
10544384,10545172,788,0,0,1,2
10545173,10545422,249,1,0,0,2
10545179,10545409,230,1,0,0,1
10545203,10545337,134,0,1,0,2
10545206,10545339,133,0,1,0,1
10545410,10545658,248,0,0,1,1
10545423,10545657,234,0,0,1,2
10545658,10545724,66,1,0,0,2
10545659,10545725,66,1,0,0,1
10545725,10545847,122,0,0,1,2
10545726,10545845,119,0,0,1,1
10545846,10545875,29,1,0,0,1
10545848,10545867,19,1,0,0,2
10545868,10546827,959,0,0,1,2
10545876,10546828,952,0,0,1,1
10546828,10546919,91,1,0,0,2
10546829,10546918,89,1,0,0,1
10546919,10547094,175,0,0,1,1
10546920,10547096,176,0,0,1,2
10547095,10547140,45,1,0,0,1
10547097,10547140,43,1,0,0,2
10547141,10547220,79,0,0,1,1
10547141,10547220,79,0,0,1,2
10547221,10547340,119,1,0,0,2
10547221,10547417,196,1,0,0,1
10547341,10547378,37,0,0,1,2
10547379,10547413,34,1,0,0,2
10547414,10547557,143,0,0,1,2
10547418,10547557,139,0,0,1,1
10547558,10547580,22,1,0,0,1
10547558,10547581,23,1,0,0,2
10547581,10547655,74,0,0,1,1
10547582,10547655,73,0,0,1,2
10547656,10547678,22,1,0,0,1
10547656,10547678,22,1,0,0,2
10547679,10548367,688,0,0,1,1
10547679,10548368,689,0,0,1,2
10548368,10548458,90,1,0,0,1
10548369,10548457,88,1,0,0,2
10548458,10548834,376,0,0,1,2
10548459,10548836,377,0,0,1,1
10548835,10548881,46,1,0,0,2
10548837,10548880,43,1,0,0,1
10548881,10549044,163,0,0,1,1
10548882,10549044,162,0,0,1,2
10549045,10549064,19,1,0,0,2
10549045,10549067,22,1,0,0,1
10549065,10549456,391,0,0,1,2
10549068,10549451,383,0,0,1,1
10549452,10549811,359,1,0,0,1
10549457,10549813,356,1,0,0,2
10549490,10549758,268,0,1,0,1
10549496,10549775,279,0,1,0,2
10549812,10549837,25,0,0,1,1
10549814,10550378,564,0,0,1,2
10549838,10549843,5,1,0,0,1
10549844,10550379,535,0,0,1,1
10550379,10550457,78,1,0,0,2
10550380,10550454,74,1,0,0,1
10550455,10550518,63,0,0,1,1
10550458,10550516,58,0,0,1,2
10550517,10550542,25,1,0,0,2
10550519,10550552,33,1,0,0,1
10550543,10550710,167,0,0,1,2
10550553,10550713,160,0,0,1,1
10550711,10550729,18,1,0,0,2
10550714,10550727,13,1,0,0,1
10550728,10551696,968,0,0,1,1
10550730,10551696,966,0,0,1,2
10551697,10551803,106,1,0,0,2
10551697,10551812,115,1,0,0,1
10551804,10552146,342,0,0,1,2
10551813,10552145,332,0,0,1,1
10552146,10552205,59,1,0,0,1
10552147,10552206,59,1,0,0,2
10552206,10552311,105,0,0,1,1
10552207,10552308,101,0,0,1,2
10552309,10552330,21,1,0,0,2
10552312,10552330,18,1,0,0,1
10552331,10552419,88,0,0,1,1
10552331,10552421,90,0,0,1,2
10552420,10552434,14,1,0,0,1
10552422,10552433,11,1,0,0,2
10552434,10553213,779,0,0,1,2
10552435,10553216,781,0,0,1,1
10553214,10553436,222,1,0,0,2
10553217,10553417,200,1,0,0,1
10553248,10553368,120,0,1,0,1
10553249,10553354,105,0,1,0,2
10553418,10553683,265,0,0,1,1
10553437,10553683,246,0,0,1,2
10553684,10553754,70,1,0,0,2
10553684,10553760,76,1,0,0,1
10553755,10553852,97,0,0,1,2
10553761,10553853,92,0,0,1,1
10553853,10553882,29,1,0,0,2
10553854,10553879,25,1,0,0,1
10553880,10554008,128,0,0,1,1
10553883,10554004,121,0,0,1,2
10554005,10554024,19,1,0,0,2
10554009,10554024,15,1,0,0,1
10554025,10554257,232,0,0,1,2
10554025,10554926,901,0,0,1,1
10554258,10554268,10,1,0,0,2
10554269,10554926,657,0,0,1,2
10554927,10555025,98,1,0,0,2
10554927,10555028,101,1,0,0,1
10555026,10555206,180,0,0,1,2
10555029,10555209,180,0,0,1,1
10555207,10555256,49,1,0,0,2
10555210,10555257,47,1,0,0,1
10555257,10555362,105,0,0,1,2
10555258,10555362,104,0,0,1,1
10555363,10555383,20,1,0,0,1
10555363,10555383,20,1,0,0,2
10555384,10556155,771,0,0,1,1
10555384,10556160,776,0,0,1,2
10556156,10556430,274,1,0,0,1
10556161,10556428,267,1,0,0,2
10556201,10556350,149,0,1,0,2
10556206,10556351,145,0,1,0,1
10556429,10556550,121,0,0,1,2
10556431,10556548,117,0,0,1,1
10556549,10556648,99,1,0,0,1
10556551,10556645,94,1,0,0,2
10556646,10556766,120,0,0,1,2
10556649,10556765,116,0,0,1,1
10556766,10556786,20,1,0,0,1
10556767,10556786,19,1,0,0,2
10556787,10557548,761,0,0,1,1
10556787,10557549,762,0,0,1,2
10557549,10557610,61,1,0,0,1
10557550,10557610,60,1,0,0,2
10557611,10557961,350,0,0,1,2
10557611,10557962,351,0,0,1,1
10557962,10558028,66,1,0,0,2
10557963,10558028,65,1,0,0,1
10558029,10558103,74,0,0,1,2
10558029,10558104,75,0,0,1,1
10558104,10558127,23,1,0,0,2
10558105,10558127,22,1,0,0,1
10558128,10558211,83,0,0,1,1
10558128,10558215,87,0,0,1,2
10558212,10558229,17,1,0,0,1
10558216,10558230,14,1,0,0,2
10558230,10558889,659,0,0,1,1
10558231,10558893,662,0,0,1,2
10558890,10559126,236,1,0,0,1
10558894,10559152,258,1,0,0,2
10558917,10559075,158,0,1,0,1
10558918,10559073,155,0,1,0,2
10559127,10559371,244,0,0,1,1
10559153,10559372,219,0,0,1,2
10559372,10559429,57,1,0,0,1
10559373,10559433,60,1,0,0,2
10559430,10559589,159,0,0,1,1
10559434,10559587,153,0,0,1,2
10559588,10559599,11,1,0,0,2
10559590,10559595,5,1,0,0,1
10559596,10560593,997,0,0,1,1
10559600,10560594,994,0,0,1,2
10560594,10560644,50,1,0,0,1
10560595,10560644,49,1,0,0,2
10560645,10560812,167,0,0,1,1
10560645,10560812,167,0,0,1,2
10560813,10560879,66,1,0,0,1
10560813,10560889,76,1,0,0,2
10560880,10560939,59,0,0,1,1
10560890,10560938,48,0,0,1,2
10560939,10560964,25,1,0,0,2
10560940,10560963,23,1,0,0,1
10560964,10561022,58,0,0,1,1
10560965,10561020,55,0,0,1,2
10561021,10561048,27,1,0,0,2
10561023,10561048,25,1,0,0,1
10561049,10561334,285,0,0,1,2
10561049,10561339,290,0,0,1,1
10561335,10561351,16,1,0,0,2
10561340,10561350,10,1,0,0,1
10561351,10561812,461,0,0,1,1
10561352,10561807,455,0,0,1,2
10561808,10561895,87,1,0,0,2
10561813,10561895,82,1,0,0,1
10561896,10562180,284,0,0,1,1
10561896,10562180,284,0,0,1,2
10562181,10562245,64,1,0,0,2
10562181,10562355,174,1,0,0,1
10562246,10562314,68,0,0,1,2
10562315,10562348,33,1,0,0,2
10562349,10562482,133,0,0,1,2
10562356,10562481,125,0,0,1,1
10562482,10562502,20,1,0,0,1
10562483,10562502,19,1,0,0,2
10562503,10562845,342,0,0,1,1
10562503,10562873,370,0,0,1,2
10562846,10563378,532,1,0,0,1
10562874,10563003,129,1,0,0,2
10562922,10562971,49,0,1,0,2
10562929,10563072,143,0,1,0,1
10563004,10563026,22,0,0,1,2
10563027,10563360,333,1,0,0,2
10563101,10563341,240,0,1,0,1
10563117,10563312,195,0,1,0,2
10563361,10563491,130,0,0,1,2
10563379,10563492,113,0,0,1,1
10563492,10563539,47,1,0,0,2
10563493,10563540,47,1,0,0,1
10563540,10563570,30,0,0,1,2
10563541,10563569,28,0,0,1,1
10563570,10563634,64,1,0,0,1
10563571,10563631,60,1,0,0,2
10563632,10563731,99,0,0,1,2
10563635,10563732,97,0,0,1,1
10563732,10563764,32,1,0,0,2
10563733,10563765,32,1,0,0,1
10563765,10563850,85,0,0,1,2
10563766,10563852,86,0,0,1,1
10563851,10563878,27,1,0,0,2
10563853,10563941,88,1,0,0,1
10563879,10564463,584,0,0,1,2
10563942,10564078,136,0,0,1,1
10564079,10564090,11,1,0,0,1
10564091,10564146,55,0,0,1,1
10564147,10564201,54,1,0,0,1
10564202,10564316,114,0,0,1,1
10564317,10564358,41,1,0,0,1
10564359,10564516,157,0,0,1,1
10564474,10564831,357,0,1,0,2
10564517,10564874,357,1,0,0,1
10564549,10564838,289,0,1,0,1
10564841,10564842,1,1,0,0,2
10564843,10565039,196,0,0,1,2
10564875,10564896,21,0,0,1,1
10564897,10564911,14,1,0,0,1
10564912,10565040,128,0,0,1,1
10565040,10565113,73,1,0,0,2
10565041,10565112,71,1,0,0,1
10565113,10565180,67,0,0,1,1
10565114,10565178,64,0,0,1,2
10565179,10565214,35,1,0,0,2
10565181,10565220,39,1,0,0,1
10565215,10566141,926,0,0,1,2
10565221,10566122,901,0,0,1,1
10566123,10566494,371,1,0,0,1
10566139,10566462,323,0,1,0,1
10566142,10566456,314,1,0,0,2
10566169,10566414,245,0,1,0,2
10566457,10566588,131,0,0,1,2
10566495,10566587,92,0,0,1,1
10566588,10566634,46,1,0,0,1
10566589,10566632,43,1,0,0,2
10566633,10566787,154,0,0,1,2
10566635,10566791,156,0,0,1,1
10566788,10566805,17,1,0,0,2
10566792,10566824,32,1,0,0,1
10566806,10567931,1125,0,0,1,2
10566825,10567933,1108,0,0,1,1
10567932,10568058,126,1,0,0,2
10567934,10568060,126,1,0,0,1
10568059,10568131,72,0,0,1,2
10568061,10568135,74,0,0,1,1
10568132,10568164,32,1,0,0,2
10568136,10568159,23,1,0,0,1
10568160,10568246,86,0,0,1,1
10568165,10568245,80,0,0,1,2
10568246,10568275,29,1,0,0,2
10568247,10568267,20,1,0,0,1
10568268,10568966,698,0,0,1,1
10568276,10568965,689,0,0,1,2
10568966,10569018,52,1,0,0,2
10568967,10569020,53,1,0,0,1
10569019,10569294,275,0,0,1,2
10569021,10569293,272,0,0,1,1
10569294,10569357,63,1,0,0,1
10569295,10569358,63,1,0,0,2
10569358,10569409,51,0,0,1,1
10569359,10569411,52,0,0,1,2
10569410,10569437,27,1,0,0,1
10569412,10569436,24,1,0,0,2
10569437,10569535,98,0,0,1,2
10569438,10569536,98,0,0,1,1
10569536,10569556,20,1,0,0,2
10569537,10569555,18,1,0,0,1
10569556,10570174,618,0,0,1,1
10569557,10570208,651,0,0,1,2
10570175,10570494,319,1,0,0,1
10570209,10570463,254,1,0,0,2
10570224,10570429,205,0,1,0,1
10570227,10570377,150,0,1,0,2
10570464,10570662,198,0,0,1,2
10570495,10570662,167,0,0,1,1
10570663,10570751,88,1,0,0,2
10570663,10570766,103,1,0,0,1
10570752,10570800,48,0,0,1,2
10570767,10570800,33,0,0,1,1
10570801,10570829,28,1,0,0,1
10570801,10570829,28,1,0,0,2
10570830,10570913,83,0,0,1,2
10570830,10570915,85,0,0,1,1
10570914,10570933,19,1,0,0,2
10570916,10570933,17,1,0,0,1
10570934,10571835,901,0,0,1,1
10570934,10571837,903,0,0,1,2
10571836,10571920,84,1,0,0,1
10571838,10571918,80,1,0,0,2
10571919,10572051,132,0,0,1,2
10571921,10572052,131,0,0,1,1
10572052,10572088,36,1,0,0,2
10572053,10572081,28,1,0,0,1
10572082,10572184,102,0,0,1,1
10572089,10572185,96,0,0,1,2
10572185,10572205,20,1,0,0,1
10572186,10572206,20,1,0,0,2
10572206,10573109,903,0,0,1,1
10572207,10573110,903,0,0,1,2
10573110,10573163,53,1,0,0,1
10573111,10573163,52,1,0,0,2
10573164,10573366,202,0,0,1,2
10573164,10573367,203,0,0,1,1
10573367,10573434,67,1,0,0,2
10573368,10573443,75,1,0,0,1
10573435,10573485,50,0,0,1,2
10573444,10573487,43,0,0,1,1
10573486,10573522,36,1,0,0,2
10573488,10573522,34,1,0,0,1
10573523,10573625,102,0,0,1,2
10573523,10573627,104,0,0,1,1
10573626,10573648,22,1,0,0,2
10573628,10573649,21,1,0,0,1
10573649,10573782,133,0,0,1,2
10573650,10573784,134,0,0,1,1
10573783,10573799,16,1,0,0,2
10573785,10573799,14,1,0,0,1
10573800,10574242,442,0,0,1,1
10573800,10574274,474,0,0,1,2
10574243,10574513,270,1,0,0,1
10574275,10574509,234,1,0,0,2
10574349,10574435,86,0,1,0,2
10574351,10574428,77,0,1,0,1
10574510,10574716,206,0,0,1,2
10574514,10574717,203,0,0,1,1
10574717,10574776,59,1,0,0,2
10574718,10574778,60,1,0,0,1
10574777,10574887,110,0,0,1,2
10574779,10574888,109,0,0,1,1
10574888,10574920,32,1,0,0,2
10574889,10574921,32,1,0,0,1
10574921,10575017,96,0,0,1,2
10574922,10575017,95,0,0,1,1
10575018,10575037,19,1,0,0,1
10575018,10575037,19,1,0,0,2
10575038,10575257,219,0,0,1,1
10575038,10575473,435,0,0,1,2
10575258,10575266,8,1,0,0,1
10575267,10575485,218,0,0,1,1
10575474,10575870,396,1,0,0,2
10575486,10575922,436,1,0,0,1
10575524,10575911,387,0,1,0,1
10575525,10575859,334,0,1,0,2
10575871,10576254,383,0,0,1,2
10575923,10576254,331,0,0,1,1
10576255,10576321,66,1,0,0,2
10576255,10576442,187,1,0,0,1
10576306,10576409,103,0,1,0,1
10576322,10576391,69,0,0,1,2
10576392,10576439,47,1,0,0,2
10576440,10576537,97,0,0,1,2
10576443,10576481,38,0,0,1,1
10576482,10576623,141,1,0,0,1
10576538,10576542,4,1,0,0,2
10576543,10577733,1190,0,0,1,2
10576624,10576701,77,0,0,1,1
10576702,10577009,307,1,0,0,1
10577010,10577057,47,0,0,1,1
10577058,10577164,106,1,0,0,1
10577165,10577726,561,0,0,1,1
10577727,10577861,134,1,0,0,1
10577734,10577856,122,1,0,0,2
10577745,10577757,12,0,1,0,1
10577857,10577931,74,0,0,1,2
10577862,10577930,68,0,0,1,1
10577931,10577963,32,1,0,0,1
10577932,10577964,32,1,0,0,2
10577964,10578040,76,0,0,1,1
10577965,10578040,75,0,0,1,2
10578041,10578063,22,1,0,0,2
10578041,10578071,30,1,0,0,1
10578064,10578218,154,0,0,1,2
10578072,10578220,148,0,0,1,1
10578219,10578237,18,1,0,0,2
10578221,10578238,17,1,0,0,1
10578238,10578922,684,0,0,1,2
10578239,10578922,683,0,0,1,1
10578923,10579004,81,1,0,0,2
10578923,10579005,82,1,0,0,1
10579005,10579146,141,0,0,1,2
10579006,10579149,143,0,0,1,1
10579147,10579231,84,1,0,0,2
10579150,10579231,81,1,0,0,1
10579232,10579299,67,0,0,1,1
10579232,10579299,67,0,0,1,2
10579300,10579324,24,1,0,0,1
10579300,10579331,31,1,0,0,2
10579325,10579509,184,0,0,1,1
10579332,10579509,177,0,0,1,2
10579510,10579525,15,1,0,0,1
10579510,10579525,15,1,0,0,2
10579526,10580197,671,0,0,1,2
10579526,10580199,673,0,0,1,1
10580198,10580476,278,1,0,0,2
10580200,10580491,291,1,0,0,1
10580274,10580382,108,0,1,0,1
10580277,10580397,120,0,1,0,2
10580477,10580673,196,0,0,1,2
10580492,10580672,180,0,0,1,1
10580673,10580728,55,1,0,0,1
10580674,10580729,55,1,0,0,2
10580729,10580822,93,0,0,1,1
10580730,10580821,91,0,0,1,2
10580822,10580844,22,1,0,0,2
10580823,10580844,21,1,0,0,1
10580845,10581711,866,0,0,1,1
10580845,10581720,875,0,0,1,2
10581712,10582036,324,1,0,0,1
10581721,10581972,251,1,0,0,2
10581738,10581926,188,0,1,0,2
10581740,10581963,223,0,1,0,1
10581973,10582204,231,0,0,1,2
10582037,10582204,167,0,0,1,1
10582205,10582261,56,1,0,0,2
10582205,10582274,69,1,0,0,1
10582262,10582340,78,0,0,1,2
10582275,10582331,56,0,0,1,1
10582341,10582363,22,1,0,0,2
10582342,10582393,51,0,1,0,1
10582364,10583592,1228,0,0,1,2
10582403,10582518,115,1,0,0,1
10582429,10582508,79,0,1,0,1
10582519,10582553,34,0,0,1,1
10582564,10583641,1077,0,1,0,1
10583593,10583655,62,1,0,0,2
10583651,10583687,36,1,0,0,1
10583656,10583747,91,0,0,1,2
10583688,10583747,59,0,0,1,1
10583748,10583771,23,1,0,0,1
10583748,10583776,28,1,0,0,2
10583772,10583859,87,0,0,1,1
10583777,10583859,82,0,0,1,2
10583860,10583877,17,1,0,0,1
10583860,10583877,17,1,0,0,2
10583878,10585097,1219,0,0,1,2
10583878,10585098,1220,0,0,1,1
10585098,10585178,80,1,0,0,2
10585099,10585226,127,1,0,0,1
10585179,10585201,22,0,0,1,2
10585202,10585231,29,1,0,0,2
10585227,10585309,82,0,0,1,1
10585232,10585308,76,0,0,1,2
10585309,10585329,20,1,0,0,2
10585310,10585330,20,1,0,0,1
10585330,10586081,751,0,0,1,2
10585331,10586082,751,0,0,1,1
10586082,10586177,95,1,0,0,2
10586083,10586178,95,1,0,0,1
10586178,10586583,405,0,0,1,2
10586179,10586583,404,0,0,1,1
10586584,10586643,59,1,0,0,2
10586584,10586645,61,1,0,0,1
10586644,10587858,1214,0,0,1,2
10586646,10586897,251,0,0,1,1
10586898,10586906,8,1,0,0,1
10586907,10587869,962,0,0,1,1
10587859,10588092,233,1,0,0,2
10587870,10588104,234,1,0,0,1
10587889,10588044,155,0,1,0,1
10587890,10588047,157,0,1,0,2
10588066,10588066,0,0,1,0,1
10588093,10588539,446,0,0,1,2
10588105,10588540,435,0,0,1,1
10588540,10588581,41,1,0,0,2
10588541,10588581,40,1,0,0,1
10588582,10588708,126,0,0,1,2
10588582,10588710,128,0,0,1,1
10588709,10588730,21,1,0,0,2
10588711,10588730,19,1,0,0,1
10588731,10590571,1840,0,0,1,2
10588731,10590576,1845,0,0,1,1
10590572,10590869,297,1,0,0,2
10590577,10590872,295,1,0,0,1
10590600,10590829,229,0,1,0,1
10590601,10590828,227,0,1,0,2
10590870,10590941,71,0,0,1,2
10590873,10590940,67,0,0,1,1
10590941,10591138,197,1,0,0,1
10590942,10591138,196,1,0,0,2
10590964,10591108,144,0,1,0,2
10590967,10591114,147,0,1,0,1
10591139,10592335,1196,0,0,1,1
10591139,10592335,1196,0,0,1,2
10592336,10592398,62,1,0,0,2
10592336,10592410,74,1,0,0,1
10592399,10592513,114,0,0,1,2
10592411,10592514,103,0,0,1,1
10592514,10592535,21,1,0,0,2
10592515,10592536,21,1,0,0,1
10592536,10593708,1172,0,0,1,2
10592537,10593706,1169,0,0,1,1
10593707,10593762,55,1,0,0,1
10593709,10593762,53,1,0,0,2
10593763,10593846,83,0,0,1,1
10593763,10593846,83,0,0,1,2
10593847,10593869,22,1,0,0,2
10593847,10593872,25,1,0,0,1
10593870,10594381,511,0,0,1,2
10593873,10594378,505,0,0,1,1
10594379,10594724,345,1,0,0,1
10594382,10594723,341,1,0,0,2
10594410,10594700,290,0,1,0,1
10594414,10594686,272,0,1,0,2
10594724,10595261,537,0,0,1,2
10594725,10595265,540,0,0,1,1
10595262,10595278,16,1,0,0,2
10595266,10595277,11,1,0,0,1
10595278,10595433,155,0,0,1,1
10595279,10595432,153,0,0,1,2
10595433,10595654,221,1,0,0,2
10595434,10595652,218,1,0,0,1
10595456,10595601,145,0,1,0,2
10595457,10595608,151,0,1,0,1
10595653,10595900,247,0,0,1,1
10595655,10595901,246,0,0,1,2
10595901,10596227,326,1,0,0,1
10595902,10596222,320,1,0,0,2
10595922,10596174,252,0,1,0,2
10595925,10596183,258,0,1,0,1
10596223,10596936,713,0,0,1,2
10596228,10596939,711,0,0,1,1
10596937,10596982,45,1,0,0,2
10596940,10596983,43,1,0,0,1
10596983,10597452,469,0,0,1,2
10596984,10597452,468,0,0,1,1
10597453,10597500,47,1,0,0,1
10597453,10597500,47,1,0,0,2
10597501,10598243,742,0,0,1,1
10597501,10598245,744,0,0,1,2
10598244,10598592,348,1,0,0,1
10598246,10598548,302,1,0,0,2
10598270,10598517,247,0,1,0,1
10598279,10598506,227,0,1,0,2
10598549,10599205,656,0,0,1,2
10598581,10598583,2,0,1,0,1
10598593,10598622,29,0,0,1,1
10598633,10598698,65,0,1,0,1
10598707,10598707,0,1,0,0,1
10598708,10598827,119,0,0,1,1
10598838,10599207,369,0,1,0,1
10599206,10599261,55,1,0,0,2
10599217,10599284,67,1,0,0,1
10599262,10601309,2047,0,0,1,2
10599285,10601289,2004,0,0,1,1
10601290,10601642,352,1,0,0,1
10601310,10601651,341,1,0,0,2
10601328,10601581,253,0,1,0,1
10601330,10601582,252,0,1,0,2
10601643,10603257,1614,0,0,1,1
10601652,10603255,1603,0,0,1,2
10603256,10603397,141,1,0,0,2
10603258,10603345,87,1,0,0,1
10603346,10603371,25,0,0,1,1
10603372,10603421,49,1,0,0,1
10603398,10603461,63,0,0,1,2
10603422,10603461,39,0,0,1,1
10603462,10603492,30,1,0,0,1
10603462,10603492,30,1,0,0,2
10603493,10604896,1403,0,0,1,2
10603493,10604897,1404,0,0,1,1
10604897,10604951,54,1,0,0,2
10604898,10604952,54,1,0,0,1
10604952,10606986,2034,0,0,1,2
10604953,10606975,2022,0,0,1,1
10606976,10607361,385,1,0,0,1
10606987,10607331,344,1,0,0,2
10607023,10607292,269,0,1,0,2
10607024,10607317,293,0,1,0,1
10607332,10607379,47,0,0,1,2
10607362,10607668,306,0,0,1,1
10607380,10607384,4,1,0,0,2
10607385,10607669,284,0,0,1,2
10607669,10607706,37,1,0,0,1
10607670,10607710,40,1,0,0,2
10607707,10608176,469,0,0,1,1
10607711,10608175,464,0,0,1,2
10608176,10608214,38,1,0,0,2
10608177,10608213,36,1,0,0,1
10608214,10608807,593,0,0,1,1
10608215,10608808,593,0,0,1,2
10608808,10608864,56,1,0,0,1
10608809,10608863,54,1,0,0,2
10608864,10608987,123,0,0,1,2
10608865,10608987,122,0,0,1,1
10608988,10609008,20,1,0,0,1
10608988,10609008,20,1,0,0,2
10609009,10610029,1020,0,0,1,2
10609009,10610031,1022,0,0,1,1
10610030,10610083,53,1,0,0,2
10610032,10610087,55,1,0,0,1
10610084,10610271,187,0,0,1,2
10610088,10610276,188,0,0,1,1
10610272,10610292,20,1,0,0,2
10610277,10610294,17,1,0,0,1
10610293,10612086,1793,0,0,1,2
10610295,10612095,1800,0,0,1,1
10612087,10612504,417,1,0,0,2
10612096,10612477,381,1,0,0,1
10612122,10612493,371,0,1,0,2
10612124,10612451,327,0,1,0,1
10612478,10612623,145,0,0,1,1
10612505,10612600,95,0,0,1,2
10612601,10612676,75,1,0,0,2
10612624,10612738,114,1,0,0,1
10612677,10613387,710,0,0,1,2
10612679,10612729,50,0,1,0,1
10612739,10612767,28,0,0,1,1
10612768,10612784,16,1,0,0,1
10612785,10613386,601,0,0,1,1
10613387,10613475,88,1,0,0,1
10613388,10613467,79,1,0,0,2
10613468,10613546,78,0,0,1,2
10613476,10613548,72,0,0,1,1
10613547,10613567,20,1,0,0,2
10613549,10613567,18,1,0,0,1
10613568,10613726,158,0,0,1,1
10613568,10613727,159,0,0,1,2
10613727,10613745,18,1,0,0,1
10613728,10613744,16,1,0,0,2
10613745,10614784,1039,0,0,1,2
10613746,10614784,1038,0,0,1,1
10614785,10614837,52,1,0,0,1
10614785,10614837,52,1,0,0,2
10614838,10615013,175,0,0,1,1
10614838,10615015,177,0,0,1,2
10615014,10615038,24,1,0,0,1
10615016,10615035,19,1,0,0,2
10615036,10616365,1329,0,0,1,2
10615039,10616354,1315,0,0,1,1
10616355,10616460,105,1,0,0,1
10616366,10616420,54,1,0,0,2
10616421,10616672,251,0,0,1,2
10616461,10616664,203,0,0,1,1
10616665,10616925,260,1,0,0,1
10616673,10616919,246,1,0,0,2
10616691,10616877,186,0,1,0,2
10616691,10616897,206,0,1,0,1
10616920,10617028,108,0,0,1,2
10616926,10617006,80,0,0,1,1
10617007,10617219,212,1,0,0,1
10617029,10617213,184,1,0,0,2
10617047,10617177,130,0,1,0,2
10617047,10617189,142,0,1,0,1
10617214,10618271,1057,0,0,1,2
10617220,10618272,1052,0,0,1,1
10618272,10618340,68,1,0,0,2
10618273,10618351,78,1,0,0,1
10618341,10618436,95,0,0,1,2
10618352,10618435,83,0,0,1,1
10618436,10618458,22,1,0,0,1
10618437,10618459,22,1,0,0,2
10618459,10619141,682,0,0,1,1
10618460,10619151,691,0,0,1,2
10619142,10619523,381,1,0,0,1
10619152,10619404,252,1,0,0,2
10619171,10619354,183,0,1,0,2
10619171,10619362,191,0,1,0,1
10619405,10619742,337,0,0,1,2
10619524,10619742,218,0,0,1,1
10619743,10619803,60,1,0,0,2
10619743,10619820,77,1,0,0,1
10619804,10620844,1040,0,0,1,2
10619821,10619884,63,0,0,1,1
10619885,10619925,40,1,0,0,1
10619926,10620830,904,0,0,1,1
10620831,10621209,378,1,0,0,1
10620845,10621122,277,1,0,0,2
10620862,10621031,169,0,1,0,2
10620863,10621042,179,0,1,0,1
10621123,10621879,756,0,0,1,2
10621210,10621862,652,0,0,1,1
10621863,10622187,324,1,0,0,1
10621880,10622168,288,1,0,0,2
10621901,10622146,245,0,1,0,2
10621901,10622166,265,0,1,0,1
10622169,10623437,1268,0,0,1,2
10622188,10623437,1249,0,0,1,1
10623438,10623514,76,1,0,0,2
10623438,10623523,85,1,0,0,1
10623515,10623619,104,0,0,1,2
10623524,10623621,97,0,0,1,1
10623620,10623652,32,1,0,0,2
10623622,10623653,31,1,0,0,1
10623653,10623718,65,0,0,1,2
10623654,10623719,65,0,0,1,1
10623719,10623747,28,1,0,0,2
10623720,10623746,26,1,0,0,1
10623747,10624876,1129,0,0,1,1
10623748,10624874,1126,0,0,1,2
10624875,10624928,53,1,0,0,2
10624877,10624927,50,1,0,0,1
10624928,10625877,949,0,0,1,1
10624929,10625875,946,0,0,1,2
10625876,10626194,318,1,0,0,2
10625878,10626197,319,1,0,0,1
10625916,10626051,135,0,1,0,2
10625917,10626041,124,0,1,0,1
10626195,10626940,745,0,0,1,2
10626198,10626939,741,0,0,1,1
10626940,10627281,341,1,0,0,1
10626941,10627272,331,1,0,0,2
10627009,10627201,192,0,1,0,2
10627013,10627258,245,0,1,0,1
10627223,10627228,5,0,1,0,2
10627273,10628145,872,0,0,1,2
10627282,10628144,862,0,0,1,1
10628145,10628223,78,1,0,0,1
10628146,10628209,63,1,0,0,2
10628210,10628388,178,0,0,1,2
10628224,10628390,166,0,0,1,1
10628389,10628468,79,1,0,0,2
10628391,10628475,84,1,0,0,1
10628469,10628552,83,0,0,1,2
10628476,10628554,78,0,0,1,1
10628553,10628584,31,1,0,0,2
10628555,10628577,22,1,0,0,1
10628578,10628620,42,0,0,1,1
10628585,10628620,35,0,0,1,2
10628621,10628642,21,1,0,0,2
10628621,10628649,28,1,0,0,1
10628643,10628851,208,0,0,1,2
10628650,10628853,203,0,0,1,1
10628852,10628866,14,1,0,0,2
10628854,10628865,11,1,0,0,1
10628866,10629592,726,0,0,1,1
10628867,10629567,700,0,0,1,2
10629568,10629573,5,1,0,0,2
10629574,10629594,20,0,0,1,2
10629593,10629685,92,1,0,0,1
10629595,10629692,97,1,0,0,2
10629686,10629981,295,0,0,1,1
10629693,10629981,288,0,0,1,2
10629982,10630034,52,1,0,0,2
10629982,10630037,55,1,0,0,1
10630035,10630416,381,0,0,1,2
10630038,10630416,378,0,0,1,1
10630417,10630458,41,1,0,0,1
10630417,10630458,41,1,0,0,2
10630459,10631003,544,0,0,1,2
10630459,10631004,545,0,0,1,1
10631004,10631022,18,1,0,0,2
10631005,10631023,18,1,0,0,1
10631023,10632506,1483,0,0,1,2
10631024,10632482,1458,0,0,1,1
10632483,10633009,526,1,0,0,1
10632507,10633013,506,1,0,0,2
10632526,10632678,152,0,1,0,1
10632539,10632654,115,0,1,0,2
10632804,10632943,139,0,1,0,1
10632808,10632941,133,0,1,0,2
10633010,10634438,1428,0,0,1,1
10633014,10634438,1424,0,0,1,2
10634439,10634487,48,1,0,0,2
10634439,10634488,49,1,0,0,1
10634488,10634608,120,0,0,1,2
10634489,10634611,122,0,0,1,1
10634609,10634621,12,1,0,0,2
10634612,10634621,9,1,0,0,1
10634622,10635024,402,0,0,1,2
10634622,10635034,412,0,0,1,1
10635025,10635246,221,1,0,0,2
10635035,10635232,197,1,0,0,1
10635056,10635167,111,0,1,0,2
10635057,10635191,134,0,1,0,1
10635233,10635359,126,0,0,1,1
10635247,10635358,111,0,0,1,2
10635359,10635372,13,1,0,0,2
10635360,10635366,6,1,0,0,1
10635367,10635570,203,0,0,1,1
10635373,10635570,197,0,0,1,2
10635571,10635609,38,1,0,0,1
10635571,10635610,39,1,0,0,2
10635610,10637123,1513,0,0,1,1
10635611,10637131,1520,0,0,1,2
10637124,10637376,252,1,0,0,1
10637132,10637378,246,1,0,0,2
10637149,10637344,195,0,1,0,1
10637151,10637307,156,0,1,0,2
10637377,10637832,455,0,0,1,1
10637379,10637832,453,0,0,1,2
10637833,10637881,48,1,0,0,2
10637833,10637883,50,1,0,0,1
10637882,10637928,46,0,0,1,2
10637884,10637933,49,0,0,1,1
10637929,10638182,253,1,0,0,2
10637934,10638158,224,1,0,0,1
10637964,10638112,148,0,1,0,2
10637964,10638117,153,0,1,0,1
10638159,10638801,642,0,0,1,1
10638183,10638802,619,0,0,1,2
10638802,10638874,72,1,0,0,1
10638803,10638857,54,1,0,0,2
10638858,10639004,146,0,0,1,2
10638875,10639005,130,0,0,1,1
10639005,10639023,18,1,0,0,2
10639006,10639022,16,1,0,0,1
10639023,10639187,164,0,0,1,1
10639024,10639188,164,0,0,1,2
10639188,10639205,17,1,0,0,1
10639189,10639204,15,1,0,0,2
10639205,10639736,531,0,0,1,2
10639206,10639721,515,0,0,1,1
10639722,10640001,279,1,0,0,1
10639737,10639948,211,1,0,0,2
10639755,10639935,180,0,1,0,1
10639756,10639887,131,0,1,0,2
10639949,10640698,749,0,0,1,2
10640002,10640699,697,0,0,1,1
10640699,10640737,38,1,0,0,2
10640700,10640739,39,1,0,0,1
10640738,10640882,144,0,0,1,2
10640740,10640881,141,0,0,1,1
10640882,10640904,22,1,0,0,1
10640883,10640903,20,1,0,0,2
10640904,10641932,1028,0,0,1,2
10640905,10641920,1015,0,0,1,1
10641921,10642225,304,1,0,0,1
10641933,10642195,262,1,0,0,2
10641952,10642194,242,0,1,0,1
10641954,10642144,190,0,1,0,2
10642196,10642768,572,0,0,1,2
10642226,10642608,382,0,0,1,1
10642609,10642697,88,1,0,0,1
10642698,10642738,40,0,0,1,1
10642739,10643084,345,1,0,0,1
10642769,10643030,261,1,0,0,2
10642787,10643040,253,0,1,0,1
10642791,10642988,197,0,1,0,2
10643031,10643509,478,0,0,1,2
10643085,10643511,426,0,0,1,1
10643510,10643558,48,1,0,0,2
10643512,10643559,47,1,0,0,1
10643559,10644753,1194,0,0,1,2
10643560,10644752,1192,0,0,1,1
10644753,10644847,94,1,0,0,1
10644754,10644814,60,1,0,0,2
10644815,10644901,86,0,0,1,2
10644848,10644898,50,0,0,1,1
10644899,10644920,21,1,0,0,1
10644902,10644922,20,1,0,0,2
10644921,10644993,72,0,0,1,1
10644923,10644993,70,0,0,1,2
10644994,10645001,7,1,0,0,2
10644994,10645006,12,1,0,0,1
10645002,10646195,1193,0,0,1,2
10645007,10646195,1188,0,0,1,1
10646196,10646237,41,1,0,0,2
10646196,10646240,44,1,0,0,1
10646238,10647453,1215,0,0,1,2
10646241,10647441,1200,0,0,1,1
10647442,10647750,308,1,0,0,1
10647454,10647709,255,1,0,0,2
10647472,10647702,230,0,1,0,1
10647474,10647659,185,0,1,0,2
10647710,10648444,734,0,0,1,2
10647751,10648076,325,0,0,1,1
10648077,10648127,50,1,0,0,1
10648128,10648445,317,0,0,1,1
10648445,10648482,37,1,0,0,2
10648446,10648482,36,1,0,0,1
10648483,10648884,401,0,0,1,1
10648483,10648888,405,0,0,1,2
10648885,10649118,233,1,0,0,1
10648889,10649092,203,1,0,0,2
10648907,10649053,146,0,1,0,2
10648908,10649069,161,0,1,0,1
10649093,10649592,499,0,0,1,2
10649119,10649594,475,0,0,1,1
10649593,10649630,37,1,0,0,2
10649595,10649630,35,1,0,0,1
10649631,10649882,251,0,0,1,1
10649631,10649882,251,0,0,1,2
10649883,10649941,58,1,0,0,2
10649883,10649942,59,1,0,0,1
10649942,10650058,116,0,0,1,2
10649943,10650056,113,0,0,1,1
10650057,10650077,20,1,0,0,1
10650059,10650078,19,1,0,0,2
10650078,10650175,97,0,0,1,1
10650079,10650176,97,0,0,1,2
10650176,10650188,12,1,0,0,1
10650177,10650188,11,1,0,0,2
10650189,10650877,688,0,0,1,1
10650189,10651005,816,0,0,1,2
10650878,10650897,19,1,0,0,1
10650898,10651002,104,0,0,1,1
10651003,10651053,50,1,0,0,1
10651006,10651053,47,1,0,0,2
10651054,10651198,144,0,0,1,1
10651054,10651291,237,0,0,1,2
10651199,10651314,115,1,0,0,1
10651292,10651310,18,1,0,0,2
10651311,10652827,1516,0,0,1,2
10651315,10652828,1513,0,0,1,1
10652828,10653124,296,1,0,0,2
10652829,10653233,404,1,0,0,1
10652851,10653208,357,0,1,0,1
10652857,10653113,256,0,1,0,2
10653125,10653680,555,0,0,1,2
10653234,10653677,443,0,0,1,1
10653678,10653726,48,1,0,0,1
10653681,10653727,46,1,0,0,2
10653727,10654019,292,0,0,1,1
10653728,10654018,290,0,0,1,2
10654019,10654064,45,1,0,0,2
10654020,10654063,43,1,0,0,1
10654064,10654304,240,0,0,1,1
10654065,10654303,238,0,0,1,2
10654304,10654368,64,1,0,0,2
10654305,10654375,70,1,0,0,1
10654369,10654475,106,0,0,1,2
10654376,10654403,27,0,0,1,1
10654404,10654449,45,1,0,0,1
10654450,10654479,29,0,0,1,1
10654476,10654506,30,1,0,0,2
10654480,10654535,55,1,0,0,1
10654507,10655212,705,0,0,1,2
10654536,10654559,23,0,0,1,1
10654560,10654616,56,1,0,0,1
10654617,10654642,25,0,0,1,1
10654643,10654671,28,1,0,0,1
10654672,10654763,91,0,0,1,1
10654764,10656092,1328,1,0,0,1
10655213,10655228,15,1,0,0,2
10655229,10655279,50,0,0,1,2
10655280,10655297,17,1,0,0,2
10655298,10656167,869,0,0,1,2
10656093,10656144,51,0,0,1,1
10656145,10656208,63,1,0,0,1
10656168,10656209,41,1,0,0,2
10656209,10658199,1990,0,0,1,1
10656210,10656403,193,0,0,1,2
10656404,10656416,12,1,0,0,2
10656417,10656451,34,0,0,1,2
10656452,10656494,42,1,0,0,2
10656495,10656522,27,0,0,1,2
10656523,10656598,75,1,0,0,2
10656599,10656661,62,0,0,1,2
10656662,10656676,14,1,0,0,2
10656677,10656712,35,0,0,1,2
10656713,10656871,158,1,0,0,2
10656872,10656987,115,0,0,1,2
10656988,10656997,9,1,0,0,2
10656998,10657115,117,0,0,1,2
10657116,10657129,13,1,0,0,2
10657130,10657818,688,0,0,1,2
10657819,10657855,36,1,0,0,2
10657856,10658195,339,0,0,1,2
10658196,10658612,416,1,0,0,2
10658200,10658521,321,1,0,0,1
10658228,10658462,234,0,1,0,1
10658229,10658479,250,0,1,0,2
10658522,10658642,120,0,0,1,1
10658613,10658642,29,0,0,1,2
10658643,10658688,45,1,0,0,1
10658643,10658688,45,1,0,0,2
10658689,10659588,899,0,0,1,1
10658689,10659589,900,0,0,1,2
10659589,10659638,49,1,0,0,1
10659590,10659639,49,1,0,0,2
10659639,10660224,585,0,0,1,1
10659640,10660226,586,0,0,1,2
10660225,10660289,64,1,0,0,1
10660227,10660272,45,1,0,0,2
10660273,10660429,156,0,0,1,2
10660290,10660436,146,0,0,1,1
10660430,10660447,17,1,0,0,2
10660437,10660448,11,1,0,0,1
10660448,10661159,711,0,0,1,2
10660449,10661139,690,0,0,1,1
10661140,10661406,266,1,0,0,1
10661160,10661390,230,1,0,0,2
10661176,10661322,146,0,1,0,1
10661179,10661314,135,0,1,0,2
10661391,10661627,236,0,0,1,2
10661407,10661627,220,0,0,1,1
10661628,10661675,47,1,0,0,2
10661628,10661677,49,1,0,0,1
10661676,10661849,173,0,0,1,2
10661678,10661850,172,0,0,1,1
10661850,10661870,20,1,0,0,2
10661851,10661890,39,1,0,0,1
10661871,10663688,1817,0,0,1,2
10661891,10663668,1777,0,0,1,1
10663669,10664078,409,1,0,0,1
10663689,10664018,329,1,0,0,2
10663707,10663995,288,0,1,0,2
10663709,10664041,332,0,1,0,1
10664019,10665130,1111,0,0,1,2
10664079,10664117,38,0,0,1,1
10664118,10664162,44,1,0,0,1
10664163,10664190,27,0,0,1,1
10664191,10664264,73,1,0,0,1
10664265,10664297,32,0,0,1,1
10664298,10664328,30,1,0,0,1
10664329,10665128,799,0,0,1,1
10665129,10665202,73,1,0,0,1
10665131,10665195,64,1,0,0,2
10665196,10665230,34,0,0,1,2
10665203,10665229,26,0,0,1,1
10665230,10665256,26,1,0,0,1
10665231,10665257,26,1,0,0,2
10665257,10666696,1439,0,0,1,1
10665258,10666694,1436,0,0,1,2
10666695,10666739,44,1,0,0,2
10666697,10666738,41,1,0,0,1
10666739,10666921,182,0,0,1,1
10666740,10666925,185,0,0,1,2
10666922,10666943,21,1,0,0,1
10666926,10666943,17,1,0,0,2
10666944,10667148,204,0,0,1,1
10666944,10667151,207,0,0,1,2
10667149,10667164,15,1,0,0,1
10667152,10667161,9,1,0,0,2
10667162,10668338,1176,0,0,1,2
10667165,10668334,1169,0,0,1,1
10668335,10668528,193,1,0,0,1
10668339,10668548,209,1,0,0,2
10668365,10668478,113,0,1,0,2
10668365,10668481,116,0,1,0,1
10668529,10669001,472,0,0,1,1
10668549,10668999,450,0,0,1,2
10669000,10669056,56,1,0,0,2
10669002,10669056,54,1,0,0,1
10669057,10670486,1429,0,0,1,2
10669057,10670487,1430,0,0,1,1
10670487,10670550,63,1,0,0,2
10670488,10670552,64,1,0,0,1
10670551,10670599,48,0,0,1,2
10670553,10670599,46,0,0,1,1
10670600,10670623,23,1,0,0,1
10670600,10670633,33,1,0,0,2
10670624,10670682,58,0,0,1,1
10670634,10670681,47,0,0,1,2
10670682,10670712,30,1,0,0,2
10670683,10670710,27,1,0,0,1
10670711,10670777,66,0,0,1,1
10670713,10670775,62,0,0,1,2
10670776,10670795,19,1,0,0,2
10670778,10670796,18,1,0,0,1
10670796,10670962,166,0,0,1,2
10670797,10670962,165,0,0,1,1
10670963,10670979,16,1,0,0,1
10670963,10670979,16,1,0,0,2
10670980,10672210,1230,0,0,1,1
10670980,10672211,1231,0,0,1,2
10672211,10672255,44,1,0,0,1
10672212,10672254,42,1,0,0,2
10672255,10672415,160,0,0,1,2
10672256,10672415,159,0,0,1,1
10672416,10672438,22,1,0,0,1
10672416,10672439,23,1,0,0,2
10672439,10673320,881,0,0,1,1
10672440,10673334,894,0,0,1,2
10673321,10673569,248,1,0,0,1
10673335,10673581,246,1,0,0,2
10673370,10673479,109,0,1,0,1
10673372,10673474,102,0,1,0,2
10673570,10674503,933,0,0,1,1
10673582,10674503,921,0,0,1,2
10674504,10674562,58,1,0,0,2
10674504,10674565,61,1,0,0,1
10674563,10674624,61,0,0,1,2
10674566,10674624,58,0,0,1,1
10674625,10674896,271,1,0,0,1
10674625,10674902,277,1,0,0,2
10674647,10674821,174,0,1,0,1
10674649,10674817,168,0,1,0,2
10674897,10675358,461,0,0,1,1
10674903,10675358,455,0,0,1,2
10675359,10675401,42,1,0,0,1
10675359,10675401,42,1,0,0,2
10675402,10676159,757,0,0,1,1
10675402,10676159,757,0,0,1,2
10676160,10676212,52,1,0,0,2
10676160,10676235,75,1,0,0,1
10676213,10676380,167,0,0,1,2
10676236,10676374,138,0,0,1,1
10676375,10676398,23,1,0,0,1
10676381,10676392,11,1,0,0,2
10676393,10677347,954,0,0,1,2
10676399,10677348,949,0,0,1,1
10677348,10677398,50,1,0,0,2
10677349,10677401,52,1,0,0,1
10677399,10677800,401,0,0,1,2
10677402,10677802,400,0,0,1,1
10677801,10677817,16,1,0,0,2
10677803,10677814,11,1,0,0,1
10677815,10679441,1626,0,0,1,1
10677818,10679445,1627,0,0,1,2
10679442,10679695,253,1,0,0,1
10679446,10679667,221,1,0,0,2
10679477,10679637,160,0,1,0,1
10679480,10679614,134,0,1,0,2
10679668,10680982,1314,0,0,1,2
10679696,10680983,1287,0,0,1,1
10680983,10681051,68,1,0,0,2
10680984,10681051,67,1,0,0,1
10681052,10681162,110,0,0,1,2
10681052,10681163,111,0,0,1,1
10681163,10681192,29,1,0,0,2
10681164,10681186,22,1,0,0,1
10681187,10681249,62,0,0,1,1
10681193,10681249,56,0,0,1,2
10681250,10681280,30,1,0,0,2
10681250,10681283,33,1,0,0,1
10681281,10682190,909,0,0,1,2
10681284,10682191,907,0,0,1,1
10682191,10682245,54,1,0,0,2
10682192,10682256,64,1,0,0,1
10682246,10682424,178,0,0,1,2
10682257,10682425,168,0,0,1,1
10682425,10682448,23,1,0,0,2
10682426,10682445,19,1,0,0,1
10682446,10684701,2255,0,0,1,1
10682449,10684698,2249,0,0,1,2
10684699,10685033,334,1,0,0,2
10684702,10685026,324,1,0,0,1
10684746,10684787,41,0,1,0,1
10684850,10684966,116,0,1,0,1
10684850,10684974,124,0,1,0,2
10685027,10685556,529,0,0,1,1
10685034,10685554,520,0,0,1,2
10685555,10685608,53,1,0,0,2
10685557,10685615,58,1,0,0,1
10685609,10685713,104,0,0,1,2
10685616,10685714,98,0,0,1,1
10685714,10685745,31,1,0,0,2
10685715,10685745,30,1,0,0,1
10685746,10685826,80,0,0,1,2
10685746,10685831,85,0,0,1,1
10685827,10685853,26,1,0,0,2
10685832,10685844,12,1,0,0,1
10685845,10687135,1290,0,0,1,1
10685854,10687135,1281,0,0,1,2
10687136,10687175,39,1,0,0,2
10687136,10687177,41,1,0,0,1
10687176,10687398,222,0,0,1,2
10687178,10687400,222,0,0,1,1
10687399,10687417,18,1,0,0,2
10687401,10687418,17,1,0,0,1
10687418,10689261,1843,0,0,1,2
10687419,10689261,1842,0,0,1,1
10689262,10689832,570,1,0,0,2
10689262,10689851,589,1,0,0,1
10689365,10689566,201,0,1,0,2
10689416,10689555,139,0,1,0,1
10689659,10689804,145,0,1,0,2
10689665,10689806,141,0,1,0,1
10689833,10690937,1104,0,0,1,2
10689852,10690936,1084,0,0,1,1
10690937,10690994,57,1,0,0,1
10690938,10690996,58,1,0,0,2
10690995,10691117,122,0,0,1,1
10690997,10691116,119,0,0,1,2
10691117,10691149,32,1,0,0,2
10691118,10691140,22,1,0,0,1
10691141,10691224,83,0,0,1,1
10691150,10691219,69,0,0,1,2
10691220,10691240,20,1,0,0,2
10691225,10691238,13,1,0,0,1
10691239,10692167,928,0,0,1,1
10691241,10692167,926,0,0,1,2
10692168,10692220,52,1,0,0,2
10692168,10692228,60,1,0,0,1
10692221,10692452,231,0,0,1,2
10692229,10692457,228,0,0,1,1
10692453,10692472,19,1,0,0,2
10692458,10692474,16,1,0,0,1
10692473,10693451,978,0,0,1,2
10692475,10693440,965,0,0,1,1
10693441,10693683,242,1,0,0,1
10693452,10693650,198,1,0,0,2
10693476,10693583,107,0,1,0,2
10693476,10693614,138,0,1,0,1
10693651,10694347,696,0,0,1,2
10693684,10694342,658,0,0,1,1
10694343,10694660,317,1,0,0,1
10694348,10694665,317,1,0,0,2
10694371,10694601,230,0,1,0,1
10694373,10694591,218,0,1,0,2
10694661,10695594,933,0,0,1,1
10694666,10695593,927,0,0,1,2
10695594,10695631,37,1,0,0,2
10695595,10695631,36,1,0,0,1
10695632,10695776,144,0,0,1,2
10695632,10696596,964,0,0,1,1
10695777,10695781,4,1,0,0,2
10695782,10696603,821,0,0,1,2
10696597,10696747,150,1,0,0,1
10696604,10696737,133,1,0,0,2
10696631,10696662,31,0,1,0,2
10696637,10696656,19,0,1,0,1
10696738,10697271,533,0,0,1,2
10696748,10697271,523,0,0,1,1
10697272,10697559,287,1,0,0,1
10697272,10697567,295,1,0,0,2
10697301,10697502,201,0,1,0,2
10697305,10697507,202,0,1,0,1
10697560,10697699,139,0,0,1,1
10697568,10697698,130,0,0,1,2
10697699,10697718,19,1,0,0,2
10697700,10697719,19,1,0,0,1
10697719,10699269,1550,0,0,1,2
10697720,10699266,1546,0,0,1,1
10699267,10699581,314,1,0,0,1
10699270,10699545,275,1,0,0,2
10699297,10699493,196,0,1,0,2
10699297,10699546,249,0,1,0,1
10699546,10699566,20,0,0,1,2
10699567,10699572,5,1,0,0,2
10699573,10699770,197,0,0,1,2
10699582,10699611,29,0,0,1,1
10699612,10699646,34,1,0,0,1
10699647,10699774,127,0,0,1,1
10699771,10700057,286,1,0,0,2
10699775,10700028,253,1,0,0,1
10699805,10699961,156,0,1,0,1
10699805,10699971,166,0,1,0,2
10700029,10701056,1027,0,0,1,1
10700058,10701058,1000,0,0,1,2
10701057,10701124,67,1,0,0,1
10701059,10701116,57,1,0,0,2
10701117,10701225,108,0,0,1,2
10701125,10701225,100,0,0,1,1
10701226,10701247,21,1,0,0,2
10701226,10701253,27,1,0,0,1
10701248,10701317,69,0,0,1,2
10701254,10701323,69,0,0,1,1
10701318,10701336,18,1,0,0,2
10701324,10701335,11,1,0,0,1
10701336,10701906,570,0,0,1,1
10701337,10701907,570,0,0,1,2
10701907,10702153,246,1,0,0,1
10701908,10702107,199,1,0,0,2
10701936,10702032,96,0,1,0,1
10701938,10702027,89,0,1,0,2
10702108,10702266,158,0,0,1,2
10702154,10702265,111,0,0,1,1
10702266,10702289,23,1,0,0,1
10702267,10702287,20,1,0,0,2
10702288,10702500,212,0,0,1,2
10702290,10702745,455,0,0,1,1
10702501,10702514,13,1,0,0,2
10702515,10702747,232,0,0,1,2
10702746,10702799,53,1,0,0,1
10702748,10702805,57,1,0,0,2
10702800,10703019,219,0,0,1,1
10702806,10703019,213,0,0,1,2
10703020,10703043,23,1,0,0,2
10703020,10703044,24,1,0,0,1
10703044,10703866,822,0,0,1,2
10703045,10703808,763,0,0,1,1
10703809,10703918,109,1,0,0,1
10703867,10703883,16,1,0,0,2
10703884,10704326,442,0,0,1,2
10703919,10704315,396,0,0,1,1
10704316,10704591,275,1,0,0,1
10704327,10704572,245,1,0,0,2
10704352,10704506,154,0,1,0,1
10704355,10704477,122,0,1,0,2
10704573,10704810,237,0,0,1,2
10704592,10704802,210,0,0,1,1
10704803,10705207,404,1,0,0,1
10704811,10705203,392,1,0,0,2
10704840,10705174,334,0,1,0,2
10704840,10705196,356,0,1,0,1
10705204,10705433,229,0,0,1,2
10705208,10705428,220,0,0,1,1
10705429,10705740,311,1,0,0,1
10705434,10705731,297,1,0,0,2
10705450,10705686,236,0,1,0,2
10705451,10705697,246,0,1,0,1
10705732,10706671,939,0,0,1,2
10705741,10706671,930,0,0,1,1
10706672,10706727,55,1,0,0,1
10706672,10706729,57,1,0,0,2
10706728,10706837,109,0,0,1,1
10706730,10706835,105,0,0,1,2
10706836,10706859,23,1,0,0,2
10706838,10706860,22,1,0,0,1
10706860,10706957,97,0,0,1,2
10706861,10706962,101,0,0,1,1
10706958,10706975,17,1,0,0,2
10706963,10706974,11,1,0,0,1
10706975,10707449,474,0,0,1,1
10706976,10707461,485,0,0,1,2
10707450,10707920,470,1,0,0,1
10707462,10707745,283,1,0,0,2
10707483,10707891,408,0,1,0,1
10707485,10707724,239,0,1,0,2
10707746,10707836,90,0,0,1,2
10707837,10707883,46,1,0,0,2
10707884,10708514,630,0,0,1,2
10707921,10708514,593,0,0,1,1
10708515,10708519,4,1,0,0,1
10708515,10708520,5,1,0,0,2
10708520,10708908,388,0,0,1,1
10708521,10708927,406,0,0,1,2
10708909,10709273,364,1,0,0,1
10708928,10709269,341,1,0,0,2
10708942,10709202,260,0,1,0,1
10708944,10709203,259,0,1,0,2
10709270,10709557,287,0,0,1,2
10709274,10709539,265,0,0,1,1
10709540,10709877,337,1,0,0,1
10709558,10709846,288,1,0,0,2
10709583,10709804,221,0,1,0,1
10709588,10709789,201,0,1,0,2
10709814,10709819,5,0,1,0,2
10709847,10711264,1417,0,0,1,2
10709878,10711264,1386,0,0,1,1
10711265,10711316,51,1,0,0,1
10711265,10711316,51,1,0,0,2
10711317,10711491,174,0,0,1,1
10711317,10711491,174,0,0,1,2
10711492,10711505,13,1,0,0,1
10711492,10711507,15,1,0,0,2
10711506,10712785,1279,0,0,1,1
10711508,10712800,1292,0,0,1,2
10712786,10712929,143,1,0,0,1
10712800,10712804,4,0,1,0,1
10712801,10712942,141,1,0,0,2
10712827,10712880,53,0,1,0,1
10712831,10712869,38,0,1,0,2
10712903,10712918,15,0,1,0,1
10712930,10713061,131,0,0,1,1
10712943,10713059,116,0,0,1,2
10713060,10713082,22,1,0,0,2
10713062,10713090,28,1,0,0,1
10713083,10713239,156,0,0,1,2
10713091,10713239,148,0,0,1,1
10713240,10713582,342,1,0,0,2
10713250,10713524,274,0,1,0,1
10713272,10713522,250,0,1,0,2
10713534,10713577,43,1,0,0,1
10713545,10713557,12,0,1,0,1
10713578,10714868,1290,0,0,1,1
10713583,10713635,52,0,0,1,2
10713636,10713640,4,1,0,0,2
10713641,10714872,1231,0,0,1,2
10714869,10715450,581,1,0,0,1
10714873,10715439,566,1,0,0,2
10714906,10715439,533,0,1,0,1
10714909,10715391,482,0,1,0,2
10715440,10716632,1192,0,0,1,2
10715451,10716630,1179,0,0,1,1
10716631,10716721,90,1,0,0,1
10716633,10716724,91,1,0,0,2
10716722,10716783,61,0,0,1,1
10716725,10716783,58,0,0,1,2
10716784,10716808,24,1,0,0,2
10716784,10716809,25,1,0,0,1
10716809,10716851,42,0,0,1,2
10716810,10716851,41,0,0,1,1
10716852,10716881,29,1,0,0,1
10716852,10716881,29,1,0,0,2
10716882,10717930,1048,0,0,1,2
10716882,10717933,1051,0,0,1,1
10717931,10717982,51,1,0,0,2
10717934,10717982,48,1,0,0,1
10717983,10718072,89,0,0,1,2
10717983,10718074,91,0,0,1,1
10718073,10718095,22,1,0,0,2
10718075,10718094,19,1,0,0,1
10718095,10720015,1920,0,0,1,1
10718096,10720035,1939,0,0,1,2
10720016,10720490,474,1,0,0,1
10720036,10720469,433,1,0,0,2
10720061,10720432,371,0,1,0,2
10720062,10720448,386,0,1,0,1
10720470,10720616,146,0,0,1,2
10720491,10720613,122,0,0,1,1
10720614,10721032,418,1,0,0,1
10720617,10721057,440,1,0,0,2
10720646,10721022,376,0,1,0,1
10720649,10720983,334,0,1,0,2
10721033,10721063,30,0,0,1,1
10721058,10721149,91,0,0,1,2
10721064,10721072,8,1,0,0,1
10721073,10721149,76,0,0,1,1
10721150,10721210,60,1,0,0,2
10721150,10721225,75,1,0,0,1
10721211,10721493,282,0,0,1,2
10721226,10721493,267,0,0,1,1
10721494,10721546,52,1,0,0,1
10721494,10721546,52,1,0,0,2
10721547,10721667,120,0,0,1,2
10721547,10721671,124,0,0,1,1
10721668,10721689,21,1,0,0,2
10721672,10721691,19,1,0,0,1
10721690,10723176,1486,0,0,1,2
10721692,10723178,1486,0,0,1,1
10723177,10723223,46,1,0,0,2
10723179,10723220,41,1,0,0,1
10723221,10723423,202,0,0,1,1
10723224,10723424,200,0,0,1,2
10723424,10723446,22,1,0,0,1
10723425,10723445,20,1,0,0,2
10723446,10725299,1853,0,0,1,2
10723447,10725293,1846,0,0,1,1
10725294,10725627,333,1,0,0,1
10725300,10725628,328,1,0,0,2
10725318,10725555,237,0,1,0,2
10725322,10725554,232,0,1,0,1
10725628,10725678,50,0,0,1,1
10725629,10725684,55,0,0,1,2
10725679,10726016,337,1,0,0,1
10725685,10726014,329,1,0,0,2
10725708,10725968,260,0,1,0,2
10725709,10725948,239,0,1,0,1
10726015,10727245,1230,0,0,1,2
10726017,10727244,1227,0,0,1,1
10727245,10727311,66,1,0,0,1
10727246,10727311,65,1,0,0,2
10727312,10727398,86,0,0,1,2
10727312,10727403,91,0,0,1,1
10727399,10727420,21,1,0,0,2
10727404,10727422,18,1,0,0,1
10727421,10727624,203,0,0,1,2
10727423,10728051,628,0,0,1,1
10727625,10727635,10,1,0,0,2
10727636,10728067,431,0,0,1,2
10728052,10728519,467,1,0,0,1
10728068,10728325,257,1,0,0,2
10728069,10728407,338,0,1,0,1
10728097,10728290,193,0,1,0,2
10728326,10728424,98,0,0,1,2
10728435,10728777,342,0,1,0,2
10728520,10728594,74,0,0,1,1
10728595,10728894,299,1,0,0,1
10728607,10728781,174,0,1,0,1
10728787,10728817,30,1,0,0,2
10728818,10728852,34,0,0,1,2
10728853,10728920,67,1,0,0,2
10728895,10730716,1821,0,0,1,1
10728921,10730721,1800,0,0,1,2
10730717,10731371,654,1,0,0,1
10730722,10731366,644,1,0,0,2
10730761,10731322,561,0,1,0,1
10730762,10731355,593,0,1,0,2
10731344,10731360,16,0,1,0,1
10731367,10731476,109,0,0,1,2
10731372,10731417,45,0,0,1,1
10731418,10731437,19,1,0,0,1
10731438,10731475,37,0,0,1,1
10731476,10731529,53,1,0,0,1
10731477,10731538,61,1,0,0,2
10731530,10731996,466,0,0,1,1
10731539,10731995,456,0,0,1,2
10731996,10732035,39,1,0,0,2
10731997,10732036,39,1,0,0,1
10732036,10732259,223,0,0,1,2
10732037,10732259,222,0,0,1,1
10732260,10732281,21,1,0,0,1
10732260,10732281,21,1,0,0,2
10732282,10733073,791,0,0,1,2
10732282,10733074,792,0,0,1,1
10733074,10733115,41,1,0,0,2
10733075,10733115,40,1,0,0,1
10733116,10733414,298,0,0,1,1
10733116,10733416,300,0,0,1,2
10733415,10733458,43,1,0,0,1
10733417,10733459,42,1,0,0,2
10733459,10733572,113,0,0,1,1
10733460,10733580,120,0,0,1,2
10733573,10739056,5483,1,0,0,1
10733581,10739057,5476,1,0,0,2
10733606,10739045,5439,0,1,0,1
10733606,10739046,5440,0,1,0,2
10739057,10739186,129,0,0,1,1
10739058,10739185,127,0,0,1,2
10739186,10739227,41,1,0,0,2
10739187,10739228,41,1,0,0,1
10739228,10739900,672,0,0,1,2
10739229,10739900,671,0,0,1,1
10787446,10787592,146,0,0,1,1
10787446,10787592,146,0,0,1,2
10787593,10787629,36,1,0,0,2
10787593,10787632,39,1,0,0,1
10787630,10787665,35,0,0,1,2
10787633,10787665,32,0,0,1,1
10787666,10787704,38,1,0,0,1
10787666,10787704,38,1,0,0,2
10787705,10787934,229,0,0,1,1
10787705,10787947,242,0,0,1,2
10787935,10788774,839,1,0,0,1
10787948,10788757,809,1,0,0,2
10787967,10788732,765,0,1,0,1
10787967,10788745,778,0,1,0,2
10788758,10789059,301,0,0,1,2
10788775,10789054,279,0,0,1,1
10789055,10789073,18,1,0,0,1
10789060,10789073,13,1,0,0,2
10789074,10790474,1400,0,0,1,1
10789074,10790474,1400,0,0,1,2
10790475,10790545,70,1,0,0,1
10790475,10790547,72,1,0,0,2
10790546,10790604,58,0,0,1,1
10790548,10790603,55,0,0,1,2
10790604,10790631,27,1,0,0,2
10790605,10790630,25,1,0,0,1
10790631,10790711,80,0,0,1,1
10790632,10790709,77,0,0,1,2
10790710,10790731,21,1,0,0,2
10790712,10790730,18,1,0,0,1
10790731,10791793,1062,0,0,1,1
10790732,10791791,1059,0,0,1,2
10791792,10791884,92,1,0,0,2
10791794,10791884,90,1,0,0,1
10791885,10792122,237,0,0,1,2
10791885,10792123,238,0,0,1,1
10792123,10792180,57,1,0,0,2
10792124,10792181,57,1,0,0,1
10792181,10792292,111,0,0,1,2
10792182,10792295,113,0,0,1,1
10792293,10792317,24,1,0,0,2
10792296,10792327,31,1,0,0,1
10792318,10793179,861,0,0,1,2
10792328,10793170,842,0,0,1,1
10793171,10793391,220,1,0,0,1
10793180,10793355,175,1,0,0,2
10793197,10793379,182,0,1,0,1
10793201,10793320,119,0,1,0,2
10793356,10793665,309,0,0,1,2
10793392,10793665,273,0,0,1,1
10793666,10793741,75,1,0,0,2
10793666,10793743,77,1,0,0,1
10793742,10793842,100,0,0,1,2
10793744,10793843,99,0,0,1,1
10793843,10793876,33,1,0,0,2
10793844,10793869,25,1,0,0,1
10793870,10794930,1060,0,0,1,1
10793877,10794928,1051,0,0,1,2
10794929,10795205,276,1,0,0,2
10794931,10795199,268,1,0,0,1
10795011,10795161,150,0,1,0,2
10795016,10795140,124,0,1,0,1
10795200,10795317,117,0,0,1,1
10795206,10795316,110,0,0,1,2
10795317,10795397,80,1,0,0,2
10795318,10795397,79,1,0,0,1
10795398,10795484,86,0,0,1,2
10795398,10795485,87,0,0,1,1
10795485,10795517,32,1,0,0,2
10795486,10795519,33,1,0,0,1
10795518,10796426,908,0,0,1,2
10795520,10796424,904,0,0,1,1
10796425,10796737,312,1,0,0,1
10796427,10796729,302,1,0,0,2
10796454,10796669,215,0,1,0,2
10796454,10796676,222,0,1,0,1
10796730,10796911,181,0,0,1,2
10796738,10796910,172,0,0,1,1
10796911,10796965,54,1,0,0,1
10796912,10796965,53,1,0,0,2
10796966,10797119,153,0,0,1,1
10796966,10797125,159,0,0,1,2
10797120,10797138,18,1,0,0,1
10797126,10797137,11,1,0,0,2
10797138,10797968,830,0,0,1,2
10797139,10797946,807,0,0,1,1
10797947,10798250,303,1,0,0,1
10797969,10798230,261,1,0,0,2
10797988,10798195,207,0,1,0,1
10797991,10798167,176,0,1,0,2
10798231,10798408,177,0,0,1,2
10798251,10798411,160,0,0,1,1
10798409,10798437,28,1,0,0,2
10798412,10798436,24,1,0,0,1
10798437,10798459,22,0,0,1,1
10798438,10798461,23,0,0,1,2
10798460,10798555,95,1,0,0,1
10798462,10798552,90,1,0,0,2
10798553,10798635,82,0,0,1,2
10798556,10798636,80,0,0,1,1
10798636,10798665,29,1,0,0,2
10798637,10798660,23,1,0,0,1
10798661,10798756,95,0,0,1,1
10798666,10798754,88,0,0,1,2
10798755,10798775,20,1,0,0,2
10798757,10798775,18,1,0,0,1
10798776,10799597,821,0,0,1,2
10798776,10799599,823,0,0,1,1
10799598,10799683,85,1,0,0,2
10799600,10799683,83,1,0,0,1
10799684,10799980,296,0,0,1,1
10799684,10799980,296,0,0,1,2
10799981,10800027,46,1,0,0,1
10799981,10800027,46,1,0,0,2
10800028,10800186,158,0,0,1,2
10800028,10800191,163,0,0,1,1
10800187,10800202,15,1,0,0,2
10800192,10800202,10,1,0,0,1
10800203,10801003,800,0,0,1,1
10800203,10801003,800,0,0,1,2
10801004,10801212,208,1,0,0,1
10801004,10801233,229,1,0,0,2
10801044,10801156,112,0,1,0,2
10801048,10801190,142,0,1,0,1
10801213,10801471,258,0,0,1,1
10801234,10801470,236,0,0,1,2
10801471,10801535,64,1,0,0,2
10801472,10801537,65,1,0,0,1
10801536,10801594,58,0,0,1,2
10801538,10801595,57,0,0,1,1
10801595,10801630,35,1,0,0,2
10801596,10801628,32,1,0,0,1
10801629,10801749,120,0,0,1,1
10801631,10801746,115,0,0,1,2
10801747,10801769,22,1,0,0,2
10801750,10801770,20,1,0,0,1
10801770,10801858,88,0,0,1,2
10801771,10801858,87,0,0,1,1
10801859,10801877,18,1,0,0,1
10801859,10801878,19,1,0,0,2
10801878,10802551,673,0,0,1,1
10801879,10802549,670,0,0,1,2
10802550,10802796,246,1,0,0,2
10802552,10802798,246,1,0,0,1
10802609,10802726,117,0,1,0,2
10802610,10802750,140,0,1,0,1
10802797,10803013,216,0,0,1,2
10802799,10803013,214,0,0,1,1
10803014,10803077,63,1,0,0,1
10803014,10803081,67,1,0,0,2
10803078,10803223,145,0,0,1,1
10803082,10803221,139,0,0,1,2
10803222,10803253,31,1,0,0,2
10803224,10803246,22,1,0,0,1
10803247,10804118,871,0,0,1,1
10803254,10804118,864,0,0,1,2
10804119,10804180,61,1,0,0,1
10804119,10804182,63,1,0,0,2
10804181,10804418,237,0,0,1,1
10804183,10804418,235,0,0,1,2
10804419,10804492,73,1,0,0,1
10804419,10804493,74,1,0,0,2
10804493,10804568,75,0,0,1,1
10804494,10804566,72,0,0,1,2
10804567,10804596,29,1,0,0,2
10804569,10804593,24,1,0,0,1
10804594,10804711,117,0,0,1,1
10804597,10804710,113,0,0,1,2
10804711,10804733,22,1,0,0,2
10804712,10804734,22,1,0,0,1
10804734,10805460,726,0,0,1,2
10804735,10805447,712,0,0,1,1
10805448,10805735,287,1,0,0,1
10805461,10805707,246,1,0,0,2
10805477,10805664,187,0,1,0,2
10805478,10805658,180,0,1,0,1
10805708,10805833,125,0,0,1,2
10805736,10805831,95,0,0,1,1
10805832,10805882,50,1,0,0,1
10805834,10805882,48,1,0,0,2
10805883,10805948,65,0,0,1,1
10805883,10805948,65,0,0,1,2
10805949,10805991,42,1,0,0,2
10805949,10805992,43,1,0,0,1
10805992,10806027,35,0,0,1,2
10805993,10806028,35,0,0,1,1
10806028,10806058,30,1,0,0,2
10806029,10806056,27,1,0,0,1
10806057,10806182,125,0,0,1,1
10806059,10806182,123,0,0,1,2
10806183,10806202,19,1,0,0,2
10806183,10806277,94,1,0,0,1
10806203,10807068,865,0,0,1,2
10806278,10807043,765,0,0,1,1
10807044,10807401,357,1,0,0,1
10807069,10807333,264,1,0,0,2
10807090,10807265,175,0,1,0,1
10807090,10807268,178,0,1,0,2
10807334,10807462,128,0,0,1,2
10807402,10807430,28,0,0,1,1
10807431,10807510,79,1,0,0,1
10807463,10807513,50,1,0,0,2
10807511,10807656,145,0,0,1,1
10807514,10807656,142,0,0,1,2
10807657,10807675,18,1,0,0,2
10807657,10807676,19,1,0,0,1
10807676,10808913,1237,0,0,1,2
10807677,10808913,1236,0,0,1,1
10808914,10808958,44,1,0,0,1
10808914,10808958,44,1,0,0,2
10808959,10809015,56,0,0,1,1
10808959,10809015,56,0,0,1,2
10809016,10809105,89,1,0,0,1
10809016,10809106,90,1,0,0,2
10809106,10809158,52,0,0,1,1
10809107,10809159,52,0,0,1,2
10809159,10809186,27,1,0,0,1
10809160,10809184,24,1,0,0,2
10809185,10809238,53,0,0,1,2
10809187,10809242,55,0,0,1,1
10809239,10809263,24,1,0,0,2
10809243,10809274,31,1,0,0,1
10809264,10809753,489,0,0,1,2
10809275,10809770,495,0,0,1,1
10809754,10809839,85,1,0,0,2
10809771,10809839,68,1,0,0,1
10809840,10810082,242,0,0,1,1
10809840,10810091,251,0,0,1,2
10810083,10810163,80,1,0,0,1
10810092,10810165,73,1,0,0,2
10810164,10810463,299,0,0,1,1
10810166,10810461,295,0,0,1,2
10810462,10810521,59,1,0,0,2
10810464,10810525,61,1,0,0,1
10810522,10810650,128,0,0,1,2
10810526,10810650,124,0,0,1,1
10810651,10810676,25,1,0,0,1
10810651,10810683,32,1,0,0,2
10810677,10811403,726,0,0,1,1
10810684,10811412,728,0,0,1,2
10811404,10811715,311,1,0,0,1
10811413,10811718,305,1,0,0,2
10811473,10811646,173,0,1,0,2
10811475,10811586,111,0,1,0,1
10811630,10811651,21,0,1,0,1
10811716,10811878,162,0,0,1,1
10811719,10811877,158,0,0,1,2
10811878,10811926,48,1,0,0,2
10811879,10811927,48,1,0,0,1
10811927,10812060,133,0,0,1,2
10811928,10812059,131,0,0,1,1
10812060,10812080,20,1,0,0,1
10812061,10812081,20,1,0,0,2
10812081,10813049,968,0,0,1,1
10812082,10813046,964,0,0,1,2
10813047,10813092,45,1,0,0,2
10813050,10813093,43,1,0,0,1
10813093,10813248,155,0,0,1,2
10813094,10813247,153,0,0,1,1
10813248,10813459,211,1,0,0,1
10813249,10813330,81,1,0,0,2
10813331,10813423,92,0,0,1,2
10813424,10813448,24,1,0,0,2
10813449,10813518,69,0,0,1,2
10813460,10813517,57,0,0,1,1
10813518,10813574,56,1,0,0,1
10813519,10813536,17,1,0,0,2
10813537,10813914,377,0,0,1,2
10813575,10813875,300,0,0,1,1
10813876,10814772,896,1,0,0,1
10813915,10814144,229,1,0,0,2
10813936,10814071,135,0,1,0,2
10813938,10814081,143,0,1,0,1
10814145,10814337,192,0,0,1,2
10814338,10814654,316,1,0,0,2
10814357,10814594,237,0,1,0,1
10814360,10814610,250,0,1,0,2
10814655,10814708,53,0,0,1,2
10814709,10814770,61,1,0,0,2
10814771,10814907,136,0,0,1,2
10814773,10814907,134,0,0,1,1
10814908,10814931,23,1,0,0,1
10814908,10814931,23,1,0,0,2
10814932,10815079,147,0,0,1,2
10814932,10815080,148,0,0,1,1
10815080,10815091,11,1,0,0,2
10815081,10815090,9,1,0,0,1
10815091,10815654,563,0,0,1,1
10815092,10815666,574,0,0,1,2
10815655,10816066,411,1,0,0,1
10815667,10816031,364,1,0,0,2
10815698,10815966,268,0,1,0,2
10815702,10815987,285,0,1,0,1
10816009,10816040,31,0,1,0,1
10816032,10816127,95,0,0,1,2
10816067,10816128,61,0,0,1,1
10816128,10816172,44,1,0,0,2
10816129,10816172,43,1,0,0,1
10816173,10816332,159,0,0,1,2
10816173,10816336,163,0,0,1,1
10816333,10816349,16,1,0,0,2
10816337,10816350,13,1,0,0,1
10816350,10816963,613,0,0,1,2
10816351,10816950,599,0,0,1,1
10816951,10817346,395,1,0,0,1
10816964,10817295,331,1,0,0,2
10816981,10817261,280,0,1,0,1
10816996,10817238,242,0,1,0,2
10817291,10817296,5,0,1,0,1
10817296,10817437,141,0,0,1,2
10817347,10817437,90,0,0,1,1
10817438,10817532,94,1,0,0,1
10817438,10817533,95,1,0,0,2
10817533,10817560,27,0,0,1,1
10817534,10817561,27,0,0,1,2
10817561,10817591,30,1,0,0,1
10817562,10817607,45,1,0,0,2
10817592,10817640,48,0,0,1,1
10817608,10817636,28,0,0,1,2
10817637,10817663,26,1,0,0,2
10817641,10817664,23,1,0,0,1
10817664,10817726,62,0,0,1,2
10817665,10817727,62,0,0,1,1
10817727,10817759,32,1,0,0,2
10817728,10817750,22,1,0,0,1
10817751,10818469,718,0,0,1,1
10817760,10818472,712,0,0,1,2
10818470,10818828,358,1,0,0,1
10818473,10818731,258,1,0,0,2
10818510,10818669,159,0,1,0,2
10818514,10818635,121,0,1,0,1
10818664,10818679,15,0,1,0,1
10818701,10818718,17,0,1,0,1
10818732,10818800,68,0,0,1,2
10818801,10818831,30,1,0,0,2
10818829,10818871,42,0,0,1,1
10818832,10818871,39,0,0,1,2
10818872,10818931,59,1,0,0,2
10818872,10820206,1334,1,0,0,1
10818924,10818935,11,0,1,0,1
10818932,10819005,73,0,0,1,2
10819006,10819042,36,1,0,0,2
10819023,10820100,1077,0,1,0,1
10819043,10819171,128,0,0,1,2
10819172,10819191,19,1,0,0,2
10819192,10819722,530,0,0,1,2
10819723,10820200,477,1,0,0,2
10819751,10820105,354,0,1,0,2
10820163,10820192,29,0,1,0,1
10820201,10820236,35,0,0,1,2
10820207,10820236,29,0,0,1,1
10820237,10820298,61,1,0,0,1
10820237,10820302,65,1,0,0,2
10820299,10820348,49,0,0,1,1
10820303,10820348,45,0,0,1,2
10820349,10820383,34,1,0,0,1
10820349,10820383,34,1,0,0,2
10820384,10820497,113,0,0,1,1
10820384,10820499,115,0,0,1,2
10820498,10820526,28,1,0,0,1
10820500,10820525,25,1,0,0,2
10820526,10821139,613,0,0,1,2
10820527,10821143,616,0,0,1,1
10821140,10821452,312,1,0,0,2
10821144,10821739,595,1,0,0,1
10821163,10821426,263,0,1,0,1
10821174,10821441,267,0,1,0,2
10821453,10821553,100,0,0,1,2
10821478,10821524,46,0,1,0,1
10821552,10821565,13,0,1,0,1
10821554,10821651,97,1,0,0,2
10821568,10821584,16,0,1,0,2
10821589,10821596,7,0,1,0,1
10821652,10821697,45,0,0,1,2
10821698,10821737,39,1,0,0,2
10821738,10821871,133,0,0,1,2
10821740,10821871,131,0,0,1,1
10821872,10821889,17,1,0,0,1
10821872,10821889,17,1,0,0,2
10821890,10822513,623,0,0,1,1
10821890,10822514,624,0,0,1,2
10822514,10823040,526,1,0,0,1
10822515,10822820,305,1,0,0,2
10822544,10822699,155,0,1,0,2
10822551,10822727,176,0,1,0,1
10822725,10822803,78,0,1,0,2
10822759,10822795,36,0,1,0,1
10822816,10822856,40,0,1,0,1
10822821,10822914,93,0,0,1,2
10822884,10822911,27,0,1,0,1
10822915,10823025,110,1,0,0,2
10823026,10823111,85,0,0,1,2
10823041,10823113,72,0,0,1,1
10823112,10823138,26,1,0,0,2
10823114,10823168,54,1,0,0,1
10823139,10823301,162,0,0,1,2
10823169,10823297,128,0,0,1,1
10823298,10823313,15,1,0,0,1
10823302,10823312,10,1,0,0,2
10823313,10824061,748,0,0,1,2
10823314,10823904,590,0,0,1,1
10823905,10823920,15,1,0,0,1
10823921,10823984,63,0,0,1,1
10823985,10824001,16,1,0,0,1
10824002,10824057,55,0,0,1,1
10824058,10824112,54,1,0,0,1
10824062,10824114,52,1,0,0,2
10824113,10824295,182,0,0,1,1
10824115,10824293,178,0,0,1,2
10824294,10824349,55,1,0,0,2
10824296,10824353,57,1,0,0,1
10824350,10824444,94,0,0,1,2
10824354,10824442,88,0,0,1,1
10824443,10824477,34,1,0,0,1
10824445,10824468,23,1,0,0,2
10824469,10824960,491,0,0,1,2
10824478,10824960,482,0,0,1,1
10824961,10825270,309,1,0,0,2
10824961,10825748,787,1,0,0,1
10824989,10825677,688,0,1,0,1
10824996,10825260,264,0,1,0,2
10825271,10825789,518,0,0,1,2
10825716,10825739,23,0,1,0,1
10825749,10825789,40,0,0,1,1
10825790,10825858,68,1,0,0,2
10825790,10825885,95,1,0,0,1
10825815,10825815,0,0,1,0,1
10825836,10825848,12,0,1,0,1
10825859,10825911,52,0,0,1,2
10825886,10825910,24,0,0,1,1
10825911,10825943,32,1,0,0,1
10825912,10825936,24,1,0,0,2
10825937,10826113,176,0,0,1,2
10825944,10826115,171,0,0,1,1
10826114,10826127,13,1,0,0,2
10826116,10826126,10,1,0,0,1
10826127,10826808,681,0,0,1,1
10826128,10826821,693,0,0,1,2
10826809,10827372,563,1,0,0,1
10826822,10827168,346,1,0,0,2
10826845,10827086,241,0,1,0,2
10826846,10827173,327,0,1,0,1
10827169,10827258,89,0,0,1,2
10827194,10827277,83,0,1,0,1
10827259,10827372,113,1,0,0,2
10827373,10827418,45,0,0,1,2
10827373,10827419,46,0,0,1,1
10827419,10827454,35,1,0,0,2
10827420,10827467,47,1,0,0,1
10827455,10827529,74,0,0,1,2
10827468,10827529,61,0,0,1,1
10827530,10827552,22,1,0,0,1
10827530,10827553,23,1,0,0,2
10827553,10827820,267,0,0,1,1
10827554,10827821,267,0,0,1,2
10827821,10827832,11,1,0,0,1
10827822,10827831,9,1,0,0,2
10827832,10828231,399,0,0,1,2
10827833,10828226,393,0,0,1,1
10828227,10828655,428,1,0,0,1
10828232,10828551,319,1,0,0,2
10828266,10828495,229,0,1,0,2
10828269,10828513,244,0,1,0,1
10828551,10828561,10,0,1,0,1
10828552,10828616,64,0,0,1,2
10828617,10828644,27,1,0,0,2
10828645,10828710,65,0,0,1,2
10828656,10828712,56,0,0,1,1
10828711,10828781,70,1,0,0,2
10828713,10829161,448,1,0,0,1
10828750,10828857,107,0,1,0,1
10828782,10829071,289,0,0,1,2
10828882,10829094,212,0,1,0,1
10829072,10829089,17,1,0,0,2
10829090,10829610,520,0,0,1,2
10829162,10829201,39,0,0,1,1
10829202,10830147,945,1,0,0,1
10829213,10829252,39,0,1,0,1
10829279,10829906,627,0,1,0,1
10829611,10829856,245,1,0,0,2
10829631,10829832,201,0,1,0,2
10829857,10830072,215,0,0,1,2
10830073,10830144,71,1,0,0,2
10830145,10830188,43,0,0,1,2
10830148,10830187,39,0,0,1,1
10830188,10830215,27,1,0,0,1
10830189,10830215,26,1,0,0,2
10830216,10830319,103,0,0,1,2
10830216,10830320,104,0,0,1,1
10830320,10830340,20,1,0,0,2
10830321,10830341,20,1,0,0,1
10830341,10831165,824,0,0,1,2
10830342,10831165,823,0,0,1,1
10831166,10831435,269,1,0,0,2
10831166,10831467,301,1,0,0,1
10831196,10831372,176,0,1,0,2
10831199,10831409,210,0,1,0,1
10831436,10831609,173,0,0,1,2
10831468,10831608,140,0,0,1,1
10831609,10831695,86,1,0,0,1
10831610,10831686,76,1,0,0,2
10831687,10831865,178,0,0,1,2
10831696,10831866,170,0,0,1,1
10831866,10831884,18,1,0,0,2
10831867,10831885,18,1,0,0,1
10831885,10832686,801,0,0,1,2
10831886,10832688,802,0,0,1,1
10832687,10832944,257,1,0,0,2
10832689,10832913,224,1,0,0,1
10832742,10832850,108,0,1,0,2
10832745,10832857,112,0,1,0,1
10832914,10833071,157,0,0,1,1
10832945,10833069,124,0,0,1,2
10833070,10833140,70,1,0,0,2
10833072,10833139,67,1,0,0,1
10833140,10833196,56,0,0,1,1
10833141,10833194,53,0,0,1,2
10833195,10833276,81,1,0,0,2
10833197,10833326,129,1,0,0,1
10833277,10833388,111,0,0,1,2
10833327,10833389,62,0,0,1,1
10833389,10833413,24,1,0,0,2
10833390,10833451,61,1,0,0,1
10833414,10833797,383,0,0,1,2
10833452,10834270,818,0,0,1,1
10833798,10833804,6,1,0,0,2
10833805,10834282,477,0,0,1,2
10834271,10834504,233,1,0,0,1
10834283,10834537,254,1,0,0,2
10834308,10834443,135,0,1,0,2
10834311,10834456,145,0,1,0,1
10834505,10834635,130,0,0,1,1
10834538,10834637,99,0,0,1,2
10834636,10834674,38,1,0,0,1
10834638,10834673,35,1,0,0,2
10834674,10834769,95,0,0,1,2
10834675,10834769,94,0,0,1,1
10834770,10834826,56,1,0,0,2
10834770,10834839,69,1,0,0,1
10834827,10834934,107,0,0,1,2
10834840,10834901,61,0,0,1,1
10834902,10834978,76,1,0,0,1
10834935,10834961,26,1,0,0,2
10834962,10835675,713,0,0,1,2
10834979,10835025,46,0,0,1,1
10835026,10835048,22,1,0,0,1
10835049,10835666,617,0,0,1,1
10835667,10835985,318,1,0,0,1
10835676,10835979,303,1,0,0,2
10835697,10835914,217,0,1,0,2
10835701,10835922,221,0,1,0,1
10835980,10836147,167,0,0,1,2
10835986,10836146,160,0,0,1,1
10836147,10836202,55,1,0,0,1
10836148,10836194,46,1,0,0,2
10836195,10837102,907,0,0,1,2
10836203,10837076,873,0,0,1,1
10837077,10837502,425,1,0,0,1
10837103,10837456,353,1,0,0,2
10837124,10837412,288,0,1,0,1
10837129,10837416,287,0,1,0,2
10837457,10837576,119,0,0,1,2
10837503,10837579,76,0,0,1,1
10837577,10837638,61,1,0,0,2
10837580,10837639,59,1,0,0,1
10837639,10837697,58,0,0,1,2
10837640,10837697,57,0,0,1,1
10837698,10837749,51,1,0,0,1
10837698,10837750,52,1,0,0,2
10837750,10837810,60,0,0,1,1
10837751,10837811,60,0,0,1,2
10837811,10837842,31,1,0,0,1
10837812,10837836,24,1,0,0,2
10837837,10838521,684,0,0,1,2
10837843,10838526,683,0,0,1,1
10838522,10838898,376,1,0,0,2
10838527,10838870,343,1,0,0,1
10838562,10838785,223,0,1,0,2
10838562,10838807,245,0,1,0,1
10838871,10838969,98,0,0,1,1
10838899,10838969,70,0,0,1,2
10838970,10839011,41,1,0,0,2
10838970,10839038,68,1,0,0,1
10839012,10839238,226,0,0,1,2
10839039,10839243,204,0,0,1,1
10839239,10839254,15,1,0,0,2
10839244,10839248,4,1,0,0,1
10839249,10840065,816,0,0,1,1
10839255,10840078,823,0,0,1,2
10840066,10840092,26,1,0,0,1
10840079,10840087,8,1,0,0,2
10840088,10840463,375,0,0,1,2
10840093,10840462,369,0,0,1,1
10840463,10841600,1137,1,0,0,1
10840464,10840515,51,1,0,0,2
10840516,10840632,116,0,0,1,2
10840526,10841576,1050,0,1,0,1
10840633,10840657,24,1,0,0,2
10840658,10841151,493,0,0,1,2
10841152,10841463,311,1,0,0,2
10841178,10841452,274,0,1,0,2
10841464,10842056,592,0,0,1,2
10841601,10841955,354,0,0,1,1
10841966,10842057,91,0,1,0,1
10842057,10842174,117,1,0,0,2
10842067,10842188,121,1,0,0,1
10842175,10842262,87,0,0,1,2
10842189,10842264,75,0,0,1,1
10842263,10842295,32,1,0,0,2
10842265,10842306,41,1,0,0,1
10842296,10843014,718,0,0,1,2
10842307,10843000,693,0,0,1,1
10843001,10843321,320,1,0,0,1
10843015,10843295,280,1,0,0,2
10843055,10843224,169,0,1,0,2
10843059,10843244,185,0,1,0,1
10843296,10843536,240,0,0,1,2
10843322,10843535,213,0,0,1,1
10843536,10843617,81,1,0,0,1
10843537,10843609,72,1,0,0,2
10843610,10843688,78,0,0,1,2
10843618,10843689,71,0,0,1,1
10843689,10843725,36,1,0,0,2
10843690,10843724,34,1,0,0,1
10843725,10843791,66,0,0,1,1
10843726,10843791,65,0,0,1,2
10843792,10843821,29,1,0,0,1
10843792,10843821,29,1,0,0,2
10843822,10844761,939,0,0,1,2
10843822,10844764,942,0,0,1,1
10844762,10845140,378,1,0,0,2
10844765,10845144,379,1,0,0,1
10844795,10845129,334,0,1,0,2
10844800,10845131,331,0,1,0,1
10845141,10845232,91,0,0,1,2
10845145,10845233,88,0,0,1,1
10845233,10845319,86,1,0,0,2
10845234,10845312,78,1,0,0,1
10845313,10845408,95,0,0,1,1
10845320,10845408,88,0,0,1,2
10845409,10845434,25,1,0,0,2
10845409,10845448,39,1,0,0,1
10845435,10845581,146,0,0,1,2
10845449,10845593,144,0,0,1,1
10845582,10845593,11,1,0,0,2
10845594,10845610,16,1,0,0,1
10845594,10846278,684,0,0,1,2
10845611,10846268,657,0,0,1,1
10846269,10846568,299,1,0,0,1
10846279,10846577,298,1,0,0,2
10846313,10846490,177,0,1,0,2
10846313,10846497,184,0,1,0,1
10846569,10846592,23,0,0,1,1
10846578,10846761,183,0,0,1,2
10846593,10846597,4,1,0,0,1
10846598,10846758,160,0,0,1,1
10846759,10846838,79,1,0,0,1
10846762,10846824,62,1,0,0,2
10846825,10846935,110,0,0,1,2
10846839,10846936,97,0,0,1,1
10846936,10846958,22,1,0,0,2
10846937,10846965,28,1,0,0,1
10846959,10847692,733,0,0,1,2
10846966,10847682,716,0,0,1,1
10847683,10847941,258,1,0,0,1
10847693,10847955,262,1,0,0,2
10847712,10847878,166,0,1,0,2
10847717,10847882,165,0,1,0,1
10847942,10848159,217,0,0,1,1
10847956,10848156,200,0,0,1,2
10848157,10848206,49,1,0,0,2
10848160,10848207,47,1,0,0,1
10848207,10848323,116,0,0,1,2
10848208,10848324,116,0,0,1,1
10848324,10848354,30,1,0,0,2
10848325,10848346,21,1,0,0,1
10848347,10849227,880,0,0,1,1
10848355,10849231,876,0,0,1,2
10849228,10849535,307,1,0,0,1
10849232,10849491,259,1,0,0,2
10849257,10849440,183,0,1,0,1
10849258,10849428,170,0,1,0,2
10849461,10849465,4,0,1,0,1
10849492,10849597,105,0,0,1,2
10849536,10849596,60,0,0,1,1
10849597,10849655,58,1,0,0,1
10849598,10849646,48,1,0,0,2
10849647,10850437,790,0,0,1,2
10849656,10850420,764,0,0,1,1
10850421,10850878,457,1,0,0,1
10850438,10850765,327,1,0,0,2
10850441,10850852,411,0,1,0,1
10850464,10850697,233,0,1,0,2
10850766,10850932,166,0,0,1,2
10850879,10850929,50,0,0,1,1
10850930,10851017,87,1,0,0,1
10850933,10851015,82,1,0,0,2
10851016,10851064,48,0,0,1,2
10851018,10851067,49,0,0,1,1
10851065,10851093,28,1,0,0,2
10851068,10851092,24,1,0,0,1
10851093,10851999,906,0,0,1,1
10851094,10851986,892,0,0,1,2
10851987,10852242,255,1,0,0,2
10852000,10852236,236,1,0,0,1
10852032,10852182,150,0,1,0,2
10852033,10852184,151,0,1,0,1
10852208,10852208,0,0,1,0,1
10852237,10852391,154,0,0,1,1
10852243,10852391,148,0,0,1,2
10852392,10852474,82,1,0,0,1
10852392,10852477,85,1,0,0,2
10852475,10852522,47,0,0,1,1
10852478,10852520,42,0,0,1,2
10852521,10852553,32,1,0,0,2
10852523,10852550,27,1,0,0,1
10852551,10852617,66,0,0,1,1
10852554,10852615,61,0,0,1,2
10852616,10852648,32,1,0,0,2
10852618,10852639,21,1,0,0,1
10852640,10853488,848,0,0,1,1
10852649,10853462,813,0,0,1,2
10853463,10853695,232,1,0,0,2
10853489,10853702,213,1,0,0,1
10853532,10853589,57,0,1,0,1
10853539,10853627,88,0,1,0,2
10853619,10853627,8,0,1,0,1
10853696,10853908,212,0,0,1,2
10853703,10853908,205,0,0,1,1
10853909,10854003,94,1,0,0,1
10853909,10854003,94,1,0,0,2
10854004,10854049,45,0,0,1,2
10854004,10854050,46,0,0,1,1
10854050,10854077,27,1,0,0,2
10854051,10854076,25,1,0,0,1
10854077,10854151,74,0,0,1,1
10854078,10854148,70,0,0,1,2
10854149,10854184,35,1,0,0,2
10854152,10854173,21,1,0,0,1
10854174,10854453,279,0,0,1,1
10854185,10854457,272,0,0,1,2
10854454,10854471,17,1,0,0,1
10854458,10854469,11,1,0,0,2
10854470,10854919,449,0,0,1,2
10854472,10854916,444,0,0,1,1
10854917,10854995,78,1,0,0,1
10854920,10854995,75,1,0,0,2
10854996,10855309,313,0,0,1,2
10854996,10855310,314,0,0,1,1
10855310,10855359,49,1,0,0,2
10855311,10855366,55,1,0,0,1
10855360,10855465,105,0,0,1,2
10855367,10855467,100,0,0,1,1
10855466,10855487,21,1,0,0,2
10855468,10855488,20,1,0,0,1
10855488,10855969,481,0,0,1,2
10855489,10855967,478,0,0,1,1
10855968,10856243,275,1,0,0,1
10855970,10856231,261,1,0,0,2
10856001,10856131,130,0,1,0,1
10856004,10856121,117,0,1,0,2
10856232,10856437,205,0,0,1,2
10856244,10856435,191,0,0,1,1
10856436,10856487,51,1,0,0,1
10856438,10856489,51,1,0,0,2
10856488,10856738,250,0,0,1,1
10856490,10856737,247,0,0,1,2
10856738,10856811,73,1,0,0,2
10856739,10856811,72,1,0,0,1
10856812,10856855,43,0,0,1,2
10856812,10856858,46,0,0,1,1
10856856,10856900,44,1,0,0,2
10856859,10856886,27,1,0,0,1
10856887,10857251,364,0,0,1,1
10856901,10857251,350,0,0,1,2
10857252,10857256,4,1,0,0,1
10857252,10857263,11,1,0,0,2
10857257,10857681,424,0,0,1,1
10857264,10857678,414,0,0,1,2
10857679,10857908,229,1,0,0,2
10857682,10857890,208,1,0,0,1
10857728,10857831,103,0,1,0,2
10857735,10857829,94,0,1,0,1
10857891,10858149,258,0,0,1,1
10857909,10858150,241,0,0,1,2
10858150,10858207,57,1,0,0,1
10858151,10858210,59,1,0,0,2
10858208,10858253,45,0,0,1,1
10858211,10858254,43,0,0,1,2
10858254,10858281,27,1,0,0,1
10858255,10858281,26,1,0,0,2
10858282,10858431,149,0,0,1,1
10858282,10858431,149,0,0,1,2
10858432,10858449,17,1,0,0,1
10858432,10858451,19,1,0,0,2
10858450,10859507,1057,0,0,1,1
10858452,10859506,1054,0,0,1,2
10859507,10859644,137,1,0,0,2
10859508,10859649,141,1,0,0,1
10859645,10859733,88,0,0,1,2
10859650,10859732,82,0,0,1,1
10859733,10859927,194,1,0,0,1
10859734,10859779,45,1,0,0,2
10859780,10859868,88,0,0,1,2
10859869,10859891,22,1,0,0,2
10859892,10860192,300,0,0,1,2
10859928,10860436,508,0,0,1,1
10860193,10860202,9,1,0,0,2
10860203,10860493,290,0,0,1,2
10860437,10860762,325,1,0,0,1
10860494,10860747,253,1,0,0,2
10860518,10860706,188,0,1,0,2
10860518,10860745,227,0,1,0,1
10860748,10861127,379,0,0,1,2
10860763,10861127,364,0,0,1,1
10861128,10861209,81,1,0,0,2
10861128,10861221,93,1,0,0,1
10861210,10861282,72,0,0,1,2
10861222,10861282,60,0,0,1,1
10861283,10861306,23,1,0,0,1
10861283,10861308,25,1,0,0,2
10861307,10861401,94,0,0,1,1
10861309,10861403,94,0,0,1,2
10861402,10861426,24,1,0,0,1
10861404,10861426,22,1,0,0,2
10861427,10863323,1896,0,0,1,1
10861427,10863323,1896,0,0,1,2
10863324,10863364,40,1,0,0,1
10863324,10863364,40,1,0,0,2
10863365,10863613,248,0,0,1,1
10863365,10863613,248,0,0,1,2
10863614,10863631,17,1,0,0,2
10863614,10863633,19,1,0,0,1
10863632,10863916,284,0,0,1,2
10863634,10863939,305,0,0,1,1
10863917,10864213,296,1,0,0,2
10863940,10864207,267,1,0,0,1
10863964,10864181,217,0,1,0,2
10863967,10864182,215,0,1,0,1
10864208,10864466,258,0,0,1,1
10864214,10864479,265,0,0,1,2
10864467,10864772,305,1,0,0,1
10864480,10864762,282,1,0,0,2
10864497,10864720,223,0,1,0,1
10864500,10864728,228,0,1,0,2
10864763,10865491,728,0,0,1,2
10864773,10865481,708,0,0,1,1
10865482,10865846,364,1,0,0,1
10865492,10865838,346,1,0,0,2
10865515,10865783,268,0,1,0,1
10865518,10865783,265,0,1,0,2
10865839,10866501,662,0,0,1,2
10865847,10866500,653,0,0,1,1
10866501,10866535,34,1,0,0,1
10866502,10866547,45,1,0,0,2
10866536,10867402,866,0,0,1,1
10866548,10867400,852,0,0,1,2
10867401,10867478,77,1,0,0,2
10867403,10867487,84,1,0,0,1
10867479,10867712,233,0,0,1,2
10867488,10867714,226,0,0,1,1
10867713,10867732,19,1,0,0,2
10867715,10867732,17,1,0,0,1
10867733,10868349,616,0,0,1,1
10867733,10868349,616,0,0,1,2
10868350,10868652,302,1,0,0,1
10868350,10868692,342,1,0,0,2
10868375,10868565,190,0,1,0,1
10868378,10868549,171,0,1,0,2
10868653,10868796,143,0,0,1,1
10868693,10868799,106,0,0,1,2
10868797,10868817,20,1,0,0,1
10868800,10868814,14,1,0,0,2
10868815,10870070,1255,0,0,1,2
10868818,10870051,1233,0,0,1,1
10870052,10870437,385,1,0,0,1
10870071,10870425,354,1,0,0,2
10870137,10870367,230,0,1,0,2
10870139,10870379,240,0,1,0,1
10870426,10870772,346,0,0,1,2
10870438,10870771,333,0,0,1,1
10870772,10870837,65,1,0,0,1
10870773,10870828,55,1,0,0,2
10870829,10870936,107,0,0,1,2
10870838,10870937,99,0,0,1,1
10870937,10870999,62,1,0,0,2
10870938,10871000,62,1,0,0,1
10871000,10871740,740,0,0,1,2
10871001,10871740,739,0,0,1,1
10871741,10871806,65,1,0,0,2
10871741,10871808,67,1,0,0,1
10871807,10872057,250,0,0,1,2
10871809,10872522,713,0,0,1,1
10872058,10872069,11,1,0,0,2
10872070,10872532,462,0,0,1,2
10872523,10872881,358,1,0,0,1
10872533,10872824,291,1,0,0,2
10872566,10872675,109,0,1,0,1
10872567,10872686,119,0,1,0,2
10872825,10873371,546,0,0,1,2
10872882,10873370,488,0,0,1,1
10873371,10873420,49,1,0,0,1
10873372,10873420,48,1,0,0,2
10873421,10873706,285,0,0,1,1
10873421,10873712,291,0,0,1,2
10873707,10873724,17,1,0,0,1
10873713,10873724,11,1,0,0,2
10873725,10874462,737,0,0,1,1
10873725,10874472,747,0,0,1,2
10874463,10874908,445,1,0,0,1
10874473,10874869,396,1,0,0,2
10874501,10874794,293,0,1,0,2
10874504,10874861,357,0,1,0,1
10874870,10875475,605,0,0,1,2
10874909,10875474,565,0,0,1,1
10875475,10875526,51,1,0,0,1
10875476,10875525,49,1,0,0,2
10875526,10875586,60,0,0,1,2
10875527,10875571,44,0,0,1,1
10875572,10875903,331,1,0,0,1
10875587,10875919,332,1,0,0,2
10875616,10875846,230,0,1,0,1
10875619,10875830,211,0,1,0,2
10875904,10876980,1076,0,0,1,1
10875920,10876980,1060,0,0,1,2
10876981,10877039,58,1,0,0,2
10876981,10877072,91,1,0,0,1
10877040,10877282,242,0,0,1,2
10877073,10877280,207,0,0,1,1
10877281,10877344,63,1,0,0,1
10877283,10877336,53,1,0,0,2
10877337,10877453,116,0,0,1,2
10877345,10877455,110,0,0,1,1
10877454,10877473,19,1,0,0,2
10877456,10877473,17,1,0,0,1
10877474,10877996,522,0,0,1,1
10877474,10878009,535,0,0,1,2
10877997,10878372,375,1,0,0,1
10878010,10878379,369,1,0,0,2
10878032,10878359,327,0,1,0,1
10878035,10878369,334,0,1,0,2
10878373,10878867,494,0,0,1,1
10878380,10878865,485,0,0,1,2
10878866,10878969,103,1,0,0,2
10878868,10878942,74,1,0,0,1
10878943,10879149,206,0,0,1,1
10878970,10879150,180,0,0,1,2
10879150,10879169,19,1,0,0,1
10879151,10879167,16,1,0,0,2
10879168,10879848,680,0,0,1,2
10879170,10879854,684,0,0,1,1
10879849,10880173,324,1,0,0,2
10879855,10880297,442,1,0,0,1
10879885,10880150,265,0,1,0,1
10879887,10880163,276,0,1,0,2
10880174,10880624,450,0,0,1,2
10880298,10880978,680,0,0,1,1
10880625,10880682,57,1,0,0,2
10880683,10880970,287,0,0,1,2
10880971,10881294,323,1,0,0,2
10880979,10881324,345,1,0,0,1
10881016,10881244,228,0,1,0,2
10881016,10881262,246,0,1,0,1
10881295,10881368,73,0,0,1,2
10881325,10881551,226,0,0,1,1
10881369,10881374,5,1,0,0,2
10881375,10881551,176,0,0,1,2
10881552,10881600,48,1,0,0,2
10881552,10881602,50,1,0,0,1
10881601,10882766,1165,0,0,1,2
10881603,10882768,1165,0,0,1,1
10882767,10882823,56,1,0,0,2
10882769,10882823,54,1,0,0,1
10882824,10882928,104,0,0,1,2
10882824,10882929,105,0,0,1,1
10882929,10882951,22,1,0,0,2
10882930,10882950,20,1,0,0,1
10882951,10883033,82,0,0,1,1
10882952,10883032,80,0,0,1,2
10883033,10883053,20,1,0,0,2
10883034,10883053,19,1,0,0,1
10883054,10883496,442,0,0,1,1
10883054,10883501,447,0,0,1,2
10883497,10883705,208,1,0,0,1
10883502,10883710,208,1,0,0,2
10883529,10883630,101,0,1,0,1
10883539,10883623,84,0,1,0,2
10883706,10883856,150,0,0,1,1
10883711,10883853,142,0,0,1,2
10883854,10883874,20,1,0,0,2
10883857,10883872,15,1,0,0,1
10883873,10884057,184,0,0,1,1
10883875,10884058,183,0,0,1,2
10884058,10884131,73,1,0,0,1
10884059,10884112,53,1,0,0,2
10884113,10885176,1063,0,0,1,2
10884132,10885170,1038,0,0,1,1
10885171,10885381,210,1,0,0,1
10885177,10885360,183,1,0,0,2
10885205,10885285,80,0,1,0,1
10885209,10885277,68,0,1,0,2
10885361,10886077,716,0,0,1,2
10885382,10886066,684,0,0,1,1
10886067,10886458,391,1,0,0,1
10886078,10886395,317,1,0,0,2
10886103,10886357,254,0,1,0,1
10886104,10886333,229,0,1,0,2
10886396,10886711,315,0,0,1,2
10886459,10886710,251,0,0,1,1
10886711,10886752,41,1,0,0,1
10886712,10886750,38,1,0,0,2
10886751,10887697,946,0,0,1,2
10886753,10887699,946,0,0,1,1
10887698,10887751,53,1,0,0,2
10887700,10887756,56,1,0,0,1
10887752,10887879,127,0,0,1,2
10887757,10887881,124,0,0,1,1
10887880,10887900,20,1,0,0,2
10887882,10887901,19,1,0,0,1
10887901,10888470,569,0,0,1,2
10887902,10888475,573,0,0,1,1
10888471,10888728,257,1,0,0,2
10888476,10888839,363,1,0,0,1
10888506,10888631,125,0,1,0,1
10888509,10888632,123,0,1,0,2
10888729,10888822,93,0,0,1,2
10888823,10888854,31,1,0,0,2
10888840,10889279,439,0,0,1,1
10888855,10889280,425,0,0,1,2
10889280,10889336,56,1,0,0,1
10889281,10889331,50,1,0,0,2
10889332,10889439,107,0,0,1,2
10889337,10889439,102,0,0,1,1
10889440,10889463,23,1,0,0,1
10889440,10889464,24,1,0,0,2
10889464,10890107,643,0,0,1,1
10889465,10890108,643,0,0,1,2
10890108,10890464,356,1,0,0,1
10890109,10890448,339,1,0,0,2
10890136,10890372,236,0,1,0,1
10890139,10890353,214,0,1,0,2
10890449,10890480,31,0,0,1,2
10890465,10890717,252,0,0,1,1
10890481,10890516,35,1,0,0,2
10890517,10890695,178,0,0,1,2
10890696,10891127,431,1,0,0,2
10890718,10890960,242,1,0,0,1
10890752,10890896,144,0,1,0,1
10890754,10890886,132,0,1,0,2
10890961,10891387,426,0,0,1,1
10891128,10891370,242,0,0,1,2
10891371,10891889,518,1,0,0,2
10891388,10891913,525,1,0,0,1
10891413,10891807,394,0,1,0,1
10891424,10891795,371,0,1,0,2
10891890,10892037,147,0,0,1,2
10891914,10892300,386,0,0,1,1
10892038,10892090,52,1,0,0,2
10892091,10892302,211,0,0,1,2
10892301,10892325,24,1,0,0,1
10892303,10892341,38,1,0,0,2
10892326,10893216,890,0,0,1,1
10892342,10893215,873,0,0,1,2
10893216,10893268,52,1,0,0,2
10893217,10893298,81,1,0,0,1
10893269,10893407,138,0,0,1,2
10893299,10893407,108,0,0,1,1
10893408,10893421,13,1,0,0,1
10893408,10893423,15,1,0,0,2
10893422,10894698,1276,0,0,1,1
10893424,10894697,1273,0,0,1,2
10894698,10894740,42,1,0,0,2
10894699,10894741,42,1,0,0,1
10894741,10894958,217,0,0,1,2
10894742,10894959,217,0,0,1,1
10894959,10894978,19,1,0,0,2
10894960,10894978,18,1,0,0,1
10894979,10895367,388,0,0,1,2
10894979,10895369,390,0,0,1,1
10895368,10895636,268,1,0,0,2
10895370,10895610,240,1,0,0,1
10895409,10895520,111,0,1,0,2
10895411,10895526,115,0,1,0,1
10895611,10896600,989,0,0,1,1
10895637,10895668,31,0,0,1,2
10895669,10895796,127,1,0,0,2
10895797,10896568,771,0,0,1,2
10896569,10897194,625,1,0,0,2
10896601,10897114,513,1,0,0,1
10896658,10897103,445,0,1,0,2
10896731,10897086,355,0,1,0,1
10897115,10898711,1596,0,0,1,1
10897195,10898712,1517,0,0,1,2
10898712,10898941,229,1,0,0,1
10898713,10898806,93,1,0,0,2
10898807,10898904,97,0,0,1,2
10898809,10898880,71,0,1,0,1
10898905,10898929,24,1,0,0,2
10898915,10898917,2,0,1,0,1
10898930,10899591,661,0,0,1,2
10898942,10899119,177,0,0,1,1
10899120,10899136,16,1,0,0,1
10899137,10899589,452,0,0,1,1
10899590,10899648,58,1,0,0,1
10899592,10899634,42,1,0,0,2
10899635,10900055,420,0,0,1,2
10899649,10900053,404,0,0,1,1
10900054,10900068,14,1,0,0,1
10900056,10900071,15,1,0,0,2
10900069,10900880,811,0,0,1,1
10900072,10900915,843,0,0,1,2
10900881,10901318,437,1,0,0,1
10900916,10901209,293,1,0,0,2
10900939,10901168,229,0,1,0,1
10900941,10901174,233,0,1,0,2
10901189,10901218,29,0,1,0,1
10901210,10901571,361,0,0,1,2
10901257,10901297,40,0,1,0,1
10901319,10901380,61,0,0,1,1
10901381,10901385,4,1,0,0,1
10901386,10901561,175,0,0,1,1
10901562,10902123,561,1,0,0,1
10901572,10902163,591,1,0,0,2
10901602,10902076,474,0,1,0,1
10901605,10902087,482,0,1,0,2
10902124,10902387,263,0,0,1,1
10902164,10902389,225,0,0,1,2
10902388,10902434,46,1,0,0,1
10902390,10902433,43,1,0,0,2
10902434,10902872,438,0,0,1,2
10902435,10902869,434,0,0,1,1
10902870,10902955,85,1,0,0,1
10902873,10902955,82,1,0,0,2
10902956,10903041,85,0,0,1,1
10902956,10903042,86,0,0,1,2
10903042,10903066,24,1,0,0,1
10903043,10903065,22,1,0,0,2
10903066,10904160,1094,0,0,1,2
10903067,10904161,1094,0,0,1,1
10904161,10904210,49,1,0,0,2
10904162,10904214,52,1,0,0,1
10904211,10906236,2025,0,0,1,2
10904215,10906228,2013,0,0,1,1
10906229,10906718,489,1,0,0,1
10906237,10906748,511,1,0,0,2
10906259,10906704,445,0,1,0,1
10906268,10906676,408,0,1,0,2
10906719,10907624,905,0,0,1,1
10906749,10907623,874,0,0,1,2
10907624,10907673,49,1,0,0,2
10907625,10907672,47,1,0,0,1
10907673,10907743,70,0,0,1,1
10907674,10907743,69,0,0,1,2
10907744,10907774,30,1,0,0,2
10907744,10907775,31,1,0,0,1
10907775,10907945,170,0,0,1,2
10907776,10907938,162,0,0,1,1
10907939,10907953,14,1,0,0,1
10907946,10907955,9,1,0,0,2
10907954,10909120,1166,0,0,1,1
10907956,10909121,1165,0,0,1,2
10909121,10909160,39,1,0,0,1
10909122,10909160,38,1,0,0,2
10909161,10909844,683,0,0,1,1
10909161,10909844,683,0,0,1,2
10909845,10909856,11,1,0,0,1
10909845,10909857,12,1,0,0,2
10909857,10910213,356,0,0,1,1
10909858,10910230,372,0,0,1,2
10910214,10910694,480,1,0,0,1
10910231,10910703,472,1,0,0,2
10910252,10910667,415,0,1,0,1
10910255,10910663,408,0,1,0,2
10910695,10911394,699,0,0,1,1
10910704,10911394,690,0,0,1,2
10911395,10911450,55,1,0,0,2
10911395,10911451,56,1,0,0,1
10911451,10911805,354,0,0,1,2
10911452,10911806,354,0,0,1,1
10911806,10911852,46,1,0,0,2
10911807,10911851,44,1,0,0,1
10911852,10912223,371,0,0,1,1
10911853,10912223,370,0,0,1,2
10912224,10912267,43,1,0,0,1
10912224,10912268,44,1,0,0,2
10912268,10912953,685,0,0,1,1
10912269,10912954,685,0,0,1,2
10912954,10913013,59,1,0,0,1
10912955,10913013,58,1,0,0,2
10913014,10913149,135,0,0,1,1
10913014,10913149,135,0,0,1,2
10913150,10913174,24,1,0,0,2
10913150,10913233,83,1,0,0,1
10913175,10914249,1074,0,0,1,2
10913234,10913742,508,0,0,1,1
10913743,10913845,102,1,0,0,1
10913846,10914007,161,0,0,1,1
10914008,10914033,25,1,0,0,1
10914034,10914138,104,0,0,1,1
10914139,10914152,13,1,0,0,1
10914153,10914249,96,0,0,1,1
10914250,10914293,43,1,0,0,2
10914250,10914320,70,1,0,0,1
10914274,10914274,0,0,1,0,1
10914294,10914512,218,0,0,1,2
10914321,10914513,192,0,0,1,1
10914513,10914533,20,1,0,0,2
10914514,10914543,29,1,0,0,1
10914534,10914826,292,0,0,1,2
10914544,10914785,241,0,0,1,1
10914786,10915247,461,1,0,0,1
10914815,10915236,421,0,1,0,1
10914827,10915086,259,1,0,0,2
10914851,10915075,224,0,1,0,2
10915087,10916381,1294,0,0,1,2
10915248,10916363,1115,0,0,1,1
10916364,10916726,362,1,0,0,1
10916382,10916716,334,1,0,0,2
10916398,10916675,277,0,1,0,1
10916405,10916652,247,0,1,0,2
10916717,10917128,411,0,0,1,2
10916727,10917128,401,0,0,1,1
10917129,10917190,61,1,0,0,1
10917129,10917195,66,1,0,0,2
10917191,10917548,357,0,0,1,1
10917196,10917549,353,0,0,1,2
10917549,10917641,92,1,0,0,1
10917550,10917612,62,1,0,0,2
10917613,10917715,102,0,0,1,2
10917642,10917717,75,0,0,1,1
10917716,10917737,21,1,0,0,2
10917718,10917747,29,1,0,0,1
10917738,10917816,78,0,0,1,2
10917748,10917807,59,0,0,1,1
10917808,10917847,39,1,0,0,1
10917817,10917829,12,1,0,0,2
10917830,10919125,1295,0,0,1,2
10917848,10918489,641,0,0,1,1
10918490,10918506,16,1,0,0,1
10918507,10919124,617,0,0,1,1
10919125,10919173,48,1,0,0,1
10919126,10919172,46,1,0,0,2
10919173,10919280,107,0,0,1,2
10919174,10919276,102,0,0,1,1
10919277,10919311,34,1,0,0,1
10919281,10919309,28,1,0,0,2
10919310,10921134,1824,0,0,1,2
10919312,10919730,418,0,0,1,1
10919731,10919804,73,1,0,0,1
10919805,10921032,1227,0,0,1,1
10921043,10921102,59,0,1,0,1
10921112,10921610,498,1,0,0,1
10921135,10921486,351,1,0,0,2
10921161,10921599,438,0,1,0,1
10921167,10921428,261,0,1,0,2
10921487,10921955,468,0,0,1,2
10921611,10921956,345,0,0,1,1
10921956,10922034,78,1,0,0,2
10921957,10922026,69,1,0,0,1
10922027,10922931,904,0,0,1,1
10922035,10922930,895,0,0,1,2
10922931,10923008,77,1,0,0,2
10922932,10923013,81,1,0,0,1
10923009,10923044,35,0,0,1,2
10923014,10923044,30,0,0,1,1
10923045,10923069,24,1,0,0,2
10923045,10923071,26,1,0,0,1
10923070,10923248,178,0,0,1,2
10923072,10923257,185,0,0,1,1
10923249,10923269,20,1,0,0,2
10923258,10923269,11,1,0,0,1
10923270,10924932,1662,0,0,1,2
10923270,10924936,1666,0,0,1,1
10924933,10925063,130,1,0,0,2
10924937,10925021,84,1,0,0,1
10925022,10925127,105,0,0,1,1
10925064,10925124,60,0,0,1,2
10925125,10925144,19,1,0,0,2
10925128,10925143,15,1,0,0,1
10925144,10926716,1572,0,0,1,1
10925145,10926709,1564,0,0,1,2
10926710,10927265,555,1,0,0,2
10926717,10927293,576,1,0,0,1
10926810,10927224,414,0,1,0,1
10926812,10927220,408,0,1,0,2
10927266,10927567,301,0,0,1,2
10927294,10927567,273,0,0,1,1
10927568,10927617,49,1,0,0,2
10927568,10927623,55,1,0,0,1
10927618,10928893,1275,0,0,1,2
10927624,10928896,1272,0,0,1,1
10928894,10928973,79,1,0,0,2
10928897,10928995,98,1,0,0,1
10928974,10929103,129,0,0,1,2
10928996,10929103,107,0,0,1,1
10929104,10929123,19,1,0,0,1
10929104,10929123,19,1,0,0,2
10929124,10929599,475,0,0,1,1
10929124,10929601,477,0,0,1,2
10929600,10929616,16,1,0,0,1
10929602,10929616,14,1,0,0,2
10929617,10929797,180,0,0,1,1
10929617,10930213,596,0,0,1,2
10929798,10929803,5,1,0,0,1
10929804,10930215,411,0,0,1,1
10930214,10930261,47,1,0,0,2
10930216,10930254,38,1,0,0,1
10930255,10930404,149,0,0,1,1
10930262,10930400,138,0,0,1,2
10930401,10930424,23,1,0,0,2
10930405,10930422,17,1,0,0,1
10930423,10931012,589,0,0,1,1
10930425,10931016,591,0,0,1,2
10931013,10931247,234,1,0,0,1
10931017,10931276,259,1,0,0,2
10931039,10931212,173,0,1,0,1
10931042,10931214,172,0,1,0,2
10931248,10931425,177,0,0,1,1
10931277,10932205,928,0,0,1,2
10931426,10931435,9,1,0,0,1
10931436,10932200,764,0,0,1,1
10932201,10932760,559,1,0,0,1
10932206,10932844,638,1,0,0,2
10932239,10932714,475,0,1,0,1
10932239,10932721,482,0,1,0,2
10932761,10932788,27,0,0,1,1
10932789,10932799,10,1,0,0,1
10932800,10932948,148,0,0,1,1
10932845,10932874,29,0,0,1,2
10932875,10932884,9,1,0,0,2
10932885,10932949,64,0,0,1,2
10932949,10933246,297,1,0,0,1
10932950,10933240,290,1,0,0,2
10932971,10933203,232,0,1,0,1
10932974,10933188,214,0,1,0,2
10933241,10933541,300,0,0,1,2
10933247,10933541,294,0,0,1,1
10933542,10933591,49,1,0,0,1
10933542,10933591,49,1,0,0,2
10933592,10933689,97,0,0,1,2
10933592,10933690,98,0,0,1,1
10933690,10933721,31,1,0,0,2
10933691,10933719,28,1,0,0,1
10933720,10933783,63,0,0,1,1
10933722,10933780,58,0,0,1,2
10933781,10933811,30,1,0,0,2
10933784,10933811,27,1,0,0,1
10933812,10934435,623,0,0,1,1
10933812,10934441,629,0,0,1,2
10934436,10934600,164,1,0,0,1
10934442,10934591,149,1,0,0,2
10934465,10934549,84,0,1,0,1
10934468,10934535,67,0,1,0,2
10934592,10934709,117,0,0,1,2
10934601,10934712,111,0,0,1,1
10934710,10934732,22,1,0,0,2
10934713,10934732,19,1,0,0,1
10934733,10935240,507,0,0,1,1
10934733,10935242,509,0,0,1,2
10935241,10935295,54,1,0,0,1
10935243,10935295,52,1,0,0,2
10935296,10935571,275,0,0,1,2
10935296,10936954,1658,0,0,1,1
10935572,10935585,13,1,0,0,2
10935586,10936953,1367,0,0,1,2
10936954,10937194,240,1,0,0,2
10936955,10937200,245,1,0,0,1
10936992,10937121,129,0,1,0,2
10936996,10937104,108,0,1,0,1
10937195,10937430,235,0,0,1,2
10937201,10937432,231,0,0,1,1
10937431,10937495,64,1,0,0,2
10937433,10937496,63,1,0,0,1
10937496,10937827,331,0,0,1,2
10937497,10937829,332,0,0,1,1
10937828,10937890,62,1,0,0,2
10937830,10937891,61,1,0,0,1
10937891,10937978,87,0,0,1,2
10937892,10937976,84,0,0,1,1
10937977,10938221,244,1,0,0,1
10937979,10938254,275,1,0,0,2
10938004,10938176,172,0,1,0,2
10938006,10938170,164,0,1,0,1
10938194,10938196,2,0,1,0,1
10938222,10939176,954,0,0,1,1
10938255,10939175,920,0,0,1,2
10939176,10939199,23,1,0,0,2
10939177,10939198,21,1,0,0,1
10939199,10940020,821,0,0,1,1
10939200,10940022,822,0,0,1,2
10940021,10940276,255,1,0,0,1
10940023,10940271,248,1,0,0,2
10940041,10940184,143,0,1,0,2
10940044,10940195,151,0,1,0,1
10940272,10940453,181,0,0,1,2
10940277,10940453,176,0,0,1,1
10940454,10940507,53,1,0,0,2
10940454,10940508,54,1,0,0,1
10940508,10940604,96,0,0,1,2
10940509,10940605,96,0,0,1,1
10940605,10940640,35,1,0,0,2
10940606,10940638,32,1,0,0,1
10940639,10940700,61,0,0,1,1
10940641,10940699,58,0,0,1,2
10940700,10940731,31,1,0,0,2
10940701,10940723,22,1,0,0,1
10940724,10942242,1518,0,0,1,1
10940732,10942238,1506,0,0,1,2
10942239,10942702,463,1,0,0,2
10942243,10942710,467,1,0,0,1
10942279,10942613,334,0,1,0,2
10942280,10942634,354,0,1,0,1
10942703,10942925,222,0,0,1,2
10942711,10942925,214,0,0,1,1
10942926,10942986,60,1,0,0,2
10942926,10942987,61,1,0,0,1
10942987,10943517,530,0,0,1,2
10942988,10943516,528,0,0,1,1
10943517,10943577,60,1,0,0,1
10943518,10943569,51,1,0,0,2
10943570,10943740,170,0,0,1,2
10943578,10943740,162,0,0,1,1
10943741,10943758,17,1,0,0,1
10943741,10943760,19,1,0,0,2
10943759,10944390,631,0,0,1,1
10943761,10944398,637,0,0,1,2
10944391,10944670,279,1,0,0,1
10944399,10944689,290,1,0,0,2
10944412,10944661,249,0,1,0,1
10944426,10944639,213,0,1,0,2
10944671,10944703,32,0,0,1,1
10944690,10945246,556,0,0,1,2
10944704,10944758,54,1,0,0,1
10944738,10944749,11,0,1,0,1
10944759,10945247,488,0,0,1,1
10945247,10945289,42,1,0,0,2
10945248,10945303,55,1,0,0,1
10945290,10945483,193,0,0,1,2
10945304,10945483,179,0,0,1,1
10945484,10945503,19,1,0,0,2
10945484,10945504,20,1,0,0,1
10945504,10947324,1820,0,0,1,2
10945505,10947320,1815,0,0,1,1
10947321,10947739,418,1,0,0,1
10947325,10947749,424,1,0,0,2
10947343,10947710,367,0,1,0,1
10947352,10947686,334,0,1,0,2
10947740,10948107,367,0,0,1,1
10947750,10948108,358,0,0,1,2
10948108,10948171,63,1,0,0,1
10948109,10948171,62,1,0,0,2
10948172,10948880,708,0,0,1,1
10948172,10948881,709,0,0,1,2
10948881,10948931,50,1,0,0,1
10948882,10948936,54,1,0,0,2
10948932,10949142,210,0,0,1,1
10948937,10949139,202,0,0,1,2
10949140,10949189,49,1,0,0,2
10949143,10949191,48,1,0,0,1
10949190,10949320,130,0,0,1,2
10949192,10949321,129,0,0,1,1
10949321,10949342,21,1,0,0,2
10949322,10949341,19,1,0,0,1
10949342,10950060,718,0,0,1,1
10949343,10950065,722,0,0,1,2
10950061,10950403,342,1,0,0,1
10950066,10950399,333,1,0,0,2
10950087,10950297,210,0,1,0,2
10950088,10950307,219,0,1,0,1
10950330,10950333,3,0,1,0,1
10950400,10950472,72,0,0,1,2
10950404,10950472,68,0,0,1,1
10950473,10950523,50,1,0,0,2
10950473,10950530,57,1,0,0,1
10950524,10950664,140,0,0,1,2
10950531,10950664,133,0,0,1,1
10950665,10950695,30,1,0,0,2
10950665,10950706,41,1,0,0,1
10950696,10952431,1735,0,0,1,2
10950707,10952416,1709,0,0,1,1
10952417,10952910,493,1,0,0,1
10952432,10952854,422,1,0,0,2
10952434,10952435,1,0,1,0,1
10952458,10952837,379,0,1,0,2
10952464,10952820,356,0,1,0,1
10952854,10952899,45,0,1,0,1
10952855,10953301,446,0,0,1,2
10952911,10953303,392,0,0,1,1
10953302,10953353,51,1,0,0,2
10953304,10953353,49,1,0,0,1
10953354,10953563,209,0,0,1,1
10953354,10953563,209,0,0,1,2
10953564,10953588,24,1,0,0,2
10953564,10953590,26,1,0,0,1
10953589,10954746,1157,0,0,1,2
10953591,10954745,1154,0,0,1,1
10954746,10954787,41,1,0,0,1
10954747,10954788,41,1,0,0,2
10954788,10954955,167,0,0,1,1
10954789,10954954,165,0,0,1,2
10954955,10954977,22,1,0,0,2
10954956,10954977,21,1,0,0,1
10954978,10956829,1851,0,0,1,2
10954978,10956833,1855,0,0,1,1
10956830,10957231,401,1,0,0,2
10956834,10957271,437,1,0,0,1
10956859,10957193,334,0,1,0,2
10956863,10957190,327,0,1,0,1
10957232,10957265,33,0,0,1,2
10957266,10957307,41,1,0,0,2
10957272,10958189,917,0,0,1,1
10957308,10958187,879,0,0,1,2
10958188,10958238,50,1,0,0,2
10958190,10958238,48,1,0,0,1
10958239,10958327,88,0,0,1,1
10958239,10958699,460,0,0,1,2
10958328,10958344,16,1,0,0,1
10958345,10958457,112,0,0,1,1
10958458,10958546,88,1,0,0,1
10958547,10958614,67,0,0,1,1
10958615,10958647,32,1,0,0,1
10958648,10958797,149,0,0,1,1
10958700,10958903,203,1,0,0,2
10958798,10958832,34,1,0,0,1
10958833,10959047,214,0,0,1,1
10958904,10958945,41,0,0,1,2
10958946,10959585,639,1,0,0,2
10959048,10959075,27,1,0,0,1
10959076,10959719,643,0,0,1,1
10959586,10959720,134,0,0,1,2
10959720,10959758,38,1,0,0,1
10959721,10959759,38,1,0,0,2
10959759,10961799,2040,0,0,1,1
10959760,10960414,654,0,0,1,2
10960415,10960430,15,1,0,0,2
10960431,10960464,33,0,0,1,2
10960465,10960483,18,1,0,0,2
10960484,10960542,58,0,0,1,2
10960543,10960591,48,1,0,0,2
10960592,10960902,310,0,0,1,2
10960903,10960913,10,1,0,0,2
10960914,10961022,108,0,0,1,2
10961023,10961205,182,1,0,0,2
10961206,10961332,126,0,0,1,2
10961333,10961339,6,1,0,0,2
10961340,10961783,443,0,0,1,2
10961784,10962436,652,1,0,0,2
10961800,10962435,635,1,0,0,1
10961825,10962416,591,0,1,0,1
10961828,10962384,556,0,1,0,2
10962436,10962692,256,0,0,1,1
10962437,10962472,35,0,0,1,2
10962473,10962654,181,1,0,0,2
10962655,10962696,41,0,0,1,2
10962693,10962754,61,1,0,0,1
10962697,10962745,48,1,0,0,2
10962746,10963512,766,0,0,1,2
10962755,10963514,759,0,0,1,1
10963513,10963568,55,1,0,0,2
10963515,10963711,196,1,0,0,1
10963569,10963689,120,0,0,1,2
10963690,10963708,18,1,0,0,2
10963709,10964648,939,0,0,1,2
10963712,10964049,337,0,0,1,1
10964050,10964090,40,1,0,0,1
10964091,10964185,94,0,0,1,1
10964186,10964270,84,1,0,0,1
10964271,10964416,145,0,0,1,1
10964417,10964468,51,1,0,0,1
10964469,10964635,166,0,0,1,1
10964636,10964703,67,1,0,0,1
10964649,10964706,57,1,0,0,2
10964704,10964901,197,0,0,1,1
10964707,10964737,30,0,0,1,2
10964738,10964802,64,1,0,0,2
10964803,10964837,34,0,0,1,2
10964838,10965211,373,1,0,0,2
10964902,10964990,88,1,0,0,1
10964991,10966695,1704,0,0,1,1
10965212,10966677,1465,0,0,1,2
10966678,10967161,483,1,0,0,2
10966696,10967083,387,1,0,0,1
10966717,10967073,356,0,1,0,1
10966719,10967053,334,0,1,0,2
10967084,10967122,38,0,0,1,1
10967123,10967170,47,1,0,0,1
10967162,10967233,71,0,0,1,2
10967171,10967474,303,0,0,1,1
10967234,10967830,596,1,0,0,2
10967475,10967518,43,1,0,0,1
10967519,10967912,393,0,0,1,1
10967831,10967911,80,0,0,1,2
10967912,10967962,50,1,0,0,2
10967913,10967964,51,1,0,0,1
10967963,10968052,89,0,0,1,2
10967965,10968052,87,0,0,1,1
10968053,10968079,26,1,0,0,1
10968053,10968079,26,1,0,0,2
10968080,10968130,50,0,0,1,1
10968080,10968131,51,0,0,1,2
10968131,10968162,31,1,0,0,1
10968132,10968154,22,1,0,0,2
10968155,10968359,204,0,0,1,2
10968163,10968356,193,0,0,1,1
10968357,10968375,18,1,0,0,1
10968360,10968374,14,1,0,0,2
10968375,10968958,583,0,0,1,2
10968376,10968957,581,0,0,1,1
10968958,10969204,246,1,0,0,1
10968959,10969211,252,1,0,0,2
10968982,10969155,173,0,1,0,2
10968983,10969153,170,0,1,0,1
10969205,10969528,323,0,0,1,1
10969212,10969528,316,0,0,1,2
10969529,10969578,49,1,0,0,2
10969529,10969581,52,1,0,0,1
10969579,10971635,2056,0,0,1,2
10969582,10971630,2048,0,0,1,1
10971631,10971948,317,1,0,0,1
10971636,10971952,316,1,0,0,2
10971660,10971866,206,0,1,0,2
10971663,10971873,210,0,1,0,1
10971949,10972199,250,0,0,1,1
10971953,10972199,246,0,0,1,2
10972200,10972253,53,1,0,0,1
10972200,10972256,56,1,0,0,2
10972254,10972781,527,0,0,1,1
10972257,10972781,524,0,0,1,2
10972782,10972830,48,1,0,0,1
10972782,10972830,48,1,0,0,2
10972831,10973189,358,0,0,1,2
10972831,10973190,359,0,0,1,1
10973190,10973251,61,1,0,0,2
10973191,10973261,70,1,0,0,1
10973252,10973318,66,0,0,1,2
10973262,10973356,94,0,0,1,1
10973319,10973405,86,1,0,0,2
10973357,10973396,39,1,0,0,1
10973397,10973446,49,0,0,1,1
10973406,10973446,40,0,0,1,2
10973447,10973465,18,1,0,0,1
10973447,10973470,23,1,0,0,2
10973466,10973774,308,0,0,1,1
10973471,10973577,106,0,0,1,2
10973578,10973712,134,1,0,0,2
10973713,10973743,30,0,0,1,2
10973744,10973778,34,1,0,0,2
10973775,10973845,70,1,0,0,1
10973779,10974016,237,0,0,1,2
10973846,10973973,127,0,0,1,1
10973974,10974042,68,1,0,0,1
10974017,10974080,63,1,0,0,2
10974043,10974074,31,0,0,1,1
10974075,10974216,141,1,0,0,1
10974081,10974120,39,0,0,1,2
10974121,10974139,18,1,0,0,2
10974140,10974305,165,0,0,1,2
10974217,10974308,91,0,0,1,1
10974306,10974359,53,1,0,0,2
10974309,10974359,50,1,0,0,1
10974360,10975069,709,0,0,1,2
10974360,10975074,714,0,0,1,1
10975070,10975088,18,1,0,0,2
10975075,10975087,12,1,0,0,1
10975088,10976405,1317,0,0,1,1
10975089,10976396,1307,0,0,1,2
10976397,10977035,638,1,0,0,2
10976406,10977102,696,1,0,0,1
10976424,10977044,620,0,1,0,1
10976433,10977026,593,0,1,0,2
10977036,10977645,609,0,0,1,2
10977103,10977644,541,0,0,1,1
10977645,10977805,160,1,0,0,1
10977646,10977749,103,1,0,0,2
10977750,10977779,29,0,0,1,2
10977780,10977807,27,1,0,0,2
10977806,10977954,148,0,0,1,1
10977808,10977956,148,0,0,1,2
10977955,10977978,23,1,0,0,1
10977957,10977977,20,1,0,0,2
10977978,10979014,1036,0,0,1,2
10977979,10979014,1035,0,0,1,1
10979015,10979064,49,1,0,0,2
10979015,10979067,52,1,0,0,1
10979065,10979203,138,0,0,1,2
10979068,10979202,134,0,0,1,1
10979203,10979226,23,1,0,0,1
10979204,10979226,22,1,0,0,2
10979227,10981158,1931,0,0,1,1
10979227,10981161,1934,0,0,1,2
10981159,10981751,592,1,0,0,1
10981162,10981718,556,1,0,0,2
10981188,10981707,519,0,1,0,2
10981196,10981698,502,0,1,0,1
10981719,10982643,924,0,0,1,2
10981752,10982644,892,0,0,1,1
10982644,10982698,54,1,0,0,2
10982645,10982706,61,1,0,0,1
10982699,10982805,106,0,0,1,2
10982707,10982807,100,0,0,1,1
10982806,10982836,30,1,0,0,2
10982808,10982837,29,1,0,0,1
10982837,10983170,333,0,0,1,2
10982838,10984132,1294,0,0,1,1
10983171,10983291,120,1,0,0,2
10983292,10983678,386,0,0,1,2
10983679,10983699,20,1,0,0,2
10983700,10983929,229,0,0,1,2
10983930,10983962,32,1,0,0,2
10983963,10984201,238,0,0,1,2
10984133,10984262,129,1,0,0,1
10984202,10984260,58,1,0,0,2
10984261,10984478,217,0,0,1,2
10984263,10984478,215,0,0,1,1
10984479,10984511,32,1,0,0,1
10984479,10984511,32,1,0,0,2
10984512,10986540,2028,0,0,1,1
10984512,10986541,2029,0,0,1,2
10986541,10987190,649,1,0,0,1
10986542,10987156,614,1,0,0,2
10986578,10987169,591,0,1,0,1
10986581,10987137,556,0,1,0,2
10987157,10987627,470,0,0,1,2
10987191,10987626,435,0,0,1,1
10987627,10987673,46,1,0,0,1
10987628,10987674,46,1,0,0,2
10987674,10988055,381,0,0,1,1
10987675,10988054,379,0,0,1,2
10988055,10988099,44,1,0,0,2
10988056,10988100,44,1,0,0,1
10988100,10988498,398,0,0,1,2
10988101,10988498,397,0,0,1,1
10988499,10988562,63,1,0,0,1
10988499,10988562,63,1,0,0,2
10988563,10988599,36,0,0,1,2
10988563,10988600,37,0,0,1,1
10988600,10988629,29,1,0,0,2
10988601,10988628,27,1,0,0,1
10988629,10988777,148,0,0,1,1
10988630,10988778,148,0,0,1,2
10988778,10988797,19,1,0,0,1
10988779,10988797,18,1,0,0,2
10988798,10990195,1397,0,0,1,1
10988798,10990195,1397,0,0,1,2
10990196,10990250,54,1,0,0,2
10990196,10990251,55,1,0,0,1
10990251,10992255,2004,0,0,1,2
10990252,10992246,1994,0,0,1,1
10992247,10992612,365,1,0,0,1
10992256,10992620,364,1,0,0,2
10992305,10992510,205,0,1,0,2
10992305,10992519,214,0,1,0,1
10992613,10992872,259,0,0,1,1
10992621,10992871,250,0,0,1,2
10992872,10993078,206,1,0,0,2
10992873,10993071,198,1,0,0,1
10992906,10993014,108,0,1,0,1
10992907,10993005,98,0,1,0,2
10993072,10994015,943,0,0,1,1
10993079,10994012,933,0,0,1,2
10994013,10994059,46,1,0,0,2
10994016,10994057,41,1,0,0,1
10994058,10994200,142,0,0,1,1
10994060,10994200,140,0,0,1,2
10994201,10994221,20,1,0,0,2
10994201,10994223,22,1,0,0,1
10994222,10995162,940,0,0,1,2
10994224,10995162,938,0,0,1,1
10995163,10995204,41,1,0,0,2
10995163,10995205,42,1,0,0,1
10995205,10995478,273,0,0,1,2
10995206,10995478,272,0,0,1,1
10995479,10995498,19,1,0,0,1
10995479,10995499,20,1,0,0,2
10995499,10997220,1721,0,0,1,1
10995500,10997225,1725,0,0,1,2
10997221,10997767,546,1,0,0,1
10997226,10997762,536,1,0,0,2
10997268,10997713,445,0,1,0,2
10997273,10997717,444,0,1,0,1
10997763,10998169,406,0,0,1,2
10997768,10998172,404,0,0,1,1
10998170,10998216,46,1,0,0,2
10998173,10998216,43,1,0,0,1
10998217,10998430,213,0,0,1,2
10998217,10998432,215,0,0,1,1
10998431,10998470,39,1,0,0,2
10998433,10998470,37,1,0,0,1
10998471,10999574,1103,0,0,1,1
10998471,10999574,1103,0,0,1,2
10999575,10999658,83,1,0,0,2
10999575,10999660,85,1,0,0,1
10999659,10999778,119,0,0,1,2
10999661,10999778,117,0,0,1,1
10999779,10999802,23,1,0,0,2
10999779,10999815,36,1,0,0,1
10999803,11000966,1163,0,0,1,2
10999816,11000964,1148,0,0,1,1
11000965,11001015,50,1,0,0,1
11000967,11001017,50,1,0,0,2
11001016,11003042,2026,0,0,1,1
11001018,11003045,2027,0,0,1,2
11003043,11003535,492,1,0,0,1
11003046,11003539,493,1,0,0,2
11003070,11003516,446,0,1,0,2
11003072,11003516,444,0,1,0,1
11003536,11003867,331,0,0,1,1
11003540,11003867,327,0,0,1,2
11003868,11003918,50,1,0,0,2
11003868,11003919,51,1,0,0,1
11003919,11004294,375,0,0,1,2
11003920,11004293,373,0,0,1,1
11004294,11004342,48,1,0,0,1
11004295,11004346,51,1,0,0,2
11004343,11004653,310,0,0,1,1
11004347,11004652,305,0,0,1,2
11004653,11004683,30,1,0,0,2
11004654,11004682,28,1,0,0,1
11004683,11004863,180,0,0,1,1
11004684,11004863,179,0,0,1,2
11004864,11004890,26,1,0,0,2
11004864,11004891,27,1,0,0,1
11004891,11005045,154,0,0,1,2
11004892,11005047,155,0,0,1,1
11005046,11005396,350,1,0,0,2
11005048,11005415,367,1,0,0,1
11005076,11005337,261,0,1,0,2
11005076,11005348,272,0,1,0,1
11005397,11005564,167,0,0,1,2
11005416,11005565,149,0,0,1,1
11005565,11005592,27,1,0,0,2
11005566,11005597,31,1,0,0,1
11005593,11005821,228,0,0,1,2
11005598,11005821,223,0,0,1,1
11049550,11049809,259,0,0,1,1
11049550,11049810,260,0,0,1,2
11049810,11049894,84,1,0,0,1
11049811,11049891,80,1,0,0,2
11049892,11049928,36,0,0,1,2
11049895,11049927,32,0,0,1,1
11049928,11049967,39,1,0,0,1
11049929,11049956,27,1,0,0,2
11049957,11050009,52,0,0,1,2
11049968,11050012,44,0,0,1,1
11050010,11050035,25,1,0,0,2
11050013,11050051,38,1,0,0,1
11050036,11050132,96,0,0,1,2
11050052,11050134,82,0,0,1,1
11050133,11050154,21,1,0,0,2
11050135,11050154,19,1,0,0,1
11050155,11050237,82,0,0,1,1
11050155,11050239,84,0,0,1,2
11050238,11051595,1357,1,0,0,1
11050240,11051589,1349,1,0,0,2
11050262,11051558,1296,0,1,0,2
11050263,11051584,1321,0,1,0,1
11051590,11051691,101,0,0,1,2
11051596,11051692,96,0,0,1,1
11051692,11051723,31,1,0,0,2
11051693,11051721,28,1,0,0,1
11051722,11051946,224,0,0,1,1
11051724,11051946,222,0,0,1,2
11051947,11051966,19,1,0,0,1
11051947,11051967,20,1,0,0,2
11051967,11053059,1092,0,0,1,1
11051968,11053056,1088,0,0,1,2
11053057,11053144,87,1,0,0,2
11053060,11053145,85,1,0,0,1
11053145,11053530,385,0,0,1,2
11053146,11053530,384,0,0,1,1
11053531,11053584,53,1,0,0,1
11053531,11053586,55,1,0,0,2
11053585,11053682,97,0,0,1,1
11053587,11053682,95,0,0,1,2
11053683,11053705,22,1,0,0,1
11053683,11053705,22,1,0,0,2
11053706,11054567,861,0,0,1,1
11053706,11054567,861,0,0,1,2
11054568,11054635,67,1,0,0,2
11054568,11054636,68,1,0,0,1
11054636,11055014,378,0,0,1,2
11054637,11055015,378,0,0,1,1
11055015,11055101,86,1,0,0,2
11055016,11055100,84,1,0,0,1
11055101,11055149,48,0,0,1,1
11055102,11055150,48,0,0,1,2
11055150,11055176,26,1,0,0,1
11055151,11055183,32,1,0,0,2
11055177,11055319,142,0,0,1,1
11055184,11055318,134,0,0,1,2
11055319,11055332,13,1,0,0,2
11055320,11055328,8,1,0,0,1
11055329,11055974,645,0,0,1,1
11055333,11055971,638,0,0,1,2
11055972,11056255,283,1,0,0,2
11055975,11056239,264,1,0,0,1
11056037,11056201,164,0,1,0,2
11056044,11056198,154,0,1,0,1
11056240,11056405,165,0,0,1,1
11056256,11056403,147,0,0,1,2
11056404,11056477,73,1,0,0,2
11056406,11056487,81,1,0,0,1
11056478,11056585,107,0,0,1,2
11056488,11056586,98,0,0,1,1
11056586,11056613,27,1,0,0,2
11056587,11056616,29,1,0,0,1
11056614,11057377,763,0,0,1,2
11056617,11057372,755,0,0,1,1
11057373,11057450,77,1,0,0,1
11057378,11057451,73,1,0,0,2
11057451,11057873,422,0,0,1,1
11057452,11057871,419,0,0,1,2
11057872,11057939,67,1,0,0,2
11057874,11057941,67,1,0,0,1
11057940,11058112,172,0,0,1,2
11057942,11058110,168,0,0,1,1
11058111,11058134,23,1,0,0,1
11058113,11058132,19,1,0,0,2
11058133,11059038,905,0,0,1,2
11058135,11059036,901,0,0,1,1
11059037,11059125,88,1,0,0,1
11059039,11059111,72,1,0,0,2
11059112,11059310,198,0,0,1,2
11059126,11059310,184,0,0,1,1
11059311,11059370,59,1,0,0,1
11059311,11059370,59,1,0,0,2
11059371,11059466,95,0,0,1,2
11059371,11059467,96,0,0,1,1
11059467,11059511,44,1,0,0,2
11059468,11059511,43,1,0,0,1
11059512,11059593,81,0,0,1,2
11059512,11059596,84,0,0,1,1
11059594,11059620,26,1,0,0,2
11059597,11059621,24,1,0,0,1
11059621,11059691,70,0,0,1,2
11059622,11059691,69,0,0,1,1
11059692,11059710,18,1,0,0,2
11059692,11059712,20,1,0,0,1
11059711,11060041,330,0,0,1,2
11059713,11060037,324,0,0,1,1
11060038,11060333,295,1,0,0,1
11060042,11060301,259,1,0,0,2
11060067,11060237,170,0,1,0,1
11060067,11060249,182,0,1,0,2
11060302,11060637,335,0,0,1,2
11060334,11060636,302,0,0,1,1
11060637,11060680,43,1,0,0,1
11060638,11060673,35,1,0,0,2
11060674,11061035,361,0,0,1,2
11060681,11061035,354,0,0,1,1
11061036,11061086,50,1,0,0,1
11061036,11061086,50,1,0,0,2
11061087,11061200,113,0,0,1,1
11061087,11061201,114,0,0,1,2
11061201,11061244,43,1,0,0,1
11061202,11061241,39,1,0,0,2
11061242,11061975,733,0,0,1,2
11061245,11061601,356,0,0,1,1
11061602,11061610,8,1,0,0,1
11061611,11061978,367,0,0,1,1
11061976,11062485,509,1,0,0,2
11061979,11062499,520,1,0,0,1
11062009,11062486,477,0,1,0,1
11062013,11062126,113,0,1,0,2
11062162,11062166,4,0,1,0,2
11062191,11062207,16,0,1,0,2
11062228,11062459,231,0,1,0,2
11062486,11062638,152,0,0,1,2
11062500,11062637,137,0,0,1,1
11062638,11062690,52,1,0,0,1
11062639,11062687,48,1,0,0,2
11062688,11063892,1204,0,0,1,2
11062691,11063145,454,0,0,1,1
11063146,11063171,25,1,0,0,1
11063172,11063269,97,0,0,1,1
11063270,11063283,13,1,0,0,1
11063284,11063861,577,0,0,1,1
11063862,11064164,302,1,0,0,1
11063893,11064131,238,1,0,0,2
11063916,11064102,186,0,1,0,1
11063918,11064087,169,0,1,0,2
11064132,11064341,209,0,0,1,2
11064165,11064340,175,0,0,1,1
11064341,11064415,74,1,0,0,1
11064342,11064410,68,1,0,0,2
11064411,11064460,49,0,0,1,2
11064416,11064461,45,0,0,1,1
11064461,11064487,26,1,0,0,2
11064462,11064487,25,1,0,0,1
11064488,11064543,55,0,0,1,1
11064488,11064544,56,0,0,1,2
11064544,11064575,31,1,0,0,1
11064545,11064574,29,1,0,0,2
11064575,11064645,70,0,0,1,2
11064576,11064643,67,0,0,1,1
11064644,11064664,20,1,0,0,1
11064646,11064665,19,1,0,0,2
11064665,11064846,181,0,0,1,1
11064666,11064847,181,0,0,1,2
11064847,11064858,11,1,0,0,1
11064848,11064852,4,1,0,0,2
11064853,11065920,1067,0,0,1,2
11064859,11065919,1060,0,0,1,1
11065920,11065965,45,1,0,0,1
11065921,11065964,43,1,0,0,2
11065965,11066998,1033,0,0,1,2
11065966,11066171,205,0,0,1,1
11066172,11066182,10,1,0,0,1
11066183,11066992,809,0,0,1,1
11066993,11067258,265,1,0,0,1
11066999,11067252,253,1,0,0,2
11067027,11067186,159,0,1,0,2
11067031,11067195,164,0,1,0,1
11067253,11067462,209,0,0,1,2
11067259,11067463,204,0,0,1,1
11067463,11067532,69,1,0,0,2
11067464,11067535,71,1,0,0,1
11067533,11067568,35,0,0,1,2
11067536,11067568,32,0,0,1,1
11067569,11067612,43,1,0,0,2
11067569,11067613,44,1,0,0,1
11067613,11067716,103,0,0,1,2
11067614,11067717,103,0,0,1,1
11067717,11067741,24,1,0,0,2
11067718,11067741,23,1,0,0,1
11067742,11068623,881,0,0,1,1
11067742,11068629,887,0,0,1,2
11068624,11068920,296,1,0,0,1
11068630,11068922,292,1,0,0,2
11068666,11068823,157,0,1,0,2
11068672,11068836,164,0,1,0,1
11068858,11068868,10,0,1,0,1
11068921,11069088,167,0,0,1,1
11068923,11069087,164,0,0,1,2
11069088,11069149,61,1,0,0,2
11069089,11069151,62,1,0,0,1
11069150,11069253,103,0,0,1,2
11069152,11069254,102,0,0,1,1
11069254,11069292,38,1,0,0,2
11069255,11069284,29,1,0,0,1
11069285,11070215,930,0,0,1,1
11069293,11070222,929,0,0,1,2
11070216,11070498,282,1,0,0,1
11070223,11070519,296,1,0,0,2
11070249,11070415,166,0,1,0,2
11070253,11070429,176,0,1,0,1
11070499,11070672,173,0,0,1,1
11070520,11070674,154,0,0,1,2
11070673,11072136,1463,1,0,0,1
11070675,11070763,88,1,0,0,2
11070764,11070790,26,0,0,1,2
11070791,11070837,46,1,0,0,2
11070809,11072126,1317,0,1,0,1
11070838,11070992,154,0,0,1,2
11070993,11071013,20,1,0,0,2
11071014,11071478,464,0,0,1,2
11071479,11072118,639,1,0,0,2
11071500,11071780,280,0,1,0,2
11071801,11072065,264,0,1,0,2
11072119,11072301,182,0,0,1,2
11072137,11072302,165,0,0,1,1
11072302,11072392,90,1,0,0,2
11072303,11072424,121,1,0,0,1
11072393,11072483,90,0,0,1,2
11072425,11072484,59,0,0,1,1
11072484,11072507,23,1,0,0,2
11072485,11072533,48,1,0,0,1
11072508,11072523,15,0,1,0,1
11072508,11072583,75,0,0,1,2
11072534,11072568,34,0,0,1,1
11072579,11072621,42,0,1,0,1
11072584,11072595,11,1,0,0,2
11072596,11073395,799,0,0,1,2
11072631,11072647,16,1,0,0,1
11072648,11072762,114,0,0,1,1
11072763,11073875,1112,1,0,0,1
11072776,11073864,1088,0,1,0,1
11073396,11073852,456,1,0,0,2
11073425,11073834,409,0,1,0,2
11073853,11073978,125,0,0,1,2
11073876,11073981,105,0,0,1,1
11073979,11074041,62,1,0,0,2
11073982,11074055,73,1,0,0,1
11074042,11074064,22,0,0,1,2
11074056,11074186,130,0,0,1,1
11074065,11074072,7,1,0,0,2
11074073,11074188,115,0,0,1,2
11074187,11074207,20,1,0,0,1
11074189,11074208,19,1,0,0,2
11074208,11075664,1456,0,0,1,1
11074209,11075663,1454,0,0,1,2
11075664,11075708,44,1,0,0,2
11075665,11075707,42,1,0,0,1
11075708,11075777,69,0,0,1,1
11075709,11075777,68,0,0,1,2
11075778,11075800,22,1,0,0,1
11075778,11075808,30,1,0,0,2
11075801,11075985,184,0,0,1,1
11075809,11075987,178,0,0,1,2
11075986,11076002,16,1,0,0,1
11075988,11076006,18,1,0,0,2
11076003,11076786,783,0,0,1,1
11076007,11076785,778,0,0,1,2
11076786,11077023,237,1,0,0,2
11076787,11076989,202,1,0,0,1
11076826,11076919,93,0,1,0,2
11076828,11076922,94,0,1,0,1
11076990,11077240,250,0,0,1,1
11077024,11077241,217,0,0,1,2
11077241,11077322,81,1,0,0,1
11077242,11077314,72,1,0,0,2
11077315,11077366,51,0,0,1,2
11077323,11077364,41,0,0,1,1
11077365,11077400,35,1,0,0,1
11077367,11077400,33,1,0,0,2
11077401,11077480,79,0,0,1,1
11077401,11077480,79,0,0,1,2
11077481,11077503,22,1,0,0,2
11077481,11077504,23,1,0,0,1
11077504,11078334,830,0,0,1,2
11077505,11078338,833,0,0,1,1
11078335,11078558,223,1,0,0,2
11078339,11078529,190,1,0,0,1
11078381,11078477,96,0,1,0,2
11078386,11078471,85,0,1,0,1
11078530,11078811,281,0,0,1,1
11078559,11078811,252,0,0,1,2
11078812,11078857,45,1,0,0,2
11078812,11078858,46,1,0,0,1
11078858,11079012,154,0,0,1,2
11078859,11079014,155,0,0,1,1
11079013,11079027,14,1,0,0,2
11079015,11079028,13,1,0,0,1
11079028,11080317,1289,0,0,1,2
11079029,11080319,1290,0,0,1,1
11080318,11080374,56,1,0,0,2
11080320,11080398,78,1,0,0,1
11080375,11080483,108,0,0,1,2
11080399,11080482,83,0,0,1,1
11080483,11080538,55,1,0,0,1
11080484,11080504,20,1,0,0,2
11080505,11080606,101,0,0,1,2
11080539,11080603,64,0,0,1,1
11080604,11080624,20,1,0,0,1
11080607,11080624,17,1,0,0,2
11080625,11081398,773,0,0,1,1
11080625,11081400,775,0,0,1,2
11081399,11081752,353,1,0,0,1
11081401,11081681,280,1,0,0,2
11081435,11081641,206,0,1,0,1
11081440,11081632,192,0,1,0,2
11081682,11081931,249,0,0,1,2
11081753,11081930,177,0,0,1,1
11081931,11082023,92,1,0,0,1
11081932,11082021,89,1,0,0,2
11082022,11082060,38,0,0,1,2
11082024,11082065,41,0,0,1,1
11082061,11082089,28,1,0,0,2
11082066,11082091,25,1,0,0,1
11082090,11082152,62,0,0,1,2
11082092,11082151,59,0,0,1,1
11082152,11082173,21,1,0,0,1
11082153,11082184,31,1,0,0,2
11082174,11082259,85,0,0,1,1
11082185,11082255,70,0,0,1,2
11082256,11082276,20,1,0,0,2
11082260,11082277,17,1,0,0,1
11082277,11083165,888,0,0,1,2
11082278,11083166,888,0,0,1,1
11083166,11083233,67,1,0,0,2
11083167,11083233,66,1,0,0,1
11083234,11083495,261,0,0,1,1
11083234,11083496,262,0,0,1,2
11083496,11083563,67,1,0,0,1
11083497,11083553,56,1,0,0,2
11083554,11083645,91,0,0,1,2
11083564,11083647,83,0,0,1,1
11083646,11083677,31,1,0,0,2
11083648,11083688,40,1,0,0,1
11083678,11084540,862,0,0,1,2
11083689,11084546,857,0,0,1,1
11084541,11084778,237,1,0,0,2
11084547,11084764,217,1,0,0,1
11084584,11084678,94,0,1,0,2
11084585,11084679,94,0,1,0,1
11084765,11084913,148,0,0,1,1
11084779,11084912,133,0,0,1,2
11084913,11084956,43,1,0,0,2
11084914,11084956,42,1,0,0,1
11084957,11085017,60,0,0,1,1
11084957,11085017,60,0,0,1,2
11085018,11085085,67,1,0,0,2
11085018,11085096,78,1,0,0,1
11085086,11085192,106,0,0,1,2
11085097,11085167,70,0,0,1,1
11085168,11085227,59,1,0,0,1
11085193,11085213,20,1,0,0,2
11085214,11086015,801,0,0,1,2
11085228,11085315,87,0,0,1,1
11085316,11085374,58,1,0,0,1
11085375,11085465,90,0,0,1,1
11085466,11085482,16,1,0,0,1
11085483,11085766,283,0,0,1,1
11085767,11085852,85,1,0,0,1
11085853,11086017,164,0,0,1,1
11086016,11086076,60,1,0,0,2
11086018,11086083,65,1,0,0,1
11086077,11086462,385,0,0,1,2
11086084,11086461,377,0,0,1,1
11086462,11086525,63,1,0,0,1
11086463,11086524,61,1,0,0,2
11086525,11087149,624,0,0,1,2
11086526,11087130,604,0,0,1,1
11087131,11087304,173,1,0,0,1
11087150,11087272,122,1,0,0,2
11087178,11087285,107,0,1,0,1
11087181,11087253,72,0,1,0,2
11087273,11087455,182,0,0,1,2
11087305,11087453,148,0,0,1,1
11087454,11087751,297,1,0,0,1
11087456,11087742,286,1,0,0,2
11087476,11087708,232,0,1,0,1
11087479,11087694,215,0,1,0,2
11087743,11087926,183,0,0,1,2
11087752,11087925,173,0,0,1,1
11087926,11087998,72,1,0,0,1
11087927,11087984,57,1,0,0,2
11087985,11088046,61,0,0,1,2
11087999,11088046,47,0,0,1,1
11088047,11088071,24,1,0,0,2
11088047,11088109,62,1,0,0,1
11088072,11088331,259,0,0,1,2
11088110,11088271,161,0,0,1,1
11088272,11088295,23,1,0,0,1
11088296,11088330,34,0,0,1,1
11088331,11088356,25,1,0,0,1
11088332,11088342,10,1,0,0,2
11088343,11089339,996,0,0,1,2
11088357,11089340,983,0,0,1,1
11089340,11089436,96,1,0,0,2
11089341,11089437,96,1,0,0,1
11089437,11089475,38,0,0,1,2
11089438,11089477,39,0,0,1,1
11089476,11089522,46,1,0,0,2
11089478,11089507,29,1,0,0,1
11089508,11089639,131,0,0,1,1
11089523,11089639,116,0,0,1,2
11089640,11089669,29,1,0,0,2
11089640,11089670,30,1,0,0,1
11089670,11089963,293,0,0,1,2
11089671,11090513,842,0,0,1,1
11089964,11089969,5,1,0,0,2
11089970,11090512,542,0,0,1,2
11090513,11090735,222,1,0,0,2
11090514,11090704,190,1,0,0,1
11090567,11090620,53,0,1,0,2
11090580,11090605,25,0,1,0,1
11090705,11090859,154,0,0,1,1
11090736,11090859,123,0,0,1,2
11090860,11090928,68,1,0,0,1
11090860,11090929,69,1,0,0,2
11090929,11091034,105,0,0,1,1
11090930,11091035,105,0,0,1,2
11091035,11091070,35,1,0,0,1
11091036,11091064,28,1,0,0,2
11091065,11091201,136,0,0,1,2
11091071,11091199,128,0,0,1,1
11091200,11091222,22,1,0,0,1
11091202,11091220,18,1,0,0,2
11091221,11091383,162,0,0,1,2
11091223,11091377,154,0,0,1,1
11091378,11091393,15,1,0,0,1
11091384,11091393,9,1,0,0,2
11091394,11091845,451,0,0,1,1
11091394,11091910,516,0,0,1,2
11091846,11092251,405,1,0,0,1
11091911,11092198,287,1,0,0,2
11091925,11092149,224,0,1,0,2
11091926,11092152,226,0,1,0,1
11092199,11092465,266,0,0,1,2
11092252,11092467,215,0,0,1,1
11092466,11092574,108,1,0,0,2
11092468,11092578,110,1,0,0,1
11092575,11092606,31,0,0,1,2
11092579,11092607,28,0,0,1,1
11092607,11092636,29,1,0,0,2
11092608,11092637,29,1,0,0,1
11092637,11092794,157,0,0,1,2
11092638,11092798,160,0,0,1,1
11092795,11092816,21,1,0,0,2
11092799,11092815,16,1,0,0,1
11092816,11093636,820,0,0,1,1
11092817,11093629,812,0,0,1,2
11093630,11093882,252,1,0,0,2
11093637,11093862,225,1,0,0,1
11093699,11093771,72,0,1,0,2
11093699,11093778,79,0,1,0,1
11093863,11094081,218,0,0,1,1
11093883,11094081,198,0,0,1,2
11094082,11094172,90,1,0,0,2
11094082,11094174,92,1,0,0,1
11094173,11094221,48,0,0,1,2
11094175,11094219,44,0,0,1,1
11094220,11094255,35,1,0,0,1
11094222,11094257,35,1,0,0,2
11094256,11094321,65,0,0,1,1
11094258,11094324,66,0,0,1,2
11094322,11094356,34,1,0,0,1
11094325,11094356,31,1,0,0,2
11094357,11094572,215,0,0,1,1
11094357,11095179,822,0,0,1,2
11094573,11094583,10,1,0,0,1
11094584,11095179,595,0,0,1,1
11095180,11095274,94,1,0,0,1
11095180,11095274,94,1,0,0,2
11095275,11095461,186,0,0,1,1
11095275,11095461,186,0,0,1,2
11095462,11095505,43,1,0,0,2
11095462,11095521,59,1,0,0,1
11095506,11096429,923,0,0,1,2
11095522,11096431,909,0,0,1,1
11096430,11096703,273,1,0,0,2
11096432,11096687,255,1,0,0,1
11096462,11096643,181,0,1,0,2
11096465,11096653,188,0,1,0,1
11096688,11096857,169,0,0,1,1
11096704,11096858,154,0,0,1,2
11096858,11096917,59,1,0,0,1
11096859,11096917,58,1,0,0,2
11096918,11096964,46,0,0,1,1
11096918,11096964,46,0,0,1,2
11096965,11097047,82,1,0,0,2
11096965,11097048,83,1,0,0,1
11097048,11097098,50,0,0,1,2
11097049,11097100,51,0,0,1,1
11097099,11097131,32,1,0,0,2
11097101,11097133,32,1,0,0,1
11097132,11097216,84,0,0,1,2
11097134,11097217,83,0,0,1,1
11097217,11097244,27,1,0,0,2
11097218,11097248,30,1,0,0,1
11097245,11097366,121,0,0,1,2
11097249,11097364,115,0,0,1,1
11097365,11097380,15,1,0,0,1
11097367,11097378,11,1,0,0,2
11097379,11098056,677,0,0,1,2
11097381,11098044,663,0,0,1,1
11098045,11098308,263,1,0,0,1
11098057,11098336,279,1,0,0,2
11098116,11098201,85,0,1,0,2
11098124,11098177,53,0,1,0,1
11098309,11098562,253,0,0,1,1
11098337,11098561,224,0,0,1,2
11098562,11098641,79,1,0,0,2
11098563,11098644,81,1,0,0,1
11098642,11098718,76,0,0,1,2
11098645,11098718,73,0,0,1,1
11098719,11098751,32,1,0,0,1
11098719,11098751,32,1,0,0,2
11098752,11098809,57,0,0,1,1
11098752,11098809,57,0,0,1,2
11098810,11098841,31,1,0,0,2
11098810,11098842,32,1,0,0,1
11098842,11098971,129,0,0,1,2
11098843,11098971,128,0,0,1,1
11098972,11098988,16,1,0,0,1
11098972,11098989,17,1,0,0,2
11098989,11099655,666,0,0,1,1
11098990,11099656,666,0,0,1,2
11099656,11099952,296,1,0,0,1
11099657,11099915,258,1,0,0,2
11099713,11099827,114,0,1,0,2
11099718,11099834,116,0,1,0,1
11099916,11100117,201,0,0,1,2
11099953,11100118,165,0,0,1,1
11100118,11100179,61,1,0,0,2
11100119,11100179,60,1,0,0,1
11100180,11100335,155,0,0,1,2
11100180,11100337,157,0,0,1,1
11100336,11100355,19,1,0,0,2
11100338,11100356,18,1,0,0,1
11100356,11101563,1207,0,0,1,2
11100357,11101562,1205,0,0,1,1
11101563,11101628,65,1,0,0,1
11101564,11101626,62,1,0,0,2
11101627,11101776,149,0,0,1,2
11101629,11101776,147,0,0,1,1
11101777,11101801,24,1,0,0,2
11101777,11101802,25,1,0,0,1
11101802,11101896,94,0,0,1,2
11101803,11101896,93,0,0,1,1
11101897,11101915,18,1,0,0,2
11101897,11101916,19,1,0,0,1
11101916,11102923,1007,0,0,1,2
11101917,11102925,1008,0,0,1,1
11102924,11102981,57,1,0,0,2
11102926,11102983,57,1,0,0,1
11102982,11104378,1396,0,0,1,2
11102984,11104379,1395,0,0,1,1
11104379,11104431,52,1,0,0,2
11104380,11104459,79,1,0,0,1
11104432,11104534,102,0,0,1,2
11104460,11104536,76,0,0,1,1
11104535,11104555,20,1,0,0,2
11104537,11104556,19,1,0,0,1
11104556,11104625,69,0,0,1,2
11104557,11105121,564,0,0,1,1
11104626,11104651,25,1,0,0,2
11104652,11104867,215,0,0,1,2
11104868,11104872,4,1,0,0,2
11104873,11105371,498,0,0,1,2
11105122,11105133,11,1,0,0,1
11105134,11105367,233,0,0,1,1
11105368,11105700,332,1,0,0,1
11105372,11105680,308,1,0,0,2
11105398,11105627,229,0,1,0,1
11105403,11105605,202,0,1,0,2
11105681,11105819,138,0,0,1,2
11105701,11105818,117,0,0,1,1
11105819,11105904,85,1,0,0,1
11105820,11105874,54,1,0,0,2
11105875,11105980,105,0,0,1,2
11105905,11105976,71,0,0,1,1
11105977,11106003,26,1,0,0,1
11105981,11106000,19,1,0,0,2
11106001,11106825,824,0,0,1,2
11106004,11106716,712,0,0,1,1
11106717,11106721,4,1,0,0,1
11106722,11106823,101,0,0,1,1
11106824,11107285,461,1,0,0,1
11106826,11107145,319,1,0,0,2
11106843,11107200,357,0,1,0,1
11106856,11107116,260,0,1,0,2
11107146,11107311,165,0,0,1,2
11107286,11107312,26,0,0,1,1
11107312,11107494,182,1,0,0,2
11107313,11107686,373,1,0,0,1
11107343,11107358,15,0,1,0,1
11107387,11107418,31,0,1,0,2
11107451,11107453,2,0,1,0,2
11107495,11107584,89,0,0,1,2
11107585,11107608,23,1,0,0,2
11107609,11108300,691,0,0,1,2
11107687,11107760,73,0,0,1,1
11107761,11107835,74,1,0,0,1
11107836,11107920,84,0,0,1,1
11107921,11107942,21,1,0,0,1
11107943,11107997,54,0,0,1,1
11107998,11108019,21,1,0,0,1
11108020,11108048,28,0,0,1,1
11108049,11108089,40,1,0,0,1
11108090,11108276,186,0,0,1,1
11108277,11109098,821,1,0,0,1
11108301,11108689,388,1,0,0,2
11108391,11108718,327,0,1,0,1
11108410,11108668,258,0,1,0,2
11108690,11108913,223,0,0,1,2
11108914,11108998,84,1,0,0,2
11108982,11109027,45,0,1,0,1
11108999,11109040,41,0,0,1,2
11109041,11109082,41,1,0,0,2
11109083,11109198,115,0,0,1,2
11109099,11109197,98,0,0,1,1
11109198,11109230,32,1,0,0,1
11109199,11109217,18,1,0,0,2
11109218,11109948,730,0,0,1,2
11109231,11109927,696,0,0,1,1
11109928,11110462,534,1,0,0,1
11109949,11110327,378,1,0,0,2
11109970,11110221,251,0,1,0,1
11109975,11110189,214,0,1,0,2
11110328,11110386,58,0,0,1,2
11110387,11110447,60,1,0,0,2
11110448,11110532,84,0,0,1,2
11110463,11110533,70,0,0,1,1
11110533,11110556,23,1,0,0,2
11110534,11110566,32,1,0,0,1
11110557,11110707,150,0,0,1,2
11110567,11110705,138,0,0,1,1
11110706,11110724,18,1,0,0,1
11110708,11110724,16,1,0,0,2
11110725,11111807,1082,0,0,1,2
11110725,11111811,1086,0,0,1,1
11111808,11111855,47,1,0,0,2
11111812,11111856,44,1,0,0,1
11111856,11111918,62,0,0,1,2
11111857,11111920,63,0,0,1,1
11111919,11111995,76,1,0,0,2
11111921,11112028,107,1,0,0,1
11111996,11112061,65,0,0,1,2
11112029,11112056,27,0,0,1,1
11112057,11112586,529,1,0,0,1
11112062,11112090,28,1,0,0,2
11112091,11112190,99,0,0,1,2
11112191,11112210,19,1,0,0,2
11112211,11112451,240,0,0,1,2
11112452,11112457,5,1,0,0,2
11112458,11112877,419,0,0,1,2
11112587,11112860,273,0,0,1,1
11112861,11113194,333,1,0,0,1
11112878,11113205,327,1,0,0,2
11112892,11113169,277,0,1,0,1
11112902,11113134,232,0,1,0,2
11113195,11113318,123,0,0,1,1
11113206,11113322,116,0,0,1,2
11113319,11113435,116,1,0,0,1
11113323,11113416,93,1,0,0,2
11113417,11113468,51,0,0,1,2
11113436,11113468,32,0,0,1,1
11113469,11113503,34,1,0,0,2
11113469,11113515,46,1,0,0,1
11113504,11113675,171,0,0,1,2
11113516,11113674,158,0,0,1,1
11113675,11113690,15,1,0,0,1
11113676,11113686,10,1,0,0,2
11113687,11114322,635,0,0,1,2
11113691,11114289,598,0,0,1,1
11114290,11114594,304,1,0,0,1
11114323,11114615,292,1,0,0,2
11114344,11114540,196,0,1,0,1
11114349,11114529,180,0,1,0,2
11114595,11114745,150,0,0,1,1
11114616,11114742,126,0,0,1,2
11114743,11114847,104,1,0,0,2
11114746,11114846,100,1,0,0,1
11114847,11114869,22,0,0,1,1
11114848,11114868,20,0,0,1,2
11114869,11114902,33,1,0,0,2
11114870,11114898,28,1,0,0,1
11114899,11114965,66,0,0,1,1
11114903,11114965,62,0,0,1,2
11114966,11114991,25,1,0,0,1
11114966,11114991,25,1,0,0,2
11114992,11115179,187,0,0,1,1
11114992,11115181,189,0,0,1,2
11115180,11115193,13,1,0,0,1
11115182,11115194,12,1,0,0,2
11115194,11115937,743,0,0,1,1
11115195,11115938,743,0,0,1,2
11115938,11116025,87,1,0,0,1
11115939,11116026,87,1,0,0,2
11116026,11116213,187,0,0,1,1
11116027,11116212,185,0,0,1,2
11116213,11116274,61,1,0,0,2
11116214,11116276,62,1,0,0,1
11116275,11116366,91,0,0,1,2
11116277,11116368,91,0,0,1,1
11116367,11116395,28,1,0,0,2
11116369,11116396,27,1,0,0,1
11116396,11116576,180,0,0,1,2
11116397,11116574,177,0,0,1,1
11116575,11116594,19,1,0,0,1
11116577,11116594,17,1,0,0,2
11116595,11117157,562,0,0,1,2
11116595,11117159,564,0,0,1,1
11117158,11117434,276,1,0,0,2
11117160,11117414,254,1,0,0,1
11117192,11117309,117,0,1,0,2
11117195,11117315,120,0,1,0,1
11117415,11117602,187,0,0,1,1
11117435,11117602,167,0,0,1,2
11117603,11117683,80,1,0,0,2
11117603,11117689,86,1,0,0,1
11117684,11117763,79,0,0,1,2
11117690,11117766,76,0,0,1,1
11117764,11117804,40,1,0,0,2
11117767,11117802,35,1,0,0,1
11117803,11117906,103,0,0,1,1
11117805,11117906,101,0,0,1,2
11117907,11117927,20,1,0,0,2
11117907,11117928,21,1,0,0,1
11117928,11118665,737,0,0,1,2
11117929,11118378,449,0,0,1,1
11118389,11118469,80,0,1,0,1
11118479,11118488,9,1,0,0,1
11118489,11118545,56,0,0,1,1
11118556,11118688,132,0,1,0,1
11118666,11118727,61,1,0,0,2
11118698,11118729,31,1,0,0,1
11118728,11118942,214,0,0,1,2
11118730,11118943,213,0,0,1,1
11118943,11119025,82,1,0,0,2
11118944,11119026,82,1,0,0,1
11119026,11119129,103,0,0,1,2
11119027,11119129,102,0,0,1,1
11119130,11119157,27,1,0,0,1
11119130,11119157,27,1,0,0,2
11119158,11119877,719,0,0,1,2
11119158,11119884,726,0,0,1,1
11119878,11120204,326,1,0,0,2
11119885,11120229,344,1,0,0,1
11119908,11120111,203,0,1,0,2
11119910,11120132,222,0,1,0,1
11120205,11120234,29,0,0,1,2
11120230,11120348,118,0,0,1,1
11120235,11120251,16,1,0,0,2
11120252,11120346,94,0,0,1,2
11120347,11120417,70,1,0,0,2
11120349,11120428,79,1,0,0,1
11120418,11120523,105,0,0,1,2
11120429,11120522,93,0,0,1,1
11120523,11120545,22,1,0,0,1
11120524,11120552,28,1,0,0,2
11120546,11120615,69,0,0,1,1
11120553,11120615,62,0,0,1,2
11120616,11120635,19,1,0,0,1
11120616,11120635,19,1,0,0,2
11120636,11121657,1021,0,0,1,1
11120636,11121657,1021,0,0,1,2
11121658,11121718,60,1,0,0,1
11121658,11121720,62,1,0,0,2
11121719,11121772,53,0,0,1,1
11121721,11121771,50,0,0,1,2
11121772,11121830,58,1,0,0,2
11121773,11121837,64,1,0,0,1
11121831,11121966,135,0,0,1,2
11121838,11121966,128,0,0,1,1
11121967,11121987,20,1,0,0,2
11121967,11121988,21,1,0,0,1
11121988,11122460,472,0,0,1,2
11121989,11122461,472,0,0,1,1
11122461,11122472,11,1,0,0,2
11122462,11122474,12,1,0,0,1
11122473,11122780,307,0,0,1,2
11122475,11122643,168,0,0,1,1
11122644,11122648,4,1,0,0,1
11122649,11122767,118,0,0,1,1
11122768,11123088,320,1,0,0,1
11122781,11123065,284,1,0,0,2
11122791,11123026,235,0,1,0,1
11122811,11122952,141,0,1,0,2
11122979,11123006,27,0,1,0,2
11123066,11123171,105,0,0,1,2
11123089,11123172,83,0,0,1,1
11123172,11123264,92,1,0,0,2
11123173,11123269,96,1,0,0,1
11123265,11123301,36,0,0,1,2
11123270,11123304,34,0,0,1,1
11123302,11123332,30,1,0,0,2
11123305,11123347,42,1,0,0,1
11123333,11123384,51,0,0,1,2
11123348,11123382,34,0,0,1,1
11123383,11123418,35,1,0,0,1
11123385,11123417,32,1,0,0,2
11123418,11123507,89,0,0,1,2
11123419,11123506,87,0,0,1,1
11123507,11123527,20,1,0,0,1
11123508,11123528,20,1,0,0,2
11123528,11123722,194,0,0,1,1
11123529,11123723,194,0,0,1,2
11123723,11123737,14,1,0,0,1
11123724,11123739,15,1,0,0,2
11123738,11124189,451,0,0,1,1
11123740,11124183,443,0,0,1,2
11124184,11124446,262,1,0,0,2
11124190,11124471,281,1,0,0,1
11124254,11124367,113,0,1,0,1
11124257,11124360,103,0,1,0,2
11124447,11124608,161,0,0,1,2
11124472,11124607,135,0,0,1,1
11124608,11124708,100,1,0,0,1
11124609,11124692,83,1,0,0,2
11124693,11124744,51,0,0,1,2
11124709,11124742,33,0,0,1,1
11124743,11124771,28,1,0,0,1
11124745,11124774,29,1,0,0,2
11124772,11124844,72,0,0,1,1
11124775,11124845,70,0,0,1,2
11124845,11124870,25,1,0,0,1
11124846,11124870,24,1,0,0,2
11124871,11125724,853,0,0,1,2
11124871,11125727,856,0,0,1,1
11125725,11125827,102,1,0,0,2
11125728,11125829,101,1,0,0,1
11125828,11126054,226,0,0,1,2
11125830,11126054,224,0,0,1,1
11126055,11126102,47,1,0,0,2
11126055,11126105,50,1,0,0,1
11126103,11126220,117,0,0,1,2
11126106,11126221,115,0,0,1,1
11126221,11126243,22,1,0,0,2
11126222,11126245,23,1,0,0,1
11126244,11126697,453,0,0,1,2
11126246,11126697,451,0,0,1,1
11126698,11126708,10,1,0,0,1
11126698,11126708,10,1,0,0,2
11126709,11128001,1292,0,0,1,1
11126709,11128002,1293,0,0,1,2
11128002,11128044,42,1,0,0,1
11128003,11128044,41,1,0,0,2
11128045,11128653,608,0,0,1,1
11128045,11128660,615,0,0,1,2
11128654,11128919,265,1,0,0,1
11128661,11128915,254,1,0,0,2
11128685,11128862,177,0,1,0,2
11128685,11128864,179,0,1,0,1
11128916,11130190,1274,0,0,1,2
11128920,11130183,1263,0,0,1,1
11130184,11130422,238,1,0,0,1
11130191,11130425,234,1,0,0,2
11130211,11130365,154,0,1,0,1
11130213,11130355,142,0,1,0,2
11130423,11131904,1481,0,0,1,1
11130426,11131905,1479,0,0,1,2
11131905,11131951,46,1,0,0,1
11131906,11131951,45,1,0,0,2
11131952,11132118,166,0,0,1,2
11131952,11132678,726,0,0,1,1
11132119,11132123,4,1,0,0,2
11132124,11132710,586,0,0,1,2
11132679,11132846,167,1,0,0,1
11132711,11132757,46,1,0,0,2
11132758,11132916,158,0,0,1,2
11132847,11132918,71,0,0,1,1
11132917,11132955,38,1,0,0,2
11132919,11132957,38,1,0,0,1
11132956,11133947,991,0,0,1,2
11132958,11133940,982,0,0,1,1
11133941,11134185,244,1,0,0,1
11133948,11134158,210,1,0,0,2
11133969,11134103,134,0,1,0,2
11133969,11134132,163,0,1,0,1
11134159,11134578,419,0,0,1,2
11134186,11134568,382,0,0,1,1
11134569,11134791,222,1,0,0,1
11134579,11134778,199,1,0,0,2
11134599,11134730,131,0,1,0,2
11134600,11134760,160,0,1,0,1
11134779,11135202,423,0,0,1,2
11134792,11135203,411,0,0,1,1
11135203,11135250,47,1,0,0,2
11135204,11135250,46,1,0,0,1
11135251,11135425,174,0,0,1,1
11135251,11135426,175,0,0,1,2
11135426,11135680,254,1,0,0,1
11135427,11135663,236,1,0,0,2
11135450,11135629,179,0,1,0,1
11135451,11135584,133,0,1,0,2
11135664,11136144,480,0,0,1,2
11135681,11136144,463,0,0,1,1
11136145,11136204,59,1,0,0,2
11136145,11136221,76,1,0,0,1
11136205,11136432,227,0,0,1,2
11136222,11136268,46,0,0,1,1
11136269,11136280,11,1,0,0,1
11136281,11136427,146,0,0,1,1
11136428,11136450,22,1,0,0,1
11136433,11136448,15,1,0,0,2
11136449,11137383,934,0,0,1,2
11136451,11136630,179,0,0,1,1
11136631,11136666,35,1,0,0,1
11136667,11137041,374,0,0,1,1
11137052,11137389,337,0,1,0,1
11137384,11137426,42,1,0,0,2
11137399,11137443,44,1,0,0,1
11137419,11137422,3,0,1,0,1
11137427,11139435,2008,0,0,1,2
11137444,11137575,131,0,0,1,1
11137576,11137583,7,1,0,0,1
11137584,11139416,1832,0,0,1,1
11139417,11139778,361,1,0,0,1
11139436,11139742,306,1,0,0,2
11139458,11139705,247,0,1,0,1
11139462,11139690,228,0,1,0,2
11139743,11140772,1029,0,0,1,2
11139779,11140772,993,0,0,1,1
11140773,11140818,45,1,0,0,2
11140773,11140821,48,1,0,0,1
11140819,11141069,250,0,0,1,2
11140822,11141075,253,0,0,1,1
11141070,11141089,19,1,0,0,2
11141076,11141086,10,1,0,0,1
11141087,11141566,479,0,0,1,1
11141090,11141576,486,0,0,1,2
11141567,11141834,267,1,0,0,1
11141577,11141819,242,1,0,0,2
11141599,11141727,128,0,1,0,1
11141601,11141702,101,0,1,0,2
11141820,11142227,407,0,0,1,2
11141835,11142227,392,0,0,1,1
11142228,11142271,43,1,0,0,2
11142228,11142273,45,1,0,0,1
11142272,11142534,262,0,0,1,2
11142274,11142535,261,0,0,1,1
11142535,11142552,17,1,0,0,2
11142536,11142550,14,1,0,0,1
11142551,11144306,1755,0,0,1,1
11142553,11144308,1755,0,0,1,2
11144307,11144654,347,1,0,0,1
11144309,11144664,355,1,0,0,2
11144333,11144586,253,0,1,0,1
11144335,11144576,241,0,1,0,2
11144655,11144997,342,0,0,1,1
11144665,11144998,333,0,0,1,2
11144998,11145040,42,1,0,0,1
11144999,11145039,40,1,0,0,2
11145040,11146024,984,0,0,1,2
11145041,11146024,983,0,0,1,1
11146025,11146076,51,1,0,0,2
11146025,11146078,53,1,0,0,1
11146077,11146826,749,0,0,1,2
11146079,11146819,740,0,0,1,1
11146820,11147083,263,1,0,0,1
11146827,11147020,193,1,0,0,2
11146852,11147027,175,0,1,0,1
11146862,11147003,141,0,1,0,2
11147021,11147042,21,0,0,1,2
11147043,11147067,24,1,0,0,2
11147068,11147621,553,0,0,1,2
11147084,11147619,535,0,0,1,1
11147620,11147746,126,1,0,0,1
11147622,11147662,40,1,0,0,2
11147663,11147843,180,0,0,1,2
11147747,11148355,608,0,0,1,1
11147844,11147859,15,1,0,0,2
11147860,11148358,498,0,0,1,2
11148356,11148810,454,1,0,0,1
11148359,11148710,351,1,0,0,2
11148368,11148720,352,0,1,0,1
11148397,11148684,287,0,1,0,2
11148711,11149178,467,0,0,1,2
11148811,11149160,349,0,0,1,1
11149171,11149253,82,0,1,0,1
11149179,11149199,20,1,0,0,2
11149200,11149846,646,0,0,1,2
11149263,11149266,3,1,0,0,1
11149267,11149836,569,0,0,1,1
11149837,11150142,305,1,0,0,1
11149847,11150160,313,1,0,0,2
11149849,11150096,247,0,1,0,1
11149870,11150085,215,0,1,0,2
11150143,11150412,269,0,0,1,1
11150161,11150411,250,0,0,1,2
11150412,11150453,41,1,0,0,2
11150413,11150452,39,1,0,0,1
11150453,11151276,823,0,0,1,1
11150454,11151274,820,0,0,1,2
11151275,11151319,44,1,0,0,2
11151277,11151317,40,1,0,0,1
11151318,11151552,234,0,0,1,1
11151320,11151550,230,0,0,1,2
11151551,11151620,69,1,0,0,2
11151553,11151619,66,1,0,0,1
11151620,11151774,154,0,0,1,1
11151621,11151774,153,0,0,1,2
11151775,11151796,21,1,0,0,1
11151775,11151796,21,1,0,0,2
11151797,11153129,1332,0,0,1,2
11151797,11153130,1333,0,0,1,1
11153130,11153175,45,1,0,0,2
11153131,11153175,44,1,0,0,1
11153176,11153240,64,0,0,1,2
11153176,11153241,65,0,0,1,1
11153241,11153267,26,1,0,0,2
11153242,11153267,25,1,0,0,1
11153268,11153357,89,0,0,1,1
11153268,11153360,92,0,0,1,2
11153358,11153380,22,1,0,0,1
11153361,11153391,30,1,0,0,2
11153381,11154361,980,0,0,1,1
11153392,11154360,968,0,0,1,2
11154361,11154637,276,1,0,0,2
11154362,11154586,224,1,0,0,1
11154390,11154503,113,0,1,0,2
11154391,11154501,110,0,1,0,1
11154587,11155206,619,0,0,1,1
11154638,11155199,561,0,0,1,2
11155200,11155493,293,1,0,0,2
11155207,11155490,283,1,0,0,1
11155242,11155407,165,0,1,0,2
11155243,11155413,170,0,1,0,1
11155491,11155906,415,0,0,1,1
11155494,11155905,411,0,0,1,2
11155906,11155950,44,1,0,0,2
11155907,11155948,41,1,0,0,1
11155949,11156517,568,0,0,1,1
11155951,11156515,564,0,0,1,2
11156516,11156574,58,1,0,0,2
11156518,11156574,56,1,0,0,1
11156575,11156730,155,0,0,1,1
11156575,11156732,157,0,0,1,2
11156731,11156751,20,1,0,0,1
11156733,11156753,20,1,0,0,2
11156752,11158241,1489,0,0,1,1
11156754,11158241,1487,0,0,1,2
11158242,11158285,43,1,0,0,1
11158242,11158285,43,1,0,0,2
11158286,11158429,143,0,0,1,2
11158286,11158431,145,0,0,1,1
11158430,11158453,23,1,0,0,2
11158432,11158453,21,1,0,0,1
11158454,11158995,541,0,0,1,1
11158454,11159001,547,0,0,1,2
11158996,11159227,231,1,0,0,1
11159002,11159275,273,1,0,0,2
11159035,11159154,119,0,1,0,2
11159035,11159158,123,0,1,0,1
11159228,11160423,1195,0,0,1,1
11159276,11160424,1148,0,0,1,2
11160424,11160765,341,1,0,0,1
11160425,11160791,366,1,0,0,2
11160453,11160680,227,0,1,0,2
11160453,11160693,240,0,1,0,1
11160766,11161412,646,0,0,1,1
11160792,11161414,622,0,0,1,2
11161413,11161454,41,1,0,0,1
11161415,11161454,39,1,0,0,2
11161455,11161990,535,0,0,1,1
11161455,11161990,535,0,0,1,2
11161991,11162038,47,1,0,0,1
11161991,11162040,49,1,0,0,2
11162039,11162234,195,0,0,1,1
11162041,11162234,193,0,0,1,2
11162235,11162300,65,1,0,0,2
11162235,11162322,87,1,0,0,1
11162301,11162403,102,0,0,1,2
11162323,11162405,82,0,0,1,1
11162404,11162426,22,1,0,0,2
11162406,11162431,25,1,0,0,1
11162427,11162491,64,0,0,1,2
11162432,11162491,59,0,0,1,1
11162492,11162523,31,1,0,0,2
11162492,11162532,40,1,0,0,1
11162524,11162651,127,0,0,1,2
11162533,11162646,113,0,0,1,1
11162647,11162664,17,1,0,0,1
11162652,11162662,10,1,0,0,2
11162663,11163786,1123,0,0,1,2
11162665,11163480,815,0,0,1,1
11163481,11163510,29,1,0,0,1
11163511,11163783,272,0,0,1,1
11163784,11163886,102,1,0,0,1
11163787,11163839,52,1,0,0,2
11163840,11164274,434,0,0,1,2
11163887,11164270,383,0,0,1,1
11164271,11164305,34,1,0,0,1
11164275,11164285,10,1,0,0,2
11164286,11165933,1647,0,0,1,2
11164306,11165925,1619,0,0,1,1
11165926,11166345,419,1,0,0,1
11165934,11166290,356,1,0,0,2
11165971,11166259,288,0,1,0,1
11165975,11166263,288,0,1,0,2
11166281,11166301,20,0,1,0,1
11166291,11166772,481,0,0,1,2
11166346,11166769,423,0,0,1,1
11166770,11166834,64,1,0,0,1
11166773,11166833,60,1,0,0,2
11166834,11167475,641,0,0,1,2
11166835,11167475,640,0,0,1,1
11167476,11167539,63,1,0,0,1
11167476,11167539,63,1,0,0,2
11167540,11167668,128,0,0,1,1
11167540,11167670,130,0,0,1,2
11167669,11167699,30,1,0,0,1
11167671,11167691,20,1,0,0,2
11167692,11168328,636,0,0,1,2
11167700,11168001,301,0,0,1,1
11168002,11168021,19,1,0,0,1
11168022,11168380,358,0,0,1,1
11168329,11168334,5,1,0,0,2
11168335,11168361,26,0,0,1,2
11168362,11168602,240,1,0,0,2
11168381,11168572,191,1,0,0,1
11168573,11168610,37,0,0,1,1
11168603,11169013,410,0,0,1,2
11168611,11168620,9,1,0,0,1
11168621,11169020,399,0,0,1,1
11169014,11169033,19,1,0,0,2
11169021,11169033,12,1,0,0,1
11169034,11170571,1537,0,0,1,1
11169034,11170571,1537,0,0,1,2
11170572,11170964,392,1,0,0,2
11170572,11170998,426,1,0,0,1
11170615,11170898,283,0,1,0,2
11170615,11170942,327,0,1,0,1
11170965,11171245,280,0,0,1,2
11170999,11171244,245,0,0,1,1
11171245,11171298,53,1,0,0,1
11171246,11171298,52,1,0,0,2
11171299,11171849,550,0,0,1,2
11171299,11171850,551,0,0,1,1
11171850,11171911,61,1,0,0,2
11171851,11171911,60,1,0,0,1
11171912,11172076,164,0,0,1,2
11171912,11172077,165,0,0,1,1
11172077,11172098,21,1,0,0,2
11172078,11172098,20,1,0,0,1
11172099,11172178,79,0,0,1,2
11172099,11172273,174,0,0,1,1
11172179,11172438,259,1,0,0,2
11172274,11172346,72,1,0,0,1
11172347,11172798,451,0,0,1,1
11172439,11172786,347,0,0,1,2
11172787,11173066,279,1,0,0,2
11172799,11173375,576,1,0,0,1
11172834,11172933,99,0,1,0,1
11172837,11173013,176,0,1,0,2
11172963,11173049,86,0,1,0,1
11173067,11173103,36,0,0,1,2
11173104,11173414,310,1,0,0,2
11173114,11173326,212,0,1,0,1
11173130,11173320,190,0,1,0,2
11173376,11175182,1806,0,0,1,1
11173415,11175174,1759,0,0,1,2
11175175,11175590,415,1,0,0,2
11175183,11175619,436,1,0,0,1
11175223,11175512,289,0,1,0,1
11175226,11175492,266,0,1,0,2
11175591,11176346,755,0,0,1,2
11175620,11176347,727,0,0,1,1
11176347,11176418,71,1,0,0,2
11176348,11176424,76,1,0,0,1
11176419,11176470,51,0,0,1,2
11176425,11176471,46,0,0,1,1
11176471,11176502,31,1,0,0,2
11176472,11176505,33,1,0,0,1
11176503,11176715,212,0,0,1,2
11176506,11176710,204,0,0,1,1
11176711,11176728,17,1,0,0,1
11176716,11176726,10,1,0,0,2
11176727,11177561,834,0,0,1,2
11176729,11177560,831,0,0,1,1
11177561,11177613,52,1,0,0,1
11177562,11177612,50,1,0,0,2
11177613,11177729,116,0,0,1,2
11177614,11177729,115,0,0,1,1
11177730,11177751,21,1,0,0,1
11177730,11177751,21,1,0,0,2
11177752,11179736,1984,0,0,1,1
11177752,11179762,2010,0,0,1,2
11179737,11180086,349,1,0,0,1
11179763,11180073,310,1,0,0,2
11179791,11179985,194,0,1,0,2
11179793,11179995,202,0,1,0,1
11180018,11180033,15,0,1,0,1
11180074,11180353,279,0,0,1,2
11180087,11180354,267,0,0,1,1
11180354,11180392,38,1,0,0,2
11180355,11180393,38,1,0,0,1
11180393,11180700,307,0,0,1,2
11180394,11180701,307,0,0,1,1
11180701,11180738,37,1,0,0,2
11180702,11180737,35,1,0,0,1
11180738,11181108,370,0,0,1,1
11180739,11181107,368,0,0,1,2
11181108,11181170,62,1,0,0,2
11181109,11181181,72,1,0,0,1
11181171,11181269,98,0,0,1,2
11181182,11181269,87,0,0,1,1
11181270,11181292,22,1,0,0,2
11181270,11181301,31,1,0,0,1
11181293,11181427,134,0,0,1,2
11181302,11181422,120,0,0,1,1
11181423,11181556,133,1,0,0,1
11181428,11181438,10,1,0,0,2
11181439,11182429,990,0,0,1,2
11181557,11182427,870,0,0,1,1
11182428,11182496,68,1,0,0,1
11182430,11182479,49,1,0,0,2
11182480,11182671,191,0,0,1,2
11182497,11182541,44,0,0,1,1
11182542,11182570,28,1,0,0,1
11182571,11182669,98,0,0,1,1
11182670,11182703,33,1,0,0,1
11182672,11182691,19,1,0,0,2
11182692,11184520,1828,0,0,1,2
11182704,11183656,952,0,0,1,1
11183657,11183708,51,1,0,0,1
11183709,11184491,782,0,0,1,1
11184492,11184957,465,1,0,0,1
11184521,11184967,446,1,0,0,2
11184544,11184901,357,0,1,0,1
11184547,11184918,371,0,1,0,2
11184958,11185874,916,0,0,1,1
11184968,11185873,905,0,0,1,2
11185874,11185936,62,1,0,0,2
11185875,11185927,52,1,0,0,1
11185928,11186117,189,0,0,1,1
11185937,11186118,181,0,0,1,2
11186118,11186131,13,1,0,0,1
11186119,11186132,13,1,0,0,2
11186132,11187657,1525,0,0,1,1
11186133,11187657,1524,0,0,1,2
11187658,11187714,56,1,0,0,1
11187658,11187716,58,1,0,0,2
11187715,11189788,2073,0,0,1,1
11187717,11189788,2071,0,0,1,2
11189789,11190251,462,1,0,0,1
11189789,11190254,465,1,0,0,2
11189818,11190189,371,0,1,0,2
11189824,11190209,385,0,1,0,1
11190252,11191620,1368,0,0,1,1
11190255,11190275,20,0,0,1,2
11190276,11190281,5,1,0,0,2
11190282,11191620,1338,0,0,1,2
11191621,11191689,68,1,0,0,1
11191621,11191691,70,1,0,0,2
11191690,11191786,96,0,0,1,1
11191692,11191786,94,0,0,1,2
11191787,11191820,33,1,0,0,2
11191787,11191822,35,1,0,0,1
11191821,11191886,65,0,0,1,2
11191823,11191888,65,0,0,1,1
11191887,11191910,23,1,0,0,2
11191889,11191919,30,1,0,0,1
11191911,11193161,1250,0,0,1,2
11191920,11193161,1241,0,0,1,1
11193162,11193213,51,1,0,0,2
11193162,11193215,53,1,0,0,1
11193214,11193437,223,0,0,1,2
11193216,11193437,221,0,0,1,1
11193438,11193448,10,1,0,0,2
11193438,11193449,11,1,0,0,1
11193449,11195272,1823,0,0,1,2
11193450,11195261,1811,0,0,1,1
11195262,11195615,353,1,0,0,1
11195273,11195632,359,1,0,0,2
11195299,11195528,229,0,1,0,2
11195300,11195536,236,0,1,0,1
11195616,11196772,1156,0,0,1,1
11195633,11196773,1140,0,0,1,2
11196773,11196837,64,1,0,0,1
11196774,11196837,63,1,0,0,2
11196838,11197110,272,0,0,1,2
11196838,11197112,274,0,0,1,1
11197111,11197153,42,1,0,0,2
11197113,11197162,49,1,0,0,1
11197154,11197281,127,0,0,1,2
11197163,11197250,87,0,0,1,1
11197251,11197303,52,1,0,0,1
11197282,11197303,21,1,0,0,2
11197304,11198332,1028,0,0,1,2
11197304,11198335,1031,0,0,1,1
11198333,11198374,41,1,0,0,2
11198336,11198375,39,1,0,0,1
11198375,11200378,2003,0,0,1,2
11198376,11198426,50,0,0,1,1
11198427,11198447,20,1,0,0,1
11198448,11198492,44,0,0,1,1
11198493,11198691,198,1,0,0,1
11198692,11198745,53,0,0,1,1
11198746,11198789,43,1,0,0,1
11198790,11199309,519,0,0,1,1
11199310,11199332,22,1,0,0,1
11199333,11200366,1033,0,0,1,1
11200367,11200794,427,1,0,0,1
11200379,11200713,334,1,0,0,2
11200405,11200732,327,0,1,0,1
11200409,11200665,256,0,1,0,2
11200714,11201119,405,0,0,1,2
11200795,11200982,187,0,0,1,1
11200993,11201027,34,0,1,0,1
11201037,11201053,16,1,0,0,1
11201054,11201120,66,0,0,1,1
11201120,11201162,42,1,0,0,2
11201121,11201218,97,1,0,0,1
11201151,11201191,40,0,1,0,1
11201163,11201743,580,0,0,1,2
11201219,11201294,75,0,0,1,1
11201305,11201305,0,0,1,0,1
11201315,11201358,43,1,0,0,1
11201359,11201395,36,0,0,1,1
11201406,11201452,46,0,1,0,1
11201462,11201785,323,1,0,0,1
11201588,11201758,170,0,1,0,1
11201744,11201782,38,1,0,0,2
11201783,11203189,1406,0,0,1,2
11201786,11203020,1234,0,0,1,1
11203021,11203086,65,1,0,0,1
11203048,11203077,29,0,1,0,1
11203087,11203116,29,0,0,1,1
11203127,11203140,13,0,1,0,1
11203150,11203151,1,1,0,0,1
11203152,11203200,48,0,0,1,1
11203190,11203199,9,1,0,0,2
11203200,11204069,869,0,0,1,2
11203201,11203496,295,1,0,0,1
11203258,11203487,229,0,1,0,1
11203497,11204071,574,0,0,1,1
11204070,11204130,60,1,0,0,2
11204072,11204125,53,1,0,0,1
11204126,11204251,125,0,0,1,1
11204131,11204251,120,0,0,1,2
11204252,11204273,21,1,0,0,1
11204252,11204283,31,1,0,0,2
11204274,11206224,1950,0,0,1,1
11204284,11206226,1942,0,0,1,2
11206225,11206307,82,1,0,0,1
11206227,11206300,73,1,0,0,2
11206301,11206595,294,0,0,1,2
11206308,11206389,81,0,0,1,1
11206390,11206400,10,1,0,0,1
11206401,11206446,45,0,0,1,1
11206447,11206451,4,1,0,0,1
11206452,11206526,74,0,0,1,1
11206527,11209388,2861,1,0,0,1
11206542,11209302,2760,0,1,0,1
11206606,11209240,2634,0,1,0,2
11209250,11209411,161,1,0,0,2
11209389,11209573,184,0,0,1,1
11209412,11209572,160,0,0,1,2
11209573,11209594,21,1,0,0,2
11209574,11209596,22,1,0,0,1
11209595,11209882,287,0,0,1,2
11209597,11209893,296,0,0,1,1
11209883,11210107,224,1,0,0,2
11209894,11210083,189,1,0,0,1
11209915,11210021,106,0,1,0,2
11209915,11210030,115,0,1,0,1
11210084,11210223,139,0,0,1,1
11210108,11210221,113,0,0,1,2
11210222,11210242,20,1,0,0,2
11210224,11210235,11,1,0,0,1
11210236,11211517,1281,0,0,1,1
11210243,11211516,1273,0,0,1,2
11211517,11211557,40,1,0,0,2
11211518,11211557,39,1,0,0,1
11211558,11211769,211,0,0,1,1
11211558,11211769,211,0,0,1,2
11211770,11211787,17,1,0,0,2
11211770,11211789,19,1,0,0,1
11211788,11212319,531,0,0,1,2
11211790,11212326,536,0,0,1,1
11212320,11212561,241,1,0,0,2
11212327,11212529,202,1,0,0,1
11212359,11212459,100,0,1,0,2
11212364,11212449,85,0,1,0,1
11212530,11213590,1060,0,0,1,1
11212562,11213597,1035,0,0,1,2
11213591,11214050,459,1,0,0,1
11213598,11214059,461,1,0,0,2
11213632,11213966,334,0,1,0,2
11213633,11213960,327,0,1,0,1
11214051,11214261,210,0,0,1,1
11214060,11214262,202,0,0,1,2
11214262,11214320,58,1,0,0,1
11214263,11214313,50,1,0,0,2
11214314,11214466,152,0,0,1,2
11214321,11214465,144,0,0,1,1
11214466,11214509,43,1,0,0,1
11214467,11214508,41,1,0,0,2
11214509,11214934,425,0,0,1,2
11214510,11214933,423,0,0,1,1
11214934,11214981,47,1,0,0,1
11214935,11214971,36,1,0,0,2
11214972,11215123,151,0,0,1,2
11214982,11215123,141,0,0,1,1
11215124,11215134,10,1,0,0,2
11215124,11215135,11,1,0,0,1
11215135,11216681,1546,0,0,1,2
11215136,11216682,1546,0,0,1,1
11216682,11216728,46,1,0,0,2
11216683,11216738,55,1,0,0,1
11216729,11217002,273,0,0,1,2
11216739,11217002,263,0,0,1,1
11217003,11217023,20,1,0,0,1
11217003,11217023,20,1,0,0,2
11217024,11218397,1373,0,0,1,2
11217024,11218777,1753,0,0,1,1
11218398,11218475,77,1,0,0,2
11218476,11218578,102,0,0,1,2
11218579,11218629,50,1,0,0,2
11218630,11218703,73,0,0,1,2
11218704,11219135,431,1,0,0,2
11218778,11219070,292,1,0,0,1
11218809,11219019,210,0,1,0,1
11218810,11219001,191,0,1,0,2
11219071,11219459,388,0,0,1,1
11219136,11219231,95,0,0,1,2
11219232,11219326,94,1,0,0,2
11219327,11219460,133,0,0,1,2
11219460,11219517,57,1,0,0,1
11219461,11219518,57,1,0,0,2
11219518,11220788,1270,0,0,1,1
11219519,11220789,1270,0,0,1,2
11220789,11220870,81,1,0,0,1
11220790,11220862,72,1,0,0,2
11220863,11220959,96,0,0,1,2
11220871,11220958,87,0,0,1,1
11220959,11220980,21,1,0,0,1
11220960,11220979,19,1,0,0,2
11220980,11221176,196,0,0,1,2
11220981,11221182,201,0,0,1,1
11221177,11221182,5,1,0,0,2
11221183,11221187,4,1,0,0,1
11221183,11222245,1062,0,0,1,2
11221188,11222247,1059,0,0,1,1
11222246,11222332,86,1,0,0,2
11222248,11222332,84,1,0,0,1
11222333,11222695,362,0,0,1,1
11222333,11222695,362,0,0,1,2
11222696,11222778,82,1,0,0,2
11222696,11222782,86,1,0,0,1
11222779,11222828,49,0,0,1,2
11222783,11222829,46,0,0,1,1
11222829,11222856,27,1,0,0,2
11222830,11222857,27,1,0,0,1
11222857,11223018,161,0,0,1,2
11222858,11223017,159,0,0,1,1
11223018,11223044,26,1,0,0,1
11223019,11223038,19,1,0,0,2
11223039,11224790,1751,0,0,1,2
11223045,11224809,1764,0,0,1,1
11224791,11225279,488,1,0,0,2
11224810,11225241,431,1,0,0,1
11224845,11225003,158,0,1,0,2
11224848,11225205,357,0,1,0,1
11225039,11225185,146,0,1,0,2
11225242,11225854,612,0,0,1,1
11225280,11225853,573,0,0,1,2
11225854,11225896,42,1,0,0,2
11225855,11225897,42,1,0,0,1
11225897,11226729,832,0,0,1,2
11225898,11226729,831,0,0,1,1
11226730,11226782,52,1,0,0,2
11226730,11226794,64,1,0,0,1
11226783,11226896,113,0,0,1,2
11226795,11226896,101,0,0,1,1
11226897,11226917,20,1,0,0,2
11226897,11226925,28,1,0,0,1
11226918,11226970,52,0,0,1,2
11226926,11226970,44,0,0,1,1
11226971,11226992,21,1,0,0,1
11226971,11226992,21,1,0,0,2
11226993,11228962,1969,0,0,1,1
11226993,11228962,1969,0,0,1,2
11228963,11229003,40,1,0,0,1
11228963,11229003,40,1,0,0,2
11229004,11229206,202,0,0,1,1
11229004,11229207,203,0,0,1,2
11229207,11229234,27,1,0,0,1
11229208,11229230,22,1,0,0,2
11229231,11229415,184,0,0,1,2
11229235,11229420,185,0,0,1,1
11229416,11229433,17,1,0,0,2
11229421,11229433,12,1,0,0,1
11229434,11231107,1673,0,0,1,2
11229434,11231115,1681,0,0,1,1
11231108,11231419,311,1,0,0,2
11231116,11231388,272,1,0,0,1
11231147,11231326,179,0,1,0,2
11231156,11231324,168,0,1,0,1
11231389,11232481,1092,0,0,1,1
11231420,11232482,1062,0,0,1,2
11232482,11232506,24,1,0,0,1
11232483,11232521,38,1,0,0,2
11232507,11233029,522,0,0,1,1
11232522,11233029,507,0,0,1,2
11233030,11233071,41,1,0,0,2
11233030,11233072,42,1,0,0,1
11233072,11233291,219,0,0,1,2
11233073,11233293,220,0,0,1,1
11233292,11233302,10,1,0,0,2
11233294,11233300,6,1,0,0,1
11233301,11234199,898,0,0,1,1
11233303,11234200,897,0,0,1,2
11234200,11234250,50,1,0,0,1
11234201,11234259,58,1,0,0,2
11234251,11234453,202,0,0,1,1
11234260,11234454,194,0,0,1,2
11234454,11234472,18,1,0,0,1
11234455,11234472,17,1,0,0,2
11234473,11236248,1775,0,0,1,1
11234473,11236262,1789,0,0,1,2
11236249,11236543,294,1,0,0,1
11236263,11236538,275,1,0,0,2
11236291,11236468,177,0,1,0,2
11236300,11236467,167,0,1,0,1
11236539,11237001,462,0,0,1,2
11236544,11237001,457,0,0,1,1
11237002,11237031,29,1,0,0,2
11237002,11237032,30,1,0,0,1
11237032,11237641,609,0,0,1,2
11237033,11237640,607,0,0,1,1
11237641,11237711,70,1,0,0,1
11237642,11237702,60,1,0,0,2
11237703,11237873,170,0,0,1,2
11237712,11237879,167,0,0,1,1
11237874,11237893,19,1,0,0,2
11237880,11237892,12,1,0,0,1
11237893,11239362,1469,0,0,1,1
11237894,11239362,1468,0,0,1,2
11239363,11239403,40,1,0,0,2
11239363,11239406,43,1,0,0,1
11239404,11239468,64,0,0,1,2
11239407,11239468,61,0,0,1,1
11239469,11239491,22,1,0,0,1
11239469,11239491,22,1,0,0,2
11239492,11241501,2009,0,0,1,1
11239492,11241513,2021,0,0,1,2
11241502,11241768,266,1,0,0,1
11241514,11241801,287,1,0,0,2
11241540,11241712,172,0,1,0,2
11241543,11241720,177,0,1,0,1
11241769,11242222,453,0,0,1,1
11241802,11242221,419,0,0,1,2
11242222,11242264,42,1,0,0,2
11242223,11242265,42,1,0,0,1
11242265,11242922,657,0,0,1,2
11242266,11242921,655,0,0,1,1
11242922,11242974,52,1,0,0,1
11242923,11242975,52,1,0,0,2
11242975,11243177,202,0,0,1,1
11242976,11243176,200,0,0,1,2
11243177,11243245,68,1,0,0,2
11243178,11243235,57,1,0,0,1
11243236,11243354,118,0,0,1,1
11243246,11243354,108,0,0,1,2
11243355,11243373,18,1,0,0,2
11243355,11243382,27,1,0,0,1
11243374,11244547,1173,0,0,1,2
11243383,11244548,1165,0,0,1,1
11244548,11244607,59,1,0,0,2
11244549,11244602,53,1,0,0,1
11244603,11244688,85,0,0,1,1
11244608,11244688,80,0,0,1,2
11244689,11244712,23,1,0,0,2
11244689,11244713,24,1,0,0,1
11244713,11246123,1410,0,0,1,2
11244714,11246115,1401,0,0,1,1
11246116,11246380,264,1,0,0,1
11246124,11246450,326,1,0,0,2
11246168,11246290,122,0,1,0,2
11246172,11246292,120,0,1,0,1
11246381,11246681,300,0,0,1,1
11246451,11246680,229,0,0,1,2
11246681,11246745,64,1,0,0,2
11246682,11246751,69,1,0,0,1
11246746,11247241,495,0,0,1,2
11246752,11247240,488,0,0,1,1
11247241,11247292,51,1,0,0,1
11247242,11247292,50,1,0,0,2
11247293,11247757,464,0,0,1,1
11247293,11247757,464,0,0,1,2
11247758,11247789,31,1,0,0,2
11247758,11247791,33,1,0,0,1
11247790,11247979,189,0,0,1,2
11247792,11247979,187,0,0,1,1
11247980,11248036,56,1,0,0,2
11247980,11248044,64,1,0,0,1
11248037,11248739,702,0,0,1,2
11248045,11248734,689,0,0,1,1
11248735,11249022,287,1,0,0,1
11248740,11249010,270,1,0,0,2
11248761,11248964,203,0,1,0,2
11248763,11248983,220,0,1,0,1
11249011,11249111,100,0,0,1,2
11249023,11249111,88,0,0,1,1
11249112,11249135,23,1,0,0,1
11249112,11249151,39,1,0,0,2
11249136,11249457,321,0,0,1,1
11249152,11249456,304,0,0,1,2
11249457,11249552,95,1,0,0,2
11249458,11249522,64,1,0,0,1
11249523,11249750,227,0,0,1,1
11249553,11249751,198,0,0,1,2
11249751,11249769,18,1,0,0,1
11249752,11249768,16,1,0,0,2
11249769,11251345,1576,0,0,1,2
11249770,11251546,1776,0,0,1,1
11251346,11251388,42,1,0,0,2
11251389,11251504,115,0,0,1,2
11251505,11251927,422,1,0,0,2
11251547,11251957,410,1,0,0,1
11251580,11251907,327,0,1,0,1
11251582,11251916,334,0,1,0,2
11251928,11253276,1348,0,0,1,2
11251958,11253274,1316,0,0,1,1
11253275,11253314,39,1,0,0,1
11253277,11253313,36,1,0,0,2
11253314,11253446,132,0,0,1,2
11253315,11254763,1448,0,0,1,1
11253447,11253464,17,1,0,0,2
11253465,11254764,1299,0,0,1,2
11254764,11254883,119,1,0,0,1
11254765,11254819,54,1,0,0,2
11254820,11255079,259,0,0,1,2
11254884,11254960,76,0,0,1,1
11254961,11255020,59,1,0,0,1
11255021,11255070,49,0,0,1,1
11255071,11255090,19,1,0,0,1
11255080,11255091,11,1,0,0,2
11255091,11256768,1677,0,0,1,1
11255092,11256784,1692,0,0,1,2
11256769,11257102,333,1,0,0,1
11256785,11257070,285,1,0,0,2
11256801,11257028,227,0,1,0,2
11256803,11257047,244,0,1,0,1
11257071,11258445,1374,0,0,1,2
11257103,11258445,1342,0,0,1,1
11258446,11258518,72,1,0,0,2
11258446,11258541,95,1,0,0,1
11258519,11258575,56,0,0,1,2
11258542,11258571,29,0,0,1,1
11258572,11258599,27,1,0,0,1
11258576,11258599,23,1,0,0,2
11258600,11258656,56,0,0,1,1
11258600,11258657,57,0,0,1,2
11258657,11258686,29,1,0,0,1
11258658,11258687,29,1,0,0,2
11258687,11258778,91,0,0,1,1
11258688,11258771,83,0,0,1,2
11258772,11258792,20,1,0,0,2
11258779,11258791,12,1,0,0,1
11258792,11259664,872,0,0,1,1
11258793,11259662,869,0,0,1,2
11259663,11259705,42,1,0,0,2
11259665,11259707,42,1,0,0,1
11259706,11259903,197,0,0,1,2
11259708,11259904,196,0,0,1,1
11259904,11259914,10,1,0,0,2
11259905,11259915,10,1,0,0,1
11259915,11261222,1307,0,0,1,2
11259916,11261224,1308,0,0,1,1
11261223,11261523,300,1,0,0,2
11261225,11261520,295,1,0,0,1
11261259,11261454,195,0,1,0,2
11261262,11261441,179,0,1,0,1
11261521,11261594,73,0,0,1,1
11261524,11261544,20,0,0,1,2
11261545,11261568,23,1,0,0,2
11261569,11261595,26,0,0,1,2
11261595,11261638,43,1,0,0,1
11261596,11261639,43,1,0,0,2
11261639,11261808,169,0,0,1,1
11261640,11261803,163,0,0,1,2
11261804,11262122,318,1,0,0,2
11261809,11262114,305,1,0,0,1
11261844,11262073,229,0,1,0,2
11261845,11262050,205,0,1,0,1
11262115,11262805,690,0,0,1,1
11262123,11262805,682,0,0,1,2
11262806,11262875,69,1,0,0,1
11262806,11262875,69,1,0,0,2
11262876,11263071,195,0,0,1,2
11262876,11263074,198,0,0,1,1
11263072,11263127,55,1,0,0,2
11263075,11263130,55,1,0,0,1
11263128,11263237,109,0,0,1,2
11263131,11263238,107,0,0,1,1
11263238,11263260,22,1,0,0,2
11263239,11263261,22,1,0,0,1
11263261,11264551,1290,0,0,1,2
11263262,11264551,1289,0,0,1,1
11264552,11264604,52,1,0,0,2
11264552,11264620,68,1,0,0,1
11264605,11264674,69,0,0,1,2
11264621,11264674,53,0,0,1,1
11264675,11264704,29,1,0,0,2
11264675,11264705,30,1,0,0,1
11264705,11264888,183,0,0,1,2
11264706,11264887,181,0,0,1,1
11264888,11264907,19,1,0,0,1
11264889,11264909,20,1,0,0,2
11264908,11266752,1844,0,0,1,1
11264910,11266759,1849,0,0,1,2
11266753,11267005,252,1,0,0,1
11266760,11267047,287,1,0,0,2
11266799,11266946,147,0,1,0,1
11266799,11266949,150,0,1,0,2
11267006,11267998,992,0,0,1,1
11267048,11267997,949,0,0,1,2
11267998,11268044,46,1,0,0,2
11267999,11268043,44,1,0,0,1
11268044,11268247,203,0,0,1,1
11268045,11268247,202,0,0,1,2
11268248,11268309,61,1,0,0,2
11268248,11268321,73,1,0,0,1
11268310,11268565,255,0,0,1,2
11268322,11268564,242,0,0,1,1
11268565,11268579,14,1,0,0,1
11268566,11268575,9,1,0,0,2
11268576,11269089,513,0,0,1,2
11268580,11269073,493,0,0,1,1
11269074,11269437,363,1,0,0,1
11269090,11269303,213,1,0,0,2
11269114,11269292,178,0,1,0,2
11269114,11269307,193,0,1,0,1
11269304,11269411,107,0,0,1,2
11269349,11269360,11,0,1,0,1
11269412,11269422,10,1,0,0,2
11269423,11269774,351,0,0,1,2
11269438,11269774,336,0,0,1,1
11269775,11269814,39,1,0,0,2
11269775,11269816,41,1,0,0,1
11269815,11271854,2039,0,0,1,2
11269817,11271834,2017,0,0,1,1
11271835,11272216,381,1,0,0,1
11271855,11272190,335,1,0,0,2
11271874,11272165,291,0,1,0,1
11271876,11272136,260,0,1,0,2
11272191,11273415,1224,0,0,1,2
11272217,11273415,1198,0,0,1,1
