start,end,duration,saccade,blink,fixation,eye
9595517,9595900,383,0,0,1,1
9595517,9595901,384,0,0,1,2
9595901,9595966,65,1,0,0,1
9595902,9595980,78,1,0,0,2
9595967,9596706,739,0,0,1,1
9595981,9596134,153,0,0,1,2
9596135,9596146,11,1,0,0,2
9596147,9596707,560,0,0,1,2
9596707,9596719,12,1,0,0,1
9596708,9596723,15,1,0,0,2
9596720,9596833,113,0,0,1,1
9596724,9596831,107,0,0,1,2
9596832,9596848,16,1,0,0,2
9596834,9596846,12,1,0,0,1
9596847,9597536,689,0,0,1,1
9596849,9597536,687,0,0,1,2
9597537,9597622,85,1,0,0,2
9597537,9597623,86,1,0,0,1
9597623,9597897,274,0,0,1,2
9597624,9597898,274,0,0,1,1
9597898,9597950,52,1,0,0,2
9597899,9597955,56,1,0,0,1
9597951,9598103,152,0,0,1,2
9597956,9598102,146,0,0,1,1
9598103,9598132,29,1,0,0,1
9598104,9598122,18,1,0,0,2
9598123,9599933,1810,0,0,1,2
9598133,9598326,193,0,0,1,1
9598327,9598331,4,1,0,0,1
9598332,9599934,1602,0,0,1,1
9599934,9600160,226,1,0,0,2
9599935,9600149,214,1,0,0,1
9599985,9600115,130,0,1,0,1
9599990,9600119,129,0,1,0,2
9600150,9600321,171,0,0,1,1
9600161,9600324,163,0,0,1,2
9600322,9600347,25,1,0,0,1
9600325,9600346,21,1,0,0,2
9600347,9601859,1512,0,0,1,2
9600348,9601860,1512,0,0,1,1
9601860,9601917,57,1,0,0,2
9601861,9601923,62,1,0,0,1
9601918,9602031,113,0,0,1,2
9601924,9602030,106,0,0,1,1
9602031,9602053,22,1,0,0,1
9602032,9602052,20,1,0,0,2
9602053,9602457,404,0,0,1,2
9602054,9602455,401,0,0,1,1
9602456,9602470,14,1,0,0,1
9602458,9602470,12,1,0,0,2
9602471,9603678,1207,0,0,1,1
9602471,9603679,1208,0,0,1,2
9603679,9603777,98,1,0,0,1
9603680,9603779,99,1,0,0,2
9603778,9603847,69,0,0,1,1
9603780,9603846,66,0,0,1,2
9603847,9603892,45,1,0,0,2
9603848,9603893,45,1,0,0,1
9603893,9604021,128,0,0,1,2
9603894,9604022,128,0,0,1,1
9604022,9604051,29,1,0,0,2
9604023,9604044,21,1,0,0,1
9604045,9605416,1371,0,0,1,1
9604052,9605416,1364,0,0,1,2
9605417,9605509,92,1,0,0,2
9605417,9605510,93,1,0,0,1
9605510,9605597,87,0,0,1,2
9605511,9605598,87,0,0,1,1
9605598,9605623,25,1,0,0,2
9605599,9605622,23,1,0,0,1
9605623,9607186,1563,0,0,1,1
9605624,9607185,1561,0,0,1,2
9607186,9607236,50,1,0,0,2
9607187,9607224,37,1,0,0,1
9607225,9607327,102,0,0,1,1
9607237,9607328,91,0,0,1,2
9607328,9607349,21,1,0,0,1
9607329,9607358,29,1,0,0,2
9607350,9608764,1414,0,0,1,1
9607359,9608761,1402,0,0,1,2
9608762,9608863,101,1,0,0,2
9608765,9608863,98,1,0,0,1
9608864,9608946,82,0,0,1,1
9608864,9608946,82,0,0,1,2
9608947,9608979,32,1,0,0,2
9608947,9608981,34,1,0,0,1
9608980,9610153,1173,0,0,1,2
9608982,9609154,172,0,0,1,1
9609155,9609165,10,1,0,0,1
9609166,9610153,987,0,0,1,1
9610154,9610208,54,1,0,0,2
9610154,9610209,55,1,0,0,1
9610209,9610406,197,0,0,1,2
9610210,9610406,196,0,0,1,1
9610407,9610476,69,1,0,0,1
9610407,9610476,69,1,0,0,2
9610477,9610550,73,0,0,1,1
9610477,9610550,73,0,0,1,2
9610551,9610576,25,1,0,0,2
9610551,9610579,28,1,0,0,1
9610577,9612205,1628,0,0,1,2
9610580,9612204,1624,0,0,1,1
9612205,9612279,74,1,0,0,1
9612206,9612280,74,1,0,0,2
9612280,9612465,185,0,0,1,1
9612281,9612460,179,0,0,1,2
9612461,9612488,27,1,0,0,2
9612466,9612478,12,1,0,0,1
9612479,9613543,1064,0,0,1,1
9612489,9613543,1054,0,0,1,2
9613544,9613597,53,1,0,0,2
9613544,9613598,54,1,0,0,1
9613598,9613889,291,0,0,1,2
9613599,9613889,290,0,0,1,1
9613890,9613946,56,1,0,0,1
9613890,9613952,62,1,0,0,2
9613947,9614055,108,0,0,1,1
9613953,9614055,102,0,0,1,2
9614056,9614075,19,1,0,0,1
9614056,9614083,27,1,0,0,2
9614076,9614289,213,0,0,1,1
9614084,9614290,206,0,0,1,2
9614290,9614301,11,1,0,0,1
9614291,9614311,20,1,0,0,2
9614302,9615556,1254,0,0,1,1
9614312,9615556,1244,0,0,1,2
9615557,9615659,102,1,0,0,2
9615557,9615660,103,1,0,0,1
9615660,9615763,103,0,0,1,2
9615661,9615764,103,0,0,1,1
9615764,9615790,26,1,0,0,2
9615765,9615789,24,1,0,0,1
9615790,9617336,1546,0,0,1,1
9615791,9617335,1544,0,0,1,2
9617336,9617413,77,1,0,0,2
9617337,9617412,75,1,0,0,1
9617413,9617535,122,0,0,1,1
9617414,9617535,121,0,0,1,2
9617536,9617551,15,1,0,0,1
9617536,9617552,16,1,0,0,2
9617552,9617737,185,0,0,1,1
9617553,9619222,1669,0,0,1,2
9617738,9617746,8,1,0,0,1
9617747,9619221,1474,0,0,1,1
9619222,9619300,78,1,0,0,1
9619223,9619308,85,1,0,0,2
9619301,9619426,125,0,0,1,1
9619309,9619426,117,0,0,1,2
9619427,9619453,26,1,0,0,1
9619427,9619455,28,1,0,0,2
9619454,9619733,279,0,0,1,1
9619456,9619738,282,0,0,1,2
9619734,9619750,16,1,0,0,1
9619739,9619749,10,1,0,0,2
9619750,9621054,1304,0,0,1,2
9619751,9621055,1304,0,0,1,1
9621055,9621128,73,1,0,0,2
9621056,9621139,83,1,0,0,1
9621129,9621237,108,0,0,1,2
9621140,9621236,96,0,0,1,1
9621237,9621262,25,1,0,0,1
9621238,9621262,24,1,0,0,2
9621263,9621468,205,0,0,1,1
9621263,9622980,1717,0,0,1,2
9621469,9621481,12,1,0,0,1
9621482,9622980,1498,0,0,1,1
9622981,9623092,111,1,0,0,1
9622981,9623093,112,1,0,0,2
9623093,9623165,72,0,0,1,1
9623094,9623165,71,0,0,1,2
9623166,9623212,46,1,0,0,2
9623166,9623213,47,1,0,0,1
9623213,9623404,191,0,0,1,2
9623214,9623403,189,0,0,1,1
9623404,9623421,17,1,0,0,1
9623405,9623421,16,1,0,0,2
9623422,9623555,133,0,0,1,1
9623422,9624013,591,0,0,1,2
9623556,9623570,14,1,0,0,1
9623571,9624013,442,0,0,1,1
9624014,9624032,18,1,0,0,1
9624014,9624032,18,1,0,0,2
9624033,9624860,827,0,0,1,1
9624033,9624861,828,0,0,1,2
9624861,9624915,54,1,0,0,1
9624862,9624909,47,1,0,0,2
9624910,9625019,109,0,0,1,2
9624916,9625019,103,0,0,1,1
9625020,9625040,20,1,0,0,2
9625020,9625041,21,1,0,0,1
9625041,9626801,1760,0,0,1,2
9625042,9625228,186,0,0,1,1
9625229,9625235,6,1,0,0,1
9625236,9626802,1566,0,0,1,1
9626802,9626894,92,1,0,0,2
9626803,9626904,101,1,0,0,1
9626895,9627153,258,0,0,1,2
9626905,9627155,250,0,0,1,1
9627154,9627174,20,1,0,0,2
9627156,9627175,19,1,0,0,1
9627175,9627531,356,0,0,1,2
9627176,9628726,1550,0,0,1,1
9627532,9627542,10,1,0,0,2
9627543,9628729,1186,0,0,1,2
9628727,9628808,81,1,0,0,1
9628730,9628811,81,1,0,0,2
9628809,9628930,121,0,0,1,1
9628812,9628931,119,0,0,1,2
9628931,9628949,18,1,0,0,1
9628932,9628951,19,1,0,0,2
9628950,9629129,179,0,0,1,1
9628952,9629124,172,0,0,1,2
9629125,9629141,16,1,0,0,2
9629130,9629140,10,1,0,0,1
9629141,9630515,1374,0,0,1,1
9629142,9630514,1372,0,0,1,2
9630515,9630621,106,1,0,0,2
9630516,9630621,105,1,0,0,1
9630622,9630697,75,0,0,1,2
9630622,9630698,76,0,0,1,1
9630698,9630724,26,1,0,0,2
9630699,9630723,24,1,0,0,1
9630724,9631469,745,0,0,1,1
9630725,9632263,1538,0,0,1,2
9631470,9631474,4,1,0,0,1
9631475,9632262,787,0,0,1,1
9632263,9632334,71,1,0,0,1
9632264,9632328,64,1,0,0,2
9632329,9632395,66,0,0,1,2
9632335,9632394,59,0,0,1,1
9632395,9632459,64,1,0,0,1
9632396,9632462,66,1,0,0,2
9632460,9632557,97,0,0,1,1
9632463,9632555,92,0,0,1,2
9632556,9632578,22,1,0,0,2
9632558,9632580,22,1,0,0,1
9632579,9632742,163,0,0,1,2
9632581,9632748,167,0,0,1,1
9632743,9632759,16,1,0,0,2
9632749,9632759,10,1,0,0,1
9632760,9634250,1490,0,0,1,2
9632760,9634251,1491,0,0,1,1
9634251,9634343,92,1,0,0,2
9634252,9634363,111,1,0,0,1
9634344,9634428,84,0,0,1,2
9634364,9634429,65,0,0,1,1
9634429,9634474,45,1,0,0,2
9634430,9634465,35,1,0,0,1
9634466,9636115,1649,0,0,1,1
9634475,9636113,1638,0,0,1,2
9636114,9636217,103,1,0,0,2
9636116,9636206,90,1,0,0,1
9636207,9636305,98,0,0,1,1
9636218,9636305,87,0,0,1,2
9636306,9636338,32,1,0,0,1
9636306,9636338,32,1,0,0,2
9636339,9637160,821,0,0,1,2
9636339,9637161,822,0,0,1,1
9637161,9637172,11,1,0,0,2
9637162,9637175,13,1,0,0,1
9637173,9637283,110,0,0,1,2
9637176,9637283,107,0,0,1,1
9637284,9637302,18,1,0,0,1
9637284,9637302,18,1,0,0,2
9637303,9637996,693,0,0,1,1
9637303,9637997,694,0,0,1,2
9637997,9638040,43,1,0,0,1
9637998,9638041,43,1,0,0,2
9638041,9638150,109,0,0,1,1
9638042,9638150,108,0,0,1,2
9638151,9638170,19,1,0,0,1
9638151,9638178,27,1,0,0,2
9638171,9639635,1464,0,0,1,1
9638179,9639634,1455,0,0,1,2
9639635,9639720,85,1,0,0,2
9639636,9639723,87,1,0,0,1
9639721,9639854,133,0,0,1,2
9639724,9639854,130,0,0,1,1
9639855,9639873,18,1,0,0,2
9639855,9639883,28,1,0,0,1
9639874,9640220,346,0,0,1,2
9639884,9641460,1576,0,0,1,1
9640221,9640225,4,1,0,0,2
9640226,9641460,1234,0,0,1,2
9641461,9641539,78,1,0,0,1
9641461,9641539,78,1,0,0,2
9641540,9641643,103,0,0,1,1
9641540,9641643,103,0,0,1,2
9641644,9641670,26,1,0,0,2
9641644,9641682,38,1,0,0,1
9641671,9642072,401,0,0,1,2
9641683,9642067,384,0,0,1,1
9642068,9642083,15,1,0,0,1
9642073,9642083,10,1,0,0,2
9642084,9643327,1243,0,0,1,1
9642084,9643331,1247,0,0,1,2
9643328,9643384,56,1,0,0,1
9643332,9643379,47,1,0,0,2
9643380,9643572,192,0,0,1,2
9643385,9643570,185,0,0,1,1
9643571,9643585,14,1,0,0,1
9643573,9643586,13,1,0,0,2
9643586,9645195,1609,0,0,1,1
9643587,9645195,1608,0,0,1,2
9645196,9645277,81,1,0,0,1
9645196,9645278,82,1,0,0,2
9645278,9645390,112,0,0,1,1
9645279,9645390,111,0,0,1,2
9645391,9645415,24,1,0,0,1
9645391,9645417,26,1,0,0,2
9645416,9645766,350,0,0,1,1
9645418,9645765,347,0,0,1,2
9645766,9645776,10,1,0,0,2
9645767,9645778,11,1,0,0,1
9645777,9646963,1186,0,0,1,2
9645779,9646963,1184,0,0,1,1
9646964,9647049,85,1,0,0,1
9646964,9647049,85,1,0,0,2
9647050,9647146,96,0,0,1,1
9647050,9647146,96,0,0,1,2
9647147,9647169,22,1,0,0,2
9647147,9647177,30,1,0,0,1
9647170,9648826,1656,0,0,1,2
9647178,9648827,1649,0,0,1,1
9648827,9648874,47,1,0,0,2
9648828,9648882,54,1,0,0,1
9648875,9648993,118,0,0,1,2
9648883,9648994,111,0,0,1,1
9648994,9649016,22,1,0,0,2
9648995,9649017,22,1,0,0,1
9649017,9649611,594,0,0,1,2
9649018,9649607,589,0,0,1,1
9649608,9649623,15,1,0,0,1
9649612,9649623,11,1,0,0,2
9649624,9650575,951,0,0,1,2
9649624,9650576,952,0,0,1,1
9650576,9650681,105,1,0,0,2
9650577,9650681,104,1,0,0,1
9650682,9650787,105,0,0,1,1
9650682,9650787,105,0,0,1,2
9650788,9650812,24,1,0,0,2
9650788,9650823,35,1,0,0,1
9650813,9651287,474,0,0,1,2
9650824,9651011,187,0,0,1,1
9651012,9651020,8,1,0,0,1
9651021,9651286,265,0,0,1,1
9651287,9651471,184,1,0,0,1
9651288,9651441,153,1,0,0,2
9651315,9651426,111,0,1,0,1
9651339,9651398,59,0,1,0,2
9651442,9652420,978,0,0,1,2
9651472,9652421,949,0,0,1,1
9652421,9652474,53,1,0,0,2
9652422,9652477,55,1,0,0,1
9652475,9652577,102,0,0,1,2
9652478,9652577,99,0,0,1,1
9652578,9652603,25,1,0,0,2
9652578,9652604,26,1,0,0,1
9652604,9652774,170,0,0,1,2
9652605,9652771,166,0,0,1,1
9652772,9652782,10,1,0,0,1
9652775,9652779,4,1,0,0,2
9652780,9654266,1486,0,0,1,2
9652783,9654266,1483,0,0,1,1
9654267,9654346,79,1,0,0,1
9654267,9654358,91,1,0,0,2
9654347,9654433,86,0,0,1,1
9654359,9654434,75,0,0,1,2
9654434,9654468,34,1,0,0,1
9654435,9654472,37,1,0,0,2
9654469,9654619,150,0,0,1,1
9654473,9654617,144,0,0,1,2
9654618,9654636,18,1,0,0,2
9654620,9654637,17,1,0,0,1
9654637,9654855,218,0,0,1,2
9654638,9656276,1638,0,0,1,1
9654856,9654860,4,1,0,0,2
9654861,9656278,1417,0,0,1,2
9656277,9656746,469,1,0,0,1
9656279,9656414,135,1,0,0,2
9656357,9656475,118,0,1,0,1
9656415,9656516,101,0,0,1,2
9656517,9656548,31,1,0,0,2
9656534,9656599,65,0,1,0,1
9656549,9656699,150,0,0,1,2
9656700,9656719,19,1,0,0,2
9656720,9657339,619,0,0,1,2
9656747,9656869,122,0,0,1,1
9656870,9656886,16,1,0,0,1
9656887,9657342,455,0,0,1,1
9657340,9657354,14,1,0,0,2
9657343,9657370,27,1,0,0,1
9657355,9657553,198,0,0,1,2
9657371,9657545,174,0,0,1,1
9657546,9657578,32,1,0,0,1
9657554,9657570,16,1,0,0,2
9657571,9658166,595,0,0,1,2
9657579,9658163,584,0,0,1,1
9658164,9658277,113,1,0,0,1
9658167,9658289,122,1,0,0,2
9658278,9658349,71,0,0,1,1
9658290,9658349,59,0,0,1,2
9658350,9658388,38,1,0,0,1
9658350,9658391,41,1,0,0,2
9658389,9660068,1679,0,0,1,1
9658392,9660066,1674,0,0,1,2
9660067,9660163,96,1,0,0,2
9660069,9660164,95,1,0,0,1
9660164,9660315,151,0,0,1,2
9660165,9660317,152,0,0,1,1
9660316,9660337,21,1,0,0,2
9660318,9660345,27,1,0,0,1
9660338,9661801,1463,0,0,1,2
9660346,9661801,1455,0,0,1,1
9661802,9661859,57,1,0,0,1
9661802,9661865,63,1,0,0,2
9661860,9661942,82,0,0,1,1
9661866,9661943,77,0,0,1,2
9661943,9661978,35,1,0,0,1
9661944,9661991,47,1,0,0,2
9661979,9662626,647,0,0,1,1
9661992,9663651,1659,0,0,1,2
9662627,9662638,11,1,0,0,1
9662639,9663650,1011,0,0,1,1
9663651,9663735,84,1,0,0,1
9663652,9663737,85,1,0,0,2
9663736,9663842,106,0,0,1,1
9663738,9663843,105,0,0,1,2
9663843,9663873,30,1,0,0,1
9663844,9663871,27,1,0,0,2
9663872,9664035,163,0,0,1,2
9663874,9664039,165,0,0,1,1
9664036,9664056,20,1,0,0,2
9664040,9664053,13,1,0,0,1
9664054,9665433,1379,0,0,1,1
9664057,9665433,1376,0,0,1,2
9665434,9665532,98,1,0,0,2
9665434,9665540,106,1,0,0,1
9665533,9665640,107,0,0,1,2
9665541,9665640,99,0,0,1,1
9665641,9665665,24,1,0,0,2
9665641,9665671,30,1,0,0,1
9665666,9666279,613,0,0,1,2
9665672,9666282,610,0,0,1,1
9666280,9666301,21,1,0,0,2
9666283,9666308,25,1,0,0,1
9666302,9666405,103,0,0,1,2
9666309,9666404,95,0,0,1,1
9666405,9666427,22,1,0,0,1
9666406,9666430,24,1,0,0,2
9666428,9667197,769,0,0,1,1
9666431,9667196,765,0,0,1,2
9667197,9667291,94,1,0,0,2
9667198,9667292,94,1,0,0,1
9667292,9667411,119,0,0,1,2
9667293,9667411,118,0,0,1,1
9667412,9667430,18,1,0,0,2
9667412,9667431,19,1,0,0,1
9667431,9668952,1521,0,0,1,2
9667432,9668954,1522,0,0,1,1
9668953,9669015,62,1,0,0,2
9668955,9669005,50,1,0,0,1
9669006,9669177,171,0,0,1,1
9669016,9669178,162,0,0,1,2
9669178,9669197,19,1,0,0,1
9669179,9669196,17,1,0,0,2
9669197,9670801,1604,0,0,1,2
9669198,9670802,1604,0,0,1,1
9670802,9670845,43,1,0,0,2
9670803,9670846,43,1,0,0,1
9670846,9671010,164,0,0,1,2
9670847,9671006,159,0,0,1,1
9671007,9671033,26,1,0,0,1
9671011,9671033,22,1,0,0,2
9671034,9672567,1533,0,0,1,1
9671034,9672567,1533,0,0,1,2
9672568,9672623,55,1,0,0,1
9672568,9672626,58,1,0,0,2
9672624,9672735,111,0,0,1,1
9672627,9672736,109,0,0,1,2
9672736,9672757,21,1,0,0,1
9672737,9672757,20,1,0,0,2
9672758,9674292,1534,0,0,1,1
9672758,9674292,1534,0,0,1,2
9674293,9674393,100,1,0,0,2
9674293,9674412,119,1,0,0,1
9674394,9674487,93,0,0,1,2
9674413,9674486,73,0,0,1,1
9674487,9674513,26,1,0,0,1
9674488,9674511,23,1,0,0,2
9674512,9675128,616,0,0,1,2
9674514,9674753,239,0,0,1,1
9674754,9674765,11,1,0,0,1
9674766,9676022,1256,0,0,1,1
9675129,9675148,19,1,0,0,2
9675149,9676022,873,0,0,1,2
9676023,9676131,108,1,0,0,1
9676023,9676131,108,1,0,0,2
9676132,9676214,82,0,0,1,2
9676132,9676215,83,0,0,1,1
9676215,9676254,39,1,0,0,2
9676216,9676252,36,1,0,0,1
9676253,9676423,170,0,0,1,1
9676255,9676424,169,0,0,1,2
9676424,9676449,25,1,0,0,1
9676425,9676442,17,1,0,0,2
9676443,9677576,1133,0,0,1,2
9676450,9677575,1125,0,0,1,1
9677576,9677633,57,1,0,0,1
9677577,9677637,60,1,0,0,2
9677634,9677739,105,0,0,1,1
9677638,9677739,101,0,0,1,2
9677740,9677759,19,1,0,0,1
9677740,9677759,19,1,0,0,2
9677760,9678069,309,0,0,1,2
9677760,9679179,1419,0,0,1,1
9678070,9678079,9,1,0,0,2
9678080,9679178,1098,0,0,1,2
9679179,9679240,61,1,0,0,2
9679180,9679240,60,1,0,0,1
9679241,9679334,93,0,0,1,2
9679241,9679335,94,0,0,1,1
9679335,9679357,22,1,0,0,2
9679336,9679365,29,1,0,0,1
9679358,9680752,1394,0,0,1,2
9679366,9680752,1386,0,0,1,1
9680753,9680813,60,1,0,0,2
9680753,9680814,61,1,0,0,1
9680814,9680923,109,0,0,1,2
9680815,9680922,107,0,0,1,1
9680923,9680945,22,1,0,0,1
9680924,9680945,21,1,0,0,2
9680946,9682334,1388,0,0,1,1
9680946,9682334,1388,0,0,1,2
9682335,9682415,80,1,0,0,2
9682335,9682424,89,1,0,0,1
9682416,9682551,135,0,0,1,2
9682425,9682551,126,0,0,1,1
9682552,9682568,16,1,0,0,2
9682552,9682569,17,1,0,0,1
9682569,9683988,1419,0,0,1,2
9682570,9683988,1418,0,0,1,1
9683989,9684067,78,1,0,0,1
9683989,9684070,81,1,0,0,2
9684068,9684194,126,0,0,1,1
9684071,9684196,125,0,0,1,2
9684195,9684458,263,1,0,0,1
9684197,9684455,258,1,0,0,2
9684219,9684420,201,0,1,0,1
9684225,9684382,157,0,1,0,2
9684456,9684737,281,0,0,1,2
9684459,9684737,278,0,0,1,1
9684738,9684796,58,1,0,0,1
9684738,9684811,73,1,0,0,2
9684797,9684897,100,0,0,1,1
9684812,9684896,84,0,0,1,2
9684897,9684929,32,1,0,0,2
9684898,9684923,25,1,0,0,1
9684924,9686862,1938,0,0,1,1
9684930,9686861,1931,0,0,1,2
9686862,9686921,59,1,0,0,2
9686863,9686921,58,1,0,0,1
9686922,9687034,112,0,0,1,1
9686922,9687034,112,0,0,1,2
9687035,9687056,21,1,0,0,1
9687035,9687057,22,1,0,0,2
9687057,9690853,3796,0,0,1,1
9687058,9690853,3795,0,0,1,2
9690854,9690937,83,1,0,0,2
9690854,9690946,92,1,0,0,1
9690938,9691035,97,0,0,1,2
9690947,9691035,88,0,0,1,1
9691036,9691061,25,1,0,0,1
9691036,9691061,25,1,0,0,2
9691062,9691177,115,0,0,1,1
9691062,9691177,115,0,0,1,2
9691178,9691188,10,1,0,0,2
9691178,9691196,18,1,0,0,1
9691189,9692360,1171,0,0,1,2
9691197,9692361,1164,0,0,1,1
9692361,9692432,71,1,0,0,2
9692362,9692433,71,1,0,0,1
9692433,9694574,2141,0,0,1,2
9692434,9694573,2139,0,0,1,1
9694574,9694832,258,1,0,0,1
9694575,9694826,251,1,0,0,2
9694621,9694794,173,0,1,0,1
9694628,9694770,142,0,1,0,2
9694827,9696043,1216,0,0,1,2
9694833,9696043,1210,0,0,1,1
9696044,9696129,85,1,0,0,2
9696044,9696135,91,1,0,0,1
9696130,9696223,93,0,0,1,2
9696136,9696219,83,0,0,1,1
9696220,9696237,17,1,0,0,1
9696224,9696239,15,1,0,0,2
9696238,9697395,1157,0,0,1,1
9696240,9696626,386,0,0,1,2
9696627,9696637,10,1,0,0,2
9696638,9697396,758,0,0,1,2
9697396,9697448,52,1,0,0,1
9697397,9697456,59,1,0,0,2
9697449,9697852,403,0,0,1,1
9697457,9698127,670,0,0,1,2
9697853,9697864,11,1,0,0,1
9697865,9698121,256,0,0,1,1
9698122,9698132,10,1,0,0,1
9698128,9698132,4,1,0,0,2
9698133,9699789,1656,0,0,1,1
9698133,9699798,1665,0,0,1,2
9699790,9700050,260,1,0,0,1
9699799,9700046,247,1,0,0,2
9699810,9700040,230,0,1,0,1
9699818,9699978,160,0,1,0,2
9700047,9700912,865,0,0,1,2
9700051,9700911,860,0,0,1,1
9700912,9700983,71,1,0,0,1
9700913,9700982,69,1,0,0,2
9700983,9701095,112,0,0,1,2
9700984,9701095,111,0,0,1,1
9701096,9701112,16,1,0,0,1
9701096,9701115,19,1,0,0,2
9701113,9702175,1062,0,0,1,1
9701116,9702174,1058,0,0,1,2
9702175,9702232,57,1,0,0,2
9702176,9702225,49,1,0,0,1
9702226,9702343,117,0,0,1,1
9702233,9702343,110,0,0,1,2
9702344,9702363,19,1,0,0,1
9702344,9702364,20,1,0,0,2
9702364,9702873,509,0,0,1,1
9702365,9702872,507,0,0,1,2
9702873,9702888,15,1,0,0,2
9702874,9702889,15,1,0,0,1
9702889,9705425,2536,0,0,1,2
9702890,9705426,2536,0,0,1,1
9705426,9705496,70,1,0,0,2
9705427,9705505,78,1,0,0,1
9705497,9705608,111,0,0,1,2
9705506,9705608,102,0,0,1,1
9705609,9705639,30,1,0,0,2
9705609,9705640,31,1,0,0,1
9705640,9705998,358,0,0,1,2
9705641,9705997,356,0,0,1,1
9705998,9706009,11,1,0,0,1
9705999,9706009,10,1,0,0,2
9706010,9706123,113,0,0,1,1
9706010,9706127,117,0,0,1,2
9706124,9706140,16,1,0,0,1
9706128,9706139,11,1,0,0,2
9706140,9706871,731,0,0,1,2
9706141,9706870,729,0,0,1,1
9706871,9706911,40,1,0,0,1
9706872,9706911,39,1,0,0,2
9706912,9707054,142,0,0,1,1
9706912,9707054,142,0,0,1,2
9707055,9707075,20,1,0,0,2
9707055,9707076,21,1,0,0,1
9707076,9709391,2315,0,0,1,2
9707077,9709391,2314,0,0,1,1
9709392,9709644,252,1,0,0,2
9709392,9709665,273,1,0,0,1
9709425,9709617,192,0,1,0,1
9709432,9709602,170,0,1,0,2
9709645,9710411,766,0,0,1,2
9709666,9710411,745,0,0,1,1
9710412,9710487,75,1,0,0,1
9710412,9710487,75,1,0,0,2
9710488,9710630,142,0,0,1,1
9710488,9710630,142,0,0,1,2
9710631,9710659,28,1,0,0,1
9710631,9710662,31,1,0,0,2
9710660,9711856,1196,0,0,1,1
9710663,9711856,1193,0,0,1,2
9711857,9711916,59,1,0,0,1
9711857,9711916,59,1,0,0,2
9711917,9712314,397,0,0,1,2
9711917,9712315,398,0,0,1,1
9712315,9712336,21,1,0,0,2
9712316,9712338,22,1,0,0,1
9712337,9714016,1679,0,0,1,2
9712339,9714017,1678,0,0,1,1
9714017,9714029,12,1,0,0,2
9714018,9714027,9,1,0,0,1
9714028,9714260,232,0,0,1,1
9714030,9714257,227,0,0,1,2
9714258,9714284,26,1,0,0,2
9714261,9714284,23,1,0,0,1
9714285,9715240,955,0,0,1,1
9714285,9715240,955,0,0,1,2
9715241,9715296,55,1,0,0,2
9715241,9715297,56,1,0,0,1
9715297,9715413,116,0,0,1,2
9715298,9715413,115,0,0,1,1
9715414,9715437,23,1,0,0,1
9715414,9715437,23,1,0,0,2
9715438,9717300,1862,0,0,1,1
9715438,9717301,1863,0,0,1,2
9717301,9717356,55,1,0,0,1
9717302,9717351,49,1,0,0,2
9717352,9717546,194,0,0,1,2
9717357,9717547,190,0,0,1,1
9717547,9717565,18,1,0,0,2
9717548,9717567,19,1,0,0,1
9717566,9721328,3762,0,0,1,2
9717568,9721328,3760,0,0,1,1
9721329,9721418,89,1,0,0,2
9721329,9721420,91,1,0,0,1
9721419,9721533,114,0,0,1,2
9721421,9721534,113,0,0,1,1
9721534,9721553,19,1,0,0,2
9721535,9721553,18,1,0,0,1
9721554,9721701,147,0,0,1,2
9721554,9723077,1523,0,0,1,1
9721702,9721706,4,1,0,0,2
9721707,9723077,1370,0,0,1,2
9723078,9723143,65,1,0,0,1
9723078,9723144,66,1,0,0,2
9723144,9727013,3869,0,0,1,1
9723145,9727015,3870,0,0,1,2
9727014,9727092,78,1,0,0,1
9727016,9727093,77,1,0,0,2
9727093,9727219,126,0,0,1,1
9727094,9727220,126,0,0,1,2
9727220,9727240,20,1,0,0,1
9727221,9727246,25,1,0,0,2
9727241,9727641,400,0,0,1,1
9727247,9728867,1620,0,0,1,2
9727642,9727651,9,1,0,0,1
9727652,9728867,1215,0,0,1,1
9728868,9728909,41,1,0,0,1
9728868,9728909,41,1,0,0,2
9728910,9729096,186,0,0,1,1
9728910,9729097,187,0,0,1,2
9729097,9729112,15,1,0,0,1
9729098,9729111,13,1,0,0,2
9729112,9730074,962,0,0,1,2
9729113,9730074,961,0,0,1,1
9730075,9730085,10,1,0,0,2
9730075,9730086,11,1,0,0,1
9730086,9731151,1065,0,0,1,2
9730087,9731140,1053,0,0,1,1
9731141,9731628,487,1,0,0,1
9731152,9731611,459,1,0,0,2
9731171,9731617,446,0,1,0,1
9731184,9731342,158,0,1,0,2
9731380,9731565,185,0,1,0,2
9731612,9731813,201,0,0,1,2
9731629,9731814,185,0,0,1,1
9731814,9731864,50,1,0,0,2
9731815,9731854,39,1,0,0,1
9731855,9732571,716,0,0,1,1
9731865,9732573,708,0,0,1,2
9732572,9732640,68,1,0,0,1
9732574,9732641,67,1,0,0,2
9732641,9732748,107,0,0,1,1
9732642,9732748,106,0,0,1,2
9732749,9732767,18,1,0,0,2
9732749,9732768,19,1,0,0,1
9732768,9734680,1912,0,0,1,2
9732769,9734680,1911,0,0,1,1
9734681,9734747,66,1,0,0,2
9734681,9734748,67,1,0,0,1
9734748,9734878,130,0,0,1,2
9734749,9734878,129,0,0,1,1
9734879,9734901,22,1,0,0,2
9734879,9734903,24,1,0,0,1
9734902,9737158,2256,0,0,1,2
9734904,9737155,2251,0,0,1,1
9737156,9737460,304,1,0,0,1
9737159,9737452,293,1,0,0,2
9737183,9737432,249,0,1,0,1
9737192,9737360,168,0,1,0,2
9737453,9737724,271,0,0,1,2
9737461,9737724,263,0,0,1,1
9737725,9737760,35,1,0,0,1
9737725,9737770,45,1,0,0,2
9737761,9738688,927,0,0,1,1
9737771,9738688,917,0,0,1,2
9738689,9738728,39,1,0,0,1
9738689,9738731,42,1,0,0,2
9738729,9738869,140,0,0,1,1
9738732,9738869,137,0,0,1,2
9738870,9738879,9,1,0,0,2
9738870,9738882,12,1,0,0,1
9738880,9739037,157,0,0,1,2
9738883,9739035,152,0,0,1,1
9739036,9739050,14,1,0,0,1
9739038,9739050,12,1,0,0,2
9739051,9740158,1107,0,0,1,1
9739051,9740159,1108,0,0,1,2
9740159,9740208,49,1,0,0,1
9740160,9740205,45,1,0,0,2
9740206,9742281,2075,0,0,1,2
9740209,9742281,2072,0,0,1,1
9742282,9742301,19,1,0,0,1
9742282,9742304,22,1,0,0,2
9742302,9742998,696,0,0,1,1
9742305,9742997,692,0,0,1,2
9742998,9743045,47,1,0,0,2
9742999,9743036,37,1,0,0,1
9743037,9743760,723,0,0,1,1
9743046,9743760,714,0,0,1,2
9743761,9743832,71,1,0,0,1
9743761,9743833,72,1,0,0,2
9743833,9744253,420,0,0,1,1
9743834,9744017,183,0,0,1,2
9744018,9744028,10,1,0,0,2
9744029,9744254,225,0,0,1,2
9744254,9744275,21,1,0,0,1
9744255,9744282,27,1,0,0,2
9744276,9744505,229,0,0,1,1
9744283,9744505,222,0,0,1,2
9744506,9744519,13,1,0,0,1
9744506,9744519,13,1,0,0,2
9744520,9744653,133,0,0,1,1
9744520,9744653,133,0,0,1,2
9744654,9744665,11,1,0,0,1
9744654,9744675,21,1,0,0,2
9744666,9745606,940,0,0,1,1
9744676,9745607,931,0,0,1,2
9745607,9745656,49,1,0,0,1
9745608,9745651,43,1,0,0,2
9745652,9745905,253,0,0,1,2
9745657,9745906,249,0,0,1,1
9745906,9745926,20,1,0,0,2
9745907,9745928,21,1,0,0,1
9745927,9749469,3542,0,0,1,2
9745929,9749468,3539,0,0,1,1
9749469,9749546,77,1,0,0,1
9749470,9749555,85,1,0,0,2
9749547,9749657,110,0,0,1,1
9749556,9749657,101,0,0,1,2
9749658,9749679,21,1,0,0,1
9749658,9749698,40,1,0,0,2
9749680,9749764,84,0,0,1,1
9749699,9749764,65,0,0,1,2
9749765,9749795,30,1,0,0,2
9749765,9749797,32,1,0,0,1
9749796,9749896,100,0,0,1,2
9749798,9749897,99,0,0,1,1
9749897,9749916,19,1,0,0,2
9749898,9749915,17,1,0,0,1
9749916,9750849,933,0,0,1,1
9749917,9751006,1089,0,0,1,2
9750850,9750855,5,1,0,0,1
9750856,9751006,150,0,0,1,1
9751007,9751090,83,1,0,0,1
9751007,9751091,84,1,0,0,2
9751091,9751348,257,0,0,1,1
9751092,9751348,256,0,0,1,2
9751349,9751371,22,1,0,0,1
9751349,9751372,23,1,0,0,2
9751372,9753361,1989,0,0,1,1
9751373,9753371,1998,0,0,1,2
9753362,9753679,317,1,0,0,1
9753372,9753677,305,1,0,0,2
9753391,9753657,266,0,1,0,1
9753406,9753587,181,0,1,0,2
9753622,9753622,0,0,1,0,2
9753678,9754545,867,0,0,1,2
9753680,9754545,865,0,0,1,1
9754546,9754645,99,1,0,0,1
9754546,9754648,102,1,0,0,2
9754646,9754756,110,0,0,1,1
9754649,9754754,105,0,0,1,2
9754755,9754779,24,1,0,0,2
9754757,9754780,23,1,0,0,1
9754780,9755952,1172,0,0,1,2
9754781,9755952,1171,0,0,1,1
9755953,9756016,63,1,0,0,2
9755953,9756028,75,1,0,0,1
9756017,9756125,108,0,0,1,2
9756029,9756125,96,0,0,1,1
9756126,9756153,27,1,0,0,1
9756126,9756153,27,1,0,0,2
9756154,9756581,427,0,0,1,2
9756154,9756588,434,0,0,1,1
9756582,9756594,12,1,0,0,2
9756589,9756594,5,1,0,0,1
9756595,9758700,2105,0,0,1,2
9756595,9758702,2107,0,0,1,1
9758701,9758770,69,1,0,0,2
9758703,9758764,61,1,0,0,1
9758765,9759368,603,0,0,1,1
9758771,9759369,598,0,0,1,2
9759369,9759434,65,1,0,0,1
9759370,9759437,67,1,0,0,2
9759435,9759575,140,0,0,1,1
9759438,9759572,134,0,0,1,2
9759573,9759601,28,1,0,0,2
9759576,9759591,15,1,0,0,1
9759592,9761149,1557,0,0,1,1
9759602,9761149,1547,0,0,1,2
9761150,9761214,64,1,0,0,1
9761150,9761217,67,1,0,0,2
9761215,9761367,152,0,0,1,1
9761218,9761366,148,0,0,1,2
9761367,9761389,22,1,0,0,2
9761368,9761396,28,1,0,0,1
9761390,9761819,429,0,0,1,2
9761397,9761818,421,0,0,1,1
9761819,9761838,19,1,0,0,1
9761820,9761839,19,1,0,0,2
9761839,9763438,1599,0,0,1,1
9761840,9763437,1597,0,0,1,2
9763438,9763468,30,1,0,0,2
9763439,9763459,20,1,0,0,1
9763460,9764959,1499,0,0,1,1
9763469,9764959,1490,0,0,1,2
9764960,9765060,100,1,0,0,2
9764960,9765062,102,1,0,0,1
9765061,9765155,94,0,0,1,2
9765063,9765155,92,0,0,1,1
9765156,9765196,40,1,0,0,2
9765156,9765197,41,1,0,0,1
9765197,9765450,253,0,0,1,2
9765198,9765450,252,0,0,1,1
9765451,9765474,23,1,0,0,1
9765451,9765482,31,1,0,0,2
9765475,9766764,1289,0,0,1,1
9765483,9766764,1281,0,0,1,2
9766765,9766802,37,1,0,0,2
9766765,9766808,43,1,0,0,1
9766803,9767048,245,0,0,1,2
9766809,9767048,239,0,0,1,1
9767049,9767067,18,1,0,0,1
9767049,9767068,19,1,0,0,2
9767068,9769192,2124,0,0,1,1
9767069,9769191,2122,0,0,1,2
9769192,9769245,53,1,0,0,2
9769193,9769246,53,1,0,0,1
9769246,9770684,1438,0,0,1,2
9769247,9770684,1437,0,0,1,1
9770685,9770754,69,1,0,0,1
9770685,9770756,71,1,0,0,2
9770755,9770849,94,0,0,1,1
9770757,9770850,93,0,0,1,2
9770850,9770872,22,1,0,0,1
9770851,9770874,23,1,0,0,2
9770873,9770991,118,0,0,1,1
9770875,9770990,115,0,0,1,2
9770991,9770998,7,1,0,0,2
9770992,9770998,6,1,0,0,1
9770999,9772463,1464,0,0,1,1
9770999,9772463,1464,0,0,1,2
9772464,9772507,43,1,0,0,2
9772464,9772508,44,1,0,0,1
9772508,9772635,127,0,0,1,2
9772509,9772635,126,0,0,1,1
9772636,9772654,18,1,0,0,1
9772636,9772654,18,1,0,0,2
9772655,9776427,3772,0,0,1,1
9772655,9776428,3773,0,0,1,2
9776428,9776488,60,1,0,0,1
9776429,9776495,66,1,0,0,2
9776489,9776607,118,0,0,1,1
9776496,9776608,112,0,0,1,2
9776608,9776632,24,1,0,0,1
9776609,9776634,25,1,0,0,2
9776633,9776897,264,0,0,1,1
9776635,9776899,264,0,0,1,2
9776898,9776914,16,1,0,0,1
9776900,9776924,24,1,0,0,2
9776915,9778795,1880,0,0,1,1
9776925,9778795,1870,0,0,1,2
9778796,9778854,58,1,0,0,2
9778796,9778861,65,1,0,0,1
9778855,9781624,2769,0,0,1,2
9778862,9781624,2762,0,0,1,1
9781625,9781687,62,1,0,0,1
9781625,9781688,63,1,0,0,2
9781688,9782775,1087,0,0,1,1
9781689,9782774,1085,0,0,1,2
9782775,9782845,70,1,0,0,2
9782776,9782852,76,1,0,0,1
9782846,9783009,163,0,0,1,2
9782853,9783008,155,0,0,1,1
9783009,9783029,20,1,0,0,1
9783010,9783029,19,1,0,0,2
9783030,9783534,504,0,0,1,1
9783030,9783534,504,0,0,1,2
9783535,9783543,8,1,0,0,1
9783535,9783543,8,1,0,0,2
9783544,9784224,680,0,0,1,1
9783544,9784224,680,0,0,1,2
9784225,9784290,65,1,0,0,1
9784225,9784290,65,1,0,0,2
9784291,9784547,256,0,0,1,2
9784291,9784548,257,0,0,1,1
9784548,9784552,4,1,0,0,2
9784549,9784556,7,1,0,0,1
9784553,9786582,2029,0,0,1,2
9784557,9786578,2021,0,0,1,1
9786579,9786930,351,1,0,0,1
9786583,9786920,337,1,0,0,2
9786615,9786893,278,0,1,0,1
9786625,9786844,219,0,1,0,2
9786921,9787938,1017,0,0,1,2
9786931,9787937,1006,0,0,1,1
9787938,9788003,65,1,0,0,1
9787939,9788002,63,1,0,0,2
9788003,9788128,125,0,0,1,2
9788004,9788127,123,0,0,1,1
9788128,9788159,31,1,0,0,1
9788129,9788160,31,1,0,0,2
9788160,9788490,330,0,0,1,1
9788161,9789714,1553,0,0,1,2
9788491,9788499,8,1,0,0,1
9788500,9789715,1215,0,0,1,1
9789715,9789761,46,1,0,0,2
9789716,9789762,46,1,0,0,1
9789762,9790491,729,0,0,1,2
9789763,9790491,728,0,0,1,1
9790492,9790511,19,1,0,0,2
9790492,9790512,20,1,0,0,1
9790512,9791516,1004,0,0,1,2
9790513,9791503,990,0,0,1,1
9791504,9791681,177,1,0,0,1
9791517,9791685,168,1,0,0,2
9791528,9791654,126,0,1,0,1
9791542,9791557,15,0,1,0,2
9791584,9791590,6,0,1,0,2
9791682,9791787,105,0,0,1,1
9791686,9791788,102,0,0,1,2
9791788,9792112,324,1,0,0,1
9791789,9792156,367,1,0,0,2
9791807,9792091,284,0,1,0,1
9791815,9792036,221,0,1,0,2
9792069,9792074,5,0,1,0,2
9792113,9793794,1681,0,0,1,1
9792157,9793794,1637,0,0,1,2
9793795,9793871,76,1,0,0,1
9793795,9793879,84,1,0,0,2
9793872,9793982,110,0,0,1,1
9793880,9793981,101,0,0,1,2
9793982,9794013,31,1,0,0,2
9793983,9794002,19,1,0,0,1
9794003,9795207,1204,0,0,1,1
9794014,9795207,1193,0,0,1,2
9795208,9795283,75,1,0,0,1
9795208,9795283,75,1,0,0,2
9795284,9795434,150,0,0,1,1
9795284,9795436,152,0,0,1,2
9795435,9795455,20,1,0,0,1
9795437,9795451,14,1,0,0,2
9795452,9797295,1843,0,0,1,2
9795456,9797295,1839,0,0,1,1
9797296,9797791,495,1,0,0,1
9797296,9797800,504,1,0,0,2
9797338,9797780,442,0,1,0,1
9797348,9797789,441,0,1,0,2
9797792,9798760,968,0,0,1,1
9797801,9798760,959,0,0,1,2
9798761,9798832,71,1,0,0,2
9798761,9798836,75,1,0,0,1
9798833,9798934,101,0,0,1,2
9798837,9798933,96,0,0,1,1
9798934,9798961,27,1,0,0,1
9798935,9798961,26,1,0,0,2
9798962,9799209,247,0,0,1,1
9798962,9799212,250,0,0,1,2
9799210,9799235,25,1,0,0,1
9799213,9799231,18,1,0,0,2
9799232,9799913,681,0,0,1,2
9799236,9799913,677,0,0,1,1
9799914,9799939,25,1,0,0,1
9799914,9799939,25,1,0,0,2
9799940,9800443,503,0,0,1,1
9799940,9800444,504,0,0,1,2
9800444,9800499,55,1,0,0,1
9800445,9800506,61,1,0,0,2
9800500,9800684,184,0,0,1,1
9800507,9800688,181,0,0,1,2
9800685,9800703,18,1,0,0,1
9800689,9800705,16,1,0,0,2
9800704,9800922,218,0,0,1,1
9800706,9800925,219,0,0,1,2
9800923,9800943,20,1,0,0,1
9800926,9800943,17,1,0,0,2
9800944,9802052,1108,0,0,1,1
9800944,9802564,1620,0,0,1,2
9802053,9802061,8,1,0,0,1
9802062,9802561,499,0,0,1,1
9802562,9802814,252,1,0,0,1
9802565,9802788,223,1,0,0,2
9802587,9802766,179,0,1,0,1
9802596,9802718,122,0,1,0,2
9802789,9804408,1619,0,0,1,2
9802815,9804409,1594,0,0,1,1
9804409,9804494,85,1,0,0,2
9804410,9804494,84,1,0,0,1
9804495,9804609,114,0,0,1,2
9804495,9804610,115,0,0,1,1
9804610,9804630,20,1,0,0,2
9804611,9804638,27,1,0,0,1
9804631,9804832,201,0,0,1,2
9804639,9804831,192,0,0,1,1
9804832,9804860,28,1,0,0,1
9804833,9804861,28,1,0,0,2
9804861,9805522,661,0,0,1,1
9804862,9805522,660,0,0,1,2
9805523,9805562,39,1,0,0,1
9805523,9805563,40,1,0,0,2
9805563,9805675,112,0,0,1,1
9805564,9805676,112,0,0,1,2
9805676,9805696,20,1,0,0,1
9805677,9805697,20,1,0,0,2
9805697,9807522,1825,0,0,1,1
9805698,9807517,1819,0,0,1,2
9807518,9807837,319,1,0,0,2
9807523,9807809,286,1,0,0,1
9807538,9807785,247,0,1,0,1
9807549,9807782,233,0,1,0,2
9807810,9808141,331,0,0,1,1
9807838,9808142,304,0,0,1,2
9808142,9808183,41,1,0,0,1
9808143,9808181,38,1,0,0,2
9808182,9808865,683,0,0,1,2
9808184,9808864,680,0,0,1,1
9808865,9808939,74,1,0,0,1
9808866,9808949,83,1,0,0,2
9808940,9808968,28,0,0,1,1
9808950,9808980,30,0,0,1,2
9808969,9809698,729,1,0,0,1
9808981,9809559,578,1,0,0,2
9808989,9809687,698,0,1,0,1
9808998,9809548,550,0,1,0,2
9809560,9809597,37,0,0,1,2
9809598,9809619,21,1,0,0,2
9809620,9810111,491,0,0,1,2
9809699,9810113,414,0,0,1,1
9810112,9810131,19,1,0,0,2
9810114,9810131,17,1,0,0,1
9810132,9810299,167,0,0,1,1
9810132,9810300,168,0,0,1,2
9810300,9810323,23,1,0,0,1
9810301,9810333,32,1,0,0,2
9810324,9810557,233,0,0,1,1
9810334,9810557,223,0,0,1,2
9810558,9810614,56,1,0,0,2
9810558,9810622,64,1,0,0,1
9810615,9812150,1535,0,0,1,2
9810623,9811510,887,0,0,1,1
9811521,9811527,6,0,1,0,1
9811537,9811538,1,1,0,0,1
9811539,9811715,176,0,0,1,1
9811726,9811783,57,0,1,0,1
9811793,9811797,4,1,0,0,1
9811798,9812147,349,0,0,1,1
9812148,9812243,95,1,0,0,1
9812151,9812176,25,1,0,0,2
9812177,9812361,184,0,0,1,2
9812244,9812288,44,0,0,1,1
9812289,9812328,39,1,0,0,1
9812300,9812319,19,0,1,0,1
9812329,9812359,30,0,0,1,1
9812360,9812397,37,1,0,0,1
9812362,9812390,28,1,0,0,2
9812391,9813169,778,0,0,1,2
9812398,9812443,45,0,0,1,1
9812454,9813199,745,0,1,0,1
9813170,9813233,63,1,0,0,2
9813209,9813234,25,1,0,0,1
9813234,9814020,786,0,0,1,2
9813235,9814019,784,0,0,1,1
9814020,9814081,61,1,0,0,1
9814021,9814082,61,1,0,0,2
9814082,9814197,115,0,0,1,1
9814083,9814198,115,0,0,1,2
9814198,9814218,20,1,0,0,1
9814199,9814227,28,1,0,0,2
9814219,9815594,1375,0,0,1,1
9814228,9815595,1367,0,0,1,2
9815595,9815654,59,1,0,0,1
9815596,9815656,60,1,0,0,2
9815655,9815843,188,0,0,1,1
9815657,9815843,186,0,0,1,2
9815844,9815855,11,1,0,0,1
9815844,9815859,15,1,0,0,2
9815856,9818616,2760,0,0,1,1
9815860,9818617,2757,0,0,1,2
9818617,9818661,44,1,0,0,1
9818618,9818670,52,1,0,0,2
9818662,9819413,751,0,0,1,1
9818671,9819414,743,0,0,1,2
9819414,9819520,106,1,0,0,1
9819415,9819519,104,1,0,0,2
9819520,9819596,76,0,0,1,2
9819521,9819598,77,0,0,1,1
9819597,9819632,35,1,0,0,2
9819599,9819625,26,1,0,0,1
9819626,9819766,140,0,0,1,1
9819633,9819762,129,0,0,1,2
9819763,9819784,21,1,0,0,2
9819767,9819785,18,1,0,0,1
9819785,9819926,141,0,0,1,2
9819786,9819931,145,0,0,1,1
9819927,9819946,19,1,0,0,2
9819932,9819943,11,1,0,0,1
9819944,9821005,1061,0,0,1,1
9819947,9821005,1058,0,0,1,2
9821006,9821064,58,1,0,0,1
9821006,9821064,58,1,0,0,2
9821065,9823622,2557,0,0,1,1
9821065,9823622,2557,0,0,1,2
9823623,9823694,71,1,0,0,1
9823623,9823701,78,1,0,0,2
9823695,9824804,1109,0,0,1,1
9823702,9824804,1102,0,0,1,2
9824805,9824855,50,1,0,0,1
9824805,9824856,51,1,0,0,2
9824856,9824928,72,0,0,1,1
9824857,9824928,71,0,0,1,2
9824929,9824952,23,1,0,0,2
9824929,9824953,24,1,0,0,1
9824953,9825070,117,0,0,1,2
9824954,9825069,115,0,0,1,1
9825070,9825087,17,1,0,0,1
9825071,9825089,18,1,0,0,2
9825088,9825258,170,0,0,1,1
9825090,9826279,1189,0,0,1,2
9825259,9825263,4,1,0,0,1
9825264,9826279,1015,0,0,1,1
9826280,9826328,48,1,0,0,2
9826280,9826329,49,1,0,0,1
9826329,9827107,778,0,0,1,2
9826330,9827108,778,0,0,1,1
9827108,9827129,21,1,0,0,2
9827109,9827127,18,1,0,0,1
9827128,9829207,2079,0,0,1,1
9827130,9829207,2077,0,0,1,2
9829208,9829231,23,1,0,0,1
9829208,9829244,36,1,0,0,2
9829232,9829969,737,0,0,1,1
9829245,9829968,723,0,0,1,2
9829969,9830048,79,1,0,0,2
9829970,9830049,79,1,0,0,1
9830049,9830164,115,0,0,1,2
9830050,9830162,112,0,0,1,1
9830163,9830183,20,1,0,0,1
9830165,9830181,16,1,0,0,2
9830182,9830296,114,0,0,1,2
9830184,9830296,112,0,0,1,1
9830297,9830322,25,1,0,0,1
9830297,9830324,27,1,0,0,2
9830323,9831762,1439,0,0,1,1
9830325,9831761,1436,0,0,1,2
9831762,9831819,57,1,0,0,2
9831763,9831821,58,1,0,0,1
9831820,9835609,3789,0,0,1,2
9831822,9835608,3786,0,0,1,1
9835609,9835674,65,1,0,0,1
9835610,9835673,63,1,0,0,2
9835674,9835857,183,0,0,1,2
9835675,9835858,183,0,0,1,1
9835858,9835912,54,1,0,0,2
9835859,9836182,323,1,0,0,1
9835913,9835944,31,0,0,1,2
9835945,9836156,211,1,0,0,2
9835957,9836138,181,0,1,0,1
9835967,9836099,132,0,1,0,2
9836157,9836264,107,0,0,1,2
9836183,9836263,80,0,0,1,1
9836264,9836286,22,1,0,0,1
9836265,9836288,23,1,0,0,2
9836287,9836488,201,0,0,1,1
9836289,9836486,197,0,0,1,2
9836487,9836511,24,1,0,0,2
9836489,9836511,22,1,0,0,1
9836512,9836947,435,0,0,1,1
9836512,9836947,435,0,0,1,2
9881130,9881415,285,0,0,1,2
9881130,9881416,286,0,0,1,1
9881416,9881486,70,1,0,0,2
9881417,9881495,78,1,0,0,1
9881487,9881575,88,0,0,1,2
9881496,9881574,78,0,0,1,1
9881575,9881600,25,1,0,0,1
9881576,9881607,31,1,0,0,2
9881601,9882373,772,0,0,1,1
9881608,9882375,767,0,0,1,2
9882374,9882394,20,1,0,0,1
9882376,9882395,19,1,0,0,2
9882395,9883593,1198,0,0,1,1
9882396,9883592,1196,0,0,1,2
9883593,9883671,78,1,0,0,2
9883594,9883672,78,1,0,0,1
9883672,9883779,107,0,0,1,2
9883673,9883778,105,0,0,1,1
9883779,9883799,20,1,0,0,1
9883780,9883799,19,1,0,0,2
9883800,9885357,1557,0,0,1,1
9883800,9885357,1557,0,0,1,2
9885358,9885408,50,1,0,0,1
9885358,9885417,59,1,0,0,2
9885409,9885564,155,0,0,1,1
9885418,9885563,145,0,0,1,2
9885564,9885573,9,1,0,0,2
9885565,9885575,10,1,0,0,1
9885574,9885810,236,0,0,1,2
9885576,9885961,385,0,0,1,1
9885811,9885816,5,1,0,0,2
9885817,9885961,144,0,0,1,2
9885962,9885974,12,1,0,0,1
9885962,9885974,12,1,0,0,2
9885975,9886978,1003,0,0,1,1
9885975,9886978,1003,0,0,1,2
9886979,9887034,55,1,0,0,1
9886979,9887041,62,1,0,0,2
9887035,9887117,82,0,0,1,1
9887042,9887116,74,0,0,1,2
9887117,9887143,26,1,0,0,2
9887118,9887141,23,1,0,0,1
9887142,9887255,113,0,0,1,1
9887144,9887254,110,0,0,1,2
9887255,9887274,19,1,0,0,2
9887256,9887273,17,1,0,0,1
9887274,9888619,1345,0,0,1,1
9887275,9888619,1344,0,0,1,2
9888620,9888693,73,1,0,0,1
9888620,9888693,73,1,0,0,2
9888694,9888889,195,0,0,1,1
9888694,9888891,197,0,0,1,2
9888890,9888902,12,1,0,0,1
9888892,9888904,12,1,0,0,2
9888903,9890233,1330,0,0,1,1
9888905,9890233,1328,0,0,1,2
9890234,9890310,76,1,0,0,1
9890234,9890313,79,1,0,0,2
9890311,9890407,96,0,0,1,1
9890314,9890406,92,0,0,1,2
9890407,9890427,20,1,0,0,2
9890408,9890427,19,1,0,0,1
9890428,9890772,344,0,0,1,2
9890428,9890926,498,0,0,1,1
9890773,9890782,9,1,0,0,2
9890783,9890920,137,0,0,1,2
9890921,9890931,10,1,0,0,2
9890927,9890932,5,1,0,0,1
9890932,9891937,1005,0,0,1,2
9890933,9891939,1006,0,0,1,1
9891938,9892053,115,1,0,0,2
9891940,9892062,122,1,0,0,1
9892054,9892157,103,0,0,1,2
9892063,9892157,94,0,0,1,1
9892158,9892194,36,1,0,0,1
9892158,9892194,36,1,0,0,2
9892195,9892484,289,0,0,1,1
9892195,9892484,289,0,0,1,2
9892485,9892489,4,1,0,0,2
9892485,9892495,10,1,0,0,1
9892490,9893287,797,0,0,1,2
9892496,9893287,791,0,0,1,1
9893288,9893369,81,1,0,0,1
9893288,9893370,82,1,0,0,2
9893370,9893556,186,0,0,1,1
9893371,9893556,185,0,0,1,2
9893557,9893618,61,1,0,0,2
9893557,9893620,63,1,0,0,1
9893619,9893726,107,0,0,1,2
9893621,9893725,104,0,0,1,1
9893726,9893748,22,1,0,0,1
9893727,9893747,20,1,0,0,2
9893748,9893909,161,0,0,1,2
9893749,9893909,160,0,0,1,1
9893910,9893919,9,1,0,0,1
9893910,9893920,10,1,0,0,2
9893920,9894885,965,0,0,1,1
9893921,9894885,964,0,0,1,2
9894886,9894965,79,1,0,0,1
9894886,9894965,79,1,0,0,2
9894966,9895304,338,0,0,1,1
9894966,9895304,338,0,0,1,2
9895305,9895371,66,1,0,0,1
9895305,9895372,67,1,0,0,2
9895372,9895449,77,0,0,1,1
9895373,9895449,76,0,0,1,2
9895450,9895471,21,1,0,0,2
9895450,9895472,22,1,0,0,1
9895472,9897213,1741,0,0,1,2
9895473,9897212,1739,0,0,1,1
9897213,9897280,67,1,0,0,1
9897214,9897279,65,1,0,0,2
9897280,9897360,80,0,0,1,2
9897281,9897360,79,0,0,1,1
9897361,9897383,22,1,0,0,1
9897361,9897392,31,1,0,0,2
9897384,9899083,1699,0,0,1,1
9897393,9897530,137,0,0,1,2
9897531,9897541,10,1,0,0,2
9897542,9899083,1541,0,0,1,2
9899084,9899141,57,1,0,0,1
9899084,9899148,64,1,0,0,2
9899142,9899285,143,0,0,1,1
9899149,9899285,136,0,0,1,2
9899286,9899303,17,1,0,0,2
9899286,9899305,19,1,0,0,1
9899304,9899930,626,0,0,1,2
9899306,9899790,484,0,0,1,1
9899791,9899803,12,1,0,0,1
9899804,9899929,125,0,0,1,1
9899930,9899942,12,1,0,0,1
9899931,9899940,9,1,0,0,2
9899941,9900874,933,0,0,1,2
9899943,9900873,930,0,0,1,1
9900874,9900953,79,1,0,0,1
9900875,9900953,78,1,0,0,2
9900954,9901908,954,0,0,1,1
9900954,9901915,961,0,0,1,2
9901909,9902216,307,1,0,0,1
9901916,9902162,246,1,0,0,2
9901945,9902159,214,0,1,0,1
9901984,9902128,144,0,1,0,2
9902163,9902462,299,0,0,1,2
9902217,9902462,245,0,0,1,1
9902463,9902532,69,1,0,0,1
9902463,9902539,76,1,0,0,2
9902533,9902678,145,0,0,1,1
9902540,9902677,137,0,0,1,2
9902678,9902758,80,1,0,0,2
9902679,9902757,78,1,0,0,1
9902758,9902845,87,0,0,1,1
9902759,9902845,86,0,0,1,2
9902846,9902874,28,1,0,0,2
9902846,9902878,32,1,0,0,1
9902875,9903066,191,0,0,1,2
9902879,9903064,185,0,0,1,1
9903065,9903081,16,1,0,0,1
9903067,9903081,14,1,0,0,2
9903082,9903195,113,0,0,1,1
9903082,9903198,116,0,0,1,2
9903196,9903218,22,1,0,0,1
9903199,9903215,16,1,0,0,2
9903216,9903934,718,0,0,1,2
9903219,9903935,716,0,0,1,1
9903935,9903986,51,1,0,0,2
9903936,9903976,40,1,0,0,1
9903977,9904310,333,0,0,1,1
9903987,9904309,322,0,0,1,2
9904310,9904370,60,1,0,0,2
9904311,9904372,61,1,0,0,1
9904371,9904469,98,0,0,1,2
9904373,9904468,95,0,0,1,1
9904469,9904492,23,1,0,0,1
9904470,9904494,24,1,0,0,2
9904493,9904674,181,0,0,1,1
9904495,9904669,174,0,0,1,2
9904670,9904687,17,1,0,0,2
9904675,9904684,9,1,0,0,1
9904685,9905852,1167,0,0,1,1
9904688,9905179,491,0,0,1,2
9905180,9905194,14,1,0,0,2
9905195,9905852,657,0,0,1,2
9905853,9905905,52,1,0,0,2
9905853,9905912,59,1,0,0,1
9905906,9906058,152,0,0,1,2
9905913,9906057,144,0,0,1,1
9906058,9906118,60,1,0,0,1
9906059,9906128,69,1,0,0,2
9906119,9906315,196,0,0,1,1
9906129,9906317,188,0,0,1,2
9906316,9906330,14,1,0,0,1
9906318,9906328,10,1,0,0,2
9906329,9906589,260,0,0,1,2
9906331,9906588,257,0,0,1,1
9906589,9906604,15,1,0,0,1
9906590,9906603,13,1,0,0,2
9906604,9907253,649,0,0,1,2
9906605,9907251,646,0,0,1,1
9907252,9907302,50,1,0,0,1
9907254,9907272,18,1,0,0,2
9907273,9907740,467,0,0,1,2
9907303,9907739,436,0,0,1,1
9907740,9907798,58,1,0,0,1
9907741,9907797,56,1,0,0,2
9907798,9907907,109,0,0,1,2
9907799,9907907,108,0,0,1,1
9907908,9907928,20,1,0,0,1
9907908,9907928,20,1,0,0,2
9907929,9908703,774,0,0,1,2
9907929,9908704,775,0,0,1,1
9908704,9908718,14,1,0,0,2
9908705,9908715,10,1,0,0,1
9908716,9908920,204,0,0,1,1
9908719,9908919,200,0,0,1,2
9908920,9908965,45,1,0,0,2
9908921,9908966,45,1,0,0,1
9908966,9909318,352,0,0,1,2
9908967,9909318,351,0,0,1,1
9909319,9909390,71,1,0,0,2
9909319,9909391,72,1,0,0,1
9909391,9909538,147,0,0,1,2
9909392,9909540,148,0,0,1,1
9909539,9909563,24,1,0,0,2
9909541,9909563,22,1,0,0,1
9909564,9910804,1240,0,0,1,1
9909564,9910806,1242,0,0,1,2
9910805,9910878,73,1,0,0,1
9910807,9910877,70,1,0,0,2
9910878,9911016,138,0,0,1,2
9910879,9911016,137,0,0,1,1
9911017,9911122,105,1,0,0,2
9911017,9911236,219,1,0,0,1
9911123,9911166,43,0,0,1,2
9911167,9911241,74,1,0,0,2
9911237,9911319,82,0,0,1,1
9911242,9911318,76,0,0,1,2
9911319,9911343,24,1,0,0,2
9911320,9911345,25,1,0,0,1
9911344,9911536,192,0,0,1,2
9911346,9911537,191,0,0,1,1
9911537,9911554,17,1,0,0,2
9911538,9911554,16,1,0,0,1
9911555,9912293,738,0,0,1,2
9911555,9912294,739,0,0,1,1
9912294,9912306,12,1,0,0,2
9912295,9912307,12,1,0,0,1
9912307,9912958,651,0,0,1,2
9912308,9912956,648,0,0,1,1
9912957,9913126,169,1,0,0,1
9912959,9913116,157,1,0,0,2
9913117,9913215,98,0,0,1,2
9913127,9913216,89,0,0,1,1
9913216,9913250,34,1,0,0,2
9913217,9913255,38,1,0,0,1
9913251,9913563,312,0,0,1,2
9913256,9913563,307,0,0,1,1
9913564,9913580,16,1,0,0,2
9913564,9913589,25,1,0,0,1
9913581,9913694,113,0,0,1,2
9913590,9913699,109,0,0,1,1
9913695,9913711,16,1,0,0,2
9913700,9913714,14,1,0,0,1
9913712,9914363,651,0,0,1,2
9913715,9914362,647,0,0,1,1
9914363,9914444,81,1,0,0,1
9914364,9914447,83,1,0,0,2
9914445,9914597,152,0,0,1,1
9914448,9914597,149,0,0,1,2
9914598,9914663,65,1,0,0,1
9914598,9914663,65,1,0,0,2
9914664,9914806,142,0,0,1,1
9914664,9914807,143,0,0,1,2
9914807,9914854,47,1,0,0,1
9914808,9914854,46,1,0,0,2
9914855,9914977,122,0,0,1,1
9914855,9914977,122,0,0,1,2
9914978,9914999,21,1,0,0,1
9914978,9914999,21,1,0,0,2
9915000,9915106,106,0,0,1,1
9915000,9915106,106,0,0,1,2
9915107,9915127,20,1,0,0,1
9915107,9915127,20,1,0,0,2
9915128,9916001,873,0,0,1,1
9915128,9916001,873,0,0,1,2
9916002,9916055,53,1,0,0,1
9916002,9916055,53,1,0,0,2
9916056,9916453,397,0,0,1,1
9916056,9916454,398,0,0,1,2
9916454,9916521,67,1,0,0,1
9916455,9916520,65,1,0,0,2
9916521,9916625,104,0,0,1,2
9916522,9916625,103,0,0,1,1
9916626,9916647,21,1,0,0,1
9916626,9916657,31,1,0,0,2
9916648,9918037,1389,0,0,1,1
9916658,9917006,348,0,0,1,2
9917007,9917011,4,1,0,0,2
9917012,9918037,1025,0,0,1,2
9918038,9918106,68,1,0,0,1
9918038,9918107,69,1,0,0,2
9918107,9918274,167,0,0,1,1
9918108,9918273,165,0,0,1,2
9918274,9918361,87,1,0,0,2
9918275,9918361,86,1,0,0,1
9918362,9918474,112,0,0,1,1
9918362,9918474,112,0,0,1,2
9918475,9918498,23,1,0,0,2
9918475,9918508,33,1,0,0,1
9918499,9918819,320,0,0,1,2
9918509,9918818,309,0,0,1,1
9918819,9918844,25,1,0,0,1
9918820,9918843,23,1,0,0,2
9918844,9918937,93,0,0,1,2
9918845,9918935,90,0,0,1,1
9918936,9918959,23,1,0,0,1
9918938,9918959,21,1,0,0,2
9918960,9919608,648,0,0,1,2
9918960,9919609,649,0,0,1,1
9919609,9919676,67,1,0,0,2
9919610,9919676,66,1,0,0,1
9919677,9920034,357,0,0,1,1
9919677,9920035,358,0,0,1,2
9920035,9920118,83,1,0,0,1
9920036,9920125,89,1,0,0,2
9920119,9920221,102,0,0,1,1
9920126,9920222,96,0,0,1,2
9920222,9920246,24,1,0,0,1
9920223,9920245,22,1,0,0,2
9920246,9920435,189,0,0,1,2
9920247,9920439,192,0,0,1,1
9920436,9920459,23,1,0,0,2
9920440,9920452,12,1,0,0,1
9920453,9921482,1029,0,0,1,1
9920460,9921482,1022,0,0,1,2
9921483,9921534,51,1,0,0,2
9921483,9921537,54,1,0,0,1
9921535,9921730,195,0,0,1,2
9921538,9921732,194,0,0,1,1
9921731,9921804,73,1,0,0,2
9921733,9921804,71,1,0,0,1
9921805,9921889,84,0,0,1,2
9921805,9921890,85,0,0,1,1
9921890,9921916,26,1,0,0,2
9921891,9921916,25,1,0,0,1
9921917,9922102,185,0,0,1,2
9921917,9922105,188,0,0,1,1
9922103,9922130,27,1,0,0,2
9922106,9922131,25,1,0,0,1
9922131,9922299,168,0,0,1,2
9922132,9922298,166,0,0,1,1
9922299,9922312,13,1,0,0,1
9922300,9922312,12,1,0,0,2
9922313,9923356,1043,0,0,1,1
9922313,9923357,1044,0,0,1,2
9923357,9923446,89,1,0,0,1
9923358,9923457,99,1,0,0,2
9923447,9923567,120,0,0,1,1
9923458,9923567,109,0,0,1,2
9923568,9923600,32,1,0,0,1
9923568,9923603,35,1,0,0,2
9923601,9923713,112,0,0,1,1
9923604,9923713,109,0,0,1,2
9923714,9923735,21,1,0,0,1
9923714,9923737,23,1,0,0,2
9923736,9924684,948,0,0,1,1
9923738,9924684,946,0,0,1,2
9924685,9924725,40,1,0,0,1
9924685,9924734,49,1,0,0,2
9924726,9925103,377,0,0,1,1
9924735,9925104,369,0,0,1,2
9925104,9925253,149,1,0,0,1
9925105,9925231,126,1,0,0,2
9925232,9925343,111,0,0,1,2
9925254,9925341,87,0,0,1,1
9925342,9925377,35,1,0,0,1
9925344,9925368,24,1,0,0,2
9925369,9925815,446,0,0,1,2
9925378,9925814,436,0,0,1,1
9925815,9925825,10,1,0,0,1
9925816,9925826,10,1,0,0,2
9925826,9927005,1179,0,0,1,1
9925827,9927004,1177,0,0,1,2
9927005,9927110,105,1,0,0,2
9927006,9927117,111,1,0,0,1
9927111,9927243,132,0,0,1,2
9927118,9927243,125,0,0,1,1
9927244,9927265,21,1,0,0,2
9927244,9927272,28,1,0,0,1
9927266,9927435,169,0,0,1,2
9927273,9927437,164,0,0,1,1
9927436,9927459,23,1,0,0,2
9927438,9927458,20,1,0,0,1
9927459,9927607,148,0,0,1,1
9927460,9927608,148,0,0,1,2
9927608,9927633,25,1,0,0,1
9927609,9927636,27,1,0,0,2
9927634,9928002,368,0,0,1,1
9927637,9928003,366,0,0,1,2
9928003,9928013,10,1,0,0,1
9928004,9928011,7,1,0,0,2
9928012,9928404,392,0,0,1,2
9928014,9928404,390,0,0,1,1
9928405,9928435,30,1,0,0,2
9928405,9928437,32,1,0,0,1
9928436,9928674,238,0,0,1,2
9928438,9928673,235,0,0,1,1
9928674,9928741,67,1,0,0,1
9928675,9928740,65,1,0,0,2
9928741,9928867,126,0,0,1,2
9928742,9928866,124,0,0,1,1
9928867,9928986,119,1,0,0,1
9928868,9928988,120,1,0,0,2
9928987,9929070,83,0,0,1,1
9928989,9929068,79,0,0,1,2
9929069,9929113,44,1,0,0,2
9929071,9929104,33,1,0,0,1
9929105,9929330,225,0,0,1,1
9929114,9929325,211,0,0,1,2
9929326,9929344,18,1,0,0,2
9929331,9929345,14,1,0,0,1
9929345,9929454,109,0,0,1,2
9929346,9929458,112,0,0,1,1
9929455,9929472,17,1,0,0,2
9929459,9929473,14,1,0,0,1
9929473,9929826,353,0,0,1,2
9929474,9929826,352,0,0,1,1
9929827,9929844,17,1,0,0,1
9929827,9929844,17,1,0,0,2
9929845,9930400,555,0,0,1,1
9929845,9930401,556,0,0,1,2
9930401,9930453,52,1,0,0,1
9930402,9930449,47,1,0,0,2
9930450,9930570,120,0,0,1,2
9930454,9930570,116,0,0,1,1
9930571,9930624,53,1,0,0,1
9930571,9930625,54,1,0,0,2
9930625,9930853,228,0,0,1,1
9930626,9930853,227,0,0,1,2
9930854,9930979,125,1,0,0,2
9930854,9931013,159,1,0,0,1
9930948,9931004,56,0,1,0,1
9930980,9931090,110,0,0,1,2
9931014,9931089,75,0,0,1,1
9931090,9932388,1298,1,0,0,1
9931091,9931115,24,1,0,0,2
9931107,9931240,133,0,1,0,1
9931116,9931354,238,0,0,1,2
9931273,9932377,1104,0,1,0,1
9931355,9931891,536,1,0,0,2
9931383,9931712,329,0,1,0,2
9931892,9931921,29,0,0,1,2
9931922,9931928,6,1,0,0,2
9931929,9932277,348,0,0,1,2
9932278,9932334,56,1,0,0,2
9932335,9932720,385,0,0,1,2
9932389,9932720,331,0,0,1,1
9932721,9932806,85,1,0,0,2
9932721,9932813,92,1,0,0,1
9932807,9933000,193,0,0,1,2
9932814,9932994,180,0,0,1,1
9932995,9933017,22,1,0,0,1
9933001,9933012,11,1,0,0,2
9933013,9933367,354,0,0,1,2
9933018,9933366,348,0,0,1,1
9933367,9933388,21,1,0,0,1
9933368,9933394,26,1,0,0,2
9933389,9933775,386,0,0,1,1
9933395,9933775,380,0,0,1,2
9933776,9933793,17,1,0,0,1
9933776,9933793,17,1,0,0,2
9933794,9934468,674,0,0,1,1
9933794,9934468,674,0,0,1,2
9934469,9934534,65,1,0,0,1
9934469,9934536,67,1,0,0,2
9934535,9934579,44,0,0,1,1
9934537,9934578,41,0,0,1,2
9934579,9934672,93,1,0,0,2
9934580,9934672,92,1,0,0,1
9934673,9934741,68,0,0,1,1
9934673,9934742,69,0,0,1,2
9934742,9934786,44,1,0,0,1
9934743,9934789,46,1,0,0,2
9934787,9934892,105,0,0,1,1
9934790,9934893,103,0,0,1,2
9934893,9934916,23,1,0,0,1
9934894,9934923,29,1,0,0,2
9934917,9936485,1568,0,0,1,1
9934924,9936485,1561,0,0,1,2
9936486,9936555,69,1,0,0,2
9936486,9936565,79,1,0,0,1
9936556,9936668,112,0,0,1,2
9936566,9936668,102,0,0,1,1
9936669,9936701,32,1,0,0,2
9936669,9936702,33,1,0,0,1
9936702,9936857,155,0,0,1,2
9936703,9936857,154,0,0,1,1
9936858,9936874,16,1,0,0,2
9936858,9936875,17,1,0,0,1
9936875,9938510,1635,0,0,1,2
9936876,9938510,1634,0,0,1,1
9938511,9938619,108,1,0,0,1
9938511,9938620,109,1,0,0,2
9938620,9938677,57,0,0,1,1
9938621,9938677,56,0,0,1,2
9938678,9938721,43,1,0,0,2
9938678,9938723,45,1,0,0,1
9938722,9940410,1688,0,0,1,2
9938724,9940411,1687,0,0,1,1
9940411,9940525,114,1,0,0,2
9940412,9940539,127,1,0,0,1
9940526,9940591,65,0,0,1,2
9940540,9940592,52,0,0,1,1
9940592,9940635,43,1,0,0,2
9940593,9940663,70,1,0,0,1
9940636,9940753,117,0,0,1,2
9940664,9940752,88,0,0,1,1
9940753,9940771,18,1,0,0,1
9940754,9940771,17,1,0,0,2
9940772,9942414,1642,0,0,1,2
9940772,9942416,1644,0,0,1,1
9942415,9942488,73,1,0,0,2
9942417,9942489,72,1,0,0,1
9942489,9942629,140,0,0,1,2
9942490,9942629,139,0,0,1,1
9942630,9942652,22,1,0,0,1
9942630,9942660,30,1,0,0,2
9942653,9944209,1556,0,0,1,1
9942661,9944209,1548,0,0,1,2
9944210,9944270,60,1,0,0,1
9944210,9944272,62,1,0,0,2
9944271,9944370,99,0,0,1,1
9944273,9944371,98,0,0,1,2
9944371,9944392,21,1,0,0,1
9944372,9944390,18,1,0,0,2
9944391,9946083,1692,0,0,1,2
9944393,9946083,1690,0,0,1,1
9946084,9946250,166,1,0,0,2
9946084,9946254,170,1,0,0,1
9946251,9946314,63,0,0,1,2
9946255,9946315,60,0,0,1,1
9946315,9946344,29,1,0,0,2
9946316,9946344,28,1,0,0,1
9946345,9946464,119,0,0,1,1
9946345,9946466,121,0,0,1,2
9946465,9946493,28,1,0,0,1
9946467,9946494,27,1,0,0,2
9946494,9948041,1547,0,0,1,1
9946495,9948041,1546,0,0,1,2
9948042,9948112,70,1,0,0,1
9948042,9948115,73,1,0,0,2
9948113,9948226,113,0,0,1,1
9948116,9948226,110,0,0,1,2
9948227,9948251,24,1,0,0,1
9948227,9948255,28,1,0,0,2
9948252,9948810,558,0,0,1,1
9948256,9948997,741,0,0,1,2
9948811,9948820,9,1,0,0,1
9948821,9949864,1043,0,0,1,1
9948998,9949009,11,1,0,0,2
9949010,9949864,854,0,0,1,2
9949865,9949963,98,1,0,0,1
9949865,9949964,99,1,0,0,2
9949964,9950054,90,0,0,1,1
9949965,9950054,89,0,0,1,2
9950055,9950079,24,1,0,0,1
9950055,9950088,33,1,0,0,2
9950080,9951651,1571,0,0,1,1
9950089,9951650,1561,0,0,1,2
9951651,9951730,79,1,0,0,2
9951652,9951730,78,1,0,0,1
9951731,9951881,150,0,0,1,1
9951731,9951886,155,0,0,1,2
9951882,9951902,20,1,0,0,1
9951887,9951901,14,1,0,0,2
9951902,9952147,245,0,0,1,2
9951903,9952153,250,0,0,1,1
9952148,9952164,16,1,0,0,2
9952154,9952166,12,1,0,0,1
9952165,9952291,126,0,0,1,2
9952167,9952290,123,0,0,1,1
9952291,9952304,13,1,0,0,1
9952292,9952303,11,1,0,0,2
9952304,9953693,1389,0,0,1,2
9952305,9953692,1387,0,0,1,1
9953693,9953754,61,1,0,0,1
9953694,9953752,58,1,0,0,2
9953753,9953872,119,0,0,1,2
9953755,9953873,118,0,0,1,1
9953873,9953896,23,1,0,0,2
9953874,9953896,22,1,0,0,1
9953897,9955521,1624,0,0,1,1
9953897,9955522,1625,0,0,1,2
9955522,9955605,83,1,0,0,1
9955523,9955615,92,1,0,0,2
9955606,9955721,115,0,0,1,1
9955616,9955721,105,0,0,1,2
9955722,9955751,29,1,0,0,1
9955722,9955754,32,1,0,0,2
9955752,9956126,374,0,0,1,1
9955755,9956119,364,0,0,1,2
9956120,9956131,11,1,0,0,2
9956127,9956131,4,1,0,0,1
9956132,9956297,165,0,0,1,1
9956132,9956297,165,0,0,1,2
9956298,9956309,11,1,0,0,2
9956298,9956310,12,1,0,0,1
9956310,9957414,1104,0,0,1,2
9956311,9957414,1103,0,0,1,1
9957415,9957483,68,1,0,0,2
9957415,9957494,79,1,0,0,1
9957484,9957606,122,0,0,1,2
9957495,9957606,111,0,0,1,1
9957607,9957626,19,1,0,0,2
9957607,9957631,24,1,0,0,1
9957627,9959375,1748,0,0,1,2
9957632,9959375,1743,0,0,1,1
9959376,9959506,130,1,0,0,1
9959376,9959506,130,1,0,0,2
9959507,9959590,83,0,0,1,2
9959507,9959591,84,0,0,1,1
9959591,9959633,42,1,0,0,2
9959592,9959631,39,1,0,0,1
9959632,9959773,141,0,0,1,1
9959634,9959773,139,0,0,1,2
9959774,9959792,18,1,0,0,1
9959774,9959794,20,1,0,0,2
9959793,9961408,1615,0,0,1,1
9959795,9961409,1614,0,0,1,2
9961409,9961532,123,1,0,0,1
9961410,9961523,113,1,0,0,2
9961524,9961595,71,0,0,1,2
9961533,9961595,62,0,0,1,1
9961596,9961650,54,1,0,0,1
9961596,9961650,54,1,0,0,2
9961651,9961837,186,0,0,1,1
9961651,9961837,186,0,0,1,2
9961838,9961858,20,1,0,0,1
9961838,9961859,21,1,0,0,2
9961859,9963360,1501,0,0,1,1
9961860,9963360,1500,0,0,1,2
9963361,9963515,154,1,0,0,2
9963361,9963517,156,1,0,0,1
9963516,9963566,50,0,0,1,2
9963518,9963566,48,0,0,1,1
9963567,9963616,49,1,0,0,1
9963567,9963617,50,1,0,0,2
9963617,9963776,159,0,0,1,1
9963618,9963777,159,0,0,1,2
9963777,9963806,29,1,0,0,1
9963778,9963806,28,1,0,0,2
9963807,9963998,191,0,0,1,1
9963807,9963999,192,0,0,1,2
9963999,9964011,12,1,0,0,1
9964000,9964010,10,1,0,0,2
9964011,9965278,1267,0,0,1,2
9964012,9965278,1266,0,0,1,1
9965279,9965355,76,1,0,0,1
9965279,9965365,86,1,0,0,2
9965356,9965402,46,0,0,1,1
9965366,9965403,37,0,0,1,2
9965403,9965478,75,1,0,0,1
9965404,9965478,74,1,0,0,2
9965479,9965590,111,0,0,1,1
9965479,9965590,111,0,0,1,2
9965591,9965616,25,1,0,0,1
9965591,9965626,35,1,0,0,2
9965617,9967420,1803,0,0,1,1
9965627,9967420,1793,0,0,1,2
9967421,9967494,73,1,0,0,2
9967421,9967495,74,1,0,0,1
9967495,9967604,109,0,0,1,2
9967496,9967604,108,0,0,1,1
9967605,9967635,30,1,0,0,2
9967605,9967636,31,1,0,0,1
9967636,9969405,1769,0,0,1,2
9967637,9969405,1768,0,0,1,1
9969406,9969489,83,1,0,0,1
9969406,9969489,83,1,0,0,2
9969490,9969596,106,0,0,1,1
9969490,9969596,106,0,0,1,2
9969597,9969621,24,1,0,0,2
9969597,9969622,25,1,0,0,1
9969622,9969804,182,0,0,1,2
9969623,9969803,180,0,0,1,1
9969804,9969814,10,1,0,0,1
9969805,9969812,7,1,0,0,2
9969813,9970187,374,0,0,1,2
9969815,9971316,1501,0,0,1,1
9970188,9970197,9,1,0,0,2
9970198,9971316,1118,0,0,1,2
9971317,9971392,75,1,0,0,1
9971317,9971393,76,1,0,0,2
9971393,9971438,45,0,0,1,1
9971394,9971438,44,0,0,1,2
9971439,9971485,46,1,0,0,1
9971439,9971486,47,1,0,0,2
9971486,9971588,102,0,0,1,1
9971487,9971587,100,0,0,1,2
9971588,9971612,24,1,0,0,2
9971589,9971611,22,1,0,0,1
9971612,9971772,160,0,0,1,1
9971613,9971767,154,0,0,1,2
9971768,9971787,19,1,0,0,2
9971773,9971787,14,1,0,0,1
9971788,9973015,1227,0,0,1,1
9971788,9973015,1227,0,0,1,2
9973016,9973063,47,1,0,0,1
9973016,9973063,47,1,0,0,2
9973064,9976558,3494,0,0,1,1
9973064,9976558,3494,0,0,1,2
9976559,9976620,61,1,0,0,2
9976559,9976625,66,1,0,0,1
9976621,9976730,109,0,0,1,2
9976626,9976731,105,0,0,1,1
9976731,9976744,13,1,0,0,2
9976732,9976747,15,1,0,0,1
9976745,9976925,180,0,0,1,2
9976748,9976865,117,0,0,1,1
9976866,9976893,27,1,0,0,1
9976894,9976957,63,0,0,1,1
9976926,9976931,5,1,0,0,2
9976932,9976974,42,0,0,1,2
9976958,9977222,264,1,0,0,1
9976975,9977230,255,1,0,0,2
9976987,9977198,211,0,1,0,1
9977012,9977153,141,0,1,0,2
9977223,9977349,126,0,0,1,1
9977231,9977348,117,0,0,1,2
9977349,9977368,19,1,0,0,2
9977350,9977366,16,1,0,0,1
9977367,9977821,454,0,0,1,1
9977369,9977822,453,0,0,1,2
9977822,9977864,42,1,0,0,1
9977823,9977865,42,1,0,0,2
9977865,9980535,2670,0,0,1,1
9977866,9980534,2668,0,0,1,2
9980535,9980584,49,1,0,0,2
9980536,9980582,46,1,0,0,1
9980583,9981195,612,0,0,1,1
9980585,9981195,610,0,0,1,2
9981196,9981254,58,1,0,0,1
9981196,9981254,58,1,0,0,2
9981255,9981391,136,0,0,1,1
9981255,9981396,141,0,0,1,2
9981392,9981414,22,1,0,0,1
9981397,9981414,17,1,0,0,2
9981415,9982894,1479,0,0,1,2
9981415,9982896,1481,0,0,1,1
9982895,9982954,59,1,0,0,2
9982897,9982953,56,1,0,0,1
9982954,9984915,1961,0,0,1,1
9982955,9984925,1970,0,0,1,2
9984916,9985543,627,1,0,0,1
9984926,9985384,458,1,0,0,2
9984946,9985492,546,0,1,0,1
9984968,9985373,405,0,1,0,2
9985385,9985485,100,0,0,1,2
9985486,9985545,59,1,0,0,2
9985544,9985634,90,0,0,1,1
9985546,9985665,119,0,0,1,2
9985635,9986018,383,1,0,0,1
9985654,9985989,335,0,1,0,1
9985666,9985894,228,1,0,0,2
9985684,9985841,157,0,1,0,2
9985895,9986604,709,0,0,1,2
9986019,9986604,585,0,0,1,1
9986605,9986645,40,1,0,0,1
9986605,9986645,40,1,0,0,2
9986646,9986762,116,0,0,1,1
9986646,9986762,116,0,0,1,2
9986763,9986786,23,1,0,0,1
9986763,9986788,25,1,0,0,2
9986787,9988449,1662,0,0,1,1
9986789,9988449,1660,0,0,1,2
9988450,9988511,61,1,0,0,2
9988450,9988518,68,1,0,0,1
9988512,9988622,110,0,0,1,2
9988519,9988625,106,0,0,1,1
9988623,9988647,24,1,0,0,2
9988626,9988646,20,1,0,0,1
9988647,9990822,2175,0,0,1,1
9988648,9990829,2181,0,0,1,2
9990823,9991101,278,1,0,0,1
9990830,9991097,267,1,0,0,2
9990857,9991075,218,0,1,0,1
9990867,9991013,146,0,1,0,2
9991098,9991146,48,0,0,1,2
9991102,9991145,43,0,0,1,1
9991146,9991408,262,1,0,0,1
9991147,9991428,281,1,0,0,2
9991169,9991391,222,0,1,0,1
9991176,9991358,182,0,1,0,2
9991409,9992420,1011,0,0,1,1
9991429,9992419,990,0,0,1,2
9992420,9992486,66,1,0,0,2
9992421,9992484,63,1,0,0,1
9992485,9992527,42,0,0,1,1
9992487,9992527,40,0,0,1,2
9992528,9992624,96,1,0,0,1
9992528,9992632,104,1,0,0,2
9992625,9992737,112,0,0,1,1
9992633,9992737,104,0,0,1,2
9992738,9992767,29,1,0,0,2
9992738,9992782,44,1,0,0,1
9992768,9992908,140,0,0,1,2
9992783,9992907,124,0,0,1,1
9992908,9992926,18,1,0,0,1
9992909,9992928,19,1,0,0,2
9992927,9993477,550,0,0,1,1
9992929,9993475,546,0,0,1,2
9993476,9993488,12,1,0,0,2
9993478,9993489,11,1,0,0,1
9993489,9993711,222,0,0,1,2
9993490,9993712,222,0,0,1,1
9993712,9993767,55,1,0,0,2
9993713,9993765,52,1,0,0,1
9993766,9994209,443,0,0,1,1
9993768,9994212,444,0,0,1,2
9994210,9994225,15,1,0,0,1
9994213,9994225,12,1,0,0,2
9994226,9996221,1995,0,0,1,2
9994226,9996223,1997,0,0,1,1
9996222,9996511,289,1,0,0,2
9996224,9996489,265,1,0,0,1
9996254,9996438,184,0,1,0,1
9996256,9996421,165,0,1,0,2
9996490,9996948,458,0,0,1,1
9996512,9996949,437,0,0,1,2
9996949,9997031,82,1,0,0,1
9996950,9997041,91,1,0,0,2
9997032,9997141,109,0,0,1,1
9997042,9997141,99,0,0,1,2
9997142,9997168,26,1,0,0,1
9997142,9997181,39,1,0,0,2
9997169,9997298,129,0,0,1,1
9997182,9997298,116,0,0,1,2
9997299,9997315,16,1,0,0,1
9997299,9997316,17,1,0,0,2
9997316,9997481,165,0,0,1,1
9997317,9997475,158,0,0,1,2
9997476,9997492,16,1,0,0,2
9997482,9997492,10,1,0,0,1
9997493,9997723,230,0,0,1,1
9997493,9997727,234,0,0,1,2
9997724,9997750,26,1,0,0,1
9997728,9997741,13,1,0,0,2
9997742,9997976,234,0,0,1,2
9997751,9997978,227,0,0,1,1
9997977,9997990,13,1,0,0,2
9997979,9997990,11,1,0,0,1
9997991,9998597,606,0,0,1,1
9997991,9998597,606,0,0,1,2
9998598,9998650,52,1,0,0,1
9998598,9998650,52,1,0,0,2
9998651,9999179,528,0,0,1,1
9998651,9999181,530,0,0,1,2
9999180,9999199,19,1,0,0,1
9999182,9999200,18,1,0,0,2
9999200,10000761,1561,0,0,1,1
9999201,10000772,1571,0,0,1,2
10000762,10001064,302,1,0,0,1
10000773,10001028,255,1,0,0,2
10000793,10001015,222,0,1,0,1
10000803,10000966,163,0,1,0,2
10001029,10001211,182,0,0,1,2
10001065,10001212,147,0,0,1,1
10001212,10001255,43,1,0,0,2
10001213,10001245,32,1,0,0,1
10001246,10002017,771,0,0,1,1
10001256,10002017,761,0,0,1,2
10002018,10002062,44,1,0,0,1
10002018,10002062,44,1,0,0,2
10002063,10002277,214,0,0,1,1
10002063,10002278,215,0,0,1,2
10002278,10002337,59,1,0,0,1
10002279,10002345,66,1,0,0,2
10002338,10002446,108,0,0,1,1
10002346,10002446,100,0,0,1,2
10002447,10002467,20,1,0,0,1
10002447,10002476,29,1,0,0,2
10002468,10003832,1364,0,0,1,1
10002477,10003832,1355,0,0,1,2
10003833,10003893,60,1,0,0,1
10003833,10003893,60,1,0,0,2
10003894,10007255,3361,0,0,1,2
10003894,10007256,3362,0,0,1,1
10007256,10007341,85,1,0,0,2
10007257,10007341,84,1,0,0,1
10007342,10007452,110,0,0,1,2
10007342,10007453,111,0,0,1,1
10007453,10007467,14,1,0,0,2
10007454,10007470,16,1,0,0,1
10007468,10007636,168,0,0,1,2
10007471,10007637,166,0,0,1,1
10007637,10007655,18,1,0,0,2
10007638,10007656,18,1,0,0,1
10007656,10007800,144,0,0,1,2
10007657,10009118,1461,0,0,1,1
10007801,10007815,14,1,0,0,2
10007816,10009117,1301,0,0,1,2
10009118,10009184,66,1,0,0,2
10009119,10009183,64,1,0,0,1
10009184,10011696,2512,0,0,1,1
10009185,10011695,2510,0,0,1,2
10011696,10011732,36,1,0,0,2
10011697,10011720,23,1,0,0,1
10011721,10011751,30,0,0,1,1
10011733,10011839,106,0,0,1,2
10011752,10011757,5,1,0,0,1
10011758,10011840,82,0,0,1,1
10011840,10011850,10,1,0,0,2
10011841,10011856,15,1,0,0,1
10011851,10012019,168,0,0,1,2
10011857,10012017,160,0,0,1,1
10012018,10012084,66,1,0,0,1
10012020,10012065,45,1,0,0,2
10012066,10013223,1157,0,0,1,2
10012085,10013222,1137,0,0,1,1
10013223,10013291,68,1,0,0,1
10013224,10013293,69,1,0,0,2
10013292,10013400,108,0,0,1,1
10013294,10013399,105,0,0,1,2
10013400,10013421,21,1,0,0,2
10013401,10013421,20,1,0,0,1
10013422,10013640,218,0,0,1,1
10013422,10013641,219,0,0,1,2
10013641,10013652,11,1,0,0,1
10013642,10013651,9,1,0,0,2
10013652,10013797,145,0,0,1,2
10013653,10013792,139,0,0,1,1
10013793,10013808,15,1,0,0,1
10013798,10013809,11,1,0,0,2
10013809,10014506,697,0,0,1,1
10013810,10014506,696,0,0,1,2
10014507,10014551,44,1,0,0,2
10014507,10014555,48,1,0,0,1
10014552,10014807,255,0,0,1,2
10014556,10014810,254,0,0,1,1
10014808,10014834,26,1,0,0,2
10014811,10014836,25,1,0,0,1
10014835,10016842,2007,0,0,1,2
10014837,10016842,2005,0,0,1,1
10016843,10017091,248,1,0,0,2
10016843,10017184,341,1,0,0,1
10016899,10017127,228,0,1,0,1
10016931,10017060,129,0,1,0,2
10017092,10017938,846,0,0,1,2
10017185,10017939,754,0,0,1,1
10017939,10017994,55,1,0,0,2
10017940,10017995,55,1,0,0,1
10017995,10018077,82,0,0,1,2
10017996,10018077,81,0,0,1,1
10018078,10018106,28,1,0,0,1
10018078,10018108,30,1,0,0,2
10018107,10018236,129,0,0,1,1
10018109,10018236,127,0,0,1,2
10018237,10018253,16,1,0,0,1
10018237,10018255,18,1,0,0,2
10018254,10018359,105,0,0,1,1
10018256,10018361,105,0,0,1,2
10018360,10018376,16,1,0,0,1
10018362,10018384,22,1,0,0,2
10018377,10018544,167,0,0,1,1
10018385,10018652,267,0,0,1,2
10018545,10018555,10,1,0,0,1
10018556,10018653,97,0,0,1,1
10018653,10018680,27,1,0,0,2
10018654,10018671,17,1,0,0,1
10018672,10019382,710,0,0,1,1
10018681,10019382,701,0,0,1,2
10019383,10019430,47,1,0,0,2
10019383,10019432,49,1,0,0,1
10019431,10020055,624,0,0,1,2
10019433,10020059,626,0,0,1,1
10020056,10020071,15,1,0,0,2
10020060,10020073,13,1,0,0,1
10020072,10021626,1554,0,0,1,2
10020074,10021606,1532,0,0,1,1
10021607,10022255,648,1,0,0,1
10021627,10021850,223,1,0,0,2
10021634,10022228,594,0,1,0,1
10021671,10021825,154,0,1,0,2
10021851,10021873,22,0,0,1,2
10021874,10022138,264,1,0,0,2
10021897,10022089,192,0,1,0,2
10022139,10022766,627,0,0,1,2
10022256,10022765,509,0,0,1,1
10022766,10022774,8,1,0,0,1
10022767,10022771,4,1,0,0,2
10022772,10023000,228,0,0,1,2
10022775,10023002,227,0,0,1,1
10023001,10023081,80,1,0,0,2
10023003,10023081,78,1,0,0,1
10023082,10023204,122,0,0,1,1
10023082,10023204,122,0,0,1,2
10023205,10023228,23,1,0,0,2
10023205,10023237,32,1,0,0,1
10023229,10023375,146,0,0,1,2
10023238,10023375,137,0,0,1,1
10023376,10023395,19,1,0,0,1
10023376,10023414,38,1,0,0,2
10023396,10023523,127,0,0,1,1
10023415,10023525,110,0,0,1,2
10023524,10023540,16,1,0,0,1
10023526,10023537,11,1,0,0,2
10023538,10024596,1058,0,0,1,2
10023541,10024005,464,0,0,1,1
10024006,10024015,9,1,0,0,1
10024016,10024596,580,0,0,1,1
10024597,10024645,48,1,0,0,2
10024597,10024648,51,1,0,0,1
10024646,10024850,204,0,0,1,2
10024649,10024849,200,0,0,1,1
10024850,10024871,21,1,0,0,1
10024851,10024870,19,1,0,0,2
10024871,10026427,1556,0,0,1,2
10024872,10026429,1557,0,0,1,1
10026428,10026445,17,1,0,0,2
10026430,10026446,16,1,0,0,1
10026446,10028264,1818,0,0,1,2
10026447,10028264,1817,0,0,1,1
10028265,10028344,79,1,0,0,1
10028265,10028352,87,1,0,0,2
10028345,10028451,106,0,0,1,1
10028353,10028451,98,0,0,1,2
10028452,10028476,24,1,0,0,1
10028452,10028485,33,1,0,0,2
10028477,10028718,241,0,0,1,1
10028486,10028720,234,0,0,1,2
10028719,10028739,20,1,0,0,1
10028721,10028740,19,1,0,0,2
10028740,10028940,200,0,0,1,1
10028741,10028937,196,0,0,1,2
10028938,10028955,17,1,0,0,2
10028941,10028955,14,1,0,0,1
10028956,10029140,184,0,0,1,1
10028956,10029146,190,0,0,1,2
10029141,10029152,11,1,0,0,1
10029147,10029152,5,1,0,0,2
10029153,10030306,1153,0,0,1,2
10029153,10030307,1154,0,0,1,1
10030307,10030358,51,1,0,0,2
10030308,10030360,52,1,0,0,1
10030359,10030585,226,0,0,1,2
10030361,10030585,224,0,0,1,1
10030586,10030610,24,1,0,0,2
10030586,10030612,26,1,0,0,1
10030611,10032721,2110,0,0,1,2
10030613,10032725,2112,0,0,1,1
10032722,10032967,245,1,0,0,2
10032726,10032992,266,1,0,0,1
10032755,10032940,185,0,1,0,1
10032761,10032924,163,0,1,0,2
10032968,10033161,193,0,0,1,2
10032993,10033162,169,0,0,1,1
10033162,10033702,540,1,0,0,2
10033163,10033706,543,1,0,0,1
10033248,10033695,447,0,1,0,1
10033311,10033519,208,0,1,0,2
10033549,10033550,1,0,1,0,2
10033587,10033664,77,0,1,0,2
10033703,10033904,201,0,0,1,2
10033707,10033903,196,0,0,1,1
10033904,10033971,67,1,0,0,1
10033905,10033965,60,1,0,0,2
10033966,10034060,94,0,0,1,2
10033972,10034059,87,0,0,1,1
10034060,10034085,25,1,0,0,1
10034061,10034084,23,1,0,0,2
10034085,10034285,200,0,0,1,2
10034086,10035160,1074,0,0,1,1
10034286,10034299,13,1,0,0,2
10034300,10035160,860,0,0,1,2
10035161,10035216,55,1,0,0,2
10035161,10035218,57,1,0,0,1
10035217,10037246,2029,0,0,1,2
10035219,10037246,2027,0,0,1,1
10037247,10038114,867,1,0,0,1
10037247,10038117,870,1,0,0,2
10037336,10038103,767,0,1,0,1
10037362,10037372,10,0,1,0,2
10037407,10038100,693,0,1,0,2
10038115,10038314,199,0,0,1,1
10038118,10038313,195,0,0,1,2
10038314,10038385,71,1,0,0,2
10038315,10038388,73,1,0,0,1
10038386,10038474,88,0,0,1,2
10038389,10038474,85,0,0,1,1
10038475,10038503,28,1,0,0,1
10038475,10038503,28,1,0,0,2
10038504,10038657,153,0,0,1,2
10038504,10038658,154,0,0,1,1
10038658,10038676,18,1,0,0,2
10038659,10038676,17,1,0,0,1
10038677,10039824,1147,0,0,1,1
10038677,10039825,1148,0,0,1,2
10039825,10039886,61,1,0,0,1
10039826,10039895,69,1,0,0,2
10039887,10041995,2108,0,0,1,1
10039896,10041996,2100,0,0,1,2
10041996,10042021,25,1,0,0,1
10041997,10042022,25,1,0,0,2
10042022,10042085,63,0,0,1,1
10042023,10042086,63,0,0,1,2
10042086,10042417,331,1,0,0,1
10042087,10042402,315,1,0,0,2
10042113,10042370,257,0,1,0,1
10042125,10042357,232,0,1,0,2
10042403,10043384,981,0,0,1,2
10042418,10043384,966,0,0,1,1
10043385,10043429,44,1,0,0,2
10043385,10043430,45,1,0,0,1
10043430,10043570,140,0,0,1,2
10043431,10043569,138,0,0,1,1
10043570,10043589,19,1,0,0,1
10043571,10043598,27,1,0,0,2
10043590,10045071,1481,0,0,1,1
10043599,10045069,1470,0,0,1,2
10045070,10045136,66,1,0,0,2
10045072,10045138,66,1,0,0,1
10045137,10048010,2873,0,0,1,2
10045139,10048010,2871,0,0,1,1
10048011,10048031,20,1,0,0,1
10048011,10048031,20,1,0,0,2
10048032,10049099,1067,0,0,1,2
10048032,10049100,1068,0,0,1,1
10049100,10049149,49,1,0,0,2
10049101,10049147,46,1,0,0,1
10049148,10049391,243,0,0,1,1
10049150,10049385,235,0,0,1,2
10049386,10049401,15,1,0,0,2
10049392,10049404,12,1,0,0,1
10049402,10049582,180,0,0,1,2
10049405,10050691,1286,0,0,1,1
10049583,10049594,11,1,0,0,2
10049595,10049882,287,0,0,1,2
10049883,10049893,10,1,0,0,2
10049894,10050690,796,0,0,1,2
10050691,10050744,53,1,0,0,2
10050692,10050735,43,1,0,0,1
10050736,10050872,136,0,0,1,1
10050745,10050872,127,0,0,1,2
10050873,10050885,12,1,0,0,2
10050873,10050887,14,1,0,0,1
10050886,10051396,510,0,0,1,2
10050888,10051392,504,0,0,1,1
10051393,10051408,15,1,0,0,1
10051397,10051408,11,1,0,0,2
10051409,10053203,1794,0,0,1,1
10051409,10053209,1800,0,0,1,2
10053204,10053587,383,1,0,0,1
10053210,10053587,377,1,0,0,2
10053234,10053568,334,0,1,0,1
10053238,10053537,299,0,1,0,2
10053588,10054299,711,0,0,1,1
10053588,10054299,711,0,0,1,2
10054300,10054375,75,1,0,0,2
10054300,10054376,76,1,0,0,1
10054376,10054519,143,0,0,1,2
10054377,10054520,143,0,0,1,1
10054520,10054525,5,1,0,0,2
10054521,10054527,6,1,0,0,1
10054526,10055106,580,0,0,1,2
10054528,10054976,448,0,0,1,1
10054977,10054981,4,1,0,0,1
10054982,10055117,135,0,0,1,1
10055107,10055123,16,1,0,0,2
10055118,10055122,4,1,0,0,1
10055123,10055798,675,0,0,1,1
10055124,10055798,674,0,0,1,2
10055799,10055839,40,1,0,0,1
10055799,10055839,40,1,0,0,2
10055840,10056007,167,0,0,1,1
10055840,10056008,168,0,0,1,2
10056008,10056025,17,1,0,0,1
10056009,10056020,11,1,0,0,2
10056021,10056262,241,0,0,1,2
10056026,10056261,235,0,0,1,1
10056262,10056284,22,1,0,0,1
10056263,10056287,24,1,0,0,2
10056285,10057845,1560,0,0,1,1
10056288,10057844,1556,0,0,1,2
10057845,10058181,336,1,0,0,2
10057846,10058168,322,1,0,0,1
10057873,10058126,253,0,1,0,1
10057877,10058138,261,0,1,0,2
10058169,10058334,165,0,0,1,1
10058182,10058334,152,0,0,1,2
10058335,10058391,56,1,0,0,1
10058335,10058391,56,1,0,0,2
10058392,10059443,1051,0,0,1,1
10058392,10059444,1052,0,0,1,2
10059444,10059510,66,1,0,0,1
10059445,10059521,76,1,0,0,2
10059511,10059623,112,0,0,1,1
10059522,10059622,100,0,0,1,2
10059623,10059652,29,1,0,0,2
10059624,10059643,19,1,0,0,1
10059644,10059928,284,0,0,1,1
10059653,10059928,275,0,0,1,2
10059929,10059947,18,1,0,0,1
10059929,10059947,18,1,0,0,2
10059948,10060099,151,0,0,1,2
10059948,10060102,154,0,0,1,1
10060100,10060118,18,1,0,0,2
10060103,10060117,14,1,0,0,1
10060118,10060816,698,0,0,1,1
10060119,10060816,697,0,0,1,2
10060817,10060872,55,1,0,0,1
10060817,10060872,55,1,0,0,2
10060873,10062858,1985,0,0,1,1
10060873,10062873,2000,0,0,1,2
10062859,10062988,129,1,0,0,1
10062874,10062916,42,1,0,0,2
10062882,10062953,71,0,1,0,1
10062917,10063097,180,0,0,1,2
10062989,10063096,107,0,0,1,1
10063097,10063139,42,1,0,0,1
10063098,10063147,49,1,0,0,2
10063140,10063447,307,0,0,1,1
10063148,10063447,299,0,0,1,2
10063448,10063497,49,1,0,0,1
10063448,10063497,49,1,0,0,2
10063498,10063735,237,0,0,1,1
10063498,10063735,237,0,0,1,2
10063736,10063788,52,1,0,0,2
10063736,10063790,54,1,0,0,1
10063789,10064046,257,0,0,1,2
10063791,10064047,256,0,0,1,1
10064047,10064139,92,1,0,0,2
10064048,10064128,80,1,0,0,1
10064129,10064247,118,0,0,1,1
10064140,10064247,107,0,0,1,2
10064248,10064267,19,1,0,0,2
10064248,10064269,21,1,0,0,1
10064268,10064554,286,0,0,1,2
10064270,10064553,283,0,0,1,1
10064554,10064559,5,1,0,0,1
10064555,10064564,9,1,0,0,2
10064560,10065871,1311,0,0,1,1
10064565,10065871,1306,0,0,1,2
10065872,10065940,68,1,0,0,1
10065872,10065942,70,1,0,0,2
10065941,10066124,183,0,0,1,1
10065943,10066123,180,0,0,1,2
10066124,10066157,33,1,0,0,2
10066125,10066154,29,1,0,0,1
10066155,10068282,2127,0,0,1,1
10066158,10068271,2113,0,0,1,2
10068272,10068571,299,1,0,0,2
10068283,10068589,306,1,0,0,1
10068315,10068526,211,0,1,0,1
10068324,10068485,161,0,1,0,2
10068572,10069018,446,0,0,1,2
10068590,10069020,430,0,0,1,1
10069019,10069064,45,1,0,0,2
10069021,10069054,33,1,0,0,1
10069055,10069672,617,0,0,1,1
10069065,10069673,608,0,0,1,2
10069673,10069731,58,1,0,0,1
10069674,10069743,69,1,0,0,2
10069732,10069825,93,0,0,1,1
10069744,10069824,80,0,0,1,2
10069825,10069847,22,1,0,0,2
10069826,10069846,20,1,0,0,1
10069847,10070000,153,0,0,1,1
10069848,10070251,403,0,0,1,2
10070001,10070012,11,1,0,0,1
10070013,10071047,1034,0,0,1,1
10070252,10070256,4,1,0,0,2
10070257,10071045,788,0,0,1,2
10071046,10071101,55,1,0,0,2
10071048,10071100,52,1,0,0,1
10071101,10073134,2033,0,0,1,1
10071102,10073146,2044,0,0,1,2
10073135,10073223,88,1,0,0,1
10073147,10073156,9,1,0,0,2
10073157,10073479,322,0,0,1,2
10073224,10073468,244,0,0,1,1
10073469,10073816,347,1,0,0,1
10073480,10073812,332,1,0,0,2
10073499,10073768,269,0,1,0,1
10073512,10073757,245,0,1,0,2
10073813,10074428,615,0,0,1,2
10073817,10074430,613,0,0,1,1
10074429,10074477,48,1,0,0,2
10074431,10074469,38,1,0,0,1
10074470,10074693,223,0,0,1,1
10074478,10074693,215,0,0,1,2
10074694,10074737,43,1,0,0,1
10074694,10074738,44,1,0,0,2
10074738,10074824,86,0,0,1,1
10074739,10074824,85,0,0,1,2
10074825,10074843,18,1,0,0,1
10074825,10074846,21,1,0,0,2
10074844,10075935,1091,0,0,1,1
10074847,10075935,1088,0,0,1,2
10075936,10076006,70,1,0,0,2
10075936,10076007,71,1,0,0,1
10076007,10076138,131,0,0,1,2
10076008,10076135,127,0,0,1,1
10076136,10076155,19,1,0,0,1
10076139,10076152,13,1,0,0,2
10076153,10078309,2156,0,0,1,2
10076156,10078309,2153,0,0,1,1
10078310,10078358,48,1,0,0,2
10078310,10078360,50,1,0,0,1
10078359,10078567,208,0,0,1,2
10078361,10078566,205,0,0,1,1
10078567,10078597,30,1,0,0,1
10078568,10078587,19,1,0,0,2
10078588,10078793,205,0,0,1,2
10078598,10078793,195,0,0,1,1
10078794,10078842,48,1,0,0,1
10078794,10078845,51,1,0,0,2
10078843,10079159,316,0,0,1,1
10078846,10079158,312,0,0,1,2
10079159,10079222,63,1,0,0,2
10079160,10079214,54,1,0,0,1
10079215,10079435,220,0,0,1,1
10079223,10079434,211,0,0,1,2
10079435,10079503,68,1,0,0,2
10079436,10079503,67,1,0,0,1
10079504,10079686,182,0,0,1,1
10079504,10079686,182,0,0,1,2
10079687,10079706,19,1,0,0,1
10079687,10079706,19,1,0,0,2
10079707,10079976,269,0,0,1,1
10079707,10079979,272,0,0,1,2
10079977,10079993,16,1,0,0,1
10079980,10079993,13,1,0,0,2
10079994,10080136,142,0,0,1,1
10079994,10080139,145,0,0,1,2
10080137,10080150,13,1,0,0,1
10080140,10080151,11,1,0,0,2
10080151,10080653,502,0,0,1,1
10080152,10080653,501,0,0,1,2
10080654,10080716,62,1,0,0,1
10080654,10080716,62,1,0,0,2
10080717,10084093,3376,0,0,1,2
10080717,10084094,3377,0,0,1,1
10084094,10084165,71,1,0,0,2
10084095,10084166,71,1,0,0,1
10084166,10084296,130,0,0,1,2
10084167,10084295,128,0,0,1,1
10084296,10084326,30,1,0,0,1
10084297,10084318,21,1,0,0,2
10084319,10084531,212,0,0,1,2
10084327,10084526,199,0,0,1,1
10084527,10084546,19,1,0,0,1
10084532,10084551,19,1,0,0,2
10084547,10085952,1405,0,0,1,1
10084552,10085952,1400,0,0,1,2
10085953,10086014,61,1,0,0,2
10085953,10086031,78,1,0,0,1
10086015,10088509,2494,0,0,1,2
10086032,10088508,2476,0,0,1,1
10088509,10088528,19,1,0,0,1
10088510,10088531,21,1,0,0,2
10088529,10088864,335,0,0,1,1
10088532,10088864,332,0,0,1,2
10088865,10088890,25,1,0,0,2
10088865,10088899,34,1,0,0,1
10088891,10089891,1000,0,0,1,2
10088900,10089891,991,0,0,1,1
10089892,10089977,85,1,0,0,1
10089892,10089978,86,1,0,0,2
10089978,10090089,111,0,0,1,1
10089979,10090088,109,0,0,1,2
10090089,10090119,30,1,0,0,2
10090090,10090118,28,1,0,0,1
10090119,10090339,220,0,0,1,1
10090120,10090339,219,0,0,1,2
10090340,10090344,4,1,0,0,1
10090340,10090354,14,1,0,0,2
10090345,10090607,262,0,0,1,1
10090355,10091543,1188,0,0,1,2
10090608,10090618,10,1,0,0,1
10090619,10091542,923,0,0,1,1
10091543,10091581,38,1,0,0,1
10091544,10091591,47,1,0,0,2
10091582,10091713,131,0,0,1,1
10091592,10091714,122,0,0,1,2
10091714,10091731,17,1,0,0,1
10091715,10091732,17,1,0,0,2
10091732,10091930,198,0,0,1,1
10091733,10091930,197,0,0,1,2
10091931,10091941,10,1,0,0,1
10091931,10091941,10,1,0,0,2
10091942,10092241,299,0,0,1,2
10091942,10092242,300,0,0,1,1
10092242,10092255,13,1,0,0,2
10092243,10092254,11,1,0,0,1
10092255,10095066,2811,0,0,1,1
10092256,10095065,2809,0,0,1,2
10095066,10095116,50,1,0,0,2
10095067,10095114,47,1,0,0,1
10095115,10095353,238,0,0,1,1
10095117,10095353,236,0,0,1,2
10095354,10095365,11,1,0,0,1
10095354,10095366,12,1,0,0,2
10095366,10096313,947,0,0,1,1
10095367,10096313,946,0,0,1,2
10096314,10096372,58,1,0,0,1
10096314,10096381,67,1,0,0,2
10096373,10098707,2334,0,0,1,1
10096382,10098707,2325,0,0,1,2
10098708,10098729,21,1,0,0,1
10098708,10098731,23,1,0,0,2
10098730,10099606,876,0,0,1,1
10098732,10099606,874,0,0,1,2
10099607,10099713,106,1,0,0,1
10099607,10099713,106,1,0,0,2
10099714,10099820,106,0,0,1,1
10099714,10099820,106,0,0,1,2
10099821,10099846,25,1,0,0,2
10099821,10099864,43,1,0,0,1
10099847,10100103,256,0,0,1,2
10099865,10100105,240,0,0,1,1
10100104,10100115,11,1,0,0,2
10100106,10100117,11,1,0,0,1
10100116,10101730,1614,0,0,1,2
10100118,10101730,1612,0,0,1,1
10101731,10101794,63,1,0,0,2
10101731,10101796,65,1,0,0,1
10101795,10101978,183,0,0,1,2
10101797,10101977,180,0,0,1,1
10101978,10102006,28,1,0,0,1
10101979,10102015,36,1,0,0,2
10102007,10104440,2433,0,0,1,1
10102016,10104440,2424,0,0,1,2
10104441,10104495,54,1,0,0,1
10104441,10104495,54,1,0,0,2
10104496,10104694,198,0,0,1,2
10104496,10104696,200,0,0,1,1
10104695,10104750,55,1,0,0,2
10104697,10104749,52,1,0,0,1
10104750,10105797,1047,0,0,1,1
10104751,10105798,1047,0,0,1,2
10105798,10105872,74,1,0,0,1
10105799,10105874,75,1,0,0,2
10105873,10105978,105,0,0,1,1
10105875,10105978,103,0,0,1,2
10105979,10106009,30,1,0,0,1
10105979,10106012,33,1,0,0,2
10106010,10106991,981,0,0,1,1
10106013,10106992,979,0,0,1,2
10106992,10107033,41,1,0,0,1
10106993,10107040,47,1,0,0,2
10107034,10107434,400,0,0,1,1
10107041,10107434,393,0,0,1,2
10107435,10107457,22,1,0,0,1
10107435,10107457,22,1,0,0,2
10107458,10109009,1551,0,0,1,2
10107458,10109014,1556,0,0,1,1
10109010,10109293,283,1,0,0,2
10109015,10109316,301,1,0,0,1
10109049,10109258,209,0,1,0,1
10109055,10109229,174,0,1,0,2
10109294,10110266,972,0,0,1,2
10109317,10110266,949,0,0,1,1
10110267,10110360,93,1,0,0,2
10110267,10110368,101,1,0,0,1
10110361,10110490,129,0,0,1,2
10110369,10110486,117,0,0,1,1
10110487,10110500,13,1,0,0,1
10110491,10110509,18,1,0,0,2
10110501,10110727,226,0,0,1,1
10110510,10110730,220,0,0,1,2
10110728,10110744,16,1,0,0,1
10110731,10110753,22,1,0,0,2
10110745,10112073,1328,0,0,1,1
10110754,10110887,133,0,0,1,2
10110888,10110896,8,1,0,0,2
10110897,10111181,284,0,0,1,2
10111182,10111243,61,1,0,0,2
10111244,10112072,828,0,0,1,2
10112073,10112138,65,1,0,0,2
10112074,10112139,65,1,0,0,1
10112139,10112402,263,0,0,1,2
10112140,10112402,262,0,0,1,1
10112403,10112432,29,1,0,0,2
10112403,10112433,30,1,0,0,1
10112433,10115825,3392,0,0,1,2
10112434,10115824,3390,0,0,1,1
10115825,10115890,65,1,0,0,1
10115826,10115899,73,1,0,0,2
10115891,10116880,989,0,0,1,1
10115900,10116881,981,0,0,1,2
10116881,10125630,8749,1,0,0,1
10116882,10125678,8796,1,0,0,2
10116922,10125578,8656,0,1,0,1
10116962,10117476,514,0,1,0,2
10117549,10125530,7981,0,1,0,2
10125631,10125665,34,0,0,1,1
10125666,10125679,13,1,0,0,1
10125679,10125721,42,0,0,1,2
10125680,10125721,41,0,0,1,1
10125722,10125754,32,1,0,0,1
10125722,10125760,38,1,0,0,2
10125755,10126162,407,0,0,1,1
10125761,10126162,401,0,0,1,2
10174287,10174497,210,0,0,1,2
10174287,10174498,211,0,0,1,1
10174498,10174545,47,1,0,0,2
10174499,10174547,48,1,0,0,1
10174546,10174647,101,0,0,1,2
10174548,10174647,99,0,0,1,1
10174648,10174679,31,1,0,0,1
10174648,10174686,38,1,0,0,2
10174680,10174860,180,0,0,1,1
10174687,10174860,173,0,0,1,2
10174861,10174876,15,1,0,0,1
10174861,10174876,15,1,0,0,2
10174877,10175095,218,0,0,1,1
10174877,10176468,1591,0,0,1,2
10175096,10175108,12,1,0,0,1
10175109,10176466,1357,0,0,1,1
10176467,10176565,98,1,0,0,1
10176469,10176567,98,1,0,0,2
10176566,10176772,206,0,0,1,1
10176568,10176776,208,0,0,1,2
10176773,10176791,18,1,0,0,1
10176777,10176791,14,1,0,0,2
10176792,10177018,226,0,0,1,1
10176792,10177020,228,0,0,1,2
10177019,10177031,12,1,0,0,1
10177021,10177031,10,1,0,0,2
10177032,10177129,97,0,0,1,1
10177032,10177131,99,0,0,1,2
10177130,10177149,19,1,0,0,1
10177132,10177155,23,1,0,0,2
10177150,10177463,313,0,0,1,1
10177156,10177849,693,0,0,1,2
10177464,10177473,9,1,0,0,1
10177474,10177849,375,0,0,1,1
10177850,10177861,11,1,0,0,2
10177850,10177862,12,1,0,0,1
10177862,10178169,307,0,0,1,2
10177863,10178170,307,0,0,1,1
10178170,10178245,75,1,0,0,2
10178171,10178246,75,1,0,0,1
10178246,10178327,81,0,0,1,2
10178247,10178327,80,0,0,1,1
10178328,10178358,30,1,0,0,1
10178328,10178358,30,1,0,0,2
10178359,10178559,200,0,0,1,1
10178359,10178990,631,0,0,1,2
10178560,10178564,4,1,0,0,1
10178565,10178988,423,0,0,1,1
10178989,10179000,11,1,0,0,1
10178991,10179000,9,1,0,0,2
10179001,10180115,1114,0,0,1,1
10179001,10180115,1114,0,0,1,2
10180116,10180187,71,1,0,0,1
10180116,10180195,79,1,0,0,2
10180188,10180297,109,0,0,1,1
10180196,10180298,102,0,0,1,2
10180298,10180321,23,1,0,0,1
10180299,10180331,32,1,0,0,2
10180322,10180480,158,0,0,1,1
10180332,10180477,145,0,0,1,2
10180478,10180492,14,1,0,0,2
10180481,10180492,11,1,0,0,1
10180493,10181922,1429,0,0,1,2
10180493,10181923,1430,0,0,1,1
10181923,10182028,105,1,0,0,2
10181924,10182036,112,1,0,0,1
10182029,10182130,101,0,0,1,2
10182037,10182130,93,0,0,1,1
10182131,10182156,25,1,0,0,2
10182131,10182165,34,1,0,0,1
10182157,10182638,481,0,0,1,2
10182166,10182640,474,0,0,1,1
10182639,10182644,5,1,0,0,2
10182641,10182652,11,1,0,0,1
10182645,10182757,112,0,0,1,2
10182653,10182757,104,0,0,1,1
10182758,10182770,12,1,0,0,1
10182758,10182770,12,1,0,0,2
10182771,10183491,720,0,0,1,1
10182771,10183492,721,0,0,1,2
10183492,10183570,78,1,0,0,1
10183493,10183570,77,1,0,0,2
10183571,10183760,189,0,0,1,1
10183571,10183760,189,0,0,1,2
10183761,10183830,69,1,0,0,1
10183761,10183831,70,1,0,0,2
10183831,10183910,79,0,0,1,1
10183832,10183910,78,0,0,1,2
10183911,10183936,25,1,0,0,1
10183911,10183936,25,1,0,0,2
10183937,10184056,119,0,0,1,1
10183937,10184060,123,0,0,1,2
10184057,10184073,16,1,0,0,1
10184061,10184072,11,1,0,0,2
10184073,10184335,262,0,0,1,2
10184074,10185654,1580,0,0,1,1
10184336,10184340,4,1,0,0,2
10184341,10185654,1313,0,0,1,2
10185655,10185713,58,1,0,0,1
10185655,10185713,58,1,0,0,2
10185714,10185809,95,0,0,1,1
10185714,10185809,95,0,0,1,2
10185810,10185833,23,1,0,0,2
10185810,10185834,24,1,0,0,1
10185834,10186144,310,0,0,1,2
10185835,10186146,311,0,0,1,1
10186145,10186149,4,1,0,0,2
10186147,10186156,9,1,0,0,1
10186150,10187432,1282,0,0,1,2
10186157,10187432,1275,0,0,1,1
10187433,10187507,74,1,0,0,1
10187433,10187508,75,1,0,0,2
10187508,10187616,108,0,0,1,1
10187509,10187616,107,0,0,1,2
10187617,10187639,22,1,0,0,1
10187617,10187646,29,1,0,0,2
10187640,10189458,1818,0,0,1,1
10187647,10189459,1812,0,0,1,2
10189459,10189520,61,1,0,0,1
10189460,10189529,69,1,0,0,2
10189521,10189627,106,0,0,1,1
10189530,10189628,98,0,0,1,2
10189628,10189650,22,1,0,0,1
10189629,10189651,22,1,0,0,2
10189651,10191293,1642,0,0,1,1
10189652,10191293,1641,0,0,1,2
10191294,10191341,47,1,0,0,2
10191294,10191343,49,1,0,0,1
10191342,10191448,106,0,0,1,2
10191344,10191448,104,0,0,1,1
10191449,10191469,20,1,0,0,2
10191449,10191471,22,1,0,0,1
10191470,10193256,1786,0,0,1,2
10191472,10193257,1785,0,0,1,1
10193257,10193365,108,1,0,0,2
10193258,10193366,108,1,0,0,1
10193366,10193464,98,0,0,1,2
10193367,10193463,96,0,0,1,1
10193464,10193497,33,1,0,0,1
10193465,10193488,23,1,0,0,2
10193489,10193892,403,0,0,1,2
10193498,10193891,393,0,0,1,1
10193892,10193903,11,1,0,0,1
10193893,10193903,10,1,0,0,2
10193904,10195124,1220,0,0,1,1
10193904,10195124,1220,0,0,1,2
10195125,10195226,101,1,0,0,1
10195125,10195228,103,1,0,0,2
10195227,10195336,109,0,0,1,1
10195229,10195336,107,0,0,1,2
10195337,10195364,27,1,0,0,2
10195337,10195365,28,1,0,0,1
10195365,10196996,1631,0,0,1,2
10195366,10196996,1630,0,0,1,1
10196997,10197085,88,1,0,0,2
10196997,10197086,89,1,0,0,1
10197086,10197163,77,0,0,1,2
10197087,10197163,76,0,0,1,1
10197164,10197191,27,1,0,0,1
10197164,10197192,28,1,0,0,2
10197192,10197316,124,0,0,1,1
10197193,10197315,122,0,0,1,2
10197316,10197335,19,1,0,0,2
10197317,10197335,18,1,0,0,1
10197336,10198527,1191,0,0,1,1
10197336,10198528,1192,0,0,1,2
10198528,10198603,75,1,0,0,1
10198529,10198604,75,1,0,0,2
10198604,10198945,341,0,0,1,1
10198605,10198944,339,0,0,1,2
10198945,10199038,93,1,0,0,2
10198946,10199050,104,1,0,0,1
10199039,10199156,117,0,0,1,2
10199051,10199156,105,0,0,1,1
10199157,10199177,20,1,0,0,2
10199157,10199179,22,1,0,0,1
10199178,10199529,351,0,0,1,2
10199180,10199529,349,0,0,1,1
10199530,10199541,11,1,0,0,1
10199530,10199542,12,1,0,0,2
10199542,10200777,1235,0,0,1,1
10199543,10200779,1236,0,0,1,2
10200778,10200884,106,1,0,0,1
10200780,10200883,103,1,0,0,2
10200884,10200952,68,0,0,1,2
10200885,10200954,69,0,0,1,1
10200953,10201004,51,1,0,0,2
10200955,10201003,48,1,0,0,1
10201004,10201136,132,0,0,1,1
10201005,10201136,131,0,0,1,2
10201137,10201154,17,1,0,0,2
10201137,10201161,24,1,0,0,1
10201155,10202619,1464,0,0,1,2
10201162,10202619,1457,0,0,1,1
10202620,10202695,75,1,0,0,2
10202620,10202697,77,1,0,0,1
10202696,10202833,137,0,0,1,2
10202698,10202833,135,0,0,1,1
10202834,10202897,63,1,0,0,1
10202834,10202898,64,1,0,0,2
10202898,10203088,190,0,0,1,1
10202899,10203089,190,0,0,1,2
10203089,10203101,12,1,0,0,1
10203090,10203099,9,1,0,0,2
10203100,10204809,1709,0,0,1,2
10203102,10204809,1707,0,0,1,1
10204810,10204897,87,1,0,0,1
10204810,10204914,104,1,0,0,2
10204898,10205044,146,0,0,1,1
10204915,10205043,128,0,0,1,2
10205044,10205066,22,1,0,0,2
10205045,10205065,20,1,0,0,1
10205066,10205757,691,0,0,1,1
10205067,10205757,690,0,0,1,2
10205758,10205769,11,1,0,0,1
10205758,10205769,11,1,0,0,2
10205770,10206378,608,0,0,1,1
10205770,10206378,608,0,0,1,2
10206379,10206419,40,1,0,0,1
10206379,10206428,49,1,0,0,2
10206420,10206778,358,0,0,1,1
10206429,10206778,349,0,0,1,2
10206779,10206887,108,1,0,0,2
10206779,10206888,109,1,0,0,1
10206888,10206992,104,0,0,1,2
10206889,10206992,103,0,0,1,1
10206993,10207019,26,1,0,0,1
10206993,10207019,26,1,0,0,2
10207020,10207444,424,0,0,1,1
10207020,10207448,428,0,0,1,2
10207445,10207456,11,1,0,0,1
10207449,10207457,8,1,0,0,2
10207457,10207989,532,0,0,1,1
10207458,10208455,997,0,0,1,2
10207990,10208001,11,1,0,0,1
10208002,10208456,454,0,0,1,1
10208456,10208522,66,1,0,0,2
10208457,10208527,70,1,0,0,1
10208523,10208653,130,0,0,1,2
10208528,10208652,124,0,0,1,1
10208653,10208696,43,1,0,0,1
10208654,10208697,43,1,0,0,2
10208697,10208836,139,0,0,1,1
10208698,10208837,139,0,0,1,2
10208837,10208857,20,1,0,0,1
10208838,10208855,17,1,0,0,2
10208856,10209234,378,0,0,1,2
10208858,10209233,375,0,0,1,1
10209234,10209251,17,1,0,0,1
10209235,10209251,16,1,0,0,2
10209252,10210556,1304,0,0,1,1
10209252,10210556,1304,0,0,1,2
10210557,10210650,93,1,0,0,1
10210557,10210657,100,1,0,0,2
10210651,10210733,82,0,0,1,1
10210658,10210734,76,0,0,1,2
10210734,10210772,38,1,0,0,1
10210735,10210774,39,1,0,0,2
10210773,10211390,617,0,0,1,1
10210775,10212089,1314,0,0,1,2
10211391,10211402,11,1,0,0,1
10211403,10212089,686,0,0,1,1
10212090,10212170,80,1,0,0,2
10212090,10212179,89,1,0,0,1
10212171,10212589,418,0,0,1,2
10212180,10212588,408,0,0,1,1
10212589,10212633,44,1,0,0,1
10212590,10212642,52,1,0,0,2
10212634,10212826,192,0,0,1,1
10212643,10212826,183,0,0,1,2
10212827,10212838,11,1,0,0,1
10212827,10212839,12,1,0,0,2
10212839,10214344,1505,0,0,1,1
10212840,10214343,1503,0,0,1,2
10214344,10214424,80,1,0,0,2
10214345,10214419,74,1,0,0,1
10214420,10214520,100,0,0,1,1
10214425,10214519,94,0,0,1,2
10214520,10214544,24,1,0,0,2
10214521,10214545,24,1,0,0,1
10214545,10214755,210,0,0,1,2
10214546,10214752,206,0,0,1,1
10214753,10214769,16,1,0,0,1
10214756,10214771,15,1,0,0,2
10214770,10216087,1317,0,0,1,1
10214772,10216087,1315,0,0,1,2
10216088,10216141,53,1,0,0,2
10216088,10216142,54,1,0,0,1
10216142,10216252,110,0,0,1,2
10216143,10216254,111,0,0,1,1
10216253,10216280,27,1,0,0,2
10216255,10216278,23,1,0,0,1
10216279,10218422,2143,0,0,1,1
10216281,10218422,2141,0,0,1,2
10218423,10218551,128,1,0,0,2
10218423,10218581,158,1,0,0,1
10218552,10218670,118,0,0,1,2
10218582,10218670,88,0,0,1,1
10218671,10218695,24,1,0,0,1
10218671,10218695,24,1,0,0,2
10218696,10218941,245,0,0,1,2
10218696,10218943,247,0,0,1,1
10218942,10218954,12,1,0,0,2
10218944,10218952,8,1,0,0,1
10218953,10220120,1167,0,0,1,1
10218955,10220120,1165,0,0,1,2
10220121,10220213,92,1,0,0,1
10220121,10220213,92,1,0,0,2
10220214,10220579,365,0,0,1,2
10220214,10220580,366,0,0,1,1
10220580,10220644,64,1,0,0,2
10220581,10220642,61,1,0,0,1
10220643,10220772,129,0,0,1,1
10220645,10220773,128,0,0,1,2
10220773,10220808,35,1,0,0,1
10220774,10220809,35,1,0,0,2
10220809,10221618,809,0,0,1,1
10220810,10221238,428,0,0,1,2
10221239,10221244,5,1,0,0,2
10221245,10221618,373,0,0,1,2
10221619,10221624,5,1,0,0,2
10221619,10221630,11,1,0,0,1
10221625,10222187,562,0,0,1,2
10221631,10222187,556,0,0,1,1
10222188,10222245,57,1,0,0,1
10222188,10222249,61,1,0,0,2
10222246,10222397,151,0,0,1,1
10222250,10222398,148,0,0,1,2
10222398,10222452,54,1,0,0,1
10222399,10222454,55,1,0,0,2
10222453,10222546,93,0,0,1,1
10222455,10222546,91,0,0,1,2
10222547,10222603,56,1,0,0,2
10222547,10222604,57,1,0,0,1
10222604,10222761,157,0,0,1,2
10222605,10222761,156,0,0,1,1
10222762,10222786,24,1,0,0,2
10222762,10222788,26,1,0,0,1
10222787,10222986,199,0,0,1,2
10222789,10222986,197,0,0,1,1
10222987,10222999,12,1,0,0,2
10222987,10223000,13,1,0,0,1
10223000,10224553,1553,0,0,1,2
10223001,10224553,1552,0,0,1,1
10224554,10224636,82,1,0,0,2
10224554,10224640,86,1,0,0,1
10224637,10224748,111,0,0,1,2
10224641,10224746,105,0,0,1,1
10224747,10224774,27,1,0,0,1
10224749,10224771,22,1,0,0,2
10224772,10226327,1555,0,0,1,2
10224775,10224971,196,0,0,1,1
10224972,10224977,5,1,0,0,1
10224978,10226327,1349,0,0,1,1
10226328,10226373,45,1,0,0,1
10226328,10226374,46,1,0,0,2
10226374,10226558,184,0,0,1,1
10226375,10226559,184,0,0,1,2
10226559,10226578,19,1,0,0,1
10226560,10226578,18,1,0,0,2
10226579,10228186,1607,0,0,1,2
10226579,10228187,1608,0,0,1,1
10228187,10228311,124,1,0,0,2
10228188,10228312,124,1,0,0,1
10228312,10228418,106,0,0,1,2
10228313,10228418,105,0,0,1,1
10228419,10228467,48,1,0,0,2
10228419,10228472,53,1,0,0,1
10228468,10228579,111,0,0,1,2
10228473,10228580,107,0,0,1,1
10228580,10228601,21,1,0,0,2
10228581,10228600,19,1,0,0,1
10228601,10230334,1733,0,0,1,1
10228602,10230335,1733,0,0,1,2
10230335,10230403,68,1,0,0,1
10230336,10230404,68,1,0,0,2
10230404,10230487,83,0,0,1,1
10230405,10230487,82,0,0,1,2
10230488,10230512,24,1,0,0,2
10230488,10230514,26,1,0,0,1
10230513,10230680,167,0,0,1,2
10230515,10230684,169,0,0,1,1
10230681,10230698,17,1,0,0,2
10230685,10230699,14,1,0,0,1
10230699,10230802,103,0,0,1,2
10230700,10230797,97,0,0,1,1
10230798,10230815,17,1,0,0,1
10230803,10230816,13,1,0,0,2
10230816,10231182,366,0,0,1,1
10230817,10231183,366,0,0,1,2
10231183,10231192,9,1,0,0,1
10231184,10231195,11,1,0,0,2
10231193,10232299,1106,0,0,1,1
10231196,10232299,1103,0,0,1,2
10232300,10232402,102,1,0,0,2
10232300,10232426,126,1,0,0,1
10232403,10232486,83,0,0,1,2
10232427,10232487,60,0,0,1,1
10232487,10232511,24,1,0,0,2
10232488,10232513,25,1,0,0,1
10232512,10232656,144,0,0,1,2
10232514,10232655,141,0,0,1,1
10232656,10232678,22,1,0,0,1
10232657,10232676,19,1,0,0,2
10232677,10234240,1563,0,0,1,2
10232679,10234241,1562,0,0,1,1
10234241,10234368,127,1,0,0,2
10234242,10234408,166,1,0,0,1
10234369,10234475,106,0,0,1,2
10234409,10234476,67,0,0,1,1
10234476,10234509,33,1,0,0,2
10234477,10234508,31,1,0,0,1
10234509,10234621,112,0,0,1,1
10234510,10234622,112,0,0,1,2
10234622,10234639,17,1,0,0,1
10234623,10234639,16,1,0,0,2
10234640,10236233,1593,0,0,1,2
10234640,10236234,1594,0,0,1,1
10236234,10236290,56,1,0,0,2
10236235,10236285,50,1,0,0,1
10236286,10236493,207,0,0,1,1
10236291,10236494,203,0,0,1,2
10236494,10236511,17,1,0,0,1
10236495,10236511,16,1,0,0,2
10236512,10238082,1570,0,0,1,1
10236512,10238083,1571,0,0,1,2
10238083,10238153,70,1,0,0,1
10238084,10238171,87,1,0,0,2
10238154,10238344,190,0,0,1,1
10238172,10238344,172,0,0,1,2
10238345,10238366,21,1,0,0,1
10238345,10238366,21,1,0,0,2
10238367,10238555,188,0,0,1,2
10238367,10238557,190,0,0,1,1
10238556,10238568,12,1,0,0,2
10238558,10238569,11,1,0,0,1
10238569,10238690,121,0,0,1,2
10238570,10238694,124,0,0,1,1
10238691,10238716,25,1,0,0,2
10238695,10238709,14,1,0,0,1
10238710,10239808,1098,0,0,1,1
10238717,10239807,1090,0,0,1,2
10239808,10239821,13,1,0,0,2
10239809,10239817,8,1,0,0,1
10239818,10240068,250,0,0,1,1
10239822,10240068,246,0,0,1,2
10240069,10240140,71,1,0,0,1
10240069,10240141,72,1,0,0,2
10240141,10240240,99,0,0,1,1
10240142,10240240,98,0,0,1,2
10240241,10240266,25,1,0,0,2
10240241,10240274,33,1,0,0,1
10240267,10242026,1759,0,0,1,2
10240275,10242026,1751,0,0,1,1
10242027,10242138,111,1,0,0,1
10242027,10242138,111,1,0,0,2
10242139,10242244,105,0,0,1,2
10242139,10242245,106,0,0,1,1
10242245,10242269,24,1,0,0,2
10242246,10242271,25,1,0,0,1
10242270,10243783,1513,0,0,1,2
10242272,10243784,1512,0,0,1,1
10243784,10243839,55,1,0,0,2
10243785,10243839,54,1,0,0,1
10243840,10244012,172,0,0,1,1
10243840,10244012,172,0,0,1,2
10244013,10244116,103,1,0,0,2
10244013,10244117,104,1,0,0,1
10244117,10244177,60,0,0,1,2
10244118,10244175,57,0,0,1,1
10244176,10244246,70,1,0,0,1
10244178,10244217,39,1,0,0,2
10244218,10244318,100,0,0,1,2
10244247,10244316,69,0,0,1,1
10244317,10244344,27,1,0,0,1
10244319,10244346,27,1,0,0,2
10244345,10244894,549,0,0,1,1
10244347,10244893,546,0,0,1,2
10244894,10244907,13,1,0,0,2
10244895,10244907,12,1,0,0,1
10244908,10245443,535,0,0,1,1
10244908,10245445,537,0,0,1,2
10245444,10245561,117,1,0,0,1
10245446,10245560,114,1,0,0,2
10245492,10245533,41,0,1,0,1
10245561,10245878,317,0,0,1,2
10245562,10245877,315,0,0,1,1
10245878,10245934,56,1,0,0,1
10245879,10245934,55,1,0,0,2
10245935,10246072,137,0,0,1,2
10245935,10246073,138,0,0,1,1
10246073,10246092,19,1,0,0,2
10246074,10246092,18,1,0,0,1
10246093,10246309,216,0,0,1,2
10246093,10246311,218,0,0,1,1
10246310,10246322,12,1,0,0,2
10246312,10246316,4,1,0,0,1
10246317,10247647,1330,0,0,1,1
10246323,10247647,1324,0,0,1,2
10247648,10247707,59,1,0,0,1
10247648,10247708,60,1,0,0,2
10247708,10247804,96,0,0,1,1
10247709,10247805,96,0,0,1,2
10247805,10247837,32,1,0,0,1
10247806,10247838,32,1,0,0,2
10247838,10248165,327,0,0,1,1
10247839,10248166,327,0,0,1,2
10248166,10248177,11,1,0,0,1
10248167,10248177,10,1,0,0,2
10248178,10248299,121,0,0,1,1
10248178,10248301,123,0,0,1,2
10248300,10248317,17,1,0,0,1
10248302,10248318,16,1,0,0,2
10248318,10249456,1138,0,0,1,1
10248319,10249455,1136,0,0,1,2
10249456,10249535,79,1,0,0,2
10249457,10249540,83,1,0,0,1
10249536,10249611,75,0,0,1,2
10249541,10249611,70,0,0,1,1
10249612,10249654,42,1,0,0,2
10249612,10249663,51,1,0,0,1
10249655,10249784,129,0,0,1,2
10249664,10249783,119,0,0,1,1
10249784,10249809,25,1,0,0,1
10249785,10249801,16,1,0,0,2
10249802,10250032,230,0,0,1,2
10249810,10250037,227,0,0,1,1
10250033,10250045,12,1,0,0,2
10250038,10250044,6,1,0,0,1
10250045,10251319,1274,0,0,1,1
10250046,10250509,463,0,0,1,2
10250510,10250521,11,1,0,0,2
10250522,10251320,798,0,0,1,2
10251320,10251406,86,1,0,0,1
10251321,10251424,103,1,0,0,2
10251407,10251496,89,0,0,1,1
10251425,10251496,71,0,0,1,2
10251497,10251524,27,1,0,0,2
10251497,10251525,28,1,0,0,1
10251525,10253294,1769,0,0,1,2
10251526,10253295,1769,0,0,1,1
10253295,10253339,44,1,0,0,2
10253296,10253339,43,1,0,0,1
10253340,10253424,84,0,0,1,1
10253340,10253424,84,0,0,1,2
10253425,10253449,24,1,0,0,1
10253425,10253456,31,1,0,0,2
10253450,10253848,398,0,0,1,1
10253457,10253847,390,0,0,1,2
10253848,10253861,13,1,0,0,2
10253849,10253861,12,1,0,0,1
10253862,10255213,1351,0,0,1,1
10253862,10255214,1352,0,0,1,2
10255214,10255306,92,1,0,0,1
10255215,10255304,89,1,0,0,2
10255305,10255408,103,0,0,1,2
10255307,10255407,100,0,0,1,1
10255408,10255439,31,1,0,0,1
10255409,10255442,33,1,0,0,2
10255440,10255822,382,0,0,1,1
10255443,10257218,1775,0,0,1,2
10255823,10255833,10,1,0,0,1
10255834,10257217,1383,0,0,1,1
10257218,10257300,82,1,0,0,1
10257219,10257300,81,1,0,0,2
10257301,10257397,96,0,0,1,1
10257301,10257398,97,0,0,1,2
10257398,10257420,22,1,0,0,1
10257399,10257421,22,1,0,0,2
10257421,10257969,548,0,0,1,1
10257422,10257968,546,0,0,1,2
10257969,10257980,11,1,0,0,2
10257970,10257980,10,1,0,0,1
10257981,10259126,1145,0,0,1,1
10257981,10259127,1146,0,0,1,2
10259127,10259201,74,1,0,0,1
10259128,10259211,83,1,0,0,2
10259202,10259300,98,0,0,1,1
10259212,10259301,89,0,0,1,2
10259301,10259330,29,1,0,0,1
10259302,10259325,23,1,0,0,2
10259326,10260922,1596,0,0,1,2
10259331,10260922,1591,0,0,1,1
10260923,10261024,101,1,0,0,1
10260923,10261051,128,1,0,0,2
10261025,10261161,136,0,0,1,1
10261052,10261162,110,0,0,1,2
10261162,10261191,29,1,0,0,1
10261163,10261192,29,1,0,0,2
10261192,10261312,120,0,0,1,1
10261193,10261315,122,0,0,1,2
10261313,10261334,21,1,0,0,1
10261316,10261335,19,1,0,0,2
10261335,10262192,857,0,0,1,1
10261336,10262195,859,0,0,1,2
10262193,10262425,232,1,0,0,1
10262196,10262421,225,1,0,0,2
10262243,10262380,137,0,1,0,1
10262244,10262376,132,0,1,0,2
10262422,10262632,210,0,0,1,2
10262426,10262633,207,0,0,1,1
10262633,10262688,55,1,0,0,2
10262634,10262691,57,1,0,0,1
10262689,10262755,66,0,0,1,2
10262692,10262756,64,0,0,1,1
10262756,10262801,45,1,0,0,2
10262757,10262799,42,1,0,0,1
10262800,10262934,134,0,0,1,1
10262802,10262938,136,0,0,1,2
10262935,10262954,19,1,0,0,1
10262939,10262954,15,1,0,0,2
10262955,10264301,1346,0,0,1,1
10262955,10264303,1348,0,0,1,2
10264302,10264384,82,1,0,0,1
10264304,10264401,97,1,0,0,2
10264385,10264507,122,0,0,1,1
10264402,10264507,105,0,0,1,2
10264508,10264530,22,1,0,0,1
10264508,10264537,29,1,0,0,2
10264531,10265035,504,0,0,1,1
10264538,10265034,496,0,0,1,2
10265035,10265045,10,1,0,0,2
10265036,10265045,9,1,0,0,1
10265046,10266050,1004,0,0,1,2
10265046,10266051,1005,0,0,1,1
10266051,10266131,80,1,0,0,2
10266052,10266132,80,1,0,0,1
10266132,10266243,111,0,0,1,2
10266133,10266244,111,0,0,1,1
10266244,10266269,25,1,0,0,2
10266245,10266269,24,1,0,0,1
10266270,10266435,165,0,0,1,1
10266270,10266440,170,0,0,1,2
10266436,10266450,14,1,0,0,1
10266441,10266449,8,1,0,0,2
10266450,10267961,1511,0,0,1,2
10266451,10267960,1509,0,0,1,1
10267961,10268039,78,1,0,0,1
10267962,10268040,78,1,0,0,2
10268040,10268148,108,0,0,1,1
10268041,10268147,106,0,0,1,2
10268148,10268172,24,1,0,0,2
10268149,10268172,23,1,0,0,1
10268173,10269424,1251,0,0,1,2
10268173,10269425,1252,0,0,1,1
10269425,10269479,54,1,0,0,2
10269426,10269479,53,1,0,0,1
10269480,10269644,164,0,0,1,1
10269480,10271783,2303,0,0,1,2
10269645,10269660,15,1,0,0,1
10269661,10271781,2120,0,0,1,1
10271782,10271841,59,1,0,0,1
10271784,10271840,56,1,0,0,2
10271841,10272840,999,0,0,1,2
10271842,10272840,998,0,0,1,1
10272841,10272945,104,1,0,0,1
10272841,10272945,104,1,0,0,2
10272946,10273067,121,0,0,1,2
10272946,10273068,122,0,0,1,1
10273068,10273088,20,1,0,0,2
10273069,10273090,21,1,0,0,1
10273089,10273148,59,0,0,1,2
10273091,10273139,48,0,0,1,1
10273140,10273475,335,1,0,0,1
10273149,10273434,285,1,0,0,2
10273166,10273391,225,0,1,0,1
10273168,10273378,210,0,1,0,2
10273435,10273455,20,0,0,1,2
10273456,10273475,19,1,0,0,2
10273476,10274548,1072,0,0,1,1
10273476,10274548,1072,0,0,1,2
10274549,10274590,41,1,0,0,1
10274549,10274597,48,1,0,0,2
10274591,10275190,599,0,0,1,1
10274598,10275195,597,0,0,1,2
10275191,10275207,16,1,0,0,1
10275196,10275207,11,1,0,0,2
10275208,10275366,158,0,0,1,2
10275208,10275368,160,0,0,1,1
10275367,10275381,14,1,0,0,2
10275369,10275379,10,1,0,0,1
10275380,10277240,1860,0,0,1,1
10275382,10277266,1884,0,0,1,2
10277241,10277569,328,1,0,0,1
10277267,10277566,299,1,0,0,2
10277284,10277530,246,0,1,0,1
10277309,10277493,184,0,1,0,2
10277567,10278014,447,0,0,1,2
10277570,10278014,444,0,0,1,1
10278015,10278075,60,1,0,0,1
10278015,10278080,65,1,0,0,2
10278076,10278166,90,0,0,1,1
10278081,10278167,86,0,0,1,2
10278167,10278194,27,1,0,0,1
10278168,10278195,27,1,0,0,2
10278195,10279366,1171,0,0,1,1
10278196,10279366,1170,0,0,1,2
10279367,10279428,61,1,0,0,1
10279367,10279429,62,1,0,0,2
10279429,10280392,963,0,0,1,1
10279430,10280392,962,0,0,1,2
10280393,10280414,21,1,0,0,1
10280393,10280414,21,1,0,0,2
10280415,10281553,1138,0,0,1,1
10280415,10281559,1144,0,0,1,2
10281554,10281958,404,1,0,0,1
10281560,10282009,449,1,0,0,2
10281603,10281938,335,0,1,0,1
10281609,10281916,307,0,1,0,2
10281959,10281979,20,0,0,1,1
10281980,10282016,36,1,0,0,1
10282010,10282114,104,0,0,1,2
10282017,10282113,96,0,0,1,1
10282114,10282153,39,1,0,0,1
10282115,10282153,38,1,0,0,2
10282154,10282998,844,0,0,1,1
10282154,10282998,844,0,0,1,2
10282999,10283065,66,1,0,0,1
10282999,10283075,76,1,0,0,2
10283066,10283173,107,0,0,1,1
10283076,10283172,96,0,0,1,2
10283173,10283194,21,1,0,0,2
10283174,10283194,20,1,0,0,1
10283195,10285432,2237,0,0,1,2
10283195,10285433,2238,0,0,1,1
10285433,10285480,47,1,0,0,2
10285434,10285479,45,1,0,0,1
10285480,10285654,174,0,0,1,1
10285481,10285653,172,0,0,1,2
10285654,10285677,23,1,0,0,2
10285655,10285676,21,1,0,0,1
10285677,10287513,1836,0,0,1,1
10285678,10287533,1855,0,0,1,2
10287514,10289013,1499,1,0,0,1
10287534,10289041,1507,1,0,0,2
10287546,10288996,1450,0,1,0,1
10287563,10289013,1450,0,1,0,2
10289014,10289243,229,0,0,1,1
10289042,10289244,202,0,0,1,2
10289244,10289317,73,1,0,0,1
10289245,10289319,74,1,0,0,2
10289318,10289412,94,0,0,1,1
10289320,10289412,92,0,0,1,2
10289413,10289436,23,1,0,0,1
10289413,10289437,24,1,0,0,2
10289437,10289586,149,0,0,1,1
10289438,10289584,146,0,0,1,2
10289585,10289601,16,1,0,0,2
10289587,10289602,15,1,0,0,1
10289602,10289819,217,0,0,1,2
10289603,10289819,216,0,0,1,1
10289820,10289833,13,1,0,0,1
10289820,10289833,13,1,0,0,2
10289834,10290510,676,0,0,1,2
10289834,10290511,677,0,0,1,1
10290511,10290566,55,1,0,0,2
10290512,10290566,54,1,0,0,1
10290567,10290715,148,0,0,1,1
10290567,10290715,148,0,0,1,2
10290716,10290733,17,1,0,0,2
10290716,10290734,18,1,0,0,1
10290734,10292558,1824,0,0,1,2
10290735,10292554,1819,0,0,1,1
10292555,10293426,871,1,0,0,1
10292559,10293427,868,1,0,0,2
10292572,10293410,838,0,1,0,1
10292579,10293417,838,0,1,0,2
10293427,10293932,505,0,0,1,1
10293428,10293931,503,0,0,1,2
10293932,10294009,77,1,0,0,2
10293933,10294018,85,1,0,0,1
10294010,10294117,107,0,0,1,2
10294019,10294117,98,0,0,1,1
10294118,10294142,24,1,0,0,2
10294118,10294159,41,1,0,0,1
10294143,10294639,496,0,0,1,2
10294160,10294305,145,0,0,1,1
10294306,10294312,6,1,0,0,1
10294313,10294638,325,0,0,1,1
10294639,10294650,11,1,0,0,1
10294640,10294659,19,1,0,0,2
10294651,10295479,828,0,0,1,1
10294660,10295478,818,0,0,1,2
10295479,10295534,55,1,0,0,2
10295480,10295533,53,1,0,0,1
10295534,10295633,99,0,0,1,1
10295535,10295632,97,0,0,1,2
10295633,10295658,25,1,0,0,2
10295634,10295657,23,1,0,0,1
10295658,10296297,639,0,0,1,1
10295659,10296302,643,0,0,1,2
10296298,10296314,16,1,0,0,1
10296303,10296314,11,1,0,0,2
10296315,10296824,509,0,0,1,1
10296315,10298087,1772,0,0,1,2
10296825,10296836,11,1,0,0,1
10296837,10297004,167,0,0,1,1
10297005,10297016,11,1,0,0,1
10297017,10298087,1070,0,0,1,1
10298088,10298166,78,1,0,0,2
10298088,10298173,85,1,0,0,1
10298167,10298394,227,0,0,1,2
10298174,10298394,220,0,0,1,1
10298395,10298426,31,1,0,0,1
10298395,10298428,33,1,0,0,2
10298427,10298807,380,0,0,1,1
10298429,10298806,377,0,0,1,2
10298807,10298856,49,1,0,0,2
10298808,10298856,48,1,0,0,1
10298857,10298995,138,0,0,1,2
10298857,10299198,341,0,0,1,1
10298996,10299004,8,1,0,0,2
10299005,10299202,197,0,0,1,2
10299199,10299218,19,1,0,0,1
10299203,10299215,12,1,0,0,2
10299216,10300000,784,0,0,1,2
10299219,10299998,779,0,0,1,1
10299999,10300041,42,1,0,0,1
10300001,10300041,40,1,0,0,2
10300042,10300411,369,0,0,1,2
10300042,10300416,374,0,0,1,1
10300412,10300699,287,1,0,0,2
10300417,10300657,240,1,0,0,1
10300441,10300628,187,0,1,0,1
10300454,10300603,149,0,1,0,2
10300658,10302136,1478,0,0,1,1
10300700,10302133,1433,0,0,1,2
10302134,10302157,23,1,0,0,2
10302137,10302156,19,1,0,0,1
10302157,10302183,26,0,0,1,1
10302158,10302182,24,0,0,1,2
10302183,10302565,382,1,0,0,2
10302184,10302562,378,1,0,0,1
10302213,10302547,334,0,1,0,1
10302215,10302549,334,0,1,0,2
10302563,10303537,974,0,0,1,1
10302566,10303537,971,0,0,1,2
10303538,10303609,71,1,0,0,1
10303538,10303616,78,1,0,0,2
10303610,10303708,98,0,0,1,1
10303617,10303708,91,0,0,1,2
10303709,10303728,19,1,0,0,1
10303709,10303728,19,1,0,0,2
10303729,10303754,25,0,0,1,1
10303729,10303761,32,0,0,1,2
10303755,10304342,587,1,0,0,1
10303762,10304240,478,1,0,0,2
10303772,10304330,558,0,1,0,1
10303782,10304067,285,0,1,0,2
10304088,10304134,46,0,1,0,2
10304241,10305747,1506,0,0,1,2
10304343,10305746,1403,0,0,1,1
10305747,10305787,40,1,0,0,1
10305748,10305785,37,1,0,0,2
10305786,10306004,218,0,0,1,2
10305788,10306005,217,0,0,1,1
10306005,10306038,33,1,0,0,2
10306006,10306027,21,1,0,0,1
10306028,10308450,2422,0,0,1,1
10306039,10308449,2410,0,0,1,2
10308450,10308499,49,1,0,0,2
10308451,10308494,43,1,0,0,1
10308495,10309816,1321,0,0,1,1
10308500,10309817,1317,0,0,1,2
10309817,10309887,70,1,0,0,1
10309818,10309894,76,1,0,0,2
10309888,10309993,105,0,0,1,1
10309895,10309993,98,0,0,1,2
10309994,10310016,22,1,0,0,1
10309994,10310027,33,1,0,0,2
10310017,10311765,1748,0,0,1,1
10310028,10311764,1736,0,0,1,2
10311765,10311800,35,1,0,0,2
10311766,10311806,40,1,0,0,1
10311801,10311954,153,0,0,1,2
10311807,10311954,147,0,0,1,1
10311955,10311967,12,1,0,0,1
10311955,10311969,14,1,0,0,2
10311968,10312186,218,0,0,1,1
10311970,10312181,211,0,0,1,2
10312182,10312196,14,1,0,0,2
10312187,10312197,10,1,0,0,1
10312197,10313902,1705,0,0,1,2
10312198,10314482,2284,0,0,1,1
10313903,10313915,12,1,0,0,2
10313916,10314481,565,0,0,1,2
10314482,10314535,53,1,0,0,2
10314483,10314534,51,1,0,0,1
10314535,10315686,1151,0,0,1,1
10314536,10315686,1150,0,0,1,2
10315687,10315767,80,1,0,0,1
10315687,10315777,90,1,0,0,2
10315768,10315875,107,0,0,1,1
10315778,10315875,97,0,0,1,2
10315876,10315908,32,1,0,0,1
10315876,10315909,33,1,0,0,2
10315909,10316318,409,0,0,1,1
10315910,10316318,408,0,0,1,2
10316319,10316329,10,1,0,0,1
10316319,10316330,11,1,0,0,2
10316330,10317800,1470,0,0,1,1
10316331,10317800,1469,0,0,1,2
10317801,10317865,64,1,0,0,2
10317801,10317873,72,1,0,0,1
10317866,10317973,107,0,0,1,2
10317874,10317972,98,0,0,1,1
10317973,10317997,24,1,0,0,1
10317974,10317998,24,1,0,0,2
10317998,10318097,99,0,0,1,1
10317999,10318098,99,0,0,1,2
10318098,10318112,14,1,0,0,1
10318099,10318111,12,1,0,0,2
10318112,10320207,2095,0,0,1,2
10318113,10320203,2090,0,0,1,1
10320204,10320501,297,1,0,0,1
10320208,10320524,316,1,0,0,2
10320241,10320463,222,0,1,0,1
10320249,10320436,187,0,1,0,2
10320502,10321878,1376,0,0,1,1
10320525,10321879,1354,0,0,1,2
10321879,10321959,80,1,0,0,1
10321880,10321967,87,1,0,0,2
10321960,10322070,110,0,0,1,1
10321968,10322069,101,0,0,1,2
10322070,10322096,26,1,0,0,2
10322071,10322095,24,1,0,0,1
10322096,10322342,246,0,0,1,1
10322097,10322339,242,0,0,1,2
10322340,10322356,16,1,0,0,2
10322343,10322356,13,1,0,0,1
10322357,10322510,153,0,0,1,2
10322357,10322512,155,0,0,1,1
10322511,10322526,15,1,0,0,2
10322513,10322540,27,1,0,0,1
10322527,10322722,195,0,0,1,2
10322541,10323563,1022,0,0,1,1
10322723,10322736,13,1,0,0,2
10322737,10323563,826,0,0,1,2
10323564,10323615,51,1,0,0,2
10323564,10323618,54,1,0,0,1
10323616,10325784,2168,0,0,1,2
10323619,10325762,2143,0,0,1,1
10325763,10326239,476,1,0,0,1
10325785,10326160,375,1,0,0,2
10325801,10326135,334,0,1,0,1
10325814,10326069,255,0,1,0,2
10326161,10326231,70,0,0,1,2
10326232,10326239,7,1,0,0,2
10326240,10326318,78,0,0,1,1
10326240,10326320,80,0,0,1,2
10326319,10326337,18,1,0,0,1
10326321,10326338,17,1,0,0,2
10326338,10327313,975,0,0,1,1
10326339,10327312,973,0,0,1,2
10327313,10327369,56,1,0,0,2
10327314,10327365,51,1,0,0,1
10327366,10327486,120,0,0,1,1
10327370,10327488,118,0,0,1,2
10327487,10327506,19,1,0,0,1
10327489,10327509,20,1,0,0,2
10327507,10327783,276,0,0,1,1
10327510,10327779,269,0,0,1,2
10327780,10327799,19,1,0,0,2
10327784,10327800,16,1,0,0,1
10327800,10327906,106,0,0,1,2
10327801,10327905,104,0,0,1,1
10327906,10327926,20,1,0,0,1
10327907,10327926,19,1,0,0,2
10327927,10328921,994,0,0,1,1
10327927,10328921,994,0,0,1,2
10328922,10328984,62,1,0,0,1
10328922,10328992,70,1,0,0,2
10328985,10329175,190,0,0,1,1
10328993,10329175,182,0,0,1,2
10329176,10329198,22,1,0,0,1
10329176,10329199,23,1,0,0,2
10329199,10330760,1561,0,0,1,1
10329200,10330773,1573,0,0,1,2
10330761,10331019,258,1,0,0,1
10330774,10331007,233,1,0,0,2
10330785,10330988,203,0,1,0,1
10330798,10330937,139,0,1,0,2
10331008,10332727,1719,0,0,1,2
10331020,10332728,1708,0,0,1,1
10332728,10332817,89,1,0,0,2
10332729,10332826,97,1,0,0,1
10332818,10332929,111,0,0,1,2
10332827,10332928,101,0,0,1,1
10332929,10332958,29,1,0,0,1
10332930,10332952,22,1,0,0,2
10332953,10333098,145,0,0,1,2
10332959,10333097,138,0,0,1,1
10333098,10333119,21,1,0,0,1
10333099,10333128,29,1,0,0,2
10333120,10334744,1624,0,0,1,1
10333129,10334744,1615,0,0,1,2
10334745,10334786,41,1,0,0,1
10334745,10334793,48,1,0,0,2
10334787,10334932,145,0,0,1,1
10334794,10334931,137,0,0,1,2
10334932,10334952,20,1,0,0,2
10334933,10334953,20,1,0,0,1
10334953,10335118,165,0,0,1,2
10334954,10335117,163,0,0,1,1
10335118,10335144,26,1,0,0,1
10335119,10335147,28,1,0,0,2
10335145,10335547,402,0,0,1,1
10335148,10335545,397,0,0,1,2
10335546,10335564,18,1,0,0,2
10335548,10335567,19,1,0,0,1
10335565,10335679,114,0,0,1,2
10335568,10335681,113,0,0,1,1
10335680,10335700,20,1,0,0,2
10335682,10335700,18,1,0,0,1
10335701,10336213,512,0,0,1,2
10335701,10336214,513,0,0,1,1
10336214,10336232,18,1,0,0,2
10336215,10336233,18,1,0,0,1
10336233,10336833,600,0,0,1,2
10336234,10337365,1131,0,0,1,1
10336834,10336845,11,1,0,0,2
10336846,10337361,515,0,0,1,2
10337362,10337651,289,1,0,0,2
10337366,10337640,274,1,0,0,1
10337384,10337614,230,0,1,0,1
10337395,10337573,178,0,1,0,2
10337597,10337597,0,0,1,0,2
10337641,10338623,982,0,0,1,1
10337652,10338623,971,0,0,1,2
10338624,10338685,61,1,0,0,2
10338624,10338694,70,1,0,0,1
10338686,10338780,94,0,0,1,2
10338695,10338781,86,0,0,1,1
10338781,10338817,36,1,0,0,2
10338782,10338814,32,1,0,0,1
10338815,10339247,432,0,0,1,1
10338818,10339247,429,0,0,1,2
10339248,10339259,11,1,0,0,1
10339248,10339269,21,1,0,0,2
10339260,10339859,599,0,0,1,1
10339270,10339860,590,0,0,1,2
10339860,10339919,59,1,0,0,1
10339861,10339926,65,1,0,0,2
10339920,10340035,115,0,0,1,1
10339927,10340035,108,0,0,1,2
10340036,10340060,24,1,0,0,1
10340036,10340069,33,1,0,0,2
10340061,10340339,278,0,0,1,1
10340070,10340337,267,0,0,1,2
10340338,10340359,21,1,0,0,2
10340340,10340358,18,1,0,0,1
10340359,10342846,2487,0,0,1,1
10340360,10342845,2485,0,0,1,2
10342846,10342920,74,1,0,0,2
10342847,10342910,63,1,0,0,1
10342911,10343101,190,0,0,1,1
10342921,10343102,181,0,0,1,2
10343102,10343175,73,1,0,0,1
10343103,10343179,76,1,0,0,2
10343176,10343283,107,0,0,1,1
10343180,10343283,103,0,0,1,2
10343284,10343304,20,1,0,0,2
10343284,10343305,21,1,0,0,1
10343305,10343569,264,0,0,1,2
10343306,10344158,852,0,0,1,1
10343570,10343578,8,1,0,0,2
10343579,10344157,578,0,0,1,2
10344158,10344221,63,1,0,0,2
10344159,10344214,55,1,0,0,1
10344215,10344416,201,0,0,1,1
10344222,10344421,199,0,0,1,2
10344417,10344432,15,1,0,0,1
10344422,10344432,10,1,0,0,2
10344433,10346426,1993,0,0,1,1
10344433,10346438,2005,0,0,1,2
10346427,10346741,314,1,0,0,1
10346439,10346705,266,1,0,0,2
10346452,10346695,243,0,1,0,1
10346471,10346627,156,0,1,0,2
10346706,10347409,703,0,0,1,2
10346742,10347410,668,0,0,1,1
10347410,10347473,63,1,0,0,2
10347411,10347473,62,1,0,0,1
10347474,10347576,102,0,0,1,1
10347474,10347576,102,0,0,1,2
10347577,10347601,24,1,0,0,2
10347577,10347610,33,1,0,0,1
10347602,10347933,331,0,0,1,2
10347611,10347932,321,0,0,1,1
10347933,10347944,11,1,0,0,1
10347934,10347945,11,1,0,0,2
10347945,10348745,800,0,0,1,1
10347946,10348746,800,0,0,1,2
10348746,10348803,57,1,0,0,1
10348747,10348800,53,1,0,0,2
10348801,10349081,280,0,0,1,2
10348804,10349078,274,0,0,1,1
10349079,10349104,25,1,0,0,1
10349082,10349098,16,1,0,0,2
10349099,10351028,1929,0,0,1,2
10349105,10351024,1919,0,0,1,1
10351025,10351353,328,1,0,0,1
10351029,10351343,314,1,0,0,2
10351059,10351303,244,0,1,0,1
10351074,10351255,181,0,1,0,2
10351344,10352163,819,0,0,1,2
10351354,10352163,809,0,0,1,1
10352164,10352244,80,1,0,0,1
10352164,10352251,87,1,0,0,2
10352245,10352355,110,0,0,1,1
10352252,10352355,103,0,0,1,2
10352356,10352375,19,1,0,0,1
10352356,10352375,19,1,0,0,2
10352376,10352536,160,0,0,1,2
10352376,10352538,162,0,0,1,1
10352537,10352546,9,1,0,0,2
10352539,10352547,8,1,0,0,1
10352547,10354093,1546,0,0,1,2
10352548,10354094,1546,0,0,1,1
10354094,10354141,47,1,0,0,2
10354095,10354142,47,1,0,0,1
10354142,10354425,283,0,0,1,2
10354143,10354426,283,0,0,1,1
10354426,10354453,27,1,0,0,2
10354427,10354452,25,1,0,0,1
10354453,10356373,1920,0,0,1,1
10354454,10356389,1935,0,0,1,2
10356374,10356762,388,1,0,0,1
10356390,10356691,301,1,0,0,2
10356401,10356736,335,0,1,0,1
10356409,10356665,256,0,1,0,2
10356692,10357322,630,0,0,1,2
10356763,10357323,560,0,0,1,1
10357323,10357366,43,1,0,0,2
10357324,10357348,24,1,0,0,1
10357349,10358012,663,0,0,1,1
10357367,10358012,645,0,0,1,2
10358013,10358101,88,1,0,0,2
10358013,10358102,89,1,0,0,1
10358102,10358211,109,0,0,1,2
10358103,10358211,108,0,0,1,1
10358212,10358233,21,1,0,0,2
10358212,10358234,22,1,0,0,1
10358234,10358533,299,0,0,1,2
10358235,10358532,297,0,0,1,1
10358533,10358552,19,1,0,0,1
10358534,10358550,16,1,0,0,2
10358551,10358681,130,0,0,1,2
10358553,10358680,127,0,0,1,1
10358681,10358698,17,1,0,0,1
10358682,10358699,17,1,0,0,2
10358699,10359261,562,0,0,1,1
10358700,10359263,563,0,0,1,2
10359262,10359327,65,1,0,0,1
10359264,10359337,73,1,0,0,2
10359328,10359479,151,0,0,1,1
10359338,10359478,140,0,0,1,2
10359479,10359499,20,1,0,0,2
10359480,10359498,18,1,0,0,1
10359499,10362536,3037,0,0,1,1
10359500,10362535,3035,0,0,1,2
10362536,10362632,96,1,0,0,2
10362537,10362639,102,1,0,0,1
10362633,10362741,108,0,0,1,2
10362640,10362739,99,0,0,1,1
10362740,10362764,24,1,0,0,1
10362742,10362764,22,1,0,0,2
10362765,10362982,217,0,0,1,1
10362765,10362984,219,0,0,1,2
10362983,10363001,18,1,0,0,1
10362985,10363001,16,1,0,0,2
10363002,10363844,842,0,0,1,2
10363002,10363845,843,0,0,1,1
10363845,10363885,40,1,0,0,2
10363846,10363887,41,1,0,0,1
10363886,10364018,132,0,0,1,2
10363888,10364016,128,0,0,1,1
10364017,10364036,19,1,0,0,1
10364019,10364037,18,1,0,0,2
10364037,10367272,3235,0,0,1,1
10364038,10367273,3235,0,0,1,2
10367273,10367365,92,1,0,0,1
10367274,10367375,101,1,0,0,2
10367366,10367472,106,0,0,1,1
10367376,10367473,97,0,0,1,2
10367473,10367500,27,1,0,0,1
10367474,10367500,26,1,0,0,2
10367501,10367647,146,0,0,1,1
10367501,10367647,146,0,0,1,2
10367648,10367659,11,1,0,0,1
10367648,10367659,11,1,0,0,2
10367660,10368079,419,0,0,1,1
10367660,10368079,419,0,0,1,2
10368080,10368092,12,1,0,0,1
10368080,10368094,14,1,0,0,2
10368093,10368663,570,0,0,1,1
10368095,10368381,286,0,0,1,2
10368382,10368390,8,1,0,0,2
10368391,10369371,980,0,0,1,2
10368664,10368674,10,1,0,0,1
10368675,10369371,696,0,0,1,1
10369372,10369461,89,1,0,0,2
10369372,10369463,91,1,0,0,1
10369462,10369983,521,0,0,1,2
10369464,10369981,517,0,0,1,1
10369982,10370003,21,1,0,0,1
10369984,10370002,18,1,0,0,2
10370003,10370225,222,0,0,1,2
10370004,10370227,223,0,0,1,1
10370226,10370246,20,1,0,0,2
10370228,10370247,19,1,0,0,1
10370247,10370395,148,0,0,1,2
10370248,10370395,147,0,0,1,1
10370396,10370416,20,1,0,0,1
10370396,10370429,33,1,0,0,2
10370417,10371445,1028,0,0,1,1
10370430,10371447,1017,0,0,1,2
10371446,10371782,336,1,0,0,1
10371448,10371786,338,1,0,0,2
10371474,10371729,255,0,1,0,1
10371485,10371697,212,0,1,0,2
10371783,10373340,1557,0,0,1,1
10371787,10373339,1552,0,0,1,2
10373340,10373391,51,1,0,0,2
10373341,10373396,55,1,0,0,1
10373392,10373498,106,0,0,1,2
10373397,10373498,101,0,0,1,1
10373499,10373522,23,1,0,0,1
10373499,10373523,24,1,0,0,2
10373523,10373684,161,0,0,1,1
10373524,10373685,161,0,0,1,2
10373685,10373702,17,1,0,0,1
10373686,10373702,16,1,0,0,2
10373703,10373823,120,0,0,1,2
10373703,10373824,121,0,0,1,1
10373824,10373842,18,1,0,0,2
10373825,10373841,16,1,0,0,1
10373842,10374778,936,0,0,1,1
10373843,10374778,935,0,0,1,2
10374779,10374850,71,1,0,0,2
10374779,10374852,73,1,0,0,1
10374851,10374981,130,0,0,1,2
10374853,10374981,128,0,0,1,1
10374982,10375005,23,1,0,0,2
10374982,10375006,24,1,0,0,1
10375006,10376854,1848,0,0,1,2
10375007,10376847,1840,0,0,1,1
10376848,10377197,349,1,0,0,1
10376855,10377204,349,1,0,0,2
10376870,10377149,279,0,1,0,1
10376878,10377144,266,0,1,0,2
10377198,10377543,345,0,0,1,1
10377205,10377543,338,0,0,1,2
10377544,10377572,28,1,0,0,1
10377544,10377573,29,1,0,0,2
10377573,10378381,808,0,0,1,1
10377574,10378381,807,0,0,1,2
10378382,10378452,70,1,0,0,2
10378382,10378453,71,1,0,0,1
10378453,10378550,97,0,0,1,2
10378454,10378549,95,0,0,1,1
10378550,10378571,21,1,0,0,1
10378551,10378571,20,1,0,0,2
10378572,10378703,131,0,0,1,1
10378572,10378703,131,0,0,1,2
10378704,10378719,15,1,0,0,2
10378704,10378720,16,1,0,0,1
10378720,10380251,1531,0,0,1,2
10378721,10378891,170,0,0,1,1
10378892,10378896,4,1,0,0,1
10378897,10380250,1353,0,0,1,1
10380251,10380321,70,1,0,0,1
10380252,10380314,62,1,0,0,2
10380315,10380471,156,0,0,1,2
10380322,10380470,148,0,0,1,1
10380471,10380491,20,1,0,0,1
10380472,10380491,19,1,0,0,2
10380492,10380688,196,0,0,1,1
10380492,10380689,197,0,0,1,2
10380689,10380708,19,1,0,0,1
10380690,10380709,19,1,0,0,2
10380709,10384360,3651,0,0,1,1
10380710,10384360,3650,0,0,1,2
10384361,10384434,73,1,0,0,1
10384361,10384442,81,1,0,0,2
10384435,10384545,110,0,0,1,1
10384443,10384546,103,0,0,1,2
10384546,10384567,21,1,0,0,1
10384547,10384574,27,1,0,0,2
10384568,10384732,164,0,0,1,1
10384575,10386384,1809,0,0,1,2
10384733,10384737,4,1,0,0,1
10384738,10386381,1643,0,0,1,1
10386382,10386451,69,1,0,0,1
10386385,10386450,65,1,0,0,2
10386451,10389205,2754,0,0,1,2
10386452,10389204,2752,0,0,1,1
10389205,10389471,266,1,0,0,1
10389206,10389482,276,1,0,0,2
10389237,10389429,192,0,1,0,1
10389242,10389412,170,0,1,0,2
10389472,10390430,958,0,0,1,1
10389483,10390430,947,0,0,1,2
10390431,10390508,77,1,0,0,1
10390431,10390517,86,1,0,0,2
10390509,10390613,104,0,0,1,1
10390518,10390614,96,0,0,1,2
10390614,10390647,33,1,0,0,1
10390615,10390651,36,1,0,0,2
10390648,10391919,1271,0,0,1,1
10390652,10391923,1271,0,0,1,2
10391920,10391994,74,1,0,0,1
10391924,10391994,70,1,0,0,2
10391995,10392232,237,0,0,1,1
10391995,10392234,239,0,0,1,2
10392233,10392258,25,1,0,0,1
10392235,10392257,22,1,0,0,2
10392258,10394935,2677,0,0,1,2
10392259,10394935,2676,0,0,1,1
10394936,10394994,58,1,0,0,1
10394936,10394995,59,1,0,0,2
10394995,10395470,475,0,0,1,1
10394996,10395470,474,0,0,1,2
10395471,10395526,55,1,0,0,1
10395471,10395526,55,1,0,0,2
10395527,10395683,156,0,0,1,2
10395527,10395684,157,0,0,1,1
10395684,10395705,21,1,0,0,2
10395685,10395711,26,1,0,0,1
10395706,10396663,957,0,0,1,2
10395712,10396663,951,0,0,1,1
10396664,10396702,38,1,0,0,1
10396664,10396704,40,1,0,0,2
10396703,10399438,2735,0,0,1,1
10396705,10399439,2734,0,0,1,2
10399439,10399465,26,1,0,0,1
10399440,10399462,22,1,0,0,2
10399463,10400108,645,0,0,1,2
10399466,10400108,642,0,0,1,1
10400109,10400154,45,1,0,0,1
10400109,10400155,46,1,0,0,2
10400155,10400323,168,0,0,1,1
10400156,10400324,168,0,0,1,2
10400324,10400344,20,1,0,0,1
10400325,10400344,19,1,0,0,2
10400345,10401404,1059,0,0,1,1
10400345,10401404,1059,0,0,1,2
10401405,10401449,44,1,0,0,1
10401405,10401457,52,1,0,0,2
10401450,10404781,3331,0,0,1,1
10401458,10404781,3323,0,0,1,2
10404782,10404860,78,1,0,0,2
10404782,10404868,86,1,0,0,1
10404861,10404976,115,0,0,1,2
10404869,10404976,107,0,0,1,1
10404977,10405007,30,1,0,0,1
10404977,10405007,30,1,0,0,2
10405008,10405120,112,0,0,1,1
10405008,10405120,112,0,0,1,2
10405121,10405140,19,1,0,0,2
10405121,10405146,25,1,0,0,1
10405141,10406267,1126,0,0,1,2
10405147,10406265,1118,0,0,1,1
10406266,10406309,43,1,0,0,1
10406268,10406308,40,1,0,0,2
10406309,10406468,159,0,0,1,2
10406310,10406469,159,0,0,1,1
10406469,10406492,23,1,0,0,2
10406470,10406492,22,1,0,0,1
10406493,10407760,1267,0,0,1,1
10406493,10407761,1268,0,0,1,2
10407761,10407777,16,1,0,0,1
10407762,10407779,17,1,0,0,2
10407778,10408283,505,0,0,1,1
10407780,10408284,504,0,0,1,2
10408284,10408687,403,1,0,0,1
10408285,10408686,401,1,0,0,2
10408304,10408676,372,0,1,0,1
10408320,10408582,262,0,1,0,2
10408687,10408970,283,0,0,1,2
10408688,10408970,282,0,0,1,1
10408971,10408994,23,1,0,0,2
10408971,10409004,33,1,0,0,1
10408995,10409917,922,0,0,1,2
10409005,10409917,912,0,0,1,1
10409918,10410005,87,1,0,0,1
10409918,10410017,99,1,0,0,2
10410006,10410381,375,0,0,1,1
10410018,10410178,160,0,0,1,2
10410179,10410183,4,1,0,0,2
10410184,10410380,196,0,0,1,2
10410381,10410394,13,1,0,0,2
10410382,10410387,5,1,0,0,1
10410388,10410776,388,0,0,1,1
10410395,10410769,374,0,0,1,2
10410770,10410782,12,1,0,0,2
10410777,10410782,5,1,0,0,1
10410783,10411131,348,0,0,1,1
10410783,10411131,348,0,0,1,2
10411132,10411199,67,1,0,0,1
10411132,10411203,71,1,0,0,2
10411200,10411900,700,0,0,1,1
10411204,10411897,693,0,0,1,2
10411898,10411909,11,1,0,0,2
10411901,10411916,15,1,0,0,1
10411910,10413306,1396,0,0,1,2
10411917,10413308,1391,0,0,1,1
10413307,10413322,15,1,0,0,2
10413309,10413322,13,1,0,0,1
10413323,10413476,153,0,0,1,1
10413323,10413476,153,0,0,1,2
10413477,10413813,336,1,0,0,2
10413477,10413880,403,1,0,0,1
10413514,10413782,268,0,1,0,1
10413533,10413776,243,0,1,0,2
10413814,10413917,103,0,0,1,2
10413881,10413916,35,0,0,1,1
10413917,10413952,35,1,0,0,1
10413918,10413954,36,1,0,0,2
10413953,10414131,178,0,0,1,1
10413955,10414129,174,0,0,1,2
10414130,10414197,67,1,0,0,2
10414132,10414189,57,1,0,0,1
10414190,10414353,163,0,0,1,1
10414198,10414354,156,0,0,1,2
10414354,10414405,51,1,0,0,1
10414355,10414413,58,1,0,0,2
10414406,10415124,718,0,0,1,1
10414414,10415124,710,0,0,1,2
10415125,10415146,21,1,0,0,1
10415125,10415152,27,1,0,0,2
10415147,10415479,332,0,0,1,1
10415153,10415477,324,0,0,1,2
10415478,10415489,11,1,0,0,2
10415480,10415491,11,1,0,0,1
10415490,10415536,46,0,0,1,2
10415492,10415536,44,0,0,1,1
10464326,10464891,565,0,0,1,2
10464326,10464892,566,0,0,1,1
10464892,10464916,24,1,0,0,2
10464893,10464908,15,1,0,0,1
10464909,10465733,824,0,0,1,1
10464917,10465734,817,0,0,1,2
10465734,10465759,25,1,0,0,1
10465735,10465759,24,1,0,0,2
10465760,10466119,359,0,0,1,1
10465760,10466119,359,0,0,1,2
10466120,10466131,11,1,0,0,1
10466120,10466132,12,1,0,0,2
10466132,10466926,794,0,0,1,1
10466133,10466925,792,0,0,1,2
10466926,10467016,90,1,0,0,2
10466927,10467011,84,1,0,0,1
10467012,10467108,96,0,0,1,1
10467017,10467106,89,0,0,1,2
10467107,10467141,34,1,0,0,2
10467109,10467137,28,1,0,0,1
10467138,10467270,132,0,0,1,1
10467142,10467271,129,0,0,1,2
10467271,10467287,16,1,0,0,1
10467272,10467288,16,1,0,0,2
10467288,10467546,258,0,0,1,1
10467289,10467551,262,0,0,1,2
10467547,10467571,24,1,0,0,1
10467552,10467572,20,1,0,0,2
10467572,10467713,141,0,0,1,1
10467573,10467713,140,0,0,1,2
10467714,10467732,18,1,0,0,1
10467714,10467745,31,1,0,0,2
10467733,10468622,889,0,0,1,1
10467746,10468622,876,0,0,1,2
10468623,10468729,106,1,0,0,1
10468623,10468731,108,1,0,0,2
10468730,10468902,172,0,0,1,1
10468732,10468899,167,0,0,1,2
10468900,10468919,19,1,0,0,2
10468903,10468920,17,1,0,0,1
10468920,10470453,1533,0,0,1,2
10468921,10469301,380,0,0,1,1
10469302,10469316,14,1,0,0,1
10469317,10470453,1136,0,0,1,1
10470454,10470548,94,1,0,0,2
10470454,10470556,102,1,0,0,1
10470549,10470640,91,0,0,1,2
10470557,10470641,84,0,0,1,1
10470641,10470680,39,1,0,0,2
10470642,10470665,23,1,0,0,1
10470666,10470857,191,0,0,1,1
10470681,10472205,1524,0,0,1,2
10470858,10470868,10,1,0,0,1
10470869,10472207,1338,0,0,1,1
10472206,10472263,57,1,0,0,2
10472208,10472264,56,1,0,0,1
10472264,10472393,129,0,0,1,2
10472265,10472392,127,0,0,1,1
10472393,10472413,20,1,0,0,1
10472394,10472413,19,1,0,0,2
10472414,10473905,1491,0,0,1,1
10472414,10473906,1492,0,0,1,2
10473906,10473983,77,1,0,0,1
10473907,10473982,75,1,0,0,2
10473983,10474080,97,0,0,1,2
10473984,10474080,96,0,0,1,1
10474081,10474104,23,1,0,0,2
10474081,10474111,30,1,0,0,1
10474105,10475606,1501,0,0,1,2
10474112,10475607,1495,0,0,1,1
10475607,10475661,54,1,0,0,2
10475608,10475672,64,1,0,0,1
10475662,10475785,123,0,0,1,2
10475673,10475789,116,0,0,1,1
10475786,10475804,18,1,0,0,2
10475790,10475807,17,1,0,0,1
10475805,10477451,1646,0,0,1,2
10475808,10477450,1642,0,0,1,1
10477451,10477554,103,1,0,0,1
10477452,10477563,111,1,0,0,2
10477555,10477650,95,0,0,1,1
10477564,10477651,87,0,0,1,2
10477651,10477688,37,1,0,0,1
10477652,10477688,36,1,0,0,2
10477689,10477858,169,0,0,1,2
10477689,10477859,170,0,0,1,1
10477859,10477878,19,1,0,0,2
10477860,10477877,17,1,0,0,1
10477878,10479366,1488,0,0,1,1
10477879,10479366,1487,0,0,1,2
10479367,10479443,76,1,0,0,1
10479367,10479444,77,1,0,0,2
10479444,10479533,89,0,0,1,1
10479445,10479533,88,0,0,1,2
10479534,10479571,37,1,0,0,1
10479534,10479578,44,1,0,0,2
10479572,10479771,199,0,0,1,1
10479579,10479771,192,0,0,1,2
10479772,10479783,11,1,0,0,1
10479772,10479785,13,1,0,0,2
10479784,10481174,1390,0,0,1,1
10479786,10480947,1161,0,0,1,2
10480948,10480954,6,1,0,0,2
10480955,10481174,219,0,0,1,2
10481175,10481215,40,1,0,0,1
10481175,10481222,47,1,0,0,2
10481216,10481543,327,0,0,1,1
10481223,10481542,319,0,0,1,2
10481543,10481589,46,1,0,0,2
10481544,10481590,46,1,0,0,1
10481590,10481702,112,0,0,1,2
10481591,10481701,110,0,0,1,1
10481702,10481721,19,1,0,0,1
10481703,10481722,19,1,0,0,2
10481722,10483340,1618,0,0,1,1
10481723,10481950,227,0,0,1,2
10481951,10481975,24,1,0,0,2
10481976,10483342,1366,0,0,1,2
10483341,10483408,67,1,0,0,1
10483343,10483406,63,1,0,0,2
10483407,10483515,108,0,0,1,2
10483409,10483516,107,0,0,1,1
10483516,10483548,32,1,0,0,2
10483517,10483539,22,1,0,0,1
10483540,10483689,149,0,0,1,1
10483549,10483688,139,0,0,1,2
10483689,10483704,15,1,0,0,2
10483690,10483704,14,1,0,0,1
10483705,10485112,1407,0,0,1,2
10483705,10485114,1409,0,0,1,1
10485113,10485215,102,1,0,0,2
10485115,10485216,101,1,0,0,1
10485216,10485355,139,0,0,1,2
10485217,10485355,138,0,0,1,1
10485356,10485379,23,1,0,0,1
10485356,10485380,24,1,0,0,2
10485380,10485562,182,0,0,1,1
10485381,10485561,180,0,0,1,2
10485562,10485577,15,1,0,0,2
10485563,10485585,22,1,0,0,1
10485578,10485695,117,0,0,1,2
10485586,10485695,109,0,0,1,1
10485696,10485708,12,1,0,0,1
10485696,10485708,12,1,0,0,2
10485709,10486866,1157,0,0,1,1
10485709,10486866,1157,0,0,1,2
10486867,10486923,56,1,0,0,1
10486867,10486932,65,1,0,0,2
10486924,10486972,48,0,0,1,1
10486933,10486972,39,0,0,1,2
10486973,10487027,54,1,0,0,2
10486973,10487029,56,1,0,0,1
10487028,10487094,66,0,0,1,2
10487030,10487095,65,0,0,1,1
10487095,10487136,41,1,0,0,2
10487096,10487145,49,1,0,0,1
10487137,10487259,122,0,0,1,2
10487146,10487259,113,0,0,1,1
10487260,10487279,19,1,0,0,2
10487260,10487293,33,1,0,0,1
10487280,10488798,1518,0,0,1,2
10487294,10487884,590,0,0,1,1
10487885,10487896,11,1,0,0,1
10487897,10488799,902,0,0,1,1
10488799,10488897,98,1,0,0,2
10488800,10488886,86,1,0,0,1
10488887,10488990,103,0,0,1,1
10488898,10488989,91,0,0,1,2
10488990,10489008,18,1,0,0,2
10488991,10489009,18,1,0,0,1
10489009,10489202,193,0,0,1,2
10489010,10489197,187,0,0,1,1
10489198,10489208,10,1,0,0,1
10489203,10489213,10,1,0,0,2
10489209,10489773,564,0,0,1,1
10489214,10489773,559,0,0,1,2
10489774,10489783,9,1,0,0,2
10489774,10489785,11,1,0,0,1
10489784,10490298,514,0,0,1,2
10489786,10490299,513,0,0,1,1
10490299,10490342,43,1,0,0,2
10490300,10490341,41,1,0,0,1
10490342,10490720,378,0,0,1,1
10490343,10490719,376,0,0,1,2
10490720,10490762,42,1,0,0,2
10490721,10490759,38,1,0,0,1
10490760,10490925,165,0,0,1,1
10490763,10490925,162,0,0,1,2
10490926,10490943,17,1,0,0,1
10490926,10490946,20,1,0,0,2
10490944,10492265,1321,0,0,1,1
10490947,10492264,1317,0,0,1,2
10492265,10492293,28,1,0,0,2
10492266,10492293,27,1,0,0,1
10492294,10492379,85,0,0,1,1
10492294,10492379,85,0,0,1,2
10492380,10492447,67,1,0,0,1
10492380,10492479,99,1,0,0,2
10492448,10492526,78,0,0,1,1
10492480,10492524,44,0,0,1,2
10492525,10492562,37,1,0,0,2
10492527,10492552,25,1,0,0,1
10492553,10492749,196,0,0,1,1
10492563,10492746,183,0,0,1,2
10492747,10492766,19,1,0,0,2
10492750,10492766,16,1,0,0,1
10492767,10493058,291,0,0,1,1
10492767,10494265,1498,0,0,1,2
10493059,10493063,4,1,0,0,1
10493064,10494265,1201,0,0,1,1
10494266,10494348,82,1,0,0,1
10494266,10494348,82,1,0,0,2
10494349,10494424,75,0,0,1,1
10494349,10494424,75,0,0,1,2
10494425,10494466,41,1,0,0,1
10494425,10494466,41,1,0,0,2
10494467,10494614,147,0,0,1,2
10494467,10494619,152,0,0,1,1
10494615,10494631,16,1,0,0,2
10494620,10494632,12,1,0,0,1
10494632,10496061,1429,0,0,1,2
10494633,10496062,1429,0,0,1,1
10496062,10496151,89,1,0,0,2
10496063,10496161,98,1,0,0,1
10496152,10496238,86,0,0,1,2
10496162,10496237,75,0,0,1,1
10496238,10496281,43,1,0,0,1
10496239,10496264,25,1,0,0,2
10496265,10496390,125,0,0,1,2
10496282,10496391,109,0,0,1,1
10496391,10496411,20,1,0,0,2
10496392,10496409,17,1,0,0,1
10496410,10496995,585,0,0,1,1
10496412,10496996,584,0,0,1,2
10496996,10497008,12,1,0,0,1
10496997,10497007,10,1,0,0,2
10497008,10497905,897,0,0,1,2
10497009,10497904,895,0,0,1,1
10497905,10497977,72,1,0,0,1
10497906,10497965,59,1,0,0,2
10497966,10498094,128,0,0,1,2
10497978,10498094,116,0,0,1,1
10498095,10498118,23,1,0,0,2
10498095,10498126,31,1,0,0,1
10498119,10498285,166,0,0,1,2
10498127,10498281,154,0,0,1,1
10498282,10498301,19,1,0,0,1
10498286,10498298,12,1,0,0,2
10498299,10499798,1499,0,0,1,2
10498302,10499797,1495,0,0,1,1
10499798,10500383,585,1,0,0,1
10499799,10500327,528,1,0,0,2
10499846,10500365,519,0,1,0,1
10499851,10500269,418,0,1,0,2
10500328,10501482,1154,0,0,1,2
10500384,10501477,1093,0,0,1,1
10501478,10501498,20,1,0,0,1
10501483,10501493,10,1,0,0,2
10501494,10501827,333,0,0,1,2
10501499,10501828,329,0,0,1,1
10501828,10501943,115,1,0,0,2
10501829,10501915,86,1,0,0,1
10501916,10502009,93,0,0,1,1
10501944,10502009,65,0,0,1,2
10502010,10502037,27,1,0,0,2
10502010,10502038,28,1,0,0,1
10502038,10503816,1778,0,0,1,2
10502039,10503815,1776,0,0,1,1
10503816,10503905,89,1,0,0,1
10503817,10503912,95,1,0,0,2
10503906,10503986,80,0,0,1,1
10503913,10503983,70,0,0,1,2
10503984,10504027,43,1,0,0,2
10503987,10504027,40,1,0,0,1
10504028,10504136,108,0,0,1,2
10504028,10504137,109,0,0,1,1
10504137,10504157,20,1,0,0,2
10504138,10504156,18,1,0,0,1
10504157,10505526,1369,0,0,1,1
10504158,10505525,1367,0,0,1,2
10505526,10505605,79,1,0,0,2
10505527,10505604,77,1,0,0,1
10505605,10505747,142,0,0,1,1
10505606,10505747,141,0,0,1,2
10505748,10505802,54,1,0,0,1
10505748,10505804,56,1,0,0,2
10505803,10505895,92,0,0,1,1
10505805,10505895,90,0,0,1,2
10505896,10505919,23,1,0,0,2
10505896,10505920,24,1,0,0,1
10505920,10506323,403,0,0,1,2
10505921,10507194,1273,0,0,1,1
10506324,10506328,4,1,0,0,2
10506329,10507193,864,0,0,1,2
10507194,10507251,57,1,0,0,2
10507195,10507250,55,1,0,0,1
10507251,10507640,389,0,0,1,1
10507252,10507639,387,0,0,1,2
10507640,10507715,75,1,0,0,2
10507641,10507725,84,1,0,0,1
10507716,10507831,115,0,0,1,2
10507726,10507830,104,0,0,1,1
10507831,10507865,34,1,0,0,1
10507832,10507864,32,1,0,0,2
10507865,10509024,1159,0,0,1,2
10507866,10509024,1158,0,0,1,1
10509025,10509106,81,1,0,0,1
10509025,10509110,85,1,0,0,2
10509107,10509426,319,0,0,1,1
10509111,10509427,316,0,0,1,2
10509427,10509503,76,1,0,0,1
10509428,10509510,82,1,0,0,2
10509504,10509577,73,0,0,1,1
10509511,10509577,66,0,0,1,2
10509578,10509608,30,1,0,0,1
10509578,10509610,32,1,0,0,2
10509609,10509777,168,0,0,1,1
10509611,10509772,161,0,0,1,2
10509773,10509791,18,1,0,0,2
10509778,10509792,14,1,0,0,1
10509792,10511512,1720,0,0,1,2
10509793,10511513,1720,0,0,1,1
10511513,10511632,119,1,0,0,2
10511514,10511642,128,1,0,0,1
10511633,10511732,99,0,0,1,2
10511643,10511734,91,0,0,1,1
10511733,10511777,44,1,0,0,2
10511735,10511782,47,1,0,0,1
10511778,10511903,125,0,0,1,2
10511783,10511903,120,0,0,1,1
10511904,10511922,18,1,0,0,2
10511904,10511925,21,1,0,0,1
10511923,10512188,265,0,0,1,2
10511926,10512191,265,0,0,1,1
10512189,10512210,21,1,0,0,2
10512192,10512210,18,1,0,0,1
10512211,10513326,1115,0,0,1,1
10512211,10513326,1115,0,0,1,2
10513327,10513393,66,1,0,0,1
10513327,10513405,78,1,0,0,2
10513394,10513505,111,0,0,1,1
10513406,10513505,99,0,0,1,2
10513506,10513591,85,1,0,0,2
10513506,10513592,86,1,0,0,1
10513592,10513697,105,0,0,1,2
10513593,10513698,105,0,0,1,1
10513698,10513723,25,1,0,0,2
10513699,10513723,24,1,0,0,1
10513724,10515335,1611,0,0,1,1
10513724,10515335,1611,0,0,1,2
10515336,10515402,66,1,0,0,2
10515336,10515403,67,1,0,0,1
10515403,10515459,56,0,0,1,2
10515404,10515459,55,0,0,1,1
10515460,10515522,62,1,0,0,1
10515460,10515539,79,1,0,0,2
10515523,10515633,110,0,0,1,1
10515540,10515633,93,0,0,1,2
10515634,10515658,24,1,0,0,1
10515634,10515658,24,1,0,0,2
10515659,10517308,1649,0,0,1,1
10515659,10517308,1649,0,0,1,2
10517309,10517384,75,1,0,0,1
10517309,10517390,81,1,0,0,2
10517385,10517483,98,0,0,1,1
10517391,10517484,93,0,0,1,2
10517484,10517516,32,1,0,0,1
10517485,10517514,29,1,0,0,2
10517515,10517669,154,0,0,1,2
10517517,10517669,152,0,0,1,1
10517670,10517688,18,1,0,0,1
10517670,10517688,18,1,0,0,2
10517689,10519265,1576,0,0,1,1
10517689,10519265,1576,0,0,1,2
10519266,10519409,143,1,0,0,1
10519266,10519409,143,1,0,0,2
10519410,10519512,102,0,0,1,1
10519410,10519513,103,0,0,1,2
10519513,10519555,42,1,0,0,1
10519514,10519544,30,1,0,0,2
10519545,10519871,326,0,0,1,2
10519556,10519870,314,0,0,1,1
10519871,10519875,4,1,0,0,1
10519872,10519882,10,1,0,0,2
10519876,10520056,180,0,0,1,1
10519883,10520056,173,0,0,1,2
10520057,10520068,11,1,0,0,1
10520057,10520069,12,1,0,0,2
10520069,10521359,1290,0,0,1,1
10520070,10520747,677,0,0,1,2
10520748,10520752,4,1,0,0,2
10520753,10521358,605,0,0,1,2
10521359,10521452,93,1,0,0,2
10521360,10521445,85,1,0,0,1
10521446,10521551,105,0,0,1,1
10521453,10521551,98,0,0,1,2
10521552,10521576,24,1,0,0,2
10521552,10521577,25,1,0,0,1
10521577,10521761,184,0,0,1,2
10521578,10521762,184,0,0,1,1
10521762,10521775,13,1,0,0,2
10521763,10521774,11,1,0,0,1
10521775,10522825,1050,0,0,1,1
10521776,10522825,1049,0,0,1,2
10522826,10522866,40,1,0,0,1
10522826,10522876,50,1,0,0,2
10522867,10523265,398,0,0,1,1
10522877,10523265,388,0,0,1,2
10523266,10523351,85,1,0,0,1
10523266,10523351,85,1,0,0,2
10523352,10523755,403,0,0,1,1
10523352,10523755,403,0,0,1,2
10523756,10523766,10,1,0,0,2
10523756,10523767,11,1,0,0,1
10523767,10525204,1437,0,0,1,2
10523768,10525205,1437,0,0,1,1
10525205,10525273,68,1,0,0,2
10525206,10525272,66,1,0,0,1
10525273,10525460,187,0,0,1,1
10525274,10525993,719,0,0,1,2
10525461,10525472,11,1,0,0,1
10525473,10525987,514,0,0,1,1
10525988,10525998,10,1,0,0,1
10525994,10525998,4,1,0,0,2
10525999,10526837,838,0,0,1,1
10525999,10526838,839,0,0,1,2
10526838,10526930,92,1,0,0,1
10526839,10526921,82,1,0,0,2
10526922,10527052,130,0,0,1,2
10526931,10527052,121,0,0,1,1
10527053,10527073,20,1,0,0,2
10527053,10527076,23,1,0,0,1
10527074,10528673,1599,0,0,1,2
10527077,10528674,1597,0,0,1,1
10528674,10528786,112,1,0,0,2
10528675,10528783,108,1,0,0,1
10528784,10528924,140,0,0,1,1
10528787,10528922,135,0,0,1,2
10528923,10528947,24,1,0,0,2
10528925,10528953,28,1,0,0,1
10528948,10529315,367,0,0,1,2
10528954,10529319,365,0,0,1,1
10529316,10529332,16,1,0,0,2
10529320,10529331,11,1,0,0,1
10529332,10529437,105,0,0,1,1
10529333,10529442,109,0,0,1,2
10529438,10529458,20,1,0,0,1
10529443,10529460,17,1,0,0,2
10529459,10529731,272,0,0,1,1
10529461,10530525,1064,0,0,1,2
10529732,10529745,13,1,0,0,1
10529746,10530524,778,0,0,1,1
10530525,10530629,104,1,0,0,1
10530526,10530625,99,1,0,0,2
10530626,10530743,117,0,0,1,2
10530630,10530743,113,0,0,1,1
10530744,10530767,23,1,0,0,2
10530744,10530778,34,1,0,0,1
10530768,10532411,1643,0,0,1,2
10530779,10532413,1634,0,0,1,1
10532412,10532570,158,1,0,0,2
10532414,10532555,141,1,0,0,1
10532556,10532627,71,0,0,1,1
10532571,10532628,57,0,0,1,2
10532628,10532675,47,1,0,0,1
10532629,10532674,45,1,0,0,2
10532675,10532720,45,0,0,1,2
10532676,10532828,152,0,0,1,1
10532721,10532741,20,1,0,0,2
10532742,10532826,84,0,0,1,2
10532827,10532849,22,1,0,0,2
10532829,10532849,20,1,0,0,1
10532850,10533394,544,0,0,1,1
10532850,10533394,544,0,0,1,2
10533395,10533405,10,1,0,0,1
10533395,10533405,10,1,0,0,2
10533406,10534456,1050,0,0,1,1
10533406,10534456,1050,0,0,1,2
10534457,10534563,106,1,0,0,1
10534457,10534575,118,1,0,0,2
10534564,10534652,88,0,0,1,1
10534576,10534652,76,0,0,1,2
10534653,10534691,38,1,0,0,1
10534653,10534701,48,1,0,0,2
10534692,10534862,170,0,0,1,1
10534702,10534867,165,0,0,1,2
10534863,10534882,19,1,0,0,1
10534868,10534883,15,1,0,0,2
10534883,10535184,301,0,0,1,1
10534884,10535181,297,0,0,1,2
10535182,10535207,25,1,0,0,2
10535185,10535195,10,1,0,0,1
10535196,10536380,1184,0,0,1,1
10535208,10536379,1171,0,0,1,2
10536380,10536472,92,1,0,0,2
10536381,10536473,92,1,0,0,1
10536473,10536547,74,0,0,1,2
10536474,10536548,74,0,0,1,1
10536548,10536587,39,1,0,0,2
10536549,10536585,36,1,0,0,1
10536586,10536775,189,0,0,1,1
10536588,10536775,187,0,0,1,2
10536776,10536792,16,1,0,0,1
10536776,10536792,16,1,0,0,2
10536793,10536955,162,0,0,1,1
10536793,10536955,162,0,0,1,2
10536956,10536966,10,1,0,0,1
10536956,10536966,10,1,0,0,2
10536967,10538192,1225,0,0,1,1
10536967,10538193,1226,0,0,1,2
10538193,10538261,68,1,0,0,1
10538194,10538275,81,1,0,0,2
10538262,10538359,97,0,0,1,1
10538276,10538360,84,0,0,1,2
10538360,10538393,33,1,0,0,1
10538361,10538396,35,1,0,0,2
10538394,10538724,330,0,0,1,1
10538397,10538732,335,0,0,1,2
10538725,10538729,4,1,0,0,1
10538730,10540031,1301,0,0,1,1
10538733,10538737,4,1,0,0,2
10538738,10540031,1293,0,0,1,2
10540032,10540196,164,1,0,0,2
10540032,10540199,167,1,0,0,1
10540197,10540283,86,0,0,1,2
10540200,10540283,83,0,0,1,1
10540284,10540311,27,1,0,0,2
10540284,10540315,31,1,0,0,1
10540312,10540469,157,0,0,1,2
10540316,10540475,159,0,0,1,1
10540470,10540490,20,1,0,0,2
10540476,10540486,10,1,0,0,1
10540487,10540695,208,0,0,1,1
10540491,10540695,204,0,0,1,2
10540696,10540708,12,1,0,0,1
10540696,10540709,13,1,0,0,2
10540709,10542081,1372,0,0,1,1
10540710,10542081,1371,0,0,1,2
10542082,10542171,89,1,0,0,1
10542082,10542182,100,1,0,0,2
10542172,10542270,98,0,0,1,1
10542183,10542270,87,0,0,1,2
10542271,10542307,36,1,0,0,2
10542271,10542309,38,1,0,0,1
10542308,10542501,193,0,0,1,2
10542310,10542500,190,0,0,1,1
10542501,10542514,13,1,0,0,1
10542502,10542513,11,1,0,0,2
10542514,10543410,896,0,0,1,2
10542515,10543411,896,0,0,1,1
10543411,10543476,65,1,0,0,2
10543412,10543468,56,1,0,0,1
10543469,10543796,327,0,0,1,1
10543477,10543795,318,0,0,1,2
10543796,10543857,61,1,0,0,2
10543797,10543856,59,1,0,0,1
10543857,10543935,78,0,0,1,1
10543858,10543935,77,0,0,1,2
10543936,10543961,25,1,0,0,1
10543936,10543961,25,1,0,0,2
10543962,10544684,722,0,0,1,1
10543962,10544686,724,0,0,1,2
10544685,10544695,10,1,0,0,1
10544687,10544696,9,1,0,0,2
10544696,10546036,1340,0,0,1,1
10544697,10546035,1338,0,0,1,2
10546036,10546152,116,1,0,0,2
10546037,10546132,95,1,0,0,1
10546133,10546260,127,0,0,1,1
10546153,10546261,108,0,0,1,2
10546261,10546286,25,1,0,0,1
10546262,10546287,25,1,0,0,2
10546287,10546442,155,0,0,1,1
10546288,10546438,150,0,0,1,2
10546439,10546446,7,1,0,0,2
10546443,10546454,11,1,0,0,1
10546447,10547764,1317,0,0,1,2
10546455,10547764,1309,0,0,1,1
10547765,10547830,65,1,0,0,1
10547765,10547831,66,1,0,0,2
10547831,10547965,134,0,0,1,1
10547832,10547966,134,0,0,1,2
10547966,10548047,81,1,0,0,1
10547967,10548048,81,1,0,0,2
10548048,10548155,107,0,0,1,1
10548049,10548155,106,0,0,1,2
10548156,10548178,22,1,0,0,1
10548156,10548188,32,1,0,0,2
10548179,10549395,1216,0,0,1,1
10548189,10549394,1205,0,0,1,2
10549395,10549454,59,1,0,0,2
10549396,10549453,57,1,0,0,1
10549454,10549826,372,0,0,1,1
10549455,10549827,372,0,0,1,2
10549827,10549906,79,1,0,0,1
10549828,10549904,76,1,0,0,2
10549905,10550055,150,0,0,1,2
10549907,10550057,150,0,0,1,1
10550056,10550074,18,1,0,0,2
10550058,10550077,19,1,0,0,1
10550075,10551681,1606,0,0,1,2
10550078,10551680,1602,0,0,1,1
10551681,10551784,103,1,0,0,1
10551682,10551784,102,1,0,0,2
10551785,10551855,70,0,0,1,2
10551785,10551856,71,0,0,1,1
10551856,10551902,46,1,0,0,2
10551857,10551902,45,1,0,0,1
10551903,10552035,132,0,0,1,1
10551903,10552035,132,0,0,1,2
10552036,10552053,17,1,0,0,1
10552036,10552055,19,1,0,0,2
10552054,10553645,1591,0,0,1,1
10552056,10553646,1590,0,0,1,2
10553646,10553728,82,1,0,0,1
10553647,10553729,82,1,0,0,2
10553729,10553869,140,0,0,1,1
10553730,10553868,138,0,0,1,2
10553869,10553887,18,1,0,0,2
10553870,10553888,18,1,0,0,1
10553888,10555153,1265,0,0,1,2
10553889,10554263,374,0,0,1,1
10554264,10554274,10,1,0,0,1
10554275,10555154,879,0,0,1,1
10555154,10555218,64,1,0,0,2
10555155,10555216,61,1,0,0,1
10555217,10555443,226,0,0,1,1
10555219,10555443,224,0,0,1,2
10555444,10555496,52,1,0,0,1
10555444,10555504,60,1,0,0,2
10555497,10555594,97,0,0,1,1
10555505,10555594,89,0,0,1,2
10555595,10555625,30,1,0,0,1
10555595,10555625,30,1,0,0,2
10555626,10556831,1205,0,0,1,1
10555626,10556836,1210,0,0,1,2
10556832,10557051,219,1,0,0,1
10556837,10557050,213,1,0,0,2
10556859,10557022,163,0,1,0,1
10556871,10557006,135,0,1,0,2
10557051,10557394,343,0,0,1,2
10557052,10557394,342,0,0,1,1
10557395,10557458,63,1,0,0,1
10557395,10557467,72,1,0,0,2
10557459,10557489,30,0,0,1,1
10557468,10557488,20,0,0,1,2
10557489,10557563,74,1,0,0,2
10557490,10557563,73,1,0,0,1
10557564,10557672,108,0,0,1,1
10557564,10557673,109,0,0,1,2
10557673,10557702,29,1,0,0,1
10557674,10557702,28,1,0,0,2
10557703,10557837,134,0,0,1,2
10557703,10557839,136,0,0,1,1
10557838,10557862,24,1,0,0,2
10557840,10557856,16,1,0,0,1
10557857,10559324,1467,0,0,1,1
10557863,10559324,1461,0,0,1,2
10559325,10559376,51,1,0,0,1
10559325,10559376,51,1,0,0,2
10559377,10559473,96,0,0,1,2
10559377,10559475,98,0,0,1,1
10559474,10559508,34,1,0,0,2
10559476,10559498,22,1,0,0,1
10559499,10561624,2125,0,0,1,1
10559509,10561623,2114,0,0,1,2
10561624,10561835,211,1,0,0,2
10561625,10561844,219,1,0,0,1
10561657,10561794,137,0,1,0,1
10561662,10561762,100,0,1,0,2
10561836,10563101,1265,0,0,1,2
10561845,10563100,1255,0,0,1,1
10563101,10563176,75,1,0,0,1
10563102,10563189,87,1,0,0,2
10563177,10563281,104,0,0,1,1
10563190,10563282,92,0,0,1,2
10563282,10563305,23,1,0,0,1
10563283,10563306,23,1,0,0,2
10563306,10563465,159,0,0,1,1
10563307,10563810,503,0,0,1,2
10563466,10563481,15,1,0,0,1
10563482,10564487,1005,0,0,1,1
10563811,10563821,10,1,0,0,2
10563822,10564487,665,0,0,1,2
10564488,10564554,66,1,0,0,2
10564488,10564555,67,1,0,0,1
10564555,10566485,1930,0,0,1,2
10564556,10566480,1924,0,0,1,1
10566481,10566918,437,1,0,0,1
10566486,10566684,198,1,0,0,2
10566505,10566667,162,0,1,0,1
10566518,10566633,115,0,1,0,2
10566685,10566727,42,0,0,1,2
10566728,10566920,192,1,0,0,2
10566743,10566898,155,0,1,0,1
10566757,10566867,110,0,1,0,2
10566919,10567090,171,0,0,1,1
10566921,10567089,168,0,0,1,2
10567090,10567150,60,1,0,0,2
10567091,10567142,51,1,0,0,1
10567143,10567972,829,0,0,1,1
10567151,10567971,820,0,0,1,2
10567972,10568040,68,1,0,0,2
10567973,10568049,76,1,0,0,1
10568041,10568157,116,0,0,1,2
10568050,10568157,107,0,0,1,1
10568158,10568187,29,1,0,0,1
10568158,10568189,31,1,0,0,2
10568188,10568372,184,0,0,1,1
10568190,10568372,182,0,0,1,2
10568373,10568388,15,1,0,0,1
10568373,10568390,17,1,0,0,2
10568389,10568503,114,0,0,1,1
10568391,10568505,114,0,0,1,2
10568504,10568524,20,1,0,0,1
10568506,10568523,17,1,0,0,2
10568524,10569064,540,0,0,1,2
10568525,10569064,539,0,0,1,1
10569065,10569125,60,1,0,0,1
10569065,10569137,72,1,0,0,2
10569126,10569322,196,0,0,1,1
10569138,10569322,184,0,0,1,2
10569323,10569347,24,1,0,0,1
10569323,10569355,32,1,0,0,2
10569348,10571126,1778,0,0,1,1
10569356,10571114,1758,0,0,1,2
10571115,10571428,313,1,0,0,2
10571127,10571417,290,1,0,0,1
10571142,10571388,246,0,1,0,1
10571148,10571372,224,0,1,0,2
10571418,10572364,946,0,0,1,1
10571429,10572365,936,0,0,1,2
10572365,10572428,63,1,0,0,1
10572366,10572442,76,1,0,0,2
10572429,10572579,150,0,0,1,1
10572443,10573746,1303,0,0,1,2
10572580,10572590,10,1,0,0,1
10572591,10573745,1154,0,0,1,1
10573746,10573809,63,1,0,0,1
10573747,10573808,61,1,0,0,2
10573809,10574070,261,0,0,1,2
10573810,10574075,265,0,0,1,1
10574071,10574082,11,1,0,0,2
10574076,10574084,8,1,0,0,1
10574083,10576039,1956,0,0,1,2
10574085,10576031,1946,0,0,1,1
10576032,10576273,241,1,0,0,1
10576040,10576244,204,1,0,0,2
10576057,10576235,178,0,1,0,1
10576078,10576208,130,0,1,0,2
10576245,10576655,410,0,0,1,2
10576274,10576656,382,0,0,1,1
10576656,10576726,70,1,0,0,2
10576657,10576719,62,1,0,0,1
10576720,10577391,671,0,0,1,1
10576727,10577391,664,0,0,1,2
10577392,10577426,34,1,0,0,2
10577392,10577431,39,1,0,0,1
10577427,10577602,175,0,0,1,2
10577432,10577605,173,0,0,1,1
10577603,10577619,16,1,0,0,2
10577606,10577618,12,1,0,0,1
10577619,10578716,1097,0,0,1,1
10577620,10578717,1097,0,0,1,2
10578717,10578774,57,1,0,0,1
10578718,10578770,52,1,0,0,2
10578771,10579073,302,0,0,1,2
10578775,10579074,299,0,0,1,1
10579074,10579086,12,1,0,0,2
10579075,10579091,16,1,0,0,1
10579087,10580975,1888,0,0,1,2
10579092,10580962,1870,0,0,1,1
10580963,10581379,416,1,0,0,1
10580976,10581339,363,1,0,0,2
10580996,10581368,372,0,1,0,1
10581042,10581299,257,0,1,0,2
10581340,10581453,113,0,0,1,2
10581380,10581454,74,0,0,1,1
10581454,10581503,49,1,0,0,2
10581455,10581501,46,1,0,0,1
10581502,10582238,736,0,0,1,1
10581504,10582239,735,0,0,1,2
10582239,10582297,58,1,0,0,1
10582240,10582306,66,1,0,0,2
10582298,10582521,223,0,0,1,1
10582307,10582521,214,0,0,1,2
10582522,10582532,10,1,0,0,1
10582522,10582533,11,1,0,0,2
10582533,10583978,1445,0,0,1,1
10582534,10583227,693,0,0,1,2
10583228,10583246,18,1,0,0,2
10583247,10583977,730,0,0,1,2
10583978,10584038,60,1,0,0,2
10583979,10584037,58,1,0,0,1
10584038,10584292,254,0,0,1,1
10584039,10584292,253,0,0,1,2
10584293,10584313,20,1,0,0,1
10584293,10584313,20,1,0,0,2
10584314,10586362,2048,0,0,1,2
10584314,10586371,2057,0,0,1,1
10586363,10586606,243,1,0,0,2
10586372,10586609,237,1,0,0,1
10586391,10586586,195,0,1,0,1
10586394,10586563,169,0,1,0,2
10586607,10587895,1288,0,0,1,2
10586610,10587896,1286,0,0,1,1
10587896,10587984,88,1,0,0,2
10587897,10587973,76,1,0,0,1
10587974,10588090,116,0,0,1,1
10587985,10588090,105,0,0,1,2
10588091,10588115,24,1,0,0,2
10588091,10588116,25,1,0,0,1
10588116,10588323,207,0,0,1,2
10588117,10588323,206,0,0,1,1
10588324,10588340,16,1,0,0,2
10588324,10588342,18,1,0,0,1
10588341,10589608,1267,0,0,1,2
10588343,10589608,1265,0,0,1,1
10589609,10589665,56,1,0,0,1
10589609,10589673,64,1,0,0,2
10589666,10589872,206,0,0,1,1
10589674,10589870,196,0,0,1,2
10589871,10589901,30,1,0,0,2
10589873,10589892,19,1,0,0,1
10589893,10593409,3516,0,0,1,1
10589902,10593408,3506,0,0,1,2
10593409,10593511,102,1,0,0,2
10593410,10593512,102,1,0,0,1
10593512,10593600,88,0,0,1,2
10593513,10593601,88,0,0,1,1
10593601,10593643,42,1,0,0,2
10593602,10593644,42,1,0,0,1
10593644,10593736,92,0,0,1,2
10593645,10593735,90,0,0,1,1
10593736,10593761,25,1,0,0,1
10593737,10593760,23,1,0,0,2
10593761,10593906,145,0,0,1,2
10593762,10593905,143,0,0,1,1
10593906,10593923,17,1,0,0,1
10593907,10593923,16,1,0,0,2
10593924,10595569,1645,0,0,1,1
10593924,10595571,1647,0,0,1,2
10595570,10595636,66,1,0,0,1
10595572,10595633,61,1,0,0,2
10595634,10596168,534,0,0,1,2
10595637,10597918,2281,0,0,1,1
10596169,10596174,5,1,0,0,2
10596175,10597915,1740,0,0,1,2
10597916,10597933,17,1,0,0,2
10597919,10597933,14,1,0,0,1
10597934,10598200,266,0,0,1,2
10597934,10598202,268,0,0,1,1
10598201,10598220,19,1,0,0,2
10598203,10598220,17,1,0,0,1
10598221,10598431,210,0,0,1,1
10598221,10598434,213,0,0,1,2
10598432,10598688,256,1,0,0,1
10598435,10598694,259,1,0,0,2
10598458,10598670,212,0,1,0,1
10598472,10598639,167,0,1,0,2
10598689,10599620,931,0,0,1,1
10598695,10599620,925,0,0,1,2
10599621,10599685,64,1,0,0,1
10599621,10599686,65,1,0,0,2
10599686,10599798,112,0,0,1,1
10599687,10599802,115,0,0,1,2
10599799,10599815,16,1,0,0,1
10599803,10599817,14,1,0,0,2
10599816,10600472,656,0,0,1,1
10599818,10600946,1128,0,0,1,2
10600473,10600482,9,1,0,0,1
10600483,10600947,464,0,0,1,1
10600947,10601010,63,1,0,0,2
10600948,10601009,61,1,0,0,1
10601010,10601371,361,0,0,1,1
10601011,10601377,366,0,0,1,2
10601372,10601401,29,1,0,0,1
10601378,10601395,17,1,0,0,2
10601396,10604377,2981,0,0,1,2
10601402,10604376,2974,0,0,1,1
10604377,10604476,99,1,0,0,1
10604378,10604477,99,1,0,0,2
10604477,10604585,108,0,0,1,1
10604478,10604585,107,0,0,1,2
10604586,10604608,22,1,0,0,2
10604586,10604609,23,1,0,0,1
10604609,10604781,172,0,0,1,2
10604610,10604781,171,0,0,1,1
10604782,10604794,12,1,0,0,2
10604782,10604795,13,1,0,0,1
10604795,10605930,1135,0,0,1,2
10604796,10605930,1134,0,0,1,1
10605931,10605975,44,1,0,0,1
10605931,10605986,55,1,0,0,2
10605976,10606098,122,0,0,1,1
10605987,10606098,111,0,0,1,2
10606099,10606125,26,1,0,0,1
10606099,10606128,29,1,0,0,2
10606126,10608283,2157,0,0,1,1
10606129,10608286,2157,0,0,1,2
10608284,10608492,208,1,0,0,1
10608287,10608493,206,1,0,0,2
10608314,10608453,139,0,1,0,1
10608323,10608418,95,0,1,0,2
10608493,10609145,652,0,0,1,1
10608494,10609145,651,0,0,1,2
10609146,10609197,51,1,0,0,2
10609146,10609198,52,1,0,0,1
10609198,10609234,36,0,0,1,2
10609199,10609234,35,0,0,1,1
10609235,10609279,44,1,0,0,1
10609235,10609280,45,1,0,0,2
10609280,10609393,113,0,0,1,1
10609281,10609394,113,0,0,1,2
10609394,10609459,65,1,0,0,1
10609395,10609467,72,1,0,0,2
10609460,10609582,122,0,0,1,1
10609468,10609582,114,0,0,1,2
10609583,10609605,22,1,0,0,1
10609583,10609607,24,1,0,0,2
10609606,10611093,1487,0,0,1,1
10609608,10611093,1485,0,0,1,2
10611094,10611134,40,1,0,0,1
10611094,10611142,48,1,0,0,2
10611135,10612896,1761,0,0,1,1
10611143,10612901,1758,0,0,1,2
10612897,10612907,10,1,0,0,1
10612902,10612907,5,1,0,0,2
10612908,10613534,626,0,0,1,1
10612908,10613534,626,0,0,1,2
10613535,10613597,62,1,0,0,1
10613535,10613604,69,1,0,0,2
10613598,10614832,1234,0,0,1,1
10613605,10614831,1226,0,0,1,2
10614832,10614867,35,1,0,0,2
10614833,10614860,27,1,0,0,1
10614861,10616053,1192,0,0,1,1
10614868,10615249,381,0,0,1,2
10615250,10615260,10,1,0,0,2
10615261,10616053,792,0,0,1,2
10616054,10616133,79,1,0,0,1
10616054,10616134,80,1,0,0,2
10616134,10618624,2490,0,0,1,1
10616135,10618624,2489,0,0,1,2
10618625,10618678,53,1,0,0,2
10618625,10618681,56,1,0,0,1
10618679,10619283,604,0,0,1,2
10618682,10619283,601,0,0,1,1
10619284,10619325,41,1,0,0,1
10619284,10619328,44,1,0,0,2
10619326,10619431,105,0,0,1,1
10619329,10619430,101,0,0,1,2
10619431,10619456,25,1,0,0,2
10619432,10619457,25,1,0,0,1
10619457,10619625,168,0,0,1,2
10619458,10620450,992,0,0,1,1
10619626,10619636,10,1,0,0,2
10619637,10620449,812,0,0,1,2
10620450,10620504,54,1,0,0,2
10620451,10620504,53,1,0,0,1
10620505,10620618,113,0,0,1,1
10620505,10620620,115,0,0,1,2
10620619,10620648,29,1,0,0,1
10620621,10620637,16,1,0,0,2
10620638,10623675,3037,0,0,1,2
10620649,10623675,3026,0,0,1,1
10623676,10623759,83,1,0,0,2
10623676,10623760,84,1,0,0,1
10623760,10623861,101,0,0,1,2
10623761,10623862,101,0,0,1,1
10623862,10623891,29,1,0,0,2
10623863,10623903,40,1,0,0,1
10623892,10623972,80,0,0,1,2
10623904,10623968,64,0,0,1,1
10623969,10624483,514,1,0,0,1
10623973,10624467,494,1,0,0,2
10623986,10624470,484,0,1,0,1
10623997,10624258,261,0,1,0,2
10624283,10624289,6,0,1,0,2
10624339,10624340,1,0,1,0,2
10624468,10625435,967,0,0,1,2
10624484,10625435,951,0,0,1,1
10625436,10625493,57,1,0,0,1
10625436,10625493,57,1,0,0,2
10625494,10625651,157,0,0,1,1
10625494,10625651,157,0,0,1,2
10625652,10625671,19,1,0,0,1
10625652,10625672,20,1,0,0,2
10625672,10629237,3565,0,0,1,1
10625673,10629236,3563,0,0,1,2
10629237,10629281,44,1,0,0,2
10629238,10629282,44,1,0,0,1
10629282,10629438,156,0,0,1,2
10629283,10629436,153,0,0,1,1
10629437,10629464,27,1,0,0,1
10629439,10629456,17,1,0,0,2
10629457,10629591,134,0,0,1,2
10629465,10629588,123,0,0,1,1
10629589,10629609,20,1,0,0,1
10629592,10629609,17,1,0,0,2
10629610,10630488,878,0,0,1,1
10629610,10630488,878,0,0,1,2
10630489,10630553,64,1,0,0,1
10630489,10630553,64,1,0,0,2
10630554,10630753,199,0,0,1,2
10630554,10630754,200,0,0,1,1
10630754,10630777,23,1,0,0,2
10630755,10630778,23,1,0,0,1
10630778,10632769,1991,0,0,1,2
10630779,10632768,1989,0,0,1,1
10632769,10633143,374,1,0,0,1
10632770,10633124,354,1,0,0,2
10632791,10633125,334,0,1,0,1
10632801,10633078,277,0,1,0,2
10633125,10633292,167,0,0,1,2
10633144,10633292,148,0,0,1,1
10633293,10633335,42,1,0,0,1
10633293,10633336,43,1,0,0,2
10633336,10633703,367,0,0,1,1
10633337,10633702,365,0,0,1,2
10633703,10633745,42,1,0,0,2
10633704,10633745,41,1,0,0,1
10633746,10633889,143,0,0,1,1
10633746,10633890,144,0,0,1,2
10633890,10633906,16,1,0,0,1
10633891,10633909,18,1,0,0,2
10633907,10634093,186,0,0,1,1
10633910,10634095,185,0,0,1,2
10634094,10634105,11,1,0,0,1
10634096,10634106,10,1,0,0,2
10634106,10634359,253,0,0,1,1
10634107,10634359,252,0,0,1,2
10634360,10634370,10,1,0,0,1
10634360,10634370,10,1,0,0,2
10634371,10635232,861,0,0,1,1
10634371,10635232,861,0,0,1,2
10635233,10635298,65,1,0,0,1
10635233,10635314,81,1,0,0,2
10635299,10635445,146,0,0,1,1
10635315,10635446,131,0,0,1,2
10635446,10635465,19,1,0,0,1
10635447,10635463,16,1,0,0,2
10635464,10637903,2439,0,0,1,2
10635466,10637902,2436,0,0,1,1
10637903,10637958,55,1,0,0,1
10637904,10637959,55,1,0,0,2
10637959,10638227,268,0,0,1,1
10637960,10638227,267,0,0,1,2
10638228,10638277,49,1,0,0,1
10638228,10638280,52,1,0,0,2
10638278,10639055,777,0,0,1,1
10638281,10639055,774,0,0,1,2
10639056,10639136,80,1,0,0,1
10639056,10639139,83,1,0,0,2
10639137,10639246,109,0,0,1,1
10639140,10639245,105,0,0,1,2
10639246,10639268,22,1,0,0,2
10639247,10639268,21,1,0,0,1
10639269,10639431,162,0,0,1,1
10639269,10639431,162,0,0,1,2
10639432,10639445,13,1,0,0,2
10639432,10639452,20,1,0,0,1
10639446,10640337,891,0,0,1,2
10639453,10640337,884,0,0,1,1
10640338,10640401,63,1,0,0,1
10640338,10640402,64,1,0,0,2
10640402,10640563,161,0,0,1,1
10640403,10640563,160,0,0,1,2
10640564,10640599,35,1,0,0,1
10640564,10640599,35,1,0,0,2
10640600,10643038,2438,0,0,1,2
10640600,10643039,2439,0,0,1,1
10643039,10643127,88,1,0,0,2
10643040,10643124,84,1,0,0,1
10643125,10643347,222,0,0,1,1
10643128,10643349,221,0,0,1,2
10643348,10643398,50,1,0,0,1
10643350,10643401,51,1,0,0,2
10643399,10643610,211,0,0,1,1
10643402,10643608,206,0,0,1,2
10643609,10643701,92,1,0,0,2
10643611,10643689,78,1,0,0,1
10643690,10643803,113,0,0,1,1
10643702,10643802,100,0,0,1,2
10643803,10643835,32,1,0,0,2
10643804,10643826,22,1,0,0,1
10643827,10643992,165,0,0,1,1
10643836,10643992,156,0,0,1,2
10643993,10644004,11,1,0,0,2
10643993,10644005,12,1,0,0,1
10644005,10645088,1083,0,0,1,2
10644006,10645088,1082,0,0,1,1
10645089,10645137,48,1,0,0,2
10645089,10645138,49,1,0,0,1
10645138,10645234,96,0,0,1,2
10645139,10645234,95,0,0,1,1
10645235,10645257,22,1,0,0,1
10645235,10645259,24,1,0,0,2
10645258,10647312,2054,0,0,1,1
10645260,10645469,209,0,0,1,2
10645470,10645480,10,1,0,0,2
10645481,10645751,270,0,0,1,2
10645752,10645761,9,1,0,0,2
10645762,10647313,1551,0,0,1,2
10647313,10647828,515,1,0,0,1
10647314,10647845,531,1,0,0,2
10647337,10647816,479,0,1,0,1
10647363,10647778,415,0,1,0,2
10647829,10648097,268,0,0,1,1
10647846,10648097,251,0,0,1,2
10648098,10648140,42,1,0,0,2
10648098,10648149,51,1,0,0,1
10648141,10648773,632,0,0,1,2
10648150,10648774,624,0,0,1,1
10648774,10648863,89,1,0,0,2
10648775,10648862,87,1,0,0,1
10648863,10648992,129,0,0,1,1
10648864,10648991,127,0,0,1,2
10648992,10649014,22,1,0,0,2
10648993,10649014,21,1,0,0,1
10649015,10649344,329,0,0,1,2
10649015,10649347,332,0,0,1,1
10649345,10649362,17,1,0,0,2
10649348,10649360,12,1,0,0,1
10649361,10650376,1015,0,0,1,1
10649363,10650373,1010,0,0,1,2
10650374,10650442,68,1,0,0,2
10650377,10650436,59,1,0,0,1
10650437,10650577,140,0,0,1,1
10650443,10650577,134,0,0,1,2
10650578,10650603,25,1,0,0,1
10650578,10650603,25,1,0,0,2
10650604,10652549,1945,0,0,1,2
10650604,10652552,1948,0,0,1,1
10652550,10652572,22,1,0,0,2
10652553,10652571,18,1,0,0,1
10652572,10652858,286,0,0,1,1
10652573,10652857,284,0,0,1,2
10652858,10652897,39,1,0,0,2
10652859,10652899,40,1,0,0,1
10652898,10654173,1275,0,0,1,2
10652900,10654173,1273,0,0,1,1
10654174,10654227,53,1,0,0,2
10654174,10654228,54,1,0,0,1
10654228,10654315,87,0,0,1,2
10654229,10654316,87,0,0,1,1
10654316,10654348,32,1,0,0,2
10654317,10654340,23,1,0,0,1
10654341,10654492,151,0,0,1,1
10654349,10654496,147,0,0,1,2
10654493,10654519,26,1,0,0,1
10654497,10654514,17,1,0,0,2
10654515,10655998,1483,0,0,1,2
10654520,10655997,1477,0,0,1,1
10655998,10656038,40,1,0,0,1
10655999,10656045,46,1,0,0,2
10656039,10656294,255,0,0,1,1
10656046,10656292,246,0,0,1,2
10656293,10656313,20,1,0,0,2
10656295,10656313,18,1,0,0,1
10656314,10656511,197,0,0,1,1
10656314,10656511,197,0,0,1,2
10656512,10656532,20,1,0,0,2
10656512,10656533,21,1,0,0,1
10656533,10656759,226,0,0,1,2
10656534,10656764,230,0,0,1,1
10656760,10656780,20,1,0,0,2
10656765,10656781,16,1,0,0,1
10656781,10658244,1463,0,0,1,2
10656782,10658247,1465,0,0,1,1
10658245,10658751,506,1,0,0,2
10658248,10658760,512,1,0,0,1
10658281,10658723,442,0,1,0,1
10658289,10658694,405,0,1,0,2
10658752,10658797,45,0,0,1,2
10658761,10658792,31,0,0,1,1
10658793,10658813,20,1,0,0,1
10658798,10658816,18,1,0,0,2
10658814,10660050,1236,0,0,1,1
10658817,10660049,1232,0,0,1,2
10660050,10660147,97,1,0,0,2
10660051,10660138,87,1,0,0,1
10660139,10660289,150,0,0,1,1
10660148,10660288,140,0,0,1,2
10660289,10660306,17,1,0,0,2
10660290,10660305,15,1,0,0,1
10660306,10660421,115,0,0,1,1
10660307,10660422,115,0,0,1,2
10660422,10660440,18,1,0,0,1
10660423,10660442,19,1,0,0,2
10660441,10660621,180,0,0,1,1
10660443,10660621,178,0,0,1,2
10660622,10660631,9,1,0,0,1
10660622,10660633,11,1,0,0,2
10660632,10660793,161,0,0,1,1
10660634,10660795,161,0,0,1,2
10660794,10660812,18,1,0,0,1
10660796,10660813,17,1,0,0,2
10660813,10661927,1114,0,0,1,1
10660814,10661928,1114,0,0,1,2
10661928,10661970,42,1,0,0,1
10661929,10661969,40,1,0,0,2
10661970,10663928,1958,0,0,1,2
10661971,10663932,1961,0,0,1,1
10663929,10664504,575,1,0,0,2
10663933,10664383,450,1,0,0,1
10663966,10664372,406,0,1,0,1
10663979,10664349,370,0,1,0,2
10664384,10664776,392,0,0,1,1
10664505,10664783,278,0,0,1,2
10664777,10664790,13,1,0,0,1
10664784,10664793,9,1,0,0,2
10664791,10664863,72,0,0,1,1
10664794,10664867,73,0,0,1,2
10664864,10665169,305,1,0,0,1
10664868,10665194,326,1,0,0,2
10664888,10665126,238,0,1,0,1
10664893,10665128,235,0,1,0,2
10665170,10665999,829,0,0,1,1
10665195,10666012,817,0,0,1,2
10666000,10666087,87,1,0,0,1
10666013,10666088,75,1,0,0,2
10666088,10666208,120,0,0,1,1
10666089,10666208,119,0,0,1,2
10666209,10666220,11,1,0,0,2
10666209,10666224,15,1,0,0,1
10666221,10668032,1811,0,0,1,2
10666225,10668032,1807,0,0,1,1
10668033,10668079,46,1,0,0,1
10668033,10668081,48,1,0,0,2
10668080,10670206,2126,0,0,1,1
10668082,10670204,2122,0,0,1,2
10670205,10670553,348,1,0,0,2
10670207,10670532,325,1,0,0,1
10670226,10670518,292,0,1,0,1
10670240,10670460,220,0,1,0,2
10670533,10672077,1544,0,0,1,1
10670554,10672077,1523,0,0,1,2
10672078,10672118,40,1,0,0,1
10672078,10672119,41,1,0,0,2
10672119,10672241,122,0,0,1,1
10672120,10672242,122,0,0,1,2
10672242,10672262,20,1,0,0,1
10672243,10672264,21,1,0,0,2
10672263,10672643,380,0,0,1,1
10672265,10673223,958,0,0,1,2
10672644,10672653,9,1,0,0,1
10672654,10673222,568,0,0,1,1
10673223,10673270,47,1,0,0,1
10673224,10673270,46,1,0,0,2
10673271,10673438,167,0,0,1,1
10673271,10673441,170,0,0,1,2
10673439,10673453,14,1,0,0,1
10673442,10673451,9,1,0,0,2
10673452,10675344,1892,0,0,1,2
10673454,10675345,1891,0,0,1,1
10675345,10675371,26,1,0,0,2
10675346,10675370,24,1,0,0,1
10675371,10675401,30,0,0,1,1
10675372,10675403,31,0,0,1,2
10675402,10675743,341,1,0,0,1
10675404,10675741,337,1,0,0,2
10675428,10675690,262,0,1,0,1
10675441,10675658,217,0,1,0,2
10675742,10676476,734,0,0,1,2
10675744,10676477,733,0,0,1,1
10676477,10676546,69,1,0,0,2
10676478,10676556,78,1,0,0,1
10676547,10676668,121,0,0,1,2
10676557,10676667,110,0,0,1,1
10676668,10676689,21,1,0,0,1
10676669,10676688,19,1,0,0,2
10676689,10676823,134,0,0,1,2
10676690,10676821,131,0,0,1,1
10676822,10676844,22,1,0,0,1
10676824,10676843,19,1,0,0,2
10676844,10677195,351,0,0,1,2
10676845,10677039,194,0,0,1,1
10677040,10677052,12,1,0,0,1
10677053,10677193,140,0,0,1,1
10677194,10677207,13,1,0,0,1
10677196,10677207,11,1,0,0,2
10677208,10678353,1145,0,0,1,1
10677208,10678354,1146,0,0,1,2
10678354,10678398,44,1,0,0,1
10678355,10678398,43,1,0,0,2
10678399,10678531,132,0,0,1,1
10678399,10678531,132,0,0,1,2
10678532,10678554,22,1,0,0,1
10678532,10678554,22,1,0,0,2
10678555,10679170,615,0,0,1,2
10678555,10679173,618,0,0,1,1
10679171,10679188,17,1,0,0,2
10679174,10679186,12,1,0,0,1
10679187,10680448,1261,0,0,1,1
10679189,10680448,1259,0,0,1,2
10680449,10680469,20,1,0,0,1
10680449,10680474,25,1,0,0,2
10680470,10680507,37,0,0,1,1
10680475,10680503,28,0,0,1,2
10680504,10680976,472,1,0,0,2
10680508,10680928,420,1,0,0,1
10680534,10680904,370,0,1,0,1
10680542,10680948,406,0,1,0,2
10680929,10681831,902,0,0,1,1
10680977,10681830,853,0,0,1,2
10681831,10681864,33,1,0,0,2
10681832,10681865,33,1,0,0,1
10681865,10682368,503,0,0,1,2
10681866,10682366,500,0,0,1,1
10682367,10682392,25,1,0,0,1
10682369,10682391,22,1,0,0,2
10682392,10682561,169,0,0,1,2
10682393,10684033,1640,0,0,1,1
10682562,10682572,10,1,0,0,2
10682573,10684033,1460,0,0,1,2
10684034,10684097,63,1,0,0,1
10684034,10684100,66,1,0,0,2
10684098,10684432,334,0,0,1,1
10684101,10684429,328,0,0,1,2
10684430,10684450,20,1,0,0,2
10684433,10684449,16,1,0,0,1
10684450,10686091,1641,0,0,1,1
10684451,10686104,1653,0,0,1,2
10686092,10687723,1631,1,0,0,1
10686105,10687753,1648,1,0,0,2
10686116,10687710,1594,0,1,0,1
10686139,10687742,1603,0,1,0,2
10687724,10687992,268,0,0,1,1
10687754,10687992,238,0,0,1,2
10687993,10688077,84,1,0,0,1
10687993,10688079,86,1,0,0,2
10688078,10688168,90,0,0,1,1
10688080,10688170,90,0,0,1,2
10688169,10688872,703,1,0,0,1
10688171,10688445,274,1,0,0,2
10688182,10688777,595,0,1,0,1
10688191,10688434,243,0,1,0,2
10688446,10689922,1476,0,0,1,2
10688873,10689923,1050,0,0,1,1
10689923,10689970,47,1,0,0,2
10689924,10689967,43,1,0,0,1
10689968,10692217,2249,0,0,1,1
10689971,10692239,2268,0,0,1,2
10692218,10692521,303,1,0,0,1
10692240,10692472,232,1,0,0,2
10692246,10692487,241,0,1,0,1
10692262,10692449,187,0,1,0,2
10692473,10693120,647,0,0,1,2
10692522,10693120,598,0,0,1,1
10693121,10693178,57,1,0,0,1
10693121,10693178,57,1,0,0,2
10693179,10693865,686,0,0,1,2
10693179,10693866,687,0,0,1,1
10693866,10693954,88,1,0,0,2
10693867,10693954,87,1,0,0,1
10693955,10694070,115,0,0,1,2
10693955,10694072,117,0,0,1,1
10694071,10694093,22,1,0,0,2
10694073,10694094,21,1,0,0,1
10694094,10695905,1811,0,0,1,2
10694095,10695905,1810,0,0,1,1
10695906,10695959,53,1,0,0,1
10695906,10695959,53,1,0,0,2
10695960,10698039,2079,0,0,1,1
10695960,10698042,2082,0,0,1,2
10698040,10698322,282,1,0,0,1
10698043,10698327,284,1,0,0,2
10698066,10698286,220,0,1,0,1
10698078,10698274,196,0,1,0,2
10698323,10698650,327,0,0,1,1
10698328,10698656,328,0,0,1,2
10698651,10698860,209,1,0,0,1
10698657,10698851,194,1,0,0,2
10698671,10698818,147,0,1,0,1
10698677,10698790,113,0,1,0,2
10698852,10699707,855,0,0,1,2
10698861,10699707,846,0,0,1,1
10699708,10699784,76,1,0,0,1
10699708,10699784,76,1,0,0,2
10699785,10699933,148,0,0,1,1
10699785,10699934,149,0,0,1,2
10699934,10699955,21,1,0,0,1
10699935,10699958,23,1,0,0,2
10699956,10700275,319,0,0,1,1
10699959,10700273,314,0,0,1,2
10700274,10700287,13,1,0,0,2
10700276,10700286,10,1,0,0,1
10700287,10701272,985,0,0,1,1
10700288,10701271,983,0,0,1,2
10701272,10701322,50,1,0,0,2
10701273,10701310,37,1,0,0,1
10701311,10703739,2428,0,0,1,1
10701323,10703739,2416,0,0,1,2
10703740,10703802,62,1,0,0,1
10703740,10703802,62,1,0,0,2
10703803,10704026,223,0,0,1,1
10703803,10704026,223,0,0,1,2
10704027,10704068,41,1,0,0,1
10704027,10704077,50,1,0,0,2
10704069,10704904,835,0,0,1,1
10704078,10704904,826,0,0,1,2
10704905,10704965,60,1,0,0,2
10704905,10704967,62,1,0,0,1
10704966,10705660,694,0,0,1,2
10704968,10705660,692,0,0,1,1
10705661,10705692,31,1,0,0,1
10705661,10705692,31,1,0,0,2
10705693,10705854,161,0,0,1,1
10705693,10705854,161,0,0,1,2
10752800,10752909,109,0,1,0,2
10752800,10752923,123,0,1,0,1
10752800,10752941,141,1,0,0,2
10752800,10752975,175,1,0,0,1
10752942,10753200,258,0,0,1,2
10752976,10753199,223,0,0,1,1
10753200,10753283,83,1,0,0,1
10753201,10753281,80,1,0,0,2
10753282,10753431,149,0,0,1,2
10753284,10753432,148,0,0,1,1
10753432,10753454,22,1,0,0,2
10753433,10753455,22,1,0,0,1
10753455,10754975,1520,0,0,1,2
10753456,10754976,1520,0,0,1,1
10754976,10755054,78,1,0,0,2
10754977,10755048,71,1,0,0,1
10755049,10755104,55,0,0,1,1
10755055,10755103,48,0,0,1,2
10755104,10755145,41,1,0,0,2
10755105,10755130,25,1,0,0,1
10755131,10755243,112,0,0,1,1
10755146,10755241,95,0,0,1,2
10755242,10755263,21,1,0,0,2
10755244,10755264,20,1,0,0,1
10755264,10756759,1495,0,0,1,2
10755265,10755508,243,0,0,1,1
10755509,10755513,4,1,0,0,1
10755514,10756760,1246,0,0,1,1
10756760,10756815,55,1,0,0,2
10756761,10756814,53,1,0,0,1
10756815,10756926,111,0,0,1,1
10756816,10756925,109,0,0,1,2
10756926,10756950,24,1,0,0,2
10756927,10756959,32,1,0,0,1
10756951,10758458,1507,0,0,1,2
10756960,10758459,1499,0,0,1,1
10758459,10758554,95,1,0,0,2
10758460,10758553,93,1,0,0,1
10758554,10758659,105,0,0,1,1
10758555,10758660,105,0,0,1,2
10758660,10758682,22,1,0,0,1
10758661,10758680,19,1,0,0,2
10758681,10758835,154,0,0,1,2
10758683,10758840,157,0,0,1,1
10758836,10758853,17,1,0,0,2
10758841,10758856,15,1,0,0,1
10758854,10758952,98,0,0,1,2
10758857,10758953,96,0,0,1,1
10758953,10758973,20,1,0,0,2
10758954,10758974,20,1,0,0,1
10758974,10759148,174,0,0,1,2
10758975,10759149,174,0,0,1,1
10759149,10759160,11,1,0,0,2
10759150,10759159,9,1,0,0,1
10759160,10759295,135,0,0,1,1
10759161,10759297,136,0,0,1,2
10759296,10759307,11,1,0,0,1
10759298,10759308,10,1,0,0,2
10759308,10760074,766,0,0,1,1
10759309,10760074,765,0,0,1,2
10760075,10760141,66,1,0,0,1
10760075,10760144,69,1,0,0,2
10760142,10760309,167,0,0,1,1
10760145,10760309,164,0,0,1,2
10760310,10760371,61,1,0,0,2
10760310,10760376,66,1,0,0,1
10760372,10760530,158,0,0,1,2
10760377,10760524,147,0,0,1,1
10760525,10760550,25,1,0,0,1
10760531,10760550,19,1,0,0,2
10760551,10761558,1007,0,0,1,2
10760551,10761561,1010,0,0,1,1
10761559,10761609,50,1,0,0,2
10761562,10761608,46,1,0,0,1
10761609,10761905,296,0,0,1,1
10761610,10761905,295,0,0,1,2
10761906,10761983,77,1,0,0,1
10761906,10761983,77,1,0,0,2
10761984,10762145,161,0,0,1,1
10761984,10762146,162,0,0,1,2
10762146,10762167,21,1,0,0,1
10762147,10762167,20,1,0,0,2
10762168,10763673,1505,0,0,1,2
10762168,10763674,1506,0,0,1,1
10763674,10763770,96,1,0,0,2
10763675,10763781,106,1,0,0,1
10763771,10763875,104,0,0,1,2
10763782,10763877,95,0,0,1,1
10763876,10763901,25,1,0,0,2
10763878,10763900,22,1,0,0,1
10763901,10764075,174,0,0,1,1
10763902,10764072,170,0,0,1,2
10764073,10764082,9,1,0,0,2
10764076,10764090,14,1,0,0,1
10764083,10764464,381,0,0,1,2
10764091,10764463,372,0,0,1,1
10764464,10764475,11,1,0,0,1
10764465,10764476,11,1,0,0,2
10764476,10765304,828,0,0,1,1
10764477,10765305,828,0,0,1,2
10765305,10765371,66,1,0,0,1
10765306,10765380,74,1,0,0,2
10765372,10765487,115,0,0,1,1
10765381,10765484,103,0,0,1,2
10765485,10765539,54,1,0,0,2
10765488,10765535,47,1,0,0,1
10765536,10765627,91,0,0,1,1
10765540,10765631,91,0,0,1,2
10765628,10765652,24,1,0,0,1
10765632,10765652,20,1,0,0,2
10765653,10765993,340,0,0,1,2
10765653,10765994,341,0,0,1,1
10765994,10766006,12,1,0,0,2
10765995,10766006,11,1,0,0,1
10766007,10766307,300,0,0,1,2
10766007,10766314,307,0,0,1,1
10766308,10766318,10,1,0,0,2
10766315,10766319,4,1,0,0,1
10766319,10766452,133,0,0,1,2
10766320,10766452,132,0,0,1,1
10766453,10766465,12,1,0,0,1
10766453,10766467,14,1,0,0,2
10766466,10767300,834,0,0,1,1
10766468,10767300,832,0,0,1,2
10767301,10767357,56,1,0,0,2
10767301,10767364,63,1,0,0,1
10767358,10767532,174,0,0,1,2
10767365,10767531,166,0,0,1,1
10767532,10767537,5,1,0,0,1
10767533,10767548,15,1,0,0,2
10767538,10769112,1574,0,0,1,1
10767549,10769112,1563,0,0,1,2
10769113,10769221,108,1,0,0,2
10769113,10769224,111,1,0,0,1
10769222,10769338,116,0,0,1,2
10769225,10769339,114,0,0,1,1
10769339,10769361,22,1,0,0,2
10769340,10769363,23,1,0,0,1
10769362,10769562,200,0,0,1,2
10769364,10769561,197,0,0,1,1
10769562,10769574,12,1,0,0,1
10769563,10769568,5,1,0,0,2
10769569,10769760,191,0,0,1,2
10769575,10770546,971,0,0,1,1
10769761,10769773,12,1,0,0,2
10769774,10770545,771,0,0,1,2
10770546,10770608,62,1,0,0,2
10770547,10770609,62,1,0,0,1
10770609,10770927,318,0,0,1,2
10770610,10770928,318,0,0,1,1
10770928,10770968,40,1,0,0,2
10770929,10770967,38,1,0,0,1
10770968,10771504,536,0,0,1,1
10770969,10771127,158,0,0,1,2
10771128,10771134,6,1,0,0,2
10771135,10771513,378,0,0,1,2
10771505,10771516,11,1,0,0,1
10771514,10771520,6,1,0,0,2
10771517,10772659,1142,0,0,1,1
10771521,10772660,1139,0,0,1,2
10772660,10772723,63,1,0,0,1
10772661,10772724,63,1,0,0,2
10772724,10772810,86,0,0,1,1
10772725,10772810,85,0,0,1,2
10772811,10772839,28,1,0,0,2
10772811,10772854,43,1,0,0,1
10772840,10772971,131,0,0,1,2
10772855,10772973,118,0,0,1,1
10772972,10772995,23,1,0,0,2
10772974,10772994,20,1,0,0,1
10772995,10773196,201,0,0,1,1
10772996,10773195,199,0,0,1,2
10773196,10773207,11,1,0,0,2
10773197,10773208,11,1,0,0,1
10773208,10774565,1357,0,0,1,2
10773209,10774566,1357,0,0,1,1
10774566,10774669,103,1,0,0,2
10774567,10774670,103,1,0,0,1
10774670,10774761,91,0,0,1,2
10774671,10774761,90,0,0,1,1
10774762,10774799,37,1,0,0,1
10774762,10774812,50,1,0,0,2
10774800,10774914,114,0,0,1,1
10774813,10774919,106,0,0,1,2
10774915,10774934,19,1,0,0,1
10774920,10774932,12,1,0,0,2
10774933,10775216,283,0,0,1,2
10774935,10775211,276,0,0,1,1
10775212,10775229,17,1,0,0,1
10775217,10775237,20,1,0,0,2
10775230,10776510,1280,0,0,1,1
10775238,10776511,1273,0,0,1,2
10776511,10776607,96,1,0,0,1
10776512,10776606,94,1,0,0,2
10776607,10776698,91,0,0,1,2
10776608,10776698,90,0,0,1,1
10776699,10776728,29,1,0,0,1
10776699,10776728,29,1,0,0,2
10776729,10776857,128,0,0,1,2
10776729,10778407,1678,0,0,1,1
10776858,10776874,16,1,0,0,2
10776875,10778407,1532,0,0,1,2
10778408,10778495,87,1,0,0,1
10778408,10778513,105,1,0,0,2
10778496,10778605,109,0,0,1,1
10778514,10778605,91,0,0,1,2
10778606,10778629,23,1,0,0,1
10778606,10778629,23,1,0,0,2
10778630,10778822,192,0,0,1,1
10778630,10778822,192,0,0,1,2
10778823,10778832,9,1,0,0,2
10778823,10778836,13,1,0,0,1
10778833,10780243,1410,0,0,1,2
10778837,10780242,1405,0,0,1,1
10780243,10780314,71,1,0,0,1
10780244,10780314,70,1,0,0,2
10780315,10780408,93,0,0,1,1
10780315,10780408,93,0,0,1,2
10780409,10780439,30,1,0,0,1
10780409,10780441,32,1,0,0,2
10780440,10780725,285,0,0,1,1
10780442,10780728,286,0,0,1,2
10780726,10780736,10,1,0,0,1
10780729,10780747,18,1,0,0,2
10780737,10782178,1441,0,0,1,1
10780748,10782179,1431,0,0,1,2
10782179,10782244,65,1,0,0,1
10782180,10782245,65,1,0,0,2
10782245,10782342,97,0,0,1,1
10782246,10782343,97,0,0,1,2
10782343,10782371,28,1,0,0,1
10782344,10782371,27,1,0,0,2
10782372,10782558,186,0,0,1,1
10782372,10782558,186,0,0,1,2
10782559,10782580,21,1,0,0,1
10782559,10782580,21,1,0,0,2
10782581,10782709,128,0,0,1,1
10782581,10782712,131,0,0,1,2
10782710,10782722,12,1,0,0,1
10782713,10782730,17,1,0,0,2
10782723,10783032,309,0,0,1,1
10782731,10783030,299,0,0,1,2
10783031,10783046,15,1,0,0,2
10783033,10783046,13,1,0,0,1
10783047,10784134,1087,0,0,1,1
10783047,10784134,1087,0,0,1,2
10784135,10784199,64,1,0,0,1
10784135,10784199,64,1,0,0,2
10784200,10784304,104,0,0,1,2
10784200,10784305,105,0,0,1,1
10784305,10784331,26,1,0,0,2
10784306,10784332,26,1,0,0,1
10784332,10784500,168,0,0,1,2
10784333,10784495,162,0,0,1,1
10784496,10784517,21,1,0,0,1
10784501,10784516,15,1,0,0,2
10784517,10786100,1583,0,0,1,2
10784518,10786099,1581,0,0,1,1
10786100,10786167,67,1,0,0,1
10786101,10786167,66,1,0,0,2
10786168,10786269,101,0,0,1,1
10786168,10786270,102,0,0,1,2
10786270,10786292,22,1,0,0,1
10786271,10786292,21,1,0,0,2
10786293,10788030,1737,0,0,1,2
10786293,10788031,1738,0,0,1,1
10788031,10788105,74,1,0,0,2
10788032,10788100,68,1,0,0,1
10788101,10788317,216,0,0,1,1
10788106,10788318,212,0,0,1,2
10788318,10788340,22,1,0,0,1
10788319,10788340,21,1,0,0,2
10788341,10788611,270,0,0,1,1
10788341,10788742,401,0,0,1,2
10788612,10788621,9,1,0,0,1
10788622,10788743,121,0,0,1,1
10788743,10788755,12,1,0,0,2
10788744,10788754,10,1,0,0,1
10788755,10789876,1121,0,0,1,1
10788756,10789875,1119,0,0,1,2
10789876,10789944,68,1,0,0,2
10789877,10789935,58,1,0,0,1
10789936,10790121,185,0,0,1,1
10789945,10790125,180,0,0,1,2
10790122,10790139,17,1,0,0,1
10790126,10790140,14,1,0,0,2
10790140,10791533,1393,0,0,1,1
10790141,10791533,1392,0,0,1,2
10791534,10791578,44,1,0,0,1
10791534,10791580,46,1,0,0,2
10791579,10791683,104,0,0,1,1
10791581,10791685,104,0,0,1,2
10791684,10791751,67,1,0,0,1
10791686,10791758,72,1,0,0,2
10791752,10791884,132,0,0,1,1
10791759,10791884,125,0,0,1,2
10791885,10791911,26,1,0,0,2
10791885,10791921,36,1,0,0,1
10791912,10792174,262,0,0,1,2
10791922,10792171,249,0,0,1,1
10792172,10792188,16,1,0,0,1
10792175,10792186,11,1,0,0,2
10792187,10793673,1486,0,0,1,2
10792189,10793673,1484,0,0,1,1
10793674,10793747,73,1,0,0,1
10793674,10793759,85,1,0,0,2
10793748,10795607,1859,0,0,1,1
10793760,10795607,1847,0,0,1,2
10795608,10795674,66,1,0,0,1
10795608,10795675,67,1,0,0,2
10795675,10795779,104,0,0,1,1
10795676,10795780,104,0,0,1,2
10795780,10795806,26,1,0,0,1
10795781,10795806,25,1,0,0,2
10795807,10796600,793,0,0,1,1
10795807,10796601,794,0,0,1,2
10796601,10796610,9,1,0,0,1
10796602,10796612,10,1,0,0,2
10796611,10796727,116,0,0,1,1
10796613,10796723,110,0,0,1,2
10796724,10796740,16,1,0,0,2
10796728,10796741,13,1,0,0,1
10796741,10797697,956,0,0,1,2
10796742,10797696,954,0,0,1,1
10797697,10797791,94,1,0,0,1
10797698,10797778,80,1,0,0,2
10797779,10797910,131,0,0,1,2
10797792,10797908,116,0,0,1,1
10797909,10797930,21,1,0,0,1
10797911,10797939,28,1,0,0,2
10797931,10798335,404,0,0,1,1
10797940,10798335,395,0,0,1,2
10798336,10798345,9,1,0,0,2
10798336,10798347,11,1,0,0,1
10798346,10799676,1330,0,0,1,2
10798348,10799676,1328,0,0,1,1
10799677,10799777,100,1,0,0,2
10799677,10799779,102,1,0,0,1
10799778,10799877,99,0,0,1,2
10799780,10799877,97,0,0,1,1
10799878,10799904,26,1,0,0,2
10799878,10799918,40,1,0,0,1
10799905,10800184,279,0,0,1,2
10799919,10800178,259,0,0,1,1
10800179,10800193,14,1,0,0,1
10800185,10800196,11,1,0,0,2
10800194,10800625,431,0,0,1,1
10800197,10801704,1507,0,0,1,2
10800626,10800631,5,1,0,0,1
10800632,10801704,1072,0,0,1,1
10801705,10801771,66,1,0,0,1
10801705,10801781,76,1,0,0,2
10801772,10801962,190,0,0,1,1
10801782,10801962,180,0,0,1,2
10801963,10801983,20,1,0,0,1
10801963,10801983,20,1,0,0,2
10801984,10802240,256,0,0,1,1
10801984,10802240,256,0,0,1,2
10802241,10802252,11,1,0,0,2
10802241,10802253,12,1,0,0,1
10802253,10802982,729,0,0,1,2
10802254,10802979,725,0,0,1,1
10802980,10802994,14,1,0,0,1
10802983,10802996,13,1,0,0,2
10802995,10803835,840,0,0,1,1
10802997,10803835,838,0,0,1,2
10803836,10803956,120,1,0,0,1
10803836,10803977,141,1,0,0,2
10803957,10804066,109,0,0,1,1
10803978,10804065,87,0,0,1,2
10804066,10804094,28,1,0,0,2
10804067,10804095,28,1,0,0,1
10804095,10805976,1881,0,0,1,2
10804096,10805977,1881,0,0,1,1
10805977,10806065,88,1,0,0,2
10805978,10806058,80,1,0,0,1
10806059,10806182,123,0,0,1,1
10806066,10806182,116,0,0,1,2
10806183,10806204,21,1,0,0,2
10806183,10806205,22,1,0,0,1
10806205,10806349,144,0,0,1,2
10806206,10806345,139,0,0,1,1
10806346,10806365,19,1,0,0,1
10806350,10806366,16,1,0,0,2
10806366,10807983,1617,0,0,1,1
10806367,10807983,1616,0,0,1,2
10807984,10808035,51,1,0,0,1
10807984,10808045,61,1,0,0,2
10808036,10808156,120,0,0,1,1
10808046,10808156,110,0,0,1,2
10808157,10808179,22,1,0,0,1
10808157,10808179,22,1,0,0,2
10808180,10808361,181,0,0,1,2
10808180,10808363,183,0,0,1,1
10808362,10808378,16,1,0,0,2
10808364,10808377,13,1,0,0,1
10808378,10808755,377,0,0,1,1
10808379,10808756,377,0,0,1,2
10808756,10808768,12,1,0,0,1
10808757,10808767,10,1,0,0,2
10808768,10808879,111,0,0,1,2
10808769,10808874,105,0,0,1,1
10808875,10808892,17,1,0,0,1
10808880,10808901,21,1,0,0,2
10808893,10809901,1008,0,0,1,1
10808902,10809903,1001,0,0,1,2
10809902,10809983,81,1,0,0,1
10809904,10809992,88,1,0,0,2
10809984,10810108,124,0,0,1,1
10809993,10810107,114,0,0,1,2
10810108,10810131,23,1,0,0,2
10810109,10810131,22,1,0,0,1
10810132,10810353,221,0,0,1,2
10810132,10810355,223,0,0,1,1
10810354,10810373,19,1,0,0,2
10810356,10810364,8,1,0,0,1
10810365,10811897,1532,0,0,1,1
10810374,10811897,1523,0,0,1,2
10811898,10811988,90,1,0,0,1
10811898,10811988,90,1,0,0,2
10811989,10812078,89,0,0,1,1
10811989,10812078,89,0,0,1,2
10812079,10812107,28,1,0,0,1
10812079,10812121,42,1,0,0,2
10812108,10812254,146,0,0,1,1
10812122,10812254,132,0,0,1,2
10812255,10812276,21,1,0,0,2
10812255,10812277,22,1,0,0,1
10812277,10813999,1722,0,0,1,2
10812278,10813997,1719,0,0,1,1
10813998,10814122,124,1,0,0,1
10814000,10814122,122,1,0,0,2
10814123,10814214,91,0,0,1,2
10814123,10814215,92,0,0,1,1
10814215,10814246,31,1,0,0,2
10814216,10814243,27,1,0,0,1
10814244,10814474,230,0,0,1,1
10814247,10814473,226,0,0,1,2
10814474,10814504,30,1,0,0,2
10814475,10814495,20,1,0,0,1
10814496,10816091,1595,0,0,1,1
10814505,10816090,1585,0,0,1,2
10816091,10816183,92,1,0,0,2
10816092,10816182,90,1,0,0,1
10816183,10816275,92,0,0,1,1
10816184,10816276,92,0,0,1,2
10816276,10816312,36,1,0,0,1
10816277,10816312,35,1,0,0,2
10816313,10816982,669,0,0,1,1
10816313,10816983,670,0,0,1,2
10816983,10816995,12,1,0,0,1
10816984,10816997,13,1,0,0,2
10816996,10818119,1123,0,0,1,1
10816998,10818120,1122,0,0,1,2
10818120,10818187,67,1,0,0,1
10818121,10818196,75,1,0,0,2
10818188,10818298,110,0,0,1,1
10818197,10818299,102,0,0,1,2
10818299,10818323,24,1,0,0,1
10818300,10818332,32,1,0,0,2
10818324,10818505,181,0,0,1,1
10818333,10818501,168,0,0,1,2
10818502,10818518,16,1,0,0,2
10818506,10818519,13,1,0,0,1
10818519,10819070,551,0,0,1,2
10818520,10819071,551,0,0,1,1
10819071,10819082,11,1,0,0,2
10819072,10819081,9,1,0,0,1
10819082,10819192,110,0,0,1,1
10819083,10819188,105,0,0,1,2
10819189,10819207,18,1,0,0,2
10819193,10819206,13,1,0,0,1
10819207,10820098,891,0,0,1,1
10819208,10820097,889,0,0,1,2
10820098,10820216,118,1,0,0,2
10820099,10820218,119,1,0,0,1
10820217,10820325,108,0,0,1,2
10820219,10820323,104,0,0,1,1
10820324,10820361,37,1,0,0,1
10820326,10820349,23,1,0,0,2
10820350,10820527,177,0,0,1,2
10820362,10820526,164,0,0,1,1
10820527,10820545,18,1,0,0,1
10820528,10820546,18,1,0,0,2
10820546,10820819,273,0,0,1,1
10820547,10820827,280,0,0,1,2
10820820,10820840,20,1,0,0,1
10820828,10820842,14,1,0,0,2
10820841,10821150,309,0,0,1,1
10820843,10821156,313,0,0,1,2
10821151,10821161,10,1,0,0,1
10821157,10821161,4,1,0,0,2
10821162,10822017,855,0,0,1,1
10821162,10822019,857,0,0,1,2
10822018,10822112,94,1,0,0,1
10822020,10822113,93,1,0,0,2
10822113,10822221,108,0,0,1,1
10822114,10822221,107,0,0,1,2
10822222,10822252,30,1,0,0,1
10822222,10822256,34,1,0,0,2
10822253,10822552,299,0,0,1,1
10822257,10822549,292,0,0,1,2
10822550,10822566,16,1,0,0,2
10822553,10822564,11,1,0,0,1
10822565,10822714,149,0,0,1,1
10822567,10822710,143,0,0,1,2
10822711,10822727,16,1,0,0,2
10822715,10822728,13,1,0,0,1
10822728,10822856,128,0,0,1,2
10822729,10822856,127,0,0,1,1
10822857,10822870,13,1,0,0,1
10822857,10822871,14,1,0,0,2
10822871,10823946,1075,0,0,1,1
10822872,10823949,1077,0,0,1,2
10823947,10824021,74,1,0,0,1
10823950,10824021,71,1,0,0,2
10824022,10824134,112,0,0,1,1
10824022,10824135,113,0,0,1,2
10824135,10824189,54,1,0,0,1
10824136,10824187,51,1,0,0,2
10824188,10824322,134,0,0,1,2
10824190,10824321,131,0,0,1,1
10824322,10824339,17,1,0,0,1
10824323,10824340,17,1,0,0,2
10824340,10826293,1953,0,0,1,1
10824341,10826293,1952,0,0,1,2
10826294,10826419,125,1,0,0,2
10826294,10826420,126,1,0,0,1
10826420,10826526,106,0,0,1,2
10826421,10826526,105,0,0,1,1
10826527,10826566,39,1,0,0,2
10826527,10826570,43,1,0,0,1
10826567,10828110,1543,0,0,1,2
10826571,10828110,1539,0,0,1,1
10828111,10828171,60,1,0,0,2
10828111,10828173,62,1,0,0,1
10828172,10828391,219,0,0,1,2
10828174,10828392,218,0,0,1,1
10828392,10828494,102,1,0,0,2
10828393,10828505,112,1,0,0,1
10828495,10828580,85,0,0,1,2
10828506,10828581,75,0,0,1,1
10828581,10828637,56,1,0,0,2
10828582,10828647,65,1,0,0,1
10828638,10828763,125,0,0,1,2
10828648,10828762,114,0,0,1,1
10828763,10828781,18,1,0,0,1
10828764,10828789,25,1,0,0,2
10828782,10830069,1287,0,0,1,1
10828790,10830068,1278,0,0,1,2
10830069,10830107,38,1,0,0,2
10830070,10830114,44,1,0,0,1
10830108,10830513,405,0,0,1,2
10830115,10830513,398,0,0,1,1
10830514,10830654,140,1,0,0,1
10830514,10830659,145,1,0,0,2
10830655,10830746,91,0,0,1,1
10830660,10830746,86,0,0,1,2
10830747,10830789,42,1,0,0,1
10830747,10830790,43,1,0,0,2
10830790,10831043,253,0,0,1,1
10830791,10831043,252,0,0,1,2
10831044,10831063,19,1,0,0,1
10831044,10831063,19,1,0,0,2
10831064,10832560,1496,0,0,1,1
10831064,10832561,1497,0,0,1,2
10832561,10832660,99,1,0,0,1
10832562,10832664,102,1,0,0,2
10832661,10832760,99,0,0,1,1
10832665,10832759,94,0,0,1,2
10832760,10832786,26,1,0,0,2
10832761,10832787,26,1,0,0,1
10832787,10834260,1473,0,0,1,2
10832788,10834260,1472,0,0,1,1
10834261,10834285,24,1,0,0,1
10834261,10834293,32,1,0,0,2
10834286,10834474,188,0,0,1,1
10834294,10834473,179,0,0,1,2
10834474,10834545,71,1,0,0,2
10834475,10834553,78,1,0,0,1
10834546,10834684,138,0,0,1,2
10834554,10834684,130,0,0,1,1
10834685,10834702,17,1,0,0,1
10834685,10834705,20,1,0,0,2
10834703,10836320,1617,0,0,1,1
10834706,10836320,1614,0,0,1,2
10836321,10836431,110,1,0,0,2
10836321,10836432,111,1,0,0,1
10836432,10836544,112,0,0,1,2
10836433,10836544,111,0,0,1,1
10836545,10836587,42,1,0,0,1
10836545,10836588,43,1,0,0,2
10836588,10836737,149,0,0,1,1
10836589,10836738,149,0,0,1,2
10836738,10836757,19,1,0,0,1
10836739,10836756,17,1,0,0,2
10836757,10837009,252,0,0,1,2
10836758,10837013,255,0,0,1,1
10837010,10837037,27,1,0,0,2
10837014,10837029,15,1,0,0,1
10837030,10838375,1345,0,0,1,1
10837038,10838377,1339,0,0,1,2
10838376,10838559,183,1,0,0,1
10838378,10838511,133,1,0,0,2
10838512,10838604,92,0,0,1,2
10838560,10838603,43,0,0,1,1
10838604,10838641,37,1,0,0,1
10838605,10838641,36,1,0,0,2
10838642,10840367,1725,0,0,1,2
10838642,10840368,1726,0,0,1,1
10840368,10840459,91,1,0,0,2
10840369,10840459,90,1,0,0,1
10840460,10840555,95,0,0,1,2
10840460,10840556,96,0,0,1,1
10840556,10840583,27,1,0,0,2
10840557,10840582,25,1,0,0,1
10840583,10840695,112,0,0,1,1
10840584,10840695,111,0,0,1,2
10840696,10840715,19,1,0,0,1
10840696,10840716,20,1,0,0,2
10840716,10841268,552,0,0,1,1
10840717,10841270,553,0,0,1,2
10841269,10841282,13,1,0,0,1
10841271,10841281,10,1,0,0,2
10841282,10841385,103,0,0,1,2
10841283,10841381,98,0,0,1,1
10841382,10841399,17,1,0,0,1
10841386,10841400,14,1,0,0,2
10841400,10842419,1019,0,0,1,1
10841401,10842418,1017,0,0,1,2
10842419,10842514,95,1,0,0,2
10842420,10842493,73,1,0,0,1
10842494,10842612,118,0,0,1,1
10842515,10842611,96,0,0,1,2
10842612,10842631,19,1,0,0,2
10842613,10842630,17,1,0,0,1
10842631,10843069,438,0,0,1,1
10842632,10842789,157,0,0,1,2
10842790,10842796,6,1,0,0,2
10842797,10843063,266,0,0,1,2
10843064,10843084,20,1,0,0,2
10843070,10843082,12,1,0,0,1
10843083,10844528,1445,0,0,1,1
10843085,10844530,1445,0,0,1,2
10844529,10844581,52,1,0,0,1
10844531,10844583,52,1,0,0,2
10844582,10844691,109,0,0,1,1
10844584,10844692,108,0,0,1,2
10844692,10844706,14,1,0,0,1
10844693,10844708,15,1,0,0,2
10844707,10844869,162,0,0,1,1
10844709,10844867,158,0,0,1,2
10844868,10844880,12,1,0,0,2
10844870,10844884,14,1,0,0,1
10844881,10846285,1404,0,0,1,2
10844885,10846285,1400,0,0,1,1
10846286,10846373,87,1,0,0,2
10846286,10846381,95,1,0,0,1
10846374,10846480,106,0,0,1,2
10846382,10846480,98,0,0,1,1
10846481,10846506,25,1,0,0,1
10846481,10846515,34,1,0,0,2
10846507,10846723,216,0,0,1,1
10846516,10846728,212,0,0,1,2
10846724,10846739,15,1,0,0,1
10846729,10846743,14,1,0,0,2
10846740,10848393,1653,0,0,1,1
10846744,10848392,1648,0,0,1,2
10848393,10848419,26,1,0,0,2
10848394,10848422,28,1,0,0,1
10848420,10848576,156,0,0,1,2
10848423,10848574,151,0,0,1,1
10848575,10848603,28,1,0,0,1
10848577,10848594,17,1,0,0,2
10848595,10848884,289,0,0,1,2
10848604,10848886,282,0,0,1,1
10848885,10848904,19,1,0,0,2
10848887,10848898,11,1,0,0,1
10848899,10849990,1091,0,0,1,1
10848905,10849989,1084,0,0,1,2
10849990,10850046,56,1,0,0,2
10849991,10850046,55,1,0,0,1
10850047,10850216,169,0,0,1,1
10850047,10850216,169,0,0,1,2
10850217,10850237,20,1,0,0,1
10850217,10850239,22,1,0,0,2
10850238,10850450,212,0,0,1,1
10850240,10850449,209,0,0,1,2
10850450,10850471,21,1,0,0,2
10850451,10850473,22,1,0,0,1
10850472,10852010,1538,0,0,1,2
10850474,10852012,1538,0,0,1,1
10852011,10852444,433,1,0,0,2
10852013,10852441,428,1,0,0,1
10852060,10852430,370,0,1,0,1
10852062,10852401,339,0,1,0,2
10852442,10852552,110,0,0,1,1
10852445,10852550,105,0,0,1,2
10852551,10852581,30,1,0,0,2
10852553,10852580,27,1,0,0,1
10852581,10853785,1204,0,0,1,1
10852582,10853784,1202,0,0,1,2
10853785,10853874,89,1,0,0,2
10853786,10853873,87,1,0,0,1
10853874,10853972,98,0,0,1,1
10853875,10853970,95,0,0,1,2
10853971,10853982,11,1,0,0,2
10853973,10853979,6,1,0,0,1
10853980,10855072,1092,0,0,1,1
10853983,10855242,1259,0,0,1,2
10855073,10855077,4,1,0,0,1
10855078,10855241,163,0,0,1,1
10855242,10855284,42,1,0,0,1
10855243,10855284,41,1,0,0,2
10855285,10857405,2120,0,0,1,1
10855285,10857419,2134,0,0,1,2
10857406,10857923,517,1,0,0,1
10857420,10857921,501,1,0,0,2
10857435,10857913,478,0,1,0,1
10857453,10857894,441,0,1,0,2
10857922,10858719,797,0,0,1,2
10857924,10858719,795,0,0,1,1
10858720,10858797,77,1,0,0,2
10858720,10858798,78,1,0,0,1
10858798,10858975,177,0,0,1,2
10858799,10858977,178,0,0,1,1
10858976,10859051,75,1,0,0,2
10858978,10859050,72,1,0,0,1
10859051,10859160,109,0,0,1,1
10859052,10859161,109,0,0,1,2
10859161,10859194,33,1,0,0,1
10859162,10859193,31,1,0,0,2
10859194,10859395,201,0,0,1,2
10859195,10859396,201,0,0,1,1
10859396,10859417,21,1,0,0,2
10859397,10859425,28,1,0,0,1
10859418,10859539,121,0,0,1,2
10859426,10859542,116,0,0,1,1
10859540,10859558,18,1,0,0,2
10859543,10859558,15,1,0,0,1
10859559,10860524,965,0,0,1,1
10859559,10860524,965,0,0,1,2
10860525,10860571,46,1,0,0,1
10860525,10860571,46,1,0,0,2
10860572,10860697,125,0,0,1,2
10860572,10860699,127,0,0,1,1
10860698,10860724,26,1,0,0,2
10860700,10860724,24,1,0,0,1
10860725,10862629,1904,0,0,1,2
10860725,10862630,1905,0,0,1,1
10862630,10862651,21,1,0,0,2
10862631,10862650,19,1,0,0,1
10862651,10862798,147,0,0,1,1
10862652,10862800,148,0,0,1,2
10862799,10863083,284,1,0,0,1
10862801,10863109,308,1,0,0,2
10862831,10863045,214,0,1,0,1
10862842,10863015,173,0,1,0,2
10863084,10863182,98,0,0,1,1
10863110,10863180,70,0,0,1,2
10863181,10863209,28,1,0,0,2
10863183,10863200,17,1,0,0,1
10863201,10864120,919,0,0,1,1
10863210,10864120,910,0,0,1,2
10864121,10864164,43,1,0,0,1
10864121,10864168,47,1,0,0,2
10864165,10864281,116,0,0,1,1
10864169,10864281,112,0,0,1,2
10864282,10864302,20,1,0,0,1
10864282,10864303,21,1,0,0,2
10864303,10865759,1456,0,0,1,1
10864304,10865759,1455,0,0,1,2
10865760,10865816,56,1,0,0,1
10865760,10865816,56,1,0,0,2
10865817,10865958,141,0,0,1,1
10865817,10865958,141,0,0,1,2
10865959,10865990,31,1,0,0,1
10865959,10865993,34,1,0,0,2
10865991,10866666,675,0,0,1,1
10865994,10866667,673,0,0,1,2
10866667,10866686,19,1,0,0,1
10866668,10866687,19,1,0,0,2
10866687,10867942,1255,0,0,1,1
10866688,10867945,1257,0,0,1,2
10867943,10867957,14,1,0,0,1
10867946,10867957,11,1,0,0,2
10867958,10868344,386,0,0,1,2
10867958,10868349,391,0,0,1,1
10868345,10868560,215,1,0,0,2
10868350,10868558,208,1,0,0,1
10868374,10868511,137,0,1,0,1
10868377,10868488,111,0,1,0,2
10868559,10869795,1236,0,0,1,1
10868561,10869793,1232,0,0,1,2
10869794,10869848,54,1,0,0,2
10869796,10869846,50,1,0,0,1
10869847,10869970,123,0,0,1,1
10869849,10869970,121,0,0,1,2
10869971,10869992,21,1,0,0,1
10869971,10869992,21,1,0,0,2
10869993,10871130,1137,0,0,1,2
10869993,10871132,1139,0,0,1,1
10871131,10871196,65,1,0,0,2
10871133,10871200,67,1,0,0,1
10871197,10871438,241,0,0,1,2
10871201,10871437,236,0,0,1,1
10871438,10871464,26,1,0,0,1
10871439,10871465,26,1,0,0,2
10871465,10871789,324,0,0,1,1
10871466,10871791,325,0,0,1,2
10871790,10871809,19,1,0,0,1
10871792,10871809,17,1,0,0,2
10871810,10871988,178,0,0,1,2
10871810,10871989,179,0,0,1,1
10871989,10872002,13,1,0,0,2
10871990,10872001,11,1,0,0,1
10872002,10872364,362,0,0,1,1
10872003,10873651,1648,0,0,1,2
10872365,10872376,11,1,0,0,1
10872377,10873651,1274,0,0,1,1
10873652,10873710,58,1,0,0,1
10873652,10873712,60,1,0,0,2
10873711,10874673,962,0,0,1,1
10873713,10874674,961,0,0,1,2
10874674,10874772,98,1,0,0,1
10874675,10874778,103,1,0,0,2
10874773,10874860,87,0,0,1,1
10874779,10874860,81,0,0,1,2
10874861,10874895,34,1,0,0,1
10874861,10874897,36,1,0,0,2
10874896,10875264,368,0,0,1,1
10874898,10875263,365,0,0,1,2
10875264,10875280,16,1,0,0,2
10875265,10875280,15,1,0,0,1
10875281,10876374,1093,0,0,1,2
10875281,10876375,1094,0,0,1,1
10876375,10876430,55,1,0,0,2
10876376,10876438,62,1,0,0,1
10876431,10876530,99,0,0,1,2
10876439,10876532,93,0,0,1,1
10876531,10876566,35,1,0,0,2
10876533,10876560,27,1,0,0,1
10876561,10878933,2372,0,0,1,1
10876567,10878931,2364,0,0,1,2
10878932,10878984,52,1,0,0,2
10878934,10878977,43,1,0,0,1
10878978,10879231,253,0,0,1,1
10878985,10879230,245,0,0,1,2
10879231,10879268,37,1,0,0,2
10879232,10879273,41,1,0,0,1
10879269,10880247,978,0,0,1,2
10879274,10880248,974,0,0,1,1
10880248,10880346,98,1,0,0,2
10880249,10880335,86,1,0,0,1
10880336,10880481,145,0,0,1,1
10880347,10880481,134,0,0,1,2
10880482,10880503,21,1,0,0,1
10880482,10880507,25,1,0,0,2
10880504,10880615,111,0,0,1,1
10880508,10880613,105,0,0,1,2
10880614,10880632,18,1,0,0,2
10880616,10880633,17,1,0,0,1
10880633,10881551,918,0,0,1,2
10880634,10881551,917,0,0,1,1
10881552,10881611,59,1,0,0,2
10881552,10881618,66,1,0,0,1
10881612,10881804,192,0,0,1,2
10881619,10881805,186,0,0,1,1
10881805,10881827,22,1,0,0,2
10881806,10881834,28,1,0,0,1
10881828,10883784,1956,0,0,1,2
10881835,10883790,1955,0,0,1,1
10883785,10883802,17,1,0,0,2
10883791,10883798,7,1,0,0,1
10883799,10884085,286,0,0,1,1
10883803,10884082,279,0,0,1,2
10884083,10884390,307,1,0,0,2
10884086,10884385,299,1,0,0,1
10884119,10884340,221,0,1,0,1
10884128,10884331,203,0,1,0,2
10884386,10884574,188,0,0,1,1
10884391,10884573,182,0,0,1,2
10884574,10884624,50,1,0,0,2
10884575,10884616,41,1,0,0,1
10884617,10884895,278,0,0,1,1
10884625,10884895,270,0,0,1,2
10884896,10884989,93,1,0,0,1
10884896,10884990,94,1,0,0,2
10884990,10885138,148,0,0,1,1
10884991,10885143,152,0,0,1,2
10885139,10885154,15,1,0,0,1
10885144,10885149,5,1,0,0,2
10885150,10886026,876,0,0,1,2
10885155,10886025,870,0,0,1,1
10886026,10886082,56,1,0,0,1
10886027,10886083,56,1,0,0,2
10886083,10886222,139,0,0,1,1
10886084,10886222,138,0,0,1,2
10886223,10886243,20,1,0,0,2
10886223,10886245,22,1,0,0,1
10886244,10886464,220,0,0,1,2
10886246,10886464,218,0,0,1,1
10886465,10886469,4,1,0,0,1
10886465,10886474,9,1,0,0,2
10886470,10888170,1700,0,0,1,1
10886475,10886684,209,0,0,1,2
10886685,10886697,12,1,0,0,2
10886698,10888337,1639,0,0,1,2
10888171,10888183,12,1,0,0,1
10888184,10888340,156,0,0,1,1
10888338,10888672,334,1,0,0,2
10888341,10888653,312,1,0,0,1
10888360,10888601,241,0,1,0,1
10888368,10888596,228,0,1,0,2
10888654,10888875,221,0,0,1,1
10888673,10888874,201,0,0,1,2
10888875,10888918,43,1,0,0,2
10888876,10888906,30,1,0,0,1
10888907,10889301,394,0,0,1,1
10888919,10889302,383,0,0,1,2
10889302,10889366,64,1,0,0,1
10889303,10889383,80,1,0,0,2
10889367,10889489,122,0,0,1,1
10889384,10889488,104,0,0,1,2
10889489,10889513,24,1,0,0,2
10889490,10889512,22,1,0,0,1
10889513,10889706,193,0,0,1,1
10889514,10889705,191,0,0,1,2
10889706,10889727,21,1,0,0,2
10889707,10889717,10,1,0,0,1
10889718,10890805,1087,0,0,1,1
10889728,10890805,1077,0,0,1,2
10890806,10890850,44,1,0,0,1
10890806,10890855,49,1,0,0,2
10890851,10892977,2126,0,0,1,1
10890856,10892987,2131,0,0,1,2
10892978,10893325,347,1,0,0,1
10892988,10893306,318,1,0,0,2
10893014,10893282,268,0,1,0,1
10893040,10893254,214,0,1,0,2
10893307,10893808,501,0,0,1,2
10893326,10893808,482,0,0,1,1
10893809,10893846,37,1,0,0,1
10893809,10893854,45,1,0,0,2
10893847,10894440,593,0,0,1,1
10893855,10894439,584,0,0,1,2
10894440,10894522,82,1,0,0,2
10894441,10894513,72,1,0,0,1
10894514,10894616,102,0,0,1,1
10894523,10894616,93,0,0,1,2
10894617,10894663,46,1,0,0,1
10894617,10894664,47,1,0,0,2
10894664,10896029,1365,0,0,1,1
10894665,10894901,236,0,0,1,2
10894902,10894915,13,1,0,0,2
10894916,10896030,1114,0,0,1,2
10896030,10896070,40,1,0,0,1
10896031,10896079,48,1,0,0,2
10896071,10899836,3765,0,0,1,1
10896080,10896370,290,0,0,1,2
10896371,10896380,9,1,0,0,2
10896381,10899835,3454,0,0,1,2
10899836,10899879,43,1,0,0,2
10899837,10899882,45,1,0,0,1
10899880,10900109,229,0,0,1,2
10899883,10900286,403,0,0,1,1
10900110,10900124,14,1,0,0,2
10900125,10900286,161,0,0,1,2
10900287,10900297,10,1,0,0,1
10900287,10900299,12,1,0,0,2
10900298,10901258,960,0,0,1,1
10900300,10901259,959,0,0,1,2
10901259,10901315,56,1,0,0,1
10901260,10901314,54,1,0,0,2
10901315,10901431,116,0,0,1,2
10901316,10901433,117,0,0,1,1
10901432,10901454,22,1,0,0,2
10901434,10901452,18,1,0,0,1
10901453,10901645,192,0,0,1,1
10901455,10901649,194,0,0,1,2
10901646,10901663,17,1,0,0,1
10901650,10901665,15,1,0,0,2
10901664,10901886,222,0,0,1,1
10901666,10901888,222,0,0,1,2
10901887,10901903,16,1,0,0,1
10901889,10901905,16,1,0,0,2
10901904,10903558,1654,0,0,1,1
10901906,10903554,1648,0,0,1,2
10903555,10903852,297,1,0,0,2
10903559,10903839,280,1,0,0,1
10903576,10903810,234,0,1,0,1
10903585,10903777,192,0,1,0,2
10903840,10904914,1074,0,0,1,1
10903853,10904912,1059,0,0,1,2
10904913,10904977,64,1,0,0,2
10904915,10904977,62,1,0,0,1
10904978,10905099,121,0,0,1,1
10904978,10905099,121,0,0,1,2
10905100,10905120,20,1,0,0,1
10905100,10905120,20,1,0,0,2
10905121,10905279,158,0,0,1,1
10905121,10905282,161,0,0,1,2
10905280,10905294,14,1,0,0,1
10905283,10905294,11,1,0,0,2
10905295,10906811,1516,0,0,1,2
10905295,10906813,1518,0,0,1,1
10906812,10906884,72,1,0,0,2
10906814,10906881,67,1,0,0,1
10906882,10907018,136,0,0,1,1
10906885,10907018,133,0,0,1,2
10907019,10907046,27,1,0,0,1
10907019,10907046,27,1,0,0,2
10907047,10907780,733,0,0,1,2
10907047,10907782,735,0,0,1,1
10907781,10907795,14,1,0,0,2
10907783,10907798,15,1,0,0,1
10907796,10908447,651,0,0,1,2
10907799,10908444,645,0,0,1,1
10908445,10908461,16,1,0,0,1
10908448,10908461,13,1,0,0,2
10908462,10908877,415,0,0,1,1
10908462,10908889,427,0,0,1,2
10908878,10909317,439,1,0,0,1
10908890,10909265,375,1,0,0,2
10908900,10909307,407,0,1,0,1
10908908,10909254,346,0,1,0,2
10909266,10909994,728,0,0,1,2
10909318,10909994,676,0,0,1,1
10909995,10910029,34,1,0,0,2
10909995,10910030,35,1,0,0,1
10910030,10910839,809,0,0,1,2
10910031,10910839,808,0,0,1,1
10910840,10910902,62,1,0,0,1
10910840,10910904,64,1,0,0,2
10910903,10911027,124,0,0,1,1
10910905,10911028,123,0,0,1,2
10911028,10911057,29,1,0,0,1
10911029,10911051,22,1,0,0,2
10911052,10911257,205,0,0,1,2
10911058,10911261,203,0,0,1,1
10911258,10911265,7,1,0,0,2
10911262,10911268,6,1,0,0,1
10911266,10912685,1419,0,0,1,2
10911269,10912684,1415,0,0,1,1
10912685,10912762,77,1,0,0,1
10912686,10912755,69,1,0,0,2
10912756,10912864,108,0,0,1,2
10912763,10912865,102,0,0,1,1
10912865,10912891,26,1,0,0,2
10912866,10912891,25,1,0,0,1
10912892,10913060,168,0,0,1,2
10912892,10913064,172,0,0,1,1
10913061,10913068,7,1,0,0,2
10913065,10913075,10,1,0,0,1
10913069,10914874,1805,0,0,1,2
10913076,10915069,1993,0,0,1,1
10914875,10914887,12,1,0,0,2
10914888,10915065,177,0,0,1,2
10915066,10915126,60,1,0,0,2
10915070,10915126,56,1,0,0,1
10915127,10915285,158,0,0,1,1
10915127,10915285,158,0,0,1,2
10915286,10915635,349,1,0,0,1
10915286,10915715,429,1,0,0,2
10915344,10915593,249,0,1,0,1
10915352,10915574,222,0,1,0,2
10915636,10915689,53,0,0,1,1
10915690,10915714,24,1,0,0,1
10915715,10916760,1045,0,0,1,1
10915716,10916760,1044,0,0,1,2
10916761,10916822,61,1,0,0,1
10916761,10916823,62,1,0,0,2
10916823,10916941,118,0,0,1,1
10916824,10916942,118,0,0,1,2
10916942,10916951,9,1,0,0,1
10916943,10916954,11,1,0,0,2
10916952,10917428,476,0,0,1,1
10916955,10917953,998,0,0,1,2
10917429,10917440,11,1,0,0,1
10917441,10917952,511,0,0,1,1
10917953,10917993,40,1,0,0,1
10917954,10917994,40,1,0,0,2
10917994,10918193,199,0,0,1,1
10917995,10918189,194,0,0,1,2
10918190,10918212,22,1,0,0,2
10918194,10918206,12,1,0,0,1
10918207,10918457,250,0,0,1,1
10918213,10918457,244,0,0,1,2
10918458,10918473,15,1,0,0,1
10918458,10918473,15,1,0,0,2
10918474,10918731,257,0,0,1,1
10918474,10918734,260,0,0,1,2
10918732,10918749,17,1,0,0,1
10918735,10918750,15,1,0,0,2
10918750,10920130,1380,0,0,1,1
10918751,10920138,1387,0,0,1,2
10920131,10921082,951,1,0,0,1
10920139,10921015,876,1,0,0,2
10920157,10921068,911,0,1,0,1
10920166,10921004,838,0,1,0,2
10921016,10921406,390,0,0,1,2
10921083,10921405,322,0,0,1,1
10921406,10921486,80,1,0,0,1
10921407,10921486,79,1,0,0,2
10921487,10921530,43,0,0,1,1
10921487,10921531,44,0,0,1,2
10921531,10921560,29,1,0,0,1
10921532,10921601,69,1,0,0,2
10921561,10921730,169,0,0,1,1
10921602,10921731,129,0,0,1,2
10921731,10921769,38,1,0,0,1
10921732,10921748,16,1,0,0,2
10921749,10922642,893,0,0,1,2
10921770,10922643,873,0,0,1,1
10922643,10922661,18,1,0,0,2
10922644,10922661,17,1,0,0,1
10922662,10923083,421,0,0,1,1
10922662,10923084,422,0,0,1,2
10923084,10923150,66,1,0,0,1
10923085,10923159,74,1,0,0,2
10923151,10923262,111,0,0,1,1
10923160,10923261,101,0,0,1,2
10923262,10923287,25,1,0,0,2
10923263,10923287,24,1,0,0,1
10923288,10923422,134,0,0,1,1
10923288,10923422,134,0,0,1,2
10923423,10923446,23,1,0,0,2
10923423,10923447,24,1,0,0,1
10923447,10923535,88,0,0,1,2
10923448,10923535,87,0,0,1,1
10923536,10923559,23,1,0,0,1
10923536,10923560,24,1,0,0,2
10923560,10923645,85,0,0,1,1
10923561,10923648,87,0,0,1,2
10923646,10923657,11,1,0,0,1
10923649,10923656,7,1,0,0,2
10923657,10923910,253,0,0,1,2
10923658,10923909,251,0,0,1,1
10923910,10923927,17,1,0,0,1
10923911,10923930,19,1,0,0,2
10923928,10924138,210,0,0,1,1
10923931,10924138,207,0,0,1,2
10924139,10924151,12,1,0,0,1
10924139,10924153,14,1,0,0,2
10924152,10924273,121,0,0,1,1
10924154,10924272,118,0,0,1,2
10924273,10924294,21,1,0,0,2
10924274,10924294,20,1,0,0,1
10924295,10924370,75,0,0,1,1
10924295,10924370,75,0,0,1,2
10924371,10924383,12,1,0,0,2
10924371,10924392,21,1,0,0,1
10924384,10925145,761,0,0,1,2
10924393,10925149,756,0,0,1,1
10925146,10925685,539,1,0,0,2
10925150,10925684,534,1,0,0,1
10925184,10925590,406,0,1,0,1
10925197,10925603,406,0,1,0,2
10925685,10925729,44,0,0,1,1
10925686,10925797,111,0,0,1,2
10925730,10925736,6,1,0,0,1
10925737,10925821,84,0,0,1,1
10925798,10926143,345,1,0,0,2
10925822,10926125,303,1,0,0,1
10925851,10926091,240,0,1,0,1
10925856,10926091,235,0,1,0,2
10926126,10926209,83,0,0,1,1
10926144,10926207,63,0,0,1,2
10926208,10926236,28,1,0,0,2
10926210,10926238,28,1,0,0,1
10926237,10926912,675,0,0,1,2
10926239,10926910,671,0,0,1,1
10926911,10927586,675,1,0,0,1
10926913,10927323,410,1,0,0,2
10927027,10927454,427,0,1,0,1
10927032,10927271,239,0,1,0,2
10927324,10927496,172,0,0,1,2
10927497,10927522,25,1,0,0,2
10927523,10927722,199,0,0,1,2
10927587,10927626,39,0,0,1,1
10927627,10927631,4,1,0,0,1
10927632,10927728,96,0,0,1,1
10927723,10927734,11,1,0,0,2
10927729,10927736,7,1,0,0,1
10927735,10927959,224,0,0,1,2
10927737,10927849,112,0,0,1,1
10927850,10927873,23,1,0,0,1
10927874,10929006,1132,0,0,1,1
10927960,10927970,10,1,0,0,2
10927971,10929006,1035,0,0,1,2
10929007,10929061,54,1,0,0,1
10929007,10929063,56,1,0,0,2
10929062,10929305,243,0,0,1,1
10929064,10929305,241,0,0,1,2
10929306,10929329,23,1,0,0,2
10929306,10929330,24,1,0,0,1
10929330,10930672,1342,0,0,1,2
10929331,10930674,1343,0,0,1,1
10930673,10930706,33,1,0,0,2
10930675,10930696,21,1,0,0,1
10930697,10931161,464,0,0,1,1
10930707,10931161,454,0,0,1,2
10931162,10931182,20,1,0,0,1
10931162,10931182,20,1,0,0,2
10931183,10931214,31,0,0,1,1
10931183,10931223,40,0,0,1,2
10931215,10931616,401,1,0,0,1
10931224,10931522,298,1,0,0,2
10931235,10931606,371,0,1,0,1
10931250,10931507,257,0,1,0,2
10931523,10932971,1448,0,0,1,2
10931617,10932971,1354,0,0,1,1
10932972,10933066,94,1,0,0,1
10932972,10933068,96,1,0,0,2
10933067,10933174,107,0,0,1,1
10933069,10933173,104,0,0,1,2
10933174,10933201,27,1,0,0,2
10933175,10933200,25,1,0,0,1
10933201,10933344,143,0,0,1,1
10933202,10933928,726,0,0,1,2
10933345,10933349,4,1,0,0,1
10933350,10934612,1262,0,0,1,1
10933929,10933939,10,1,0,0,2
10933940,10934330,390,0,0,1,2
10934331,10934341,10,1,0,0,2
10934342,10934612,270,0,0,1,2
10934613,10934677,64,1,0,0,1
10934613,10934680,67,1,0,0,2
10934678,10934837,159,0,0,1,1
10934681,10934838,157,0,0,1,2
10934838,10934855,17,1,0,0,1
10934839,10934858,19,1,0,0,2
10934856,10936743,1887,0,0,1,1
10934859,10936758,1899,0,0,1,2
10936744,10937354,610,1,0,0,1
10936759,10937283,524,1,0,0,2
10936773,10937287,514,0,1,0,1
10936786,10937264,478,0,1,0,2
10937284,10937332,48,0,0,1,2
10937333,10937362,29,1,0,0,2
10937355,10938292,937,0,0,1,1
10937363,10938292,929,0,0,1,2
10938293,10938347,54,1,0,0,1
10938293,10938356,63,1,0,0,2
10938348,10938466,118,0,0,1,1
10938357,10938468,111,0,0,1,2
10938467,10938487,20,1,0,0,1
10938469,10938498,29,1,0,0,2
10938488,10938668,180,0,0,1,1
10938499,10938666,167,0,0,1,2
10938667,10938693,26,1,0,0,2
10938669,10938686,17,1,0,0,1
10938687,10939588,901,0,0,1,1
10938694,10939587,893,0,0,1,2
10939588,10939653,65,1,0,0,2
10939589,10939652,63,1,0,0,1
10939653,10939965,312,0,0,1,1
10939654,10939964,310,0,0,1,2
10939965,10939987,22,1,0,0,2
10939966,10939987,21,1,0,0,1
10939988,10941625,1637,0,0,1,1
10939988,10941627,1639,0,0,1,2
10941626,10941994,368,1,0,0,1
10941628,10941960,332,1,0,0,2
10941644,10941978,334,0,1,0,1
10941657,10941946,289,0,1,0,2
10941961,10943123,1162,0,0,1,2
10941995,10943123,1128,0,0,1,1
10943124,10943147,23,1,0,0,1
10943124,10943162,38,1,0,0,2
10943148,10943276,128,0,0,1,1
10943163,10943274,111,0,0,1,2
10943275,10943293,18,1,0,0,2
10943277,10943293,16,1,0,0,1
10943294,10944652,1358,0,0,1,1
10943294,10944653,1359,0,0,1,2
10944653,10944727,74,1,0,0,1
10944654,10944727,73,1,0,0,2
10944728,10944836,108,0,0,1,1
10944728,10944836,108,0,0,1,2
10944837,10944857,20,1,0,0,2
10944837,10944858,21,1,0,0,1
10944858,10944990,132,0,0,1,2
10944859,10944987,128,0,0,1,1
10944988,10944999,11,1,0,0,1
10944991,10944999,8,1,0,0,2
10945000,10946778,1778,0,0,1,1
10945000,10946790,1790,0,0,1,2
10946779,10947152,373,1,0,0,1
10946791,10947126,335,1,0,0,2
10946808,10947142,334,0,1,0,1
10946844,10947097,253,0,1,0,2
10947127,10947171,44,0,0,1,2
10947153,10948291,1138,0,0,1,1
10947172,10947201,29,1,0,0,2
10947202,10948292,1090,0,0,1,2
10948292,10948361,69,1,0,0,1
10948293,10948371,78,1,0,0,2
10948362,10948564,202,0,0,1,1
10948372,10948566,194,0,0,1,2
10948565,10948589,24,1,0,0,1
10948567,10948590,23,1,0,0,2
10948590,10948743,153,0,0,1,1
10948591,10948741,150,0,0,1,2
10948742,10948752,10,1,0,0,2
10948744,10948755,11,1,0,0,1
10948753,10948885,132,0,0,1,2
10948756,10950057,1301,0,0,1,1
10948886,10948901,15,1,0,0,2
10948902,10950057,1155,0,0,1,2
10950058,10950106,48,1,0,0,2
10950058,10950108,50,1,0,0,1
10950107,10952116,2009,0,0,1,2
10950109,10952103,1994,0,0,1,1
10952104,10952622,518,1,0,0,1
10952117,10952485,368,1,0,0,2
10952129,10952613,484,0,1,0,1
10952163,10952456,293,0,1,0,2
10952486,10952767,281,0,0,1,2
10952623,10952768,145,0,0,1,1
10952768,10952811,43,1,0,0,2
10952769,10952810,41,1,0,0,1
10952811,10953972,1161,0,0,1,1
10952812,10953971,1159,0,0,1,2
10953972,10954025,53,1,0,0,2
10953973,10954028,55,1,0,0,1
10954026,10955339,1313,0,0,1,2
10954029,10955338,1309,0,0,1,1
10955339,10955397,58,1,0,0,1
10955340,10955405,65,1,0,0,2
10955398,10955603,205,0,0,1,1
10955406,10955604,198,0,0,1,2
10955604,10955622,18,1,0,0,1
10955605,10955623,18,1,0,0,2
10955623,10955801,178,0,0,1,1
10955624,10955796,172,0,0,1,2
10955797,10955813,16,1,0,0,2
10955802,10955813,11,1,0,0,1
10955814,10956475,661,0,0,1,2
10955814,10956829,1015,0,0,1,1
10956476,10956487,11,1,0,0,2
10956488,10956828,340,0,0,1,2
10956829,10956843,14,1,0,0,2
10956830,10956841,11,1,0,0,1
10956842,10957426,584,0,0,1,1
10956844,10957439,595,0,0,1,2
10957427,10957812,385,1,0,0,1
10957440,10957778,338,1,0,0,2
10957457,10957792,335,0,1,0,1
10957478,10957746,268,0,1,0,2
10957779,10957813,34,0,0,1,2
10957813,10958115,302,0,0,1,1
10957814,10957831,17,1,0,0,2
10957832,10958114,282,0,0,1,2
10958115,10958140,25,1,0,0,2
10958116,10958139,23,1,0,0,1
10958140,10958863,723,0,0,1,1
10958141,10958863,722,0,0,1,2
10958864,10958896,32,1,0,0,1
10958864,10958899,35,1,0,0,2
10958897,10959064,167,0,0,1,1
10958900,10959060,160,0,0,1,2
10959061,10959077,16,1,0,0,2
10959065,10959070,5,1,0,0,1
10959071,10959184,113,0,0,1,1
10959078,10959189,111,0,0,1,2
10959185,10959202,17,1,0,0,1
10959190,10959204,14,1,0,0,2
10959203,10960498,1295,0,0,1,1
10959205,10960499,1294,0,0,1,2
10960499,10960556,57,1,0,0,1
10960500,10960563,63,1,0,0,2
10960557,10962370,1813,0,0,1,1
10960564,10962370,1806,0,0,1,2
10962371,10962395,24,1,0,0,1
10962371,10962395,24,1,0,0,2
10962396,10962576,180,0,0,1,2
10962396,10962580,184,0,0,1,1
10962577,10962602,25,1,0,0,2
10962581,10963189,608,1,0,0,1
10962603,10962636,33,0,0,1,2
10962637,10963159,522,1,0,0,2
10962651,10963093,442,0,1,0,1
10962668,10963110,442,0,1,0,2
10963160,10963239,79,0,0,1,2
10963190,10963319,129,0,0,1,1
10963240,10963248,8,1,0,0,2
10963249,10963318,69,0,0,1,2
10963319,10963343,24,1,0,0,2
10963320,10963341,21,1,0,0,1
10963342,10964470,1128,0,0,1,1
10963344,10964470,1126,0,0,1,2
10964471,10964530,59,1,0,0,2
10964471,10964533,62,1,0,0,1
10964531,10964668,137,0,0,1,2
10964534,10964666,132,0,0,1,1
10964667,10964690,23,1,0,0,1
10964669,10964687,18,1,0,0,2
10964688,10964891,203,0,0,1,2
10964691,10964890,199,0,0,1,1
10964891,10964903,12,1,0,0,1
10964892,10964903,11,1,0,0,2
10964904,10965644,740,0,0,1,1
10964904,10965644,740,0,0,1,2
10965645,10965683,38,1,0,0,1
10965645,10965686,41,1,0,0,2
10965684,10965867,183,0,0,1,1
10965687,10965868,181,0,0,1,2
10965868,10965890,22,1,0,0,1
10965869,10965889,20,1,0,0,2
10965890,10967304,1414,0,0,1,2
10965891,10967304,1413,0,0,1,1
10967305,10967325,20,1,0,0,1
10967305,10967325,20,1,0,0,2
10967326,10967619,293,0,0,1,1
10967326,10967620,294,0,0,1,2
10967620,10968275,655,1,0,0,1
10967621,10968289,668,1,0,0,2
10967642,10968264,622,0,1,0,1
10967650,10968271,621,0,1,0,2
10968276,10968880,604,0,0,1,1
10968290,10968882,592,0,0,1,2
10968881,10968970,89,1,0,0,1
10968883,10968979,96,1,0,0,2
10968971,10969068,97,0,0,1,1
10968980,10969066,86,0,0,1,2
10969067,10969095,28,1,0,0,2
10969069,10969094,25,1,0,0,1
10969095,10969263,168,0,0,1,1
10969096,10969264,168,0,0,1,2
10969264,10969284,20,1,0,0,1
10969265,10969282,17,1,0,0,2
10969283,10969417,134,0,0,1,2
10969285,10969419,134,0,0,1,1
10969418,10969433,15,1,0,0,2
10969420,10969431,11,1,0,0,1
10969432,10970061,629,0,0,1,1
10969434,10970060,626,0,0,1,2
10970061,10970115,54,1,0,0,2
10970062,10970105,43,1,0,0,1
10970106,10970279,173,0,0,1,1
10970116,10970280,164,0,0,1,2
10970280,10970296,16,1,0,0,1
10970281,10970295,14,1,0,0,2
10970296,10971036,740,0,0,1,2
10970297,10971038,741,0,0,1,1
10971037,10971046,9,1,0,0,2
10971039,10971049,10,1,0,0,1
10971047,10971243,196,0,0,1,2
10971050,10971243,193,0,0,1,1
10971244,10971255,11,1,0,0,1
10971244,10971255,11,1,0,0,2
10971256,10972162,906,0,0,1,1
10971256,10972175,919,0,0,1,2
10972163,10972446,283,1,0,0,1
10972176,10972442,266,1,0,0,2
10972193,10972406,213,0,1,0,1
10972210,10972389,179,0,1,0,2
10972443,10972612,169,0,0,1,2
10972447,10972612,165,0,0,1,1
10972613,10972675,62,1,0,0,1
10972613,10972681,68,1,0,0,2
10972676,10972955,279,0,0,1,1
10972682,10972954,272,0,0,1,2
10972955,10973004,49,1,0,0,2
10972956,10973004,48,1,0,0,1
10973005,10973350,345,0,0,1,1
10973005,10973352,347,0,0,1,2
10973351,10973437,86,1,0,0,1
10973353,10973426,73,1,0,0,2
10973427,10973826,399,0,0,1,2
10973438,10973825,387,0,0,1,1
10973826,10973844,18,1,0,0,1
10973827,10973851,24,1,0,0,2
10973845,10974095,250,0,0,1,1
10973852,10974095,243,0,0,1,2
10974096,10974109,13,1,0,0,2
10974096,10974111,15,1,0,0,1
10974110,10974923,813,0,0,1,2
10974112,10974923,811,0,0,1,1
10974924,10974985,61,1,0,0,1
10974924,10974985,61,1,0,0,2
10974986,10977485,2499,0,0,1,1
10974986,10977485,2499,0,0,1,2
10977486,10977539,53,1,0,0,2
10977486,10977540,54,1,0,0,1
10977540,10978517,977,0,0,1,2
10977541,10978518,977,0,0,1,1
10978518,10978565,47,1,0,0,2
10978519,10978562,43,1,0,0,1
10978563,10978667,104,0,0,1,1
10978566,10978667,101,0,0,1,2
10978668,10978692,24,1,0,0,2
10978668,10978695,27,1,0,0,1
10978693,10979565,872,0,0,1,2
10978696,10978871,175,0,0,1,1
10978872,10978882,10,1,0,0,1
10978883,10979097,214,0,0,1,1
10979098,10979109,11,1,0,0,1
10979110,10979569,459,0,0,1,1
10979566,10979585,19,1,0,0,2
10979570,10979585,15,1,0,0,1
10979586,10980294,708,0,0,1,1
10979586,10980294,708,0,0,1,2
10980295,10980348,53,1,0,0,2
10980295,10980349,54,1,0,0,1
10980349,10982856,2507,0,0,1,2
10980350,10982855,2505,0,0,1,1
10982856,10982893,37,1,0,0,1
10982857,10982902,45,1,0,0,2
10982894,10983183,289,0,0,1,1
10982903,10983182,279,0,0,1,2
10983183,10983206,23,1,0,0,2
10983184,10983208,24,1,0,0,1
10983207,10984026,819,0,0,1,2
10983209,10984027,818,0,0,1,1
10984027,10984094,67,1,0,0,2
10984028,10984094,66,1,0,0,1
10984095,10984218,123,0,0,1,1
10984095,10984220,125,0,0,1,2
10984219,10984249,30,1,0,0,1
10984221,10984240,19,1,0,0,2
10984241,10984508,267,0,0,1,2
10984250,10984508,258,0,0,1,1
10984509,10984525,16,1,0,0,2
10984509,10984526,17,1,0,0,1
10984526,10984646,120,0,0,1,2
10984527,10984642,115,0,0,1,1
10984643,10984663,20,1,0,0,1
10984647,10984669,22,1,0,0,2
10984664,10985143,479,0,0,1,1
10984670,10985145,475,0,0,1,2
10985144,10985185,41,1,0,0,1
10985146,10985185,39,1,0,0,2
10985186,10985223,37,0,0,1,2
10985186,10985225,39,0,0,1,1
10985224,10985657,433,1,0,0,2
10985226,10985658,432,1,0,0,1
10985247,10985617,370,0,1,0,1
10985256,10985590,334,0,1,0,2
10985658,10985699,41,0,0,1,2
10985659,10986274,615,0,0,1,1
10985700,10985708,8,1,0,0,2
10985709,10986274,565,0,0,1,2
10986275,10986296,21,1,0,0,2
10986275,10986298,23,1,0,0,1
10986297,10987143,846,0,0,1,2
10986299,10987147,848,0,0,1,1
10987144,10987618,474,1,0,0,2
10987148,10987581,433,1,0,0,1
10987168,10987538,370,0,1,0,1
10987181,10987515,334,0,1,0,2
10987582,10988519,937,0,0,1,1
10987619,10988519,900,0,0,1,2
10988520,10988592,72,1,0,0,1
10988520,10988594,74,1,0,0,2
10988593,10988692,99,0,0,1,1
10988595,10988692,97,0,0,1,2
10988693,10988713,20,1,0,0,1
10988693,10988714,21,1,0,0,2
10988714,10988842,128,0,0,1,1
10988715,10988845,130,0,0,1,2
10988843,10988860,17,1,0,0,1
10988846,10988862,16,1,0,0,2
10988861,10989042,181,0,0,1,1
10988863,10989050,187,0,0,1,2
10989043,10989055,12,1,0,0,1
10989051,10989055,4,1,0,0,2
10989056,10989679,623,0,0,1,2
10989056,10989680,624,0,0,1,1
10989680,10989735,55,1,0,0,2
10989681,10989725,44,1,0,0,1
10989726,10989909,183,0,0,1,1
10989736,10989907,171,0,0,1,2
10989908,10989927,19,1,0,0,2
10989910,10989927,17,1,0,0,1
10989928,10992970,3042,0,0,1,1
10989928,10992970,3042,0,0,1,2
