start,end,duration,saccade,blink,fixation,eye
8479723,8479994,271,0,0,1,2
8479723,8479995,272,0,0,1,1
8479995,8480074,79,1,0,0,2
8479996,8480076,80,1,0,0,1
8480075,8480157,82,0,0,1,2
8480077,8480158,81,0,0,1,1
8480158,8480199,41,1,0,0,2
8480159,8480189,30,1,0,0,1
8480190,8480394,204,0,0,1,1
8480200,8480393,193,0,0,1,2
8480394,8480423,29,1,0,0,2
8480395,8480420,25,1,0,0,1
8480421,8481634,1213,0,0,1,1
8480424,8481637,1213,0,0,1,2
8481635,8481663,28,1,0,0,1
8481638,8481662,24,1,0,0,2
8481663,8482184,521,0,0,1,2
8481664,8482186,522,0,0,1,1
8482185,8482351,166,1,0,0,2
8482187,8482346,159,1,0,0,1
8482206,8482311,105,0,1,0,2
8482213,8482294,81,0,1,0,1
8482347,8482575,228,0,0,1,1
8482352,8482574,222,0,0,1,2
8482575,8482611,36,1,0,0,2
8482576,8482612,36,1,0,0,1
8482612,8482698,86,0,0,1,2
8482613,8482698,85,0,0,1,1
8482699,8482731,32,1,0,0,2
8482699,8482733,34,1,0,0,1
8482732,8483447,715,0,0,1,2
8482734,8483451,717,0,0,1,1
8483448,8483640,192,1,0,0,2
8483452,8483636,184,1,0,0,1
8483466,8483598,132,0,1,0,2
8483474,8483581,107,0,1,0,1
8483637,8484840,1203,0,0,1,1
8483641,8485189,1548,0,0,1,2
8484841,8484862,21,1,0,0,1
8484863,8485190,327,0,0,1,1
8485190,8485345,155,1,0,0,2
8485191,8485357,166,1,0,0,1
8485209,8485302,93,0,1,0,2
8485213,8485300,87,0,1,0,1
8485346,8486286,940,0,0,1,2
8485358,8485502,144,0,0,1,1
8485503,8485514,11,1,0,0,1
8485515,8486281,766,0,0,1,1
8486282,8486311,29,1,0,0,1
8486287,8486310,23,1,0,0,2
8486311,8487468,1157,0,0,1,2
8486312,8487468,1156,0,0,1,1
8487469,8487537,68,1,0,0,1
8487469,8487539,70,1,0,0,2
8487538,8487670,132,0,0,1,1
8487540,8487669,129,0,0,1,2
8487670,8487731,61,1,0,0,2
8487671,8487731,60,1,0,0,1
8487732,8487897,165,0,0,1,1
8487732,8487901,169,0,0,1,2
8487898,8487920,22,1,0,0,1
8487902,8487922,20,1,0,0,2
8487921,8488938,1017,0,0,1,1
8487923,8488939,1016,0,0,1,2
8488939,8488963,24,1,0,0,1
8488940,8488955,15,1,0,0,2
8488956,8491051,2095,0,0,1,2
8488964,8491049,2085,0,0,1,1
8491050,8491177,127,1,0,0,1
8491052,8491208,156,1,0,0,2
8491074,8491157,83,0,1,0,2
8491080,8491141,61,0,1,0,1
8491178,8491458,280,0,0,1,1
8491209,8491460,251,0,0,1,2
8491459,8491529,70,1,0,0,1
8491461,8491534,73,1,0,0,2
8491530,8491612,82,0,0,1,1
8491535,8491613,78,0,0,1,2
8491613,8491651,38,1,0,0,1
8491614,8491637,23,1,0,0,2
8491638,8491836,198,0,0,1,2
8491652,8491840,188,0,0,1,1
8491837,8491864,27,1,0,0,2
8491841,8491854,13,1,0,0,1
8491855,8492092,237,0,0,1,1
8491865,8493743,1878,0,0,1,2
8492093,8492109,16,1,0,0,1
8492110,8493743,1633,0,0,1,1
8493744,8493805,61,1,0,0,2
8493744,8493806,62,1,0,0,1
8493806,8494139,333,0,0,1,2
8493807,8494139,332,0,0,1,1
8494140,8494222,82,1,0,0,1
8494140,8494223,83,1,0,0,2
8494223,8494310,87,0,0,1,1
8494224,8494304,80,0,0,1,2
8494305,8494521,216,1,0,0,2
8494311,8494480,169,1,0,0,1
8494322,8494470,148,0,1,0,2
8494327,8494464,137,0,1,0,1
8494481,8494556,75,0,0,1,1
8494522,8494555,33,0,0,1,2
8494556,8494584,28,1,0,0,2
8494557,8494589,32,1,0,0,1
8494585,8496519,1934,0,0,1,2
8494590,8496519,1929,0,0,1,1
8496520,8496589,69,1,0,0,2
8496520,8496590,70,1,0,0,1
8496590,8496930,340,0,0,1,2
8496591,8496929,338,0,0,1,1
8496930,8497017,87,1,0,0,1
8496931,8497014,83,1,0,0,2
8497015,8497094,79,0,0,1,2
8497018,8497094,76,0,0,1,1
8497095,8497129,34,1,0,0,2
8497095,8497131,36,1,0,0,1
8497130,8497264,134,0,0,1,2
8497132,8498952,1820,0,0,1,1
8497265,8497279,14,1,0,0,2
8497280,8498951,1671,0,0,1,2
8498952,8499095,143,1,0,0,2
8498953,8499086,133,1,0,0,1
8498986,8499070,84,0,1,0,2
8498990,8499048,58,0,1,0,1
8499087,8499366,279,0,0,1,1
8499096,8499366,270,0,0,1,2
8499367,8499428,61,1,0,0,2
8499367,8499430,63,1,0,0,1
8499429,8499538,109,0,0,1,2
8499431,8499539,108,0,0,1,1
8499539,8499576,37,1,0,0,2
8499540,8499572,32,1,0,0,1
8499573,8500577,1004,0,0,1,1
8499577,8500579,1002,0,0,1,2
8500578,8500601,23,1,0,0,1
8500580,8500590,10,1,0,0,2
8500591,8500682,91,0,0,1,2
8500602,8501955,1353,0,0,1,1
8500683,8500687,4,1,0,0,2
8500688,8500819,131,0,0,1,2
8500820,8500842,22,1,0,0,2
8500843,8501954,1111,0,0,1,2
8501955,8502022,67,1,0,0,2
8501956,8502035,79,1,0,0,1
8502023,8502144,121,0,0,1,2
8502036,8502144,108,0,0,1,1
8502145,8502177,32,1,0,0,1
8502145,8502179,34,1,0,0,2
8502178,8502355,177,0,0,1,1
8502180,8502344,164,0,0,1,2
8502345,8502489,144,1,0,0,2
8502356,8502451,95,1,0,0,1
8502369,8502424,55,0,1,0,2
8502452,8504564,2112,0,0,1,1
8502490,8504228,1738,0,0,1,2
8504229,8504357,128,1,0,0,2
8504358,8504524,166,0,0,1,2
8504525,8504650,125,1,0,0,2
8504565,8504647,82,1,0,0,1
8504648,8504953,305,0,0,1,1
8504651,8504954,303,0,0,1,2
8504954,8505004,50,1,0,0,1
8504955,8505008,53,1,0,0,2
8505005,8505252,247,0,0,1,1
8505009,8505254,245,0,0,1,2
8505253,8505281,28,1,0,0,1
8505255,8505273,18,1,0,0,2
8505274,8505439,165,0,0,1,2
8505282,8505808,526,0,0,1,1
8505440,8505460,20,1,0,0,2
8505461,8505807,346,0,0,1,2
8505808,8505828,20,1,0,0,2
8505809,8505836,27,1,0,0,1
8505829,8506320,491,0,0,1,2
8505837,8507397,1560,0,0,1,1
8506321,8506336,15,1,0,0,2
8506337,8507396,1059,0,0,1,2
8507397,8507576,179,1,0,0,2
8507398,8507539,141,1,0,0,1
8507426,8507519,93,0,1,0,2
8507430,8507505,75,0,1,0,1
8507540,8507791,251,0,0,1,1
8507577,8507792,215,0,0,1,2
8507792,8507873,81,1,0,0,1
8507793,8507874,81,1,0,0,2
8507874,8507909,35,0,0,1,1
8507875,8507910,35,0,0,1,2
8507910,8507950,40,1,0,0,1
8507911,8507950,39,1,0,0,2
8507951,8508022,71,0,0,1,1
8507951,8508023,72,0,0,1,2
8508023,8508060,37,1,0,0,1
8508024,8508060,36,1,0,0,2
8508061,8508285,224,0,0,1,2
8508061,8508907,846,0,0,1,1
8508286,8508290,4,1,0,0,2
8508291,8508907,616,0,0,1,2
8508908,8508940,32,1,0,0,2
8508908,8508941,33,1,0,0,1
8508941,8509039,98,0,0,1,2
8508942,8509038,96,0,0,1,1
8509039,8509057,18,1,0,0,1
8509040,8509067,27,1,0,0,2
8509058,8509516,458,0,0,1,1
8509068,8509520,452,0,0,1,2
8509517,8509530,13,1,0,0,1
8509521,8509530,9,1,0,0,2
8509531,8510321,790,0,0,1,2
8509531,8510322,791,0,0,1,1
8510322,8510431,109,1,0,0,2
8510323,8510427,104,1,0,0,1
8510365,8510394,29,0,1,0,2
8510428,8510771,343,0,0,1,1
8510432,8510773,341,0,0,1,2
8510772,8510819,47,1,0,0,1
8510774,8510822,48,1,0,0,2
8510820,8510997,177,0,0,1,1
8510823,8510992,169,0,0,1,2
8510993,8511009,16,1,0,0,2
8510998,8511007,9,1,0,0,1
8511008,8511219,211,0,0,1,1
8511010,8511218,208,0,0,1,2
8511219,8511388,169,1,0,0,2
8511220,8511423,203,1,0,0,1
8511236,8511358,122,0,1,0,2
8511240,8511345,105,0,1,0,1
8511389,8512434,1045,0,0,1,2
8511424,8512435,1011,0,0,1,1
8512435,8512468,33,1,0,0,2
8512436,8512465,29,1,0,0,1
8512466,8513141,675,0,0,1,1
8512469,8513139,670,0,0,1,2
8513140,8513285,145,1,0,0,2
8513142,8513284,142,1,0,0,1
8513167,8513249,82,0,1,0,2
8513172,8513232,60,0,1,0,1
8513285,8513607,322,0,0,1,1
8513286,8513607,321,0,0,1,2
8513608,8513674,66,1,0,0,2
8513608,8513695,87,1,0,0,1
8513675,8513771,96,0,0,1,2
8513696,8513771,75,0,0,1,1
8513772,8513807,35,1,0,0,1
8513772,8513807,35,1,0,0,2
8513808,8514047,239,0,0,1,1
8513808,8514050,242,0,0,1,2
8514048,8514077,29,1,0,0,1
8514051,8514076,25,1,0,0,2
8514077,8514533,456,0,0,1,2
8514078,8515941,1863,0,0,1,1
8514534,8514539,5,1,0,0,2
8514540,8515942,1402,0,0,1,2
8515942,8515983,41,1,0,0,1
8515943,8516024,81,1,0,0,2
8515984,8516354,370,0,0,1,1
8516025,8516355,330,0,0,1,2
8516355,8516422,67,1,0,0,1
8516356,8516433,77,1,0,0,2
8516423,8516531,108,0,0,1,1
8516434,8516533,99,0,0,1,2
8516532,8516563,31,1,0,0,1
8516534,8516554,20,1,0,0,2
8516555,8516705,150,0,0,1,2
8516564,8516710,146,0,0,1,1
8516706,8516896,190,1,0,0,2
8516711,8516911,200,1,0,0,1
8516730,8516854,124,0,1,0,2
8516736,8516843,107,0,1,0,1
8516897,8518834,1937,0,0,1,2
8516912,8517068,156,0,0,1,1
8517069,8517087,18,1,0,0,1
8517088,8518835,1747,0,0,1,1
8518835,8518980,145,1,0,0,2
8518836,8518946,110,1,0,0,1
8518872,8518919,47,0,1,0,2
8518887,8518894,7,0,1,0,1
8518947,8519195,248,0,0,1,1
8518981,8519196,215,0,0,1,2
8519196,8519265,69,1,0,0,1
8519197,8519264,67,1,0,0,2
8519265,8519331,66,0,0,1,2
8519266,8519332,66,0,0,1,1
8519332,8519370,38,1,0,0,2
8519333,8519371,38,1,0,0,1
8519371,8519543,172,0,0,1,2
8519372,8519544,172,0,0,1,1
8519544,8519562,18,1,0,0,2
8519545,8519562,17,1,0,0,1
8519563,8519810,247,0,0,1,1
8519563,8519815,252,0,0,1,2
8519811,8519835,24,1,0,0,1
8519816,8519833,17,1,0,0,2
8519834,8521405,1571,0,0,1,2
8519836,8521406,1570,0,0,1,1
8521406,8521548,142,1,0,0,2
8521407,8521528,121,1,0,0,1
8521469,8521506,37,0,1,0,2
8521529,8521802,273,0,0,1,1
8521549,8521803,254,0,0,1,2
8521803,8521894,91,1,0,0,1
8521804,8521894,90,1,0,0,2
8521895,8522006,111,0,0,1,1
8521895,8522008,113,0,0,1,2
8522007,8522043,36,1,0,0,1
8522009,8522043,34,1,0,0,2
8522044,8522210,166,0,0,1,1
8522044,8522210,166,0,0,1,2
8522211,8522229,18,1,0,0,1
8522211,8522238,27,1,0,0,2
8522230,8522633,403,0,0,1,1
8522239,8522634,395,0,0,1,2
8522634,8522646,12,1,0,0,1
8522635,8522644,9,1,0,0,2
8522645,8524481,1836,0,0,1,2
8522647,8524480,1833,0,0,1,1
8524481,8524610,129,1,0,0,1
8524482,8524616,134,1,0,0,2
8524505,8524593,88,0,1,0,2
8524509,8524574,65,0,1,0,1
8524611,8524934,323,0,0,1,1
8524617,8524934,317,0,0,1,2
8524935,8525020,85,1,0,0,2
8524935,8525021,86,1,0,0,1
8525021,8525088,67,0,0,1,2
8525022,8525088,66,0,0,1,1
8525089,8525132,43,1,0,0,2
8525089,8525144,55,1,0,0,1
8525133,8525541,408,0,0,1,2
8525145,8525536,391,0,0,1,1
8525537,8525553,16,1,0,0,1
8525542,8525554,12,1,0,0,2
8525554,8525740,186,0,0,1,1
8525555,8525740,185,0,0,1,2
8525741,8525753,12,1,0,0,1
8525741,8525753,12,1,0,0,2
8525754,8527190,1436,0,0,1,1
8525754,8527191,1437,0,0,1,2
8527191,8527376,185,1,0,0,1
8527192,8527390,198,1,0,0,2
8527222,8527348,126,0,1,0,1
8527223,8527348,125,0,1,0,2
8527377,8527691,314,0,0,1,1
8527391,8527690,299,0,0,1,2
8527691,8527789,98,1,0,0,2
8527692,8527788,96,1,0,0,1
8527789,8527978,189,0,0,1,1
8527790,8528596,806,0,0,1,2
8527979,8527994,15,1,0,0,1
8527995,8530159,2164,0,0,1,1
8528597,8528667,70,1,0,0,2
8528668,8528725,57,0,0,1,2
8528726,8528959,233,1,0,0,2
8528960,8529035,75,0,0,1,2
8529036,8529155,119,1,0,0,2
8529156,8529188,32,0,0,1,2
8529189,8529249,60,1,0,0,2
8529250,8529422,172,0,0,1,2
8529423,8529433,10,1,0,0,2
8529434,8529584,150,0,0,1,2
8529585,8529601,16,1,0,0,2
8529602,8529810,208,0,0,1,2
8529811,8529868,57,1,0,0,2
8529869,8530160,291,0,0,1,2
8530160,8530228,68,1,0,0,1
8530161,8530227,66,1,0,0,2
8530228,8530316,88,0,0,1,2
8530229,8530315,86,0,0,1,1
8530316,8530424,108,1,0,0,1
8530317,8530418,101,1,0,0,2
8530419,8530490,71,0,0,1,2
8530425,8530490,65,0,0,1,1
8530491,8530531,40,1,0,0,2
8530491,8530538,47,1,0,0,1
8530532,8530803,271,0,0,1,2
8530539,8530802,263,0,0,1,1
8530803,8530818,15,1,0,0,1
8530804,8530813,9,1,0,0,2
8530814,8532897,2083,0,0,1,2
8530819,8532896,2077,0,0,1,1
8532897,8532953,56,1,0,0,1
8532898,8532951,53,1,0,0,2
8532952,8533327,375,0,0,1,2
8532954,8533196,242,0,0,1,1
8533197,8533209,12,1,0,0,1
8533210,8533328,118,0,0,1,1
8533328,8533428,100,1,0,0,2
8533329,8533425,96,1,0,0,1
8533426,8533506,80,0,0,1,1
8533429,8533507,78,0,0,1,2
8533507,8533540,33,1,0,0,1
8533508,8533532,24,1,0,0,2
8533533,8533656,123,0,0,1,2
8533541,8533668,127,0,0,1,1
8533657,8533877,220,1,0,0,2
8533669,8533822,153,1,0,0,1
8533672,8533825,153,0,1,0,2
8533689,8533769,80,0,1,0,1
8533823,8535148,1325,0,0,1,1
8533878,8535160,1282,0,0,1,2
8535149,8535178,29,1,0,0,1
8535161,8535165,4,1,0,0,2
8535166,8535813,647,0,0,1,2
8535179,8535813,634,0,0,1,1
8535814,8535903,89,1,0,0,2
8535814,8535913,99,1,0,0,1
8535904,8536214,310,0,0,1,2
8535914,8536213,299,0,0,1,1
8536214,8536299,85,1,0,0,1
8536215,8536300,85,1,0,0,2
8536300,8536408,108,0,0,1,1
8536301,8536409,108,0,0,1,2
8536409,8536442,33,1,0,0,1
8536410,8536432,22,1,0,0,2
8536433,8538150,1717,0,0,1,2
8536443,8538155,1712,0,0,1,1
8538151,8538267,116,1,0,0,2
8538156,8538240,84,1,0,0,1
8538189,8538194,5,0,1,0,2
8538241,8539028,787,0,0,1,1
8538268,8539027,759,0,0,1,2
8539028,8539114,86,1,0,0,2
8539029,8539106,77,1,0,0,1
8539107,8539255,148,0,0,1,1
8539115,8539255,140,0,0,1,2
8539256,8539335,79,1,0,0,2
8539256,8539345,89,1,0,0,1
8539336,8539483,147,0,0,1,2
8539346,8539482,136,0,0,1,1
8539483,8539515,32,1,0,0,1
8539484,8539514,30,1,0,0,2
8539515,8539691,176,0,0,1,2
8539516,8539693,177,0,0,1,1
8539692,8539712,20,1,0,0,2
8539694,8539710,16,1,0,0,1
8539711,8539966,255,0,0,1,1
8539713,8539967,254,0,0,1,2
8539967,8539980,13,1,0,0,1
8539968,8539978,10,1,0,0,2
8539979,8541677,1698,0,0,1,2
8539981,8541680,1699,0,0,1,1
8541678,8541875,197,1,0,0,2
8541681,8541833,152,1,0,0,1
8541697,8541828,131,0,1,0,2
8541703,8541805,102,0,1,0,1
8541834,8542157,323,0,0,1,1
8541876,8542157,281,0,0,1,2
8542158,8542246,88,1,0,0,1
8542158,8542257,99,1,0,0,2
8542247,8542346,99,0,0,1,1
8542258,8542345,87,0,0,1,2
8542346,8542380,34,1,0,0,2
8542347,8542385,38,1,0,0,1
8542381,8542919,538,0,0,1,2
8542386,8543541,1155,0,0,1,1
8542920,8542930,10,1,0,0,2
8542931,8543542,611,0,0,1,2
8543542,8543574,32,1,0,0,1
8543543,8543574,31,1,0,0,2
8543575,8544915,1340,0,0,1,2
8543575,8544916,1341,0,0,1,1
8544916,8545021,105,1,0,0,2
8544917,8545018,101,1,0,0,1
8545019,8545385,366,0,0,1,1
8545022,8545386,364,0,0,1,2
8545386,8545449,63,1,0,0,1
8545387,8545439,52,1,0,0,2
8545440,8545516,76,0,0,1,2
8545450,8545516,66,0,0,1,1
8545517,8545549,32,1,0,0,1
8545517,8545549,32,1,0,0,2
8545550,8545700,150,0,0,1,2
8545550,8545701,151,0,0,1,1
8545701,8545719,18,1,0,0,2
8545702,8545727,25,1,0,0,1
8545720,8545744,24,0,0,1,2
8545728,8545756,28,0,0,1,1
8545745,8545971,226,1,0,0,2
8545757,8545916,159,1,0,0,1
8545766,8545915,149,0,1,0,2
8545784,8545877,93,0,1,0,1
8545917,8546047,130,0,0,1,1
8545972,8546050,78,0,0,1,2
8546048,8546062,14,1,0,0,1
8546051,8546062,11,1,0,0,2
8546063,8546238,175,0,0,1,2
8546063,8546240,177,0,0,1,1
8546239,8546249,10,1,0,0,2
8546241,8546251,10,1,0,0,1
8546250,8547586,1336,0,0,1,2
8546252,8547586,1334,0,0,1,1
8547587,8547612,25,1,0,0,1
8547587,8547631,44,1,0,0,2
8547613,8548032,419,0,0,1,1
8547632,8548033,401,0,0,1,2
8548033,8548117,84,1,0,0,1
8548034,8548110,76,1,0,0,2
8548111,8548188,77,0,0,1,2
8548118,8548187,69,0,0,1,1
8548188,8548222,34,1,0,0,1
8548189,8548218,29,1,0,0,2
8548219,8548398,179,0,0,1,2
8548223,8549196,973,0,0,1,1
8548399,8548424,25,1,0,0,2
8548425,8549196,771,0,0,1,2
8549197,8549225,28,1,0,0,2
8549197,8549226,29,1,0,0,1
8549226,8550235,1009,0,0,1,2
8549227,8550236,1009,0,0,1,1
8550236,8550349,113,1,0,0,2
8550237,8550359,122,1,0,0,1
8550268,8550320,52,0,1,0,2
8550273,8550310,37,0,1,0,1
8550350,8550684,334,0,0,1,2
8550360,8550684,324,0,0,1,1
8550685,8550763,78,1,0,0,1
8550685,8550769,84,1,0,0,2
8550764,8550858,94,0,0,1,1
8550770,8550858,88,0,0,1,2
8550859,8550890,31,1,0,0,1
8550859,8550893,34,1,0,0,2
8550891,8553262,2371,0,0,1,1
8550894,8553262,2368,0,0,1,2
8553263,8553327,64,1,0,0,2
8553263,8553334,71,1,0,0,1
8553328,8553713,385,0,0,1,2
8553335,8553714,379,0,0,1,1
8553714,8553785,71,1,0,0,2
8553715,8553794,79,1,0,0,1
8553786,8553865,79,0,0,1,2
8553795,8553866,71,0,0,1,1
8553866,8553899,33,1,0,0,2
8553867,8553889,22,1,0,0,1
8553890,8554161,271,0,0,1,1
8553900,8554156,256,0,0,1,2
8554157,8554389,232,1,0,0,2
8554162,8554329,167,1,0,0,1
8554175,8554345,170,0,1,0,2
8554184,8554292,108,0,1,0,1
8554330,8556333,2003,0,0,1,1
8554390,8556333,1943,0,0,1,2
8556334,8556410,76,1,0,0,1
8556334,8556412,78,1,0,0,2
8556411,8556756,345,0,0,1,1
8556413,8556757,344,0,0,1,2
8556757,8556848,91,1,0,0,1
8556758,8556849,91,1,0,0,2
8556849,8556920,71,0,0,1,1
8556850,8556921,71,0,0,1,2
8556921,8556962,41,1,0,0,1
8556922,8556959,37,1,0,0,2
8556960,8557114,154,0,0,1,2
8556963,8557116,153,0,0,1,1
8557115,8557141,26,1,0,0,2
8557117,8557137,20,1,0,0,1
8557138,8557753,615,0,0,1,1
8557142,8557748,606,0,0,1,2
8557749,8557776,27,1,0,0,2
8557754,8557777,23,1,0,0,1
8557777,8558814,1037,0,0,1,2
8557778,8558815,1037,0,0,1,1
8558815,8558845,30,1,0,0,2
8558816,8558834,18,1,0,0,1
8558835,8559373,538,0,0,1,1
8558846,8559373,527,0,0,1,2
8559374,8559440,66,1,0,0,1
8559374,8559442,68,1,0,0,2
8559441,8559803,362,0,0,1,1
8559443,8559802,359,0,0,1,2
8559803,8559832,29,1,0,0,2
8559804,8559832,28,1,0,0,1
8559833,8559986,153,0,0,1,1
8559833,8559987,154,0,0,1,2
8559987,8560018,31,1,0,0,1
8559988,8560016,28,1,0,0,2
8560017,8560178,161,0,0,1,2
8560019,8560183,164,0,0,1,1
8560179,8560351,172,1,0,0,2
8560184,8560365,181,1,0,0,1
8560204,8560318,114,0,1,0,2
8560215,8560297,82,0,1,0,1
8560352,8560830,478,0,0,1,2
8560366,8560826,460,0,0,1,1
8560827,8560854,27,1,0,0,1
8560831,8560854,23,1,0,0,2
8560855,8562728,1873,0,0,1,2
8560855,8562729,1874,0,0,1,1
8562729,8562810,81,1,0,0,2
8562730,8562821,91,1,0,0,1
8562811,8562885,74,0,0,1,2
8562822,8562885,63,0,0,1,1
8562886,8562925,39,1,0,0,2
8562886,8562931,45,1,0,0,1
8562926,8563026,100,0,0,1,2
8562932,8563023,91,0,0,1,1
8563024,8563055,31,1,0,0,1
8563027,8563046,19,1,0,0,2
8563047,8563263,216,0,0,1,2
8563056,8563479,423,0,0,1,1
8563264,8563277,13,1,0,0,2
8563278,8563464,186,0,0,1,2
8563465,8563824,359,1,0,0,2
8563480,8563685,205,1,0,0,1
8563486,8563713,227,0,1,0,2
8563499,8563650,151,0,1,0,1
8563686,8563790,104,0,0,1,1
8563791,8563813,22,1,0,0,1
8563814,8565386,1572,0,0,1,1
8563825,8565387,1562,0,0,1,2
8565387,8565449,62,1,0,0,1
8565388,8565457,69,1,0,0,2
8565450,8565685,235,0,0,1,1
8565458,8565687,229,0,0,1,2
8565686,8565737,51,1,0,0,1
8565688,8565737,49,1,0,0,2
8565738,8565954,216,0,0,1,2
8565738,8565956,218,0,0,1,1
8565955,8566046,91,1,0,0,2
8565957,8566050,93,1,0,0,1
8566047,8566165,118,0,0,1,2
8566051,8566164,113,0,0,1,1
8566165,8566196,31,1,0,0,1
8566166,8566185,19,1,0,0,2
8566186,8568576,2390,0,0,1,2
8566197,8568575,2378,0,0,1,1
8568576,8568774,198,1,0,0,1
8568577,8568794,217,1,0,0,2
8568608,8568753,145,0,1,0,2
8568612,8568751,139,0,1,0,1
8568775,8569016,241,0,0,1,1
8568795,8569016,221,0,0,1,2
8569017,8569074,57,1,0,0,1
8569017,8569075,58,1,0,0,2
8569075,8569194,119,0,0,1,1
8569076,8569193,117,0,0,1,2
8569194,8569223,29,1,0,0,2
8569195,8569212,17,1,0,0,1
8569213,8570913,1700,0,0,1,1
8569224,8571497,2273,0,0,1,2
8570914,8570929,15,1,0,0,1
8570930,8571495,565,0,0,1,1
8571496,8571521,25,1,0,0,1
8571498,8571522,24,1,0,0,2
8571522,8571947,425,0,0,1,1
8571523,8571949,426,0,0,1,2
8571948,8572012,64,1,0,0,1
8571950,8572013,63,1,0,0,2
8572013,8572310,297,0,0,1,1
8572014,8572308,294,0,0,1,2
8572309,8572501,192,1,0,0,2
8572311,8572512,201,1,0,0,1
8572326,8572463,137,0,1,0,2
8572331,8572465,134,0,1,0,1
8572502,8572644,142,0,0,1,2
8572513,8572644,131,0,0,1,1
8572645,8572673,28,1,0,0,2
8572645,8572675,30,1,0,0,1
8572674,8573049,375,0,0,1,2
8572676,8574777,2101,0,0,1,1
8573050,8573060,10,1,0,0,2
8573061,8574775,1714,0,0,1,2
8574776,8574906,130,1,0,0,2
8574778,8574913,135,1,0,0,1
8574805,8574872,67,0,1,0,2
8574810,8574853,43,0,1,0,1
8574907,8575264,357,0,0,1,2
8574914,8575264,350,0,0,1,1
8575265,8575354,89,1,0,0,1
8575265,8575358,93,1,0,0,2
8575355,8575444,89,0,0,1,1
8575359,8575443,84,0,0,1,2
8575444,8575478,34,1,0,0,2
8575445,8575478,33,1,0,0,1
8575479,8575656,177,0,0,1,1
8575479,8575658,179,0,0,1,2
8575657,8575687,30,1,0,0,1
8575659,8575686,27,1,0,0,2
8575687,8577878,2191,0,0,1,2
8575688,8577877,2189,0,0,1,1
8577878,8578039,161,1,0,0,1
8577879,8578050,171,1,0,0,2
8577927,8577995,68,0,1,0,2
8577931,8577996,65,0,1,0,1
8578040,8578261,221,0,0,1,1
8578051,8578258,207,0,0,1,2
8578259,8578292,33,1,0,0,2
8578262,8578283,21,1,0,0,1
8578284,8578379,95,0,0,1,1
8578293,8578378,85,0,0,1,2
8578379,8578451,72,1,0,0,2
8578380,8578453,73,1,0,0,1
8578452,8578489,37,0,0,1,2
8578454,8578488,34,0,0,1,1
8578489,8578529,40,1,0,0,1
8578490,8578521,31,1,0,0,2
8578522,8578628,106,0,0,1,2
8578530,8578629,99,0,0,1,1
8578629,8578649,20,1,0,0,2
8578630,8578657,27,1,0,0,1
8578650,8580853,2203,0,0,1,2
8578658,8580850,2192,0,0,1,1
8580851,8580910,59,1,0,0,1
8580854,8580909,55,1,0,0,2
8580910,8581251,341,0,0,1,2
8580911,8581251,340,0,0,1,1
8581252,8581343,91,1,0,0,2
8581252,8581353,101,1,0,0,1
8581344,8581401,57,0,0,1,2
8581354,8581402,48,0,0,1,1
8581402,8581452,50,1,0,0,2
8581403,8581458,55,1,0,0,1
8581453,8581599,146,0,0,1,2
8581459,8581594,135,0,0,1,1
8581595,8581611,16,1,0,0,1
8581600,8581610,10,1,0,0,2
8581611,8581999,388,0,0,1,2
8581612,8581999,387,0,0,1,1
8582000,8582019,19,1,0,0,2
8582000,8582020,20,1,0,0,1
8582020,8582332,312,0,0,1,2
8582021,8582331,310,0,0,1,1
8582332,8582353,21,1,0,0,1
8582333,8582343,10,1,0,0,2
8582344,8584050,1706,0,0,1,2
8582354,8584048,1694,0,0,1,1
8584049,8584121,72,1,0,0,1
8584051,8584133,82,1,0,0,2
8584122,8584464,342,0,0,1,1
8584134,8584463,329,0,0,1,2
8584464,8584500,36,1,0,0,2
8584465,8584494,29,1,0,0,1
8584495,8584603,108,0,0,1,1
8584501,8584603,102,0,0,1,2
8584604,8584637,33,1,0,0,2
8584604,8584638,34,1,0,0,1
8584638,8584884,246,0,0,1,2
8584639,8584887,248,0,0,1,1
8584885,8585078,193,1,0,0,2
8584888,8585081,193,1,0,0,1
8584910,8585021,111,0,1,0,2
8584920,8585008,88,0,1,0,1
8585079,8585267,188,0,0,1,2
8585082,8585103,21,0,0,1,1
8585104,8585108,4,1,0,0,1
8585109,8585261,152,0,0,1,1
8585262,8585280,18,1,0,0,1
8585268,8585279,11,1,0,0,2
8585280,8587504,2224,0,0,1,2
8585281,8587504,2223,0,0,1,1
8587505,8587620,115,1,0,0,1
8587505,8587642,137,1,0,0,2
8587538,8587593,55,0,1,0,2
8587554,8587565,11,0,1,0,1
8587621,8587978,357,0,0,1,1
8587643,8587977,334,0,0,1,2
8587978,8588041,63,1,0,0,2
8587979,8588044,65,1,0,0,1
8588042,8588125,83,0,0,1,2
8588045,8588125,80,0,0,1,1
8588126,8588162,36,1,0,0,1
8588126,8588164,38,1,0,0,2
8588163,8589420,1257,0,0,1,1
8588165,8589420,1255,0,0,1,2
8589421,8589522,101,1,0,0,1
8589421,8589542,121,1,0,0,2
8589450,8589487,37,0,1,0,2
8589523,8589746,223,0,0,1,1
8589543,8589751,208,0,0,1,2
8589747,8589772,25,1,0,0,1
8589752,8589764,12,1,0,0,2
8589765,8591246,1481,0,0,1,2
8589773,8591244,1471,0,0,1,1
8591245,8591376,131,1,0,0,1
8591247,8591396,149,1,0,0,2
8591284,8591358,74,0,1,0,2
8591298,8591337,39,0,1,0,1
8591377,8591688,311,0,0,1,1
8591397,8591687,290,0,0,1,2
8591688,8591757,69,1,0,0,2
8591689,8591751,62,1,0,0,1
8591752,8591843,91,0,0,1,1
8591758,8591842,84,0,0,1,2
8591843,8591877,34,1,0,0,2
8591844,8591868,24,1,0,0,1
8591869,8592056,187,0,0,1,1
8591878,8592058,180,0,0,1,2
8592057,8592075,18,1,0,0,1
8592059,8592075,16,1,0,0,2
8592076,8592611,535,0,0,1,1
8592076,8592615,539,0,0,1,2
8592612,8592639,27,1,0,0,1
8592616,8592628,12,1,0,0,2
8592629,8593160,531,0,0,1,2
8592640,8593161,521,0,0,1,1
8593161,8593188,27,1,0,0,2
8593162,8593188,26,1,0,0,1
8593189,8594207,1018,0,0,1,1
8593189,8594776,1587,0,0,1,2
8594208,8594233,25,1,0,0,1
8594234,8594777,543,0,0,1,1
8594777,8594936,159,1,0,0,2
8594778,8594922,144,1,0,0,1
8594817,8594889,72,0,1,0,2
8594827,8594873,46,0,1,0,1
8594923,8595213,290,0,0,1,1
8594937,8595212,275,0,0,1,2
8595213,8595282,69,1,0,0,2
8595214,8595284,70,1,0,0,1
8595283,8595425,142,0,0,1,2
8595285,8595673,388,0,0,1,1
8595426,8595444,18,1,0,0,2
8595445,8595672,227,0,0,1,2
8595673,8595886,213,1,0,0,2
8595674,8595850,176,1,0,0,1
8595692,8595824,132,0,1,0,2
8595701,8595809,108,0,1,0,1
8595851,8597262,1411,0,0,1,1
8595887,8597261,1374,0,0,1,2
8597262,8597296,34,1,0,0,2
8597263,8597296,33,1,0,0,1
8597297,8597705,408,0,0,1,2
8597297,8597706,409,0,0,1,1
8597706,8597750,44,1,0,0,2
8597707,8597749,42,1,0,0,1
8597750,8598175,425,0,0,1,1
8597751,8598177,426,0,0,1,2
8598176,8598262,86,1,0,0,1
8598178,8598251,73,1,0,0,2
8598252,8598342,90,0,0,1,2
8598263,8598341,78,0,0,1,1
8598342,8598376,34,1,0,0,1
8598343,8598376,33,1,0,0,2
8598377,8598573,196,0,0,1,1
8598377,8598574,197,0,0,1,2
8598574,8598585,11,1,0,0,1
8598575,8598586,11,1,0,0,2
8598586,8599090,504,0,0,1,1
8598587,8599076,489,0,0,1,2
8599077,8599258,181,1,0,0,2
8599091,8599179,88,1,0,0,1
8599091,8599228,137,0,1,0,2
8599112,8599142,30,0,1,0,1
8599180,8599390,210,0,0,1,1
8599259,8599391,132,0,0,1,2
8599391,8599411,20,1,0,0,1
8599392,8599403,11,1,0,0,2
8599404,8600443,1039,0,0,1,2
8599412,8600442,1030,0,0,1,1
8600443,8600581,138,1,0,0,1
8600444,8600585,141,1,0,0,2
8600469,8600558,89,0,1,0,2
8600477,8600542,65,0,1,0,1
8600582,8600902,320,0,0,1,1
8600586,8600902,316,0,0,1,2
8600903,8600928,25,1,0,0,1
8600903,8600938,35,1,0,0,2
8600929,8601042,113,0,0,1,1
8600939,8601042,103,0,0,1,2
8601043,8601063,20,1,0,0,2
8601043,8601072,29,1,0,0,1
8601064,8601467,403,0,0,1,2
8601073,8601464,391,0,0,1,1
8601465,8601492,27,1,0,0,1
8601468,8601484,16,1,0,0,2
8601485,8603040,1555,0,0,1,2
8601493,8603039,1546,0,0,1,1
8603040,8603077,37,1,0,0,1
8603041,8603075,34,1,0,0,2
8603076,8603491,415,0,0,1,2
8603078,8603492,414,0,0,1,1
8603492,8603531,39,1,0,0,2
8603493,8603533,40,1,0,0,1
8603532,8603923,391,0,0,1,2
8603534,8603932,398,0,0,1,1
8603924,8604052,128,1,0,0,2
8603933,8603981,48,1,0,0,1
8603945,8603992,47,0,1,0,2
8603982,8604221,239,0,0,1,1
8604053,8604222,169,0,0,1,2
8604222,8604241,19,1,0,0,1
8604223,8604237,14,1,0,0,2
8604238,8604908,670,0,0,1,2
8604242,8604912,670,0,0,1,1
8604909,8604933,24,1,0,0,2
8604913,8604923,10,1,0,0,1
8604924,8605672,748,0,0,1,1
8604934,8605673,739,0,0,1,2
8605673,8605710,37,1,0,0,1
8605674,8605700,26,1,0,0,2
8605701,8606129,428,0,0,1,2
8605711,8606128,417,0,0,1,1
8606129,8606195,66,1,0,0,1
8606130,8606208,78,1,0,0,2
8606196,8606311,115,0,0,1,1
8606209,8606312,103,0,0,1,2
8606312,8606343,31,1,0,0,1
8606313,8606341,28,1,0,0,2
8606342,8606572,230,0,0,1,2
8606344,8606578,234,0,0,1,1
8606573,8606835,262,1,0,0,2
8606579,8606816,237,1,0,0,1
8606592,8606790,198,0,1,0,2
8606597,8606786,189,0,1,0,1
8606817,8606860,43,0,0,1,1
8606836,8606859,23,0,0,1,2
8606860,8606881,21,1,0,0,2
8606861,8606877,16,1,0,0,1
8606878,8607862,984,0,0,1,1
8606882,8607864,982,0,0,1,2
8607863,8607893,30,1,0,0,1
8607865,8607885,20,1,0,0,2
8607886,8608339,453,0,0,1,2
8607894,8608337,443,0,0,1,1
8608338,8608383,45,1,0,0,1
8608340,8608396,56,1,0,0,2
8608384,8608740,356,0,0,1,1
8608397,8608742,345,0,0,1,2
8608741,8608795,54,1,0,0,1
8608743,8608797,54,1,0,0,2
8608796,8608929,133,0,0,1,1
8608798,8608928,130,0,0,1,2
8608929,8608954,25,1,0,0,2
8608930,8608948,18,1,0,0,1
8608949,8611015,2066,0,0,1,1
8608955,8611015,2060,0,0,1,2
8611016,8611057,41,1,0,0,1
8611016,8611057,41,1,0,0,2
8611058,8611418,360,0,0,1,2
8611058,8611419,361,0,0,1,1
8611419,8611491,72,1,0,0,2
8611420,8611491,71,1,0,0,1
8611492,8611599,107,0,0,1,1
8611492,8611599,107,0,0,1,2
8611600,8611634,34,1,0,0,2
8611600,8611637,37,1,0,0,1
8611635,8612142,507,0,0,1,2
8611638,8611851,213,0,0,1,1
8611852,8611861,9,1,0,0,1
8611862,8612149,287,0,0,1,1
8612143,8612281,138,1,0,0,2
8612150,8612261,111,1,0,0,1
8612168,8612243,75,0,1,0,2
8612180,8612216,36,0,1,0,1
8612262,8612644,382,0,0,1,1
8612282,8612643,361,0,0,1,2
8612644,8612655,11,1,0,0,2
8612645,8612657,12,1,0,0,1
8612656,8613164,508,0,0,1,2
8612658,8613161,503,0,0,1,1
8613162,8613188,26,1,0,0,1
8613165,8613181,16,1,0,0,2
8613182,8613840,658,0,0,1,2
8613189,8613840,651,0,0,1,1
8613841,8613879,38,1,0,0,2
8613841,8613887,46,1,0,0,1
8613880,8614186,306,0,0,1,2
8613888,8614186,298,0,0,1,1
8614187,8614272,85,1,0,0,2
8614187,8614273,86,1,0,0,1
8614273,8614319,46,0,0,1,2
8614274,8614320,46,0,0,1,1
8614320,8614358,38,1,0,0,2
8614321,8614358,37,1,0,0,1
8614359,8614456,97,0,0,1,1
8614359,8614457,98,0,0,1,2
8614457,8614493,36,1,0,0,1
8614458,8614492,34,1,0,0,2
8614493,8614602,109,0,0,1,2
8614494,8614616,122,0,0,1,1
8614603,8614814,211,1,0,0,2
8614617,8614778,161,1,0,0,1
8614618,8614781,163,0,1,0,2
8614635,8614734,99,0,1,0,1
8614779,8614947,168,0,0,1,1
8614815,8614947,132,0,0,1,2
8614948,8614964,16,1,0,0,2
8614948,8614965,17,1,0,0,1
8614965,8616678,1713,0,0,1,2
8614966,8616676,1710,0,0,1,1
8616677,8616743,66,1,0,0,1
8616679,8616735,56,1,0,0,2
8616736,8617145,409,0,0,1,2
8616744,8617142,398,0,0,1,1
8617143,8617222,79,1,0,0,1
8617146,8617223,77,1,0,0,2
8617223,8617308,85,0,0,1,1
8617224,8617309,85,0,0,1,2
8617309,8617346,37,1,0,0,1
8617310,8617347,37,1,0,0,2
8617347,8617527,180,0,0,1,1
8617348,8617520,172,0,0,1,2
8617521,8617540,19,1,0,0,2
8617528,8617538,10,1,0,0,1
8617539,8618587,1048,0,0,1,1
8617541,8618589,1048,0,0,1,2
8618588,8618609,21,1,0,0,1
8618590,8618608,18,1,0,0,2
8618609,8619138,529,0,0,1,2
8618610,8619138,528,0,0,1,1
8619139,8619172,33,1,0,0,1
8619139,8619172,33,1,0,0,2
8619173,8619541,368,0,0,1,1
8619173,8619541,368,0,0,1,2
8619542,8619662,120,1,0,0,1
8619542,8619678,136,1,0,0,2
8619581,8619638,57,0,1,0,2
8619598,8619609,11,0,1,0,1
8619663,8620002,339,0,0,1,1
8619679,8620003,324,0,0,1,2
8620003,8620085,82,1,0,0,1
8620004,8620072,68,1,0,0,2
8620073,8620215,142,0,0,1,2
8620086,8620214,128,0,0,1,1
8620215,8620234,19,1,0,0,1
8620216,8620242,26,1,0,0,2
8620235,8621911,1676,0,0,1,1
8620243,8621914,1671,0,0,1,2
8621912,8622018,106,1,0,0,1
8621915,8622035,120,1,0,0,2
8621928,8622012,84,0,1,0,2
8621948,8621957,9,0,1,0,1
8622019,8622349,330,0,0,1,1
8622036,8622347,311,0,0,1,2
8622348,8622376,28,1,0,0,2
8622350,8622388,38,1,0,0,1
8622377,8622730,353,0,0,1,2
8622389,8622728,339,0,0,1,1
8622729,8622802,73,1,0,0,1
8622731,8622802,71,1,0,0,2
8622803,8622835,32,0,0,1,2
8622803,8622836,33,0,0,1,1
8622836,8622869,33,1,0,0,2
8622837,8622873,36,1,0,0,1
8622870,8623073,203,0,0,1,2
8622874,8623072,198,0,0,1,1
8623073,8623100,27,1,0,0,1
8623074,8623089,15,1,0,0,2
8623090,8623761,671,0,0,1,2
8623101,8623766,665,0,0,1,1
8623762,8623976,214,1,0,0,2
8623767,8623833,66,1,0,0,1
8623786,8623925,139,0,1,0,2
8623834,8625056,1222,0,0,1,1
8623977,8625055,1078,0,0,1,2
8625056,8625210,154,1,0,0,2
8625057,8625197,140,1,0,0,1
8625088,8625181,93,0,1,0,2
8625091,8625170,79,0,1,0,1
8625198,8625561,363,0,0,1,1
8625211,8625561,350,0,0,1,2
8625562,8625584,22,1,0,0,1
8625562,8625594,32,1,0,0,2
8625585,8625769,184,0,0,1,1
8625595,8625771,176,0,0,1,2
8625770,8625797,27,1,0,0,1
8625772,8625790,18,1,0,0,2
8625791,8627084,1293,0,0,1,2
8625798,8627087,1289,0,0,1,1
8627085,8627277,192,1,0,0,2
8627088,8627240,152,1,0,0,1
8627102,8627228,126,0,1,0,2
8627111,8627203,92,0,1,0,1
8627241,8627595,354,0,0,1,1
8627278,8627594,316,0,0,1,2
8627595,8627624,29,1,0,0,2
8627596,8627628,32,1,0,0,1
8627625,8628424,799,0,0,1,2
8627629,8628424,795,0,0,1,1
8628425,8628464,39,1,0,0,2
8628425,8628467,42,1,0,0,1
8628465,8629201,736,0,0,1,2
8628468,8629201,733,0,0,1,1
8629202,8629365,163,1,0,0,1
8629202,8629379,177,1,0,0,2
8629225,8629328,103,0,1,0,2
8629232,8629312,80,0,1,0,1
8629366,8629839,473,0,0,1,1
8629380,8629838,458,0,0,1,2
8629839,8629881,42,1,0,0,2
8629840,8629883,43,1,0,0,1
8629882,8630210,328,0,0,1,2
8629884,8630209,325,0,0,1,1
8630210,8630250,40,1,0,0,1
8630211,8630240,29,1,0,0,2
8630241,8630440,199,0,0,1,2
8630251,8630466,215,0,0,1,1
8630441,8630602,161,1,0,0,2
8630467,8630535,68,1,0,0,1
8630481,8630522,41,0,1,0,2
8630536,8630657,121,0,0,1,1
8630603,8630655,52,0,0,1,2
8630656,8630861,205,1,0,0,2
8630658,8630838,180,1,0,0,1
8630676,8630815,139,0,1,0,2
8630683,8630797,114,0,1,0,1
8630839,8631229,390,0,0,1,1
8630862,8631237,375,0,0,1,2
8631230,8631258,28,1,0,0,1
8631238,8631255,17,1,0,0,2
8631256,8631819,563,0,0,1,2
8631259,8631820,561,0,0,1,1
8631820,8632231,411,1,0,0,2
8631821,8632222,401,1,0,0,1
8631839,8632214,375,0,1,0,2
8631841,8632211,370,0,1,0,1
8632223,8632381,158,0,0,1,1
8632232,8632379,147,0,0,1,2
8632380,8632442,62,1,0,0,2
8632382,8632434,52,1,0,0,1
8632435,8632730,295,0,0,1,1
8632443,8632732,289,0,0,1,2
8632731,8632938,207,1,0,0,1
8632733,8632924,191,1,0,0,2
8632754,8632870,116,0,1,0,2
8632759,8632879,120,0,1,0,1
8632925,8633119,194,0,0,1,2
8632939,8633120,181,0,0,1,1
8633120,8633202,82,1,0,0,2
8633121,8633202,81,1,0,0,1
8633203,8633381,178,0,0,1,2
8633203,8633382,179,0,0,1,1
8633382,8633449,67,1,0,0,2
8633383,8633449,66,1,0,0,1
8633450,8633930,480,0,0,1,1
8633450,8633940,490,0,0,1,2
8633931,8634097,166,1,0,0,1
8633941,8634131,190,1,0,0,2
8633963,8634055,92,0,1,0,2
8633967,8634034,67,0,1,0,1
8634098,8634391,293,0,0,1,1
8634132,8634389,257,0,0,1,2
8634390,8634654,264,1,0,0,2
8634392,8634629,237,1,0,0,1
8634410,8634620,210,0,1,0,2
8634412,8634612,200,0,1,0,1
8634630,8634651,21,0,0,1,1
8634652,8634658,6,1,0,0,1
8634655,8634845,190,0,0,1,2
8634659,8634847,188,0,0,1,1
8634846,8635111,265,1,0,0,2
8634848,8635097,249,1,0,0,1
8634866,8635069,203,0,1,0,1
8634867,8635068,201,0,1,0,2
8635098,8635666,568,0,0,1,1
8635112,8635665,553,0,0,1,2
8635666,8635878,212,1,0,0,2
8635667,8635837,170,1,0,0,1
8635707,8635819,112,0,1,0,2
8635712,8635801,89,0,1,0,1
8635838,8636112,274,0,0,1,1
8635879,8636114,235,0,0,1,2
8636113,8636334,221,1,0,0,1
8636115,8636369,254,1,0,0,2
8636132,8636311,179,0,1,0,2
8636133,8636306,173,0,1,0,1
8636335,8636726,391,0,0,1,1
8636370,8636726,356,0,0,1,2
8636727,8636772,45,1,0,0,2
8636727,8636779,52,1,0,0,1
8636773,8637330,557,0,0,1,2
8636780,8637329,549,0,0,1,1
8637330,8637488,158,1,0,0,1
8637331,8637519,188,1,0,0,2
8637350,8637459,109,0,1,0,2
8637352,8637457,105,0,1,0,1
8637489,8637605,116,0,0,1,1
8637520,8637601,81,0,0,1,2
8637602,8637846,244,1,0,0,2
8637606,8637826,220,1,0,0,1
8637623,8637791,168,0,1,0,1
8637623,8637800,177,0,1,0,2
8637827,8638052,225,0,0,1,1
8637847,8638051,204,0,0,1,2
8638052,8638127,75,1,0,0,2
8638053,8638130,77,1,0,0,1
8638128,8638372,244,0,0,1,2
8638131,8638377,246,0,0,1,1
8638373,8638745,372,1,0,0,2
8638378,8638743,365,1,0,0,1
8638394,8638733,339,0,1,0,1
8638394,8638735,341,0,1,0,2
8638744,8639070,326,0,0,1,1
8638746,8639069,323,0,0,1,2
8639070,8639119,49,1,0,0,2
8639071,8639111,40,1,0,0,1
8639112,8639298,186,0,0,1,1
8639120,8639296,176,0,0,1,2
8639297,8639497,200,1,0,0,2
8639299,8639485,186,1,0,0,1
8639316,8639461,145,0,1,0,2
8639324,8639447,123,0,1,0,1
8639486,8639771,285,0,0,1,1
8639498,8639772,274,0,0,1,2
8639772,8639829,57,1,0,0,1
8639773,8639830,57,1,0,0,2
8639830,8640658,828,0,0,1,1
8639831,8640656,825,0,0,1,2
8640657,8640869,212,1,0,0,2
8640659,8640853,194,1,0,0,1
8640675,8640832,157,0,1,0,2
8640678,8640826,148,0,1,0,1
8640854,8641123,269,0,0,1,1
8640870,8641122,252,0,0,1,2
8641123,8641151,28,1,0,0,2
8641124,8641143,19,1,0,0,1
8641144,8641356,212,0,0,1,1
8641152,8641356,204,0,0,1,2
8641357,8641376,19,1,0,0,2
8641357,8641386,29,1,0,0,1
8641377,8642143,766,0,0,1,2
8641387,8642145,758,0,0,1,1
8642144,8642356,212,1,0,0,2
8642146,8642337,191,1,0,0,1
8642164,8642317,153,0,1,0,2
8642169,8642308,139,0,1,0,1
8642338,8642865,527,0,0,1,1
8642357,8642863,506,0,0,1,2
8642864,8643082,218,1,0,0,2
8642866,8643061,195,1,0,0,1
8642882,8643043,161,0,1,0,2
8642884,8643026,142,0,1,0,1
8643062,8643483,421,0,0,1,1
8643083,8643480,397,0,0,1,2
8643481,8643714,233,1,0,0,2
8643484,8643679,195,1,0,0,1
8643496,8643668,172,0,1,0,2
8643501,8643654,153,0,1,0,1
8643680,8645004,1324,0,0,1,1
8643715,8645003,1288,0,0,1,2
8645004,8645056,52,1,0,0,2
8645005,8645054,49,1,0,0,1
8645055,8645169,114,0,0,1,1
8645057,8645162,105,0,0,1,2
8645163,8645363,200,1,0,0,2
8645170,8645338,168,1,0,0,1
8645184,8645328,144,0,1,0,2
8645193,8645306,113,0,1,0,1
8645339,8645806,467,0,0,1,1
8645364,8645807,443,0,0,1,2
8645807,8645857,50,1,0,0,1
8645808,8645859,51,1,0,0,2
8645858,8646162,304,0,0,1,1
8645860,8646162,302,0,0,1,2
8646163,8646188,25,1,0,0,2
8646163,8646197,34,1,0,0,1
8646189,8646400,211,0,0,1,2
8646198,8646405,207,0,0,1,1
8646401,8646607,206,1,0,0,2
8646406,8646555,149,1,0,0,1
8646420,8646552,132,0,1,0,2
8646428,8646527,99,0,1,0,1
8646556,8647132,576,0,0,1,1
8646608,8647131,523,0,0,1,2
8647132,8647358,226,1,0,0,2
8647133,8647306,173,1,0,0,1
8647152,8647293,141,0,1,0,2
8647162,8647278,116,0,1,0,1
8647307,8648082,775,0,0,1,1
8647359,8648084,725,0,0,1,2
8648083,8648103,20,1,0,0,1
8648085,8648101,16,1,0,0,2
8648102,8648410,308,0,0,1,2
8648104,8648412,308,0,0,1,1
8648411,8648661,250,1,0,0,2
8648413,8648621,208,1,0,0,1
8648431,8648600,169,0,1,0,2
8648437,8648591,154,0,1,0,1
8648622,8649019,397,0,0,1,1
8648662,8649016,354,0,0,1,2
8649017,8649041,24,1,0,0,2
8649020,8649040,20,1,0,0,1
8649041,8649972,931,0,0,1,1
8649042,8649973,931,0,0,1,2
8649973,8650029,56,1,0,0,1
8649974,8650030,56,1,0,0,2
8650030,8650143,113,0,0,1,1
8650031,8650143,112,0,0,1,2
8650144,8650178,34,1,0,0,2
8650144,8650179,35,1,0,0,1
8650179,8650690,511,0,0,1,2
8650180,8650690,510,0,0,1,1
8650691,8650841,150,1,0,0,2
8650691,8650856,165,1,0,0,1
8650712,8650797,85,0,1,0,2
8650718,8650784,66,0,1,0,1
8650842,8651327,485,0,0,1,2
8650857,8651327,470,0,0,1,1
8651328,8651338,10,1,0,0,2
8651328,8651344,16,1,0,0,1
8651339,8652480,1141,0,0,1,2
8651345,8652479,1134,0,0,1,1
8652480,8652507,27,1,0,0,1
8652481,8652500,19,1,0,0,2
8652501,8653609,1108,0,0,1,2
8652508,8653603,1095,0,0,1,1
8653604,8653632,28,1,0,0,1
8653610,8653631,21,1,0,0,2
8653632,8653776,144,0,0,1,2
8653633,8653782,149,0,0,1,1
8653777,8653941,164,1,0,0,2
8653783,8653953,170,1,0,0,1
8653801,8653902,101,0,1,0,2
8653810,8653880,70,0,1,0,1
8653942,8654414,472,0,0,1,2
8653954,8654415,461,0,0,1,1
8654415,8654436,21,1,0,0,2
8654416,8654432,16,1,0,0,1
8654433,8655586,1153,0,0,1,1
8654437,8656168,1731,0,0,1,2
8655587,8655591,4,1,0,0,1
8655592,8656168,576,0,0,1,1
8656169,8656222,53,1,0,0,2
8656169,8656224,55,1,0,0,1
8656223,8656304,81,0,0,1,2
8656225,8656303,78,0,0,1,1
8656304,8656361,57,1,0,0,1
8656305,8656372,67,1,0,0,2
8656362,8656494,132,0,0,1,1
8656373,8656494,121,0,0,1,2
8656495,8656517,22,1,0,0,1
8656495,8656526,31,1,0,0,2
8656518,8658470,1952,0,0,1,1
8656527,8658470,1943,0,0,1,2
8658471,8658637,166,1,0,0,1
8658471,8658647,176,1,0,0,2
8658498,8658605,107,0,1,0,2
8658508,8658573,65,0,1,0,1
8658638,8658966,328,0,0,1,1
8658648,8658961,313,0,0,1,2
8658962,8659253,291,1,0,0,2
8658967,8659207,240,1,0,0,1
8658983,8659180,197,0,1,0,2
8658992,8659173,181,0,1,0,1
8659208,8659802,594,0,0,1,1
8659254,8659800,546,0,0,1,2
8659801,8660002,201,1,0,0,2
8659803,8659983,180,1,0,0,1
8659816,8659964,148,0,1,0,2
8659819,8659958,139,0,1,0,1
8659984,8660153,169,0,0,1,1
8660003,8660152,149,0,0,1,2
8660153,8660237,84,1,0,0,2
8660154,8660234,80,1,0,0,1
8660235,8660382,147,0,0,1,1
8660238,8660381,143,0,0,1,2
8660382,8660402,20,1,0,0,2
8660383,8660402,19,1,0,0,1
8660403,8663033,2630,0,0,1,1
8660403,8663035,2632,0,0,1,2
8663034,8663096,62,1,0,0,1
8663036,8663097,61,1,0,0,2
8663097,8665051,1954,0,0,1,1
8663098,8665043,1945,0,0,1,2
8665044,8665486,442,1,0,0,2
8665052,8665163,111,1,0,0,1
8665059,8665467,408,0,1,0,2
8665079,8665123,44,0,1,0,1
8665164,8665207,43,0,0,1,1
8665208,8665463,255,1,0,0,1
8665231,8665431,200,0,1,0,1
8665464,8665666,202,0,0,1,1
8665487,8665666,179,0,0,1,2
8665667,8665693,26,1,0,0,2
8665667,8665702,35,1,0,0,1
8665694,8666814,1120,0,0,1,2
8665703,8666813,1110,0,0,1,1
8666814,8666885,71,1,0,0,1
8666815,8666885,70,1,0,0,2
8666886,8667014,128,0,0,1,1
8666886,8667015,129,0,0,1,2
8667015,8667049,34,1,0,0,1
8667016,8667045,29,1,0,0,2
8667046,8668424,1378,0,0,1,2
8667050,8668427,1377,0,0,1,1
8668425,8668561,136,1,0,0,2
8668428,8668584,156,1,0,0,1
8668452,8668517,65,0,1,0,2
8668457,8668508,51,0,1,0,1
8668562,8669159,597,0,0,1,2
8668585,8669159,574,0,0,1,1
8669160,8669236,76,1,0,0,1
8669160,8669236,76,1,0,0,2
8669237,8669270,33,0,0,1,2
8669237,8669271,34,0,0,1,1
8669271,8669303,32,1,0,0,2
8669272,8669306,34,1,0,0,1
8669304,8671230,1926,0,0,1,2
8669307,8671235,1928,0,0,1,1
8671231,8671429,198,1,0,0,2
8671236,8671426,190,1,0,0,1
8671251,8671394,143,0,1,0,2
8671260,8671384,124,0,1,0,1
8671427,8671909,482,0,0,1,1
8671430,8671908,478,0,0,1,2
8671909,8671972,63,1,0,0,2
8671910,8671965,55,1,0,0,1
8671966,8672337,371,0,0,1,1
8671973,8672324,351,0,0,1,2
8672325,8672435,110,1,0,0,2
8672338,8672427,89,1,0,0,1
8672351,8672393,42,0,1,0,2
8672366,8672375,9,0,1,0,1
8672428,8672679,251,0,0,1,1
8672436,8672673,237,0,0,1,2
8672674,8672837,163,1,0,0,2
8672680,8672801,121,1,0,0,1
8672699,8672773,74,0,1,0,2
8672708,8672753,45,0,1,0,1
8672802,8673000,198,0,0,1,1
8672838,8672999,161,0,0,1,2
8673000,8673102,102,1,0,0,2
8673001,8673087,86,1,0,0,1
8673088,8673210,122,0,0,1,1
8673103,8673209,106,0,0,1,2
8673210,8673243,33,1,0,0,2
8673211,8673243,32,1,0,0,1
8673244,8673369,125,0,0,1,2
8673244,8673381,137,0,0,1,1
8673370,8673719,349,1,0,0,2
8673382,8673631,249,1,0,0,1
8673393,8673617,224,0,1,0,2
8673398,8673606,208,0,1,0,1
8673632,8673685,53,0,0,1,1
8673686,8673716,30,1,0,0,1
8673717,8674328,611,0,0,1,1
8673720,8674328,608,0,0,1,2
8674329,8674349,20,1,0,0,1
8674329,8674351,22,1,0,0,2
8674350,8675212,862,0,0,1,1
8674352,8675210,858,0,0,1,2
8675211,8675226,15,1,0,0,2
8675213,8675229,16,1,0,0,1
8675227,8675351,124,0,0,1,2
8675230,8675769,539,0,0,1,1
8675352,8675368,16,1,0,0,2
8675369,8675769,400,0,0,1,2
8675770,8675805,35,1,0,0,2
8675770,8675813,43,1,0,0,1
8675806,8676092,286,0,0,1,2
8675814,8676091,277,0,0,1,1
8676092,8676123,31,1,0,0,1
8676093,8676120,27,1,0,0,2
8676121,8677797,1676,0,0,1,2
8676124,8677798,1674,0,0,1,1
8677798,8678006,208,1,0,0,2
8677799,8677965,166,1,0,0,1
8677820,8677959,139,0,1,0,2
8677829,8677944,115,0,1,0,1
8677966,8678219,253,0,0,1,1
8678007,8678213,206,0,0,1,2
8678214,8678420,206,1,0,0,2
8678220,8678381,161,1,0,0,1
8678229,8678380,151,0,1,0,2
8678233,8678363,130,0,1,0,1
8678382,8679406,1024,0,0,1,1
8678421,8679406,985,0,0,1,2
8679407,8679481,74,1,0,0,1
8679407,8679632,225,1,0,0,2
8679482,8679692,210,0,0,1,1
8679633,8679699,66,0,0,1,2
8679693,8679715,22,1,0,0,1
8679700,8679713,13,1,0,0,2
8679714,8679807,93,0,0,1,2
8679716,8679824,108,0,0,1,1
8679808,8680130,322,1,0,0,2
8679825,8680062,237,1,0,0,1
8679833,8680058,225,0,1,0,2
8679842,8680033,191,0,1,0,1
8680063,8680171,108,0,0,1,1
8680131,8680171,40,0,0,1,2
8680172,8680188,16,1,0,0,1
8680172,8680193,21,1,0,0,2
8680189,8680677,488,0,0,1,1
8680194,8680476,282,0,0,1,2
8680477,8680487,10,1,0,0,2
8680488,8680684,196,0,0,1,2
8680678,8680700,22,1,0,0,1
8680685,8680726,41,1,0,0,2
8680701,8680876,175,0,0,1,1
8680727,8680876,149,0,0,1,2
8680877,8680943,66,1,0,0,1
8680877,8680944,67,1,0,0,2
8680944,8681167,223,0,0,1,1
8680945,8681168,223,0,0,1,2
8681168,8681197,29,1,0,0,1
8681169,8681188,19,1,0,0,2
8681189,8682925,1736,0,0,1,2
8681198,8682923,1725,0,0,1,1
8682924,8683108,184,1,0,0,1
8682926,8683134,208,1,0,0,2
8682954,8683101,147,0,1,0,2
8682960,8683090,130,0,1,0,1
8683109,8684240,1131,0,0,1,1
8683135,8684241,1106,0,0,1,2
8684241,8684323,82,1,0,0,1
8684242,8684314,72,1,0,0,2
8684315,8684400,85,0,0,1,2
8684324,8684400,76,0,0,1,1
8684401,8684436,35,1,0,0,1
8684401,8684436,35,1,0,0,2
8684437,8685484,1047,0,0,1,1
8684437,8685486,1049,0,0,1,2
8685485,8685539,54,1,0,0,1
8685487,8685540,53,1,0,0,2
8685540,8685717,177,0,0,1,1
8685541,8685717,176,0,0,1,2
8685718,8685746,28,1,0,0,2
8685718,8685748,30,1,0,0,1
8685747,8686581,834,0,0,1,2
8685749,8686589,840,0,0,1,1
8686582,8686706,124,1,0,0,2
8686590,8686701,111,1,0,0,1
8686602,8686669,67,0,1,0,2
8686613,8686641,28,0,1,0,1
8686702,8687557,855,0,0,1,1
8686707,8687556,849,0,0,1,2
8687557,8687755,198,1,0,0,2
8687558,8687730,172,1,0,0,1
8687587,8687715,128,0,1,0,2
8687595,8687691,96,0,1,0,1
8687731,8688798,1067,0,0,1,1
8687756,8688798,1042,0,0,1,2
8688799,8688865,66,1,0,0,1
8688799,8688875,76,1,0,0,2
8688866,8688999,133,0,0,1,1
8688876,8689000,124,0,0,1,2
8689000,8689031,31,1,0,0,1
8689001,8689020,19,1,0,0,2
8689021,8690080,1059,0,0,1,2
8689032,8690080,1048,0,0,1,1
8690081,8690159,78,1,0,0,1
8690081,8690160,79,1,0,0,2
8690160,8690378,218,0,0,1,1
8690161,8690380,219,0,0,1,2
8690379,8690397,18,1,0,0,1
8690381,8690394,13,1,0,0,2
8690395,8692158,1763,0,0,1,2
8690398,8692161,1763,0,0,1,1
8692159,8692380,221,1,0,0,2
8692162,8692374,212,1,0,0,1
8692183,8692348,165,0,1,0,2
8692190,8692348,158,0,1,0,1
8692375,8693355,980,0,0,1,1
8692381,8693356,975,0,0,1,2
8693356,8693423,67,1,0,0,1
8693357,8693436,79,1,0,0,2
8693424,8693503,79,0,0,1,1
8693437,8693505,68,0,0,1,2
8693504,8693535,31,1,0,0,1
8693506,8693525,19,1,0,0,2
8693526,8693769,243,0,0,1,2
8693536,8693769,233,0,0,1,1
8693770,8693780,10,1,0,0,1
8693770,8693780,10,1,0,0,2
8693781,8695324,1543,0,0,1,1
8693781,8695325,1544,0,0,1,2
8695325,8695371,46,1,0,0,1
8695326,8695374,48,1,0,0,2
8695372,8695769,397,0,0,1,1
8695375,8695759,384,0,0,1,2
8695760,8695961,201,1,0,0,2
8695770,8695897,127,1,0,0,1
8695778,8695922,144,0,1,0,2
8695794,8695870,76,0,1,0,1
8695898,8697427,1529,0,0,1,1
8695962,8696012,50,0,0,1,2
8696013,8696029,16,1,0,0,2
8696030,8697428,1398,0,0,1,2
8697428,8697616,188,1,0,0,1
8697429,8697656,227,1,0,0,2
8697451,8697620,169,0,1,0,2
8697463,8697590,127,0,1,0,1
8697617,8699109,1492,0,0,1,1
8697657,8699110,1453,0,0,1,2
8699110,8699169,59,1,0,0,1
8699111,8699170,59,1,0,0,2
8699170,8699382,212,0,0,1,1
8699171,8699381,210,0,0,1,2
8699382,8699461,79,1,0,0,2
8699383,8699465,82,1,0,0,1
8699462,8699544,82,0,0,1,2
8699466,8699543,77,0,0,1,1
8699544,8699584,40,1,0,0,1
8699545,8699582,37,1,0,0,2
8699583,8699669,86,0,0,1,2
8699585,8699877,292,0,0,1,1
8699670,8699685,15,1,0,0,2
8699686,8699834,148,0,0,1,2
8699835,8700163,328,1,0,0,2
8699878,8700106,228,1,0,0,1
8699882,8700121,239,0,1,0,2
8699897,8700056,159,0,1,0,1
8700107,8700169,62,0,0,1,1
8700164,8700191,27,0,0,1,2
8700170,8700188,18,1,0,0,1
8700189,8701859,1670,0,0,1,1
8700192,8700224,32,1,0,0,2
8700225,8700597,372,0,0,1,2
8700598,8700725,127,1,0,0,2
8700726,8701191,465,0,0,1,2
8701192,8701207,15,1,0,0,2
8701208,8701242,34,0,0,1,2
8701243,8701255,12,1,0,0,2
8701256,8701332,76,0,0,1,2
8701333,8701355,22,1,0,0,2
8701356,8701478,122,0,0,1,2
8701479,8701502,23,1,0,0,2
8701503,8701610,107,0,0,1,2
8701611,8701631,20,1,0,0,2
8701632,8701819,187,0,0,1,2
8701820,8701824,4,1,0,0,2
8701825,8701860,35,0,0,1,2
8701860,8701916,56,1,0,0,1
8701861,8701916,55,1,0,0,2
8701917,8702267,350,0,0,1,1
8701917,8702268,351,0,0,1,2
8702268,8702295,27,1,0,0,1
8702269,8702296,27,1,0,0,2
8702296,8702997,701,0,0,1,1
8702297,8702995,698,0,0,1,2
8702996,8703007,11,1,0,0,2
8702998,8703011,13,1,0,0,1
8703008,8703046,38,0,0,1,2
8703012,8703045,33,0,0,1,1
8703046,8703060,14,1,0,0,1
8703047,8703056,9,1,0,0,2
8703057,8703960,903,0,0,1,2
8703061,8703963,902,0,0,1,1
8703961,8704562,601,1,0,0,2
8703964,8704208,244,1,0,0,1
8703982,8704185,203,0,1,0,2
8703990,8704182,192,0,1,0,1
8704209,8704237,28,0,0,1,1
8704238,8704519,281,1,0,0,1
8704253,8704494,241,0,1,0,2
8704257,8704495,238,0,1,0,1
8704520,8705768,1248,0,0,1,1
8704563,8705769,1206,0,0,1,2
8705769,8705815,46,1,0,0,1
8705770,8705823,53,1,0,0,2
8705816,8705931,115,0,0,1,1
8705824,8705932,108,0,0,1,2
8705932,8706001,69,1,0,0,1
8705933,8705999,66,1,0,0,2
8706000,8706059,59,0,0,1,2
8706002,8706059,57,0,0,1,1
8706060,8706083,23,1,0,0,2
8706060,8706096,36,1,0,0,1
8706084,8706244,160,0,0,1,2
8706097,8706244,147,0,0,1,1
8706245,8706255,10,1,0,0,1
8706245,8706256,11,1,0,0,2
8706256,8707022,766,0,0,1,1
8706257,8707017,760,0,0,1,2
8707018,8707297,279,1,0,0,2
8707023,8707247,224,1,0,0,1
8707036,8707239,203,0,1,0,2
8707046,8707208,162,0,1,0,1
8707248,8707512,264,0,0,1,1
8707298,8707512,214,0,0,1,2
8707513,8707554,41,1,0,0,1
8707513,8707578,65,1,0,0,2
8707555,8707702,147,0,0,1,1
8707579,8707701,122,0,0,1,2
8707702,8707733,31,1,0,0,2
8707703,8707722,19,1,0,0,1
8707723,8709562,1839,0,0,1,1
8707734,8709555,1821,0,0,1,2
8709556,8709842,286,1,0,0,2
8709563,8709810,247,1,0,0,1
8709582,8709795,213,0,1,0,2
8709589,8709788,199,0,1,0,1
8709811,8711088,1277,0,0,1,1
8709843,8711087,1244,0,0,1,2
8711088,8711176,88,1,0,0,2
8711089,8711172,83,1,0,0,1
8711173,8711277,104,0,0,1,1
8711177,8711276,99,0,0,1,2
8711277,8711314,37,1,0,0,2
8711278,8711315,37,1,0,0,1
8711315,8712794,1479,0,0,1,2
8711316,8712796,1480,0,0,1,1
8712795,8712863,68,1,0,0,2
8712797,8712857,60,1,0,0,1
8712858,8713805,947,0,0,1,1
8712864,8713806,942,0,0,1,2
8713806,8713838,32,1,0,0,1
8713807,8713825,18,1,0,0,2
8713826,8714075,249,0,0,1,2
8713839,8714087,248,0,0,1,1
8714076,8714243,167,1,0,0,2
8714088,8714195,107,1,0,0,1
8714095,8714198,103,0,1,0,2
8714113,8714160,47,0,1,0,1
8714196,8714861,665,0,0,1,1
8714244,8714863,619,0,0,1,2
8714862,8715117,255,1,0,0,1
8714864,8715152,288,1,0,0,2
8714911,8715084,173,0,1,0,2
8714914,8715091,177,0,1,0,1
8715118,8715584,466,0,0,1,1
8715153,8715584,431,0,0,1,2
8715585,8715629,44,1,0,0,1
8715585,8715629,44,1,0,0,2
8715630,8716552,922,0,0,1,1
8715630,8716552,922,0,0,1,2
8716553,8716616,63,1,0,0,1
8716553,8716621,68,1,0,0,2
8716617,8716763,146,0,0,1,1
8716622,8716764,142,0,0,1,2
8716764,8716784,20,1,0,0,1
8716765,8716793,28,1,0,0,2
8716785,8717227,442,0,0,1,1
8716794,8717227,433,0,0,1,2
8717228,8717254,26,1,0,0,2
8717228,8717257,29,1,0,0,1
8717255,8717518,263,0,0,1,2
8717258,8717519,261,0,0,1,1
8717519,8717551,32,1,0,0,2
8717520,8717552,32,1,0,0,1
8717552,8718192,640,0,0,1,2
8717553,8718192,639,0,0,1,1
8718193,8718233,40,1,0,0,2
8718193,8718236,43,1,0,0,1
8718234,8718626,392,0,0,1,2
8718237,8718620,383,0,0,1,1
8718621,8718650,29,1,0,0,1
8718627,8718641,14,1,0,0,2
8718642,8718994,352,0,0,1,2
8718651,8718997,346,0,0,1,1
8718995,8719083,88,1,0,0,2
8718998,8719079,81,1,0,0,1
8719080,8720280,1200,0,0,1,1
8719084,8720279,1195,0,0,1,2
8720280,8720510,230,1,0,0,2
8720281,8720523,242,1,0,0,1
8720316,8720473,157,0,1,0,2
8720323,8720471,148,0,1,0,1
8720511,8720878,367,0,0,1,2
8720524,8720877,353,0,0,1,1
8720878,8720931,53,1,0,0,1
8720879,8720929,50,1,0,0,2
8720930,8721633,703,0,0,1,2
8720932,8721633,701,0,0,1,1
8721634,8721672,38,1,0,0,1
8721634,8721673,39,1,0,0,2
8721673,8722774,1101,0,0,1,1
8721674,8722767,1093,0,0,1,2
8722768,8722926,158,1,0,0,2
8722775,8722896,121,1,0,0,1
8722787,8722870,83,0,1,0,2
8722796,8722843,47,0,1,0,1
8722897,8723012,115,0,0,1,1
8722927,8723013,86,0,0,1,2
8723013,8723051,38,1,0,0,1
8723014,8723050,36,1,0,0,2
8723051,8725013,1962,0,0,1,2
8723052,8725014,1962,0,0,1,1
8725014,8725208,194,1,0,0,2
8725015,8725167,152,1,0,0,1
8725050,8725153,103,0,1,0,2
8725064,8725115,51,0,1,0,1
8725168,8726299,1131,0,0,1,1
8725209,8726299,1090,0,0,1,2
8726300,8726376,76,1,0,0,2
8726300,8726377,77,1,0,0,1
8726377,8726487,110,0,0,1,2
8726378,8726485,107,0,0,1,1
8726486,8726518,32,1,0,0,1
8726488,8726508,20,1,0,0,2
8726509,8728192,1683,0,0,1,2
8726519,8728193,1674,0,0,1,1
8728193,8728240,47,1,0,0,2
8728194,8728251,57,1,0,0,1
8728241,8728680,439,0,0,1,2
8728252,8728680,428,0,0,1,1
8728681,8728711,30,1,0,0,2
8728681,8728712,31,1,0,0,1
8728712,8730204,1492,0,0,1,2
8728713,8730204,1491,0,0,1,1
8730205,8730458,253,1,0,0,1
8730205,8730469,264,1,0,0,2
8730220,8730432,212,0,1,0,2
8730229,8730435,206,0,1,0,1
8730459,8731883,1424,0,0,1,1
8730470,8731882,1412,0,0,1,2
8731883,8731953,70,1,0,0,2
8731884,8731952,68,1,0,0,1
8731953,8732047,94,0,0,1,1
8731954,8732047,93,0,0,1,2
8732048,8732105,57,1,0,0,1
8732048,8732105,57,1,0,0,2
8732106,8732220,114,0,0,1,1
8732106,8732221,115,0,0,1,2
8732221,8732257,36,1,0,0,1
8732222,8732246,24,1,0,0,2
8732247,8732494,247,0,0,1,2
8732258,8732496,238,0,0,1,1
8732495,8732506,11,1,0,0,2
8732497,8732509,12,1,0,0,1
8732507,8733474,967,0,0,1,2
8732510,8733474,964,0,0,1,1
8733475,8733523,48,1,0,0,1
8733475,8733531,56,1,0,0,2
8733524,8733841,317,0,0,1,1
8733532,8733835,303,0,0,1,2
8733836,8734248,412,1,0,0,2
8733842,8733981,139,1,0,0,1
8733857,8733964,107,0,1,0,2
8733873,8733923,50,0,1,0,1
8733982,8735548,1566,0,0,1,1
8734249,8735549,1300,0,0,1,2
8735549,8735735,186,1,0,0,1
8735550,8735771,221,1,0,0,2
8735591,8735687,96,0,1,0,2
8735604,8735660,56,0,1,0,1
8735736,8736166,430,0,0,1,1
8735772,8736165,393,0,0,1,2
8736166,8736213,47,1,0,0,2
8736167,8736193,26,1,0,0,1
8736194,8736948,754,0,0,1,1
8736214,8736273,59,0,0,1,2
8736274,8736322,48,1,0,0,2
8736323,8736948,625,0,0,1,2
8736949,8737014,65,1,0,0,1
8736949,8737020,71,1,0,0,2
8737015,8737119,104,0,0,1,1
8737021,8737118,97,0,0,1,2
8737119,8737156,37,1,0,0,2
8737120,8737156,36,1,0,0,1
8737157,8737362,205,0,0,1,1
8737157,8737362,205,0,0,1,2
8737363,8737492,129,1,0,0,2
8737363,8737505,142,1,0,0,1
8737388,8737446,58,0,1,0,2
8737390,8737442,52,0,1,0,1
8737493,8739081,1588,0,0,1,2
8737506,8739080,1574,0,0,1,1
8739081,8739123,42,1,0,0,1
8739082,8739123,41,1,0,0,2
8739124,8739526,402,0,0,1,1
8739124,8739527,403,0,0,1,2
8739527,8739567,40,1,0,0,1
8739528,8739557,29,1,0,0,2
8739558,8740018,460,0,0,1,2
8739568,8740012,444,0,0,1,1
8740013,8740033,20,1,0,0,1
8740019,8740029,10,1,0,0,2
8740030,8741182,1152,0,0,1,2
8740034,8741186,1152,0,0,1,1
8741183,8741654,471,1,0,0,2
8741187,8741352,165,1,0,0,1
8741234,8741321,87,0,1,0,2
8741255,8741294,39,0,1,0,1
8741353,8741393,40,0,0,1,1
8741394,8741620,226,1,0,0,1
8741409,8741592,183,0,1,0,2
8741416,8741591,175,0,1,0,1
8741621,8741939,318,0,0,1,1
8741655,8741940,285,0,0,1,2
8741940,8741970,30,1,0,0,1
8741941,8741973,32,1,0,0,2
8741971,8742917,946,0,0,1,1
8741974,8742919,945,0,0,1,2
8742918,8742962,44,1,0,0,1
8742920,8742965,45,1,0,0,2
8742963,8743142,179,0,0,1,1
8742966,8743143,177,0,0,1,2
8743143,8743172,29,1,0,0,1
8743144,8743170,26,1,0,0,2
8743171,8743953,782,0,0,1,2
8743173,8743953,780,0,0,1,1
8743954,8744009,55,1,0,0,2
8743954,8744011,57,1,0,0,1
8744010,8746009,1999,0,0,1,2
8744012,8746009,1997,0,0,1,1
8746010,8746236,226,1,0,0,1
8746010,8746255,245,1,0,0,2
8746039,8746218,179,0,1,0,2
8746045,8746216,171,0,1,0,1
8746237,8746335,98,0,0,1,1
8746256,8746332,76,0,0,1,2
8746333,8746709,376,1,0,0,2
8746336,8746712,376,1,0,0,1
8746355,8746702,347,0,1,0,1
8746357,8746699,342,0,1,0,2
8746710,8747313,603,0,0,1,2
8746713,8747312,599,0,0,1,1
8747313,8747379,66,1,0,0,1
8747314,8747390,76,1,0,0,2
8747380,8747485,105,0,0,1,1
8747391,8747486,95,0,0,1,2
8747486,8747515,29,1,0,0,1
8747487,8747514,27,1,0,0,2
8747515,8749339,1824,0,0,1,2
8747516,8749339,1823,0,0,1,1
8749340,8749390,50,1,0,0,1
8749340,8749400,60,1,0,0,2
8749391,8751441,2050,0,0,1,1
8749401,8751443,2042,0,0,1,2
8751442,8751790,348,1,0,0,1
8751444,8751760,316,1,0,0,2
8751460,8751725,265,0,1,0,2
8751461,8751760,299,0,1,0,1
8751761,8751851,90,0,0,1,2
8751791,8751850,59,0,0,1,1
8751851,8751907,56,1,0,0,1
8751852,8751910,58,1,0,0,2
8751908,8752942,1034,0,0,1,1
8751911,8752943,1032,0,0,1,2
8752943,8752986,43,1,0,0,1
8752944,8752984,40,1,0,0,2
8752985,8753440,455,0,0,1,2
8752987,8753442,455,0,0,1,1
8753441,8753516,75,1,0,0,2
8753443,8753520,77,1,0,0,1
8753517,8753640,123,0,0,1,2
8753521,8753640,119,0,0,1,1
8753641,8753669,28,1,0,0,1
8753641,8753672,31,1,0,0,2
8753670,8753929,259,0,0,1,1
8753673,8755257,1584,0,0,1,2
8753930,8753940,10,1,0,0,1
8753941,8755256,1315,0,0,1,1
8755257,8755319,62,1,0,0,1
8755258,8755325,67,1,0,0,2
8755320,8755947,627,0,0,1,1
8755326,8755948,622,0,0,1,2
8755948,8755979,31,1,0,0,1
8755949,8755990,41,1,0,0,2
8755980,8756101,121,0,0,1,1
8755991,8756068,77,0,0,1,2
8756069,8756231,162,1,0,0,2
8756102,8756184,82,1,0,0,1
8756112,8756171,59,0,1,0,2
8756185,8757377,1192,0,0,1,1
8756232,8756339,107,0,0,1,2
8756340,8756381,41,1,0,0,2
8756382,8756489,107,0,0,1,2
8756490,8756565,75,1,0,0,2
8756566,8757379,813,0,0,1,2
8757378,8757621,243,1,0,0,1
8757380,8757678,298,1,0,0,2
8757429,8757601,172,0,1,0,2
8757436,8757596,160,0,1,0,1
8757622,8757730,108,0,0,1,1
8757679,8757729,50,0,0,1,2
8757730,8757764,34,1,0,0,2
8757731,8757764,33,1,0,0,1
8757765,8757988,223,0,0,1,1
8757765,8757989,224,0,0,1,2
8757989,8758030,41,1,0,0,1
8757990,8758021,31,1,0,0,2
8758022,8758734,712,0,0,1,2
8758031,8758733,702,0,0,1,1
8758734,8758763,29,1,0,0,1
8758735,8758758,23,1,0,0,2
8758759,8758977,218,0,0,1,2
8758764,8758977,213,0,0,1,1
8758978,8759048,70,1,0,0,2
8758978,8759051,73,1,0,0,1
8759049,8759170,121,0,0,1,2
8759052,8759169,117,0,0,1,1
8759170,8759200,30,1,0,0,1
8759171,8759190,19,1,0,0,2
8759191,8759816,625,0,0,1,2
8759201,8759818,617,0,0,1,1
8759817,8760033,216,1,0,0,2
8759819,8759992,173,1,0,0,1
8759830,8760001,171,0,1,0,2
8759840,8759969,129,0,1,0,1
8759993,8761021,1028,0,0,1,1
8760034,8761022,988,0,0,1,2
8761022,8761070,48,1,0,0,1
8761023,8761081,58,1,0,0,2
8761071,8761556,485,0,0,1,1
8761082,8761555,473,0,0,1,2
8761556,8761577,21,1,0,0,2
8761557,8761575,18,1,0,0,1
8761576,8762089,513,0,0,1,1
8761578,8762090,512,0,0,1,2
8762090,8762123,33,1,0,0,1
8762091,8762114,23,1,0,0,2
8762115,8762460,345,0,0,1,2
8762124,8762458,334,0,0,1,1
8762459,8762758,299,1,0,0,1
8762461,8762729,268,1,0,0,2
8762475,8762676,201,0,1,0,2
8762482,8762690,208,0,1,0,1
8762730,8763267,537,0,0,1,2
8762759,8763255,496,0,0,1,1
8763256,8763536,280,1,0,0,1
8763278,8763503,225,0,1,0,2
8763280,8763516,236,0,1,0,1
8763513,8763555,42,1,0,0,2
8763537,8763805,268,0,0,1,1
8763556,8763804,248,0,0,1,2
8763805,8763837,32,1,0,0,2
8763806,8763847,41,1,0,0,1
8763838,8764559,721,0,0,1,2
8763848,8764558,710,0,0,1,1
8764559,8764621,62,1,0,0,1
8764560,8764622,62,1,0,0,2
8764622,8764721,99,0,0,1,1
8764623,8764720,97,0,0,1,2
8764721,8764747,26,1,0,0,2
8764722,8764756,34,1,0,0,1
8764748,8765018,270,0,0,1,2
8764757,8765024,267,0,0,1,1
8765019,8765038,19,1,0,0,2
8765025,8765036,11,1,0,0,1
8765037,8765264,227,0,0,1,1
8765039,8765265,226,0,0,1,2
8765265,8765295,30,1,0,0,1
8765266,8765291,25,1,0,0,2
8765292,8765849,557,0,0,1,2
8765296,8765856,560,0,0,1,1
8765850,8765863,13,1,0,0,2
8765857,8765868,11,1,0,0,1
8765864,8766275,411,0,0,1,2
8765869,8766276,407,0,0,1,1
8766276,8766652,376,1,0,0,2
8766277,8766327,50,1,0,0,1
8766328,8766354,26,0,0,1,1
8766355,8766725,370,1,0,0,1
8766371,8766641,270,0,1,0,2
8766378,8766651,273,0,1,0,1
8766653,8766682,29,0,0,1,2
8766683,8766710,27,1,0,0,2
8766711,8767099,388,0,0,1,2
8766726,8767093,367,0,0,1,1
8767094,8767111,17,1,0,0,1
8767100,8767106,6,1,0,0,2
8767107,8768402,1295,0,0,1,2
8767112,8768404,1292,0,0,1,1
8768403,8768818,415,1,0,0,2
8768405,8768831,426,1,0,0,1
8768424,8768808,384,0,1,0,2
8768427,8768820,393,0,1,0,1
8768819,8768857,38,0,0,1,2
8768832,8768856,24,0,0,1,1
8768857,8768880,23,1,0,0,1
8768858,8768879,21,1,0,0,2
8768880,8768916,36,0,0,1,2
8768881,8768922,41,0,0,1,1
8768917,8769153,236,1,0,0,2
8768923,8769191,268,1,0,0,1
8768937,8769166,229,0,1,0,1
8768942,8769126,184,0,1,0,2
8769154,8769857,703,0,0,1,2
8769192,8769857,665,0,0,1,1
8769858,8769930,72,1,0,0,1
8769858,8769950,92,1,0,0,2
8769931,8770018,87,0,0,1,1
8769951,8770017,66,0,0,1,2
8770018,8770060,42,1,0,0,2
8770019,8770061,42,1,0,0,1
8770061,8770256,195,0,0,1,2
8770062,8770255,193,0,0,1,1
8770256,8770286,30,1,0,0,1
8770257,8770287,30,1,0,0,2
8770287,8770753,466,0,0,1,1
8770288,8770750,462,0,0,1,2
8770751,8770770,19,1,0,0,2
8770754,8770770,16,1,0,0,1
8770771,8771144,373,0,0,1,1
8770771,8771145,374,0,0,1,2
8771145,8771193,48,1,0,0,1
8771146,8771195,49,1,0,0,2
8771194,8771547,353,0,0,1,1
8771196,8771540,344,0,0,1,2
8771541,8771712,171,1,0,0,2
8771548,8771676,128,1,0,0,1
8771561,8771649,88,0,1,0,2
8771571,8771626,55,0,1,0,1
8771677,8773207,1530,0,0,1,1
8771713,8773205,1492,0,0,1,2
8773206,8773634,428,1,0,0,2
8773208,8773607,399,1,0,0,1
8773241,8773354,113,0,1,0,2
8773250,8773330,80,0,1,0,1
8773389,8773583,194,0,1,0,2
8773397,8773587,190,0,1,0,1
8773608,8773663,55,0,0,1,1
8773635,8773661,26,0,0,1,2
8773662,8773911,249,1,0,0,2
8773664,8773883,219,1,0,0,1
8773678,8773855,177,0,1,0,1
8773680,8773853,173,0,1,0,2
8773884,8774792,908,0,0,1,1
8773912,8774792,880,0,0,1,2
8774793,8775019,226,1,0,0,1
8774793,8775062,269,1,0,0,2
8774884,8774989,105,0,1,0,1
8774884,8774990,106,0,1,0,2
8775020,8775118,98,0,0,1,1
8775063,8775119,56,0,0,1,2
8775119,8775151,32,1,0,0,1
8775120,8775142,22,1,0,0,2
8775143,8775341,198,0,0,1,2
8775152,8775343,191,0,0,1,1
8775342,8775369,27,1,0,0,2
8775344,8775360,16,1,0,0,1
8775361,8776047,686,0,0,1,1
8775370,8776047,677,0,0,1,2
8776048,8776064,16,1,0,0,2
8776048,8776075,27,1,0,0,1
8776065,8776874,809,0,0,1,2
8776076,8776875,799,0,0,1,1
8776875,8776938,63,1,0,0,2
8776876,8776925,49,1,0,0,1
8776926,8777335,409,0,0,1,1
8776939,8777327,388,0,0,1,2
8777328,8777478,150,1,0,0,2
8777336,8777435,99,1,0,0,1
8777352,8777408,56,0,1,0,2
8777436,8777997,561,0,0,1,1
8777479,8777991,512,0,0,1,2
8777992,8778191,199,1,0,0,2
8777998,8778151,153,1,0,0,1
8778017,8778125,108,0,1,0,2
8778026,8778107,81,0,1,0,1
8778152,8778994,842,0,0,1,1
8778192,8778996,804,0,0,1,2
8778995,8779251,256,1,0,0,1
8778997,8779268,271,1,0,0,2
8779022,8779206,184,0,1,0,2
8779024,8779215,191,0,1,0,1
8779252,8779328,76,0,0,1,1
8779269,8779325,56,0,0,1,2
8779326,8779585,259,1,0,0,2
8779329,8779554,225,1,0,0,1
8779347,8779522,175,0,1,0,1
8779348,8779515,167,0,1,0,2
8779555,8780904,1349,0,0,1,1
8779586,8780905,1319,0,0,1,2
8780905,8780949,44,1,0,0,1
8780906,8780935,29,1,0,0,2
8780936,8781088,152,0,0,1,2
8780950,8781088,138,0,0,1,1
8781089,8781094,5,1,0,0,1
8781089,8781101,12,1,0,0,2
8781095,8781372,277,0,0,1,1
8781102,8781373,271,0,0,1,2
8781373,8781577,204,1,0,0,1
8781374,8781616,242,1,0,0,2
8781389,8781544,155,0,1,0,1
8781390,8781547,157,0,1,0,2
8781578,8782282,704,0,0,1,1
8781617,8782281,664,0,0,1,2
8782282,8782346,64,1,0,0,2
8782283,8782352,69,1,0,0,1
8782347,8782499,152,0,0,1,2
8782353,8782498,145,0,0,1,1
8782499,8782541,42,1,0,0,1
8782500,8782531,31,1,0,0,2
8782532,8782997,465,0,0,1,2
8782542,8782992,450,0,0,1,1
8782993,8783019,26,1,0,0,1
8782998,8783016,18,1,0,0,2
8783017,8784309,1292,0,0,1,2
8783020,8784312,1292,0,0,1,1
8784310,8784531,221,1,0,0,2
8784313,8784510,197,1,0,0,1
8784337,8784495,158,0,1,0,2
8784343,8784488,145,0,1,0,1
8784511,8784571,60,0,0,1,1
8784532,8784566,34,0,0,1,2
8784567,8784791,224,1,0,0,2
8784572,8784804,232,1,0,0,1
8784584,8784761,177,0,1,0,2
8784586,8784769,183,0,1,0,1
8784792,8785046,254,0,0,1,2
8784805,8785046,241,0,0,1,1
8785047,8785256,209,1,0,0,2
8785047,8785257,210,1,0,0,1
8785058,8785234,176,0,1,0,1
8785061,8785236,175,0,1,0,2
8785257,8785750,493,0,0,1,2
8785258,8785750,492,0,0,1,1
8785751,8785822,71,1,0,0,2
8785751,8785832,81,1,0,0,1
8785823,8786012,189,0,0,1,2
8785833,8788033,2200,0,0,1,1
8786013,8786043,30,1,0,0,2
8786044,8786065,21,0,0,1,2
8786066,8786130,64,1,0,0,2
8786131,8786243,112,0,0,1,2
8786244,8786340,96,1,0,0,2
8786341,8786379,38,0,0,1,2
8786380,8786395,15,1,0,0,2
8786396,8786423,27,0,0,1,2
8786424,8786484,60,1,0,0,2
8786485,8786523,38,0,0,1,2
8786524,8786596,72,1,0,0,2
8786597,8786668,71,0,0,1,2
8786669,8786718,49,1,0,0,2
8786719,8787155,436,0,0,1,2
8787156,8787218,62,1,0,0,2
8787219,8787245,26,0,0,1,2
8787246,8787387,141,1,0,0,2
8787388,8787459,71,0,0,1,2
8787460,8787647,187,1,0,0,2
8787648,8787708,60,0,0,1,2
8787709,8787769,60,1,0,0,2
8787770,8787836,66,0,0,1,2
8787837,8787861,24,1,0,0,2
8787862,8788019,157,0,0,1,2
8788020,8788085,65,1,0,0,2
8788034,8788083,49,1,0,0,1
8788084,8788251,167,0,0,1,1
8788086,8788251,165,0,0,1,2
8788252,8788270,18,1,0,0,1
8788252,8788271,19,1,0,0,2
8788271,8788434,163,0,0,1,1
8788272,8788428,156,0,0,1,2
8788429,8788629,200,1,0,0,2
8788435,8788605,170,1,0,0,1
8788447,8788581,134,0,1,0,2
8788455,8788546,91,0,1,0,1
8788606,8788733,127,0,0,1,1
8788630,8788734,104,0,0,1,2
8788734,8788752,18,1,0,0,1
8788735,8788763,28,1,0,0,2
8788753,8790084,1331,0,0,1,1
8788764,8790087,1323,0,0,1,2
8790085,8790886,801,1,0,0,1
8790088,8790890,802,1,0,0,2
8790115,8790485,370,0,1,0,2
8790121,8790490,369,0,1,0,1
8790531,8790880,349,0,1,0,2
8790532,8790876,344,0,1,0,1
8790887,8791958,1071,0,0,1,1
8790891,8791957,1066,0,0,1,2
8791958,8792027,69,1,0,0,2
8791959,8792029,70,1,0,0,1
8792028,8792142,114,0,0,1,2
8792030,8792141,111,0,0,1,1
8792142,8792172,30,1,0,0,1
8792143,8792161,18,1,0,0,2
8792162,8792473,311,0,0,1,2
8792173,8792476,303,0,0,1,1
8792474,8792716,242,1,0,0,2
8792477,8792717,240,1,0,0,1
8792493,8792673,180,0,1,0,2
8792497,8792668,171,0,1,0,1
8792717,8792792,75,0,0,1,2
8792718,8792792,74,0,0,1,1
8792793,8792820,27,1,0,0,2
8792793,8792822,29,1,0,0,1
8792821,8793376,555,0,0,1,2
8792823,8793375,552,0,0,1,1
8793376,8793433,57,1,0,0,1
8793377,8793420,43,1,0,0,2
8793421,8795444,2023,0,0,1,2
8793434,8795443,2009,0,0,1,1
8795444,8795645,201,1,0,0,1
8795445,8795965,520,1,0,0,2
8795468,8795619,151,0,1,0,2
8795477,8795607,130,0,1,0,1
8795646,8795707,61,0,0,1,1
8795708,8795946,238,1,0,0,1
8795725,8795916,191,0,1,0,2
8795726,8795913,187,0,1,0,1
8795947,8796773,826,0,0,1,1
8795966,8795994,28,0,0,1,2
8795995,8796011,16,1,0,0,2
8796012,8796773,761,0,0,1,2
8796774,8796845,71,1,0,0,1
8796774,8796894,120,1,0,0,2
8796846,8796953,107,0,0,1,1
8796895,8796953,58,0,0,1,2
8796954,8796976,22,1,0,0,2
8796954,8796987,33,1,0,0,1
8796977,8797313,336,0,0,1,2
8796988,8797313,325,0,0,1,1
8797314,8797325,11,1,0,0,2
8797314,8797333,19,1,0,0,1
8797326,8798136,810,0,0,1,2
8797334,8798131,797,0,0,1,1
8798132,8798160,28,1,0,0,1
8798137,8798153,16,1,0,0,2
8798154,8798432,278,0,0,1,2
8798161,8798431,270,0,0,1,1
8798432,8798493,61,1,0,0,1
8798433,8798507,74,1,0,0,2
8798494,8798904,410,0,0,1,1
8798508,8798903,395,0,0,1,2
8798904,8799031,127,1,0,0,2
8798905,8799020,115,1,0,0,1
8798930,8798968,38,0,1,0,2
8799021,8800469,1448,0,0,1,1
8799032,8800474,1442,0,0,1,2
8800470,8800756,286,1,0,0,1
8800475,8800763,288,1,0,0,2
8800506,8800695,189,0,1,0,2
8800510,8800699,189,0,1,0,1
8800757,8800804,47,0,0,1,1
8800764,8800793,29,0,0,1,2
8800794,8801039,245,1,0,0,2
8800805,8801038,233,1,0,0,1
8800824,8800997,173,0,1,0,2
8800826,8800989,163,0,1,0,1
8801039,8801872,833,0,0,1,1
8801040,8801070,30,0,0,1,2
8801071,8801088,17,1,0,0,2
8801089,8801872,783,0,0,1,2
8801873,8802075,202,1,0,0,2
8801873,8802078,205,1,0,0,1
8801921,8802043,122,0,1,0,1
8801921,8802044,123,0,1,0,2
8802076,8802096,20,0,0,1,2
8802079,8802193,114,0,0,1,1
8802097,8802139,42,1,0,0,2
8802140,8802194,54,0,0,1,2
8802194,8802226,32,1,0,0,1
8802195,8802215,20,1,0,0,2
8802216,8803723,1507,0,0,1,2
8802227,8803723,1496,0,0,1,1
8803724,8803770,46,1,0,0,2
8803724,8803780,56,1,0,0,1
8803771,8803945,174,0,0,1,2
8803781,8803948,167,0,0,1,1
8803946,8803978,32,1,0,0,2
8803949,8803975,26,1,0,0,1
8803976,8804160,184,0,0,1,1
8803979,8804159,180,0,0,1,2
8804160,8804342,182,1,0,0,2
8804161,8804310,149,1,0,0,1
8804185,8804263,78,0,1,0,2
8804194,8804245,51,0,1,0,1
8804311,8805770,1459,0,0,1,1
8804343,8805766,1423,0,0,1,2
8805767,8806458,691,1,0,0,2
8805771,8806172,401,1,0,0,1
8805807,8805846,39,0,1,0,2
8805892,8806130,238,0,1,0,2
8805909,8806122,213,0,1,0,1
8806173,8806231,58,0,0,1,1
8806232,8806472,240,1,0,0,1
8806249,8806424,175,0,1,0,2
8806251,8806421,170,0,1,0,1
8806459,8806927,468,0,0,1,2
8806473,8807388,915,0,0,1,1
8806928,8806942,14,1,0,0,2
8806943,8807388,445,0,0,1,2
8807389,8807452,63,1,0,0,1
8807389,8807457,68,1,0,0,2
8807453,8807525,72,0,0,1,1
8807458,8807525,67,0,0,1,2
8807526,8807550,24,1,0,0,2
8807526,8807562,36,1,0,0,1
8807551,8807665,114,0,0,1,2
8807563,8807664,101,0,0,1,1
8807665,8807701,36,1,0,0,1
8807666,8807701,35,1,0,0,2
8807702,8807809,107,0,0,1,2
8807702,8807810,108,0,0,1,1
8807810,8807844,34,1,0,0,2
8807811,8807840,29,1,0,0,1
8807841,8808311,470,0,0,1,1
8807845,8808309,464,0,0,1,2
8808310,8808712,402,1,0,0,2
8808312,8808688,376,1,0,0,1
8808328,8808662,334,0,1,0,2
8808329,8808669,340,0,1,0,1
8808689,8808847,158,0,0,1,1
8808713,8808847,134,0,0,1,2
8808848,8808884,36,1,0,0,2
8808848,8808894,46,1,0,0,1
8808885,8809010,125,0,0,1,2
8808895,8809007,112,0,0,1,1
8809008,8816930,7922,1,0,0,1
8809011,8816559,7548,1,0,0,2
8809037,8809210,173,0,1,0,1
8809038,8809202,164,0,1,0,2
8809239,8816670,7431,0,1,0,1
8809278,8816525,7247,0,1,0,2
8816560,8816690,130,0,0,1,2
8816691,8816952,261,1,0,0,2
8816708,8816906,198,0,1,0,1
8816711,8816906,195,0,1,0,2
8816931,8817299,368,0,0,1,1
8816953,8817299,346,0,0,1,2
8817300,8817328,28,1,0,0,1
8817300,8817328,28,1,0,0,2
8817329,8817430,101,0,0,1,1
8817329,8817432,103,0,0,1,2
8817431,8817672,241,1,0,0,1
8817433,8817699,266,1,0,0,2
8817450,8817644,194,0,1,0,1
8817454,8817639,185,0,1,0,2
8817673,8817871,198,0,0,1,1
8817700,8817872,172,0,0,1,2
8817872,8817914,42,1,0,0,1
8817873,8817913,40,1,0,0,2
8817914,8818053,139,0,0,1,2
8817915,8818054,139,0,0,1,1
8818054,8818092,38,1,0,0,2
8818055,8818085,30,1,0,0,1
8818086,8818264,178,0,0,1,1
8818093,8818262,169,0,0,1,2
8818263,8818295,32,1,0,0,2
8818265,8818286,21,1,0,0,1
8818287,8818602,315,0,0,1,1
8818296,8818595,299,0,0,1,2
8818596,8818813,217,1,0,0,2
8818603,8818777,174,1,0,0,1
8818621,8818755,134,0,1,0,2
8818625,8818743,118,0,1,0,1
8818778,8818892,114,0,0,1,1
8818814,8818893,79,0,0,1,2
8818893,8818939,46,1,0,0,1
8818894,8818931,37,1,0,0,2
8818932,8819533,601,0,0,1,2
8818940,8819533,593,0,0,1,1
8866464,8866552,88,0,1,0,1
8866464,8866558,94,0,1,0,2
8866464,8866584,120,1,0,0,1
8866464,8866599,135,1,0,0,2
8866585,8866699,114,0,0,1,1
8866600,8866697,97,0,0,1,2
8866698,8866755,57,1,0,0,2
8866700,8866755,55,1,0,0,1
8866756,8866844,88,0,0,1,1
8866756,8866844,88,0,0,1,2
8866845,8866874,29,1,0,0,2
8866845,8866875,30,1,0,0,1
8866875,8867101,226,0,0,1,2
8866876,8867107,231,0,0,1,1
8867102,8867119,17,1,0,0,2
8867108,8867119,11,1,0,0,1
8867120,8867516,396,0,0,1,1
8867120,8867523,403,0,0,1,2
8867517,8867533,16,1,0,0,1
8867524,8867528,4,1,0,0,2
8867529,8868944,1415,0,0,1,2
8867534,8868946,1412,0,0,1,1
8868945,8869090,145,1,0,0,2
8868947,8869049,102,1,0,0,1
8868968,8869030,62,0,1,0,2
8868975,8869013,38,0,1,0,1
8869050,8870472,1422,0,0,1,1
8869091,8870473,1382,0,0,1,2
8870473,8870638,165,1,0,0,1
8870474,8870640,166,1,0,0,2
8870507,8870601,94,0,1,0,1
8870507,8870604,97,0,1,0,2
8870639,8870869,230,0,0,1,1
8870641,8870871,230,0,0,1,2
8870870,8870950,80,1,0,0,1
8870872,8870955,83,1,0,0,2
8870951,8871025,74,0,0,1,1
8870956,8871027,71,0,0,1,2
8871026,8871061,35,1,0,0,1
8871028,8871050,22,1,0,0,2
8871051,8871410,359,0,0,1,2
8871062,8871412,350,0,0,1,1
8871411,8871422,11,1,0,0,2
8871413,8871417,4,1,0,0,1
8871418,8873499,2081,0,0,1,1
8871423,8873497,2074,0,0,1,2
8873498,8873578,80,1,0,0,2
8873500,8873578,78,1,0,0,1
8873579,8873943,364,0,0,1,2
8873579,8873944,365,0,0,1,1
8873944,8874026,82,1,0,0,2
8873945,8874029,84,1,0,0,1
8874027,8874101,74,0,0,1,2
8874030,8874102,72,0,0,1,1
8874102,8874132,30,1,0,0,2
8874103,8874122,19,1,0,0,1
8874123,8874304,181,0,0,1,1
8874133,8874293,160,0,0,1,2
8874294,8874614,320,1,0,0,2
8874305,8874522,217,1,0,0,1
8874315,8874518,203,0,1,0,2
8874322,8874496,174,0,1,0,1
8874523,8874776,253,0,0,1,1
8874615,8874777,162,0,0,1,2
8874777,8874794,17,1,0,0,1
8874778,8874791,13,1,0,0,2
8874792,8875133,341,0,0,1,2
8874795,8875127,332,0,0,1,1
8875128,8875138,10,1,0,0,1
8875134,8875146,12,1,0,0,2
8875139,8876108,969,0,0,1,1
8875147,8876103,956,0,0,1,2
8876104,8876225,121,1,0,0,2
8876109,8876215,106,1,0,0,1
8876144,8876180,36,0,1,0,2
8876150,8876178,28,0,1,0,1
8876216,8876547,331,0,0,1,1
8876226,8876547,321,0,0,1,2
8876548,8876637,89,1,0,0,2
8876548,8876639,91,1,0,0,1
8876638,8876750,112,0,0,1,2
8876640,8876747,107,0,0,1,1
8876748,8876773,25,1,0,0,1
8876751,8876772,21,1,0,0,2
8876773,8878456,1683,0,0,1,2
8876774,8878454,1680,0,0,1,1
8878455,8878643,188,1,0,0,1
8878457,8878649,192,1,0,0,2
8878480,8878618,138,0,1,0,2
8878487,8878606,119,0,1,0,1
8878644,8878937,293,0,0,1,1
8878650,8878936,286,0,0,1,2
8878937,8878990,53,1,0,0,2
8878938,8879006,68,1,0,0,1
8878991,8879089,98,0,0,1,2
8879007,8879088,81,0,0,1,1
8879089,8879128,39,1,0,0,1
8879090,8879127,37,1,0,0,2
8879128,8879374,246,0,0,1,2
8879129,8879377,248,0,0,1,1
8879375,8879623,248,1,0,0,2
8879378,8879590,212,1,0,0,1
8879394,8879559,165,0,1,0,2
8879395,8879553,158,0,1,0,1
8879591,8879794,203,0,0,1,1
8879624,8879794,170,0,0,1,2
8879795,8879813,18,1,0,0,2
8879795,8879822,27,1,0,0,1
8879814,8880066,252,0,0,1,2
8879823,8880915,1092,0,0,1,1
8880067,8880078,11,1,0,0,2
8880079,8880917,838,0,0,1,2
8880916,8880992,76,1,0,0,1
8880918,8880990,72,1,0,0,2
8880991,8881044,53,0,0,1,2
8880993,8881043,50,0,0,1,1
8881044,8881256,212,1,0,0,1
8881045,8881257,212,1,0,0,2
8881060,8881215,155,0,1,0,1
8881061,8881218,157,0,1,0,2
8881257,8881454,197,0,0,1,1
8881258,8881455,197,0,0,1,2
8881455,8881529,74,1,0,0,1
8881456,8881529,73,1,0,0,2
8881530,8881601,71,0,0,1,1
8881530,8881603,73,0,0,1,2
8881602,8881625,23,1,0,0,1
8881604,8881630,26,1,0,0,2
8881626,8881849,223,0,0,1,1
8881631,8883256,1625,0,0,1,2
8881850,8881860,10,1,0,0,1
8881861,8883254,1393,0,0,1,1
8883255,8883506,251,1,0,0,1
8883257,8883501,244,1,0,0,2
8883274,8883482,208,0,1,0,1
8883276,8883465,189,0,1,0,2
8883502,8883806,304,0,0,1,2
8883507,8883807,300,0,0,1,1
8883807,8883889,82,1,0,0,2
8883808,8883888,80,1,0,0,1
8883889,8883982,93,0,0,1,1
8883890,8883982,92,0,0,1,2
8883983,8884026,43,1,0,0,2
8883983,8884027,44,1,0,0,1
8884027,8884389,362,0,0,1,2
8884028,8884960,932,0,0,1,1
8884390,8884400,10,1,0,0,2
8884401,8884960,559,0,0,1,2
8884961,8884994,33,1,0,0,1
8884961,8884994,33,1,0,0,2
8884995,8885110,115,0,0,1,2
8884995,8885111,116,0,0,1,1
8885111,8885150,39,1,0,0,2
8885112,8885140,28,1,0,0,1
8885141,8885729,588,0,0,1,1
8885151,8885635,484,0,0,1,2
8885636,8885677,41,1,0,0,2
8885678,8885730,52,0,0,1,2
8885730,8885921,191,1,0,0,1
8885731,8885947,216,1,0,0,2
8885784,8885883,99,0,1,0,1
8885786,8885880,94,0,1,0,2
8885922,8886204,282,0,0,1,1
8885948,8886203,255,0,0,1,2
8886204,8886273,69,1,0,0,2
8886205,8886262,57,1,0,0,1
8886263,8886335,72,0,0,1,1
8886274,8886335,61,0,0,1,2
8886336,8886366,30,1,0,0,2
8886336,8886370,34,1,0,0,1
8886367,8886532,165,0,0,1,2
8886371,8886532,161,0,0,1,1
8886533,8886549,16,1,0,0,1
8886533,8886553,20,1,0,0,2
8886550,8886842,292,0,0,1,1
8886554,8886842,288,0,0,1,2
8886843,8886859,16,1,0,0,2
8886843,8886867,24,1,0,0,1
8886860,8887164,304,0,0,1,2
8886868,8887162,294,0,0,1,1
8887163,8887175,12,1,0,0,1
8887165,8887175,10,1,0,0,2
8887176,8888088,912,0,0,1,1
8887176,8888089,913,0,0,1,2
8888089,8888139,50,1,0,0,1
8888090,8888138,48,1,0,0,2
8888139,8888540,401,0,0,1,2
8888140,8888540,400,0,0,1,1
8888541,8888592,51,1,0,0,1
8888541,8888613,72,1,0,0,2
8888593,8888782,189,0,0,1,1
8888614,8888677,63,0,0,1,2
8888678,8888798,120,1,0,0,2
8888783,8888810,27,1,0,0,1
8888799,8888935,136,0,0,1,2
8888811,8888932,121,0,0,1,1
8888933,8889134,201,1,0,0,1
8888936,8889145,209,1,0,0,2
8888955,8889085,130,0,1,0,2
8888959,8889078,119,0,1,0,1
8889135,8889484,349,0,0,1,1
8889146,8889492,346,0,0,1,2
8889485,8889496,11,1,0,0,1
8889493,8889558,65,1,0,0,2
8889497,8890861,1364,0,0,1,1
8889559,8890858,1299,0,0,1,2
8890859,8890956,97,1,0,0,2
8890862,8890946,84,1,0,0,1
8890947,8891019,72,0,0,1,1
8890957,8891019,62,0,0,1,2
8891020,8891062,42,1,0,0,2
8891020,8891073,53,1,0,0,1
8891063,8891228,165,0,0,1,2
8891074,8891228,154,0,0,1,1
8891229,8891247,18,1,0,0,1
8891229,8891249,20,1,0,0,2
8891248,8891443,195,0,0,1,1
8891250,8891444,194,0,0,1,2
8891444,8891474,30,1,0,0,1
8891445,8891465,20,1,0,0,2
8891466,8891659,193,0,0,1,2
8891475,8891659,184,0,0,1,1
8891660,8891671,11,1,0,0,1
8891660,8891672,12,1,0,0,2
8891672,8892370,698,0,0,1,1
8891673,8892371,698,0,0,1,2
8892371,8892511,140,1,0,0,1
8892372,8892522,150,1,0,0,2
8892406,8892455,49,0,1,0,2
8892408,8892446,38,0,1,0,1
8892512,8892969,457,0,0,1,1
8892523,8892970,447,0,0,1,2
8892970,8893071,101,1,0,0,1
8892971,8893072,101,1,0,0,2
8893072,8893353,281,0,0,1,1
8893073,8893355,282,0,0,1,2
8893354,8893403,49,1,0,0,1
8893356,8893426,70,1,0,0,2
8893404,8893576,172,0,0,1,1
8893427,8893581,154,0,0,1,2
8893577,8893598,21,1,0,0,1
8893582,8893596,14,1,0,0,2
8893597,8894762,1165,0,0,1,2
8893599,8894761,1162,0,0,1,1
8894762,8894789,27,1,0,0,1
8894763,8894788,25,1,0,0,2
8894789,8895290,501,0,0,1,2
8894790,8895290,500,0,0,1,1
8895291,8895432,141,1,0,0,1
8895291,8895437,146,1,0,0,2
8895332,8895407,75,0,1,0,2
8895337,8895390,53,0,1,0,1
8895433,8895695,262,0,0,1,1
8895438,8895696,258,0,0,1,2
8895696,8895754,58,1,0,0,1
8895697,8895750,53,1,0,0,2
8895751,8895849,98,0,0,1,2
8895755,8895848,93,0,0,1,1
8895849,8895881,32,1,0,0,1
8895850,8895878,28,1,0,0,2
8895879,8896886,1007,0,0,1,2
8895882,8896886,1004,0,0,1,1
8896887,8897079,192,1,0,0,2
8896887,8897083,196,1,0,0,1
8896906,8897044,138,0,1,0,2
8896911,8897029,118,0,1,0,1
8897080,8897566,486,0,0,1,2
8897084,8897566,482,0,0,1,1
8897567,8897624,57,1,0,0,1
8897567,8897624,57,1,0,0,2
8897625,8898175,550,0,0,1,2
8897625,8898177,552,0,0,1,1
8898176,8898255,79,1,0,0,2
8898178,8898264,86,1,0,0,1
8898256,8898327,71,0,0,1,2
8898265,8898327,62,0,0,1,1
8898328,8898363,35,1,0,0,1
8898328,8898365,37,1,0,0,2
8898364,8898452,88,0,0,1,1
8898366,8898454,88,0,0,1,2
8898453,8898487,34,1,0,0,1
8898455,8898485,30,1,0,0,2
8898486,8898667,181,0,0,1,2
8898488,8898671,183,0,0,1,1
8898668,8898685,17,1,0,0,2
8898672,8898684,12,1,0,0,1
8898685,8899741,1056,0,0,1,1
8898686,8899742,1056,0,0,1,2
8899742,8899775,33,1,0,0,1
8899743,8899777,34,1,0,0,2
8899776,8899834,58,0,0,1,1
8899778,8899823,45,0,0,1,2
8899824,8899956,132,1,0,0,2
8899835,8899902,67,1,0,0,1
8899849,8899889,40,0,1,0,2
8899903,8900155,252,0,0,1,1
8899957,8900155,198,0,0,1,2
8900156,8900323,167,1,0,0,2
8900156,8900327,171,1,0,0,1
8900179,8900274,95,0,1,0,2
8900185,8900273,88,0,1,0,1
8900324,8900586,262,0,0,1,2
8900328,8900587,259,0,0,1,1
8900587,8900661,74,1,0,0,2
8900588,8900661,73,1,0,0,1
8900662,8900743,81,0,0,1,2
8900662,8900744,82,0,0,1,1
8900744,8900782,38,1,0,0,2
8900745,8900771,26,1,0,0,1
8900772,8900956,184,0,0,1,1
8900783,8900955,172,0,0,1,2
8900956,8900978,22,1,0,0,2
8900957,8900985,28,1,0,0,1
8900979,8902478,1499,0,0,1,2
8900986,8902477,1491,0,0,1,1
8902478,8902635,157,1,0,0,1
8902479,8902633,154,1,0,0,2
8902528,8902598,70,0,1,0,2
8902530,8902594,64,0,1,0,1
8902634,8902877,243,0,0,1,2
8902636,8902875,239,0,0,1,1
8902876,8902949,73,1,0,0,1
8902878,8902951,73,1,0,0,2
8902950,8903027,77,0,0,1,1
8902952,8903027,75,0,0,1,2
8903028,8903050,22,1,0,0,2
8903028,8903062,34,1,0,0,1
8903051,8903242,191,0,0,1,2
8903063,8903243,180,0,0,1,1
8903243,8903248,5,1,0,0,2
8903244,8903257,13,1,0,0,1
8903249,8904760,1511,0,0,1,2
8903258,8904762,1504,0,0,1,1
8904761,8904957,196,1,0,0,2
8904763,8904957,194,1,0,0,1
8904793,8904918,125,0,1,0,2
8904797,8904904,107,0,1,0,1
8904958,8905286,328,0,0,1,1
8904958,8905286,328,0,0,1,2
8905287,8905338,51,1,0,0,1
8905287,8905340,53,1,0,0,2
8905339,8905377,38,0,0,1,1
8905341,8905377,36,0,0,1,2
8905378,8905402,24,1,0,0,2
8905378,8905414,36,1,0,0,1
8905403,8905599,196,0,0,1,2
8905415,8906034,619,0,0,1,1
8905600,8905611,11,1,0,0,2
8905612,8906032,420,0,0,1,2
8906033,8906058,25,1,0,0,2
8906035,8906059,24,1,0,0,1
8906059,8906271,212,0,0,1,2
8906060,8906271,211,0,0,1,1
8906272,8906282,10,1,0,0,1
8906272,8906286,14,1,0,0,2
8906283,8906532,249,0,0,1,1
8906287,8907044,757,0,0,1,2
8906533,8906545,12,1,0,0,1
8906546,8907043,497,0,0,1,1
8907044,8907075,31,1,0,0,1
8907045,8907074,29,1,0,0,2
8907075,8907497,422,0,0,1,2
8907076,8907497,421,0,0,1,1
8907498,8907577,79,1,0,0,1
8907498,8907578,80,1,0,0,2
8907578,8907608,30,0,0,1,1
8907579,8907609,30,0,0,1,2
8907609,8907645,36,1,0,0,1
8907610,8907649,39,1,0,0,2
8907646,8907736,90,0,0,1,1
8907650,8907736,86,0,0,1,2
8907737,8907758,21,1,0,0,2
8907737,8907760,23,1,0,0,1
8907759,8907893,134,0,0,1,2
8907761,8907894,133,0,0,1,1
8907894,8907911,17,1,0,0,2
8907895,8907905,10,1,0,0,1
8907906,8908307,401,0,0,1,1
8907912,8909273,1361,0,0,1,2
8908308,8908318,10,1,0,0,1
8908319,8909280,961,0,0,1,1
8909274,8909510,236,1,0,0,2
8909281,8909520,239,1,0,0,1
8909295,8909478,183,0,1,0,2
8909301,8909486,185,0,1,0,1
8909511,8909750,239,0,0,1,2
8909521,8909749,228,0,0,1,1
8909750,8909811,61,1,0,0,1
8909751,8909803,52,1,0,0,2
8909804,8909876,72,0,0,1,2
8909812,8909876,64,0,0,1,1
8909877,8909907,30,1,0,0,1
8909877,8909909,32,1,0,0,2
8909908,8910101,193,0,0,1,1
8909910,8910105,195,0,0,1,2
8910102,8910127,25,1,0,0,1
8910106,8910117,11,1,0,0,2
8910118,8911553,1435,0,0,1,2
8910128,8911552,1424,0,0,1,1
8911553,8911577,24,1,0,0,1
8911554,8911578,24,1,0,0,2
8911578,8911973,395,0,0,1,1
8911579,8911974,395,0,0,1,2
8911974,8912055,81,1,0,0,1
8911975,8912057,82,1,0,0,2
8912056,8912148,92,0,0,1,1
8912058,8912149,91,0,0,1,2
8912149,8912186,37,1,0,0,1
8912150,8912191,41,1,0,0,2
8912187,8912334,147,0,0,1,1
8912192,8912330,138,0,0,1,2
8912331,8912352,21,1,0,0,2
8912335,8912350,15,1,0,0,1
8912351,8913803,1452,0,0,1,1
8912353,8913803,1450,0,0,1,2
8913804,8913875,71,1,0,0,1
8913804,8913884,80,1,0,0,2
8913876,8914301,425,0,0,1,1
8913885,8914300,415,0,0,1,2
8914301,8914384,83,1,0,0,2
8914302,8914385,83,1,0,0,1
8914385,8914444,59,0,0,1,2
8914386,8914445,59,0,0,1,1
8914445,8914495,50,1,0,0,2
8914446,8914499,53,1,0,0,1
8914496,8914569,73,0,0,1,2
8914500,8914566,66,0,0,1,1
8914567,8914602,35,1,0,0,1
8914570,8914607,37,1,0,0,2
8914603,8914786,183,0,0,1,1
8914608,8914786,178,0,0,1,2
8914787,8914798,11,1,0,0,1
8914787,8914806,19,1,0,0,2
8914799,8916255,1456,0,0,1,1
8914807,8916257,1450,0,0,1,2
8916256,8916356,100,1,0,0,1
8916258,8916356,98,1,0,0,2
8916357,8916713,356,0,0,1,1
8916357,8916713,356,0,0,1,2
8916714,8916785,71,1,0,0,1
8916714,8916797,83,1,0,0,2
8916786,8916856,70,0,0,1,1
8916798,8916855,57,0,0,1,2
8916856,8916893,37,1,0,0,2
8916857,8916893,36,1,0,0,1
8916894,8917085,191,0,0,1,1
8916894,8917089,195,0,0,1,2
8917086,8917114,28,1,0,0,1
8917090,8917103,13,1,0,0,2
8917104,8917659,555,0,0,1,2
8917115,8917672,557,0,0,1,1
8917660,8917974,314,1,0,0,2
8917673,8917929,256,1,0,0,1
8917680,8917937,257,0,1,0,2
8917691,8917913,222,0,1,0,1
8917930,8918194,264,0,0,1,1
8917975,8918197,222,0,0,1,2
8918195,8918225,30,1,0,0,1
8918198,8918224,26,1,0,0,2
8918225,8918610,385,0,0,1,2
8918226,8918611,385,0,0,1,1
8918611,8918691,80,1,0,0,2
8918612,8918691,79,1,0,0,1
8918692,8919074,382,0,0,1,1
8918692,8919075,383,0,0,1,2
8919075,8919150,75,1,0,0,1
8919076,8919152,76,1,0,0,2
8919151,8919204,53,0,0,1,1
8919153,8919204,51,0,0,1,2
8919205,8919249,44,1,0,0,1
8919205,8919249,44,1,0,0,2
8919250,8919336,86,0,0,1,2
8919250,8919337,87,0,0,1,1
8919337,8919376,39,1,0,0,2
8919338,8919377,39,1,0,0,1
8919377,8919531,154,0,0,1,2
8919378,8919532,154,0,0,1,1
8919532,8919551,19,1,0,0,2
8919533,8919552,19,1,0,0,1
8919552,8920915,1363,0,0,1,2
8919553,8920354,801,0,0,1,1
8920355,8920369,14,1,0,0,1
8920370,8920908,538,0,0,1,1
8920909,8921145,236,1,0,0,1
8920916,8921152,236,1,0,0,2
8920939,8921116,177,0,1,0,1
8920940,8921102,162,0,1,0,2
8921146,8921419,273,0,0,1,1
8921153,8921420,267,0,0,1,2
8921420,8921486,66,1,0,0,1
8921421,8921505,84,1,0,0,2
8921487,8921570,83,0,0,1,1
8921506,8921570,64,0,0,1,2
8921571,8921606,35,1,0,0,2
8921571,8921609,38,1,0,0,1
8921607,8921895,288,0,0,1,2
8921610,8921896,286,0,0,1,1
8921896,8921907,11,1,0,0,2
8921897,8921908,11,1,0,0,1
8921908,8923372,1464,0,0,1,2
8921909,8923373,1464,0,0,1,1
8923373,8923461,88,1,0,0,2
8923374,8923460,86,1,0,0,1
8923461,8923825,364,0,0,1,1
8923462,8923827,365,0,0,1,2
8923826,8923866,40,1,0,0,1
8923828,8923869,41,1,0,0,2
8923867,8923962,95,0,0,1,1
8923870,8923961,91,0,0,1,2
8923962,8923994,32,1,0,0,2
8923963,8923982,19,1,0,0,1
8923983,8925670,1687,0,0,1,1
8923995,8925670,1675,0,0,1,2
8925671,8925852,181,1,0,0,1
8925671,8925898,227,1,0,0,2
8925698,8925842,144,0,1,0,2
8925704,8925815,111,0,1,0,1
8925853,8926149,296,0,0,1,1
8925899,8926149,250,0,0,1,2
8926150,8926238,88,1,0,0,2
8926150,8926242,92,1,0,0,1
8926239,8926320,81,0,0,1,2
8926243,8926321,78,0,0,1,1
8926321,8926356,35,1,0,0,2
8926322,8926356,34,1,0,0,1
8926357,8926670,313,0,0,1,2
8926357,8926671,314,0,0,1,1
8926671,8926690,19,1,0,0,2
8926672,8926692,20,1,0,0,1
8926691,8926876,185,0,0,1,2
8926693,8926879,186,0,0,1,1
8926877,8926902,25,1,0,0,2
8926880,8926901,21,1,0,0,1
8926902,8927723,821,0,0,1,1
8926903,8927724,821,0,0,1,2
8927724,8927737,13,1,0,0,1
8927725,8927736,11,1,0,0,2
8927737,8928115,378,0,0,1,2
8927738,8928114,376,0,0,1,1
8928115,8928331,216,1,0,0,1
8928116,8928350,234,1,0,0,2
8928194,8928290,96,0,1,0,2
8928198,8928280,82,0,1,0,1
8928332,8928555,223,0,0,1,1
8928351,8928556,205,0,0,1,2
8928556,8928616,60,1,0,0,1
8928557,8928631,74,1,0,0,2
8928617,8928811,194,0,0,1,1
8928632,8929807,1175,0,0,1,2
8928812,8928816,4,1,0,0,1
8928817,8929803,986,0,0,1,1
8929804,8929993,189,1,0,0,1
8929808,8929993,185,1,0,0,2
8929831,8929938,107,0,1,0,2
8929832,8929929,97,0,1,0,1
8929994,8930326,332,0,0,1,2
8929994,8930327,333,0,0,1,1
8930327,8930381,54,1,0,0,2
8930328,8930381,53,1,0,0,1
8930382,8930757,375,0,0,1,1
8930382,8930757,375,0,0,1,2
8930758,8930836,78,1,0,0,1
8930758,8930837,79,1,0,0,2
8930837,8930865,28,0,0,1,1
8930838,8930868,30,0,0,1,2
8930866,8930908,42,1,0,0,1
8930869,8930908,39,1,0,0,2
8930909,8931039,130,0,0,1,1
8930909,8931041,132,0,0,1,2
8931040,8931055,15,1,0,0,1
8931042,8931055,13,1,0,0,2
8931056,8932435,1379,0,0,1,1
8931056,8932436,1380,0,0,1,2
8932436,8932583,147,1,0,0,1
8932437,8932584,147,1,0,0,2
8932475,8932550,75,0,1,0,2
8932479,8932543,64,0,1,0,1
8932584,8932911,327,0,0,1,1
8932585,8932912,327,0,0,1,2
8932912,8932993,81,1,0,0,1
8932913,8932993,80,1,0,0,2
8932994,8933020,26,0,0,1,2
8932994,8933021,27,0,0,1,1
8933021,8933072,51,1,0,0,2
8933022,8933061,39,1,0,0,1
8933062,8933469,407,0,0,1,1
8933073,8933474,401,0,0,1,2
8933470,8933498,28,1,0,0,1
8933475,8933491,16,1,0,0,2
8933492,8934678,1186,0,0,1,2
8933499,8934678,1179,0,0,1,1
8934679,8934758,79,1,0,0,1
8934679,8934758,79,1,0,0,2
8934759,8935141,382,0,0,1,2
8934759,8935142,383,0,0,1,1
8935142,8935217,75,1,0,0,2
8935143,8935215,72,1,0,0,1
8935216,8935306,90,0,0,1,1
8935218,8935306,88,0,0,1,2
8935307,8935340,33,1,0,0,1
8935307,8935341,34,1,0,0,2
8935341,8936958,1617,0,0,1,1
8935342,8936958,1616,0,0,1,2
8936959,8937008,49,1,0,0,1
8936959,8937009,50,1,0,0,2
8937009,8937387,378,0,0,1,1
8937010,8937385,375,0,0,1,2
8937386,8937437,51,1,0,0,2
8937388,8937439,51,1,0,0,1
8937438,8937549,111,0,0,1,2
8937440,8937548,108,0,0,1,1
8937549,8937584,35,1,0,0,1
8937550,8937586,36,1,0,0,2
8937585,8939292,1707,0,0,1,1
8937587,8939293,1706,0,0,1,2
8939293,8939384,91,1,0,0,1
8939294,8939384,90,1,0,0,2
8939385,8939678,293,0,0,1,1
8939385,8939678,293,0,0,1,2
8939679,8939737,58,1,0,0,2
8939679,8939746,67,1,0,0,1
8939738,8939830,92,0,0,1,2
8939747,8939830,83,0,0,1,1
8939831,8939850,19,1,0,0,1
8939831,8939861,30,1,0,0,2
8939851,8940028,177,0,0,1,1
8939862,8940028,166,0,0,1,2
8940029,8940246,217,1,0,0,1
8940029,8940267,238,1,0,0,2
8940045,8940230,185,0,1,0,2
8940053,8940234,181,0,1,0,1
8940247,8940384,137,0,0,1,1
8940268,8940387,119,0,0,1,2
8940385,8940401,16,1,0,0,1
8940388,8940399,11,1,0,0,2
8940400,8941618,1218,0,0,1,2
8940402,8941619,1217,0,0,1,1
8941619,8941659,40,1,0,0,2
8941620,8941644,24,1,0,0,1
8941645,8942076,431,0,0,1,1
8941660,8942075,415,0,0,1,2
8942076,8942139,63,1,0,0,2
8942077,8942138,61,1,0,0,1
8942139,8942230,91,0,0,1,1
8942140,8942230,90,0,0,1,2
8942231,8942262,31,1,0,0,2
8942231,8942264,33,1,0,0,1
8942263,8943140,877,0,0,1,2
8942265,8943145,880,0,0,1,1
8943141,8943159,18,1,0,0,2
8943146,8943159,13,1,0,0,1
8943160,8943518,358,0,0,1,2
8943160,8943960,800,0,0,1,1
8943519,8943535,16,1,0,0,2
8943536,8943957,421,0,0,1,2
8943958,8944128,170,1,0,0,2
8943961,8944102,141,1,0,0,1
8943994,8944077,83,0,1,0,2
8944002,8944052,50,0,1,0,1
8944103,8944457,354,0,0,1,1
8944129,8944458,329,0,0,1,2
8944458,8944532,74,1,0,0,1
8944459,8944532,73,1,0,0,2
8944533,8944611,78,0,0,1,1
8944533,8944611,78,0,0,1,2
8944612,8944647,35,1,0,0,1
8944612,8944648,36,1,0,0,2
8944648,8944775,127,0,0,1,1
8944649,8944774,125,0,0,1,2
8944775,8944795,20,1,0,0,2
8944776,8944793,17,1,0,0,1
8944794,8945008,214,0,0,1,1
8944796,8945008,212,0,0,1,2
8945009,8945019,10,1,0,0,2
8945009,8945023,14,1,0,0,1
8945020,8945656,636,0,0,1,2
8945024,8945658,634,0,0,1,1
8945657,8945687,30,1,0,0,2
8945659,8945687,28,1,0,0,1
8945688,8946665,977,0,0,1,2
8945688,8946666,978,0,0,1,1
8946666,8946780,114,1,0,0,2
8946667,8946774,107,1,0,0,1
8946775,8947061,286,0,0,1,1
8946781,8947063,282,0,0,1,2
8947062,8947128,66,1,0,0,1
8947064,8947139,75,1,0,0,2
8947129,8948623,1494,0,0,1,1
8947140,8948617,1477,0,0,1,2
8948618,8948814,196,1,0,0,2
8948624,8948850,226,1,0,0,1
8948641,8948783,142,0,1,0,2
8948646,8948769,123,0,1,0,1
8948815,8949006,191,0,0,1,2
8948851,8949005,154,0,0,1,1
8949006,8949032,26,1,0,0,1
8949007,8949022,15,1,0,0,2
8949023,8949290,267,0,0,1,2
8949033,8949287,254,0,0,1,1
8949288,8949480,192,1,0,0,1
8949291,8949487,196,1,0,0,2
8949307,8949454,147,0,1,0,1
8949307,8949458,151,0,1,0,2
8949481,8949817,336,0,0,1,1
8949488,8949816,328,0,0,1,2
8949817,8949882,65,1,0,0,2
8949818,8949900,82,1,0,0,1
8949883,8949951,68,0,0,1,2
8949901,8949951,50,0,0,1,1
8949952,8949984,32,1,0,0,1
8949952,8949986,34,1,0,0,2
8949985,8950147,162,0,0,1,1
8949987,8950148,161,0,0,1,2
8950148,8950169,21,1,0,0,1
8950149,8950165,16,1,0,0,2
8950166,8950612,446,0,0,1,2
8950170,8950614,444,0,0,1,1
8950613,8950645,32,1,0,0,2
8950615,8950641,26,1,0,0,1
8950642,8951019,377,0,0,1,1
8950646,8951019,373,0,0,1,2
8951020,8951037,17,1,0,0,2
8951020,8951046,26,1,0,0,1
8951038,8951622,584,0,0,1,2
8951047,8951630,583,0,0,1,1
8951623,8951936,313,1,0,0,2
8951631,8951910,279,1,0,0,1
8951645,8951884,239,0,1,0,2
8951648,8951886,238,0,1,0,1
8951911,8952109,198,0,0,1,1
8951937,8952110,173,0,0,1,2
8952110,8952192,82,1,0,0,1
8952111,8952180,69,1,0,0,2
8952181,8952599,418,0,0,1,2
8952193,8952598,405,0,0,1,1
8952599,8952670,71,1,0,0,1
8952600,8952656,56,1,0,0,2
8952657,8952741,84,0,0,1,2
8952671,8952741,70,0,0,1,1
8952742,8952783,41,1,0,0,2
8952742,8952791,49,1,0,0,1
8952784,8952940,156,0,0,1,2
8952792,8952940,148,0,0,1,1
8952941,8952958,17,1,0,0,1
8952941,8952960,19,1,0,0,2
8952959,8953180,221,0,0,1,1
8952961,8953183,222,0,0,1,2
8953181,8953208,27,1,0,0,1
8953184,8953199,15,1,0,0,2
8953200,8953409,209,0,0,1,2
8953209,8953955,746,0,0,1,1
8953410,8953420,10,1,0,0,2
8953421,8953960,539,0,0,1,2
8953956,8953983,27,1,0,0,1
8953961,8953980,19,1,0,0,2
8953981,8954398,417,0,0,1,2
8953984,8954400,416,0,0,1,1
8954399,8954630,231,1,0,0,2
8954401,8954609,208,1,0,0,1
8954440,8954561,121,0,1,0,2
8954441,8954555,114,0,1,0,1
8954610,8954939,329,0,0,1,1
8954631,8954938,307,0,0,1,2
8954939,8955023,84,1,0,0,2
8954940,8955023,83,1,0,0,1
8955024,8955377,353,0,0,1,1
8955024,8955378,354,0,0,1,2
8955378,8955445,67,1,0,0,1
8955379,8955444,65,1,0,0,2
8955445,8955590,145,0,0,1,2
8955446,8955591,145,0,0,1,1
8955591,8955621,30,1,0,0,2
8955592,8955623,31,1,0,0,1
8955622,8957194,1572,0,0,1,2
8955624,8957196,1572,0,0,1,1
8957195,8957383,188,1,0,0,2
8957197,8957356,159,1,0,0,1
8957234,8957317,83,0,1,0,2
8957238,8957298,60,0,1,0,1
8957357,8957653,296,0,0,1,1
8957384,8957654,270,0,0,1,2
8957654,8957741,87,1,0,0,1
8957655,8957735,80,1,0,0,2
8957736,8957814,78,0,0,1,2
8957742,8957813,71,0,0,1,1
8957814,8957854,40,1,0,0,1
8957815,8957857,42,1,0,0,2
8957855,8957993,138,0,0,1,1
8957858,8957990,132,0,0,1,2
8957991,8958008,17,1,0,0,2
8957994,8958007,13,1,0,0,1
8958008,8958377,369,0,0,1,1
8958009,8958374,365,0,0,1,2
8958375,8958392,17,1,0,0,2
8958378,8958389,11,1,0,0,1
8958390,8959671,1281,0,0,1,1
8958393,8959670,1277,0,0,1,2
8959671,8959742,71,1,0,0,2
8959672,8959734,62,1,0,0,1
8959735,8960027,292,0,0,1,1
8959743,8960026,283,0,0,1,2
8960027,8960101,74,1,0,0,2
8960028,8960095,67,1,0,0,1
8960096,8960215,119,0,0,1,1
8960102,8960217,115,0,0,1,2
8960216,8960246,30,1,0,0,1
8960218,8960246,28,1,0,0,2
8960247,8960435,188,0,0,1,2
8960247,8962031,1784,0,0,1,1
8960436,8960447,11,1,0,0,2
8960448,8962035,1587,0,0,1,2
8962032,8962244,212,1,0,0,1
8962036,8962261,225,1,0,0,2
8962053,8962201,148,0,1,0,2
8962055,8962199,144,0,1,0,1
8962245,8962502,257,0,0,1,1
8962262,8962501,239,0,0,1,2
8962502,8962572,70,1,0,0,2
8962503,8962586,83,1,0,0,1
8962573,8962732,159,0,0,1,2
8962587,8962733,146,0,0,1,1
8962733,8962767,34,1,0,0,2
8962734,8962763,29,1,0,0,1
8962764,8962961,197,0,0,1,1
8962768,8962961,193,0,0,1,2
8962962,8962970,8,1,0,0,2
8962962,8962973,11,1,0,0,1
8962971,8964999,2028,0,0,1,2
8962974,8964998,2024,0,0,1,1
8964999,8965090,91,1,0,0,1
8965000,8965081,81,1,0,0,2
8965082,8965431,349,0,0,1,2
8965091,8965432,341,0,0,1,1
8965432,8965510,78,1,0,0,2
8965433,8965511,78,1,0,0,1
8965511,8965599,88,0,0,1,2
8965512,8965600,88,0,0,1,1
8965600,8965633,33,1,0,0,2
8965601,8965632,31,1,0,0,1
8965633,8965816,183,0,0,1,1
8965634,8966187,553,0,0,1,2
8965817,8965833,16,1,0,0,1
8965834,8966192,358,0,0,1,1
8966188,8966428,240,1,0,0,2
8966193,8966425,232,1,0,0,1
8966206,8966410,204,0,1,0,2
8966215,8966364,149,0,1,0,1
8966426,8966576,150,0,0,1,1
8966429,8966575,146,0,0,1,2
8966576,8966592,16,1,0,0,2
8966577,8966597,20,1,0,0,1
8966593,8967282,689,0,0,1,2
8966598,8967276,678,0,0,1,1
8967277,8967287,10,1,0,0,1
8967283,8967287,4,1,0,0,2
8967288,8968039,751,0,0,1,1
8967288,8968039,751,0,0,1,2
8968040,8968130,90,1,0,0,1
8968040,8968133,93,1,0,0,2
8968131,8968492,361,0,0,1,1
8968134,8968493,359,0,0,1,2
8968493,8968562,69,1,0,0,1
8968494,8968561,67,1,0,0,2
8968562,8968639,77,0,0,1,2
8968563,8968640,77,0,0,1,1
8968640,8968673,33,1,0,0,2
8968641,8968663,22,1,0,0,1
8968664,8970552,1888,0,0,1,1
8968674,8970550,1876,0,0,1,2
8970551,8970606,55,1,0,0,2
8970553,8970604,51,1,0,0,1
8970605,8971039,434,0,0,1,1
8970607,8971039,432,0,0,1,2
8971040,8971111,71,1,0,0,2
8971040,8971122,82,1,0,0,1
8971112,8971261,149,0,0,1,2
8971123,8971260,137,0,0,1,1
8971261,8971289,28,1,0,0,1
8971262,8971280,18,1,0,0,2
8971281,8972531,1250,0,0,1,2
8971290,8972537,1247,0,0,1,1
8972532,8972750,218,1,0,0,2
8972538,8972728,190,1,0,0,1
8972561,8972703,142,0,1,0,2
8972570,8972679,109,0,1,0,1
8972729,8972822,93,0,0,1,1
8972751,8972822,71,0,0,1,2
8972823,8972855,32,1,0,0,2
8972823,8972856,33,1,0,0,1
8972856,8973164,308,0,0,1,2
8972857,8973164,307,0,0,1,1
8973165,8973224,59,1,0,0,1
8973165,8973226,61,1,0,0,2
8973225,8973535,310,0,0,1,1
8973227,8973535,308,0,0,1,2
8973536,8973605,69,1,0,0,1
8973536,8973608,72,1,0,0,2
8973606,8973712,106,0,0,1,1
8973609,8973712,103,0,0,1,2
8973713,8973748,35,1,0,0,2
8973713,8973749,36,1,0,0,1
8973749,8973930,181,0,0,1,2
8973750,8973934,184,0,0,1,1
8973931,8973948,17,1,0,0,2
8973935,8973947,12,1,0,0,1
8973948,8974621,673,0,0,1,1
8973949,8974625,676,0,0,1,2
8974622,8974807,185,1,0,0,1
8974626,8974816,190,1,0,0,2
8974649,8974753,104,0,1,0,2
8974650,8974747,97,0,1,0,1
8974808,8974916,108,0,0,1,1
8974817,8974915,98,0,0,1,2
8974916,8974933,17,1,0,0,2
8974917,8974932,15,1,0,0,1
8974933,8975269,336,0,0,1,1
8974934,8975266,332,0,0,1,2
8975267,8975348,81,1,0,0,2
8975270,8975330,60,1,0,0,1
8975331,8975699,368,0,0,1,1
8975349,8975699,350,0,0,1,2
8975700,8975755,55,1,0,0,1
8975700,8975776,76,1,0,0,2
8975756,8975842,86,0,0,1,1
8975777,8975843,66,0,0,1,2
8975843,8975878,35,1,0,0,1
8975844,8975884,40,1,0,0,2
8975879,8976114,235,0,0,1,1
8975885,8976119,234,0,0,1,2
8976115,8976141,26,1,0,0,1
8976120,8976132,12,1,0,0,2
8976133,8977460,1327,0,0,1,2
8976142,8977458,1316,0,0,1,1
8977459,8977698,239,1,0,0,1
8977461,8977691,230,1,0,0,2
8977489,8977667,178,0,1,0,1
8977491,8977658,167,0,1,0,2
8977692,8977944,252,0,0,1,2
8977699,8977943,244,0,0,1,1
8977944,8978026,82,1,0,0,1
8977945,8978059,114,1,0,0,2
8978027,8978197,170,0,0,1,1
8978060,8978108,48,0,0,1,2
8978109,8978138,29,1,0,0,2
8978139,8978325,186,0,0,1,2
8978198,8978220,22,1,0,0,1
8978221,8980001,1780,0,0,1,1
8978326,8978342,16,1,0,0,2
8978343,8978813,470,0,0,1,2
8978814,8978819,5,1,0,0,2
8978820,8979414,594,0,0,1,2
8979415,8979519,104,1,0,0,2
8979520,8979963,443,0,0,1,2
8979964,8980189,225,1,0,0,2
8980002,8980201,199,1,0,0,1
8980017,8980155,138,0,1,0,2
8980024,8980155,131,0,1,0,1
8980190,8980535,345,0,0,1,2
8980202,8980533,331,0,0,1,1
8980534,8980620,86,1,0,0,1
8980536,8980607,71,1,0,0,2
8980608,8980686,78,0,0,1,2
8980621,8980684,63,0,0,1,1
8980685,8980724,39,1,0,0,1
8980687,8980721,34,1,0,0,2
8980722,8980848,126,0,0,1,2
8980725,8980849,124,0,0,1,1
8980849,8980867,18,1,0,0,2
8980850,8980867,17,1,0,0,1
8980868,8982663,1795,0,0,1,1
8980868,8982663,1795,0,0,1,2
8982664,8982857,193,1,0,0,1
8982664,8982879,215,1,0,0,2
8982706,8982811,105,0,1,0,1
8982707,8982816,109,0,1,0,2
8982858,8983143,285,0,0,1,1
8982880,8983145,265,0,0,1,2
8983144,8983233,89,1,0,0,1
8983146,8983222,76,1,0,0,2
8983223,8983301,78,0,0,1,2
8983234,8983300,66,0,0,1,1
8983301,8983336,35,1,0,0,1
8983302,8983333,31,1,0,0,2
8983334,8983491,157,0,0,1,2
8983337,8983497,160,0,0,1,1
8983492,8983511,19,1,0,0,2
8983498,8983506,8,1,0,0,1
8983507,8984936,1429,0,0,1,1
8983512,8984938,1426,0,0,1,2
8984937,8984971,34,1,0,0,1
8984939,8984971,32,1,0,0,2
8984972,8985083,111,0,0,1,1
8984972,8985084,112,0,0,1,2
8985084,8985102,18,1,0,0,1
8985085,8985106,21,1,0,0,2
8985103,8985480,377,0,0,1,1
8985107,8985480,373,0,0,1,2
8985481,8985640,159,1,0,0,1
8985481,8985657,176,1,0,0,2
8985518,8985598,80,0,1,0,1
8985518,8985605,87,0,1,0,2
8985641,8986005,364,0,0,1,1
8985658,8986003,345,0,0,1,2
8986004,8986076,72,1,0,0,2
8986006,8986074,68,1,0,0,1
8986075,8986155,80,0,0,1,1
8986077,8986155,78,0,0,1,2
8986156,8986197,41,1,0,0,2
8986156,8986198,42,1,0,0,1
8986198,8986371,173,0,0,1,2
8986199,8986371,172,0,0,1,1
8986372,8986387,15,1,0,0,2
8986372,8986388,16,1,0,0,1
8986388,8988160,1772,0,0,1,2
8986389,8988156,1767,0,0,1,1
8988157,8988373,216,1,0,0,1
8988161,8988355,194,1,0,0,2
8988206,8988318,112,0,1,0,1
8988206,8988318,112,0,1,0,2
8988356,8988656,300,0,0,1,2
8988374,8988655,281,0,0,1,1
8988656,8988717,61,1,0,0,1
8988657,8988716,59,1,0,0,2
8988717,8988820,103,0,0,1,2
8988718,8988819,101,0,0,1,1
8988820,8988860,40,1,0,0,1
8988821,8988851,30,1,0,0,2
8988852,8989038,186,0,0,1,2
8988861,8989043,182,0,0,1,1
8989039,8989057,18,1,0,0,2
8989044,8989054,10,1,0,0,1
8989055,8989770,715,0,0,1,1
8989058,8989768,710,0,0,1,2
8989769,8989785,16,1,0,0,2
8989771,8989795,24,1,0,0,1
8989786,8991305,1519,0,0,1,2
8989796,8991306,1510,0,0,1,1
8991306,8991362,56,1,0,0,2
8991307,8991375,68,1,0,0,1
8991363,8991953,590,0,0,1,2
8991376,8991954,578,0,0,1,1
8991954,8991982,28,1,0,0,2
8991955,8991990,35,1,0,0,1
8991983,8993382,1399,0,0,1,2
8991991,8993377,1386,0,0,1,1
8993378,8993605,227,1,0,0,1
8993383,8993620,237,1,0,0,2
8993415,8993573,158,0,1,0,2
8993417,8993565,148,0,1,0,1
8993606,8993736,130,0,0,1,1
8993621,8993732,111,0,0,1,2
8993733,8993986,253,1,0,0,2
8993737,8993994,257,1,0,0,1
8993752,8993948,196,0,1,0,2
8993753,8993958,205,0,1,0,1
8993987,8994202,215,0,0,1,2
8993995,8994201,206,0,0,1,1
8994202,8994244,42,1,0,0,1
8994203,8994244,41,1,0,0,2
8994245,8994732,487,0,0,1,1
8994245,8994732,487,0,0,1,2
8994733,8994808,75,1,0,0,2
8994733,8994810,77,1,0,0,1
8994809,8994901,92,0,0,1,2
8994811,8994901,90,0,0,1,1
8994902,8994938,36,1,0,0,2
8994902,8994939,37,1,0,0,1
8994939,8995151,212,0,0,1,2
8994940,8995149,209,0,0,1,1
8995150,8995178,28,1,0,0,1
8995152,8995172,20,1,0,0,2
8995173,8997110,1937,0,0,1,2
8995179,8997108,1929,0,0,1,1
8997109,8997291,182,1,0,0,1
8997111,8997288,177,1,0,0,2
8997185,8997253,68,0,1,0,1
8997189,8997248,59,0,1,0,2
8997289,8997353,64,0,0,1,2
8997292,8997353,61,0,0,1,1
8997354,8997385,31,1,0,0,1
8997354,8997387,33,1,0,0,2
8997386,8997597,211,0,0,1,1
8997388,8997598,210,0,0,1,2
8997598,8997630,32,1,0,0,1
8997599,8997628,29,1,0,0,2
8997629,8997968,339,0,0,1,2
8997631,8997969,338,0,0,1,1
8997969,8997997,28,1,0,0,2
8997970,8997987,17,1,0,0,1
8997988,8998270,282,0,0,1,1
8997998,8998269,271,0,0,1,2
8998270,8998288,18,1,0,0,2
8998271,8998289,18,1,0,0,1
8998289,8999227,938,0,0,1,2
8998290,8999225,935,0,0,1,1
8999226,8999488,262,1,0,0,1
8999228,8999496,268,1,0,0,2
8999254,8999444,190,0,1,0,1
8999255,8999446,191,0,1,0,2
8999489,8999695,206,0,0,1,1
8999497,8999694,197,0,0,1,2
8999695,8999735,40,1,0,0,2
8999696,8999735,39,1,0,0,1
8999736,9000269,533,0,0,1,1
8999736,9000269,533,0,0,1,2
9000270,9000296,26,1,0,0,1
9000270,9000315,45,1,0,0,2
9000297,9000791,494,0,0,1,1
9000316,9000791,475,0,0,1,2
9000792,9000819,27,1,0,0,1
9000792,9000826,34,1,0,0,2
9000820,9001009,189,0,0,1,1
9000827,9001008,181,0,0,1,2
9001009,9001021,12,1,0,0,2
9001010,9001022,12,1,0,0,1
9001022,9001597,575,0,0,1,2
9001023,9001597,574,0,0,1,1
9001598,9001755,157,1,0,0,1
9001598,9001783,185,1,0,0,2
9001620,9001719,99,0,1,0,2
9001626,9001698,72,0,1,0,1
9001756,9001922,166,0,0,1,1
9001784,9001921,137,0,0,1,2
9001922,9001935,13,1,0,0,2
9001923,9001932,9,1,0,0,1
9001933,9002616,683,0,0,1,1
9001936,9002616,680,0,0,1,2
9002617,9002671,54,1,0,0,1
9002617,9002682,65,1,0,0,2
9002672,9003082,410,0,0,1,1
9002683,9003082,399,0,0,1,2
9003083,9003211,128,1,0,0,2
9003083,9003225,142,1,0,0,1
9003114,9003160,46,0,1,0,1
9003118,9003154,36,0,1,0,2
9003212,9004718,1506,0,0,1,2
9003226,9004720,1494,0,0,1,1
9004719,9004966,247,1,0,0,2
9004721,9004962,241,1,0,0,1
9004764,9004921,157,0,1,0,2
9004766,9004913,147,0,1,0,1
9004963,9005029,66,0,0,1,1
9004967,9005031,64,0,0,1,2
9005030,9005038,8,1,0,0,1
9005032,9005057,25,1,0,0,2
9005039,9005197,158,0,0,1,1
9005058,9005194,136,0,0,1,2
9005195,9005422,227,1,0,0,2
9005198,9005431,233,1,0,0,1
9005217,9005387,170,0,1,0,2
9005217,9005396,179,0,1,0,1
9005423,9006034,611,0,0,1,2
9005432,9006033,601,0,0,1,1
9006034,9006087,53,1,0,0,1
9006035,9006098,63,1,0,0,2
9006088,9007073,985,0,0,1,1
9006099,9006293,194,0,0,1,2
9006294,9006302,8,1,0,0,2
9006303,9007076,773,0,0,1,2
9007074,9007095,21,1,0,0,1
9007077,9007096,19,1,0,0,2
9007096,9007395,299,0,0,1,1
9007097,9007393,296,0,0,1,2
9007394,9007411,17,1,0,0,2
9007396,9007409,13,1,0,0,1
9007410,9008124,714,0,0,1,1
9007412,9008125,713,0,0,1,2
9008125,9008194,69,1,0,0,1
9008126,9008195,69,1,0,0,2
9008195,9008368,173,0,0,1,1
9008196,9008373,177,0,0,1,2
9008369,9008577,208,1,0,0,1
9008374,9008603,229,1,0,0,2
9008392,9008557,165,0,1,0,2
9008394,9008538,144,0,1,0,1
9008578,9010160,1582,0,0,1,1
9008604,9010164,1560,0,0,1,2
9010161,9010410,249,1,0,0,1
9010165,9010397,232,1,0,0,2
9010191,9010365,174,0,1,0,2
9010196,9010355,159,0,1,0,1
9010398,9010473,75,0,0,1,2
9010411,9010474,63,0,0,1,1
9010474,9010745,271,1,0,0,2
9010475,9010762,287,1,0,0,1
9010493,9010723,230,0,1,0,1
9010495,9010707,212,0,1,0,2
9010746,9011364,618,0,0,1,2
9010763,9011363,600,0,0,1,1
9011364,9011436,72,1,0,0,1
9011365,9011427,62,1,0,0,2
9011428,9011532,104,0,0,1,2
9011437,9011532,95,0,0,1,1
9011533,9011557,24,1,0,0,2
9011533,9011568,35,1,0,0,1
9011558,9011790,232,0,0,1,2
9011569,9011789,220,0,0,1,1
9011790,9011808,18,1,0,0,1
9011791,9011808,17,1,0,0,2
9011809,9011987,178,0,0,1,1
9011809,9011987,178,0,0,1,2
9011988,9012006,18,1,0,0,2
9011988,9012007,19,1,0,0,1
9012007,9013630,1623,0,0,1,2
9012008,9012239,231,0,0,1,1
9012240,9012251,11,1,0,0,1
9012252,9013625,1373,0,0,1,1
9013626,9013788,162,1,0,0,1
9013631,9013780,149,1,0,0,2
9013654,9013739,85,0,1,0,1
9013654,9013746,92,0,1,0,2
9013781,9013865,84,0,0,1,2
9013789,9013866,77,0,0,1,1
9013866,9013900,34,1,0,0,2
9013867,9013898,31,1,0,0,1
9013899,9014128,229,0,0,1,1
9013901,9015610,1709,0,0,1,2
9014129,9014139,10,1,0,0,1
9014140,9014411,271,0,0,1,1
9014412,9014427,15,1,0,0,1
9014428,9015607,1179,0,0,1,1
9015608,9015850,242,1,0,0,1
9015611,9015858,247,1,0,0,2
9015650,9015796,146,0,1,0,1
9015650,9015796,146,0,1,0,2
9015851,9017235,1384,0,0,1,1
9015859,9017234,1375,0,0,1,2
9017235,9017297,62,1,0,0,2
9017236,9017296,60,1,0,0,1
9017297,9017424,127,0,0,1,1
9017298,9017425,127,0,0,1,2
9017425,9017455,30,1,0,0,1
9017426,9017446,20,1,0,0,2
9017447,9017866,419,0,0,1,2
9017456,9017865,409,0,0,1,1
9017866,9017897,31,1,0,0,1
9017867,9017898,31,1,0,0,2
9017898,9018069,171,0,0,1,1
9017899,9018069,170,0,0,1,2
9018070,9018077,7,1,0,0,2
9018070,9018084,14,1,0,0,1
9018078,9020229,2151,0,0,1,2
9018085,9019282,1197,0,0,1,1
9019283,9019296,13,1,0,0,1
9019297,9020232,935,0,0,1,1
9020230,9020431,201,1,0,0,2
9020233,9020401,168,1,0,0,1
9020270,9020378,108,0,1,0,2
9020276,9020361,85,0,1,0,1
9020402,9020521,119,0,0,1,1
9020432,9020521,89,0,0,1,2
9020522,9020542,20,1,0,0,2
9020522,9020543,21,1,0,0,1
9020543,9020775,232,0,0,1,2
9020544,9020770,226,0,0,1,1
9020771,9020798,27,1,0,0,1
9020776,9020789,13,1,0,0,2
9020790,9022269,1479,0,0,1,2
9020799,9022267,1468,0,0,1,1
9022268,9022763,495,1,0,0,1
9022270,9022765,495,1,0,0,2
9022306,9022748,442,0,1,0,1
9022307,9022749,442,0,1,0,2
9022764,9023378,614,0,0,1,1
9022766,9023380,614,0,0,1,2
9023379,9023586,207,1,0,0,1
9023381,9023611,230,1,0,0,2
9023403,9023559,156,0,1,0,2
9023405,9023547,142,0,1,0,1
9023587,9024294,707,0,0,1,1
9023612,9024293,681,0,0,1,2
9024294,9024379,85,1,0,0,2
9024295,9024366,71,1,0,0,1
9024367,9024477,110,0,0,1,1
9024380,9024478,98,0,0,1,2
9024478,9024507,29,1,0,0,1
9024479,9024499,20,1,0,0,2
9024500,9025338,838,0,0,1,2
9024508,9025338,830,0,0,1,1
9025339,9025367,28,1,0,0,1
9025339,9025368,29,1,0,0,2
9025368,9025667,299,0,0,1,1
9025369,9026009,640,0,0,1,2
9025668,9025679,11,1,0,0,1
9025680,9026004,324,0,0,1,1
9026005,9026191,186,1,0,0,1
9026010,9026216,206,1,0,0,2
9026026,9026142,116,0,1,0,1
9026030,9026135,105,0,1,0,2
9026192,9026684,492,0,0,1,1
9026217,9026683,466,0,0,1,2
9026684,9026733,49,1,0,0,2
9026685,9026734,49,1,0,0,1
9026734,9027244,510,0,0,1,2
9026735,9027240,505,0,0,1,1
9027241,9027257,16,1,0,0,1
9027245,9027257,12,1,0,0,2
9027258,9027317,59,0,0,1,1
9027258,9027321,63,0,0,1,2
9027318,9027584,266,1,0,0,1
9027322,9027584,262,1,0,0,2
9027342,9027503,161,0,1,0,1
9027343,9027494,151,0,1,0,2
9027585,9028697,1112,0,0,1,1
9027585,9028697,1112,0,0,1,2
9028698,9029022,324,1,0,0,1
9028698,9029054,356,1,0,0,2
9028729,9028985,256,0,1,0,2
9028729,9028996,267,0,1,0,1
9029023,9029172,149,0,0,1,1
9029055,9029174,119,0,0,1,2
9029173,9029235,62,1,0,0,1
9029175,9029233,58,1,0,0,2
9029234,9029384,150,0,0,1,2
9029236,9029399,163,0,0,1,1
9029385,9029679,294,1,0,0,2
9029400,9029675,275,1,0,0,1
9029419,9029627,208,0,1,0,1
9029421,9029628,207,0,1,0,2
9029676,9030316,640,0,0,1,1
9029680,9030315,635,0,0,1,2
9030316,9030385,69,1,0,0,2
9030317,9030383,66,1,0,0,1
9030384,9030475,91,0,0,1,1
9030386,9030475,89,0,0,1,2
9030476,9030494,18,1,0,0,1
9030476,9030499,23,1,0,0,2
9030495,9030659,164,0,0,1,1
9030500,9030658,158,0,0,1,2
9030659,9030697,38,1,0,0,2
9030660,9030694,34,1,0,0,1
9030695,9030898,203,0,0,1,1
9030698,9030895,197,0,0,1,2
9030896,9030915,19,1,0,0,2
9030899,9030914,15,1,0,0,1
9030915,9031293,378,0,0,1,1
9030916,9031294,378,0,0,1,2
9031294,9031324,30,1,0,0,1
9031295,9031323,28,1,0,0,2
9031324,9031619,295,0,0,1,2
9031325,9031621,296,0,0,1,1
9031620,9031639,19,1,0,0,2
9031622,9031639,17,1,0,0,1
9031640,9031962,322,0,0,1,1
9031640,9031968,328,0,0,1,2
9031963,9031992,29,1,0,0,1
9031969,9031990,21,1,0,0,2
9031991,9032422,431,0,0,1,2
9031993,9032426,433,0,0,1,1
9032423,9032611,188,1,0,0,2
9032427,9032595,168,1,0,0,1
9032454,9032554,100,0,1,0,2
9032455,9032542,87,0,1,0,1
9032596,9033404,808,0,0,1,1
9032612,9033404,792,0,0,1,2
9033405,9033437,32,1,0,0,2
9033405,9033440,35,1,0,0,1
9033438,9035439,2001,0,0,1,2
9033441,9035440,1999,0,0,1,1
9035440,9035690,250,1,0,0,2
9035441,9035691,250,1,0,0,1
9035465,9035651,186,0,1,0,1
9035467,9035640,173,0,1,0,2
9035691,9035732,41,0,0,1,2
9035692,9035734,42,0,0,1,1
9035733,9035992,259,1,0,0,2
9035735,9036001,266,1,0,0,1
9035753,9035965,212,0,1,0,1
9035758,9035953,195,0,1,0,2
9035993,9036054,61,0,0,1,2
9036002,9037080,1078,0,0,1,1
9036055,9036072,17,1,0,0,2
9036073,9037080,1007,0,0,1,2
9037081,9037137,56,1,0,0,1
9037081,9037137,56,1,0,0,2
9037138,9037253,115,0,0,1,2
9037138,9037255,117,0,0,1,1
9037254,9037282,28,1,0,0,2
9037256,9037279,23,1,0,0,1
9037280,9038509,1229,0,0,1,1
9037283,9038513,1230,0,0,1,2
9038510,9038747,237,1,0,0,1
9038514,9038693,179,1,0,0,2
9038528,9038684,156,0,1,0,1
9038534,9038667,133,0,1,0,2
9038694,9038894,200,0,0,1,2
9038748,9038894,146,0,0,1,1
9038895,9038969,74,1,0,0,1
9038895,9038969,74,1,0,0,2
9038970,9039206,236,0,0,1,1
9038970,9039206,236,0,0,1,2
9039207,9039218,11,1,0,0,2
9039207,9039226,19,1,0,0,1
9039219,9040874,1655,0,0,1,2
9039227,9040874,1647,0,0,1,1
9040875,9041317,442,1,0,0,1
9040875,9041324,449,1,0,0,2
9040906,9041276,370,0,1,0,2
9040906,9041306,400,0,1,0,1
9041318,9041487,169,0,0,1,1
9041325,9041790,465,0,0,1,2
9041488,9041497,9,1,0,0,1
9041498,9041790,292,0,0,1,1
9041791,9041832,41,1,0,0,1
9041791,9041833,42,1,0,0,2
9041833,9042111,278,0,0,1,1
9041834,9042110,276,0,0,1,2
9042111,9042184,73,1,0,0,2
9042112,9042194,82,1,0,0,1
9042185,9042287,102,0,0,1,2
9042195,9042284,89,0,0,1,1
9042285,9042307,22,1,0,0,1
9042288,9042305,17,1,0,0,2
9042306,9042477,171,0,0,1,2
9042308,9042478,170,0,0,1,1
9042478,9042495,17,1,0,0,2
9042479,9042499,20,1,0,0,1
9042496,9043020,524,0,0,1,2
9042500,9043021,521,0,0,1,1
9043021,9043050,29,1,0,0,2
9043022,9043040,18,1,0,0,1
9043041,9043188,147,0,0,1,1
9043051,9043190,139,0,0,1,2
9043189,9043219,30,1,0,0,1
9043191,9043209,18,1,0,0,2
9043210,9044263,1053,0,0,1,2
9043220,9044262,1042,0,0,1,1
9044263,9044318,55,1,0,0,1
9044264,9044319,55,1,0,0,2
9044319,9044429,110,0,0,1,1
9044320,9044435,115,0,0,1,2
9044430,9044450,20,1,0,0,1
9044436,9044447,11,1,0,0,2
9044448,9046343,1895,0,0,1,2
9044451,9046343,1892,0,0,1,1
9046344,9046664,320,1,0,0,1
9046344,9046670,326,1,0,0,2
9046362,9046630,268,0,1,0,2
9046364,9046631,267,0,1,0,1
9046665,9046715,50,0,0,1,1
9046671,9046711,40,0,0,1,2
9046712,9046730,18,1,0,0,2
9046716,9046731,15,1,0,0,1
9046731,9046778,47,0,0,1,2
9046732,9046781,49,0,0,1,1
9046779,9047022,243,1,0,0,2
9046782,9047006,224,1,0,0,1
9046793,9046982,189,0,1,0,2
9046794,9046982,188,0,1,0,1
9047007,9047807,800,0,0,1,1
9047023,9047807,784,0,0,1,2
9047808,9047881,73,1,0,0,1
9047808,9047884,76,1,0,0,2
9047882,9048026,144,0,0,1,1
9047885,9048028,143,0,0,1,2
9048027,9048061,34,1,0,0,1
9048029,9048059,30,1,0,0,2
9048060,9048720,660,0,0,1,2
9048062,9048725,663,0,0,1,1
9048721,9048741,20,1,0,0,2
9048726,9048738,12,1,0,0,1
9048739,9050361,1622,0,0,1,1
9048742,9050361,1619,0,0,1,2
9050362,9050418,56,1,0,0,2
9050362,9050419,57,1,0,0,1
9050419,9050566,147,0,0,1,2
9050420,9050566,146,0,0,1,1
9050567,9050601,34,1,0,0,2
9050567,9050603,36,1,0,0,1
9050602,9052422,1820,0,0,1,2
9050604,9052421,1817,0,0,1,1
9052422,9052681,259,1,0,0,1
9052423,9052692,269,1,0,0,2
9052441,9052646,205,0,1,0,1
9052442,9052634,192,0,1,0,2
9052682,9052925,243,0,0,1,1
9052693,9052832,139,0,0,1,2
9052833,9052838,5,1,0,0,2
9052839,9052926,87,0,0,1,2
9052926,9053173,247,1,0,0,1
9052927,9053183,256,1,0,0,2
9052949,9053135,186,0,1,0,1
9052950,9053125,175,0,1,0,2
9053174,9053944,770,0,0,1,1
9053184,9053946,762,0,0,1,2
9053945,9054014,69,1,0,0,1
9053947,9054014,67,1,0,0,2
9054015,9054174,159,0,0,1,1
9054015,9054174,159,0,0,1,2
9054175,9054205,30,1,0,0,2
9054175,9054207,32,1,0,0,1
9054206,9054454,248,0,0,1,2
9054208,9055799,1591,0,0,1,1
9054455,9054466,11,1,0,0,2
9054467,9055804,1337,0,0,1,2
9055800,9055977,177,1,0,0,1
9055805,9055979,174,1,0,0,2
9055821,9055935,114,0,1,0,1
9055825,9055927,102,0,1,0,2
9055978,9056643,665,0,0,1,1
9055980,9056642,662,0,0,1,2
9056643,9056680,37,1,0,0,2
9056644,9056679,35,1,0,0,1
9056680,9056827,147,0,0,1,1
9056681,9056827,146,0,0,1,2
9056828,9056851,23,1,0,0,1
9056828,9056852,24,1,0,0,2
9056852,9057223,371,0,0,1,1
9056853,9057222,369,0,0,1,2
9057223,9057252,29,1,0,0,2
9057224,9057253,29,1,0,0,1
9057253,9057511,258,0,0,1,2
9057254,9057508,254,0,0,1,1
9057509,9057728,219,1,0,0,1
9057512,9057737,225,1,0,0,2
9057529,9057692,163,0,1,0,1
9057532,9057684,152,0,1,0,2
9057729,9057968,239,0,0,1,1
9057738,9057966,228,0,0,1,2
9057967,9057980,13,1,0,0,2
9057969,9057979,10,1,0,0,1
9057980,9058688,708,0,0,1,1
9057981,9058691,710,0,0,1,2
9058689,9059131,442,1,0,0,1
9058692,9059133,441,1,0,0,2
9058714,9059120,406,0,1,0,1
9058715,9059122,407,0,1,0,2
9059132,9059589,457,0,0,1,1
9059134,9059595,461,0,0,1,2
9059590,9059853,263,1,0,0,1
9059596,9059854,258,1,0,0,2
9059610,9059814,204,0,1,0,1
9059614,9059808,194,0,1,0,2
9059854,9060523,669,0,0,1,1
9059855,9060522,667,0,0,1,2
9060523,9060599,76,1,0,0,2
9060524,9060591,67,1,0,0,1
9060592,9060722,130,0,0,1,1
9060600,9060722,122,0,0,1,2
9060723,9060745,22,1,0,0,1
9060723,9060753,30,1,0,0,2
9060746,9061082,336,0,0,1,1
9060754,9062592,1838,0,0,1,2
9061083,9061100,17,1,0,0,1
9061101,9062590,1489,0,0,1,1
9062591,9062636,45,1,0,0,1
9062593,9062639,46,1,0,0,2
9062637,9062854,217,0,0,1,1
9062640,9062856,216,0,0,1,2
9062855,9062889,34,1,0,0,1
9062857,9062889,32,1,0,0,2
9062890,9063310,420,0,0,1,2
9062890,9063311,421,0,0,1,1
9063311,9063326,15,1,0,0,2
9063312,9063334,22,1,0,0,1
9063327,9064677,1350,0,0,1,2
9063335,9064680,1345,0,0,1,1
9064678,9064984,306,1,0,0,2
9064681,9064974,293,1,0,0,1
9064704,9064949,245,0,1,0,2
9064705,9064956,251,0,1,0,1
9064975,9066016,1041,0,0,1,1
9064985,9066016,1031,0,0,1,2
9066017,9066098,81,1,0,0,1
9066017,9066127,110,1,0,0,2
9066099,9066195,96,0,0,1,1
9066128,9066194,66,0,0,1,2
9066195,9066229,34,1,0,0,2
9066196,9066229,33,1,0,0,1
9066230,9066522,292,0,0,1,1
9066230,9066523,293,0,0,1,2
9066523,9066537,14,1,0,0,1
9066524,9066538,14,1,0,0,2
9066538,9067727,1189,0,0,1,1
9066539,9067735,1196,0,0,1,2
9067728,9067743,15,1,0,0,1
9067736,9067744,8,1,0,0,2
9067744,9068304,560,0,0,1,1
9067745,9068304,559,0,0,1,2
9068305,9068352,47,1,0,0,1
9068305,9068374,69,1,0,0,2
9068353,9068409,56,0,0,1,1
9068375,9068411,36,0,0,1,2
9068410,9068523,113,1,0,0,1
9068412,9068534,122,1,0,0,2
9068438,9068487,49,0,1,0,2
9068446,9068473,27,0,1,0,1
9068524,9068772,248,0,0,1,1
9068535,9068771,236,0,0,1,2
9068772,9068798,26,1,0,0,2
9068773,9068789,16,1,0,0,1
9068790,9070420,1630,0,0,1,1
9068799,9070423,1624,0,0,1,2
9070421,9070675,254,1,0,0,1
9070424,9070660,236,1,0,0,2
9070457,9070616,159,0,1,0,2
9070458,9070616,158,0,1,0,1
9070661,9070715,54,0,0,1,2
9070676,9070715,39,0,0,1,1
9070716,9070753,37,1,0,0,1
9070716,9070759,43,1,0,0,2
9070754,9070855,101,0,0,1,1
9070760,9070856,96,0,0,1,2
9070856,9071115,259,1,0,0,1
9070857,9071180,323,1,0,0,2
9070874,9071077,203,0,1,0,1
9070878,9071069,191,0,1,0,2
9071116,9071143,27,0,0,1,1
9071144,9071165,21,1,0,0,1
9071166,9071408,242,0,0,1,1
9071181,9071409,228,0,0,1,2
9071409,9071435,26,1,0,0,1
9071410,9071435,25,1,0,0,2
9071436,9072026,590,0,0,1,2
9071436,9072027,591,0,0,1,1
9072027,9072091,64,1,0,0,2
9072028,9072102,74,1,0,0,1
9072092,9072200,108,0,0,1,2
9072103,9072200,97,0,0,1,1
9072201,9072224,23,1,0,0,1
9072201,9072229,28,1,0,0,2
9072225,9073415,1190,0,0,1,1
9072230,9073800,1570,0,0,1,2
9073416,9073431,15,1,0,0,1
9073432,9073799,367,0,0,1,1
9073800,9073867,67,1,0,0,1
9073801,9073870,69,1,0,0,2
9073868,9073970,102,0,0,1,1
9073871,9073970,99,0,0,1,2
9073971,9074130,159,1,0,0,1
9073971,9074139,168,1,0,0,2
9073996,9074086,90,0,1,0,1
9073997,9074086,89,0,1,0,2
9074131,9074323,192,0,0,1,1
9074140,9074323,183,0,0,1,2
9074324,9074344,20,1,0,0,1
9074324,9074344,20,1,0,0,2
9074345,9075952,1607,0,0,1,1
9074345,9075962,1617,0,0,1,2
9075953,9076432,479,1,0,0,1
9075963,9076432,469,1,0,0,2
9075999,9076407,408,0,1,0,1
9075999,9076407,408,0,1,0,2
9076433,9076523,90,0,0,1,1
9076433,9076529,96,0,0,1,2
9076524,9076539,15,1,0,0,1
9076530,9076541,11,1,0,0,2
9076540,9076647,107,0,0,1,1
9076542,9076649,107,0,0,1,2
9076648,9076905,257,1,0,0,1
9076650,9076888,238,1,0,0,2
9076667,9076850,183,0,1,0,1
9076672,9076836,164,0,1,0,2
9076889,9077359,470,0,0,1,2
9076906,9077360,454,0,0,1,1
9077360,9077417,57,1,0,0,2
9077361,9077415,54,1,0,0,1
9077416,9077513,97,0,0,1,1
9077418,9077513,95,0,0,1,2
9077514,9077535,21,1,0,0,2
9077514,9077544,30,1,0,0,1
9077536,9077712,176,0,0,1,2
9077545,9077711,166,0,0,1,1
9077712,9077731,19,1,0,0,1
9077713,9077731,18,1,0,0,2
9077732,9079882,2150,0,0,1,1
9077732,9079885,2153,0,0,1,2
9079883,9080049,166,1,0,0,1
9079886,9080045,159,1,0,0,2
9079914,9080023,109,0,1,0,1
9079917,9080018,101,0,1,0,2
9080046,9080081,35,0,0,1,2
9080050,9080082,32,0,0,1,1
9080082,9080118,36,1,0,0,2
9080083,9080109,26,1,0,0,1
9080110,9080233,123,0,0,1,1
9080119,9080234,115,0,0,1,2
9080234,9080264,30,1,0,0,1
9080235,9080258,23,1,0,0,2
9080259,9081003,744,0,0,1,2
9080265,9081004,739,0,0,1,1
9081004,9081024,20,1,0,0,2
9081005,9081025,20,1,0,0,1
9081025,9081921,896,0,0,1,2
9081026,9081924,898,0,0,1,1
9081922,9082190,268,1,0,0,2
9081925,9082200,275,1,0,0,1
9081960,9082161,201,0,1,0,2
9081961,9082164,203,0,1,0,1
9082191,9082250,59,0,0,1,2
9082201,9082250,49,0,0,1,1
9082251,9082513,262,1,0,0,1
9082251,9082515,264,1,0,0,2
9082268,9082471,203,0,1,0,1
9082272,9082465,193,0,1,0,2
9082514,9083877,1363,0,0,1,1
9082516,9083877,1361,0,0,1,2
9083878,9083933,55,1,0,0,1
9083878,9083947,69,1,0,0,2
9083934,9084105,171,0,0,1,1
9083948,9084105,157,0,0,1,2
9084106,9084133,27,1,0,0,2
9084106,9084134,28,1,0,0,1
9084134,9084781,647,0,0,1,2
9084135,9084777,642,0,0,1,1
9084778,9084980,202,1,0,0,1
9084782,9084980,198,1,0,0,2
9084805,9084927,122,0,1,0,2
9084806,9084927,121,0,1,0,1
9084981,9085132,151,0,0,1,2
9084981,9085135,154,0,0,1,1
9085133,9085151,18,1,0,0,2
9085136,9085150,14,1,0,0,1
9085151,9085482,331,0,0,1,1
9085152,9085482,330,0,0,1,2
9085483,9085495,12,1,0,0,2
9085483,9085496,13,1,0,0,1
9085496,9086786,1290,0,0,1,2
9085497,9086787,1290,0,0,1,1
9086787,9087067,280,1,0,0,2
9086788,9087034,246,1,0,0,1
9086869,9087007,138,0,1,0,2
9086870,9087000,130,0,1,0,1
9087035,9087144,109,0,0,1,1
9087068,9087144,76,0,0,1,2
9087145,9087171,26,1,0,0,2
9087145,9087181,36,1,0,0,1
9087172,9087506,334,0,0,1,2
9087182,9087505,323,0,0,1,1
9087506,9087537,31,1,0,0,1
9087507,9087528,21,1,0,0,2
9087529,9087913,384,0,0,1,2
9087538,9087913,375,0,0,1,1
9087914,9087943,29,1,0,0,1
9087914,9087943,29,1,0,0,2
9087944,9088834,890,0,0,1,1
9087944,9088835,891,0,0,1,2
9088835,9089279,444,1,0,0,1
9088836,9089279,443,1,0,0,2
9088891,9089262,371,0,1,0,1
9088891,9089262,371,0,1,0,2
9089280,9089332,52,0,0,1,1
9089280,9089336,56,0,0,1,2
9089333,9089340,7,1,0,0,1
9089337,9089347,10,1,0,0,2
9089341,9089433,92,0,0,1,1
9089348,9089434,86,0,0,1,2
9089434,9089461,27,1,0,0,1
9089435,9089461,26,1,0,0,2
9089462,9089733,271,0,0,1,1
9089462,9089735,273,0,0,1,2
9089734,9089760,26,1,0,0,1
9089736,9089761,25,1,0,0,2
9089761,9089801,40,0,0,1,1
9089762,9089807,45,0,0,1,2
9089802,9090057,255,1,0,0,1
9089808,9090026,218,1,0,0,2
9089820,9090004,184,0,1,0,1
9089825,9089989,164,0,1,0,2
9090027,9090712,685,0,0,1,2
9090058,9090712,654,0,0,1,1
9090713,9090763,50,1,0,0,1
9090713,9090765,52,1,0,0,2
9090764,9090877,113,0,0,1,1
9090766,9090879,113,0,0,1,2
9090878,9090915,37,1,0,0,1
9090880,9090903,23,1,0,0,2
9090904,9092040,1136,0,0,1,2
9090916,9092040,1124,0,0,1,1
9092041,9092253,212,1,0,0,2
9092041,9092276,235,1,0,0,1
9092064,9092225,161,0,1,0,1
9092071,9092202,131,0,1,0,2
9092254,9092439,185,0,0,1,2
9092277,9092438,161,0,0,1,1
9092439,9092460,21,1,0,0,1
9092440,9092458,18,1,0,0,2
9092459,9093814,1355,0,0,1,2
9092461,9093815,1354,0,0,1,1
9093815,9093849,34,1,0,0,2
9093816,9093860,44,1,0,0,1
9093850,9093987,137,0,0,1,2
9093861,9093987,126,0,0,1,1
9093988,9094011,23,1,0,0,1
9093988,9094011,23,1,0,0,2
9094012,9094407,395,0,0,1,1
9094012,9094413,401,0,0,1,2
9094408,9094610,202,1,0,0,1
9094414,9094614,200,1,0,0,2
9094431,9094563,132,0,1,0,1
9094433,9094559,126,0,1,0,2
9094611,9095856,1245,0,0,1,1
9094615,9095853,1238,0,0,1,2
9095854,9096099,245,1,0,0,2
9095857,9096100,243,1,0,0,1
9095876,9096063,187,0,1,0,1
9095881,9096050,169,0,1,0,2
9096100,9096207,107,0,0,1,2
9096101,9096212,111,0,0,1,1
9096208,9096451,243,1,0,0,2
9096213,9096441,228,1,0,0,1
9096232,9096414,182,0,1,0,1
9096242,9096409,167,0,1,0,2
9096442,9097571,1129,0,0,1,1
9096452,9097570,1118,0,0,1,2
9097571,9097677,106,1,0,0,2
9097572,9097666,94,1,0,0,1
9097667,9097724,57,0,0,1,1
9097678,9097723,45,0,0,1,2
9097724,9097770,46,1,0,0,2
9097725,9097750,25,1,0,0,1
9097751,9097896,145,0,0,1,1
9097771,9097896,125,0,0,1,2
9097897,9097925,28,1,0,0,1
9097897,9097927,30,1,0,0,2
9097926,9099023,1097,0,0,1,1
9097928,9098192,264,0,0,1,2
9098193,9098230,37,1,0,0,2
9098231,9098333,102,0,0,1,2
9098334,9098381,47,1,0,0,2
9098382,9098880,498,0,0,1,2
9098881,9098887,6,1,0,0,2
9098888,9098995,107,0,0,1,2
9098996,9099346,350,1,0,0,2
9099024,9099287,263,1,0,0,1
9099037,9099289,252,0,1,0,2
9099045,9099264,219,0,1,0,1
9099288,9099441,153,0,0,1,1
9099347,9099440,93,0,0,1,2
9099441,9099461,20,1,0,0,2
9099442,9099459,17,1,0,0,1
9099460,9100581,1121,0,0,1,1
9099462,9099703,241,0,0,1,2
9099704,9099740,36,1,0,0,2
9099741,9100031,290,0,0,1,2
9100032,9100046,14,1,0,0,2
9100047,9100574,527,0,0,1,2
9100575,9100881,306,1,0,0,2
9100582,9100878,296,1,0,0,1
9100616,9100848,232,0,1,0,2
9100618,9100853,235,0,1,0,1
9100879,9102640,1761,0,0,1,1
9100882,9102616,1734,0,0,1,2
9102617,9103044,427,1,0,0,2
9102641,9103058,417,1,0,0,1
9102658,9103028,370,0,1,0,2
9102665,9103049,384,0,1,0,1
9103045,9103081,36,0,0,1,2
9103059,9103093,34,0,0,1,1
9103082,9103464,382,1,0,0,2
9103094,9103466,372,1,0,0,1
9103107,9103455,348,0,1,0,1
9103108,9103453,345,0,1,0,2
9103465,9104461,996,0,0,1,2
9103467,9104461,994,0,0,1,1
9104462,9104539,77,1,0,0,2
9104462,9104547,85,1,0,0,1
9104540,9104652,112,0,0,1,2
9104548,9104652,104,0,0,1,1
9104653,9104691,38,1,0,0,2
9104653,9104695,42,1,0,0,1
9104692,9104896,204,0,0,1,2
9104696,9104900,204,0,0,1,1
9104897,9104914,17,1,0,0,2
9104901,9104913,12,1,0,0,1
9104914,9105174,260,0,0,1,1
9104915,9105175,260,0,0,1,2
9105175,9105187,12,1,0,0,1
9105176,9105186,10,1,0,0,2
9105187,9105699,512,0,0,1,2
9105188,9105689,501,0,0,1,1
9105690,9105909,219,1,0,0,1
9105700,9105893,193,1,0,0,2
9105710,9105859,149,0,1,0,1
9105719,9105826,107,0,1,0,2
9105894,9106043,149,0,0,1,2
9105910,9106043,133,0,0,1,1
9106044,9106071,27,1,0,0,2
9106044,9106074,30,1,0,0,1
9106072,9106700,628,0,0,1,2
9106075,9106701,626,0,0,1,1
9106701,9106749,48,1,0,0,2
9106702,9106738,36,1,0,0,1
9106739,9106791,52,0,0,1,1
9106750,9106800,50,0,0,1,2
9106792,9107020,228,1,0,0,1
9106801,9106995,194,1,0,0,2
9106816,9106962,146,0,1,0,1
9106821,9106949,128,0,1,0,2
9106996,9107451,455,0,0,1,2
9107021,9107446,425,0,0,1,1
9107447,9107464,17,1,0,0,1
9107452,9107462,10,1,0,0,2
9107463,9108720,1257,0,0,1,2
9107465,9108710,1245,0,0,1,1
9108711,9108949,238,1,0,0,1
9108721,9108932,211,1,0,0,2
9108734,9108913,179,0,1,0,1
9108740,9108894,154,0,1,0,2
9108933,9109039,106,0,0,1,2
9108950,9109042,92,0,0,1,1
9109040,9109300,260,1,0,0,2
9109043,9109311,268,1,0,0,1
9109060,9109273,213,0,1,0,1
9109065,9109263,198,0,1,0,2
9109301,9109584,283,0,0,1,2
9109312,9109585,273,0,0,1,1
9109585,9109846,261,1,0,0,2
9109586,9109834,248,1,0,0,1
9109602,9109801,199,0,1,0,1
9109607,9109794,187,0,1,0,2
9109835,9110156,321,0,0,1,1
9109847,9110156,309,0,0,1,2
9110157,9110214,57,1,0,0,2
9110157,9110218,61,1,0,0,1
9110215,9110340,125,0,0,1,2
9110219,9110339,120,0,0,1,1
9110340,9110370,30,1,0,0,1
9110341,9110369,28,1,0,0,2
9110370,9111259,889,0,0,1,2
9110371,9111254,883,0,0,1,1
9111255,9111448,193,1,0,0,1
9111260,9111462,202,1,0,0,2
9111281,9111410,129,0,1,0,1
9111282,9111405,123,0,1,0,2
9111449,9111573,124,0,0,1,1
9111463,9111573,110,0,0,1,2
9111574,9111597,23,1,0,0,1
9111574,9111598,24,1,0,0,2
9111598,9113028,1430,0,0,1,1
9111599,9113027,1428,0,0,1,2
9113028,9113323,295,1,0,0,2
9113029,9113275,246,1,0,0,1
9113057,9113231,174,0,1,0,1
9113063,9113227,164,0,1,0,2
9113276,9113426,150,0,0,1,1
9113324,9113424,100,0,0,1,2
9113425,9113457,32,1,0,0,2
9113427,9113448,21,1,0,0,1
9113449,9113631,182,0,0,1,1
9113458,9113631,173,0,0,1,2
9113632,9113652,20,1,0,0,2
9113632,9113660,28,1,0,0,1
9113653,9115110,1457,0,0,1,2
9113661,9115108,1447,0,0,1,1
9115109,9115600,491,1,0,0,1
9115111,9115605,494,1,0,0,2
9115147,9115589,442,0,1,0,1
9115151,9115556,405,0,1,0,2
9115601,9115659,58,0,0,1,1
9115606,9115661,55,0,0,1,2
9115660,9115676,16,1,0,0,1
9115662,9115679,17,1,0,0,2
9115677,9115815,138,0,0,1,1
9115680,9115814,134,0,0,1,2
9115815,9115850,35,1,0,0,2
9115816,9115837,21,1,0,0,1
9115838,9116018,180,0,0,1,1
9115851,9116002,151,0,0,1,2
9116003,9116064,61,1,0,0,2
9116019,9116064,45,1,0,0,1
9116065,9116256,191,0,0,1,1
9116065,9116257,192,0,0,1,2
9116257,9116291,34,1,0,0,1
9116258,9116282,24,1,0,0,2
9116283,9117139,856,0,0,1,2
9116292,9117137,845,0,0,1,1
9117138,9117234,96,1,0,0,1
9117140,9117233,93,1,0,0,2
9117234,9117334,100,0,0,1,2
9117235,9117332,97,0,0,1,1
9117333,9117359,26,1,0,0,1
9117335,9117373,38,1,0,0,2
9117360,9117543,183,0,0,1,1
9117374,9117541,167,0,0,1,2
9117542,9117559,17,1,0,0,2
9117544,9117555,11,1,0,0,1
9117556,9118005,449,0,0,1,1
9117560,9118010,450,0,0,1,2
9118006,9118025,19,1,0,0,1
9118011,9118021,10,1,0,0,2
9118022,9120069,2047,0,0,1,2
9118026,9120053,2027,0,0,1,1
9120054,9120436,382,1,0,0,1
9120070,9120434,364,1,0,0,2
9120079,9120423,344,0,1,0,1
9120085,9120419,334,0,1,0,2
9120435,9120702,267,0,0,1,2
9120437,9120702,265,0,0,1,1
9120703,9120725,22,1,0,0,2
9120703,9120736,33,1,0,0,1
9120726,9122121,1395,0,0,1,2
9120737,9122115,1378,0,0,1,1
9122116,9122556,440,1,0,0,1
9122122,9122538,416,1,0,0,2
9122140,9122545,405,0,1,0,1
9122141,9122511,370,0,1,0,2
9122539,9122691,152,0,0,1,2
9122557,9122689,132,0,0,1,1
9122690,9123033,343,1,0,0,1
9122692,9123040,348,1,0,0,2
9122716,9123002,286,0,1,0,1
9122723,9122993,270,0,1,0,2
9123034,9123935,901,0,0,1,1
9123041,9123937,896,0,0,1,2
9123936,9123996,60,1,0,0,1
9123938,9123997,59,1,0,0,2
9123997,9124139,142,0,0,1,1
9123998,9124139,141,0,0,1,2
9124140,9124159,19,1,0,0,1
9124140,9124161,21,1,0,0,2
9124160,9124360,200,0,0,1,1
9124162,9124359,197,0,0,1,2
9124360,9124375,15,1,0,0,2
9124361,9124373,12,1,0,0,1
9124374,9126310,1936,0,0,1,1
9124376,9126310,1934,0,0,1,2
9126311,9126367,56,1,0,0,1
9126311,9126378,67,1,0,0,2
9126368,9126481,113,0,0,1,1
9126379,9126482,103,0,0,1,2
9126482,9126711,229,1,0,0,1
9126483,9126737,254,1,0,0,2
9126497,9126687,190,0,1,0,2
9126500,9126690,190,0,1,0,1
9126712,9126906,194,0,0,1,1
9126738,9126906,168,0,0,1,2
9126907,9126915,8,1,0,0,2
9126907,9126917,10,1,0,0,1
9126916,9127217,301,0,0,1,2
9126918,9127212,294,0,0,1,1
9127213,9127232,19,1,0,0,1
9127218,9127228,10,1,0,0,2
9127229,9128388,1159,0,0,1,2
9127233,9128387,1154,0,0,1,1
9128388,9128617,229,1,0,0,1
9128389,9128650,261,1,0,0,2
9128406,9128597,191,0,1,0,1
9128407,9128587,180,0,1,0,2
9128618,9128881,263,0,0,1,1
9128651,9128878,227,0,0,1,2
9128879,9129148,269,1,0,0,2
9128882,9129158,276,1,0,0,1
9128904,9129137,233,0,1,0,1
9128907,9129117,210,0,1,0,2
9129149,9129604,455,0,0,1,2
9129159,9129603,444,0,0,1,1
9129604,9129651,47,1,0,0,1
9129605,9129674,69,1,0,0,2
9129652,9129766,114,0,0,1,1
9129675,9129766,91,0,0,1,2
9129767,9129789,22,1,0,0,1
9129767,9129803,36,1,0,0,2
9129790,9130033,243,0,0,1,1
9129804,9130038,234,0,0,1,2
9130034,9130050,16,1,0,0,1
9130039,9130053,14,1,0,0,2
9130051,9132574,2523,0,0,1,1
9130054,9132573,2519,0,0,1,2
9132574,9132624,50,1,0,0,2
9132575,9132625,50,1,0,0,1
9132625,9132662,37,0,0,1,2
9132626,9132660,34,0,0,1,1
9132661,9132861,200,1,0,0,1
9132663,9132862,199,1,0,0,2
9132682,9132808,126,0,1,0,2
9132683,9132811,128,0,1,0,1
9132862,9132948,86,0,0,1,1
9132863,9132949,86,0,0,1,2
9132949,9132979,30,1,0,0,1
9132950,9132978,28,1,0,0,2
9132979,9134709,1730,0,0,1,2
9132980,9133298,318,0,0,1,1
9133299,9133303,4,1,0,0,1
9133304,9134711,1407,0,0,1,1
9134710,9134949,239,1,0,0,2
9134712,9134947,235,1,0,0,1
9134745,9134907,162,0,1,0,2
9134747,9134912,165,0,1,0,1
9134948,9135062,114,0,0,1,1
9134950,9135064,114,0,0,1,2
9135063,9135286,223,1,0,0,1
9135065,9135288,223,1,0,0,2
9135079,9135251,172,0,1,0,1
9135081,9135245,164,0,1,0,2
9135287,9135600,313,0,0,1,1
9135289,9135600,311,0,0,1,2
9135601,9135817,216,1,0,0,1
9135601,9135823,222,1,0,0,2
9135616,9135787,171,0,1,0,1
9135622,9135775,153,0,1,0,2
9135818,9136648,830,0,0,1,1
9135824,9136650,826,0,0,1,2
9136649,9136737,88,1,0,0,1
9136651,9136737,86,1,0,0,2
9136738,9136784,46,0,0,1,1
9136738,9136825,87,0,0,1,2
9136785,9136877,92,1,0,0,1
9136826,9136862,36,1,0,0,2
9136863,9137014,151,0,0,1,2
9136878,9137013,135,0,0,1,1
9137014,9137038,24,1,0,0,1
9137015,9137031,16,1,0,0,2
9137032,9138689,1657,0,0,1,2
9137039,9138690,1651,0,0,1,1
9138690,9138736,46,1,0,0,2
9138691,9138727,36,1,0,0,1
9138728,9138839,111,0,0,1,1
9138737,9138846,109,0,0,1,2
9138840,9139148,308,1,0,0,1
9138847,9139144,297,1,0,0,2
9138863,9139102,239,0,1,0,2
9138863,9139121,258,0,1,0,1
9139145,9140807,1662,0,0,1,2
9139149,9140803,1654,0,0,1,1
9140804,9141323,519,1,0,0,1
9140808,9141045,237,1,0,0,2
9140825,9141313,488,0,1,0,1
9140827,9141017,190,0,1,0,2
9141046,9141071,25,0,0,1,2
9141072,9141328,256,1,0,0,2
9141088,9141281,193,0,1,0,2
9141324,9141800,476,0,0,1,1
9141329,9141803,474,0,0,1,2
9141801,9142037,236,1,0,0,1
9141804,9142029,225,1,0,0,2
9141814,9141999,185,0,1,0,1
9141819,9141987,168,0,1,0,2
9142030,9142190,160,0,0,1,2
9142038,9142189,151,0,0,1,1
9142190,9142247,57,1,0,0,1
9142191,9142492,301,1,0,0,2
9142248,9142273,25,0,0,1,1
9142274,9142504,230,1,0,0,1
9142294,9142459,165,0,1,0,1
9142299,9142447,148,0,1,0,2
9142493,9142608,115,0,0,1,2
9142505,9142608,103,0,0,1,1
9142609,9142627,18,1,0,0,1
9142609,9142630,21,1,0,0,2
9142628,9142920,292,0,0,1,1
9142631,9142920,289,0,0,1,2
9142921,9142932,11,1,0,0,1
9142921,9142934,13,1,0,0,2
9142933,9143158,225,0,0,1,1
9142935,9143158,223,0,0,1,2
9143159,9143170,11,1,0,0,2
9143159,9143174,15,1,0,0,1
9143171,9144396,1225,0,0,1,2
9143175,9144398,1223,0,0,1,1
9144397,9144589,192,1,0,0,2
9144399,9144596,197,1,0,0,1
9144425,9144547,122,0,1,0,1
9144431,9144535,104,0,1,0,2
9144590,9144769,179,0,0,1,2
9144597,9144771,174,0,0,1,1
9144770,9144801,31,1,0,0,2
9144772,9144803,31,1,0,0,1
9144802,9146565,1763,0,0,1,2
9144804,9146563,1759,0,0,1,1
9146564,9146986,422,1,0,0,1
9146566,9146985,419,1,0,0,2
9146587,9146755,168,0,1,0,1
9146588,9146739,151,0,1,0,2
9146776,9146959,183,0,1,0,1
9146787,9146949,162,0,1,0,2
9146986,9148237,1251,0,0,1,2
9146987,9148238,1251,0,0,1,1
9148238,9148295,57,1,0,0,2
9148239,9148300,61,1,0,0,1
9148296,9148407,111,0,0,1,2
9148301,9148407,106,0,0,1,1
9148408,9148441,33,1,0,0,1
9148408,9148441,33,1,0,0,2
9148442,9149334,892,0,0,1,1
9148442,9149340,898,0,0,1,2
9149335,9149441,106,1,0,0,1
9149341,9149439,98,1,0,0,2
9149367,9149400,33,0,1,0,1
9149368,9149395,27,0,1,0,2
9149440,9149460,20,0,0,1,2
9149442,9150670,1228,0,0,1,1
9149461,9149465,4,1,0,0,2
9149466,9150669,1203,0,0,1,2
9150670,9150920,250,1,0,0,2
9150671,9150910,239,1,0,0,1
9150716,9150846,130,0,1,0,2
9150717,9150848,131,0,1,0,1
9150911,9151296,385,0,0,1,1
9150921,9152732,1811,0,0,1,2
9151297,9151309,12,1,0,0,1
9151310,9152730,1420,0,0,1,1
9152731,9152985,254,1,0,0,1
9152733,9153009,276,1,0,0,2
9152764,9152955,191,0,1,0,1
9152767,9152943,176,0,1,0,2
9152986,9153090,104,0,0,1,1
9153010,9153091,81,0,0,1,2
9153091,9153108,17,1,0,0,1
9153092,9153119,27,1,0,0,2
9153109,9153419,310,0,0,1,1
9153120,9153420,300,0,0,1,2
9153420,9153453,33,1,0,0,1
9153421,9153447,26,1,0,0,2
9153448,9153607,159,0,0,1,2
9153454,9153603,149,0,0,1,1
9153604,9153833,229,1,0,0,1
9153608,9153812,204,1,0,0,2
9153621,9153789,168,0,1,0,1
9153625,9153778,153,0,1,0,2
9153813,9154576,763,0,0,1,2
9153834,9154575,741,0,0,1,1
9154576,9154619,43,1,0,0,1
9154577,9154629,52,1,0,0,2
9154620,9154750,130,0,0,1,1
9154630,9154752,122,0,0,1,2
9154751,9154785,34,1,0,0,1
9154753,9154785,32,1,0,0,2
9154786,9154943,157,0,0,1,2
9154786,9154947,161,0,0,1,1
9154944,9154964,20,1,0,0,2
9154948,9154959,11,1,0,0,1
9154960,9156399,1439,0,0,1,1
9154965,9156398,1433,0,0,1,2
9156399,9156443,44,1,0,0,2
9156400,9156440,40,1,0,0,1
9156441,9156728,287,0,0,1,1
9156444,9156732,288,0,0,1,2
9156729,9156899,170,1,0,0,1
9156733,9156898,165,1,0,0,2
9156750,9156849,99,0,1,0,1
9156752,9156847,95,0,1,0,2
9156899,9158395,1496,0,0,1,2
9156900,9158390,1490,0,0,1,1
9158391,9158909,518,1,0,0,1
9158396,9158897,501,1,0,0,2
9158410,9158613,203,0,1,0,1
9158414,9158596,182,0,1,0,2
9158653,9158860,207,0,1,0,1
9158657,9158847,190,0,1,0,2
9158898,9159609,711,0,0,1,2
9158910,9159610,700,0,0,1,1
9159610,9159653,43,1,0,0,2
9159611,9159652,41,1,0,0,1
9159653,9159763,110,0,0,1,1
9159654,9159764,110,0,0,1,2
9159764,9159798,34,1,0,0,1
9159765,9159796,31,1,0,0,2
9159797,9160133,336,0,0,1,2
9159799,9160133,334,0,0,1,1
9160134,9160494,360,1,0,0,1
9160134,9160505,371,1,0,0,2
9160155,9160437,282,0,1,0,2
9160157,9160448,291,0,1,0,1
9160495,9160595,100,0,0,1,1
9160506,9160595,89,0,0,1,2
9160596,9160620,24,1,0,0,2
9160596,9160628,32,1,0,0,1
9160621,9160677,56,0,0,1,2
9160629,9160669,40,0,0,1,1
9160670,9170396,9726,1,0,0,1
9160678,9170431,9753,1,0,0,2
9160695,9170385,9690,0,1,0,1
9160699,9170076,9377,0,1,0,2
9170160,9170363,203,0,1,0,2
9170397,9170825,428,0,0,1,1
9170432,9170504,72,0,0,1,2
9170505,9170513,8,1,0,0,2
9170514,9170825,311,0,0,1,2
9170826,9170864,38,1,0,0,1
9170826,9170868,42,1,0,0,2
9170865,9171103,238,0,0,1,1
9170869,9171103,234,0,0,1,2
9171104,9171129,25,1,0,0,1
9171104,9171139,35,1,0,0,2
9171130,9171414,284,0,0,1,1
9171140,9171413,273,0,0,1,2
9171414,9171448,34,1,0,0,2
9171415,9171438,23,1,0,0,1
9171439,9171962,523,0,0,1,1
9171449,9171963,514,0,0,1,2
9171963,9171985,22,1,0,0,1
9171964,9171985,21,1,0,0,2
9171986,9172206,220,0,0,1,1
9171986,9172210,224,0,0,1,2
9172207,9172469,262,1,0,0,1
9172211,9172477,266,1,0,0,2
9172232,9172431,199,0,1,0,1
9172233,9172422,189,0,1,0,2
9172470,9173100,630,0,0,1,1
9172478,9173107,629,0,0,1,2
9173101,9173387,286,1,0,0,1
9173108,9173368,260,1,0,0,2
9173123,9173332,209,0,1,0,1
9173128,9173313,185,0,1,0,2
9173369,9173390,21,0,0,1,2
9173388,9173500,112,0,0,1,1
9173391,9173418,27,1,0,0,2
9173419,9173499,80,0,0,1,2
9173500,9173525,25,1,0,0,2
9173501,9173537,36,1,0,0,1
9173526,9174062,536,0,0,1,2
9173538,9174062,524,0,0,1,1
9216386,9216527,141,0,0,1,1
9216386,9216528,142,0,0,1,2
9216528,9216576,48,1,0,0,1
9216529,9216563,34,1,0,0,2
9216564,9216622,58,0,0,1,2
9216577,9216622,45,0,0,1,1
9216623,9216700,77,1,0,0,2
9216623,9216701,78,1,0,0,1
9216701,9216966,265,0,0,1,2
9216702,9216965,263,0,0,1,1
9216966,9216978,12,1,0,0,1
9216967,9216977,10,1,0,0,2
9216978,9217504,526,0,0,1,2
9216979,9217502,523,0,0,1,1
9217503,9217773,270,1,0,0,1
9217505,9217758,253,1,0,0,2
9217522,9217741,219,0,1,0,2
9217525,9217743,218,0,1,0,1
9217759,9217855,96,0,0,1,2
9217774,9217857,83,0,0,1,1
9217856,9217876,20,1,0,0,2
9217858,9217874,16,1,0,0,1
9217875,9219520,1645,0,0,1,1
9217877,9219525,1648,0,0,1,2
9219521,9219695,174,1,0,0,1
9219526,9219704,178,1,0,0,2
9219546,9219663,117,0,1,0,2
9219549,9219656,107,0,1,0,1
9219696,9219904,208,0,0,1,1
9219705,9219905,200,0,0,1,2
9219905,9219961,56,1,0,0,1
9219906,9219954,48,1,0,0,2
9219955,9220125,170,0,0,1,2
9219962,9220125,163,0,0,1,1
9220126,9220137,11,1,0,0,1
9220126,9220142,16,1,0,0,2
9220138,9221594,1456,0,0,1,1
9220143,9221593,1450,0,0,1,2
9221594,9221633,39,1,0,0,2
9221595,9221633,38,1,0,0,1
9221634,9221912,278,0,0,1,1
9221634,9221912,278,0,0,1,2
9221913,9221969,56,1,0,0,2
9221913,9221970,57,1,0,0,1
9221970,9222060,90,0,0,1,2
9221971,9222059,88,0,0,1,1
9222060,9222094,34,1,0,0,1
9222061,9222091,30,1,0,0,2
9222092,9222246,154,0,0,1,2
9222095,9222245,150,0,0,1,1
9222246,9222258,12,1,0,0,1
9222247,9222258,11,1,0,0,2
9222259,9224021,1762,0,0,1,1
9222259,9224022,1763,0,0,1,2
9224022,9224101,79,1,0,0,1
9224023,9224094,71,1,0,0,2
9224095,9224180,85,0,0,1,2
9224102,9224179,77,0,0,1,1
9224180,9224215,35,1,0,0,1
9224181,9224203,22,1,0,0,2
9224204,9224330,126,0,0,1,2
9224216,9224330,114,0,0,1,1
9224331,9224351,20,1,0,0,1
9224331,9224359,28,1,0,0,2
9224352,9224601,249,0,0,1,1
9224360,9224601,241,0,0,1,2
9224602,9224629,27,1,0,0,2
9224602,9224632,30,1,0,0,1
9224630,9225902,1272,0,0,1,2
9224633,9225901,1268,0,0,1,1
9225902,9225979,77,1,0,0,1
9225903,9225979,76,1,0,0,2
9225980,9226325,345,0,0,1,2
9225980,9226327,347,0,0,1,1
9226326,9226408,82,1,0,0,2
9226328,9226399,71,1,0,0,1
9226400,9226473,73,0,0,1,1
9226409,9226474,65,0,0,1,2
9226474,9226510,36,1,0,0,1
9226475,9226506,31,1,0,0,2
9226507,9228244,1737,0,0,1,2
9226511,9228243,1732,0,0,1,1
9228244,9228322,78,1,0,0,1
9228245,9228324,79,1,0,0,2
9228323,9228542,219,0,0,1,1
9228325,9228541,216,0,0,1,2
9228542,9228573,31,1,0,0,2
9228543,9228582,39,1,0,0,1
9228574,9228750,176,0,0,1,2
9228583,9228751,168,0,0,1,1
9228751,9228849,98,1,0,0,2
9228752,9228852,100,1,0,0,1
9228850,9228992,142,0,0,1,2
9228853,9228992,139,0,0,1,1
9228993,9229011,18,1,0,0,2
9228993,9229013,20,1,0,0,1
9229012,9230688,1676,0,0,1,2
9229014,9230688,1674,0,0,1,1
9230689,9230797,108,1,0,0,1
9230689,9230807,118,1,0,0,2
9230798,9231018,220,0,0,1,1
9230808,9231018,210,0,0,1,2
9231019,9231074,55,1,0,0,1
9231019,9231076,57,1,0,0,2
9231075,9231118,43,0,0,1,1
9231077,9231119,42,0,0,1,2
9231119,9231167,48,1,0,0,1
9231120,9231167,47,1,0,0,2
9231168,9231245,77,0,0,1,1
9231168,9231247,79,0,0,1,2
9231246,9231322,76,1,0,0,1
9231248,9231321,73,1,0,0,2
9231322,9231403,81,0,0,1,2
9231323,9231403,80,0,0,1,1
9231404,9231432,28,1,0,0,1
9231404,9231440,36,1,0,0,2
9231433,9231626,193,0,0,1,1
9231441,9231626,185,0,0,1,2
9231627,9231647,20,1,0,0,2
9231627,9231655,28,1,0,0,1
9231648,9233346,1698,0,0,1,2
9231656,9233345,1689,0,0,1,1
9233346,9233434,88,1,0,0,1
9233347,9233435,88,1,0,0,2
9233435,9233817,382,0,0,1,1
9233436,9233819,383,0,0,1,2
9233818,9233887,69,1,0,0,1
9233820,9233886,66,1,0,0,2
9233887,9233978,91,0,0,1,2
9233888,9233978,90,0,0,1,1
9233979,9234001,22,1,0,0,2
9233979,9234011,32,1,0,0,1
9234002,9234182,180,0,0,1,2
9234012,9234187,175,0,0,1,1
9234183,9234199,16,1,0,0,2
9234188,9234196,8,1,0,0,1
9234197,9234683,486,0,0,1,1
9234200,9234685,485,0,0,1,2
9234684,9234697,13,1,0,0,1
9234686,9234698,12,1,0,0,2
9234698,9235930,1232,0,0,1,1
9234699,9235931,1232,0,0,1,2
9235931,9236129,198,1,0,0,1
9235932,9236123,191,1,0,0,2
9235987,9236091,104,0,1,0,2
9235988,9236084,96,0,1,0,1
9236124,9236580,456,0,0,1,2
9236130,9236581,451,0,0,1,1
9236581,9236670,89,1,0,0,2
9236582,9236663,81,1,0,0,1
9236664,9236745,81,0,0,1,1
9236671,9236746,75,0,0,1,2
9236746,9236776,30,1,0,0,1
9236747,9236781,34,1,0,0,2
9236777,9236943,166,0,0,1,1
9236782,9236947,165,0,0,1,2
9236944,9236979,35,1,0,0,1
9236948,9236967,19,1,0,0,2
9236968,9238873,1905,0,0,1,2
9236980,9238872,1892,0,0,1,1
9238873,9238945,72,1,0,0,1
9238874,9238945,71,1,0,0,2
9238946,9239339,393,0,0,1,1
9238946,9239340,394,0,0,1,2
9239340,9239416,76,1,0,0,1
9239341,9239405,64,1,0,0,2
9239406,9239463,57,0,0,1,2
9239417,9239462,45,0,0,1,1
9239463,9239500,37,1,0,0,1
9239464,9239502,38,1,0,0,2
9239501,9239603,102,0,0,1,1
9239503,9239602,99,0,0,1,2
9239603,9239624,21,1,0,0,2
9239604,9239633,29,1,0,0,1
9239625,9239801,176,0,0,1,2
9239634,9240173,539,0,0,1,1
9239802,9239813,11,1,0,0,2
9239814,9240180,366,0,0,1,2
9240174,9240206,32,1,0,0,1
9240181,9240197,16,1,0,0,2
9240198,9241047,849,0,0,1,2
9240207,9241036,829,0,0,1,1
9241037,9241285,248,1,0,0,1
9241048,9241290,242,1,0,0,2
9241061,9241256,195,0,1,0,2
9241063,9241230,167,0,1,0,1
9241286,9241392,106,0,0,1,1
9241291,9241400,109,0,0,1,2
9241393,9241412,19,1,0,0,1
9241401,9241405,4,1,0,0,2
9241406,9241742,336,0,0,1,2
9241413,9241743,330,0,0,1,1
9241743,9241797,54,1,0,0,2
9241744,9241797,53,1,0,0,1
9241798,9242162,364,0,0,1,1
9241798,9242163,365,0,0,1,2
9242163,9242261,98,1,0,0,1
9242164,9242262,98,1,0,0,2
9242262,9242320,58,0,0,1,1
9242263,9242319,56,0,0,1,2
9242320,9242360,40,1,0,0,2
9242321,9242361,40,1,0,0,1
9242361,9242522,161,0,0,1,2
9242362,9242524,162,0,0,1,1
9242523,9242544,21,1,0,0,2
9242525,9242553,28,1,0,0,1
9242545,9242760,215,0,0,1,2
9242554,9242761,207,0,0,1,1
9242761,9242774,13,1,0,0,2
9242762,9242773,11,1,0,0,1
9242774,9244275,1501,0,0,1,1
9242775,9244274,1499,0,0,1,2
9244275,9244506,231,1,0,0,2
9244276,9244471,195,1,0,0,1
9244323,9244444,121,0,1,0,2
9244326,9244430,104,0,1,0,1
9244472,9244798,326,0,0,1,1
9244507,9244798,291,0,0,1,2
9244799,9244885,86,1,0,0,1
9244799,9244886,87,1,0,0,2
9244886,9244966,80,0,0,1,1
9244887,9244967,80,0,0,1,2
9244967,9245005,38,1,0,0,1
9244968,9245003,35,1,0,0,2
9245004,9245714,710,0,0,1,2
9245006,9247136,2130,0,0,1,1
9245715,9245727,12,1,0,0,2
9245728,9247136,1408,0,0,1,2
9247137,9247228,91,1,0,0,1
9247137,9247228,91,1,0,0,2
9247229,9247564,335,0,0,1,2
9247229,9247565,336,0,0,1,1
9247565,9247647,82,1,0,0,2
9247566,9247650,84,1,0,0,1
9247648,9247754,106,0,0,1,2
9247651,9247755,104,0,0,1,1
9247755,9247797,42,1,0,0,2
9247756,9247816,60,1,0,0,1
9247798,9247965,167,0,0,1,2
9247817,9247967,150,0,0,1,1
9247966,9247985,19,1,0,0,2
9247968,9247993,25,1,0,0,1
9247986,9248066,80,0,0,1,2
9247994,9250061,2067,0,0,1,1
9248067,9248075,8,1,0,0,2
9248076,9250060,1984,0,0,1,2
9250061,9250134,73,1,0,0,2
9250062,9250138,76,1,0,0,1
9250135,9250520,385,0,0,1,2
9250139,9250521,382,0,0,1,1
9250521,9250578,57,1,0,0,2
9250522,9250599,77,1,0,0,1
9250579,9250685,106,0,0,1,2
9250600,9250685,85,0,0,1,1
9250686,9250721,35,1,0,0,1
9250686,9250723,37,1,0,0,2
9250722,9251078,356,0,0,1,1
9250724,9251081,357,0,0,1,2
9251079,9251111,32,1,0,0,1
9251082,9251102,20,1,0,0,2
9251103,9251487,384,0,0,1,2
9251112,9251487,375,0,0,1,1
9251488,9251516,28,1,0,0,2
9251488,9251523,35,1,0,0,1
9251517,9253029,1512,0,0,1,2
9251524,9252037,513,0,0,1,1
9252038,9252049,11,1,0,0,1
9252050,9253028,978,0,0,1,1
9253029,9253120,91,1,0,0,1
9253030,9253119,89,1,0,0,2
9253120,9253408,288,0,0,1,2
9253121,9253407,286,0,0,1,1
9253408,9253453,45,1,0,0,1
9253409,9253452,43,1,0,0,2
9253453,9253508,55,0,0,1,2
9253454,9253507,53,0,0,1,1
9253508,9253578,70,1,0,0,1
9253509,9253577,68,1,0,0,2
9253578,9253723,145,0,0,1,2
9253579,9253723,144,0,0,1,1
9253724,9253750,26,1,0,0,2
9253724,9253755,31,1,0,0,1
9253751,9255059,1308,0,0,1,2
9253756,9255054,1298,0,0,1,1
9255055,9255169,114,1,0,0,1
9255060,9255191,131,1,0,0,2
9255170,9255646,476,0,0,1,1
9255192,9255647,455,0,0,1,2
9255647,9255765,118,1,0,0,1
9255648,9255788,140,1,0,0,2
9255687,9255732,45,0,1,0,2
9255692,9255719,27,0,1,0,1
9255766,9256042,276,0,0,1,1
9255789,9256045,256,0,0,1,2
9256043,9256126,83,1,0,0,1
9256046,9256123,77,1,0,0,2
9256124,9256188,64,0,0,1,2
9256127,9256188,61,0,0,1,1
9256189,9256221,32,1,0,0,2
9256189,9256225,36,1,0,0,1
9256222,9256373,151,0,0,1,2
9256226,9256372,146,0,0,1,1
9256373,9256404,31,1,0,0,1
9256374,9256403,29,1,0,0,2
9256404,9258169,1765,0,0,1,2
9256405,9258170,1765,0,0,1,1
9258170,9258265,95,1,0,0,2
9258171,9258255,84,1,0,0,1
9258256,9258616,360,0,0,1,1
9258266,9258615,349,0,0,1,2
9258616,9258668,52,1,0,0,2
9258617,9258680,63,1,0,0,1
9258669,9258723,54,0,0,1,2
9258681,9258722,41,0,0,1,1
9258723,9258764,41,1,0,0,1
9258724,9258761,37,1,0,0,2
9258762,9258928,166,0,0,1,2
9258765,9258929,164,0,0,1,1
9258929,9258957,28,1,0,0,2
9258930,9258947,17,1,0,0,1
9258948,9260807,1859,0,0,1,1
9258958,9260808,1850,0,0,1,2
9260808,9260862,54,1,0,0,1
9260809,9260862,53,1,0,0,2
9260863,9261266,403,0,0,1,1
9260863,9261266,403,0,0,1,2
9261267,9261338,71,1,0,0,1
9261267,9261338,71,1,0,0,2
9261339,9261395,56,0,0,1,1
9261339,9261397,58,0,0,1,2
9261396,9261430,34,1,0,0,1
9261398,9261431,33,1,0,0,2
9261431,9261809,378,0,0,1,1
9261432,9261803,371,0,0,1,2
9261804,9261825,21,1,0,0,2
9261810,9261814,4,1,0,0,1
9261815,9262967,1152,0,0,1,1
9261826,9262961,1135,0,0,1,2
9262962,9263214,252,1,0,0,2
9262968,9263171,203,1,0,0,1
9262986,9263164,178,0,1,0,2
9262991,9263151,160,0,1,0,1
9263172,9263508,336,0,0,1,1
9263215,9263240,25,0,0,1,2
9263241,9263264,23,1,0,0,2
9263265,9263512,247,0,0,1,2
9263509,9263581,72,1,0,0,1
9263513,9263590,77,1,0,0,2
9263582,9264022,440,0,0,1,1
9263591,9264022,431,0,0,1,2
9264023,9264095,72,1,0,0,1
9264023,9264099,76,1,0,0,2
9264096,9264167,71,0,0,1,1
9264100,9264166,66,0,0,1,2
9264167,9264202,35,1,0,0,2
9264168,9264198,30,1,0,0,1
9264199,9264428,229,0,0,1,1
9264203,9264426,223,0,0,1,2
9264427,9264439,12,1,0,0,2
9264429,9264440,11,1,0,0,1
9264440,9264907,467,0,0,1,2
9264441,9266267,1826,0,0,1,1
9264908,9265037,129,1,0,0,2
9265038,9265227,189,0,0,1,2
9265228,9265308,80,1,0,0,2
9265309,9265478,169,0,0,1,2
9265479,9265505,26,1,0,0,2
9265506,9265551,45,0,0,1,2
9265552,9265702,150,1,0,0,2
9265703,9265750,47,0,0,1,2
9265751,9265990,239,1,0,0,2
9265991,9266145,154,0,0,1,2
9266146,9266341,195,1,0,0,2
9266268,9266352,84,1,0,0,1
9266342,9266722,380,0,0,1,2
9266353,9266723,370,0,0,1,1
9266723,9266794,71,1,0,0,2
9266724,9266803,79,1,0,0,1
9266795,9266887,92,0,0,1,2
9266804,9266887,83,0,0,1,1
9266888,9266913,25,1,0,0,1
9266888,9266922,34,1,0,0,2
9266914,9267155,241,0,0,1,1
9266923,9268132,1209,0,0,1,2
9267156,9267198,42,1,0,0,1
9267199,9268130,931,0,0,1,1
9268131,9268174,43,1,0,0,1
9268133,9268144,11,1,0,0,2
9268145,9269298,1153,0,0,1,2
9268175,9269296,1121,0,0,1,1
9269297,9269376,79,1,0,0,1
9269299,9269369,70,1,0,0,2
9269370,9269768,398,0,0,1,2
9269377,9269766,389,0,0,1,1
9269767,9269854,87,1,0,0,1
9269769,9269845,76,1,0,0,2
9269846,9269926,80,0,0,1,2
9269855,9269926,71,0,0,1,1
9269927,9269951,24,1,0,0,1
9269927,9269959,32,1,0,0,2
9269952,9270705,753,0,0,1,1
9269960,9270709,749,0,0,1,2
9270706,9270734,28,1,0,0,1
9270710,9270725,15,1,0,0,2
9270726,9272224,1498,0,0,1,2
9270735,9272224,1489,0,0,1,1
9272225,9272255,30,1,0,0,2
9272225,9272256,31,1,0,0,1
9272256,9272643,387,0,0,1,2
9272257,9272644,387,0,0,1,1
9272644,9272734,90,1,0,0,2
9272645,9272746,101,1,0,0,1
9272735,9272812,77,0,0,1,2
9272747,9272812,65,0,0,1,1
9272813,9272851,38,1,0,0,1
9272813,9272851,38,1,0,0,2
9272852,9272912,60,0,0,1,1
9272852,9272912,60,0,0,1,2
9272913,9272946,33,1,0,0,2
9272913,9272954,41,1,0,0,1
9272947,9273061,114,0,0,1,2
9272955,9273067,112,0,0,1,1
9273062,9273090,28,1,0,0,2
9273068,9273089,21,1,0,0,1
9273090,9273716,626,0,0,1,1
9273091,9273722,631,0,0,1,2
9273717,9273745,28,1,0,0,1
9273723,9273736,13,1,0,0,2
9273737,9275380,1643,0,0,1,2
9273746,9275381,1635,0,0,1,1
9275381,9275471,90,1,0,0,2
9275382,9275481,99,1,0,0,1
9275472,9275849,377,0,0,1,2
9275482,9275848,366,0,0,1,1
9275849,9275898,49,1,0,0,1
9275850,9275900,50,1,0,0,2
9275899,9276009,110,0,0,1,1
9275901,9276009,108,0,0,1,2
9276010,9276031,21,1,0,0,2
9276010,9276040,30,1,0,0,1
9276032,9276827,795,0,0,1,2
9276041,9276364,323,0,0,1,1
9276365,9276378,13,1,0,0,1
9276379,9276829,450,0,0,1,1
9276828,9276846,18,1,0,0,2
9276830,9276846,16,1,0,0,1
9276847,9277066,219,0,0,1,1
9276847,9277071,224,0,0,1,2
9277067,9277092,25,1,0,0,1
9277072,9277085,13,1,0,0,2
9277086,9278519,1433,0,0,1,2
9277093,9278520,1427,0,0,1,1
9278520,9278577,57,1,0,0,2
9278521,9278581,60,1,0,0,1
9278578,9279004,426,0,0,1,2
9278582,9279005,423,0,0,1,1
9279005,9279045,40,1,0,0,2
9279006,9279035,29,1,0,0,1
9279036,9279149,113,0,0,1,1
9279046,9279149,103,0,0,1,2
9279150,9279170,20,1,0,0,2
9279150,9279182,32,1,0,0,1
9279171,9279712,541,0,0,1,2
9279183,9279708,525,0,0,1,1
9279709,9279726,17,1,0,0,1
9279713,9279725,12,1,0,0,2
9279726,9282052,2326,0,0,1,2
9279727,9282054,2327,0,0,1,1
9282053,9282139,86,1,0,0,2
9282055,9282179,124,1,0,0,1
9282140,9282226,86,0,0,1,2
9282180,9282228,48,0,0,1,1
9282227,9282265,38,1,0,0,2
9282229,9282254,25,1,0,0,1
9282255,9282721,466,0,0,1,1
9282266,9283299,1033,0,0,1,2
9282722,9282733,11,1,0,0,1
9282734,9283289,555,0,0,1,1
9283290,9283303,13,1,0,0,1
9283300,9283316,16,1,0,0,2
9283304,9283987,683,0,0,1,1
9283317,9283990,673,0,0,1,2
9283988,9284015,27,1,0,0,1
9283991,9284014,23,1,0,0,2
9284015,9284680,665,0,0,1,2
9284016,9284677,661,0,0,1,1
9284678,9284790,112,1,0,0,1
9284681,9284790,109,1,0,0,2
9284791,9284953,162,0,0,1,1
9284791,9284953,162,0,0,1,2
9284954,9284980,26,1,0,0,2
9284954,9284985,31,1,0,0,1
9284981,9285107,126,0,0,1,2
9284986,9285106,120,0,0,1,1
9285107,9285197,90,1,0,0,1
9285108,9285199,91,1,0,0,2
9285198,9285294,96,0,0,1,1
9285200,9285294,94,0,0,1,2
9285295,9285318,23,1,0,0,1
9285295,9285318,23,1,0,0,2
9285319,9285717,398,0,0,1,1
9285319,9285718,399,0,0,1,2
9285718,9285741,23,1,0,0,1
9285719,9285740,21,1,0,0,2
9285741,9286061,320,0,0,1,2
9285742,9286061,319,0,0,1,1
9286062,9286077,15,1,0,0,1
9286062,9286078,16,1,0,0,2
9286078,9286547,469,0,0,1,1
9286079,9286548,469,0,0,1,2
9286548,9286560,12,1,0,0,1
9286549,9286560,11,1,0,0,2
9286561,9287274,713,0,0,1,1
9286561,9287276,715,0,0,1,2
9287275,9287304,29,1,0,0,1
9287277,9287299,22,1,0,0,2
9287300,9287394,94,0,0,1,2
9287305,9287393,88,0,0,1,1
9287394,9287416,22,1,0,0,1
9287395,9287425,30,1,0,0,2
9287417,9287852,435,0,0,1,1
9287426,9287850,424,0,0,1,2
9287851,9287892,41,1,0,0,2
9287853,9287892,39,1,0,0,1
9287893,9287921,28,0,0,1,2
9287893,9287922,29,0,0,1,1
9287922,9287953,31,1,0,0,2
9287923,9287953,30,1,0,0,1
9287954,9288168,214,0,0,1,2
9287954,9288169,215,0,0,1,1
9288169,9288237,68,1,0,0,2
9288170,9288240,70,1,0,0,1
9288238,9288291,53,0,0,1,2
9288241,9288289,48,0,0,1,1
9288290,9288338,48,1,0,0,1
9288292,9288340,48,1,0,0,2
9288339,9288535,196,0,0,1,1
9288341,9288531,190,0,0,1,2
9288532,9288550,18,1,0,0,2
9288536,9288549,13,1,0,0,1
9288550,9288905,355,0,0,1,1
9288551,9288908,357,0,0,1,2
9288906,9289077,171,1,0,0,1
9288909,9289087,178,1,0,0,2
9288935,9289048,113,0,1,0,2
9288942,9289028,86,0,1,0,1
9289078,9291023,1945,0,0,1,1
9289088,9291021,1933,0,0,1,2
9291022,9291071,49,1,0,0,2
9291024,9291073,49,1,0,0,1
9291072,9291481,409,0,0,1,2
9291074,9291482,408,0,0,1,1
9291482,9291551,69,1,0,0,2
9291483,9291553,70,1,0,0,1
9291552,9291630,78,0,0,1,2
9291554,9291633,79,0,0,1,1
9291631,9291654,23,1,0,0,2
9291634,9291664,30,1,0,0,1
9291655,9292308,653,0,0,1,2
9291665,9292102,437,0,0,1,1
9292103,9292125,22,1,0,0,1
9292126,9292303,177,0,0,1,1
9292304,9292517,213,1,0,0,1
9292309,9292546,237,1,0,0,2
9292336,9292466,130,0,1,0,2
9292336,9292474,138,0,1,0,1
9292518,9292550,32,0,0,1,1
9292547,9292671,124,0,0,1,2
9292551,9292567,16,1,0,0,1
9292568,9292667,99,0,0,1,1
9292668,9292700,32,1,0,0,1
9292672,9292702,30,1,0,0,2
9292701,9293097,396,0,0,1,1
9292703,9293101,398,0,0,1,2
9293098,9293112,14,1,0,0,1
9293102,9293122,20,1,0,0,2
9293113,9293287,174,0,0,1,1
9293123,9293287,164,0,0,1,2
9293288,9293300,12,1,0,0,2
9293288,9293311,23,1,0,0,1
9293301,9295048,1747,0,0,1,2
9293312,9295048,1736,0,0,1,1
9295049,9295117,68,1,0,0,2
9295049,9295131,82,1,0,0,1
9295118,9295236,118,0,0,1,2
9295132,9295236,104,0,0,1,1
9295237,9295260,23,1,0,0,2
9295237,9295272,35,1,0,0,1
9295261,9295547,286,0,0,1,2
9295273,9295546,273,0,0,1,1
9295547,9295563,16,1,0,0,1
9295548,9295561,13,1,0,0,2
9295562,9297289,1727,0,0,1,2
9295564,9296760,1196,0,0,1,1
9296761,9296777,16,1,0,0,1
9296778,9297287,509,0,0,1,1
9297288,9297384,96,1,0,0,1
9297290,9297388,98,1,0,0,2
9297385,9297716,331,0,0,1,1
9297389,9297714,325,0,0,1,2
9297715,9297774,59,1,0,0,2
9297717,9297764,47,1,0,0,1
9297765,9297852,87,0,0,1,1
9297775,9297852,77,0,0,1,2
9297853,9297875,22,1,0,0,2
9297853,9297884,31,1,0,0,1
9297876,9299619,1743,0,0,1,2
9297885,9298089,204,0,0,1,1
9298090,9298105,15,1,0,0,1
9298106,9299621,1515,0,0,1,1
9299620,9299681,61,1,0,0,2
9299622,9299685,63,1,0,0,1
9299682,9300021,339,0,0,1,2
9299686,9300021,335,0,0,1,1
9300022,9300070,48,1,0,0,1
9300022,9300071,49,1,0,0,2
9300071,9300117,46,0,0,1,1
9300072,9300116,44,0,0,1,2
9300117,9300182,65,1,0,0,2
9300118,9300195,77,1,0,0,1
9300183,9300321,138,0,0,1,2
9300196,9300321,125,0,0,1,1
9300322,9300350,28,1,0,0,1
9300322,9300350,28,1,0,0,2
9300351,9301928,1577,0,0,1,2
9300351,9301929,1578,0,0,1,1
9301929,9301996,67,1,0,0,2
9301930,9302005,75,1,0,0,1
9301997,9302310,313,0,0,1,2
9302006,9302307,301,0,0,1,1
9302308,9302355,47,1,0,0,1
9302311,9302353,42,1,0,0,2
9302354,9302436,82,0,0,1,2
9302356,9302437,81,0,0,1,1
9302437,9302470,33,1,0,0,2
9302438,9302470,32,1,0,0,1
9302471,9304086,1615,0,0,1,2
9302471,9304087,1616,0,0,1,1
9304087,9304131,44,1,0,0,2
9304088,9304132,44,1,0,0,1
9304132,9304436,304,0,0,1,2
9304133,9304510,377,0,0,1,1
9304437,9304441,4,1,0,0,2
9304442,9304508,66,0,0,1,2
9304509,9304585,76,1,0,0,2
9304511,9304579,68,1,0,0,1
9304580,9304687,107,0,0,1,1
9304586,9304684,98,0,0,1,2
9304685,9304722,37,1,0,0,2
9304688,9304717,29,1,0,0,1
9304718,9306442,1724,0,0,1,1
9304723,9306440,1717,0,0,1,2
9306441,9306528,87,1,0,0,2
9306443,9306535,92,1,0,0,1
9306529,9306906,377,0,0,1,2
9306536,9306904,368,0,0,1,1
9306905,9306996,91,1,0,0,1
9306907,9306988,81,1,0,0,2
9306989,9307125,136,0,0,1,2
9306997,9307123,126,0,0,1,1
9307124,9307157,33,1,0,0,1
9307126,9307156,30,1,0,0,2
9307157,9307314,157,0,0,1,2
9307158,9307310,152,0,0,1,1
9307311,9307326,15,1,0,0,1
9307315,9307327,12,1,0,0,2
9307327,9307772,445,0,0,1,1
9307328,9308215,887,0,0,1,2
9307773,9307786,13,1,0,0,1
9307787,9308209,422,0,0,1,1
9308210,9308227,17,1,0,0,1
9308216,9308225,9,1,0,0,2
9308226,9308557,331,0,0,1,2
9308228,9308557,329,0,0,1,1
9308558,9308569,11,1,0,0,1
9308558,9308569,11,1,0,0,2
9308570,9309157,587,0,0,1,1
9308570,9309157,587,0,0,1,2
9309158,9309200,42,1,0,0,1
9309158,9309201,43,1,0,0,2
9309201,9309548,347,0,0,1,1
9309202,9309550,348,0,0,1,2
9309549,9309605,56,1,0,0,1
9309551,9309608,57,1,0,0,2
9309606,9309717,111,0,0,1,1
9309609,9309717,108,0,0,1,2
9309718,9309737,19,1,0,0,2
9309718,9309739,21,1,0,0,1
9309738,9310312,574,0,0,1,2
9309740,9312149,2409,0,0,1,1
9310313,9310324,11,1,0,0,2
9310325,9312149,1824,0,0,1,2
9312150,9312232,82,1,0,0,1
9312150,9312238,88,1,0,0,2
9312233,9312580,347,0,0,1,1
9312239,9312578,339,0,0,1,2
9312579,9312660,81,1,0,0,2
9312581,9312659,78,1,0,0,1
9312660,9312739,79,0,0,1,1
9312661,9312738,77,0,0,1,2
9312739,9312779,40,1,0,0,2
9312740,9312772,32,1,0,0,1
9312773,9312983,210,0,0,1,1
9312780,9312982,202,0,0,1,2
9312983,9313006,23,1,0,0,2
9312984,9313004,20,1,0,0,1
9313005,9313103,98,0,0,1,1
9313007,9313103,96,0,0,1,2
9313104,9313125,21,1,0,0,2
9313104,9313135,31,1,0,0,1
9313126,9314422,1296,0,0,1,2
9313136,9314418,1282,0,0,1,1
9314419,9314453,34,1,0,0,1
9314423,9314445,22,1,0,0,2
9314446,9315120,674,0,0,1,2
9314454,9315121,667,0,0,1,1
9315121,9315198,77,1,0,0,2
9315122,9315198,76,1,0,0,1
9315199,9315520,321,0,0,1,2
9315199,9315521,322,0,0,1,1
9315521,9315580,59,1,0,0,2
9315522,9315575,53,1,0,0,1
9315576,9315666,90,0,0,1,1
9315581,9315666,85,0,0,1,2
9315667,9315686,19,1,0,0,1
9315667,9315687,20,1,0,0,2
9315687,9317452,1765,0,0,1,1
9315688,9317453,1765,0,0,1,2
9317453,9317503,50,1,0,0,1
9317454,9317509,55,1,0,0,2
9317504,9317970,466,0,0,1,1
9317510,9317969,459,0,0,1,2
9317970,9318052,82,1,0,0,2
9317971,9318047,76,1,0,0,1
9318048,9318137,89,0,0,1,1
9318053,9318137,84,0,0,1,2
9318138,9318170,32,1,0,0,1
9318138,9318174,36,1,0,0,2
9318171,9318334,163,0,0,1,1
9318175,9318339,164,0,0,1,2
9318335,9318352,17,1,0,0,1
9318340,9318351,11,1,0,0,2
9318352,9320045,1693,0,0,1,2
9318353,9320043,1690,0,0,1,1
9320044,9320129,85,1,0,0,1
9320046,9320130,84,1,0,0,2
9320130,9320500,370,0,0,1,1
9320131,9320502,371,0,0,1,2
9320501,9320587,86,1,0,0,1
9320503,9320587,84,1,0,0,2
9320588,9320692,104,0,0,1,1
9320588,9320692,104,0,0,1,2
9320693,9320730,37,1,0,0,2
9320693,9320731,38,1,0,0,1
9320731,9320839,108,0,0,1,2
9320732,9320842,110,0,0,1,1
9320840,9320868,28,1,0,0,2
9320843,9320860,17,1,0,0,1
9320861,9321595,734,0,0,1,1
9320869,9321596,727,0,0,1,2
9321596,9321615,19,1,0,0,1
9321597,9321612,15,1,0,0,2
9321613,9322269,656,0,0,1,2
9321616,9322268,652,0,0,1,1
9322269,9322298,29,1,0,0,1
9322270,9322287,17,1,0,0,2
9322288,9322408,120,0,0,1,2
9322299,9322407,108,0,0,1,1
9322408,9322423,15,1,0,0,1
9322409,9322423,14,1,0,0,2
9322424,9322999,575,0,0,1,2
9322424,9323001,577,0,0,1,1
9323000,9323203,203,1,0,0,2
9323002,9323205,203,1,0,0,1
9323041,9323155,114,0,1,0,1
9323043,9323156,113,0,1,0,2
9323204,9323460,256,0,0,1,2
9323206,9323459,253,0,0,1,1
9323460,9323490,30,1,0,0,1
9323461,9323499,38,1,0,0,2
9323491,9323609,118,0,0,1,1
9323500,9323608,108,0,0,1,2
9323609,9323628,19,1,0,0,2
9323610,9323630,20,1,0,0,1
9323629,9323839,210,0,0,1,2
9323631,9324152,521,0,0,1,1
9323840,9323844,4,1,0,0,2
9323845,9324780,935,0,0,1,2
9324153,9324164,11,1,0,0,1
9324165,9324779,614,0,0,1,1
9324780,9324799,19,1,0,0,1
9324781,9324798,17,1,0,0,2
9324799,9324916,117,0,0,1,2
9324800,9324917,117,0,0,1,1
9324917,9324936,19,1,0,0,2
9324918,9324935,17,1,0,0,1
9324936,9325188,252,0,0,1,1
9324937,9325183,246,0,0,1,2
9325184,9325201,17,1,0,0,2
9325189,9325201,12,1,0,0,1
9325202,9325580,378,0,0,1,1
9325202,9325580,378,0,0,1,2
9325581,9325634,53,1,0,0,2
9325581,9325635,54,1,0,0,1
9325635,9326011,376,0,0,1,2
9325636,9326010,374,0,0,1,1
9326011,9326082,71,1,0,0,1
9326012,9326081,69,1,0,0,2
9326082,9326167,85,0,0,1,2
9326083,9326170,87,0,0,1,1
9326168,9326206,38,1,0,0,2
9326171,9326208,37,1,0,0,1
9326207,9326347,140,0,0,1,2
9326209,9326346,137,0,0,1,1
9326347,9326378,31,1,0,0,1
9326348,9326376,28,1,0,0,2
9326377,9328074,1697,0,0,1,2
9326379,9328075,1696,0,0,1,1
9328075,9328166,91,1,0,0,2
9328076,9328164,88,1,0,0,1
9328165,9328511,346,0,0,1,1
9328167,9328509,342,0,0,1,2
9328510,9328601,91,1,0,0,2
9328512,9328594,82,1,0,0,1
9328595,9328749,154,0,0,1,1
9328602,9328752,150,0,0,1,2
9328750,9328779,29,1,0,0,1
9328753,9328768,15,1,0,0,2
9328769,9328960,191,0,0,1,2
9328780,9329853,1073,0,0,1,1
9328961,9328966,5,1,0,0,2
9328967,9330753,1786,0,0,1,2
9329854,9329865,11,1,0,0,1
9329866,9330751,885,0,0,1,1
9330752,9330831,79,1,0,0,1
9330754,9330833,79,1,0,0,2
9330832,9331250,418,0,0,1,1
9330834,9331251,417,0,0,1,2
9331251,9331325,74,1,0,0,1
9331252,9331327,75,1,0,0,2
9331326,9332108,782,0,0,1,1
9331328,9331512,184,0,0,1,2
9331513,9331529,16,1,0,0,2
9331530,9332108,578,0,0,1,2
9332109,9332138,29,1,0,0,1
9332109,9332139,30,1,0,0,2
9332139,9332553,414,0,0,1,1
9332140,9332549,409,0,0,1,2
9332550,9332578,28,1,0,0,2
9332554,9332576,22,1,0,0,1
9332577,9333051,474,0,0,1,1
9332579,9333049,470,0,0,1,2
9333050,9333183,133,1,0,0,2
9333052,9333183,131,1,0,0,1
9333082,9333138,56,0,1,0,2
9333184,9333608,424,0,0,1,2
9333184,9333609,425,0,0,1,1
9333609,9333699,90,1,0,0,2
9333610,9333697,87,1,0,0,1
9333698,9334043,345,0,0,1,1
9333700,9334044,344,0,0,1,2
9334044,9334111,67,1,0,0,1
9334045,9334113,68,1,0,0,2
9334112,9334301,189,0,0,1,1
9334114,9334299,185,0,0,1,2
9334300,9334318,18,1,0,0,2
9334302,9334320,18,1,0,0,1
9334319,9334935,616,0,0,1,2
9334321,9334926,605,0,0,1,1
9334927,9334939,12,1,0,0,1
9334936,9334940,4,1,0,0,2
9334940,9335905,965,0,0,1,1
9334941,9335905,964,0,0,1,2
9335906,9335921,15,1,0,0,1
9335906,9335922,16,1,0,0,2
9335922,9336276,354,0,0,1,1
9335923,9336275,352,0,0,1,2
9336276,9336432,156,1,0,0,2
9336277,9336425,148,1,0,0,1
9336426,9336687,261,0,0,1,1
9336433,9336690,257,0,0,1,2
9336688,9336727,39,1,0,0,1
9336691,9336726,35,1,0,0,2
9336727,9336752,25,0,0,1,2
9336728,9336750,22,0,0,1,1
9336751,9336797,46,1,0,0,1
9336753,9336796,43,1,0,0,2
9336797,9336879,82,0,0,1,2
9336798,9336878,80,0,0,1,1
9336879,9336910,31,1,0,0,1
9336880,9336907,27,1,0,0,2
9336908,9337063,155,0,0,1,2
9336911,9337061,150,0,0,1,1
9337062,9337076,14,1,0,0,1
9337064,9337079,15,1,0,0,2
9337077,9338577,1500,0,0,1,1
9337080,9338579,1499,0,0,1,2
9338578,9338607,29,1,0,0,1
9338580,9338599,19,1,0,0,2
9338600,9338810,210,0,0,1,2
9338608,9338809,201,0,0,1,1
9338810,9338826,16,1,0,0,1
9338811,9338830,19,1,0,0,2
9338827,9339121,294,0,0,1,1
9338831,9339118,287,0,0,1,2
9339119,9339144,25,1,0,0,2
9339122,9339145,23,1,0,0,1
9339145,9339494,349,0,0,1,2
9339146,9339493,347,0,0,1,1
9339494,9339555,61,1,0,0,1
9339495,9339554,59,1,0,0,2
9339555,9339656,101,0,0,1,2
9339556,9339655,99,0,0,1,1
9339656,9339689,33,1,0,0,1
9339657,9339679,22,1,0,0,2
9339680,9339803,123,0,0,1,2
9339690,9339803,113,0,0,1,1
9339804,9339834,30,1,0,0,2
9339804,9339835,31,1,0,0,1
9339835,9339939,104,0,0,1,2
9339836,9339945,109,0,0,1,1
9339940,9339958,18,1,0,0,2
9339946,9339957,11,1,0,0,1
9339958,9341087,1129,0,0,1,1
9339959,9341090,1131,0,0,1,2
9341088,9341113,25,1,0,0,1
9341091,9341113,22,1,0,0,2
9341114,9341230,116,0,0,1,2
9341114,9341909,795,0,0,1,1
9341231,9341247,16,1,0,0,2
9341248,9341908,660,0,0,1,2
9341909,9341934,25,1,0,0,2
9341910,9341937,27,1,0,0,1
9341935,9342332,397,0,0,1,2
9341938,9342334,396,0,0,1,1
9342333,9342467,134,1,0,0,2
9342335,9342458,123,1,0,0,1
9342459,9342547,88,0,0,1,1
9342468,9342545,77,0,0,1,2
9342546,9342578,32,1,0,0,2
9342548,9342567,19,1,0,0,1
9342568,9342674,106,0,0,1,1
9342579,9342672,93,0,0,1,2
9342673,9342690,17,1,0,0,2
9342675,9342692,17,1,0,0,1
9342691,9342826,135,0,0,1,2
9342693,9342827,134,0,0,1,1
9342827,9342845,18,1,0,0,2
9342828,9342846,18,1,0,0,1
9342846,9343283,437,0,0,1,2
9342847,9343282,435,0,0,1,1
9343283,9343295,12,1,0,0,1
9343284,9343292,8,1,0,0,2
9343293,9344728,1435,0,0,1,2
9343296,9344731,1435,0,0,1,1
9344729,9344801,72,1,0,0,2
9344732,9344799,67,1,0,0,1
9344800,9344941,141,0,0,1,1
9344802,9344940,138,0,0,1,2
9344941,9344965,24,1,0,0,2
9344942,9344965,23,1,0,0,1
9344966,9345177,211,0,0,1,1
9344966,9345179,213,0,0,1,2
9345178,9345243,65,1,0,0,1
9345180,9345254,74,1,0,0,2
9345244,9345312,68,0,0,1,1
9345255,9345314,59,0,0,1,2
9345313,9345350,37,1,0,0,1
9345315,9345351,36,1,0,0,2
9345351,9345478,127,0,0,1,1
9345352,9345478,126,0,0,1,2
9345479,9345499,20,1,0,0,1
9345479,9345509,30,1,0,0,2
9345500,9346476,976,0,0,1,1
9345510,9346476,966,0,0,1,2
9346477,9346504,27,1,0,0,2
9346477,9346506,29,1,0,0,1
9346505,9347953,1448,0,0,1,2
9346507,9347953,1446,0,0,1,1
9347954,9347979,25,1,0,0,1
9347954,9347980,26,1,0,0,2
9347980,9348376,396,0,0,1,1
9347981,9348375,394,0,0,1,2
9348376,9348459,83,1,0,0,2
9348377,9348452,75,1,0,0,1
9348453,9348527,74,0,0,1,1
9348460,9348527,67,0,0,1,2
9348528,9348553,25,1,0,0,2
9348528,9348561,33,1,0,0,1
9348554,9348733,179,0,0,1,2
9348562,9348734,172,0,0,1,1
9348734,9348754,20,1,0,0,2
9348735,9348750,15,1,0,0,1
9348751,9350815,2064,0,0,1,1
9348755,9351322,2567,0,0,1,2
9350816,9350828,12,1,0,0,1
9350829,9351321,492,0,0,1,1
9351322,9351357,35,1,0,0,1
9351323,9351356,33,1,0,0,2
9351357,9351854,497,0,0,1,2
9351358,9351856,498,0,0,1,1
9351855,9351930,75,1,0,0,2
9351857,9351920,63,1,0,0,1
9351921,9352007,86,0,0,1,1
9351931,9352007,76,0,0,1,2
9352008,9352030,22,1,0,0,1
9352008,9352032,24,1,0,0,2
9352031,9352061,30,0,0,1,1
9352033,9352061,28,0,0,1,2
9352062,9352084,22,1,0,0,2
9352062,9352093,31,1,0,0,1
9352085,9352311,226,0,0,1,2
9352094,9352311,217,0,0,1,1
9352312,9352331,19,1,0,0,1
9352312,9352339,27,1,0,0,2
9352332,9354385,2053,0,0,1,1
9352340,9354385,2045,0,0,1,2
9354386,9354434,48,1,0,0,1
9354386,9354441,55,1,0,0,2
9354435,9354668,233,0,0,1,1
9354442,9354669,227,0,0,1,2
9354669,9354705,36,1,0,0,1
9354670,9354701,31,1,0,0,2
9354702,9356485,1783,0,0,1,2
9354706,9356485,1779,0,0,1,1
9356486,9356663,177,1,0,0,1
9356486,9356682,196,1,0,0,2
9356530,9356641,111,0,1,0,2
9356534,9356623,89,0,1,0,1
9356664,9357678,1014,0,0,1,1
9356683,9357679,996,0,0,1,2
9357679,9357750,71,1,0,0,1
9357680,9357738,58,1,0,0,2
9357739,9357897,158,0,0,1,2
9357751,9357901,150,0,0,1,1
9357898,9357915,17,1,0,0,2
9357902,9357914,12,1,0,0,1
9357915,9358363,448,0,0,1,1
9357916,9360071,2155,0,0,1,2
9358364,9358374,10,1,0,0,1
9358375,9360069,1694,0,0,1,1
9360070,9360127,57,1,0,0,1
9360072,9360128,56,1,0,0,2
9360128,9360232,104,0,0,1,1
9360129,9360232,103,0,0,1,2
9360233,9360254,21,1,0,0,1
9360233,9360265,32,1,0,0,2
9360255,9360550,295,0,0,1,1
9360266,9360545,279,0,0,1,2
9360546,9360562,16,1,0,0,2
9360551,9360560,9,1,0,0,1
9360561,9362227,1666,0,0,1,1
9360563,9362227,1664,0,0,1,2
9362228,9362395,167,1,0,0,1
9362228,9362421,193,1,0,0,2
9362252,9362376,124,0,1,0,2
9362263,9362352,89,0,1,0,1
9362396,9362505,109,0,0,1,1
9362422,9362505,83,0,0,1,2
9362506,9362527,21,1,0,0,2
9362506,9362531,25,1,0,0,1
9362528,9362745,217,0,0,1,2
9362532,9362747,215,0,0,1,1
9362746,9362960,214,1,0,0,2
9362748,9362934,186,1,0,0,1
9362776,9362928,152,0,1,0,2
9362786,9362900,114,0,1,0,1
9362935,9363246,311,0,0,1,1
9362961,9363243,282,0,0,1,2
9363244,9363487,243,1,0,0,2
9363247,9363470,223,1,0,0,1
9363259,9363453,194,0,1,0,2
9363263,9363448,185,0,1,0,1
9363471,9363818,347,0,0,1,1
9363488,9363818,330,0,0,1,2
9363819,9363860,41,1,0,0,1
9363819,9363860,41,1,0,0,2
9363861,9364059,198,0,0,1,2
9363861,9364060,199,0,0,1,1
9364060,9364100,40,1,0,0,2
9364061,9364102,41,1,0,0,1
9364101,9364210,109,0,0,1,2
9364103,9364210,107,0,0,1,1
9364211,9364232,21,1,0,0,2
9364211,9364243,32,1,0,0,1
9364233,9364412,179,0,0,1,2
9364244,9364414,170,0,0,1,1
9364413,9364432,19,1,0,0,2
9364415,9364431,16,1,0,0,1
9364432,9366233,1801,0,0,1,1
9364433,9366234,1801,0,0,1,2
9366234,9366281,47,1,0,0,1
9366235,9366281,46,1,0,0,2
9366282,9366390,108,0,0,1,1
9366282,9366390,108,0,0,1,2
9366391,9366424,33,1,0,0,2
9366391,9366427,36,1,0,0,1
9366425,9366704,279,0,0,1,2
9366428,9366704,276,0,0,1,1
9366705,9366728,23,1,0,0,2
9366705,9366737,32,1,0,0,1
9366729,9367886,1157,0,0,1,2
9366738,9367901,1163,0,0,1,1
9367887,9368072,185,1,0,0,2
9367902,9368017,115,1,0,0,1
9367902,9368027,125,0,1,0,2
9367922,9367974,52,0,1,0,1
9368018,9368451,433,0,0,1,1
9368073,9368447,374,0,0,1,2
9368448,9368696,248,1,0,0,2
9368452,9368668,216,1,0,0,1
9368464,9368651,187,0,1,0,2
9368470,9368648,178,0,1,0,1
9368669,9369501,832,0,0,1,1
9368697,9369500,803,0,0,1,2
9369501,9369601,100,1,0,0,2
9369502,9369586,84,1,0,0,1
9369587,9369757,170,0,0,1,1
9369602,9369758,156,0,0,1,2
9369758,9369788,30,1,0,0,1
9369759,9369787,28,1,0,0,2
9369788,9370084,296,0,0,1,2
9369789,9370089,300,0,0,1,1
9370085,9370097,12,1,0,0,2
9370090,9370102,12,1,0,0,1
9370098,9371990,1892,0,0,1,2
9370103,9371989,1886,0,0,1,1
9371990,9372051,61,1,0,0,1
9371991,9372044,53,1,0,0,2
9372045,9372191,146,0,0,1,2
9372052,9372190,138,0,0,1,1
9372191,9372213,22,1,0,0,1
9372192,9372213,21,1,0,0,2
9372214,9372437,223,0,0,1,2
9372214,9372439,225,0,0,1,1
9372438,9372453,15,1,0,0,2
9372440,9372452,12,1,0,0,1
9372453,9372629,176,0,0,1,1
9372454,9372630,176,0,0,1,2
9372630,9372639,9,1,0,0,1
9372631,9372638,7,1,0,0,2
9372639,9373972,1333,0,0,1,2
9372640,9373971,1331,0,0,1,1
9373972,9373990,18,1,0,0,1
9373973,9373991,18,1,0,0,2
9373991,9374065,74,0,0,1,1
9373992,9374065,73,0,0,1,2
9374066,9374457,391,1,0,0,1
9374066,9374480,414,1,0,0,2
9374146,9374424,278,0,1,0,2
9374150,9374426,276,0,1,0,1
9374458,9374652,194,0,0,1,1
9374481,9374776,295,0,0,1,2
9374653,9374659,6,1,0,0,1
9374660,9374774,114,0,0,1,1
9374775,9374793,18,1,0,0,1
9374777,9374797,20,1,0,0,2
9374794,9374837,43,0,0,1,1
9374798,9374827,29,0,0,1,2
9374828,9375146,318,1,0,0,2
9374838,9375129,291,1,0,0,1
9374855,9375095,240,0,1,0,1
9374857,9375091,234,0,1,0,2
9375130,9375192,62,0,0,1,1
9375147,9375187,40,0,0,1,2
9375188,9375201,13,1,0,0,2
9375193,9375198,5,1,0,0,1
9375199,9375336,137,0,0,1,1
9375202,9375333,131,0,0,1,2
9375334,9375357,23,1,0,0,2
9375337,9375352,15,1,0,0,1
9375353,9375616,263,0,0,1,1
9375358,9375618,260,0,0,1,2
9375617,9375756,139,1,0,0,1
9375619,9375753,134,1,0,0,2
9375754,9375879,125,0,0,1,2
9375757,9375879,122,0,0,1,1
9375880,9375904,24,1,0,0,1
9375880,9375904,24,1,0,0,2
9375905,9375956,51,0,0,1,2
9375905,9375958,53,0,0,1,1
9375957,9375974,17,1,0,0,2
9375959,9375975,16,1,0,0,1
9375975,9376129,154,0,0,1,2
9375976,9376123,147,0,0,1,1
9376124,9376143,19,1,0,0,1
9376130,9376141,11,1,0,0,2
9376142,9376574,432,0,0,1,2
9376144,9376348,204,0,0,1,1
9376349,9376353,4,1,0,0,1
9376354,9376569,215,0,0,1,1
9376570,9376589,19,1,0,0,1
9376575,9376583,8,1,0,0,2
9376584,9377072,488,0,0,1,2
9376590,9377069,479,0,0,1,1
9377070,9377090,20,1,0,0,1
9377073,9377085,12,1,0,0,2
9377086,9378426,1340,0,0,1,2
9377091,9378425,1334,0,0,1,1
9378426,9378469,43,1,0,0,1
9378427,9378460,33,1,0,0,2
9378461,9378891,430,0,0,1,2
9378470,9378889,419,0,0,1,1
9378890,9378913,23,1,0,0,1
9378892,9378912,20,1,0,0,2
9378913,9380554,1641,0,0,1,2
9378914,9380530,1616,0,0,1,1
9380531,9380799,268,1,0,0,1
9380555,9380807,252,1,0,0,2
9380590,9380756,166,0,1,0,2
9380594,9380752,158,0,1,0,1
9380800,9380880,80,0,0,1,1
9380808,9380879,71,0,0,1,2
9380880,9381121,241,1,0,0,2
9380881,9381098,217,1,0,0,1
9380897,9381075,178,0,1,0,2
9380899,9381075,176,0,1,0,1
9381099,9382274,1175,0,0,1,1
9381122,9382276,1154,0,0,1,2
9382275,9382349,74,1,0,0,1
9382277,9382360,83,1,0,0,2
9382350,9382427,77,0,0,1,1
9382361,9382427,66,0,0,1,2
9382428,9382453,25,1,0,0,2
9382428,9382464,36,1,0,0,1
9382454,9384589,2135,0,0,1,2
9382465,9384585,2120,0,0,1,1
9384586,9384605,19,1,0,0,1
9384590,9384605,15,1,0,0,2
9384606,9385231,625,0,0,1,2
9384606,9385232,626,0,0,1,1
9385232,9385283,51,1,0,0,2
9385233,9385267,34,1,0,0,1
9385268,9385388,120,0,0,1,1
9385284,9385384,100,0,0,1,2
9385385,9385406,21,1,0,0,2
9385389,9385405,16,1,0,0,1
9385406,9385586,180,0,0,1,1
9385407,9385584,177,0,0,1,2
9385585,9385604,19,1,0,0,2
9385587,9385603,16,1,0,0,1
9385604,9385764,160,0,0,1,1
9385605,9387398,1793,0,0,1,2
9385765,9385771,6,1,0,0,1
9385772,9387396,1624,0,0,1,1
9387397,9387895,498,1,0,0,1
9387399,9387926,527,1,0,0,2
9387442,9387884,442,0,1,0,1
9387443,9387886,443,0,1,0,2
9387896,9388468,572,0,0,1,1
9387927,9388470,543,0,0,1,2
9388469,9388491,22,1,0,0,1
9388471,9388488,17,1,0,0,2
9388489,9388651,162,0,0,1,2
9388492,9388655,163,0,0,1,1
9388652,9388673,21,1,0,0,2
9388656,9388668,12,1,0,0,1
9388669,9389012,343,0,0,1,1
9388674,9389012,338,0,0,1,2
9389013,9389118,105,1,0,0,1
9389013,9389119,106,1,0,0,2
9389119,9389182,63,0,0,1,1
9389120,9389259,139,0,0,1,2
9389183,9389192,9,1,0,0,1
9389193,9389341,148,0,0,1,1
9389260,9389265,5,1,0,0,2
9389266,9389341,75,0,0,1,2
9389342,9389360,18,1,0,0,1
9389342,9389360,18,1,0,0,2
9389361,9389517,156,0,0,1,2
9389361,9389520,159,0,0,1,1
9389518,9389535,17,1,0,0,2
9389521,9389529,8,1,0,0,1
9389530,9389667,137,0,0,1,1
9389536,9389665,129,0,0,1,2
9389666,9389673,7,1,0,0,2
9389668,9389672,4,1,0,0,1
9389673,9389810,137,0,0,1,1
9389674,9389942,268,0,0,1,2
9389811,9389816,5,1,0,0,1
9389817,9389942,125,0,0,1,1
9389943,9389948,5,1,0,0,2
9389943,9389951,8,1,0,0,1
9389949,9390188,239,0,0,1,2
9389952,9390186,234,0,0,1,1
9390187,9390207,20,1,0,0,1
9390189,9390207,18,1,0,0,2
9390208,9390622,414,0,0,1,1
9390208,9390624,416,0,0,1,2
9390623,9390642,19,1,0,0,1
9390625,9390642,17,1,0,0,2
9390643,9391174,531,0,0,1,2
9390643,9391175,532,0,0,1,1
9391175,9391182,7,1,0,0,2
9391176,9391186,10,1,0,0,1
9391183,9391256,73,0,0,1,2
9391187,9391254,67,0,0,1,1
9391255,9391278,23,1,0,0,1
9391257,9391277,20,1,0,0,2
9391278,9391564,286,0,0,1,2
9391279,9391563,284,0,0,1,1
9391564,9391600,36,1,0,0,1
9391565,9391597,32,1,0,0,2
9391598,9392422,824,0,0,1,2
9391601,9392422,821,0,0,1,1
9392423,9392471,48,1,0,0,2
9392423,9392480,57,1,0,0,1
9392472,9393040,568,0,0,1,2
9392481,9393037,556,0,0,1,1
9393038,9393264,226,1,0,0,1
9393041,9393216,175,1,0,0,2
9393060,9393195,135,0,1,0,1
9393061,9393185,124,0,1,0,2
9393217,9393491,274,0,0,1,2
9393265,9393487,222,0,0,1,1
9393488,9393510,22,1,0,0,1
9393492,9393510,18,1,0,0,2
9393511,9394596,1085,0,0,1,2
9393511,9394600,1089,0,0,1,1
9394597,9394975,378,1,0,0,2
9394601,9395002,401,1,0,0,1
9394627,9394991,364,0,1,0,1
9394630,9394964,334,0,1,0,2
9394976,9395092,116,0,0,1,2
9395003,9395092,89,0,0,1,1
9395093,9395342,249,1,0,0,1
9395093,9395343,250,1,0,0,2
9395107,9395322,215,0,1,0,1
9395110,9395304,194,0,1,0,2
9395343,9395689,346,0,0,1,1
9395344,9395687,343,0,0,1,2
9395688,9395906,218,1,0,0,2
9395690,9395914,224,1,0,0,1
9395704,9395895,191,0,1,0,1
9395708,9395872,164,0,1,0,2
9395907,9396496,589,0,0,1,2
9395915,9396495,580,0,0,1,1
9396496,9396560,64,1,0,0,1
9396497,9396561,64,1,0,0,2
9396561,9396601,40,0,0,1,1
9396562,9396605,43,0,0,1,2
9396602,9396794,192,1,0,0,1
9396606,9396771,165,1,0,0,2
9396621,9396745,124,0,1,0,1
9396623,9396738,115,0,1,0,2
9396772,9396871,99,0,0,1,2
9396795,9396871,76,0,0,1,1
9396872,9396894,22,1,0,0,1
9396872,9396898,26,1,0,0,2
9396895,9397116,221,0,0,1,1
9396899,9397114,215,0,0,1,2
9397115,9397134,19,1,0,0,2
9397117,9397138,21,1,0,0,1
9397135,9399407,2272,0,0,1,2
9397139,9399407,2268,0,0,1,1
9399408,9399466,58,1,0,0,2
9399408,9399468,60,1,0,0,1
9399467,9399513,46,0,0,1,2
9399469,9399505,36,0,0,1,1
9399506,9399697,191,1,0,0,1
9399514,9399683,169,1,0,0,2
9399532,9399638,106,0,1,0,1
9399536,9399639,103,0,1,0,2
9399684,9399886,202,0,0,1,2
9399698,9399885,187,0,0,1,1
9399886,9399917,31,1,0,0,1
9399887,9399916,29,1,0,0,2
9399917,9401646,1729,0,0,1,2
9399918,9401641,1723,0,0,1,1
9401642,9401916,274,1,0,0,1
9401647,9401934,287,1,0,0,2
9401669,9401889,220,0,1,0,1
9401670,9401891,221,0,1,0,2
9401917,9402305,388,0,0,1,1
9401935,9402307,372,0,0,1,2
9402306,9402334,28,1,0,0,1
9402308,9402340,32,1,0,0,2
9402335,9402452,117,0,0,1,1
9402341,9402456,115,0,0,1,2
9402453,9402678,225,1,0,0,1
9402457,9402669,212,1,0,0,2
9402470,9402635,165,0,1,0,1
9402474,9402628,154,0,1,0,2
9402670,9403257,587,0,0,1,2
9402679,9403257,578,0,0,1,1
9403258,9403320,62,1,0,0,2
9403258,9403321,63,1,0,0,1
9403321,9403526,205,0,0,1,2
9403322,9403525,203,0,0,1,1
9403526,9403598,72,1,0,0,1
9403527,9403601,74,1,0,0,2
9403599,9403695,96,0,0,1,1
9403602,9403696,94,0,0,1,2
9403696,9403733,37,1,0,0,1
9403697,9403731,34,1,0,0,2
9403732,9403920,188,0,0,1,2
9403734,9404039,305,0,0,1,1
9403921,9403930,9,1,0,0,2
9403931,9404045,114,0,0,1,2
9404040,9404327,287,1,0,0,1
9404046,9404298,252,1,0,0,2
9404063,9404292,229,0,1,0,1
9404064,9404271,207,0,1,0,2
9404299,9404393,94,0,0,1,2
9404328,9404396,68,0,0,1,1
9404394,9404424,30,1,0,0,2
9404397,9404429,32,1,0,0,1
9404425,9406420,1995,0,0,1,2
9404430,9405575,1145,0,0,1,1
9405576,9405591,15,1,0,0,1
9405592,9406421,829,0,0,1,1
9406421,9406458,37,1,0,0,2
9406422,9406454,32,1,0,0,1
9406455,9406608,153,0,0,1,1
9406459,9406607,148,0,0,1,2
9406608,9406639,31,1,0,0,2
9406609,9406630,21,1,0,0,1
9406631,9407233,602,0,0,1,1
9406640,9407236,596,0,0,1,2
9407234,9407253,19,1,0,0,1
9407237,9407253,16,1,0,0,2
9407254,9407518,264,0,0,1,2
9407254,9407520,266,0,0,1,1
9407519,9407538,19,1,0,0,2
9407521,9407538,17,1,0,0,1
9407539,9407693,154,0,0,1,1
9407539,9407694,155,0,0,1,2
9407694,9407720,26,1,0,0,1
9407695,9407712,17,1,0,0,2
9407713,9408463,750,0,0,1,2
9407721,9408464,743,0,0,1,1
9408464,9408845,381,1,0,0,2
9408465,9408858,393,1,0,0,1
9408486,9408847,361,0,1,0,1
9408488,9408835,347,0,1,0,2
9408846,9408878,32,0,0,1,2
9408859,9409089,230,0,0,1,1
9408879,9408893,14,1,0,0,2
9408894,9409091,197,0,0,1,2
9409090,9409117,27,1,0,0,1
9409092,9409115,23,1,0,0,2
9409116,9409773,657,0,0,1,2
9409118,9409772,654,0,0,1,1
9409773,9409819,46,1,0,0,1
9409774,9409817,43,1,0,0,2
9409818,9410352,534,0,0,1,2
9409820,9410354,534,0,0,1,1
9410353,9410406,53,1,0,0,2
9410355,9410398,43,1,0,0,1
9410399,9410533,134,0,0,1,1
9410407,9410533,126,0,0,1,2
9410534,9410552,18,1,0,0,2
9410534,9410553,19,1,0,0,1
9410553,9410756,203,0,0,1,2
9410554,9410756,202,0,0,1,1
9410757,9410775,18,1,0,0,1
9410757,9410775,18,1,0,0,2
9410776,9410903,127,0,0,1,1
9410776,9411119,343,0,0,1,2
9410904,9410909,5,1,0,0,1
9410910,9411120,210,0,0,1,1
9411120,9411130,10,1,0,0,2
9411121,9411127,6,1,0,0,1
9411128,9411320,192,0,0,1,1
9411131,9411521,390,0,0,1,2
9411321,9411325,4,1,0,0,1
9411326,9411517,191,0,0,1,1
9411518,9411530,12,1,0,0,1
9411522,9411534,12,1,0,0,2
9411531,9411922,391,0,0,1,1
9411535,9411741,206,0,0,1,2
9411742,9411767,25,1,0,0,2
9411768,9411923,155,0,0,1,2
9411923,9411955,32,1,0,0,1
9411924,9411943,19,1,0,0,2
9411944,9412250,306,0,0,1,2
9411956,9412250,294,0,0,1,1
9412251,9412282,31,1,0,0,1
9412251,9412283,32,1,0,0,2
9412283,9412424,141,0,0,1,1
9412284,9412424,140,0,0,1,2
9412425,9412443,18,1,0,0,1
9412425,9412443,18,1,0,0,2
9412444,9412935,491,0,0,1,1
9412444,9412936,492,0,0,1,2
9412936,9412976,40,1,0,0,1
9412937,9412984,47,1,0,0,2
9412977,9413082,105,0,0,1,1
9412985,9413083,98,0,0,1,2
9413083,9413245,162,1,0,0,1
9413084,9413245,161,1,0,0,2
9413103,9413208,105,0,1,0,2
9413106,9413196,90,0,1,0,1
9413246,9413403,157,0,0,1,1
9413246,9413403,157,0,0,1,2
9413404,9413423,19,1,0,0,1
9413404,9413426,22,1,0,0,2
9413424,9415022,1598,0,0,1,1
9413427,9415018,1591,0,0,1,2
9415019,9415253,234,1,0,0,2
9415023,9415249,226,1,0,0,1
9415040,9415222,182,0,1,0,2
9415043,9415215,172,0,1,0,1
9415250,9415283,33,0,0,1,1
9415254,9415282,28,0,0,1,2
9415283,9415563,280,1,0,0,2
9415284,9415549,265,1,0,0,1
9415300,9415528,228,0,1,0,2
9415301,9415526,225,0,1,0,1
9415550,9416223,673,0,0,1,1
9415564,9416224,660,0,0,1,2
9416224,9416293,69,1,0,0,1
9416225,9416296,71,1,0,0,2
9416294,9416431,137,0,0,1,1
9416297,9416433,136,0,0,1,2
9416432,9416465,33,1,0,0,1
9416434,9416463,29,1,0,0,2
9416464,9416710,246,0,0,1,2
9416466,9416710,244,0,0,1,1
9416711,9416727,16,1,0,0,1
9416711,9416732,21,1,0,0,2
9416728,9417307,579,0,0,1,1
9416733,9417312,579,0,0,1,2
9417308,9417436,128,1,0,0,1
9417313,9417423,110,1,0,0,2
9417424,9419030,1606,0,0,1,2
9417437,9419031,1594,0,0,1,1
9419031,9419211,180,1,0,0,2
9419032,9419214,182,1,0,0,1
9419057,9419172,115,0,1,0,2
9419058,9419171,113,0,1,0,1
9419212,9419291,79,0,0,1,2
9419215,9419293,78,0,0,1,1
9419292,9419321,29,1,0,0,2
9419294,9419320,26,1,0,0,1
9419321,9419473,152,0,0,1,1
9419322,9419473,151,0,0,1,2
9419474,9419497,23,1,0,0,2
9419474,9419506,32,1,0,0,1
9419498,9420105,607,0,0,1,2
9419507,9420104,597,0,0,1,1
9420105,9420117,12,1,0,0,1
9420106,9420110,4,1,0,0,2
9420111,9421074,963,0,0,1,2
9420118,9421077,959,0,0,1,1
9421075,9421350,275,1,0,0,2
9421078,9421337,259,1,0,0,1
9421131,9421303,172,0,1,0,2
9421138,9421294,156,0,1,0,1
9421338,9422804,1466,0,0,1,1
9421351,9422803,1452,0,0,1,2
9422804,9422883,79,1,0,0,2
9422805,9422887,82,1,0,0,1
9422884,9422940,56,0,0,1,2
9422888,9422939,51,0,0,1,1
9422940,9422977,37,1,0,0,1
9422941,9422968,27,1,0,0,2
9422969,9423163,194,0,0,1,2
9422978,9423162,184,0,0,1,1
9423163,9423189,26,1,0,0,1
9423164,9423181,17,1,0,0,2
9423182,9423326,144,0,0,1,2
9423190,9423332,142,0,0,1,1
9423327,9423567,240,1,0,0,2
9423333,9423528,195,1,0,0,1
9423350,9423505,155,0,1,0,1
9423352,9423514,162,0,1,0,2
9423529,9423667,138,0,0,1,1
9423568,9423666,98,0,0,1,2
9423667,9423688,21,1,0,0,2
9423668,9423698,30,1,0,0,1
9423689,9424873,1184,0,0,1,2
9423699,9424872,1173,0,0,1,1
9424873,9424936,63,1,0,0,1
9424874,9424928,54,1,0,0,2
9424929,9425095,166,0,0,1,2
9424937,9425094,157,0,0,1,1
9425095,9425118,23,1,0,0,1
9425096,9425117,21,1,0,0,2
9425118,9425377,259,0,0,1,2
9425119,9425377,258,0,0,1,1
9425378,9425395,17,1,0,0,1
9425378,9425397,19,1,0,0,2
9425396,9425609,213,0,0,1,1
9425398,9425610,212,0,0,1,2
9425610,9425628,18,1,0,0,1
9425611,9425628,17,1,0,0,2
9425629,9425919,290,0,0,1,2
9425629,9427000,1371,0,0,1,1
9425920,9425933,13,1,0,0,2
9425934,9426998,1064,0,0,1,2
9426999,9427300,301,1,0,0,2
9427001,9427288,287,1,0,0,1
9427019,9427258,239,0,1,0,2
9427024,9427256,232,0,1,0,1
9427289,9427362,73,0,0,1,1
9427301,9427363,62,0,0,1,2
9427363,9427383,20,1,0,0,1
9427364,9427384,20,1,0,0,2
9427384,9427555,171,0,0,1,1
9427385,9427565,180,0,0,1,2
9427556,9427571,15,1,0,0,1
9427566,9427571,5,1,0,0,2
9427572,9427733,161,0,0,1,1
9427572,9427733,161,0,0,1,2
9427734,9427753,19,1,0,0,2
9427734,9427756,22,1,0,0,1
9427754,9427937,183,0,0,1,2
9427757,9427934,177,0,0,1,1
9427935,9427954,19,1,0,0,1
9427938,9427953,15,1,0,0,2
9427954,9428315,361,0,0,1,2
9427955,9428316,361,0,0,1,1
9428316,9428406,90,1,0,0,2
9428317,9428397,80,1,0,0,1
9428398,9428509,111,0,0,1,1
9428407,9428509,102,0,0,1,2
9428510,9428542,32,1,0,0,1
9428510,9428545,35,1,0,0,2
9428543,9428690,147,0,0,1,1
9428546,9428694,148,0,0,1,2
9428691,9428709,18,1,0,0,1
9428695,9428708,13,1,0,0,2
9428709,9428897,188,0,0,1,2
9428710,9428898,188,0,0,1,1
9428898,9428920,22,1,0,0,2
9428899,9428922,23,1,0,0,1
9428921,9430422,1501,0,0,1,2
9428923,9429121,198,0,0,1,1
9429122,9429128,6,1,0,0,1
9429129,9430422,1293,0,0,1,1
9430423,9430472,49,1,0,0,2
9430423,9430487,64,1,0,0,1
9430473,9430598,125,0,0,1,2
9430488,9430594,106,0,0,1,1
9430595,9430619,24,1,0,0,1
9430599,9430615,16,1,0,0,2
9430616,9430835,219,0,0,1,2
9430620,9430835,215,0,0,1,1
9430836,9430857,21,1,0,0,2
9430836,9430859,23,1,0,0,1
9430858,9431176,318,0,0,1,2
9430860,9432487,1627,0,0,1,1
9431177,9431191,14,1,0,0,2
9431192,9432489,1297,0,0,1,2
9432488,9432506,18,1,0,0,1
9432490,9432886,396,1,0,0,2
9432507,9432530,23,0,0,1,1
9432531,9432885,354,1,0,0,1
9432551,9432824,273,0,1,0,2
9432562,9432813,251,0,1,0,1
9432886,9433066,180,0,0,1,1
9432887,9433072,185,0,0,1,2
9433067,9433091,24,1,0,0,1
9433073,9433092,19,1,0,0,2
9433092,9433234,142,0,0,1,1
9433093,9433232,139,0,0,1,2
9433233,9433250,17,1,0,0,2
9433235,9433255,20,1,0,0,1
9433251,9433413,162,0,0,1,2
9433256,9433410,154,0,0,1,1
9433411,9433423,12,1,0,0,1
9433414,9433419,5,1,0,0,2
9433420,9433899,479,0,0,1,2
9433424,9433904,480,0,0,1,1
9433900,9433918,18,1,0,0,2
9433905,9433915,10,1,0,0,1
9433916,9434125,209,0,0,1,1
9433919,9434127,208,0,0,1,2
9434126,9434219,93,1,0,0,1
9434128,9434219,91,1,0,0,2
9434220,9434344,124,0,0,1,2
9434220,9434347,127,0,0,1,1
9434345,9434373,28,1,0,0,2
9434348,9434372,24,1,0,0,1
9434373,9434510,137,0,0,1,1
9434374,9434512,138,0,0,1,2
9434511,9434523,12,1,0,0,1
9434513,9434519,6,1,0,0,2
9434520,9434835,315,0,0,1,2
9434524,9434698,174,0,0,1,1
9434699,9434706,7,1,0,0,1
9434707,9434832,125,0,0,1,1
9434833,9434845,12,1,0,0,1
9434836,9434847,11,1,0,0,2
9434846,9435055,209,0,0,1,1
9434848,9435056,208,0,0,1,2
9435056,9435069,13,1,0,0,1
9435057,9435070,13,1,0,0,2
9435070,9435679,609,0,0,1,1
9435071,9435676,605,0,0,1,2
9435677,9435695,18,1,0,0,2
9435680,9435695,15,1,0,0,1
9435696,9435782,86,0,0,1,1
9435696,9435783,87,0,0,1,2
9435783,9435800,17,1,0,0,1
9435784,9435797,13,1,0,0,2
9435798,9436963,1165,0,0,1,2
9435801,9436960,1159,0,0,1,1
9436961,9437169,208,1,0,0,1
9436964,9437162,198,1,0,0,2
9437020,9437134,114,0,1,0,2
9437020,9437135,115,0,1,0,1
9437163,9437203,40,0,0,1,2
9437170,9437202,32,0,0,1,1
9437203,9437228,25,1,0,0,1
9437204,9437230,26,1,0,0,2
9437229,9437344,115,0,0,1,1
9437231,9437344,113,0,0,1,2
9437345,9437369,24,1,0,0,2
9437345,9437380,35,1,0,0,1
9437370,9438440,1070,0,0,1,2
9437381,9438438,1057,0,0,1,1
9438439,9438461,22,1,0,0,1
9438441,9438461,20,1,0,0,2
9438462,9438826,364,0,0,1,2
9438462,9438828,366,0,0,1,1
9438827,9438858,31,1,0,0,2
9438829,9438850,21,1,0,0,1
9438851,9439102,251,0,0,1,1
9438859,9439100,241,0,0,1,2
9439101,9439252,151,1,0,0,2
9439103,9439243,140,1,0,0,1
9439244,9439303,59,0,0,1,1
9439253,9439300,47,0,0,1,2
9439301,9439327,26,1,0,0,2
9439304,9439322,18,1,0,0,1
9439323,9439429,106,0,0,1,1
9439328,9439645,317,0,0,1,2
9439430,9439435,5,1,0,0,1
9439436,9439643,207,0,0,1,1
9439644,9439654,10,1,0,0,1
9439646,9439654,8,1,0,0,2
9439655,9440049,394,0,0,1,1
9439655,9440051,396,0,0,1,2
9440050,9440076,26,1,0,0,1
9440052,9440076,24,1,0,0,2
9440077,9440193,116,0,0,1,1
9440077,9440198,121,0,0,1,2
9440194,9440217,23,1,0,0,1
9440199,9440214,15,1,0,0,2
9440215,9440437,222,0,0,1,2
9440218,9440434,216,0,0,1,1
9440435,9440457,22,1,0,0,1
9440438,9440456,18,1,0,0,2
9440457,9440618,161,0,0,1,2
9440458,9440614,156,0,0,1,1
9440615,9440630,15,1,0,0,1
9440619,9440631,12,1,0,0,2
9440631,9440728,97,0,0,1,1
9440632,9440726,94,0,0,1,2
9440727,9440823,96,1,0,0,2
9440729,9440844,115,1,0,0,1
9440824,9440941,117,0,0,1,2
9440845,9440945,100,0,0,1,1
9440942,9440967,25,1,0,0,2
9440946,9440986,40,1,0,0,1
9440968,9441253,285,0,0,1,2
9440987,9441096,109,0,0,1,1
9441097,9441102,5,1,0,0,1
9441103,9441249,146,0,0,1,1
9441250,9441269,19,1,0,0,1
9441254,9441263,9,1,0,0,2
9441264,9441390,126,0,0,1,2
9441270,9441392,122,0,0,1,1
9441391,9441843,452,1,0,0,2
9441393,9441400,7,1,0,0,1
9441401,9441426,25,0,0,1,1
9441427,9441846,419,1,0,0,1
9441462,9441832,370,0,1,0,2
9441466,9441835,369,0,1,0,1
9441844,9441990,146,0,0,1,2
9441847,9441981,134,0,0,1,1
9441982,9441997,15,1,0,0,1
9441991,9441996,5,1,0,0,2
9441997,9442393,396,0,0,1,2
9441998,9442399,401,0,0,1,1
9442394,9442401,7,1,0,0,2
9442400,9442410,10,1,0,0,1
9442402,9442576,174,0,0,1,2
9442411,9442571,160,0,0,1,1
9442572,9442588,16,1,0,0,1
9442577,9442589,12,1,0,0,2
9442589,9443013,424,0,0,1,1
9442590,9443013,423,0,0,1,2
9443014,9443031,17,1,0,0,2
9443014,9443032,18,1,0,0,1
9443032,9443177,145,0,0,1,2
9443033,9443177,144,0,0,1,1
9443178,9443195,17,1,0,0,2
9443178,9443197,19,1,0,0,1
9443196,9444023,827,0,0,1,2
9443198,9444022,824,0,0,1,1
9444023,9444082,59,1,0,0,1
9444024,9444091,67,1,0,0,2
9444083,9444280,197,0,0,1,1
9444092,9444282,190,0,0,1,2
9444281,9444312,31,1,0,0,1
9444283,9444305,22,1,0,0,2
9444306,9446055,1749,0,0,1,2
9444313,9446061,1748,0,0,1,1
9446056,9446390,334,1,0,0,2
9446062,9446332,270,1,0,0,1
9446091,9446297,206,0,1,0,2
9446093,9446305,212,0,1,0,1
9446333,9446366,33,0,0,1,1
9446367,9446389,22,1,0,0,1
9446390,9446717,327,0,0,1,1
9446391,9446717,326,0,0,1,2
9446718,9446744,26,1,0,0,2
9446718,9446756,38,1,0,0,1
9446745,9446818,73,0,0,1,2
9446757,9446819,62,0,0,1,1
9446819,9447052,233,1,0,0,2
9446820,9447034,214,1,0,0,1
9446834,9447012,178,0,1,0,1
9446834,9447013,179,0,1,0,2
9447035,9447363,328,0,0,1,1
9447053,9447364,311,0,0,1,2
9447364,9447443,79,1,0,0,1
9447365,9447443,78,1,0,0,2
9447444,9447518,74,0,0,1,1
9447444,9447519,75,0,0,1,2
9447519,9447545,26,1,0,0,1
9447520,9447559,39,1,0,0,2
9447546,9447831,285,0,0,1,1
9447560,9447827,267,0,0,1,2
9447828,9447846,18,1,0,0,2
9447832,9447844,12,1,0,0,1
9447845,9448940,1095,0,0,1,1
9447847,9448933,1086,0,0,1,2
9448934,9449215,281,1,0,0,2
9448941,9449186,245,1,0,0,1
9448962,9449183,221,0,1,0,2
9448965,9449161,196,0,1,0,1
9449187,9450141,954,0,0,1,1
9449216,9450141,925,0,0,1,2
9450142,9450205,63,1,0,0,1
9450142,9450205,63,1,0,0,2
9450206,9450338,132,0,0,1,1
9450206,9450338,132,0,0,1,2
9450339,9450364,25,1,0,0,1
9450339,9450373,34,1,0,0,2
9450365,9450587,222,0,0,1,1
9450374,9450584,210,0,0,1,2
9450585,9450594,9,1,0,0,2
9450588,9450598,10,1,0,0,1
9450595,9452187,1592,0,0,1,2
9450599,9452186,1587,0,0,1,1
9452187,9452496,309,1,0,0,1
9452188,9452554,366,1,0,0,2
9452312,9452478,166,0,1,0,1
9452312,9452489,177,0,1,0,2
9452497,9452751,254,0,0,1,1
9452555,9452581,26,0,0,1,2
9452582,9452594,12,1,0,0,2
9452595,9452750,155,0,0,1,2
9452751,9452770,19,1,0,0,2
9452752,9452778,26,1,0,0,1
9452771,9453019,248,0,0,1,2
9452779,9453019,240,0,0,1,1
9453020,9453048,28,1,0,0,1
9453020,9453051,31,1,0,0,2
9453049,9453185,136,0,0,1,1
9453052,9453189,137,0,0,1,2
9453186,9453211,25,1,0,0,1
9453190,9453204,14,1,0,0,2
9453205,9453564,359,0,0,1,2
9453212,9453558,346,0,0,1,1
9453559,9453582,23,1,0,0,1
9453565,9453583,18,1,0,0,2
9453583,9454053,470,0,0,1,1
9453584,9454051,467,0,0,1,2
9454052,9454138,86,1,0,0,2
9454054,9454141,87,1,0,0,1
9454139,9454405,266,0,0,1,2
9454142,9454404,262,0,0,1,1
9454405,9454420,15,1,0,0,1
9454406,9454416,10,1,0,0,2
9454417,9454826,409,0,0,1,2
9454421,9454829,408,0,0,1,1
9454827,9455102,275,1,0,0,2
9454830,9455096,266,1,0,0,1
9454867,9455067,200,0,1,0,1
9454870,9455062,192,0,1,0,2
9455097,9455318,221,0,0,1,1
9455103,9455318,215,0,0,1,2
9455319,9455357,38,1,0,0,2
9455319,9455359,40,1,0,0,1
9455358,9455538,180,0,0,1,2
9455360,9455541,181,0,0,1,1
9455539,9455550,11,1,0,0,2
9455542,9455551,9,1,0,0,1
9455551,9455742,191,0,0,1,2
9455552,9455741,189,0,0,1,1
9455742,9455759,17,1,0,0,1
9455743,9455757,14,1,0,0,2
9455758,9457096,1338,0,0,1,2
9455760,9457097,1337,0,0,1,1
9457097,9457151,54,1,0,0,2
9457098,9457153,55,1,0,0,1
9457152,9457306,154,0,0,1,2
9457154,9457306,152,0,0,1,1
9457307,9457340,33,1,0,0,1
9457307,9457344,37,1,0,0,2
9457341,9457476,135,0,0,1,1
9457345,9457480,135,0,0,1,2
9457477,9457646,169,1,0,0,1
9457481,9457683,202,1,0,0,2
9457505,9457616,111,0,1,0,2
9457513,9457593,80,0,1,0,1
9457647,9457886,239,0,0,1,1
9457684,9457884,200,0,0,1,2
9457885,9457953,68,1,0,0,2
9457887,9457909,22,1,0,0,1
9457910,9459188,1278,0,0,1,1
9457954,9457975,21,0,0,1,2
9457976,9458006,30,1,0,0,2
9458007,9458074,67,0,0,1,2
9458075,9458098,23,1,0,0,2
9458099,9458175,76,0,0,1,2
9458176,9458214,38,1,0,0,2
9458215,9458241,26,0,0,1,2
9458242,9458337,95,1,0,0,2
9458338,9459189,851,0,0,1,2
9459189,9459644,455,1,0,0,1
9459190,9459644,454,1,0,0,2
9459230,9459600,370,0,1,0,2
9459234,9459603,369,0,1,0,1
9459645,9460018,373,0,0,1,1
9459645,9460019,374,0,0,1,2
9460019,9460050,31,1,0,0,1
9460020,9460046,26,1,0,0,2
9460047,9460760,713,0,0,1,2
9460051,9460758,707,0,0,1,1
9460759,9460807,48,1,0,0,1
9460761,9460829,68,1,0,0,2
9460808,9460976,168,0,0,1,1
9460830,9460976,146,0,0,1,2
9460977,9461006,29,1,0,0,2
9460977,9461008,31,1,0,0,1
9461007,9461326,319,0,0,1,2
9461009,9462243,1234,0,0,1,1
9461327,9461340,13,1,0,0,2
9461341,9462246,905,0,0,1,2
9462244,9462503,259,1,0,0,1
9462247,9462472,225,1,0,0,2
9462263,9462442,179,0,1,0,2
9462265,9462443,178,0,1,0,1
9462473,9463028,555,0,0,1,2
9462504,9463029,525,0,0,1,1
9463029,9463073,44,1,0,0,2
9463030,9463084,54,1,0,0,1
9463074,9463240,166,0,0,1,2
9463085,9463240,155,0,0,1,1
9463241,9463246,5,1,0,0,1
9463241,9463251,10,1,0,0,2
9463247,9463407,160,0,0,1,1
9463252,9463406,154,0,0,1,2
9463407,9463422,15,1,0,0,2
9463408,9463423,15,1,0,0,1
9463423,9463654,231,0,0,1,2
9463424,9463656,232,0,0,1,1
9463655,9463667,12,1,0,0,2
9463657,9463668,11,1,0,0,1
9463668,9464582,914,0,0,1,2
9463669,9464583,914,0,0,1,1
9464583,9464594,11,1,0,0,2
9464584,9464592,8,1,0,0,1
9464593,9465179,586,0,0,1,1
9464595,9465178,583,0,0,1,2
9465179,9465196,17,1,0,0,2
9465180,9465188,8,1,0,0,1
9465189,9465229,40,0,0,1,1
9465197,9465225,28,0,0,1,2
9465226,9465858,632,1,0,0,2
9465230,9465888,658,1,0,0,1
9465261,9465847,586,0,1,0,2
9465265,9465850,585,0,1,0,1
9465859,9467189,1330,0,0,1,2
9465889,9467188,1299,0,0,1,1
9467189,9467255,66,1,0,0,1
9467190,9467270,80,1,0,0,2
9467256,9467464,208,0,0,1,1
9467271,9467464,193,0,0,1,2
9467465,9467493,28,1,0,0,1
9467465,9467498,33,1,0,0,2
9467494,9467601,107,0,0,1,1
9467499,9467599,100,0,0,1,2
9467600,9467632,32,1,0,0,2
9467602,9467627,25,1,0,0,1
9467628,9467816,188,0,0,1,1
9467633,9467816,183,0,0,1,2
9467817,9467847,30,1,0,0,2
9467817,9467848,31,1,0,0,1
9467848,9469819,1971,0,0,1,2
9467849,9469124,1275,0,0,1,1
9469125,9469137,12,1,0,0,1
9469138,9469820,682,0,0,1,1
9469820,9470008,188,1,0,0,2
9469821,9470011,190,1,0,0,1
9469864,9469976,112,0,1,0,2
9469866,9469969,103,0,1,0,1
9470009,9470930,921,0,0,1,2
9470012,9470929,917,0,0,1,1
9470930,9470952,22,1,0,0,1
9470931,9470952,21,1,0,0,2
9470953,9471140,187,0,0,1,1
9470953,9471140,187,0,0,1,2
9471141,9471161,20,1,0,0,1
9471141,9471162,21,1,0,0,2
9471162,9471906,744,0,0,1,1
9471163,9471917,754,0,0,1,2
9471907,9472311,404,1,0,0,1
9471918,9472264,346,1,0,0,2
9471943,9472232,289,0,1,0,2
9471947,9472281,334,0,1,0,1
9472265,9472297,32,0,0,1,2
9472298,9472312,14,1,0,0,2
9472312,9472498,186,0,0,1,1
9472313,9472499,186,0,0,1,2
9472499,9472522,23,1,0,0,1
9472500,9472523,23,1,0,0,2
9472523,9472876,353,0,0,1,1
9472524,9472875,351,0,0,1,2
9472876,9473115,239,1,0,0,2
9472877,9473124,247,1,0,0,1
9472892,9473098,206,0,1,0,1
9472893,9473093,200,0,1,0,2
9473116,9473661,545,0,0,1,2
9473125,9473662,537,0,0,1,1
9473662,9473769,107,1,0,0,2
9473663,9473771,108,1,0,0,1
9473770,9473888,118,0,0,1,2
9473772,9473885,113,0,0,1,1
9473886,9473922,36,1,0,0,1
9473889,9473912,23,1,0,0,2
9473913,9474144,231,0,0,1,2
9473923,9474147,224,0,0,1,1
9474145,9474170,25,1,0,0,2
9474148,9474169,21,1,0,0,1
9474170,9476778,2608,0,0,1,1
9474171,9476778,2607,0,0,1,2
9476779,9476825,46,1,0,0,1
9476779,9476835,56,1,0,0,2
9476826,9476955,129,0,0,1,1
9476836,9476954,118,0,0,1,2
9476955,9476988,33,1,0,0,2
9476956,9476977,21,1,0,0,1
9476978,9477303,325,0,0,1,1
9476989,9477295,306,0,0,1,2
9477296,9477496,200,1,0,0,2
9477304,9477475,171,1,0,0,1
9477317,9477454,137,0,1,0,2
9477321,9477441,120,0,1,0,1
9477476,9477565,89,0,0,1,1
9477497,9477531,34,0,0,1,2
9477532,9477540,8,1,0,0,2
9477541,9477567,26,0,0,1,2
9477566,9477594,28,1,0,0,1
9477568,9477586,18,1,0,0,2
9477587,9477878,291,0,0,1,2
9477595,9477878,283,0,0,1,1
9477879,9477896,17,1,0,0,1
9477879,9477906,27,1,0,0,2
9477897,9478838,941,0,0,1,1
9477907,9478836,929,0,0,1,2
9478837,9479377,540,1,0,0,2
9478839,9479057,218,1,0,0,1
9478862,9479039,177,0,1,0,2
9478866,9479037,171,0,1,0,1
9479058,9479113,55,0,0,1,1
9479114,9479375,261,1,0,0,1
9479133,9479345,212,0,1,0,2
9479134,9479347,213,0,1,0,1
9479376,9479697,321,0,0,1,1
9479378,9479409,31,0,0,1,2
9479410,9479414,4,1,0,0,2
9479415,9479697,282,0,0,1,2
9479698,9479724,26,1,0,0,1
9479698,9479735,37,1,0,0,2
9479725,9480853,1128,0,0,1,1
9479736,9480854,1118,0,0,1,2
9480854,9480893,39,1,0,0,1
9480855,9480882,27,1,0,0,2
9480883,9481033,150,0,0,1,2
9480894,9481038,144,0,0,1,1
9481034,9481052,18,1,0,0,2
9481039,9481050,11,1,0,0,1
9481051,9482727,1676,0,0,1,1
9481053,9482728,1675,0,0,1,2
9482728,9482902,174,1,0,0,1
9482729,9482908,179,1,0,0,2
9482754,9482881,127,0,1,0,2
9482756,9482875,119,0,1,0,1
9482903,9483100,197,0,0,1,1
9482909,9483101,192,0,0,1,2
9483101,9483120,19,1,0,0,1
9483102,9483121,19,1,0,0,2
9483121,9483354,233,0,0,1,1
9483122,9483356,234,0,0,1,2
9483355,9483384,29,1,0,0,1
9483357,9483383,26,1,0,0,2
9483384,9484808,1424,0,0,1,2
9483385,9484815,1430,0,0,1,1
9484809,9485054,245,1,0,0,2
9484816,9485039,223,1,0,0,1
9484833,9484998,165,0,1,0,2
9484837,9484982,145,0,1,0,1
9485040,9485523,483,0,0,1,1
9485055,9485522,467,0,0,1,2
9485523,9485584,61,1,0,0,2
9485524,9485574,50,1,0,0,1
9485575,9486396,821,0,0,1,1
9485585,9486396,811,0,0,1,2
9486397,9486466,69,1,0,0,2
9486397,9486467,70,1,0,0,1
9486467,9486564,97,0,0,1,2
9486468,9486562,94,0,0,1,1
9486563,9486597,34,1,0,0,1
9486565,9486587,22,1,0,0,2
9486588,9486797,209,0,0,1,2
9486598,9486801,203,0,0,1,1
9486798,9486816,18,1,0,0,2
9486802,9486812,10,1,0,0,1
9486813,9488411,1598,0,0,1,1
9486817,9487399,582,0,0,1,2
9487400,9487409,9,1,0,0,2
9487410,9488412,1002,0,0,1,2
9488412,9488459,47,1,0,0,1
9488413,9488459,46,1,0,0,2
9488460,9488748,288,0,0,1,2
9488460,9489177,717,0,0,1,1
9488749,9488760,11,1,0,0,2
9488761,9489181,420,0,0,1,2
9489178,9489403,225,1,0,0,1
9489182,9489396,214,1,0,0,2
9489198,9489378,180,0,1,0,2
9489208,9489336,128,0,1,0,1
9489397,9489887,490,0,0,1,2
9489404,9489885,481,0,0,1,1
9489886,9489907,21,1,0,0,1
9489888,9489907,19,1,0,0,2
9489908,9490214,306,0,0,1,2
9489908,9490619,711,0,0,1,1
9490215,9490227,12,1,0,0,2
9490228,9490619,391,0,0,1,2
9490620,9491016,396,1,0,0,2
9490620,9491028,408,1,0,0,1
9490671,9491005,334,0,1,0,2
9490675,9491008,333,0,1,0,1
9491017,9491278,261,0,0,1,2
9491029,9491285,256,0,0,1,1
9491279,9491300,21,1,0,0,2
9491286,9491302,16,1,0,0,1
9491301,9491359,58,0,0,1,2
9491303,9491359,56,0,0,1,1
9491360,9491376,16,1,0,0,1
9491360,9491377,17,1,0,0,2
9491377,9491439,62,0,0,1,1
9491378,9491442,64,0,0,1,2
9491440,9491460,20,1,0,0,1
9491443,9491459,16,1,0,0,2
9491460,9492003,543,0,0,1,2
9491461,9492004,543,0,0,1,1
9492004,9492043,39,1,0,0,2
9492005,9492054,49,1,0,0,1
9492044,9492170,126,0,0,1,2
9492055,9492169,114,0,0,1,1
9492170,9492203,33,1,0,0,1
9492171,9492203,32,1,0,0,2
9492204,9492393,189,0,0,1,1
9492204,9492394,190,0,0,1,2
9492394,9492421,27,1,0,0,1
9492395,9492422,27,1,0,0,2
9492422,9494728,2306,0,0,1,1
9492423,9494731,2308,0,0,1,2
9494729,9494968,239,1,0,0,1
9494732,9494939,207,1,0,0,2
9494757,9494922,165,0,1,0,2
9494758,9494927,169,0,1,0,1
9494940,9495042,102,0,0,1,2
9494969,9495042,73,0,0,1,1
9495043,9495063,20,1,0,0,1
9495043,9495064,21,1,0,0,2
9495064,9495218,154,0,0,1,1
9495065,9495218,153,0,0,1,2
9495219,9495230,11,1,0,0,1
9495219,9495231,12,1,0,0,2
9495231,9497300,2069,0,0,1,1
9495232,9497299,2067,0,0,1,2
9497300,9497513,213,1,0,0,2
9497301,9497477,176,1,0,0,1
9497336,9497452,116,0,1,0,2
9497345,9497418,73,0,1,0,1
9497478,9497847,369,0,0,1,1
9497514,9497847,333,0,0,1,2
9497848,9497912,64,1,0,0,2
9497848,9497913,65,1,0,0,1
9497913,9498219,306,0,0,1,2
9497914,9498219,305,0,0,1,1
9498220,9498255,35,1,0,0,2
9498220,9498262,42,1,0,0,1
9498256,9498535,279,0,0,1,2
9498263,9498535,272,0,0,1,1
9498536,9498565,29,1,0,0,2
9498536,9498570,34,1,0,0,1
9498566,9498869,303,0,0,1,2
9498571,9498871,300,0,0,1,1
9498870,9498947,77,1,0,0,2
9498872,9498952,80,1,0,0,1
9498948,9499008,60,0,0,1,2
9498953,9499009,56,0,0,1,1
9499009,9499036,27,1,0,0,2
9499010,9499042,32,1,0,0,1
9499037,9499065,28,0,0,1,2
9499043,9499064,21,0,0,1,1
9499065,9499099,34,1,0,0,1
9499066,9499100,34,1,0,0,2
9499100,9499335,235,0,0,1,1
9499101,9499335,234,0,0,1,2
9499336,9499362,26,1,0,0,1
9499336,9499364,28,1,0,0,2
9499363,9499566,203,0,0,1,1
9499365,9500655,1290,0,0,1,2
9499567,9499572,5,1,0,0,1
9499573,9500653,1080,0,0,1,1
9500654,9500709,55,1,0,0,1
9500656,9500702,46,1,0,0,2
9500703,9502742,2039,0,0,1,2
9500710,9502741,2031,0,0,1,1
9502742,9502954,212,1,0,0,1
9502743,9502998,255,1,0,0,2
9502783,9502933,150,0,1,0,2
9502793,9502918,125,0,1,0,1
9502955,9503363,408,0,0,1,1
9502999,9503365,366,0,0,1,2
9503364,9503391,27,1,0,0,1
9503366,9503391,25,1,0,0,2
9503392,9503996,604,0,0,1,1
9503392,9503996,604,0,0,1,2
9503997,9504075,78,1,0,0,1
9503997,9504076,79,1,0,0,2
9504076,9504155,79,0,0,1,1
9504077,9504155,78,0,0,1,2
9504156,9504177,21,1,0,0,2
9504156,9504189,33,1,0,0,1
9504178,9506062,1884,0,0,1,2
9504190,9506064,1874,0,0,1,1
9506063,9506108,45,1,0,0,2
9506065,9506125,60,1,0,0,1
9506109,9506294,185,0,0,1,2
9506126,9506289,163,0,0,1,1
9506290,9506315,25,1,0,0,1
9506295,9506307,12,1,0,0,2
9506308,9506762,454,0,0,1,2
9506316,9506779,463,0,0,1,1
9506763,9506968,205,1,0,0,2
9506780,9506916,136,1,0,0,1
9506783,9506925,142,0,1,0,2
9506806,9506865,59,0,1,0,1
9506917,9507313,396,0,0,1,1
9506969,9507482,513,0,0,1,2
9507314,9507327,13,1,0,0,1
9507328,9507485,157,0,0,1,1
9507483,9507500,17,1,0,0,2
9507486,9507500,14,1,0,0,1
9507501,9508128,627,0,0,1,1
9507501,9508131,630,0,0,1,2
9508129,9508452,323,1,0,0,1
9508132,9508479,347,1,0,0,2
9508197,9508438,241,0,1,0,2
9508204,9508427,223,0,1,0,1
9508453,9508686,233,0,0,1,1
9508480,9508687,207,0,0,1,2
9508687,9508712,25,1,0,0,1
9508688,9508710,22,1,0,0,2
9508711,9508896,185,0,0,1,2
9508713,9508894,181,0,0,1,1
9508895,9508919,24,1,0,0,1
9508897,9508920,23,1,0,0,2
9508920,9509682,762,0,0,1,1
9508921,9509683,762,0,0,1,2
9509683,9509730,47,1,0,0,1
9509684,9509733,49,1,0,0,2
9509731,9509855,124,0,0,1,1
9509734,9509852,118,0,0,1,2
9509853,9509876,23,1,0,0,2
9509856,9509876,20,1,0,0,1
9509877,9510253,376,0,0,1,2
9509877,9510256,379,0,0,1,1
9510254,9510269,15,1,0,0,2
9510257,9510269,12,1,0,0,1
9510270,9510563,293,0,0,1,2
9510270,9511113,843,0,0,1,1
9510564,9510580,16,1,0,0,2
9510581,9511700,1119,0,0,1,2
9511114,9511123,9,1,0,0,1
9511124,9511706,582,0,0,1,1
9511701,9511750,49,1,0,0,2
9511707,9511751,44,1,0,0,1
9511751,9512107,356,0,0,1,2
9511752,9511884,132,0,0,1,1
9511885,9511893,8,1,0,0,1
9511894,9512119,225,0,0,1,1
9512108,9512343,235,1,0,0,2
9512120,9512351,231,1,0,0,1
9512142,9512307,165,0,1,0,2
9512150,9512283,133,0,1,0,1
9512344,9512524,180,0,0,1,2
9512352,9512523,171,0,0,1,1
9512524,9512540,16,1,0,0,1
9512525,9512538,13,1,0,0,2
9512539,9512671,132,0,0,1,2
9512541,9512674,133,0,0,1,1
9512672,9512681,9,1,0,0,2
9512675,9512685,10,1,0,0,1
9512682,9512972,290,0,0,1,2
9512686,9513890,1204,0,0,1,1
9512973,9512978,5,1,0,0,2
9512979,9513892,913,0,0,1,2
9513891,9514188,297,1,0,0,1
9513893,9514182,289,1,0,0,2
9513930,9514131,201,0,1,0,2
9513936,9514133,197,0,1,0,1
9514183,9514846,663,0,0,1,2
9514189,9514842,653,0,0,1,1
9514843,9514869,26,1,0,0,1
9514847,9514864,17,1,0,0,2
9514865,9515402,537,0,0,1,2
9514870,9515404,534,0,0,1,1
9515403,9515479,76,1,0,0,2
9515405,9515479,74,1,0,0,1
9515480,9515581,101,0,0,1,1
9515480,9515581,101,0,0,1,2
9515582,9515607,25,1,0,0,1
9515582,9515612,30,1,0,0,2
9515608,9515752,144,0,0,1,1
9515613,9516075,462,0,0,1,2
9515753,9515773,20,1,0,0,1
9515774,9516082,308,0,0,1,1
9516076,9516368,292,1,0,0,2
9516083,9516345,262,1,0,0,1
9516097,9516333,236,0,1,0,2
9516100,9516325,225,0,1,0,1
9516346,9516405,59,0,0,1,1
9516369,9516405,36,0,0,1,2
9516406,9516428,22,1,0,0,1
9516406,9516437,31,1,0,0,2
9516429,9516591,162,0,0,1,1
9516438,9516591,153,0,0,1,2
9516592,9516610,18,1,0,0,1
9516592,9516610,18,1,0,0,2
9516611,9518174,1563,0,0,1,1
9516611,9518174,1563,0,0,1,2
9518175,9518222,47,1,0,0,1
9518175,9518223,48,1,0,0,2
9518223,9518506,283,0,0,1,1
9518224,9518505,281,0,0,1,2
9518506,9518562,56,1,0,0,2
9518507,9518553,46,1,0,0,1
9518554,9518715,161,0,0,1,1
9518563,9518715,152,0,0,1,2
9518716,9518738,22,1,0,0,1
9518716,9518746,30,1,0,0,2
9518739,9518948,209,0,0,1,1
9518747,9518947,200,0,0,1,2
9518948,9519242,294,1,0,0,2
9518949,9519200,251,1,0,0,1
9518967,9519184,217,0,1,0,2
9518970,9519176,206,0,1,0,1
9519201,9520600,1399,0,0,1,1
9519243,9520596,1353,0,0,1,2
9520597,9521158,561,1,0,0,2
9520601,9521159,558,1,0,0,1
9520633,9521147,514,0,1,0,2
9520634,9521148,514,0,1,0,1
9521159,9521231,72,0,0,1,2
9521160,9521464,304,0,0,1,1
9521232,9521241,9,1,0,0,2
9521242,9521466,224,0,0,1,2
9521465,9521509,44,1,0,0,1
9521467,9521504,37,1,0,0,2
9521505,9521756,251,0,0,1,2
9521510,9521759,249,0,0,1,1
9521757,9521775,18,1,0,0,2
9521760,9521771,11,1,0,0,1
9521772,9522418,646,0,0,1,1
9521776,9522418,642,0,0,1,2
9522419,9522465,46,1,0,0,1
9522419,9522467,48,1,0,0,2
9522466,9522631,165,0,0,1,1
9522468,9522630,162,0,0,1,2
9522631,9522665,34,1,0,0,2
9522632,9522654,22,1,0,0,1
9522655,9523325,670,0,0,1,1
9522666,9523330,664,0,0,1,2
9523326,9523545,219,1,0,0,1
9523331,9523595,264,1,0,0,2
9523382,9523549,167,0,1,0,2
9523390,9523526,136,0,1,0,1
9523546,9523728,182,0,0,1,1
9523596,9523729,133,0,0,1,2
9523729,9523741,12,1,0,0,1
9523730,9523739,9,1,0,0,2
9523740,9524182,442,0,0,1,2
9523742,9524180,438,0,0,1,1
9524181,9524258,77,1,0,0,1
9524183,9524258,75,1,0,0,2
9524259,9524424,165,0,0,1,2
9524259,9524726,467,0,0,1,1
9524425,9524439,14,1,0,0,2
9524440,9524727,287,0,0,1,2
9524727,9524748,21,1,0,0,1
9524728,9524747,19,1,0,0,2
9524748,9526290,1542,0,0,1,2
9524749,9526293,1544,0,0,1,1
9526291,9526606,315,1,0,0,2
9526294,9526600,306,1,0,0,1
9526334,9526545,211,0,1,0,1
9526334,9526564,230,0,1,0,2
9526601,9526669,68,0,0,1,1
9526607,9526661,54,0,0,1,2
9526662,9527018,356,1,0,0,2
9526670,9527021,351,1,0,0,1
9526684,9526974,290,0,1,0,2
9526689,9526971,282,0,1,0,1
9527019,9527161,142,0,0,1,2
9527022,9527165,143,0,0,1,1
9527162,9527169,7,1,0,0,2
9527166,9527175,9,1,0,0,1
9527170,9527586,416,0,0,1,2
9527176,9527586,410,0,0,1,1
9527587,9527628,41,1,0,0,2
9527587,9527650,63,1,0,0,1
9527629,9527766,137,0,0,1,2
9527651,9527767,116,0,0,1,1
9527767,9527794,27,1,0,0,2
9527768,9527796,28,1,0,0,1
9527795,9528068,273,0,0,1,2
9527797,9528061,264,0,0,1,1
9528062,9542985,14923,1,0,0,1
9528069,9542937,14868,1,0,0,2
9528157,9542975,14818,0,1,0,1
9528160,9542863,14703,0,1,0,2
9542938,9543381,443,0,0,1,2
9542986,9543381,395,0,0,1,1
9543382,9543420,38,1,0,0,1
9543382,9543431,49,1,0,0,2
9543421,9543672,251,0,0,1,1
9543432,9543671,239,0,0,1,2
9543672,9543920,248,1,0,0,2
9543673,9543895,222,1,0,0,1
9543701,9543863,162,0,1,0,1
9543706,9543856,150,0,1,0,2
9543896,9544255,359,0,0,1,1
9543921,9544254,333,0,0,1,2
9544255,9544279,24,1,0,0,2
9544256,9544287,31,1,0,0,1
9544280,9544632,352,0,0,1,2
9544288,9544633,345,0,0,1,1
9544633,9544666,33,1,0,0,2
9544634,9544661,27,1,0,0,1
9544662,9544890,228,0,0,1,1
9544667,9544895,228,0,0,1,2
9544891,9545104,213,1,0,0,1
9544896,9545143,247,1,0,0,2
9544918,9545071,153,0,1,0,1
9544919,9545086,167,0,1,0,2
9545105,9546466,1361,0,0,1,1
9545144,9546466,1322,0,0,1,2
9593531,9593701,170,0,0,1,2
9593531,9593712,181,0,0,1,1
9593702,9593955,253,1,0,0,2
9593713,9593937,224,1,0,0,1
9593726,9593891,165,0,1,0,2
9593730,9593879,149,0,1,0,1
9593938,9594038,100,0,0,1,1
9593956,9594039,83,0,0,1,2
9594039,9594073,34,1,0,0,1
9594040,9594073,33,1,0,0,2
9594074,9594373,299,0,0,1,2
9594074,9594837,763,0,0,1,1
9594374,9594385,11,1,0,0,2
9594386,9594833,447,0,0,1,2
9594834,9594848,14,1,0,0,2
9594838,9594849,11,1,0,0,1
9594849,9595787,938,0,0,1,2
9594850,9595789,939,0,0,1,1
9595788,9595879,91,1,0,0,2
9595790,9595878,88,1,0,0,1
9595879,9596213,334,0,0,1,1
9595880,9596214,334,0,0,1,2
9596214,9596305,91,1,0,0,1
9596215,9596300,85,1,0,0,2
9596301,9596400,99,0,0,1,2
9596306,9596401,95,0,0,1,1
9596401,9596438,37,1,0,0,2
9596402,9596440,38,1,0,0,1
9596439,9596627,188,0,0,1,2
9596441,9596625,184,0,0,1,1
9596626,9596642,16,1,0,0,1
9596628,9596644,16,1,0,0,2
9596643,9597572,929,0,0,1,1
9596645,9597572,927,0,0,1,2
9597573,9597657,84,1,0,0,1
9597573,9597666,93,1,0,0,2
9597658,9597985,327,0,0,1,1
9597667,9597986,319,0,0,1,2
9597986,9598072,86,1,0,0,1
9597987,9598071,84,1,0,0,2
9598072,9598147,75,0,0,1,2
9598073,9598145,72,0,0,1,1
9598146,9598169,23,1,0,0,1
9598148,9598178,30,1,0,0,2
9598170,9598355,185,0,0,1,1
9598179,9598356,177,0,0,1,2
9598356,9598374,18,1,0,0,1
9598357,9598379,22,1,0,0,2
9598375,9599426,1051,0,0,1,1
9598380,9599425,1045,0,0,1,2
9599426,9599526,100,1,0,0,2
9599427,9599518,91,1,0,0,1
9599519,9599863,344,0,0,1,1
9599527,9599864,337,0,0,1,2
9599864,9599934,70,1,0,0,1
9599865,9599946,81,1,0,0,2
9599935,9600061,126,0,0,1,1
9599947,9600063,116,0,0,1,2
9600062,9600087,25,1,0,0,1
9600064,9600089,25,1,0,0,2
9600088,9601075,987,0,0,1,1
9600090,9601058,968,0,0,1,2
9601059,9601382,323,1,0,0,2
9601076,9601290,214,1,0,0,1
9601083,9601313,230,0,1,0,2
9601094,9601273,179,0,1,0,1
9601291,9601447,156,0,0,1,1
9601383,9601449,66,0,0,1,2
9601448,9601545,97,1,0,0,1
9601450,9601556,106,1,0,0,2
9601546,9601898,352,0,0,1,1
9601557,9601897,340,0,0,1,2
9601898,9601987,89,1,0,0,2
9601899,9601992,93,1,0,0,1
9601988,9602097,109,0,0,1,2
9601993,9602096,103,0,0,1,1
9602097,9602133,36,1,0,0,1
9602098,9602133,35,1,0,0,2
9602134,9602277,143,0,0,1,2
9602134,9602280,146,0,0,1,1
9602278,9602295,17,1,0,0,2
9602281,9602294,13,1,0,0,1
9602295,9603462,1167,0,0,1,1
9602296,9603464,1168,0,0,1,2
9603463,9603597,134,1,0,0,1
9603465,9603600,135,1,0,0,2
9603598,9603811,213,0,0,1,1
9603601,9603811,210,0,0,1,2
9603812,9603830,18,1,0,0,1
9603812,9603831,19,1,0,0,2
9603831,9603956,125,0,0,1,1
9603832,9603954,122,0,0,1,2
9603955,9604016,61,1,0,0,2
9603957,9604016,59,1,0,0,1
9604017,9604163,146,0,0,1,1
9604017,9604169,152,0,0,1,2
9604164,9604183,19,1,0,0,1
9604170,9604181,11,1,0,0,2
9604182,9604439,257,0,0,1,2
9604184,9604439,255,0,0,1,1
9604440,9604458,18,1,0,0,2
9604440,9604460,20,1,0,0,1
9604459,9604936,477,0,0,1,2
9604461,9605565,1104,0,0,1,1
9604937,9604948,11,1,0,0,2
9604949,9605564,615,0,0,1,2
9605565,9605850,285,1,0,0,2
9605566,9605804,238,1,0,0,1
9605612,9605784,172,0,1,0,2
9605620,9605759,139,0,1,0,1
9605805,9606113,308,0,0,1,1
9605851,9606111,260,0,0,1,2
9606112,9606178,66,1,0,0,2
9606114,9606171,57,1,0,0,1
9606172,9606308,136,0,0,1,1
9606179,9606306,127,0,0,1,2
9606307,9606341,34,1,0,0,2
9606309,9606341,32,1,0,0,1
9606342,9606556,214,0,0,1,1
9606342,9607736,1394,0,0,1,2
9606557,9606561,4,1,0,0,1
9606562,9607736,1174,0,0,1,1
9607737,9607794,57,1,0,0,2
9607737,9607799,62,1,0,0,1
9607795,9608168,373,0,0,1,2
9607800,9608166,366,0,0,1,1
9608167,9608219,52,1,0,0,1
9608169,9608220,51,1,0,0,2
9608220,9608311,91,0,0,1,1
9608221,9608312,91,0,0,1,2
9608312,9608334,22,1,0,0,1
9608313,9608336,23,1,0,0,2
9608335,9608530,195,0,0,1,1
9608337,9608531,194,0,0,1,2
9608531,9608549,18,1,0,0,1
9608532,9608547,15,1,0,0,2
9608548,9609769,1221,0,0,1,2
9608550,9609770,1220,0,0,1,1
9609770,9609927,157,1,0,0,2
9609771,9609912,141,1,0,0,1
9609802,9609894,92,0,1,0,2
9609806,9609869,63,0,1,0,1
9609913,9610283,370,0,0,1,1
9609928,9610283,355,0,0,1,2
9610284,9610341,57,1,0,0,2
9610284,9610344,60,1,0,0,1
9610342,9610445,103,0,0,1,2
9610345,9610445,100,0,0,1,1
9610446,9610466,20,1,0,0,2
9610446,9610468,22,1,0,0,1
9610467,9611765,1298,0,0,1,2
9610469,9611763,1294,0,0,1,1
9611764,9611942,178,1,0,0,1
9611766,9611971,205,1,0,0,2
9611803,9611906,103,0,1,0,2
9611806,9611897,91,0,1,0,1
9611943,9612272,329,0,0,1,1
9611972,9612270,298,0,0,1,2
9612271,9612349,78,1,0,0,2
9612273,9612352,79,1,0,0,1
9612350,9612426,76,0,0,1,2
9612353,9612427,74,0,0,1,1
9612427,9612462,35,1,0,0,2
9612428,9612458,30,1,0,0,1
9612459,9612655,196,0,0,1,1
9612463,9612660,197,0,0,1,2
9612656,9612673,17,1,0,0,1
9612661,9612671,10,1,0,0,2
9612672,9614047,1375,0,0,1,2
9612674,9614049,1375,0,0,1,1
9614048,9614284,236,1,0,0,2
9614050,9614241,191,1,0,0,1
9614080,9614233,153,0,1,0,2
9614092,9614210,118,0,1,0,1
9614242,9614548,306,0,0,1,1
9614285,9614548,263,0,0,1,2
9614549,9614620,71,1,0,0,1
9614549,9614627,78,1,0,0,2
9614621,9614705,84,0,0,1,1
9614628,9614703,75,0,0,1,2
9614704,9614741,37,1,0,0,2
9614706,9614740,34,1,0,0,1
9614741,9614909,168,0,0,1,1
9614742,9616208,1466,0,0,1,2
9614910,9614914,4,1,0,0,1
9614915,9616208,1293,0,0,1,1
9616209,9616312,103,1,0,0,1
9616209,9616314,105,1,0,0,2
9616313,9616443,130,0,0,1,1
9616315,9616442,127,0,0,1,2
9616443,9616488,45,1,0,0,2
9616444,9616487,43,1,0,0,1
9616488,9616650,162,0,0,1,1
9616489,9616652,163,0,0,1,2
9616651,9616696,45,1,0,0,1
9616653,9616708,55,1,0,0,2
9616697,9616932,235,0,0,1,1
9616709,9616931,222,0,0,1,2
9616932,9616950,18,1,0,0,2
9616933,9616950,17,1,0,0,1
9616951,9618180,1229,0,0,1,1
9616951,9618180,1229,0,0,1,2
9618181,9618213,32,1,0,0,1
9618181,9618213,32,1,0,0,2
9618214,9618322,108,0,0,1,2
9618214,9618323,109,0,0,1,1
9618323,9618561,238,1,0,0,2
9618324,9618536,212,1,0,0,1
9618359,9618523,164,0,1,0,2
9618361,9618511,150,0,1,0,1
9618537,9618829,292,0,0,1,1
9618562,9618830,268,0,0,1,2
9618830,9618909,79,1,0,0,1
9618831,9618904,73,1,0,0,2
9618905,9619002,97,0,0,1,2
9618910,9619001,91,0,0,1,1
9619002,9619040,38,1,0,0,1
9619003,9619045,42,1,0,0,2
9619041,9619194,153,0,0,1,1
9619046,9619194,148,0,0,1,2
9619195,9619213,18,1,0,0,2
9619195,9619214,19,1,0,0,1
9619214,9619807,593,0,0,1,2
9619215,9619540,325,0,0,1,1
9619541,9619552,11,1,0,0,1
9619553,9619803,250,0,0,1,1
9619804,9619824,20,1,0,0,1
9619808,9619822,14,1,0,0,2
9619823,9619997,174,0,0,1,2
9619825,9620000,175,0,0,1,1
9619998,9620017,19,1,0,0,2
9620001,9620018,17,1,0,0,1
9620018,9620564,546,0,0,1,2
9620019,9620561,542,0,0,1,1
9620562,9620676,114,1,0,0,1
9620565,9620696,131,1,0,0,2
9620677,9620788,111,0,0,1,1
9620697,9620787,90,0,0,1,2
9620788,9620807,19,1,0,0,2
9620789,9620812,23,1,0,0,1
9620808,9620998,190,0,0,1,2
9620813,9620997,184,0,0,1,1
9620998,9621078,80,1,0,0,1
9620999,9621081,82,1,0,0,2
9621079,9621143,64,0,0,1,1
9621082,9621143,61,0,0,1,2
9621144,9621188,44,1,0,0,1
9621144,9621188,44,1,0,0,2
9621189,9621267,78,0,0,1,2
9621189,9621270,81,0,0,1,1
9621268,9621288,20,1,0,0,2
9621271,9621289,18,1,0,0,1
9621289,9621382,93,0,0,1,2
9621290,9621384,94,0,0,1,1
9621383,9621402,19,1,0,0,2
9621385,9621403,18,1,0,0,1
9621403,9621766,363,0,0,1,2
9621404,9621766,362,0,0,1,1
9621767,9621780,13,1,0,0,1
9621767,9621780,13,1,0,0,2
9621781,9621979,198,0,0,1,1
9621781,9621980,199,0,0,1,2
9621980,9621992,12,1,0,0,1
9621981,9621993,12,1,0,0,2
9621993,9622359,366,0,0,1,1
9621994,9622346,352,0,0,1,2
9622347,9623019,672,1,0,0,2
9622359,9622973,614,0,1,0,2
9622360,9622602,242,1,0,0,1
9622378,9622586,208,0,1,0,1
9622603,9623051,448,0,0,1,1
9623020,9623052,32,0,0,1,2
9623052,9623115,63,1,0,0,1
9623053,9623131,78,1,0,0,2
9623116,9623364,248,0,0,1,1
9623132,9623367,235,0,0,1,2
9623365,9623435,70,1,0,0,1
9623368,9623437,69,1,0,0,2
9623436,9623554,118,0,0,1,1
9623438,9623555,117,0,0,1,2
9623555,9623591,36,1,0,0,1
9623556,9623590,34,1,0,0,2
9623591,9625373,1782,0,0,1,2
9623592,9625373,1781,0,0,1,1
9625374,9625398,24,1,0,0,2
9625374,9625400,26,1,0,0,1
9625399,9625589,190,0,0,1,2
9625401,9625590,189,0,0,1,1
9625590,9625616,26,1,0,0,2
9625591,9625617,26,1,0,0,1
9625617,9625832,215,0,0,1,2
9625618,9625832,214,0,0,1,1
9625833,9625937,104,1,0,0,2
9625833,9625942,109,1,0,0,1
9625938,9626042,104,0,0,1,2
9625943,9626040,97,0,0,1,1
9626041,9626064,23,1,0,0,1
9626043,9626063,20,1,0,0,2
9626064,9626702,638,0,0,1,2
9626065,9626241,176,0,0,1,1
9626242,9626252,10,1,0,0,1
9626253,9626703,450,0,0,1,1
9626703,9626729,26,1,0,0,2
9626704,9626727,23,1,0,0,1
9626728,9627075,347,0,0,1,1
9626730,9627154,424,0,0,1,2
9627076,9627080,4,1,0,0,1
9627081,9628193,1112,0,0,1,1
9627155,9627176,21,1,0,0,2
9627177,9628195,1018,0,0,1,2
9628194,9628433,239,1,0,0,1
9628196,9628469,273,1,0,0,2
9628253,9628415,162,0,1,0,2
9628258,9628394,136,0,1,0,1
9628434,9628598,164,0,0,1,1
9628470,9628599,129,0,0,1,2
9628599,9628644,45,1,0,0,1
9628600,9628650,50,1,0,0,2
9628645,9628699,54,0,0,1,1
9628651,9628699,48,0,0,1,2
9628700,9628793,93,1,0,0,1
9628700,9628796,96,1,0,0,2
9628794,9628883,89,0,0,1,1
9628797,9628882,85,0,0,1,2
9628883,9628915,32,1,0,0,2
9628884,9628920,36,1,0,0,1
9628916,9629075,159,0,0,1,2
9628921,9629075,154,0,0,1,1
9629076,9629085,9,1,0,0,1
9629076,9629086,10,1,0,0,2
9629086,9629784,698,0,0,1,1
9629087,9630564,1477,0,0,1,2
9629785,9629795,10,1,0,0,1
9629796,9630566,770,0,0,1,1
9630565,9630863,298,1,0,0,2
9630567,9630833,266,1,0,0,1
9630652,9630805,153,0,1,0,2
9630658,9630796,138,0,1,0,1
9630834,9630897,63,0,0,1,1
9630864,9630894,30,0,0,1,2
9630895,9630921,26,1,0,0,2
9630898,9630914,16,1,0,0,1
9630915,9631036,121,0,0,1,1
9630922,9631036,114,0,0,1,2
9631037,9631118,81,1,0,0,1
9631037,9631122,85,1,0,0,2
9631119,9631256,137,0,0,1,1
9631123,9631257,134,0,0,1,2
9631257,9631267,10,1,0,0,1
9631258,9631264,6,1,0,0,2
9631265,9631448,183,0,0,1,2
9631268,9631447,179,0,0,1,1
9631448,9631452,4,1,0,0,1
9631449,9631454,5,1,0,0,2
9631453,9631992,539,0,0,1,1
9631455,9631992,537,0,0,1,2
9631993,9632006,13,1,0,0,2
9631993,9632018,25,1,0,0,1
9632007,9632207,200,0,0,1,2
9632019,9632205,186,0,0,1,1
9632206,9632218,12,1,0,0,1
9632208,9632221,13,1,0,0,2
9632219,9632891,672,0,0,1,1
9632222,9632895,673,0,0,1,2
9632892,9633062,170,1,0,0,1
9632896,9633137,241,1,0,0,2
9632934,9633033,99,0,1,0,2
9632942,9633010,68,0,1,0,1
9633063,9633364,301,0,0,1,1
9633138,9633352,214,0,0,1,2
9633353,9633467,114,1,0,0,2
9633365,9633468,103,1,0,0,1
9633468,9633569,101,0,0,1,2
9633469,9633570,101,0,0,1,1
9633570,9633608,38,1,0,0,2
9633571,9633607,36,1,0,0,1
9633608,9633723,115,0,0,1,1
9633609,9633720,111,0,0,1,2
9633721,9633743,22,1,0,0,2
9633724,9633750,26,1,0,0,1
9633744,9633958,214,0,0,1,2
9633751,9633957,206,0,0,1,1
9633958,9633970,12,1,0,0,1
9633959,9633976,17,1,0,0,2
9633971,9634635,664,0,0,1,1
9633977,9634635,658,0,0,1,2
9634636,9634670,34,1,0,0,1
9634636,9634671,35,1,0,0,2
9634671,9634769,98,0,0,1,1
9634672,9634769,97,0,0,1,2
9634770,9634791,21,1,0,0,1
9634770,9634801,31,1,0,0,2
9634792,9635819,1027,0,0,1,1
9634802,9635818,1016,0,0,1,2
9635819,9635888,69,1,0,0,2
9635820,9635891,71,1,0,0,1
9635889,9635979,90,0,0,1,2
9635892,9635980,88,0,0,1,1
9635980,9636155,175,1,0,0,2
9635981,9636123,142,1,0,0,1
9636004,9636108,104,0,1,0,2
9636010,9636083,73,0,1,0,1
9636124,9636348,224,0,0,1,1
9636156,9636349,193,0,0,1,2
9636349,9636420,71,1,0,0,1
9636350,9636421,71,1,0,0,2
9636421,9636502,81,0,0,1,1
9636422,9636502,80,0,0,1,2
9636503,9636542,39,1,0,0,1
9636503,9636542,39,1,0,0,2
9636543,9636791,248,0,0,1,1
9636543,9636793,250,0,0,1,2
9636792,9636803,11,1,0,0,1
9636794,9636804,10,1,0,0,2
9636804,9637517,713,0,0,1,1
9636805,9637517,712,0,0,1,2
9637518,9637714,196,1,0,0,1
9637518,9637722,204,1,0,0,2
9637544,9637666,122,0,1,0,2
9637547,9637658,111,0,1,0,1
9637715,9638008,293,0,0,1,1
9637723,9638013,290,0,0,1,2
9638009,9638114,105,1,0,0,1
9638014,9638115,101,1,0,0,2
9638115,9638272,157,0,0,1,1
9638116,9638265,149,0,0,1,2
9638266,9638491,225,1,0,0,2
9638273,9638471,198,1,0,0,1
9638286,9638442,156,0,1,0,1
9638287,9638448,161,0,1,0,2
9638472,9638601,129,0,0,1,1
9638492,9638599,107,0,0,1,2
9638600,9638670,70,1,0,0,2
9638602,9638668,66,1,0,0,1
9638669,9638745,76,0,0,1,1
9638671,9638747,76,0,0,1,2
9638746,9638780,34,1,0,0,1
9638748,9638775,27,1,0,0,2
9638776,9640387,1611,0,0,1,2
9638781,9640385,1604,0,0,1,1
9640386,9640577,191,1,0,0,1
9640388,9640585,197,1,0,0,2
9640432,9640538,106,0,1,0,2
9640433,9640538,105,0,1,0,1
9640578,9640861,283,0,0,1,1
9640586,9640862,276,0,0,1,2
9640862,9640926,64,1,0,0,1
9640863,9640928,65,1,0,0,2
9640927,9641055,128,0,0,1,1
9640929,9641057,128,0,0,1,2
9641056,9641092,36,1,0,0,1
9641058,9641091,33,1,0,0,2
9641092,9641286,194,0,0,1,2
9641093,9642608,1515,0,0,1,1
9641287,9641297,10,1,0,0,2
9641298,9642608,1310,0,0,1,2
9642609,9642771,162,1,0,0,1
9642609,9642780,171,1,0,0,2
9642639,9642739,100,0,1,0,1
9642641,9642749,108,0,1,0,2
9642772,9643130,358,0,0,1,1
9642781,9643130,349,0,0,1,2
9643131,9643204,73,1,0,0,2
9643131,9643206,75,1,0,0,1
9643205,9643297,92,0,0,1,2
9643207,9643297,90,0,0,1,1
9643298,9643334,36,1,0,0,2
9643298,9643336,38,1,0,0,1
9643335,9643500,165,0,0,1,2
9643337,9643499,162,0,0,1,1
9643500,9643521,21,1,0,0,1
9643501,9643530,29,1,0,0,2
9643522,9643636,114,0,0,1,1
9643531,9643641,110,0,0,1,2
9643637,9643667,30,1,0,0,1
9643642,9643658,16,1,0,0,2
9643659,9644482,823,0,0,1,2
9643668,9644479,811,0,0,1,1
9644480,9644515,35,1,0,0,1
9644483,9644515,32,1,0,0,2
9644516,9644603,87,0,0,1,2
9644516,9644604,88,0,0,1,1
9644604,9644631,27,1,0,0,2
9644605,9644631,26,1,0,0,1
9644632,9644742,110,0,0,1,2
9644632,9644752,120,0,0,1,1
9644743,9644994,251,1,0,0,2
9644753,9644956,203,1,0,0,1
9644782,9644921,139,0,1,0,1
9644784,9644956,172,0,1,0,2
9644957,9645169,212,0,0,1,1
9644995,9645169,174,0,0,1,2
9645170,9645253,83,1,0,0,2
9645170,9645260,90,1,0,0,1
9645254,9645478,224,0,0,1,2
9645261,9645478,217,0,0,1,1
9645479,9645527,48,1,0,0,2
9645479,9645529,50,1,0,0,1
9645528,9645642,114,0,0,1,2
9645530,9645642,112,0,0,1,1
9645643,9645664,21,1,0,0,2
9645643,9645665,22,1,0,0,1
9645665,9645953,288,0,0,1,2
9645666,9646244,578,0,0,1,1
9645954,9645964,10,1,0,0,2
9645965,9647337,1372,0,0,1,2
9646245,9646255,10,1,0,0,1
9646256,9647338,1082,0,0,1,1
9647338,9647344,6,1,0,0,2
9647339,9647347,8,1,0,0,1
9647345,9647757,412,0,0,1,2
9647348,9647757,409,0,0,1,1
9647758,9647819,61,1,0,0,2
9647758,9647820,62,1,0,0,1
9647820,9647926,106,0,0,1,2
9647821,9647927,106,0,0,1,1
9647927,9647955,28,1,0,0,2
9647928,9647967,39,1,0,0,1
9647956,9649646,1690,0,0,1,2
9647968,9649645,1677,0,0,1,1
9649646,9649740,94,1,0,0,1
9649647,9649740,93,1,0,0,2
9649741,9650002,261,0,0,1,1
9649741,9650004,263,0,0,1,2
9650003,9650062,59,1,0,0,1
9650005,9650065,60,1,0,0,2
9650063,9650176,113,0,0,1,1
9650066,9650171,105,0,0,1,2
9650172,9650371,199,1,0,0,2
9650177,9650379,202,1,0,0,1
9650204,9650338,134,0,1,0,2
9650208,9650322,114,0,1,0,1
9650372,9650557,185,0,0,1,2
9650380,9650560,180,0,0,1,1
9650558,9650578,20,1,0,0,2
9650561,9650575,14,1,0,0,1
9650576,9652175,1599,0,0,1,1
9650579,9652175,1596,0,0,1,2
9652176,9652274,98,1,0,0,1
9652176,9652275,99,1,0,0,2
9652275,9652391,116,0,0,1,1
9652276,9652391,115,0,0,1,2
9652392,9652416,24,1,0,0,2
9652392,9652417,25,1,0,0,1
9652417,9652593,176,0,0,1,2
9652418,9652592,174,0,0,1,1
9652593,9652726,133,1,0,0,1
9652594,9652729,135,1,0,0,2
9652727,9652761,34,0,0,1,1
9652730,9652762,32,0,0,1,2
9652762,9652809,47,1,0,0,1
9652763,9652807,44,1,0,0,2
9652808,9652863,55,0,0,1,2
9652810,9652862,52,0,0,1,1
9652863,9652884,21,1,0,0,1
9652864,9652884,20,1,0,0,2
9652885,9652994,109,0,0,1,2
9652885,9652999,114,0,0,1,1
9652995,9653013,18,1,0,0,2
9653000,9653011,11,1,0,0,1
9653012,9653212,200,0,0,1,1
9653014,9653214,200,0,0,1,2
9653213,9653233,20,1,0,0,1
9653215,9653234,19,1,0,0,2
9653234,9653353,119,0,0,1,1
9653235,9653356,121,0,0,1,2
9653354,9653368,14,1,0,0,1
9653357,9653369,12,1,0,0,2
9653369,9653580,211,0,0,1,1
9653370,9653583,213,0,0,1,2
9653581,9653600,19,1,0,0,1
9653584,9653600,16,1,0,0,2
9653601,9653769,168,0,0,1,2
9653601,9653771,170,0,0,1,1
9653770,9653784,14,1,0,0,2
9653772,9653786,14,1,0,0,1
9653785,9654011,226,0,0,1,2
9653787,9654011,224,0,0,1,1
9654012,9654029,17,1,0,0,1
9654012,9654029,17,1,0,0,2
9654030,9654120,90,0,0,1,2
9654030,9654593,563,0,0,1,1
9654121,9654135,14,1,0,0,2
9654136,9654594,458,0,0,1,2
9654594,9654800,206,1,0,0,1
9654595,9654826,231,1,0,0,2
9654612,9654783,171,0,1,0,2
9654616,9654773,157,0,1,0,1
9654801,9655058,257,0,0,1,1
9654827,9655057,230,0,0,1,2
9655058,9655126,68,1,0,0,2
9655059,9655126,67,1,0,0,1
9655127,9655195,68,0,0,1,1
9655127,9655195,68,0,0,1,2
9655196,9655220,24,1,0,0,2
9655196,9655232,36,1,0,0,1
9655221,9657211,1990,0,0,1,2
9655233,9655956,723,0,0,1,1
9655957,9655969,12,1,0,0,1
9655970,9657210,1240,0,0,1,1
9657211,9657338,127,1,0,0,1
9657212,9657351,139,1,0,0,2
9657246,9657303,57,0,1,0,2
9657250,9657297,47,0,1,0,1
9657339,9657649,310,0,0,1,1
9657352,9657649,297,0,0,1,2
9657650,9657712,62,1,0,0,1
9657650,9657720,70,1,0,0,2
9657713,9657804,91,0,0,1,1
9657721,9657805,84,0,0,1,2
9657805,9657828,23,1,0,0,1
9657806,9657838,32,1,0,0,2
9657829,9658337,508,0,0,1,1
9657839,9658337,498,0,0,1,2
9658338,9658342,4,1,0,0,2
9658338,9658347,9,1,0,0,1
9658343,9659834,1491,0,0,1,2
9658348,9659834,1486,0,0,1,1
9659835,9660032,197,1,0,0,1
9659835,9660068,233,1,0,0,2
9659871,9660009,138,0,1,0,2
9659875,9659993,118,0,1,0,1
9660033,9660300,267,0,0,1,1
9660069,9660301,232,0,0,1,2
9660301,9660381,80,1,0,0,1
9660302,9660371,69,1,0,0,2
9660372,9660456,84,0,0,1,2
9660382,9660456,74,0,0,1,1
9660457,9660492,35,1,0,0,2
9660457,9660493,36,1,0,0,1
9660493,9660861,368,0,0,1,2
9660494,9660861,367,0,0,1,1
9660862,9660872,10,1,0,0,1
9660862,9660882,20,1,0,0,2
9660873,9662539,1666,0,0,1,1
9660883,9662539,1656,0,0,1,2
9662540,9662614,74,1,0,0,1
9662540,9662621,81,1,0,0,2
9662615,9662916,301,0,0,1,1
9662622,9662917,295,0,0,1,2
9662917,9662961,44,1,0,0,1
9662918,9662963,45,1,0,0,2
9662962,9663079,117,0,0,1,1
9662964,9663079,115,0,0,1,2
9663080,9663100,20,1,0,0,1
9663080,9663111,31,1,0,0,2
9663101,9663516,415,0,0,1,1
9663112,9663516,404,0,0,1,2
9663517,9663529,12,1,0,0,1
9663517,9663529,12,1,0,0,2
9663530,9664572,1042,0,0,1,2
9663530,9664576,1046,0,0,1,1
9664573,9664752,179,1,0,0,2
9664577,9664717,140,1,0,0,1
9664718,9665035,317,0,0,1,1
9664753,9665037,284,0,0,1,2
9665036,9665063,27,1,0,0,1
9665038,9665062,24,1,0,0,2
9665063,9665187,124,0,0,1,2
9665064,9665187,123,0,0,1,1
9665188,9665253,65,1,0,0,2
9665188,9665261,73,1,0,0,1
9665254,9665346,92,0,0,1,2
9665262,9665346,84,0,0,1,1
9665347,9665370,23,1,0,0,2
9665347,9665379,32,1,0,0,1
9665371,9665513,142,0,0,1,2
9665380,9665514,134,0,0,1,1
9665514,9665532,18,1,0,0,2
9665515,9665533,18,1,0,0,1
9665533,9665723,190,0,0,1,2
9665534,9665713,179,0,0,1,1
9665714,9665723,9,1,0,0,1
9665724,9665728,4,1,0,0,2
9665724,9665960,236,0,0,1,1
9665729,9665964,235,0,0,1,2
9665961,9665981,20,1,0,0,1
9665965,9665979,14,1,0,0,2
9665980,9666150,170,0,0,1,2
9665982,9667026,1044,0,0,1,1
9666151,9666165,14,1,0,0,2
9666166,9667029,863,0,0,1,2
9667027,9667050,23,1,0,0,1
9667030,9667050,20,1,0,0,2
9667051,9667286,235,0,0,1,2
9667051,9667291,240,0,0,1,1
9667287,9667313,26,1,0,0,2
9667292,9667305,13,1,0,0,1
9667306,9667446,140,0,0,1,1
9667314,9667441,127,0,0,1,2
9667442,9667552,110,1,0,0,2
9667447,9667557,110,1,0,0,1
9667553,9667700,147,0,0,1,2
9667558,9667696,138,0,0,1,1
9667697,9667731,34,1,0,0,1
9667701,9667719,18,1,0,0,2
9667720,9667869,149,0,0,1,2
9667732,9667865,133,0,0,1,1
9667866,9667884,18,1,0,0,1
9667870,9667879,9,1,0,0,2
9667880,9667960,80,0,0,1,2
9667885,9667975,90,0,0,1,1
9667961,9668258,297,1,0,0,2
9667976,9668202,226,1,0,0,1
9668005,9668198,193,0,1,0,2
9668017,9668158,141,0,1,0,1
9668203,9668388,185,0,0,1,1
9668259,9668393,134,0,0,1,2
9668389,9668410,21,1,0,0,1
9668394,9668407,13,1,0,0,2
9668408,9668807,399,0,0,1,2
9668411,9668806,395,0,0,1,1
9668807,9668828,21,1,0,0,1
9668808,9668824,16,1,0,0,2
9668825,9668919,94,0,0,1,2
9668829,9668921,92,0,0,1,1
9668920,9668928,8,1,0,0,2
9668922,9668928,6,1,0,0,1
9668929,9669021,92,0,0,1,1
9668929,9669021,92,0,0,1,2
9669022,9669045,23,1,0,0,1
9669022,9669046,24,1,0,0,2
9669046,9670187,1141,0,0,1,1
9669047,9670189,1142,0,0,1,2
9670188,9670302,114,1,0,0,1
9670190,9670306,116,1,0,0,2
9670303,9670603,300,0,0,1,1
9670307,9670603,296,0,0,1,2
9670604,9670630,26,1,0,0,1
9670604,9670630,26,1,0,0,2
9670631,9670729,98,0,0,1,1
9670631,9670730,99,0,0,1,2
9670730,9670808,78,1,0,0,1
9670731,9670801,70,1,0,0,2
9670802,9670905,103,0,0,1,2
9670809,9670906,97,0,0,1,1
9670906,9670931,25,1,0,0,2
9670907,9670929,22,1,0,0,1
9670930,9671102,172,0,0,1,1
9670932,9671103,171,0,0,1,2
9671103,9671120,17,1,0,0,1
9671104,9671121,17,1,0,0,2
9671121,9671453,332,0,0,1,1
9671122,9671450,328,0,0,1,2
9671451,9671467,16,1,0,0,2
9671454,9671467,13,1,0,0,1
9671468,9672884,1416,0,0,1,1
9671468,9672885,1417,0,0,1,2
9672885,9673101,216,1,0,0,1
9672886,9673155,269,1,0,0,2
9672906,9673116,210,0,1,0,2
9672913,9673082,169,0,1,0,1
9673102,9673542,440,0,0,1,1
9673156,9673544,388,0,0,1,2
9673543,9673623,80,1,0,0,1
9673545,9673620,75,1,0,0,2
9673621,9673697,76,0,0,1,2
9673624,9673697,73,0,0,1,1
9673698,9673744,46,1,0,0,2
9673698,9673755,57,1,0,0,1
9673745,9673922,177,0,0,1,2
9673756,9673924,168,0,0,1,1
9673923,9673943,20,1,0,0,2
9673925,9673943,18,1,0,0,1
9673944,9674161,217,0,0,1,1
9673944,9674162,218,0,0,1,2
9674162,9674173,11,1,0,0,1
9674163,9674168,5,1,0,0,2
9674169,9675262,1093,0,0,1,2
9674174,9675261,1087,0,0,1,1
9675262,9675324,62,1,0,0,1
9675263,9675325,62,1,0,0,2
9675325,9675677,352,0,0,1,1
9675326,9675676,350,0,0,1,2
9675677,9675738,61,1,0,0,2
9675678,9675742,64,1,0,0,1
9675739,9675836,97,0,0,1,2
9675743,9675838,95,0,0,1,1
9675837,9675874,37,1,0,0,2
9675839,9675865,26,1,0,0,1
9675866,9676004,138,0,0,1,1
9675875,9676005,130,0,0,1,2
9676005,9676034,29,1,0,0,1
9676006,9676023,17,1,0,0,2
9676024,9677526,1502,0,0,1,2
9676035,9677525,1490,0,0,1,1
9677526,9677575,49,1,0,0,1
9677527,9677576,49,1,0,0,2
9677576,9677911,335,0,0,1,1
9677577,9677914,337,0,0,1,2
9677912,9677996,84,1,0,0,1
9677915,9677996,81,1,0,0,2
9677997,9678070,73,0,0,1,1
9677997,9678070,73,0,0,1,2
9678071,9678103,32,1,0,0,1
9678071,9678139,68,1,0,0,2
9678104,9678154,50,0,0,1,1
9678140,9678228,88,0,0,1,2
9678155,9678171,16,1,0,0,1
9678172,9678229,57,0,0,1,1
9678229,9678246,17,1,0,0,2
9678230,9678247,17,1,0,0,1
9678247,9678331,84,0,0,1,2
9678248,9678327,79,0,0,1,1
9678328,9678556,228,1,0,0,1
9678332,9678536,204,1,0,0,2
9678347,9678524,177,0,1,0,2
9678351,9678507,156,0,1,0,1
9678537,9678732,195,0,0,1,2
9678557,9679875,1318,0,0,1,1
9678733,9678744,11,1,0,0,2
9678745,9679876,1131,0,0,1,2
9679876,9679953,77,1,0,0,1
9679877,9679948,71,1,0,0,2
9679949,9680322,373,0,0,1,2
9679954,9680320,366,0,0,1,1
9680321,9680383,62,1,0,0,1
9680323,9680383,60,1,0,0,2
9680384,9680470,86,0,0,1,1
9680384,9680470,86,0,0,1,2
9680471,9680495,24,1,0,0,1
9680471,9680504,33,1,0,0,2
9680496,9682172,1676,0,0,1,1
9680505,9682174,1669,0,0,1,2
9682173,9682326,153,1,0,0,1
9682175,9682334,159,1,0,0,2
9682221,9682294,73,0,1,0,2
9682222,9682277,55,0,1,0,1
9682327,9682682,355,0,0,1,1
9682335,9682681,346,0,0,1,2
9682682,9682740,58,1,0,0,2
9682683,9682751,68,1,0,0,1
9682741,9682813,72,0,0,1,2
9682752,9682813,61,0,0,1,1
9682814,9682846,32,1,0,0,2
9682814,9682848,34,1,0,0,1
9682847,9684535,1688,0,0,1,2
9682849,9684532,1683,0,0,1,1
9684533,9684727,194,1,0,0,1
9684536,9684757,221,1,0,0,2
9684564,9684719,155,0,1,0,2
9684573,9684696,123,0,1,0,1
9684728,9684990,262,0,0,1,1
9684758,9684989,231,0,0,1,2
9684990,9685037,47,1,0,0,2
9684991,9685049,58,1,0,0,1
9685038,9685142,104,0,0,1,2
9685050,9685144,94,0,0,1,1
9685143,9685174,31,1,0,0,2
9685145,9685165,20,1,0,0,1
9685166,9685916,750,0,0,1,1
9685175,9685916,741,0,0,1,2
9685917,9685938,21,1,0,0,2
9685917,9685949,32,1,0,0,1
9685939,9686054,115,0,0,1,2
9685950,9686053,103,0,0,1,1
9686054,9686069,15,1,0,0,1
9686055,9686069,14,1,0,0,2
9686070,9686731,661,0,0,1,2
9686070,9686733,663,0,0,1,1
9686732,9686756,24,1,0,0,2
9686734,9686756,22,1,0,0,1
9686757,9687137,380,0,0,1,2
9686757,9687139,382,0,0,1,1
9687138,9687294,156,1,0,0,2
9687140,9687293,153,1,0,0,1
9687294,9687394,100,0,0,1,1
9687295,9687394,99,0,0,1,2
9687395,9687416,21,1,0,0,1
9687395,9687429,34,1,0,0,2
9687417,9687769,352,0,0,1,1
9687430,9687582,152,0,0,1,2
9687583,9687589,6,1,0,0,2
9687590,9687759,169,0,0,1,2
9687760,9687774,14,1,0,0,2
9687770,9687774,4,1,0,0,1
9687775,9687882,107,0,0,1,1
9687775,9687883,108,0,0,1,2
9687883,9687905,22,1,0,0,1
9687884,9687906,22,1,0,0,2
9687906,9688083,177,0,0,1,1
9687907,9688081,174,0,0,1,2
9688082,9688092,10,1,0,0,2
9688084,9688090,6,1,0,0,1
9688091,9688550,459,0,0,1,1
9688093,9688358,265,0,0,1,2
9688359,9688372,13,1,0,0,2
9688373,9688547,174,0,0,1,2
9688548,9688566,18,1,0,0,2
9688551,9688565,14,1,0,0,1
9688566,9688939,373,0,0,1,1
9688567,9688939,372,0,0,1,2
9688940,9689114,174,1,0,0,1
9688940,9689147,207,1,0,0,2
9688985,9689103,118,0,1,0,2
9689003,9689058,55,0,1,0,1
9689115,9689456,341,0,0,1,1
9689148,9689457,309,0,0,1,2
9689457,9689476,19,1,0,0,1
9689458,9689477,19,1,0,0,2
9689477,9689693,216,0,0,1,1
9689478,9689691,213,0,0,1,2
9689692,9689717,25,1,0,0,2
9689694,9689733,39,1,0,0,1
9689718,9689766,48,0,0,1,2
9689734,9689763,29,0,0,1,1
9689764,9689856,92,1,0,0,1
9689767,9689870,103,1,0,0,2
9689857,9689957,100,0,0,1,1
9689871,9689956,85,0,0,1,2
9689957,9690161,204,1,0,0,2
9689958,9690096,138,1,0,0,1
9690097,9690129,32,0,0,1,1
9690130,9690166,36,1,0,0,1
9690162,9690235,73,0,0,1,2
9690167,9690236,69,0,0,1,1
9690236,9690253,17,1,0,0,2
9690237,9690252,15,1,0,0,1
9690253,9690419,166,0,0,1,1
9690254,9690421,167,0,0,1,2
9690420,9690428,8,1,0,0,1
9690422,9690435,13,1,0,0,2
9690429,9691099,670,0,0,1,1
9690436,9690922,486,0,0,1,2
9690923,9690930,7,1,0,0,2
9690931,9691097,166,0,0,1,2
9691098,9691113,15,1,0,0,2
9691100,9691115,15,1,0,0,1
9691114,9691423,309,0,0,1,2
9691116,9691423,307,0,0,1,1
9691424,9691431,7,1,0,0,1
9691424,9691435,11,1,0,0,2
9691432,9692121,689,0,0,1,1
9691436,9692454,1018,0,0,1,2
9692122,9692128,6,1,0,0,1
9692129,9692304,175,0,0,1,1
9692305,9692343,38,1,0,0,1
9692344,9692450,106,0,0,1,1
9692451,9692548,97,1,0,0,1
9692455,9692620,165,1,0,0,2
9692512,9692532,20,0,1,0,2
9692549,9692771,222,0,0,1,1
9692621,9692774,153,0,0,1,2
9692772,9692859,87,1,0,0,1
9692775,9692861,86,1,0,0,2
9692860,9692948,88,0,0,1,1
9692862,9692946,84,0,0,1,2
9692947,9692979,32,1,0,0,2
9692949,9692970,21,1,0,0,1
9692971,9693155,184,0,0,1,1
9692980,9693154,174,0,0,1,2
9693155,9693184,29,1,0,0,2
9693156,9693175,19,1,0,0,1
9693176,9693488,312,0,0,1,1
9693185,9693930,745,0,0,1,2
9693489,9693507,18,1,0,0,1
9693508,9693929,421,0,0,1,1
9693930,9693962,32,1,0,0,1
9693931,9693952,21,1,0,0,2
9693953,9694091,138,0,0,1,2
9693963,9694087,124,0,0,1,1
9694088,9694105,17,1,0,0,1
9694092,9694106,14,1,0,0,2
9694106,9694406,300,0,0,1,1
9694107,9694411,304,0,0,1,2
9694407,9694707,300,1,0,0,1
9694412,9694819,407,1,0,0,2
9694425,9694808,383,0,1,0,2
9694431,9694697,266,0,1,0,1
9694708,9695049,341,0,0,1,1
9694820,9695050,230,0,0,1,2
9695050,9695116,66,1,0,0,1
9695051,9695124,73,1,0,0,2
9695117,9695473,356,0,0,1,1
9695125,9695472,347,0,0,1,2
9695473,9695556,83,1,0,0,2
9695474,9695547,73,1,0,0,1
9695548,9695657,109,0,0,1,1
9695557,9695657,100,0,0,1,2
9695658,9695689,31,1,0,0,1
9695658,9695691,33,1,0,0,2
9695690,9696318,628,0,0,1,1
9695692,9697610,1918,0,0,1,2
9696319,9696330,11,1,0,0,1
9696331,9697613,1282,0,0,1,1
9697611,9697872,261,1,0,0,2
9697614,9697857,243,1,0,0,1
9697709,9697841,132,0,1,0,2
9697714,9697818,104,0,1,0,1
9697858,9698016,158,0,0,1,1
9697873,9698017,144,0,0,1,2
9698017,9698114,97,1,0,0,1
9698018,9698107,89,1,0,0,2
9698108,9698279,171,0,0,1,2
9698115,9698276,161,0,0,1,1
9698277,9698299,22,1,0,0,1
9698280,9698298,18,1,0,0,2
9698299,9698426,127,0,0,1,2
9698300,9698427,127,0,0,1,1
9698427,9698444,17,1,0,0,2
9698428,9698443,15,1,0,0,1
9698444,9698847,403,0,0,1,1
9698445,9698649,204,0,0,1,2
9698650,9698661,11,1,0,0,2
9698662,9698849,187,0,0,1,2
9698848,9698863,15,1,0,0,1
9698850,9698862,12,1,0,0,2
9698863,9699211,348,0,0,1,2
9698864,9699211,347,0,0,1,1
9699212,9699232,20,1,0,0,2
9699212,9699233,21,1,0,0,1
9699233,9700191,958,0,0,1,2
9699234,9700193,959,0,0,1,1
9700192,9700288,96,1,0,0,2
9700194,9700289,95,1,0,0,1
9700289,9700365,76,0,0,1,2
9700290,9700367,77,0,0,1,1
9700366,9700394,28,1,0,0,2
9700368,9700395,27,1,0,0,1
9700395,9700578,183,0,0,1,2
9700396,9700576,180,0,0,1,1
9700577,9700645,68,1,0,0,1
9700579,9700646,67,1,0,0,2
9700646,9700791,145,0,0,1,1
9700647,9700791,144,0,0,1,2
9700792,9700823,31,1,0,0,2
9700792,9700824,32,1,0,0,1
9700824,9701008,184,0,0,1,2
9700825,9701009,184,0,0,1,1
9701009,9701013,4,1,0,0,2
9701010,9701015,5,1,0,0,1
9701014,9701262,248,0,0,1,2
9701016,9701259,243,0,0,1,1
9701260,9701272,12,1,0,0,1
9701263,9701276,13,1,0,0,2
9701273,9701820,547,0,0,1,1
9701277,9701815,538,0,0,1,2
9701816,9702033,217,1,0,0,2
9701821,9702005,184,1,0,0,1
9701841,9701984,143,0,1,0,2
9701849,9701958,109,0,1,0,1
9702006,9702933,927,0,0,1,1
9702034,9702205,171,0,0,1,2
9702206,9702224,18,1,0,0,2
9702225,9702933,708,0,0,1,2
9702934,9702991,57,1,0,0,1
9702934,9702999,65,1,0,0,2
9702992,9703338,346,0,0,1,1
9703000,9703338,338,0,0,1,2
9703339,9703415,76,1,0,0,1
9703339,9703418,79,1,0,0,2
9703416,9703480,64,0,0,1,1
9703419,9703480,61,0,0,1,2
9703481,9703515,34,1,0,0,2
9703481,9703516,35,1,0,0,1
9703516,9703632,116,0,0,1,2
9703517,9703629,112,0,0,1,1
9703630,9703659,29,1,0,0,1
9703633,9703650,17,1,0,0,2
9703651,9704035,384,0,0,1,2
9703660,9704033,373,0,0,1,1
9704034,9704054,20,1,0,0,1
9704036,9704053,17,1,0,0,2
9704054,9705000,946,0,0,1,2
9704055,9705000,945,0,0,1,1
9705001,9705171,170,1,0,0,1
9705001,9705182,181,1,0,0,2
9705017,9705149,132,0,1,0,2
9705019,9705139,120,0,1,0,1
9705172,9705519,347,0,0,1,1
9705183,9705520,337,0,0,1,2
9705520,9705561,41,1,0,0,1
9705521,9705552,31,1,0,0,2
9705553,9705894,341,0,0,1,2
9705562,9705894,332,0,0,1,1
9705895,9705956,61,1,0,0,2
9705895,9705971,76,1,0,0,1
9705957,9706059,102,0,0,1,2
9705972,9706061,89,0,0,1,1
9706060,9706095,35,1,0,0,2
9706062,9706093,31,1,0,0,1
9706094,9707904,1810,0,0,1,1
9706096,9707900,1804,0,0,1,2
9707901,9708128,227,1,0,0,2
9707905,9708082,177,1,0,0,1
9707929,9708070,141,0,1,0,2
9707938,9708045,107,0,1,0,1
9708083,9708363,280,0,0,1,1
9708129,9708364,235,0,0,1,2
9708364,9708428,64,1,0,0,1
9708365,9708427,62,1,0,0,2
9708428,9708576,148,0,0,1,2
9708429,9708578,149,0,0,1,1
9708577,9708605,28,1,0,0,2
9708579,9708597,18,1,0,0,1
9708598,9710151,1553,0,0,1,1
9708606,9710135,1529,0,0,1,2
9710136,9710160,24,1,0,0,2
9710152,9710160,8,1,0,0,1
9710161,9710691,530,0,0,1,1
9710161,9710695,534,0,0,1,2
9710692,9710803,111,1,0,0,1
9710696,9710812,116,1,0,0,2
9710804,9710995,191,0,0,1,1
9710813,9710996,183,0,0,1,2
9710996,9711028,32,1,0,0,1
9710997,9711028,31,1,0,0,2
9711029,9711123,94,0,0,1,2
9711029,9711134,105,0,0,1,1
9711124,9711388,264,1,0,0,2
9711135,9711330,195,1,0,0,1
9711145,9711326,181,0,1,0,2
9711150,9711313,163,0,1,0,1
9711331,9711483,152,0,0,1,1
9711389,9711483,94,0,0,1,2
9711484,9711506,22,1,0,0,2
9711484,9711515,31,1,0,0,1
9711507,9711748,241,0,0,1,2
9711516,9711748,232,0,0,1,1
9711749,9711760,11,1,0,0,1
9711749,9711766,17,1,0,0,2
9711761,9712017,256,0,0,1,1
9711767,9714005,2238,0,0,1,2
9712018,9712029,11,1,0,0,1
9712030,9714004,1974,0,0,1,1
9714005,9714047,42,1,0,0,1
9714006,9714052,46,1,0,0,2
9714048,9714494,446,0,0,1,1
9714053,9714495,442,0,0,1,2
9714495,9714513,18,1,0,0,1
9714496,9714514,18,1,0,0,2
9714514,9714715,201,0,0,1,1
9714515,9714710,195,0,0,1,2
9714711,9714902,191,1,0,0,2
9714716,9714858,142,1,0,0,1
9714729,9714850,121,0,1,0,2
9714738,9714809,71,0,1,0,1
9714859,9716072,1213,0,0,1,1
9714903,9716070,1167,0,0,1,2
9716071,9716316,245,1,0,0,2
9716073,9716273,200,1,0,0,1
9716103,9716263,160,0,1,0,2
9716108,9716249,141,0,1,0,1
9716274,9716496,222,0,0,1,1
9716317,9716495,178,0,0,1,2
9716496,9716523,27,1,0,0,2
9716497,9716523,26,1,0,0,1
9716524,9716672,148,0,0,1,2
9716524,9716673,149,0,0,1,1
9716673,9716704,31,1,0,0,2
9716674,9716702,28,1,0,0,1
9716703,9718030,1327,0,0,1,1
9716705,9718030,1325,0,0,1,2
9718031,9718109,78,1,0,0,1
9718031,9718112,81,1,0,0,2
9718110,9719017,907,0,0,1,1
9718113,9719025,912,0,0,1,2
9719018,9719031,13,1,0,0,1
9719026,9719030,4,1,0,0,2
9719031,9720576,1545,0,0,1,2
9719032,9720575,1543,0,0,1,1
9720576,9720853,277,1,0,0,1
9720577,9720894,317,1,0,0,2
9720645,9720847,202,0,1,0,2
9720657,9720830,173,0,1,0,1
9720854,9721090,236,0,0,1,1
9720895,9721091,196,0,0,1,2
9721091,9721114,23,1,0,0,1
9721092,9721112,20,1,0,0,2
9721113,9722221,1108,0,0,1,2
9721115,9722221,1106,0,0,1,1
9722222,9722240,18,1,0,0,1
9722222,9722243,21,1,0,0,2
9722241,9722670,429,0,0,1,1
9722244,9722668,424,0,0,1,2
9722669,9722995,326,1,0,0,2
9722671,9722944,273,1,0,0,1
9722718,9722936,218,0,1,0,2
9722728,9722911,183,0,1,0,1
9722945,9723188,243,0,0,1,1
9722996,9723189,193,0,0,1,2
9723189,9723195,6,1,0,0,1
9723190,9723199,9,1,0,0,2
9723196,9723426,230,0,0,1,1
9723200,9723426,226,0,0,1,2
9723427,9723438,11,1,0,0,1
9723427,9723438,11,1,0,0,2
9723439,9723821,382,0,0,1,1
9723439,9723822,383,0,0,1,2
9723822,9723866,44,1,0,0,1
9723823,9723874,51,1,0,0,2
9723867,9724543,676,0,0,1,1
9723875,9724545,670,0,0,1,2
9724544,9724626,82,1,0,0,1
9724546,9724633,87,1,0,0,2
9724627,9724858,231,0,0,1,1
9724634,9725061,427,0,0,1,2
9724859,9724865,6,1,0,0,1
9724866,9725058,192,0,0,1,1
9725059,9725295,236,1,0,0,1
9725062,9725323,261,1,0,0,2
9725078,9725279,201,0,1,0,2
9725082,9725282,200,0,1,0,1
9725296,9725339,43,0,0,1,1
9725324,9726142,818,0,0,1,2
9725340,9725346,6,1,0,0,1
9725347,9726142,795,0,0,1,1
9726143,9726199,56,1,0,0,1
9726143,9726210,67,1,0,0,2
9726200,9726600,400,0,0,1,1
9726211,9726600,389,0,0,1,2
9726601,9726623,22,1,0,0,1
9726601,9726632,31,1,0,0,2
9726624,9726995,371,0,0,1,1
9726633,9726995,362,0,0,1,2
9726996,9727015,19,1,0,0,2
9726996,9727016,20,1,0,0,1
9727016,9727271,255,0,0,1,2
9727017,9727270,253,0,0,1,1
9727271,9727292,21,1,0,0,1
9727272,9727301,29,1,0,0,2
9727293,9728165,872,0,0,1,1
9727302,9728163,861,0,0,1,2
9728164,9728609,445,1,0,0,2
9728166,9728611,445,1,0,0,1
9728192,9728598,406,0,1,0,2
9728194,9728600,406,0,1,0,1
9728610,9728765,155,0,0,1,2
9728612,9728768,156,0,0,1,1
9728766,9729257,491,1,0,0,2
9728769,9729260,491,1,0,0,1
9728790,9729250,460,0,1,0,1
9728807,9729246,439,0,1,0,2
9729258,9729432,174,0,0,1,2
9729261,9729432,171,0,0,1,1
9729433,9729518,85,1,0,0,1
9729433,9729518,85,1,0,0,2
9729519,9729563,44,0,0,1,2
9729519,9729564,45,0,0,1,1
9729564,9729602,38,1,0,0,2
9729565,9729598,33,1,0,0,1
9729599,9729671,72,0,0,1,1
9729603,9729783,180,0,0,1,2
9729672,9729694,22,1,0,0,1
9729695,9729783,88,0,0,1,1
9729784,9729804,20,1,0,0,2
9729784,9729806,22,1,0,0,1
9729805,9729970,165,0,0,1,2
9729807,9729970,163,0,0,1,1
9729971,9729994,23,1,0,0,2
9729971,9730004,33,1,0,0,1
9729995,9730252,257,0,0,1,2
9730005,9730253,248,0,0,1,1
9730253,9730265,12,1,0,0,2
9730254,9730263,9,1,0,0,1
9730264,9731817,1553,0,0,1,1
9730266,9731814,1548,0,0,1,2
9731815,9731906,91,1,0,0,2
9731818,9731882,64,1,0,0,1
9731883,9731905,22,0,0,1,1
9731906,9731910,4,1,0,0,1
9731907,9731971,64,0,0,1,2
9731911,9731972,61,0,0,1,1
9731972,9731993,21,1,0,0,2
9731973,9731991,18,1,0,0,1
9731992,9732245,253,0,0,1,1
9731994,9732377,383,0,0,1,2
9732246,9732258,12,1,0,0,1
9732259,9732372,113,0,0,1,1
9732373,9732387,14,1,0,0,1
9732378,9732386,8,1,0,0,2
9732387,9732770,383,0,0,1,2
9732388,9732766,378,0,0,1,1
9732767,9732780,13,1,0,0,1
9732771,9732783,12,1,0,0,2
9732781,9732937,156,0,0,1,1
9732784,9733386,602,0,0,1,2
9732938,9732945,7,1,0,0,1
9732946,9734023,1077,0,0,1,1
9733387,9734368,981,1,0,0,2
9733507,9734359,852,0,1,0,2
9734034,9734041,7,0,1,0,1
9734050,9734050,0,1,0,0,1
9734051,9734572,521,0,0,1,1
9734369,9734582,213,0,0,1,2
9734573,9734588,15,1,0,0,1
9734583,9734589,6,1,0,0,2
9734589,9734700,111,0,0,1,1
9734590,9734698,108,0,0,1,2
9734699,9734728,29,1,0,0,2
9734701,9734721,20,1,0,0,1
9734722,9734772,50,0,0,1,1
9734729,9734770,41,0,0,1,2
9734771,9734792,21,1,0,0,2
9734773,9734784,11,1,0,0,1
9734785,9735512,727,0,0,1,1
9734793,9735512,719,0,0,1,2
9735513,9735565,52,1,0,0,1
9735513,9735572,59,1,0,0,2
9735566,9735762,196,0,0,1,1
9735573,9735763,190,0,0,1,2
9735763,9735827,64,1,0,0,1
9735764,9735833,69,1,0,0,2
9735828,9735943,115,0,0,1,1
9735834,9735942,108,0,0,1,2
9735943,9735975,32,1,0,0,2
9735944,9735965,21,1,0,0,1
9735966,9736621,655,0,0,1,1
9735976,9736621,645,0,0,1,2
9736622,9736654,32,1,0,0,2
9736622,9736655,33,1,0,0,1
9736655,9736763,108,0,0,1,2
9736656,9736765,109,0,0,1,1
9736764,9736950,186,1,0,0,2
9736766,9736925,159,1,0,0,1
9736783,9736907,124,0,1,0,2
9736786,9736895,109,0,1,0,1
9736926,9737087,161,0,0,1,1
9736951,9737088,137,0,0,1,2
9737088,9737120,32,1,0,0,1
9737089,9737117,28,1,0,0,2
9737118,9738226,1108,0,0,1,2
9737121,9738227,1106,0,0,1,1
9738227,9738274,47,1,0,0,2
9738228,9738274,46,1,0,0,1
9738275,9738337,62,0,0,1,1
9738275,9738338,63,0,0,1,2
9738338,9738496,158,1,0,0,1
9738339,9738511,172,1,0,0,2
9738359,9738454,95,0,1,0,2
9738360,9738448,88,0,1,0,1
9738497,9740297,1800,0,0,1,1
9738512,9740294,1782,0,0,1,2
9740295,9740546,251,1,0,0,2
9740298,9740541,243,1,0,0,1
9740317,9740504,187,0,1,0,1
9740319,9740505,186,0,1,0,2
9740542,9740717,175,0,0,1,1
9740547,9740712,165,0,0,1,2
9740713,9740956,243,1,0,0,2
9740718,9740947,229,1,0,0,1
9740734,9740910,176,0,1,0,1
9740737,9740911,174,0,1,0,2
9740948,9741539,591,0,0,1,1
9740957,9741540,583,0,0,1,2
9741540,9741563,23,1,0,0,1
9741541,9741563,22,1,0,0,2
9741564,9742065,501,0,0,1,2
9741564,9742066,502,0,0,1,1
9742066,9742291,225,1,0,0,2
9742067,9742173,106,1,0,0,1
9742174,9742250,76,0,0,1,1
9742183,9742244,61,0,1,0,2
9742251,9742275,24,1,0,0,1
9742276,9742352,76,0,0,1,1
9742292,9742352,60,0,0,1,2
9742353,9742377,24,1,0,0,2
9742353,9742387,34,1,0,0,1
9742378,9742418,40,0,0,1,2
9742388,9742564,176,0,0,1,1
9742419,9742457,38,1,0,0,2
9742458,9742562,104,0,0,1,2
9742563,9742579,16,1,0,0,2
9742565,9742579,14,1,0,0,1
9742580,9742928,348,0,0,1,2
9742580,9742933,353,0,0,1,1
9742929,9742948,19,1,0,0,2
9742934,9742947,13,1,0,0,1
9742948,9743119,171,0,0,1,1
9742949,9743120,171,0,0,1,2
9743120,9743131,11,1,0,0,1
9743121,9743132,11,1,0,0,2
9743132,9743382,250,0,0,1,1
9743133,9743387,254,0,0,1,2
9743383,9743400,17,1,0,0,1
9743388,9743400,12,1,0,0,2
9743401,9744079,678,0,0,1,2
9743401,9744510,1109,0,0,1,1
9744080,9744084,4,1,0,0,2
9744085,9744513,428,0,0,1,2
9744511,9744924,413,1,0,0,1
9744514,9744940,426,1,0,0,2
9744574,9744921,347,0,1,0,2
9744580,9744914,334,0,1,0,1
9744925,9745444,519,0,0,1,1
9744941,9745014,73,0,0,1,2
9745015,9745177,162,1,0,0,2
9745178,9745264,86,0,0,1,2
9745265,9745348,83,1,0,0,2
9745349,9745396,47,0,0,1,2
9745397,9745411,14,1,0,0,2
9745412,9745440,28,0,0,1,2
9745441,9745451,10,1,0,0,2
9745445,9745449,4,1,0,0,1
9745450,9745849,399,0,0,1,1
9745452,9745620,168,0,0,1,2
9745631,9745981,350,0,1,0,2
9745850,9745857,7,1,0,0,1
9745858,9746680,822,0,0,1,1
9745991,9747374,1383,1,0,0,2
9746016,9747268,1252,0,1,0,2
9746681,9747275,594,1,0,0,1
9746695,9747245,550,0,1,0,1
9747276,9747518,242,0,0,1,1
9747375,9747517,142,0,0,1,2
9747518,9747555,37,1,0,0,2
9747519,9747540,21,1,0,0,1
9747541,9748132,591,0,0,1,1
9747556,9748133,577,0,0,1,2
9748133,9748185,52,1,0,0,1
9748134,9748182,48,1,0,0,2
9748183,9748385,202,0,0,1,2
9748186,9748383,197,0,0,1,1
9748384,9748400,16,1,0,0,1
9748386,9748399,13,1,0,0,2
9748400,9748865,465,0,0,1,2
9748401,9748627,226,0,0,1,1
9748628,9748640,12,1,0,0,1
9748641,9748864,223,0,0,1,1
9748865,9748876,11,1,0,0,1
9748866,9748876,10,1,0,0,2
9748877,9750744,1867,0,0,1,1
9748877,9750745,1868,0,0,1,2
9750745,9750801,56,1,0,0,1
9750746,9750798,52,1,0,0,2
9750799,9751117,318,0,0,1,2
9750802,9751116,314,0,0,1,1
9751117,9751155,38,1,0,0,1
9751118,9751153,35,1,0,0,2
9751154,9751456,302,0,0,1,2
9751156,9751470,314,0,0,1,1
9751457,9751680,223,1,0,0,2
9751471,9751669,198,1,0,0,1
9751489,9751635,146,0,1,0,2
9751495,9751611,116,0,1,0,1
9751670,9752817,1147,0,0,1,1
9751681,9752816,1135,0,0,1,2
9752817,9752876,59,1,0,0,2
9752818,9752843,25,1,0,0,1
9752844,9753030,186,0,0,1,1
9752877,9753013,136,0,0,1,2
9753014,9753401,387,1,0,0,2
9753031,9753394,363,1,0,0,1
9753046,9753390,344,0,1,0,2
9753049,9753383,334,0,1,0,1
9753395,9753659,264,0,0,1,1
9753402,9753769,367,0,0,1,2
9753660,9753672,12,1,0,0,1
9753673,9753767,94,0,0,1,1
9753768,9753785,17,1,0,0,1
9753770,9753790,20,1,0,0,2
9753786,9754014,228,0,0,1,1
9753791,9754012,221,0,0,1,2
9754013,9754059,46,1,0,0,2
9754015,9754057,42,1,0,0,1
9754058,9754733,675,0,0,1,1
9754060,9754735,675,0,0,1,2
9754734,9754789,55,1,0,0,1
9754736,9754804,68,1,0,0,2
9754790,9754893,103,0,0,1,1
9754805,9754893,88,0,0,1,2
9754894,9754915,21,1,0,0,1
9754894,9754917,23,1,0,0,2
9754916,9755166,250,0,0,1,1
9754918,9757135,2217,0,0,1,2
9755167,9755179,12,1,0,0,1
9755180,9757132,1952,0,0,1,1
9757133,9757367,234,1,0,0,1
9757136,9757396,260,1,0,0,2
9757204,9757342,138,0,1,0,2
9757211,9757322,111,0,1,0,1
9757368,9757504,136,0,0,1,1
9757397,9757504,107,0,0,1,2
9757505,9757526,21,1,0,0,2
9757505,9757536,31,1,0,0,1
9757527,9758226,699,0,0,1,2
9757537,9758038,501,0,0,1,1
9758039,9758043,4,1,0,0,1
9758044,9758415,371,0,0,1,1
9758227,9758232,5,1,0,0,2
9758233,9758417,184,0,0,1,2
9758416,9758431,15,1,0,0,1
9758418,9758428,10,1,0,0,2
9758429,9758964,535,0,0,1,2
9758432,9758965,533,0,0,1,1
9758965,9758976,11,1,0,0,2
9758966,9758978,12,1,0,0,1
9758977,9759114,137,0,0,1,2
9758979,9759109,130,0,0,1,1
9759110,9759126,16,1,0,0,1
9759115,9759124,9,1,0,0,2
9759125,9759378,253,0,0,1,2
9759127,9759384,257,0,0,1,1
9759379,9759767,388,1,0,0,2
9759385,9759750,365,1,0,0,1
9759414,9759748,334,0,1,0,2
9759427,9759700,273,0,1,0,1
9759751,9760097,346,0,0,1,1
9759768,9760100,332,0,0,1,2
9760098,9760111,13,1,0,0,1
9760101,9760112,11,1,0,0,2
9760112,9760786,674,0,0,1,1
9760113,9760298,185,0,0,1,2
9760299,9760303,4,1,0,0,2
9760304,9760782,478,0,0,1,2
9760783,9760808,25,1,0,0,2
9760787,9760806,19,1,0,0,1
9760807,9760980,173,0,0,1,1
9760809,9760976,167,0,0,1,2
9760977,9761091,114,1,0,0,2
9760981,9761080,99,1,0,0,1
9761081,9761490,409,0,0,1,1
9761092,9761486,394,0,0,1,2
9761487,9761520,33,1,0,0,2
9761491,9761513,22,1,0,0,1
9761514,9761736,222,0,0,1,1
9761521,9761733,212,0,0,1,2
9761734,9761757,23,1,0,0,2
9761737,9761757,20,1,0,0,1
9761758,9762692,934,0,0,1,2
9761758,9762695,937,0,0,1,1
9762693,9762713,20,1,0,0,2
9762696,9762714,18,1,0,0,1
9762714,9762944,230,0,0,1,2
9762715,9762943,228,0,0,1,1
9762944,9762973,29,1,0,0,1
9762945,9762965,20,1,0,0,2
9762966,9763478,512,0,0,1,2
9762974,9763479,505,0,0,1,1
9763479,9763674,195,1,0,0,2
9763480,9763653,173,1,0,0,1
9763499,9763624,125,0,1,0,1
9763499,9763632,133,0,1,0,2
9763654,9763959,305,0,0,1,1
9763675,9763961,286,0,0,1,2
9763960,9763983,23,1,0,0,1
9763962,9763990,28,1,0,0,2
9763984,9764209,225,0,0,1,1
9763991,9764210,219,0,0,1,2
9764210,9764271,61,1,0,0,1
9764211,9764273,62,1,0,0,2
9764272,9764723,451,0,0,1,1
9764274,9764726,452,0,0,1,2
9764724,9764746,22,1,0,0,1
9764727,9764744,17,1,0,0,2
9764745,9765016,271,0,0,1,2
9764747,9765009,262,0,0,1,1
9765010,9765038,28,1,0,0,1
9765017,9765029,12,1,0,0,2
9765030,9766364,1334,0,0,1,2
9765039,9766367,1328,0,0,1,1
9766365,9766695,330,1,0,0,2
9766368,9766663,295,1,0,0,1
9766412,9766634,222,0,1,0,2
9766416,9766621,205,0,1,0,1
9766664,9766834,170,0,0,1,1
9766696,9766832,136,0,0,1,2
9766833,9766859,26,1,0,0,2
9766835,9766859,24,1,0,0,1
9766860,9767146,286,0,0,1,1
9766860,9767148,288,0,0,1,2
9767147,9767353,206,1,0,0,1
9767149,9767376,227,1,0,0,2
9767164,9767331,167,0,1,0,1
9767166,9767333,167,0,1,0,2
9767354,9767982,628,0,0,1,1
9767377,9767982,605,0,0,1,2
9767983,9768025,42,1,0,0,1
9767983,9768036,53,1,0,0,2
9768026,9768468,442,0,0,1,1
9768037,9768466,429,0,0,1,2
9768467,9768495,28,1,0,0,2
9768469,9768497,28,1,0,0,1
9768496,9768635,139,0,0,1,2
9768498,9768636,138,0,0,1,1
9768636,9768649,13,1,0,0,2
9768637,9768647,10,1,0,0,1
9768648,9769852,1204,0,0,1,1
9768650,9769849,1199,0,0,1,2
9769850,9769934,84,1,0,0,2
9769853,9769915,62,1,0,0,1
9769916,9770012,96,0,0,1,1
9769935,9770012,77,0,0,1,2
9770013,9770034,21,1,0,0,1
9770013,9770036,23,1,0,0,2
9770035,9770208,173,0,0,1,1
9770037,9770215,178,0,0,1,2
9770209,9770221,12,1,0,0,1
9770216,9770221,5,1,0,0,2
9770222,9770452,230,0,0,1,1
9770222,9770456,234,0,0,1,2
9770453,9770471,18,1,0,0,1
9770457,9770470,13,1,0,0,2
9770471,9770588,117,0,0,1,2
9770472,9770604,132,0,0,1,1
9770589,9770904,315,1,0,0,2
9770605,9770841,236,1,0,0,1
9770620,9770823,203,0,1,0,1
9770624,9770852,228,0,1,0,2
9770842,9771004,162,0,0,1,1
9770905,9771004,99,0,0,1,2
9771005,9771013,8,1,0,0,1
9771005,9771013,8,1,0,0,2
9771014,9771206,192,0,0,1,1
9771014,9771207,193,0,0,1,2
9771207,9771229,22,1,0,0,1
9771208,9771228,20,1,0,0,2
9771229,9771551,322,0,0,1,2
9771230,9771551,321,0,0,1,1
9771552,9771573,21,1,0,0,1
9771552,9771574,22,1,0,0,2
9771574,9771961,387,0,0,1,1
9771575,9771961,386,0,0,1,2
9771962,9772363,401,1,0,0,1
9771962,9772384,422,1,0,0,2
9772025,9772373,348,0,1,0,2
9772029,9772332,303,0,1,0,1
9772364,9772685,321,0,0,1,1
9772385,9772688,303,0,0,1,2
9772686,9772989,303,1,0,0,1
9772689,9772982,293,1,0,0,2
9772702,9772937,235,0,1,0,1
9772712,9772936,224,0,1,0,2
9772983,9773009,26,0,0,1,2
9772990,9773184,194,0,0,1,1
9773010,9773015,5,1,0,0,2
9773016,9773540,524,0,0,1,2
9773185,9773196,11,1,0,0,1
9773197,9773540,343,0,0,1,1
9773541,9773600,59,1,0,0,1
9773541,9773602,61,1,0,0,2
9773601,9773679,78,0,0,1,1
9773603,9773678,75,0,0,1,2
9773679,9773696,17,1,0,0,2
9773680,9773693,13,1,0,0,1
9773694,9773759,65,0,0,1,1
9773697,9773763,66,0,0,1,2
9773760,9773787,27,1,0,0,1
9773764,9773788,24,1,0,0,2
9773788,9773834,46,0,0,1,1
9773789,9773836,47,0,0,1,2
9773835,9773851,16,1,0,0,1
9773837,9773856,19,1,0,0,2
9773852,9773987,135,0,0,1,1
9773857,9773987,130,0,0,1,2
9773988,9773994,6,1,0,0,1
9773988,9773996,8,1,0,0,2
9773995,9774110,115,0,0,1,1
9773997,9774110,113,0,0,1,2
9774111,9774126,15,1,0,0,1
9774111,9774126,15,1,0,0,2
9774127,9774279,152,0,0,1,1
9774127,9774280,153,0,0,1,2
9774280,9774294,14,1,0,0,1
9774281,9774291,10,1,0,0,2
9774292,9774415,123,0,0,1,2
9774295,9774416,121,0,0,1,1
9774416,9774430,14,1,0,0,2
9774417,9774424,7,1,0,0,1
9774425,9774687,262,0,0,1,1
9774431,9774688,257,0,0,1,2
9774688,9774700,12,1,0,0,1
9774689,9774701,12,1,0,0,2
9774701,9775113,412,0,0,1,1
9774702,9775113,411,0,0,1,2
9775114,9775119,5,1,0,0,1
9775114,9775122,8,1,0,0,2
9775120,9775375,255,0,0,1,1
9775123,9775227,104,0,0,1,2
9775228,9775236,8,1,0,0,2
9775237,9775374,137,0,0,1,2
9775375,9775380,5,1,0,0,2
9775376,9775389,13,1,0,0,1
9775381,9775912,531,0,0,1,2
9775390,9775916,526,0,0,1,1
9775913,9776221,308,1,0,0,2
9775917,9776219,302,1,0,0,1
9775960,9776211,251,0,1,0,2
9775961,9776209,248,0,1,0,1
9776220,9776271,51,0,0,1,1
9776222,9776262,40,0,0,1,2
9776263,9776288,25,1,0,0,2
9776272,9776285,13,1,0,0,1
9776286,9776588,302,0,0,1,1
9776289,9776586,297,0,0,1,2
9776587,9776607,20,1,0,0,2
9776589,9776606,17,1,0,0,1
9776607,9778117,1510,0,0,1,1
9776608,9778119,1511,0,0,1,2
9778118,9778152,34,1,0,0,1
9778120,9778144,24,1,0,0,2
9778145,9778211,66,0,0,1,2
9778153,9778196,43,0,0,1,1
9778197,9778507,310,1,0,0,1
9778212,9778516,304,1,0,0,2
9778227,9778456,229,0,1,0,1
9778228,9778470,242,0,1,0,2
9778508,9778840,332,0,0,1,1
9778517,9778841,324,0,0,1,2
9778841,9778878,37,1,0,0,1
9778842,9778875,33,1,0,0,2
9778876,9779659,783,0,0,1,2
9778879,9779659,780,0,0,1,1
9779660,9779759,99,1,0,0,1
9779660,9779770,110,1,0,0,2
9779760,9779875,115,0,0,1,1
9779771,9779877,106,0,0,1,2
9779876,9779897,21,1,0,0,1
9779878,9779899,21,1,0,0,2
9779898,9780027,129,0,0,1,1
9779900,9780027,127,0,0,1,2
9780028,9780048,20,1,0,0,2
9780028,9780051,23,1,0,0,1
9780049,9780385,336,0,0,1,2
9780052,9780385,333,0,0,1,1
9780386,9780400,14,1,0,0,1
9780386,9780401,15,1,0,0,2
9780401,9780803,402,0,0,1,1
9780402,9780803,401,0,0,1,2
9780804,9780915,111,1,0,0,1
9780804,9780953,149,1,0,0,2
9780838,9780850,12,0,1,0,2
9780916,9781401,485,0,0,1,1
9780954,9781397,443,0,0,1,2
9781398,9781606,208,1,0,0,2
9781402,9781592,190,1,0,0,1
9781418,9781555,137,0,1,0,2
9781426,9781536,110,0,1,0,1
9781593,9781949,356,0,0,1,1
9781607,9781952,345,0,0,1,2
9781950,9782000,50,1,0,0,1
9781953,9782008,55,1,0,0,2
9782001,9782660,659,0,0,1,1
9782009,9782664,655,0,0,1,2
9782661,9782693,32,1,0,0,1
9782665,9782693,28,1,0,0,2
9782694,9783380,686,0,0,1,2
9782694,9783381,687,0,0,1,1
9783381,9783393,12,1,0,0,2
9783382,9783393,11,1,0,0,1
9783394,9784037,643,0,0,1,1
9783394,9784047,653,0,0,1,2
9784038,9784402,364,1,0,0,1
9784048,9784431,383,1,0,0,2
9784086,9784420,334,0,1,0,2
9784091,9784365,274,0,1,0,1
9784403,9784951,548,0,0,1,1
9784432,9784953,521,0,0,1,2
9784952,9784960,8,1,0,0,1
9784954,9784963,9,1,0,0,2
9784961,9785141,180,0,0,1,1
9784964,9785144,180,0,0,1,2
9785142,9785167,25,1,0,0,1
9785145,9785163,18,1,0,0,2
9785164,9785281,117,0,0,1,2
9785168,9785280,112,0,0,1,1
9785281,9785310,29,1,0,0,1
9785282,9785307,25,1,0,0,2
9785308,9785429,121,0,0,1,2
9785311,9785430,119,0,0,1,1
9785430,9785523,93,1,0,0,2
9785431,9785519,88,1,0,0,1
9785520,9785605,85,0,0,1,1
9785524,9785604,80,0,0,1,2
9785605,9785644,39,1,0,0,2
9785606,9785632,26,1,0,0,1
9785633,9785670,37,0,0,1,1
9785645,9785669,24,0,0,1,2
9785670,9785710,40,1,0,0,2
9785671,9785698,27,1,0,0,1
9785699,9785881,182,0,0,1,1
9785711,9785881,170,0,0,1,2
9785882,9785905,23,1,0,0,2
9785882,9785915,33,1,0,0,1
9785906,9786598,692,0,0,1,2
9785916,9786594,678,0,0,1,1
9786595,9786611,16,1,0,0,1
9786599,9786611,12,1,0,0,2
9786612,9787614,1002,0,0,1,2
9786612,9787617,1005,0,0,1,1
9787615,9787831,216,1,0,0,2
9787618,9787803,185,1,0,0,1
9787667,9787772,105,0,1,0,2
9787669,9787756,87,0,1,0,1
9787804,9787858,54,0,0,1,1
9787832,9787858,26,0,0,1,2
9787859,9787883,24,1,0,0,1
9787859,9787884,25,1,0,0,2
9787884,9788016,132,0,0,1,1
9787885,9788013,128,0,0,1,2
9788014,9788037,23,1,0,0,2
9788017,9788038,21,1,0,0,1
9788038,9788301,263,0,0,1,2
9788039,9788300,261,0,0,1,1
9788301,9788332,31,1,0,0,1
9788302,9788324,22,1,0,0,2
9788325,9789650,1325,0,0,1,2
9788333,9789166,833,0,0,1,1
9789167,9789174,7,1,0,0,1
9789175,9789652,477,0,0,1,1
9789651,9790136,485,1,0,0,2
9789653,9790136,483,1,0,0,1
9789686,9790092,406,0,1,0,2
9789690,9790095,405,0,1,0,1
9790137,9790373,236,0,0,1,2
9790137,9790374,237,0,0,1,1
9790374,9790381,7,1,0,0,2
9790375,9790382,7,1,0,0,1
9790382,9790603,221,0,0,1,2
9790383,9790602,219,0,0,1,1
9790603,9790626,23,1,0,0,1
9790604,9790626,22,1,0,0,2
9790627,9791196,569,0,0,1,2
9790627,9791197,570,0,0,1,1
9791197,9791275,78,1,0,0,2
9791198,9791277,79,1,0,0,1
9791276,9791639,363,0,0,1,2
9791278,9791640,362,0,0,1,1
9791640,9791660,20,1,0,0,2
9791641,9791661,20,1,0,0,1
9791661,9791935,274,0,0,1,2
9791662,9791941,279,0,0,1,1
9791936,9791961,25,1,0,0,2
9791942,9791954,12,1,0,0,1
9791955,9792247,292,0,0,1,1
9791962,9792247,285,0,0,1,2
9792248,9792252,4,1,0,0,2
9792248,9792259,11,1,0,0,1
9792253,9793393,1140,0,0,1,2
9792260,9793394,1134,0,0,1,1
9793394,9793406,12,1,0,0,2
9793395,9793407,12,1,0,0,1
9793407,9793835,428,0,0,1,2
9793408,9793835,427,0,0,1,1
9793836,9794038,202,1,0,0,1
9793836,9794074,238,1,0,0,2
9793886,9794002,116,0,1,0,2
9793898,9793978,80,0,1,0,1
9794039,9794210,171,0,0,1,1
9794075,9794210,135,0,0,1,2
9794211,9794223,12,1,0,0,2
9794211,9794224,13,1,0,0,1
9794224,9795585,1361,0,0,1,2
9794225,9795582,1357,0,0,1,1
9795583,9795602,19,1,0,0,1
9795586,9795625,39,1,0,0,2
9795603,9796030,427,0,0,1,1
9795626,9796028,402,0,0,1,2
9796029,9796318,289,1,0,0,2
9796031,9796306,275,1,0,0,1
9796068,9796278,210,0,1,0,2
9796075,9796271,196,0,1,0,1
9796307,9796378,71,0,0,1,1
9796319,9796377,58,0,0,1,2
9796378,9796402,24,1,0,0,2
9796379,9796398,19,1,0,0,1
9796399,9796626,227,0,0,1,1
9796403,9796629,226,0,0,1,2
9796627,9796654,27,1,0,0,1
9796630,9796656,26,1,0,0,2
9796655,9796925,270,0,0,1,1
9796657,9796925,268,0,0,1,2
9796926,9796950,24,1,0,0,2
9796926,9796953,27,1,0,0,1
9796951,9797849,898,0,0,1,2
9796954,9797848,894,0,0,1,1
9797849,9797919,70,1,0,0,1
9797850,9797929,79,1,0,0,2
9797920,9798021,101,0,0,1,1
9797930,9798023,93,0,0,1,2
9798022,9798063,41,1,0,0,1
9798024,9798054,30,1,0,0,2
9798055,9798224,169,0,0,1,2
9798064,9798219,155,0,0,1,1
9798220,9798236,16,1,0,0,1
9798225,9798236,11,1,0,0,2
9798237,9798421,184,0,0,1,1
9798237,9798423,186,0,0,1,2
9798422,9798443,21,1,0,0,1
9798424,9798442,18,1,0,0,2
9798443,9799744,1301,0,0,1,2
9798444,9799747,1303,0,0,1,1
9799745,9800069,324,1,0,0,2
9799748,9799766,18,1,0,0,1
9799767,9799821,54,0,0,1,1
9799822,9800077,255,1,0,0,1
9799847,9800015,168,0,1,0,2
9799848,9800011,163,0,1,0,1
9800070,9801236,1166,0,0,1,2
9800078,9801241,1163,0,0,1,1
9801237,9801255,18,1,0,0,2
9801242,9801256,14,1,0,0,1
9801256,9801925,669,0,0,1,2
9801257,9801902,645,0,0,1,1
9801903,9802702,799,1,0,0,1
9801926,9802661,735,1,0,0,2
9801967,9802634,667,0,1,0,2
9801967,9802672,705,0,1,0,1
9802662,9802690,28,0,0,1,2
9802691,9802704,13,1,0,0,2
9802703,9802769,66,0,0,1,1
9802705,9802821,116,0,0,1,2
9802770,9802783,13,1,0,0,1
9802784,9802813,29,0,0,1,1
9802814,9802841,27,1,0,0,1
9802822,9802844,22,1,0,0,2
9802842,9802905,63,0,0,1,1
9802845,9802902,57,0,0,1,2
9802903,9802939,36,1,0,0,2
9802906,9802929,23,1,0,0,1
9802930,9803234,304,0,0,1,1
9802940,9803235,295,0,0,1,2
9803235,9803265,30,1,0,0,1
9803236,9803262,26,1,0,0,2
9803263,9803344,81,0,0,1,2
9803266,9803343,77,0,0,1,1
9803344,9803373,29,1,0,0,1
9803345,9803373,28,1,0,0,2
9803374,9803640,266,0,0,1,2
9803374,9803642,268,0,0,1,1
9803641,9803727,86,1,0,0,2
9803643,9803719,76,1,0,0,1
9803720,9803928,208,0,0,1,1
9803728,9803925,197,0,0,1,2
9803926,9803948,22,1,0,0,2
9803929,9803947,18,1,0,0,1
9803948,9804923,975,0,0,1,1
9803949,9805734,1785,0,0,1,2
9804924,9804928,4,1,0,0,1
9804929,9805044,115,0,0,1,1
9805045,9805051,6,1,0,0,1
9805052,9805735,683,0,0,1,1
9805735,9805746,11,1,0,0,2
9805736,9805747,11,1,0,0,1
9805747,9806163,416,0,0,1,2
9805748,9806165,417,0,0,1,1
9806164,9806187,23,1,0,0,2
9806166,9806183,17,1,0,0,1
9806184,9806329,145,0,0,1,1
9806188,9806332,144,0,0,1,2
9806330,9806422,92,1,0,0,1
9806333,9806424,91,1,0,0,2
9806423,9806845,422,0,0,1,1
9806425,9806817,392,0,0,1,2
9806818,9807078,260,1,0,0,2
9806846,9807078,232,1,0,0,1
9806867,9807042,175,0,1,0,1
9806867,9807042,175,0,1,0,2
9807079,9808430,1351,0,0,1,2
9807079,9808438,1359,0,0,1,1
9808431,9809235,804,1,0,0,2
9808439,9809234,795,1,0,0,1
9808472,9809208,736,0,1,0,1
9808481,9809210,729,0,1,0,2
9809235,9809277,42,0,0,1,1
9809236,9809279,43,0,0,1,2
9809278,9809297,19,1,0,0,1
9809280,9809299,19,1,0,0,2
9809298,9809372,74,0,0,1,1
9809300,9809366,66,0,0,1,2
9809367,9809379,12,1,0,0,2
9809373,9809380,7,1,0,0,1
9809380,9809514,134,0,0,1,2
9809381,9809486,105,0,0,1,1
9809487,9809544,57,1,0,0,1
9809515,9809526,11,1,0,0,2
9809527,9809567,40,0,0,1,2
9809545,9809565,20,0,0,1,1
9809566,9809612,46,1,0,0,1
9809568,9809596,28,1,0,0,2
9809597,9809868,271,0,0,1,2
9809613,9809870,257,0,0,1,1
9809869,9809934,65,1,0,0,2
9809871,9809907,36,1,0,0,1
9809908,9810157,249,0,0,1,1
9809935,9810156,221,0,0,1,2
9810157,9810222,65,1,0,0,2
9810158,9810223,65,1,0,0,1
9810223,9810328,105,0,0,1,2
9810224,9810327,103,0,0,1,1
9810328,9810367,39,1,0,0,1
9810329,9810366,37,1,0,0,2
9810367,9811152,785,0,0,1,2
9810368,9811149,781,0,0,1,1
9811150,9811295,145,1,0,0,1
9811153,9811331,178,1,0,0,2
9811181,9811262,81,0,1,0,2
9811185,9811251,66,0,1,0,1
9811296,9811461,165,0,0,1,1
9811332,9811461,129,0,0,1,2
9811462,9811480,18,1,0,0,2
9811462,9811482,20,1,0,0,1
9811481,9812133,652,0,0,1,2
9811483,9812131,648,0,0,1,1
9812132,9812145,13,1,0,0,1
9812134,9812145,11,1,0,0,2
9812146,9812735,589,0,0,1,1
9812146,9812738,592,0,0,1,2
9812736,9812786,50,1,0,0,1
9812739,9812785,46,1,0,0,2
9812786,9813109,323,0,0,1,2
9812787,9813105,318,0,0,1,1
9813106,9813139,33,1,0,0,1
9813110,9813130,20,1,0,0,2
9813131,9813560,429,0,0,1,2
9813140,9813560,420,0,0,1,1
9813561,9813575,14,1,0,0,1
9813561,9813576,15,1,0,0,2
9813576,9814252,676,0,0,1,1
9813577,9814256,679,0,0,1,2
9814253,9814276,23,1,0,0,1
9814257,9814276,19,1,0,0,2
9814277,9814708,431,0,0,1,2
9814277,9814713,436,0,0,1,1
9814709,9815160,451,1,0,0,2
9814714,9815132,418,1,0,0,1
9814751,9815121,370,0,1,0,1
9814752,9815122,370,0,1,0,2
9815133,9815416,283,0,0,1,1
9815161,9815398,237,0,0,1,2
9815399,9815789,390,1,0,0,2
9815417,9815787,370,1,0,0,1
9815435,9815777,342,0,1,0,1
9815439,9815773,334,0,1,0,2
9815788,9815959,171,0,0,1,1
9815790,9815816,26,0,0,1,2
9815817,9815826,9,1,0,0,2
9815827,9815958,131,0,0,1,2
9815959,9815968,9,1,0,0,2
9815960,9815968,8,1,0,0,1
9815969,9816366,397,0,0,1,2
9815969,9816368,399,0,0,1,1
9816367,9816445,78,1,0,0,2
9816369,9816446,77,1,0,0,1
9816446,9816712,266,0,0,1,2
9816447,9816716,269,0,0,1,1
9816713,9816750,37,1,0,0,2
9816717,9816747,30,1,0,0,1
9816748,9817580,832,0,0,1,1
9816751,9817592,841,0,0,1,2
9817581,9817602,21,1,0,0,1
9817593,9817599,6,1,0,0,2
9817600,9818681,1081,0,0,1,2
9817603,9818681,1078,0,0,1,1
9818682,9818913,231,1,0,0,1
9818682,9818931,249,1,0,0,2
9818727,9818890,163,0,1,0,2
9818729,9818883,154,0,1,0,1
9818914,9819052,138,0,0,1,1
9818932,9819052,120,0,0,1,2
9819053,9819085,32,1,0,0,2
9819053,9819086,33,1,0,0,1
9819086,9820739,1653,0,0,1,2
9819087,9820746,1659,0,0,1,1
9820740,9821074,334,1,0,0,2
9820747,9821059,312,1,0,0,1
9820766,9821032,266,0,1,0,1
9820774,9821041,267,0,1,0,2
9821060,9821414,354,0,0,1,1
9821075,9821413,338,0,0,1,2
9821414,9821448,34,1,0,0,2
9821415,9821454,39,1,0,0,1
9821449,9821976,527,0,0,1,2
9821455,9821976,521,0,0,1,1
9821977,9822076,99,1,0,0,1
9821977,9822083,106,1,0,0,2
9822077,9822164,87,0,0,1,1
9822084,9822165,81,0,0,1,2
9822165,9822195,30,1,0,0,1
9822166,9822189,23,1,0,0,2
9822190,9822214,24,0,0,1,2
9822196,9822391,195,0,0,1,1
9822215,9822233,18,1,0,0,2
9822234,9822392,158,0,0,1,2
9822392,9822419,27,1,0,0,1
9822393,9822427,34,1,0,0,2
9822420,9822726,306,0,0,1,1
9822428,9822699,271,0,0,1,2
9822700,9823057,357,1,0,0,2
9822727,9822994,267,1,0,0,1
9822732,9823016,284,0,1,0,2
9822740,9822974,234,0,1,0,1
9822995,9823164,169,0,0,1,1
9823058,9823114,56,0,0,1,2
9823115,9823132,17,1,0,0,2
9823133,9823161,28,0,0,1,2
9823162,9823198,36,1,0,0,2
9823165,9823169,4,1,0,0,1
9823170,9824812,1642,0,0,1,1
9823199,9824389,1190,0,0,1,2
9824390,9824419,29,1,0,0,2
9824420,9824814,394,0,0,1,2
9824813,9824873,60,1,0,0,1
9824815,9824885,70,1,0,0,2
9824874,9825033,159,0,0,1,1
9824886,9825032,146,0,0,1,2
9825033,9825060,27,1,0,0,2
9825034,9825055,21,1,0,0,1
9825056,9825431,375,0,0,1,1
9825061,9825421,360,0,0,1,2
9825422,9825641,219,1,0,0,2
9825432,9825582,150,1,0,0,1
9825445,9825586,141,0,1,0,2
9825454,9825553,99,0,1,0,1
9825583,9826898,1315,0,0,1,1
9825642,9826900,1258,0,0,1,2
9826899,9827246,347,1,0,0,1
9826901,9827573,672,1,0,0,2
9826930,9827265,335,0,1,0,2
9826937,9827211,274,0,1,0,1
9827247,9827284,37,0,0,1,1
9827285,9827541,256,1,0,0,1
9827299,9827523,224,0,1,0,2
9827302,9827512,210,0,1,0,1
9827542,9827716,174,0,0,1,1
9827574,9827717,143,0,0,1,2
9827717,9827744,27,1,0,0,1
9827718,9827757,39,1,0,0,2
9827745,9827934,189,0,0,1,1
9827758,9827935,177,0,0,1,2
9827935,9827960,25,1,0,0,1
9827936,9827960,24,1,0,0,2
9827961,9828597,636,0,0,1,1
9827961,9828598,637,0,0,1,2
9828598,9828674,76,1,0,0,1
9828599,9828676,77,1,0,0,2
9828675,9828803,128,0,0,1,1
9828677,9828799,122,0,0,1,2
9828800,9829097,297,1,0,0,2
9828804,9829055,251,1,0,0,1
9828819,9829055,236,0,1,0,2
9828821,9829035,214,0,1,0,1
9829056,9829167,111,0,0,1,1
9829098,9829169,71,0,0,1,2
9829168,9829199,31,1,0,0,1
9829170,9829189,19,1,0,0,2
9829190,9829441,251,0,0,1,2
9829200,9829440,240,0,0,1,1
9829441,9829454,13,1,0,0,1
9829442,9829452,10,1,0,0,2
9829453,9830343,890,0,0,1,2
9829455,9830342,887,0,0,1,1
9830343,9830391,48,1,0,0,1
9830344,9830400,56,1,0,0,2
9830392,9830589,197,0,0,1,1
9830401,9830579,178,0,0,1,2
9830580,9830863,283,1,0,0,2
9830590,9830824,234,1,0,0,1
9830605,9830813,208,0,1,0,2
9830611,9830798,187,0,1,0,1
9830825,9832372,1547,0,0,1,1
9830864,9832369,1505,0,0,1,2
9832370,9832839,469,1,0,0,2
9832373,9832827,454,1,0,0,1
9832406,9832812,406,0,1,0,2
9832411,9832817,406,0,1,0,1
9832828,9833735,907,0,0,1,1
9832840,9833735,895,0,0,1,2
9833736,9833813,77,1,0,0,1
9833736,9833839,103,1,0,0,2
9833814,9833924,110,0,0,1,1
9833840,9833923,83,0,0,1,2
9833924,9833953,29,1,0,0,2
9833925,9833946,21,1,0,0,1
9833947,9834788,841,0,0,1,1
9833954,9834031,77,0,0,1,2
9834032,9834050,18,1,0,0,2
9834051,9835396,1345,0,0,1,2
9834789,9834804,15,1,0,0,1
9834805,9835747,942,0,0,1,1
9835397,9835417,20,1,0,0,2
9835418,9835452,34,0,0,1,2
9835453,9835469,16,1,0,0,2
9835470,9835749,279,0,0,1,2
9835748,9835794,46,1,0,0,1
9835750,9835795,45,1,0,0,2
9835795,9835862,67,0,0,1,1
9835796,9835835,39,0,0,1,2
9835836,9836199,363,1,0,0,2
9835863,9836137,274,1,0,0,1
9835875,9836137,262,0,1,0,2
9835883,9836116,233,0,1,0,1
9836138,9836264,126,0,0,1,1
9836200,9836235,35,0,0,1,2
9836236,9836295,59,1,0,0,2
9836265,9836298,33,1,0,0,1
9836296,9837820,1524,0,0,1,2
9836299,9837830,1531,0,0,1,1
9837821,9838195,374,1,0,0,2
9837831,9838134,303,1,0,0,1
9837853,9838127,274,0,1,0,2
9837857,9838111,254,0,1,0,1
9838135,9838167,32,0,0,1,1
9838168,9838192,24,1,0,0,1
9838193,9839143,950,0,0,1,1
9838196,9839144,948,0,0,1,2
9839144,9839220,76,1,0,0,1
9839145,9839222,77,1,0,0,2
9839221,9839326,105,0,0,1,1
9839223,9839328,105,0,0,1,2
9839327,9839353,26,1,0,0,1
9839329,9839365,36,1,0,0,2
9839354,9839509,155,0,0,1,1
9839366,9839510,144,0,0,1,2
9839510,9839751,241,1,0,0,1
9839511,9839756,245,1,0,0,2
9839527,9839718,191,0,1,0,1
9839527,9839720,193,0,1,0,2
9839752,9839862,110,0,0,1,1
9839757,9839863,106,0,0,1,2
9839863,9839883,20,1,0,0,1
9839864,9839894,30,1,0,0,2
9839884,9840851,967,0,0,1,1
9839895,9840851,956,0,0,1,2
9840852,9841142,290,1,0,0,1
9840852,9841151,299,1,0,0,2
9840897,9841125,228,0,1,0,1
9840899,9841128,229,0,1,0,2
9841143,9841209,66,0,0,1,1
9841152,9841210,58,0,0,1,2
9841210,9841236,26,1,0,0,1
9841211,9841235,24,1,0,0,2
9841236,9841388,152,0,0,1,2
9841237,9841388,151,0,0,1,1
9841389,9841408,19,1,0,0,1
9841389,9841408,19,1,0,0,2
9841409,9841594,185,0,0,1,1
9841409,9841596,187,0,0,1,2
9841595,9841617,22,1,0,0,1
9841597,9841616,19,1,0,0,2
9841617,9842126,509,0,0,1,2
9841618,9842125,507,0,0,1,1
9842126,9842139,13,1,0,0,1
9842127,9842139,12,1,0,0,2
9842140,9842304,164,0,0,1,2
9842140,9842306,166,0,0,1,1
9842305,9842313,8,1,0,0,2
9842307,9842312,5,1,0,0,1
9842313,9842922,609,0,0,1,1
9842314,9842922,608,0,0,1,2
9842923,9843584,661,1,0,0,1
9842923,9843610,687,1,0,0,2
9842949,9843584,635,0,1,0,2
9842951,9843573,622,0,1,0,1
9843585,9843992,407,0,0,1,1
9843611,9843993,382,0,0,1,2
9843993,9844021,28,1,0,0,1
9843994,9844021,27,1,0,0,2
9844022,9844352,330,0,0,1,2
9844022,9844354,332,0,0,1,1
9844353,9844402,49,1,0,0,2
9844355,9844394,39,1,0,0,1
9844395,9844499,104,0,0,1,1
9844403,9844501,98,0,0,1,2
9844500,9844566,66,1,0,0,1
9844502,9844580,78,1,0,0,2
9844567,9844751,184,0,0,1,1
9844581,9844751,170,0,0,1,2
9844752,9844775,23,1,0,0,1
9844752,9844788,36,1,0,0,2
9844776,9845567,791,0,0,1,1
9844789,9845570,781,0,0,1,2
9845568,9845581,13,1,0,0,1
9845571,9845582,11,1,0,0,2
9845582,9846288,706,0,0,1,1
9845583,9846287,704,0,0,1,2
9846288,9846355,67,1,0,0,2
9846289,9846355,66,1,0,0,1
9846356,9846411,55,0,0,1,2
9846356,9846419,63,0,0,1,1
9846412,9846651,239,1,0,0,2
9846420,9846665,245,1,0,0,1
9846449,9846613,164,0,1,0,1
9846452,9846611,159,0,1,0,2
9846652,9846777,125,0,0,1,2
9846666,9846778,112,0,0,1,1
9846778,9846796,18,1,0,0,2
9846779,9846794,15,1,0,0,1
9846795,9847060,265,0,0,1,1
9846797,9847056,259,0,0,1,2
9847057,9847074,17,1,0,0,2
9847061,9847074,13,1,0,0,1
9847075,9847253,178,0,0,1,1
9847075,9847260,185,0,0,1,2
9847254,9847272,18,1,0,0,1
9847261,9847267,6,1,0,0,2
9847268,9847662,394,0,0,1,2
9847273,9847663,390,0,0,1,1
9847663,9847676,13,1,0,0,2
9847664,9847684,20,1,0,0,1
9847677,9848350,673,0,0,1,2
9847685,9848349,664,0,0,1,1
9848350,9849066,716,1,0,0,1
9848351,9848366,15,1,0,0,2
9848367,9848400,33,0,0,1,2
9848401,9849051,650,1,0,0,2
9848433,9849019,586,0,1,0,1
9848440,9849026,586,0,1,0,2
9849052,9849092,40,0,0,1,2
9849067,9849822,755,0,0,1,1
9849093,9849101,8,1,0,0,2
9849102,9849818,716,0,0,1,2
9849819,9849951,132,1,0,0,2
9849823,9849941,118,1,0,0,1
9849942,9850092,150,0,0,1,1
9849952,9850101,149,0,0,1,2
9850093,9850137,44,1,0,0,1
9850102,9850137,35,1,0,0,2
9850138,9850235,97,0,0,1,1
9850138,9850236,98,0,0,1,2
9850236,9850258,22,1,0,0,1
9850237,9850262,25,1,0,0,2
9850259,9850399,140,0,0,1,1
9850263,9850400,137,0,0,1,2
9850400,9850426,26,1,0,0,1
9850401,9850426,25,1,0,0,2
9850427,9851183,756,0,0,1,2
9850427,9851187,760,0,0,1,1
9851184,9851203,19,1,0,0,2
9851188,9851199,11,1,0,0,1
9851200,9851368,168,0,0,1,1
9851204,9851367,163,0,0,1,2
9851368,9851381,13,1,0,0,2
9851369,9851380,11,1,0,0,1
9851381,9851791,410,0,0,1,1
9851382,9851791,409,0,0,1,2
9851792,9851810,18,1,0,0,1
9851792,9851810,18,1,0,0,2
9851811,9852388,577,0,0,1,1
9851811,9852389,578,0,0,1,2
9852389,9852614,225,1,0,0,1
9852390,9852626,236,1,0,0,2
9852474,9852583,109,0,1,0,1
9852478,9852583,105,0,1,0,2
9852615,9852776,161,0,0,1,1
9852627,9852777,150,0,0,1,2
9852777,9852786,9,1,0,0,1
9852778,9852784,6,1,0,0,2
9852785,9852960,175,0,0,1,2
9852787,9852958,171,0,0,1,1
9852959,9852965,6,1,0,0,1
9852961,9852968,7,1,0,0,2
9852966,9853569,603,0,0,1,1
9852969,9853150,181,0,0,1,2
9853151,9853155,4,1,0,0,2
9853156,9853572,416,0,0,1,2
9853570,9853578,8,1,0,0,1
9853573,9853585,12,1,0,0,2
9853579,9854294,715,0,0,1,1
9853586,9853951,365,0,0,1,2
9853952,9853968,16,1,0,0,2
9853969,9854296,327,0,0,1,2
9854295,9854313,18,1,0,0,1
9854297,9854311,14,1,0,0,2
9854312,9854505,193,0,0,1,2
9854314,9854500,186,0,0,1,1
9854501,9855163,662,1,0,0,1
9854506,9855146,640,1,0,0,2
9854529,9855152,623,0,1,0,1
9854535,9855133,598,0,1,0,2
9855147,9855184,37,0,0,1,2
9855164,9855414,250,0,0,1,1
9855185,9855195,10,1,0,0,2
9855196,9855420,224,0,0,1,2
9855415,9855441,26,1,0,0,1
9855421,9855432,11,1,0,0,2
9855433,9855566,133,0,0,1,2
9855442,9855564,122,0,0,1,1
9855565,9855592,27,1,0,0,1
9855567,9855593,26,1,0,0,2
9855593,9855717,124,0,0,1,1
9855594,9855720,126,0,0,1,2
9855718,9855948,230,1,0,0,1
9855721,9855954,233,1,0,0,2
9855776,9855921,145,0,1,0,1
9855783,9855913,130,0,1,0,2
9855949,9856269,320,0,0,1,1
9855955,9856269,314,0,0,1,2
9856270,9856341,71,1,0,0,2
9856270,9856342,72,1,0,0,1
9856342,9856548,206,0,0,1,2
9856343,9856548,205,0,0,1,1
9856549,9856579,30,1,0,0,1
9856549,9856601,52,1,0,0,2
9856580,9856994,414,0,0,1,1
9856602,9856647,45,0,0,1,2
9856648,9856662,14,1,0,0,2
9856663,9856708,45,0,0,1,2
9856709,9856774,65,1,0,0,2
9856775,9856853,78,0,0,1,2
9856854,9856869,15,1,0,0,2
9856870,9856995,125,0,0,1,2
9856995,9857018,23,1,0,0,1
9856996,9857009,13,1,0,0,2
9857010,9857229,219,0,0,1,2
9857019,9857230,211,0,0,1,1
9857230,9857242,12,1,0,0,2
9857231,9857245,14,1,0,0,1
9857243,9857500,257,0,0,1,2
9857246,9857494,248,0,0,1,1
9857495,9857514,19,1,0,0,1
9857501,9857514,13,1,0,0,2
9857515,9858653,1138,0,0,1,2
9857515,9858664,1149,0,0,1,1
9858654,9858895,241,1,0,0,2
9858665,9858867,202,1,0,0,1
9858691,9858830,139,0,1,0,2
9858696,9858818,122,0,1,0,1
9858868,9858982,114,0,0,1,1
9858896,9858980,84,0,0,1,2
9858981,9859001,20,1,0,0,2
9858983,9859000,17,1,0,0,1
9859001,9859643,642,0,0,1,1
9859002,9859646,644,0,0,1,2
9859644,9859666,22,1,0,0,1
9859647,9859663,16,1,0,0,2
9859664,9860064,400,0,0,1,2
9859667,9860068,401,0,0,1,1
9860065,9860086,21,1,0,0,2
9860069,9860086,17,1,0,0,1
9860087,9860331,244,0,0,1,2
9860087,9860683,596,0,0,1,1
9860332,9860345,13,1,0,0,2
9860346,9860692,346,0,0,1,2
9860684,9860691,7,1,0,0,1
9860692,9860724,32,0,0,1,1
9860693,9861310,617,1,0,0,2
9860725,9861279,554,1,0,0,1
9860748,9861262,514,0,1,0,2
9860754,9861267,513,0,1,0,1
9861280,9862211,931,0,0,1,1
9861311,9861618,307,0,0,1,2
9861619,9861629,10,1,0,0,2
9861630,9861777,147,0,0,1,2
9861778,9861782,4,1,0,0,2
9861783,9862209,426,0,0,1,2
9862210,9862293,83,1,0,0,2
9862212,9862278,66,1,0,0,1
9862279,9862445,166,0,0,1,1
9862294,9862448,154,0,0,1,2
9862446,9862456,10,1,0,0,1
9862449,9862464,15,1,0,0,2
9862457,9862543,86,0,0,1,1
9862465,9862541,76,0,0,1,2
9862542,9862567,25,1,0,0,2
9862544,9862568,24,1,0,0,1
9862568,9862728,160,0,0,1,2
9862569,9862731,162,0,0,1,1
9862729,9862743,14,1,0,0,2
9862732,9862743,11,1,0,0,1
9862744,9862897,153,0,0,1,1
9862744,9863249,505,0,0,1,2
9862898,9862902,4,1,0,0,1
9862903,9863951,1048,0,0,1,1
9863250,9863259,9,1,0,0,2
9863260,9863951,691,0,0,1,2
9863952,9863975,23,1,0,0,2
9863952,9863983,31,1,0,0,1
9863976,9864480,504,0,0,1,2
9863984,9864478,494,0,0,1,1
9864479,9864663,184,1,0,0,1
9864481,9864678,197,1,0,0,2
9864515,9864627,112,0,1,0,2
9864516,9864625,109,0,1,0,1
9864664,9864733,69,0,0,1,1
9864679,9864731,52,0,0,1,2
9864732,9864765,33,1,0,0,2
9864734,9864763,29,1,0,0,1
9864764,9864935,171,0,0,1,1
9864766,9864935,169,0,0,1,2
9864936,9864960,24,1,0,0,2
9864936,9864969,33,1,0,0,1
9864961,9865313,352,0,0,1,2
9864970,9866472,1502,0,0,1,1
9865314,9865323,9,1,0,0,2
9865324,9866465,1141,0,0,1,2
9866466,9866904,438,1,0,0,2
9866473,9866907,434,1,0,0,1
9866523,9866893,370,0,1,0,2
9866526,9866896,370,0,1,0,1
9866905,9867159,254,0,0,1,2
9866908,9866944,36,0,0,1,1
9866945,9866949,4,1,0,0,1
9866950,9867161,211,0,0,1,1
9867160,9867187,27,1,0,0,2
9867162,9867173,11,1,0,0,1
9867174,9867666,492,0,0,1,1
9867188,9867666,478,0,0,1,2
9867667,9867705,38,1,0,0,1
9867667,9867708,41,1,0,0,2
9867706,9867872,166,0,0,1,1
9867709,9867870,161,0,0,1,2
9867871,9867888,17,1,0,0,2
9867873,9867888,15,1,0,0,1
9867889,9868083,194,0,0,1,2
9867889,9868086,197,0,0,1,1
9868084,9868168,84,1,0,0,2
9868087,9868166,79,1,0,0,1
9868167,9868299,132,0,0,1,1
9868169,9868298,129,0,0,1,2
9868299,9868332,33,1,0,0,2
9868300,9868328,28,1,0,0,1
9868329,9868515,186,0,0,1,1
9868333,9868516,183,0,0,1,2
9868516,9868536,20,1,0,0,1
9868517,9868536,19,1,0,0,2
9868537,9868734,197,0,0,1,2
9868537,9869464,927,0,0,1,1
9868735,9868750,15,1,0,0,2
9868751,9869463,712,0,0,1,2
9869464,9869475,11,1,0,0,2
9869465,9869469,4,1,0,0,1
9869470,9870876,1406,0,0,1,1
9869476,9870840,1364,0,0,1,2
9870841,9870849,8,1,0,0,2
9870850,9870872,22,0,0,1,2
9870873,9871138,265,1,0,0,2
9870877,9871126,249,1,0,0,1
9870906,9871077,171,0,1,0,2
9870907,9871059,152,0,1,0,1
9871127,9872405,1278,0,0,1,1
9871139,9872404,1265,0,0,1,2
9872405,9872445,40,1,0,0,2
9872406,9872439,33,1,0,0,1
9872440,9872614,174,0,0,1,1
9872446,9872614,168,0,0,1,2
9872615,9872651,36,1,0,0,1
9872615,9872651,36,1,0,0,2
9872652,9872928,276,0,0,1,1
9872652,9872932,280,0,0,1,2
9872929,9873169,240,1,0,0,1
9872933,9873172,239,1,0,0,2
9872970,9873117,147,0,1,0,2
9872970,9873124,154,0,1,0,1
9873170,9873206,36,0,0,1,1
9873173,9873205,32,0,0,1,2
9873206,9873231,25,1,0,0,2
9873207,9873230,23,1,0,0,1
9873231,9873669,438,0,0,1,1
9873232,9873670,438,0,0,1,2
9873670,9873909,239,1,0,0,1
9873671,9873917,246,1,0,0,2
9873687,9873886,199,0,1,0,1
9873693,9873877,184,0,1,0,2
9873910,9874703,793,0,0,1,1
9873918,9874704,786,0,0,1,2
9874704,9874753,49,1,0,0,1
9874705,9874765,60,1,0,0,2
9874754,9874878,124,0,0,1,1
9874766,9874880,114,0,0,1,2
9874879,9874913,34,1,0,0,1
9874881,9874912,31,1,0,0,2
9874913,9875025,112,0,0,1,2
9874914,9875025,111,0,0,1,1
9875026,9875036,10,1,0,0,2
9875026,9875037,11,1,0,0,1
9875037,9875312,275,0,0,1,2
9875038,9875304,266,0,0,1,1
9875305,9875324,19,1,0,0,1
9875313,9875324,11,1,0,0,2
9875325,9876581,1256,0,0,1,2
9875325,9876583,1258,0,0,1,1
9876582,9876811,229,1,0,0,2
9876584,9876799,215,1,0,0,1
9876624,9876776,152,0,1,0,1
9876626,9876776,150,0,1,0,2
9876800,9876907,107,0,0,1,1
9876812,9876906,94,0,0,1,2
9876907,9876941,34,1,0,0,2
9876908,9876930,22,1,0,0,1
9876931,9877319,388,0,0,1,1
9876942,9877320,378,0,0,1,2
9877320,9877332,12,1,0,0,1
9877321,9877334,13,1,0,0,2
9877333,9878660,1327,0,0,1,1
9877335,9878678,1343,0,0,1,2
9878661,9879008,347,1,0,0,1
9878679,9879049,370,1,0,0,2
9878696,9878986,290,0,1,0,1
9878700,9878980,280,0,1,0,2
9879009,9879778,769,0,0,1,1
9879050,9879781,731,0,0,1,2
9879779,9879800,21,1,0,0,1
9879782,9879801,19,1,0,0,2
9879801,9880007,206,0,0,1,1
9879802,9880005,203,0,0,1,2
9880006,9880033,27,1,0,0,2
9880008,9880033,25,1,0,0,1
9880034,9880351,317,0,0,1,2
9880034,9880353,319,0,0,1,1
9880352,9880383,31,1,0,0,2
9880354,9880383,29,1,0,0,1
9880384,9881018,634,0,0,1,2
9880384,9881029,645,0,0,1,1
9881019,9891645,10626,1,0,0,2
9881030,9891890,10860,1,0,0,1
9881058,9891880,10822,0,1,0,1
9881060,9891634,10574,0,1,0,2
9891646,9891843,197,0,0,1,2
9891844,9891891,47,1,0,0,2
9891891,9892251,360,0,0,1,1
9891892,9892250,358,0,0,1,2
9892251,9892515,264,1,0,0,2
9892252,9892511,259,1,0,0,1
9892272,9892485,213,0,1,0,1
9892279,9892485,206,0,1,0,2
9892512,9892926,414,0,0,1,1
9892516,9892918,402,0,0,1,2
9892919,9893171,252,1,0,0,2
9892927,9893161,234,1,0,0,1
9892943,9893144,201,0,1,0,1
9892951,9893127,176,0,1,0,2
9893162,9893396,234,0,0,1,1
9893172,9893397,225,0,0,1,2
9893397,9894262,865,1,0,0,1
9893398,9894267,869,1,0,0,2
9893449,9894251,802,0,1,0,1
9893455,9894256,801,0,1,0,2
9894263,9894347,84,0,0,1,1
9894268,9894348,80,0,0,1,2
9894348,9894389,41,1,0,0,1
9894349,9894390,41,1,0,0,2
9894390,9894636,246,0,0,1,1
9894391,9894638,247,0,0,1,2
9894637,9894664,27,1,0,0,1
9894639,9894680,41,1,0,0,2
9894665,9895158,493,0,0,1,1
9894681,9895163,482,0,0,1,2
9895159,9895388,229,1,0,0,1
9895164,9895405,241,1,0,0,2
9895181,9895360,179,0,1,0,1
9895184,9895359,175,0,1,0,2
9895389,9895901,512,0,0,1,1
9895406,9895901,495,0,0,1,2
9942498,9942570,72,0,1,0,1
9942498,9942582,84,0,1,0,2
9942498,9942604,106,1,0,0,1
9942498,9942638,140,1,0,0,2
9942605,9942749,144,0,0,1,1
9942639,9942748,109,0,0,1,2
9942749,9942824,75,1,0,0,2
9942750,9942826,76,1,0,0,1
9942825,9942920,95,0,0,1,2
9942827,9942920,93,0,0,1,1
9942921,9942944,23,1,0,0,2
9942921,9942953,32,1,0,0,1
9942945,9943396,451,0,0,1,2
9942954,9943401,447,0,0,1,1
9943397,9944217,820,1,0,0,2
9943402,9944160,758,1,0,0,1
9943429,9944146,717,0,1,0,2
9943430,9944149,719,0,1,0,1
9944161,9944242,81,0,0,1,1
9944218,9944244,26,0,0,1,2
9944243,9944266,23,1,0,0,1
9944245,9944274,29,1,0,0,2
9944267,9944523,256,0,0,1,1
9944275,9946214,1939,0,0,1,2
9944524,9944528,4,1,0,0,1
9944529,9946213,1684,0,0,1,1
9946214,9946353,139,1,0,0,1
9946215,9946366,151,1,0,0,2
9946248,9946328,80,0,1,0,1
9946248,9946332,84,0,1,0,2
9946354,9946693,339,0,0,1,1
9946367,9946692,325,0,0,1,2
9946693,9946772,79,1,0,0,2
9946694,9946771,77,1,0,0,1
9946772,9946868,96,0,0,1,1
9946773,9946866,93,0,0,1,2
9946867,9946908,41,1,0,0,2
9946869,9946894,25,1,0,0,1
9946895,9947080,185,0,0,1,1
9946909,9947078,169,0,0,1,2
9947079,9947108,29,1,0,0,2
9947081,9947105,24,1,0,0,1
9947106,9948229,1123,0,0,1,1
9947109,9948230,1121,0,0,1,2
9948230,9948347,117,1,0,0,1
9948231,9948360,129,1,0,0,2
9948348,9948667,319,0,0,1,1
9948361,9948666,305,0,0,1,2
9948667,9948753,86,1,0,0,2
9948668,9948734,66,1,0,0,1
9948735,9948912,177,0,0,1,1
9948754,9948917,163,0,0,1,2
9948913,9948930,17,1,0,0,1
9948918,9948929,11,1,0,0,2
9948930,9949153,223,0,0,1,2
9948931,9950148,1217,0,0,1,1
9949154,9949164,10,1,0,0,2
9949165,9950147,982,0,0,1,2
9950148,9950328,180,1,0,0,2
9950149,9950313,164,1,0,0,1
9950185,9950297,112,0,1,0,2
9950189,9950291,102,0,1,0,1
9950314,9950622,308,0,0,1,1
9950329,9950623,294,0,0,1,2
9950623,9950702,79,1,0,0,1
9950624,9950707,83,1,0,0,2
9950703,9950842,139,0,0,1,1
9950708,9950842,134,0,0,1,2
9950843,9950873,30,1,0,0,2
9950843,9950875,32,1,0,0,1
9950874,9951147,273,0,0,1,2
9950876,9951151,275,0,0,1,1
9951148,9951167,19,1,0,0,2
9951152,9951164,12,1,0,0,1
9951165,9952170,1005,0,0,1,1
9951168,9952171,1003,0,0,1,2
9952171,9952355,184,1,0,0,1
9952172,9952377,205,1,0,0,2
9952220,9952346,126,0,1,0,2
9952221,9952339,118,0,1,0,1
9952356,9952609,253,0,0,1,1
9952378,9952610,232,0,0,1,2
9952610,9952651,41,1,0,0,1
9952611,9952651,40,1,0,0,2
9952652,9954479,1827,0,0,1,1
9952652,9954480,1828,0,0,1,2
9954480,9954557,77,1,0,0,1
9954481,9954548,67,1,0,0,2
9954549,9954703,154,0,0,1,2
9954558,9954702,144,0,0,1,1
9954703,9954725,22,1,0,0,1
9954704,9954721,17,1,0,0,2
9954722,9955865,1143,0,0,1,2
9954726,9955866,1140,0,0,1,1
9955866,9956089,223,1,0,0,2
9955867,9956047,180,1,0,0,1
9955909,9956031,122,0,1,0,1
9955910,9956038,128,0,1,0,2
9956048,9956332,284,0,0,1,1
9956090,9956331,241,0,0,1,2
9956332,9956389,57,1,0,0,2
9956333,9956396,63,1,0,0,1
9956390,9956485,95,0,0,1,2
9956397,9956486,89,0,0,1,1
9956486,9956524,38,1,0,0,2
9956487,9956516,29,1,0,0,1
9956517,9956668,151,0,0,1,1
9956525,9956664,139,0,0,1,2
9956665,9956686,21,1,0,0,2
9956669,9956684,15,1,0,0,1
9956685,9957825,1140,0,0,1,1
9956687,9957824,1137,0,0,1,2
9957825,9958055,230,1,0,0,2
9957826,9958015,189,1,0,0,1
9957856,9958007,151,0,1,0,2
9957861,9957998,137,0,1,0,1
9958016,9958279,263,0,0,1,1
9958056,9958280,224,0,0,1,2
9958280,9958349,69,1,0,0,1
9958281,9958347,66,1,0,0,2
9958348,9958489,141,0,0,1,2
9958350,9958489,139,0,0,1,1
9958490,9958511,21,1,0,0,1
9958490,9958531,41,1,0,0,2
9958512,9958720,208,0,0,1,1
9958532,9958717,185,0,0,1,2
9958718,9958736,18,1,0,0,2
9958721,9958738,17,1,0,0,1
9958737,9959698,961,0,0,1,2
9958739,9959701,962,0,0,1,1
9959699,9959709,10,1,0,0,2
9959702,9959708,6,1,0,0,1
9959709,9959760,51,0,0,1,1
9959710,9959760,50,0,0,1,2
9959761,9959846,85,1,0,0,1
9959761,9959859,98,1,0,0,2
9959847,9959936,89,0,0,1,1
9959860,9959939,79,0,0,1,2
9959937,9959980,43,1,0,0,1
9959940,9959970,30,1,0,0,2
9959971,9960106,135,0,0,1,2
9959981,9960105,124,0,0,1,1
9960106,9960200,94,1,0,0,1
9960107,9960211,104,1,0,0,2
9960201,9960298,97,0,0,1,1
9960212,9960297,85,0,0,1,2
9960298,9960324,26,1,0,0,2
9960299,9960322,23,1,0,0,1
9960323,9960544,221,0,0,1,1
9960325,9960542,217,0,0,1,2
9960543,9960560,17,1,0,0,2
9960545,9960558,13,1,0,0,1
9960559,9961485,926,0,0,1,1
9960561,9961481,920,0,0,1,2
9961482,9961647,165,1,0,0,2
9961486,9961644,158,1,0,0,1
9961528,9961593,65,0,1,0,1
9961533,9961588,55,0,1,0,2
9961645,9961887,242,0,0,1,1
9961648,9961886,238,0,0,1,2
9961887,9961997,110,1,0,0,2
9961888,9961996,108,1,0,0,1
9961997,9962028,31,0,0,1,1
9961998,9962028,30,0,0,1,2
9962029,9962093,64,1,0,0,1
9962029,9962095,66,1,0,0,2
9962094,9962195,101,0,0,1,1
9962096,9962194,98,0,0,1,2
9962195,9962228,33,1,0,0,2
9962196,9962225,29,1,0,0,1
9962226,9962367,141,0,0,1,1
9962229,9962366,137,0,0,1,2
9962367,9962384,17,1,0,0,2
9962368,9962386,18,1,0,0,1
9962385,9963352,967,0,0,1,2
9962387,9963351,964,0,0,1,1
9963352,9963447,95,1,0,0,1
9963353,9963443,90,1,0,0,2
9963444,9963777,333,0,0,1,2
9963448,9963775,327,0,0,1,1
9963776,9963853,77,1,0,0,1
9963778,9963855,77,1,0,0,2
9963854,9963989,135,0,0,1,1
9963856,9963988,132,0,0,1,2
9963989,9964016,27,1,0,0,2
9963990,9964017,27,1,0,0,1
9964017,9964197,180,0,0,1,2
9964018,9964199,181,0,0,1,1
9964198,9964214,16,1,0,0,2
9964200,9964210,10,1,0,0,1
9964211,9964500,289,0,0,1,1
9964215,9964501,286,0,0,1,2
9964501,9964532,31,1,0,0,1
9964502,9964524,22,1,0,0,2
9964525,9964633,108,0,0,1,2
9964533,9964637,104,0,0,1,1
9964634,9964656,22,1,0,0,2
9964638,9964654,16,1,0,0,1
9964655,9965239,584,0,0,1,1
9964657,9965238,581,0,0,1,2
9965239,9965456,217,1,0,0,2
9965240,9965458,218,1,0,0,1
9965282,9965438,156,0,1,0,1
9965289,9965423,134,0,1,0,2
9965457,9965732,275,0,0,1,2
9965459,9965733,274,0,0,1,1
9965733,9965814,81,1,0,0,2
9965734,9965829,95,1,0,0,1
9965815,9965937,122,0,0,1,2
9965830,9965938,108,0,0,1,1
9965938,9965972,34,1,0,0,2
9965939,9965970,31,1,0,0,1
9965971,9966178,207,0,0,1,1
9965973,9966176,203,0,0,1,2
9966177,9966190,13,1,0,0,2
9966179,9966193,14,1,0,0,1
9966191,9966409,218,0,0,1,2
9966194,9966408,214,0,0,1,1
9966409,9966445,36,1,0,0,1
9966410,9966425,15,1,0,0,2
9966426,9967183,757,0,0,1,2
9966446,9967177,731,0,0,1,1
9967178,9967284,106,1,0,0,1
9967184,9967286,102,1,0,0,2
9967285,9967639,354,0,0,1,1
9967287,9967640,353,0,0,1,2
9967640,9967734,94,1,0,0,1
9967641,9967724,83,1,0,0,2
9967725,9967927,202,0,0,1,2
9967735,9967925,190,0,0,1,1
9967926,9967945,19,1,0,0,1
9967928,9967948,20,1,0,0,2
9967946,9969150,1204,0,0,1,1
9967949,9969153,1204,0,0,1,2
9969151,9969362,211,1,0,0,1
9969154,9969375,221,1,0,0,2
9969207,9969336,129,0,1,0,1
9969208,9969326,118,0,1,0,2
9969363,9969613,250,0,0,1,1
9969376,9969612,236,0,0,1,2
9969613,9969676,63,1,0,0,2
9969614,9969678,64,1,0,0,1
9969677,9969762,85,0,0,1,2
9969679,9969761,82,0,0,1,1
9969762,9969794,32,1,0,0,1
9969763,9969788,25,1,0,0,2
9969789,9971116,1327,0,0,1,2
9969795,9971113,1318,0,0,1,1
9971114,9971312,198,1,0,0,1
9971117,9971337,220,1,0,0,2
9971153,9971287,134,0,1,0,2
9971155,9971287,132,0,1,0,1
9971313,9971603,290,0,0,1,1
9971338,9971605,267,0,0,1,2
9971604,9971673,69,1,0,0,1
9971606,9971676,70,1,0,0,2
9971674,9971792,118,0,0,1,1
9971677,9971793,116,0,0,1,2
9971793,9971826,33,1,0,0,1
9971794,9971826,32,1,0,0,2
9971827,9973157,1330,0,0,1,2
9971827,9973159,1332,0,0,1,1
9973158,9973409,251,1,0,0,2
9973160,9973388,228,1,0,0,1
9973209,9973353,144,0,1,0,1
9973210,9973351,141,0,1,0,2
9973389,9973468,79,0,0,1,1
9973410,9973467,57,0,0,1,2
9973468,9973496,28,1,0,0,2
9973469,9973497,28,1,0,0,1
9973497,9973569,72,0,0,1,2
9973498,9973568,70,0,0,1,1
9973569,9973644,75,1,0,0,1
9973570,9973635,65,1,0,0,2
9973636,9973711,75,0,0,1,2
9973645,9973710,65,0,0,1,1
9973711,9973737,26,1,0,0,1
9973712,9973743,31,1,0,0,2
9973738,9974077,339,0,0,1,1
9973744,9974077,333,0,0,1,2
9974078,9974089,11,1,0,0,2
9974078,9974091,13,1,0,0,1
9974090,9975145,1055,0,0,1,2
9974092,9975146,1054,0,0,1,1
9975146,9975217,71,1,0,0,2
9975147,9975208,61,1,0,0,1
9975209,9975404,195,0,0,1,1
9975218,9975402,184,0,0,1,2
9975403,9975446,43,1,0,0,2
9975405,9975443,38,1,0,0,1
9975444,9975524,80,0,0,1,1
9975447,9975524,77,0,0,1,2
9975525,9975590,65,1,0,0,1
9975525,9975592,67,1,0,0,2
9975591,9977017,1426,0,0,1,1
9975593,9977017,1424,0,0,1,2
9977018,9977120,102,1,0,0,1
9977018,9977121,103,1,0,0,2
9977121,9977466,345,0,0,1,1
9977122,9977466,344,0,0,1,2
9977467,9977536,69,1,0,0,1
9977467,9977538,71,1,0,0,2
9977537,9977596,59,0,0,1,1
9977539,9977597,58,0,0,1,2
9977597,9977622,25,1,0,0,1
9977598,9977634,36,1,0,0,2
9977623,9977794,171,0,0,1,1
9977635,9977790,155,0,0,1,2
9977791,9977808,17,1,0,0,2
9977795,9977808,13,1,0,0,1
9977809,9979020,1211,0,0,1,2
9977809,9979021,1212,0,0,1,1
9979021,9979243,222,1,0,0,2
9979022,9979043,21,1,0,0,1
9979044,9979065,21,0,0,1,1
9979066,9979215,149,1,0,0,1
9979078,9979196,118,0,1,0,1
9979079,9979197,118,0,1,0,2
9979216,9979439,223,0,0,1,1
9979244,9979437,193,0,0,1,2
9979438,9979509,71,1,0,0,2
9979440,9979508,68,1,0,0,1
9979509,9979610,101,0,0,1,1
9979510,9979606,96,0,0,1,2
9979607,9979643,36,1,0,0,2
9979611,9979637,26,1,0,0,1
9979638,9979698,60,0,0,1,1
9979644,9979698,54,0,0,1,2
9979699,9979721,22,1,0,0,2
9979699,9979731,32,1,0,0,1
9979722,9979929,207,0,0,1,2
9979732,9979927,195,0,0,1,1
9979928,9979942,14,1,0,0,1
9979930,9979941,11,1,0,0,2
9979942,9980970,1028,0,0,1,2
9979943,9980147,204,0,0,1,1
9980148,9980159,11,1,0,0,1
9980160,9980968,808,0,0,1,1
9980969,9981239,270,1,0,0,1
9980971,9981256,285,1,0,0,2
9981062,9981210,148,0,1,0,2
9981064,9981207,143,0,1,0,1
9981240,9981385,145,0,0,1,1
9981257,9981387,130,0,0,1,2
9981386,9981451,65,1,0,0,1
9981388,9981447,59,1,0,0,2
9981448,9981561,113,0,0,1,2
9981452,9981559,107,0,0,1,1
9981560,9981590,30,1,0,0,1
9981562,9981580,18,1,0,0,2
9981581,9981728,147,0,0,1,2
9981591,9981727,136,0,0,1,1
9981728,9981745,17,1,0,0,1
9981729,9981746,17,1,0,0,2
9981746,9981893,147,0,0,1,1
9981747,9981896,149,0,0,1,2
9981894,9981913,19,1,0,0,1
9981897,9981913,16,1,0,0,2
9981914,9982185,271,0,0,1,1
9981914,9982188,274,0,0,1,2
9982186,9982205,19,1,0,0,1
9982189,9982203,14,1,0,0,2
9982204,9982432,228,0,0,1,2
9982206,9982430,224,0,0,1,1
9982431,9982446,15,1,0,0,1
9982433,9982448,15,1,0,0,2
9982447,9982934,487,0,0,1,1
9982449,9982933,484,0,0,1,2
9982934,9982949,15,1,0,0,2
9982935,9982944,9,1,0,0,1
9982945,9983105,160,0,0,1,1
9982950,9982977,27,0,0,1,2
9982978,9982993,15,1,0,0,2
9982994,9983103,109,0,0,1,2
9983104,9983130,26,1,0,0,2
9983106,9983131,25,1,0,0,1
9983131,9983364,233,0,0,1,2
9983132,9983365,233,0,0,1,1
9983365,9983426,61,1,0,0,2
9983366,9983425,59,1,0,0,1
9983426,9983597,171,0,0,1,1
9983427,9983810,383,0,0,1,2
9983598,9983608,10,1,0,0,1
9983609,9983811,202,0,0,1,1
9983811,9983823,12,1,0,0,2
9983812,9983819,7,1,0,0,1
9983820,9984733,913,0,0,1,1
9983824,9984018,194,0,0,1,2
9984019,9984030,11,1,0,0,2
9984031,9984734,703,0,0,1,2
9984734,9984968,234,1,0,0,1
9984735,9984988,253,1,0,0,2
9984757,9984941,184,0,1,0,1
9984765,9984932,167,0,1,0,2
9984969,9985326,357,0,0,1,1
9984989,9985322,333,0,0,1,2
9985323,9985345,22,1,0,0,2
9985327,9985332,5,1,0,0,1
9985333,9985394,61,0,0,1,1
9985346,9985397,51,0,0,1,2
9985395,9985466,71,1,0,0,1
9985398,9985472,74,1,0,0,2
9985467,9985580,113,0,0,1,1
9985473,9985589,116,0,0,1,2
9985581,9985595,14,1,0,0,1
9985590,9985602,12,1,0,0,2
9985596,9985743,147,0,0,1,1
9985603,9985742,139,0,0,1,2
9985743,9985771,28,1,0,0,2
9985744,9985770,26,1,0,0,1
9985771,9985874,103,0,0,1,1
9985772,9985877,105,0,0,1,2
9985875,9985895,20,1,0,0,1
9985878,9985895,17,1,0,0,2
9985896,9986527,631,0,0,1,1
9985896,9986527,631,0,0,1,2
9986528,9986549,21,1,0,0,1
9986528,9986549,21,1,0,0,2
9986550,9986640,90,0,0,1,1
9986550,9986643,93,0,0,1,2
9986641,9986661,20,1,0,0,1
9986644,9986661,17,1,0,0,2
9986662,9986958,296,0,0,1,2
9986662,9986959,297,0,0,1,1
9986959,9987027,68,1,0,0,2
9986960,9987066,106,1,0,0,1
9987028,9987362,334,0,0,1,2
9987067,9987363,296,0,0,1,1
9987363,9987452,89,1,0,0,2
9987364,9987453,89,1,0,0,1
9987453,9988881,1428,0,0,1,2
9987454,9988890,1436,0,0,1,1
9988882,9989073,191,1,0,0,2
9988891,9989078,187,1,0,0,1
9988955,9989018,63,0,1,0,1
9988961,9989013,52,0,1,0,2
9989074,9989304,230,0,0,1,2
9989079,9989305,226,0,0,1,1
9989305,9989360,55,1,0,0,2
9989306,9989367,61,1,0,0,1
9989361,9989478,117,0,0,1,2
9989368,9989479,111,0,0,1,1
9989479,9989501,22,1,0,0,2
9989480,9989512,32,1,0,0,1
9989502,9989670,168,0,0,1,2
9989513,9989670,157,0,0,1,1
9989671,9989688,17,1,0,0,2
9989671,9989690,19,1,0,0,1
9989689,9990805,1116,0,0,1,2
9989691,9990805,1114,0,0,1,1
9990806,9991051,245,1,0,0,1
9990806,9991077,271,1,0,0,2
9990861,9991030,169,0,1,0,1
9990865,9991025,160,0,1,0,2
9991052,9991292,240,0,0,1,1
9991078,9991292,214,0,0,1,2
9991293,9991357,64,1,0,0,1
9991293,9991363,70,1,0,0,2
9991358,9991464,106,0,0,1,1
9991364,9991463,99,0,0,1,2
9991464,9991515,51,1,0,0,2
9991465,9991506,41,1,0,0,1
9991507,9991658,151,0,0,1,1
9991516,9991665,149,0,0,1,2
9991659,9991675,16,1,0,0,1
9991666,9991688,22,1,0,0,2
9991676,9992525,849,0,0,1,1
9991689,9992522,833,0,0,1,2
9992523,9992552,29,1,0,0,2
9992526,9992551,25,1,0,0,1
9992552,9992906,354,0,0,1,1
9992553,9992897,344,0,0,1,2
9992898,9993149,251,1,0,0,2
9992907,9993120,213,1,0,0,1
9992950,9993085,135,0,1,0,2
9992951,9993088,137,0,1,0,1
9993121,9993310,189,0,0,1,1
9993150,9993308,158,0,0,1,2
9993309,9993366,57,1,0,0,2
9993311,9993366,55,1,0,0,1
9993367,9993528,161,0,0,1,1
9993367,9993529,162,0,0,1,2
9993529,9993557,28,1,0,0,1
9993530,9993547,17,1,0,0,2
9993548,9993859,311,0,0,1,2
9993558,9994996,1438,0,0,1,1
9993860,9993872,12,1,0,0,2
9993873,9994996,1123,0,0,1,2
9994997,9995043,46,1,0,0,2
9994997,9995044,47,1,0,0,1
9995044,9995398,354,0,0,1,2
9995045,9995396,351,0,0,1,1
9995397,9995472,75,1,0,0,1
9995399,9995469,70,1,0,0,2
9995470,9995632,162,0,0,1,2
9995473,9995630,157,0,0,1,1
9995631,9995664,33,1,0,0,1
9995633,9995664,31,1,0,0,2
9995665,9997172,1507,0,0,1,2
9995665,9997175,1510,0,0,1,1
9997173,9997386,213,1,0,0,2
9997176,9997371,195,1,0,0,1
9997200,9997354,154,0,1,0,2
9997201,9997353,152,0,1,0,1
9997372,9997599,227,0,0,1,1
9997387,9997601,214,0,0,1,2
9997600,9997663,63,1,0,0,1
9997602,9997673,71,1,0,0,2
9997664,9997789,125,0,0,1,1
9997674,9997789,115,0,0,1,2
9997790,9997812,22,1,0,0,1
9997790,9997818,28,1,0,0,2
9997813,9999436,1623,0,0,1,1
9997819,9999438,1619,0,0,1,2
9999437,9999641,204,1,0,0,1
9999439,9999649,210,1,0,0,2
9999483,9999604,121,0,1,0,2
9999492,9999601,109,0,1,0,1
9999642,9999859,217,0,0,1,1
9999650,9999858,208,0,0,1,2
9999859,9999928,69,1,0,0,2
9999860,9999939,79,1,0,0,1
9999929,10000089,160,0,0,1,2
9999940,10000090,150,0,0,1,1
10000090,10000124,34,1,0,0,2
10000091,10000125,34,1,0,0,1
10000125,10000234,109,0,0,1,2
10000126,10000231,105,0,0,1,1
10000232,10000253,21,1,0,0,1
10000235,10000253,18,1,0,0,2
10000254,10000721,467,0,0,1,2
10000254,10000728,474,0,0,1,1
10000722,10000752,30,1,0,0,2
10000729,10000741,12,1,0,0,1
10000742,10000944,202,0,0,1,1
10000753,10000943,190,0,0,1,2
10000944,10000957,13,1,0,0,2
10000945,10000958,13,1,0,0,1
10000958,10001504,546,0,0,1,2
10000959,10001504,545,0,0,1,1
10001505,10001521,16,1,0,0,1
10001505,10001522,17,1,0,0,2
10001522,10001757,235,0,0,1,1
10001523,10001761,238,0,0,1,2
10001758,10001872,114,1,0,0,1
10001762,10001864,102,1,0,0,2
10001865,10002148,283,0,0,1,2
10001873,10002149,276,0,0,1,1
10002149,10002217,68,1,0,0,2
10002150,10002233,83,1,0,0,1
10002218,10002270,52,0,0,1,2
10002234,10002270,36,0,0,1,1
10002271,10002296,25,1,0,0,1
10002271,10002303,32,1,0,0,2
10002297,10002408,111,0,0,1,1
10002304,10002409,105,0,0,1,2
10002409,10002453,44,1,0,0,1
10002410,10002445,35,1,0,0,2
10002446,10002654,208,0,0,1,2
10002454,10002649,195,0,0,1,1
10002650,10002690,40,1,0,0,1
10002655,10002670,15,1,0,0,2
10002671,10003473,802,0,0,1,2
10002691,10003053,362,0,0,1,1
10003054,10003068,14,1,0,0,1
10003069,10003471,402,0,0,1,1
10003472,10003505,33,1,0,0,1
10003474,10003505,31,1,0,0,2
10003506,10003961,455,0,0,1,1
10003506,10003962,456,0,0,1,2
10003962,10004171,209,1,0,0,1
10003963,10004199,236,1,0,0,2
10004002,10004136,134,0,1,0,2
10004002,10004141,139,0,1,0,1
10004172,10004401,229,0,0,1,1
10004200,10004402,202,0,0,1,2
10004402,10004446,44,1,0,0,1
10004403,10004466,63,1,0,0,2
10004447,10004561,114,0,0,1,1
10004467,10004562,95,0,0,1,2
10004562,10004589,27,1,0,0,1
10004563,10004592,29,1,0,0,2
10004590,10006080,1490,0,0,1,1
10004593,10006077,1484,0,0,1,2
10006078,10006293,215,1,0,0,2
10006081,10006254,173,1,0,0,1
10006112,10006226,114,0,1,0,1
10006114,10006218,104,0,1,0,2
10006255,10006542,287,0,0,1,1
10006294,10006541,247,0,0,1,2
10006542,10006606,64,1,0,0,2
10006543,10006617,74,1,0,0,1
10006607,10006718,111,0,0,1,2
10006618,10006716,98,0,0,1,1
10006717,10006740,23,1,0,0,1
10006719,10006756,37,1,0,0,2
10006741,10008802,2061,0,0,1,1
10006757,10006854,97,0,0,1,2
10006855,10006859,4,1,0,0,2
10006860,10008805,1945,0,0,1,2
10008803,10009024,221,1,0,0,1
10008806,10009040,234,1,0,0,2
10008843,10008992,149,0,1,0,2
10008845,10008997,152,0,1,0,1
10009025,10009282,257,0,0,1,1
10009041,10009280,239,0,0,1,2
10009281,10009371,90,1,0,0,2
10009283,10009360,77,1,0,0,1
10009361,10009437,76,0,0,1,1
10009372,10009436,64,0,0,1,2
10009437,10009482,45,1,0,0,2
10009438,10009466,28,1,0,0,1
10009467,10009939,472,0,0,1,1
10009483,10009704,221,0,0,1,2
10009705,10009716,11,1,0,0,2
10009717,10011299,1582,0,0,1,2
10009940,10009951,11,1,0,0,1
10009952,10011298,1346,0,0,1,1
10011299,10011481,182,1,0,0,1
10011300,10011476,176,1,0,0,2
10011332,10011450,118,0,1,0,2
10011336,10011455,119,0,1,0,1
10011477,10011785,308,0,0,1,2
10011482,10011783,301,0,0,1,1
10011784,10011836,52,1,0,0,1
10011786,10011849,63,1,0,0,2
10011837,10011950,113,0,0,1,1
10011850,10011950,100,0,0,1,2
10011951,10011982,31,1,0,0,2
10011951,10011985,34,1,0,0,1
10011983,10013763,1780,0,0,1,2
10011986,10013763,1777,0,0,1,1
10013764,10013920,156,1,0,0,1
10013764,10013956,192,1,0,0,2
10013806,10013898,92,0,1,0,1
10013807,10013902,95,0,1,0,2
10013921,10014168,247,0,0,1,1
10013957,10014169,212,0,0,1,2
10014169,10014243,74,1,0,0,1
10014170,10014244,74,1,0,0,2
10014244,10014328,84,0,0,1,1
10014245,10014328,83,0,0,1,2
10014329,10014353,24,1,0,0,2
10014329,10014355,26,1,0,0,1
10014354,10014567,213,0,0,1,2
10014356,10014568,212,0,0,1,1
10014568,10014595,27,1,0,0,2
10014569,10014585,16,1,0,0,1
10014586,10014773,187,0,0,1,1
10014596,10014772,176,0,0,1,2
10014773,10014786,13,1,0,0,2
10014774,10014785,11,1,0,0,1
10014786,10015937,1151,0,0,1,1
10014787,10015935,1148,0,0,1,2
10015936,10016038,102,1,0,0,2
10015938,10016029,91,1,0,0,1
10016030,10016372,342,0,0,1,1
10016039,10016371,332,0,0,1,2
10016372,10016453,81,1,0,0,2
10016373,10016446,73,1,0,0,1
10016447,10016563,116,0,0,1,1
10016454,10016565,111,0,0,1,2
10016564,10016592,28,1,0,0,1
10016566,10016584,18,1,0,0,2
10016585,10016738,153,0,0,1,2
10016593,10016738,145,0,0,1,1
10016739,10016757,18,1,0,0,2
10016739,10016758,19,1,0,0,1
10016758,10018171,1413,0,0,1,2
10016759,10018170,1411,0,0,1,1
10018171,10018367,196,1,0,0,1
10018172,10018372,200,1,0,0,2
10018205,10018330,125,0,1,0,1
10018207,10018321,114,0,1,0,2
10018368,10018592,224,0,0,1,1
10018373,10018592,219,0,0,1,2
10018593,10018637,44,1,0,0,1
10018593,10018637,44,1,0,0,2
10018638,10018733,95,0,0,1,2
10018638,10018735,97,0,0,1,1
10018734,10018753,19,1,0,0,2
10018736,10018762,26,1,0,0,1
10018754,10020373,1619,0,0,1,2
10018763,10020366,1603,0,0,1,1
10020367,10020386,19,1,0,0,1
10020374,10020399,25,1,0,0,2
10020387,10020757,370,0,0,1,1
10020400,10020756,356,0,0,1,2
10020757,10020807,50,1,0,0,2
10020758,10020817,59,1,0,0,1
10020808,10021235,427,0,0,1,2
10020818,10020991,173,0,0,1,1
10020992,10021002,10,1,0,0,1
10021003,10021235,232,0,0,1,1
10021236,10021240,4,1,0,0,2
10021236,10021245,9,1,0,0,1
10021241,10022559,1318,0,0,1,2
10021246,10022556,1310,0,0,1,1
10022557,10022725,168,1,0,0,1
10022560,10022748,188,1,0,0,2
10022604,10022692,88,0,1,0,1
10022606,10022687,81,0,1,0,2
10022726,10022994,268,0,0,1,1
10022749,10022995,246,0,0,1,2
10022995,10023072,77,1,0,0,1
10022996,10023074,78,1,0,0,2
10023073,10023270,197,0,0,1,1
10023075,10023270,195,0,0,1,2
10023271,10023293,22,1,0,0,2
10023271,10023299,28,1,0,0,1
10023294,10023511,217,0,0,1,2
10023300,10024981,1681,0,0,1,1
10023512,10023522,10,1,0,0,2
10023523,10024982,1459,0,0,1,2
10024982,10025059,77,1,0,0,1
10024983,10025058,75,1,0,0,2
10025059,10025456,397,0,0,1,2
10025060,10025458,398,0,0,1,1
10025457,10025524,67,1,0,0,2
10025459,10025522,63,1,0,0,1
10025523,10025688,165,0,0,1,1
10025525,10025691,166,0,0,1,2
10025689,10025709,20,1,0,0,1
10025692,10025709,17,1,0,0,2
10025710,10026582,872,0,0,1,1
10025710,10026763,1053,0,0,1,2
10026583,10026596,13,1,0,0,1
10026597,10026765,168,0,0,1,1
10026764,10026787,23,1,0,0,2
10026766,10026783,17,1,0,0,1
10026784,10027255,471,0,0,1,1
10026788,10027257,469,0,0,1,2
10027256,10027526,270,1,0,0,1
10027258,10027523,265,1,0,0,2
10027323,10027494,171,0,1,0,1
10027327,10027486,159,0,1,0,2
10027524,10027705,181,0,0,1,2
10027527,10027706,179,0,0,1,1
10027706,10027764,58,1,0,0,2
10027707,10027773,66,1,0,0,1
10027765,10027910,145,0,0,1,2
10027774,10027910,136,0,0,1,1
10027911,10027930,19,1,0,0,2
10027911,10027932,21,1,0,0,1
10027931,10028152,221,0,0,1,2
10027933,10028153,220,0,0,1,1
10028153,10028164,11,1,0,0,2
10028154,10028161,7,1,0,0,1
10028162,10028801,639,0,0,1,1
10028165,10028806,641,0,0,1,2
10028802,10028818,16,1,0,0,1
10028807,10028817,10,1,0,0,2
10028818,10029420,602,0,0,1,2
10028819,10029420,601,0,0,1,1
10029421,10029448,27,1,0,0,1
10029421,10029454,33,1,0,0,2
10029449,10029888,439,0,0,1,1
10029455,10029888,433,0,0,1,2
10029889,10029953,64,1,0,0,1
10029889,10029985,96,1,0,0,2
10029954,10030096,142,0,0,1,1
10029986,10030096,110,0,0,1,2
10030097,10030116,19,1,0,0,1
10030097,10030138,41,1,0,0,2
10030117,10031676,1559,0,0,1,1
10030139,10030389,250,0,0,1,2
10030390,10030406,16,1,0,0,2
10030407,10031682,1275,0,0,1,2
10031677,10031863,186,1,0,0,1
10031683,10031903,220,1,0,0,2
10031719,10031837,118,0,1,0,2
10031720,10031840,120,0,1,0,1
10031864,10032107,243,0,0,1,1
10031904,10032105,201,0,0,1,2
10032106,10032184,78,1,0,0,2
10032108,10032181,73,1,0,0,1
10032182,10032254,72,0,0,1,1
10032185,10032255,70,0,0,1,2
10032255,10032288,33,1,0,0,1
10032256,10032279,23,1,0,0,2
10032280,10032469,189,0,0,1,2
10032289,10032470,181,0,0,1,1
10032470,10032492,22,1,0,0,2
10032471,10032481,10,1,0,0,1
10032482,10032924,442,0,0,1,1
10032493,10033943,1450,0,0,1,2
10032925,10032939,14,1,0,0,1
10032940,10033940,1000,0,0,1,1
10033941,10033982,41,1,0,0,1
10033944,10033990,46,1,0,0,2
10033983,10034389,406,0,0,1,1
10033991,10034391,400,0,0,1,2
10034390,10034469,79,1,0,0,1
10034392,10034471,79,1,0,0,2
10034470,10034577,107,0,0,1,1
10034472,10034578,106,0,0,1,2
10034578,10034612,34,1,0,0,1
10034579,10034612,33,1,0,0,2
10034613,10034709,96,0,0,1,2
10034613,10034711,98,0,0,1,1
10034710,10034732,22,1,0,0,2
10034712,10034728,16,1,0,0,1
10034729,10035130,401,0,0,1,1
10034733,10035424,691,0,0,1,2
10035131,10035154,23,1,0,0,1
10035155,10035193,38,0,0,1,1
10035194,10035211,17,1,0,0,1
10035212,10035422,210,0,0,1,1
10035423,10035454,31,1,0,0,1
10035425,10035451,26,1,0,0,2
10035452,10035666,214,0,0,1,2
10035455,10035666,211,0,0,1,1
10035667,10035677,10,1,0,0,2
10035667,10035678,11,1,0,0,1
10035678,10036325,647,0,0,1,2
10035679,10036325,646,0,0,1,1
10036326,10036538,212,1,0,0,1
10036326,10036560,234,1,0,0,2
10036369,10036526,157,0,1,0,1
10036371,10036523,152,0,1,0,2
10036539,10036812,273,0,0,1,1
10036561,10036814,253,0,0,1,2
10036813,10036890,77,1,0,0,1
10036815,10036882,67,1,0,0,2
10036883,10036976,93,0,0,1,2
10036891,10036978,87,0,0,1,1
10036977,10037005,28,1,0,0,2
10036979,10037004,25,1,0,0,1
10037005,10037239,234,0,0,1,1
10037006,10037237,231,0,0,1,2
10037238,10037251,13,1,0,0,2
10037240,10037250,10,1,0,0,1
10037251,10038770,1519,0,0,1,1
10037252,10038768,1516,0,0,1,2
10038769,10038905,136,1,0,0,2
10038771,10038904,133,1,0,0,1
10038905,10039243,338,0,0,1,1
10038906,10039242,336,0,0,1,2
10039243,10039348,105,1,0,0,2
10039244,10039350,106,1,0,0,1
10039349,10039407,58,0,0,1,2
10039351,10039408,57,0,0,1,1
10039408,10039431,23,1,0,0,2
10039409,10039432,23,1,0,0,1
10039432,10039483,51,0,0,1,2
10039433,10039488,55,0,0,1,1
10039484,10039532,48,1,0,0,2
10039489,10039517,28,1,0,0,1
10039518,10039967,449,0,0,1,1
10039533,10039963,430,0,0,1,2
10039964,10039980,16,1,0,0,2
10039968,10039979,11,1,0,0,1
10039980,10040228,248,0,0,1,1
10039981,10040227,246,0,0,1,2
10040228,10040242,14,1,0,0,2
10040229,10040235,6,1,0,0,1
10040236,10041263,1027,0,0,1,1
10040243,10041258,1015,0,0,1,2
10041259,10041494,235,1,0,0,2
10041264,10041503,239,1,0,0,1
10041303,10041453,150,0,1,0,1
10041305,10041452,147,0,1,0,2
10041495,10041586,91,0,0,1,2
10041504,10041585,81,0,0,1,1
10041586,10041611,25,1,0,0,1
10041587,10041608,21,1,0,0,2
10041609,10041754,145,0,0,1,2
10041612,10041755,143,0,0,1,1
10041755,10041821,66,1,0,0,2
10041756,10041820,64,1,0,0,1
10041821,10041935,114,0,0,1,1
10041822,10041934,112,0,0,1,2
10041935,10041957,22,1,0,0,2
10041936,10041956,20,1,0,0,1
10041957,10042153,196,0,0,1,1
10041958,10042154,196,0,0,1,2
10042154,10042165,11,1,0,0,1
10042155,10042166,11,1,0,0,2
10042166,10042346,180,0,0,1,1
10042167,10042347,180,0,0,1,2
10042347,10042359,12,1,0,0,1
10042348,10042358,10,1,0,0,2
10042359,10043485,1126,0,0,1,2
10042360,10042734,374,0,0,1,1
10042735,10042746,11,1,0,0,1
10042747,10043484,737,0,0,1,1
10043485,10043503,18,1,0,0,1
10043486,10043505,19,1,0,0,2
10043504,10043578,74,0,0,1,1
10043506,10043574,68,0,0,1,2
10043575,10043613,38,1,0,0,2
10043579,10043595,16,1,0,0,1
10043596,10043628,32,0,0,1,1
10043614,10043634,20,0,0,1,2
10043629,10043838,209,1,0,0,1
10043635,10043843,208,1,0,0,2
10043660,10043775,115,0,1,0,1
10043660,10043778,118,0,1,0,2
10043839,10044033,194,0,0,1,1
10043844,10044028,184,0,0,1,2
10044029,10044054,25,1,0,0,2
10044034,10044054,20,1,0,0,1
10044055,10044124,69,0,0,1,2
10044055,10044126,71,0,0,1,1
10044125,10044255,130,1,0,0,2
10044127,10044243,116,1,0,0,1
10044244,10044326,82,0,0,1,1
10044256,10044325,69,0,0,1,2
10044326,10044351,25,1,0,0,2
10044327,10044350,23,1,0,0,1
10044351,10044515,164,0,0,1,1
10044352,10044514,162,0,0,1,2
10044515,10044525,10,1,0,0,2
10044516,10044526,10,1,0,0,1
10044526,10044699,173,0,0,1,2
10044527,10044697,170,0,0,1,1
10044698,10044720,22,1,0,0,1
10044700,10044716,16,1,0,0,2
10044717,10045270,553,0,0,1,2
10044721,10045124,403,0,0,1,1
10045125,10045134,9,1,0,0,1
10045135,10045270,135,0,0,1,1
10045271,10045281,10,1,0,0,2
10045271,10045283,12,1,0,0,1
10045282,10045409,127,0,0,1,2
10045284,10045408,124,0,0,1,1
10045409,10045419,10,1,0,0,1
10045410,10045421,11,1,0,0,2
10045420,10045653,233,0,0,1,1
10045422,10045653,231,0,0,1,2
10045654,10045672,18,1,0,0,1
10045654,10045674,20,1,0,0,2
10045673,10045895,222,0,0,1,1
10045675,10045895,220,0,0,1,2
10045896,10045990,94,1,0,0,1
10045896,10045993,97,1,0,0,2
10045991,10046306,315,0,0,1,1
10045994,10046307,313,0,0,1,2
10046307,10046367,60,1,0,0,1
10046308,10046367,59,1,0,0,2
10046368,10046539,171,0,0,1,1
10046368,10046541,173,0,0,1,2
10046540,10046572,32,1,0,0,1
10046542,10046562,20,1,0,0,2
10046563,10048062,1499,0,0,1,2
10046573,10048060,1487,0,0,1,1
10048061,10048232,171,1,0,0,1
10048063,10048219,156,1,0,0,2
10048095,10048195,100,0,1,0,1
10048100,10048185,85,0,1,0,2
10048220,10048739,519,0,0,1,2
10048233,10048741,508,0,0,1,1
10048740,10048802,62,1,0,0,2
10048742,10048803,61,1,0,0,1
10048803,10048893,90,0,0,1,2
10048804,10048893,89,0,0,1,1
10048894,10048917,23,1,0,0,2
10048894,10048925,31,1,0,0,1
10048918,10049084,166,0,0,1,2
10048926,10049091,165,0,0,1,1
10049085,10049895,810,1,0,0,2
10049092,10049852,760,1,0,0,1
10049109,10049885,776,0,1,0,2
10049111,10049841,730,0,1,0,1
10049853,10050005,152,0,0,1,1
10049896,10050005,109,0,0,1,2
10050006,10050036,30,1,0,0,1
10050006,10050040,34,1,0,0,2
10050037,10050170,133,0,0,1,1
10050041,10050157,116,0,0,1,2
10050158,10050463,305,1,0,0,2
10050171,10050438,267,1,0,0,1
10050188,10050423,235,0,1,0,2
10050191,10050412,221,0,1,0,1
10050439,10050527,88,0,0,1,1
10050464,10050527,63,0,0,1,2
10050528,10050552,24,1,0,0,1
10050528,10050564,36,1,0,0,2
10050553,10050908,355,0,0,1,1
10050565,10050907,342,0,0,1,2
10050908,10050920,12,1,0,0,2
10050909,10050917,8,1,0,0,1
10050918,10052378,1460,0,0,1,1
10050921,10052376,1455,0,0,1,2
10052377,10052434,57,1,0,0,2
10052379,10052445,66,1,0,0,1
10052435,10052536,101,0,0,1,2
10052446,10052535,89,0,0,1,1
10052536,10052568,32,1,0,0,1
10052537,10052559,22,1,0,0,2
10052560,10052926,366,0,0,1,2
10052569,10052929,360,0,0,1,1
10052927,10052955,28,1,0,0,2
10052930,10052955,25,1,0,0,1
10052956,10053192,236,0,0,1,1
10052956,10054491,1535,0,0,1,2
10053193,10053208,15,1,0,0,1
10053209,10054489,1280,0,0,1,1
10054490,10054708,218,1,0,0,1
10054492,10054720,228,1,0,0,2
10054522,10054688,166,0,1,0,1
10054525,10054682,157,0,1,0,2
10054709,10055814,1105,0,0,1,1
10054721,10055815,1094,0,0,1,2
10055815,10055877,62,1,0,0,1
10055816,10055879,63,1,0,0,2
10055878,10056009,131,0,0,1,1
10055880,10056010,130,0,0,1,2
10056010,10056048,38,1,0,0,1
10056011,10056048,37,1,0,0,2
10056049,10057309,1260,0,0,1,2
10056049,10057310,1261,0,0,1,1
10057310,10057348,38,1,0,0,2
10057311,10057344,33,1,0,0,1
10057345,10057568,223,0,0,1,1
10057349,10057567,218,0,0,1,2
10057568,10057590,22,1,0,0,2
10057569,10057589,20,1,0,0,1
10057590,10057691,101,0,0,1,1
10057591,10057697,106,0,0,1,2
10057692,10058025,333,1,0,0,1
10057698,10058009,311,1,0,0,2
10057714,10058004,290,0,1,0,1
10057717,10057995,278,0,1,0,2
10058010,10058128,118,0,0,1,2
10058026,10058127,101,0,0,1,1
10058128,10058159,31,1,0,0,1
10058129,10058157,28,1,0,0,2
10058158,10059356,1198,0,0,1,2
10058160,10059356,1196,0,0,1,1
10059357,10059632,275,1,0,0,1
10059357,10059638,281,1,0,0,2
10059381,10059614,233,0,1,0,1
10059386,10059603,217,0,1,0,2
10059633,10060711,1078,0,0,1,1
10059639,10060709,1070,0,0,1,2
10060710,10060737,27,1,0,0,2
10060712,10060740,28,1,0,0,1
10060738,10060956,218,0,0,1,2
10060741,10060877,136,0,0,1,1
10060878,10060887,9,1,0,0,1
10060888,10060956,68,0,0,1,1
10060957,10060976,19,1,0,0,1
10060957,10060977,20,1,0,0,2
10060977,10061188,211,0,0,1,1
10060978,10061189,211,0,0,1,2
10061189,10061200,11,1,0,0,1
10061190,10061201,11,1,0,0,2
10061201,10061478,277,0,0,1,1
10061202,10061476,274,0,0,1,2
10061477,10061497,20,1,0,0,2
10061479,10061497,18,1,0,0,1
10061498,10062052,554,0,0,1,1
10061498,10062053,555,0,0,1,2
10062053,10062108,55,1,0,0,1
10062054,10062123,69,1,0,0,2
10062109,10062189,80,0,0,1,1
10062124,10062189,65,0,0,1,2
10062190,10062203,13,1,0,0,1
10062190,10062205,15,1,0,0,2
10062204,10062340,136,0,0,1,1
10062206,10062339,133,0,0,1,2
10062340,10062351,11,1,0,0,2
10062341,10062349,8,1,0,0,1
10062350,10062685,335,0,0,1,1
10062352,10062703,351,0,0,1,2
10062686,10063004,318,1,0,0,1
10062704,10062975,271,1,0,0,2
10062714,10062963,249,0,1,0,1
10062726,10062944,218,0,1,0,2
10062976,10063055,79,0,0,1,2
10063005,10063058,53,0,0,1,1
10063056,10063072,16,1,0,0,2
10063059,10063072,13,1,0,0,1
10063073,10064116,1043,0,0,1,2
10063073,10064117,1044,0,0,1,1
10064117,10064456,339,1,0,0,2
10064118,10064419,301,1,0,0,1
10064171,10064402,231,0,1,0,1
10064171,10064404,233,0,1,0,2
10064420,10064566,146,0,0,1,1
10064457,10064566,109,0,0,1,2
10064567,10064586,19,1,0,0,1
10064567,10064586,19,1,0,0,2
10064587,10065292,705,0,0,1,2
10064587,10065294,707,0,0,1,1
10065293,10065359,66,1,0,0,2
10065295,10065356,61,1,0,0,1
10065357,10065498,141,0,0,1,1
10065360,10065492,132,0,0,1,2
10065493,10065512,19,1,0,0,2
10065499,10065510,11,1,0,0,1
10065511,10065679,168,0,0,1,1
10065513,10065680,167,0,0,1,2
10065680,10065702,22,1,0,0,1
10065681,10065700,19,1,0,0,2
10065701,10066675,974,0,0,1,2
10065703,10066675,972,0,0,1,1
10066676,10066734,58,1,0,0,1
10066676,10066758,82,1,0,0,2
10066735,10066934,199,0,0,1,1
10066759,10066932,173,0,0,1,2
10066933,10066960,27,1,0,0,2
10066935,10066955,20,1,0,0,1
10066956,10067218,262,0,0,1,1
10066961,10067221,260,0,0,1,2
10067219,10067241,22,1,0,0,1
10067222,10067239,17,1,0,0,2
10067240,10067545,305,0,0,1,2
10067242,10067599,357,0,0,1,1
10067546,10067619,73,1,0,0,2
10067600,10067619,19,1,0,0,1
10067620,10067897,277,0,0,1,2
10067620,10067903,283,0,0,1,1
10067898,10067937,39,1,0,0,2
10067904,10067917,13,1,0,0,1
10067918,10068778,860,0,0,1,1
10067938,10068769,831,0,0,1,2
10068770,10069113,343,1,0,0,2
10068779,10069046,267,1,0,0,1
10068819,10069030,211,0,1,0,1
10068821,10069029,208,0,1,0,2
10069047,10069087,40,0,0,1,1
10069088,10069113,25,1,0,0,1
10069114,10069627,513,0,0,1,1
10069114,10069627,513,0,0,1,2
10069628,10069668,40,1,0,0,2
10069628,10069672,44,1,0,0,1
10069669,10069851,182,0,0,1,2
10069673,10069851,178,0,0,1,1
10069852,10069871,19,1,0,0,1
10069852,10069877,25,1,0,0,2
10069872,10070301,429,0,0,1,1
10069878,10070302,424,0,0,1,2
10070302,10070417,115,1,0,0,1
10070303,10070412,109,1,0,0,2
10070413,10070536,123,0,0,1,2
10070418,10070536,118,0,0,1,1
10070537,10070550,13,1,0,0,2
10070537,10070561,24,1,0,0,1
10070551,10070617,66,0,0,1,2
10070562,10070615,53,0,0,1,1
10070616,10070647,31,1,0,0,1
10070618,10070647,29,1,0,0,2
10070648,10070743,95,0,0,1,2
10070648,10070745,97,0,0,1,1
10070744,10070763,19,1,0,0,2
10070746,10070763,17,1,0,0,1
10070764,10070945,181,0,0,1,1
10070764,10071187,423,0,0,1,2
10070946,10070955,9,1,0,0,1
10070956,10071187,231,0,0,1,1
10071188,10071200,12,1,0,0,1
10071188,10071200,12,1,0,0,2
10071201,10071734,533,0,0,1,1
10071201,10071734,533,0,0,1,2
10071735,10071753,18,1,0,0,2
10071735,10071754,19,1,0,0,1
10071754,10072295,541,0,0,1,2
10071755,10072294,539,0,0,1,1
10072295,10072318,23,1,0,0,1
10072296,10072337,41,1,0,0,2
10072319,10073312,993,0,0,1,1
10072338,10073608,1270,0,0,1,2
10073313,10074317,1004,1,0,0,1
10073609,10073735,126,1,0,0,2
10073736,10073769,33,0,0,1,2
10073770,10074272,502,1,0,0,2
10074094,10074235,141,0,1,0,1
10074104,10074194,90,0,1,0,2
10074273,10074498,225,0,0,1,2
10074318,10074388,70,0,0,1,1
10074389,10074393,4,1,0,0,1
10074394,10074500,106,0,0,1,1
10074499,10074566,67,1,0,0,2
10074501,10074562,61,1,0,0,1
10074563,10074708,145,0,0,1,1
10074567,10074708,141,0,0,1,2
10074709,10074735,26,1,0,0,2
10074709,10074736,27,1,0,0,1
10074736,10074888,152,0,0,1,2
10074737,10074888,151,0,0,1,1
10074889,10074914,25,1,0,0,2
10074889,10074915,26,1,0,0,1
10074915,10075366,451,0,0,1,2
10074916,10075364,448,0,0,1,1
10075365,10075565,200,1,0,0,1
10075367,10075562,195,1,0,0,2
10075401,10075550,149,0,1,0,1
10075411,10075523,112,0,1,0,2
10075563,10075992,429,0,0,1,2
10075566,10075993,427,0,0,1,1
10075993,10076070,77,1,0,0,2
10075994,10076060,66,1,0,0,1
10076061,10076174,113,0,0,1,1
10076071,10076172,101,0,0,1,2
10076173,10076201,28,1,0,0,2
10076175,10076199,24,1,0,0,1
10076200,10076399,199,0,0,1,1
10076202,10076403,201,0,0,1,2
10076400,10076418,18,1,0,0,1
10076404,10076428,24,1,0,0,2
10076419,10077475,1056,0,0,1,1
10076429,10077473,1044,0,0,1,2
10077474,10077496,22,1,0,0,2
10077476,10077496,20,1,0,0,1
10077497,10078409,912,0,0,1,1
10077497,10078411,914,0,0,1,2
10078410,10078469,59,1,0,0,1
10078412,10078471,59,1,0,0,2
10078470,10078603,133,0,0,1,1
10078472,10078604,132,0,0,1,2
10078604,10078630,26,1,0,0,1
10078605,10078631,26,1,0,0,2
10078631,10078789,158,0,0,1,1
10078632,10078805,173,0,0,1,2
10078790,10079031,241,1,0,0,1
10078806,10079017,211,1,0,0,2
10078829,10078966,137,0,1,0,1
10078829,10078966,137,0,1,0,2
10079018,10079093,75,0,0,1,2
10079032,10079311,279,0,0,1,1
10079094,10079098,4,1,0,0,2
10079099,10079312,213,0,0,1,2
10079312,10079335,23,1,0,0,1
10079313,10079333,20,1,0,0,2
10079334,10079611,277,0,0,1,2
10079336,10079612,276,0,0,1,1
10079612,10079631,19,1,0,0,2
10079613,10079629,16,1,0,0,1
10079630,10079919,289,0,0,1,1
10079632,10079922,290,0,0,1,2
10079920,10079940,20,1,0,0,1
10079923,10079937,14,1,0,0,2
10079938,10080510,572,0,0,1,2
10079941,10080516,575,0,0,1,1
10080511,10080796,285,1,0,0,2
10080517,10080811,294,1,0,0,1
10080555,10080744,189,0,1,0,1
10080561,10080731,170,0,1,0,2
10080797,10080938,141,0,0,1,2
10080812,10080951,139,0,0,1,1
10080939,10081257,318,1,0,0,2
10080952,10081260,308,1,0,0,1
10080973,10081200,227,0,1,0,1
10080977,10081192,215,0,1,0,2
10081258,10081304,46,0,0,1,2
10081261,10081301,40,0,0,1,1
10081302,10081326,24,1,0,0,1
10081305,10081324,19,1,0,0,2
10081325,10081533,208,0,0,1,2
10081327,10081532,205,0,0,1,1
10081533,10081553,20,1,0,0,1
10081534,10081552,18,1,0,0,2
10081553,10081692,139,0,0,1,2
10081554,10081691,137,0,0,1,1
10081692,10081737,45,1,0,0,1
10081693,10081734,41,1,0,0,2
10081735,10081815,80,0,0,1,2
10081738,10081812,74,0,0,1,1
10081813,10081826,13,1,0,0,1
10081816,10081827,11,1,0,0,2
10081827,10081993,166,0,0,1,1
10081828,10082233,405,0,0,1,2
10081994,10082008,14,1,0,0,1
10082009,10082230,221,0,0,1,1
10082231,10082255,24,1,0,0,1
10082234,10082250,16,1,0,0,2
10082251,10082344,93,0,0,1,2
10082256,10082341,85,0,0,1,1
10082342,10082363,21,1,0,0,1
10082345,10082366,21,1,0,0,2
10082364,10082459,95,0,0,1,1
10082367,10082473,106,0,0,1,2
10082460,10082492,32,1,0,0,1
10082474,10082486,12,1,0,0,2
10082487,10082594,107,0,0,1,2
10082493,10082600,107,0,0,1,1
10082595,10082710,115,1,0,0,2
10082601,10082714,113,1,0,0,1
10082711,10082870,159,0,0,1,2
10082715,10082866,151,0,0,1,1
10082867,10082886,19,1,0,0,1
10082871,10082882,11,1,0,0,2
10082883,10082909,26,0,0,1,2
10082887,10082911,24,0,0,1,1
10082910,10082926,16,1,0,0,2
10082912,10082925,13,1,0,0,1
10082926,10082974,48,0,0,1,1
10082927,10082970,43,0,0,1,2
10082971,10082997,26,1,0,0,2
10082975,10082995,20,1,0,0,1
10082996,10083035,39,0,0,1,1
10082998,10083036,38,0,0,1,2
10083036,10083051,15,1,0,0,1
10083037,10083051,14,1,0,0,2
10083052,10083506,454,0,0,1,2
10083052,10083514,462,0,0,1,1
10083507,10084346,839,1,0,0,2
10083515,10084355,840,1,0,0,1
10083533,10084335,802,0,1,0,2
10083542,10084344,802,0,1,0,1
10084347,10084504,157,0,0,1,2
10084356,10084500,144,0,0,1,1
10084501,10084529,28,1,0,0,1
10084505,10084521,16,1,0,0,2
10084522,10084625,103,0,0,1,2
10084530,10084628,98,0,0,1,1
10084626,10084649,23,1,0,0,2
10084629,10084652,23,1,0,0,1
10084650,10084759,109,0,0,1,2
10084653,10084759,106,0,0,1,1
10084760,10084768,8,1,0,0,1
10084760,10084773,13,1,0,0,2
10084769,10084871,102,0,0,1,1
10084774,10084872,98,0,0,1,2
10084872,10084890,18,1,0,0,1
10084873,10084881,8,1,0,0,2
10084882,10084999,117,0,0,1,2
10084891,10084997,106,0,0,1,1
10084998,10085132,134,1,0,0,1
10085000,10085155,155,1,0,0,2
10085038,10085117,79,0,1,0,2
10085041,10085104,63,0,1,0,1
10085133,10085194,61,0,0,1,1
10085156,10085194,38,0,0,1,2
10085195,10085221,26,1,0,0,2
10085195,10085223,28,1,0,0,1
10085222,10085469,247,0,0,1,2
10085224,10085469,245,0,0,1,1
10085470,10085497,27,1,0,0,1
10085470,10085497,27,1,0,0,2
10085498,10086094,596,0,0,1,2
10085498,10086095,597,0,0,1,1
10086095,10086106,11,1,0,0,2
10086096,10086105,9,1,0,0,1
10086106,10087290,1184,0,0,1,1
10086107,10087291,1184,0,0,1,2
10087291,10087341,50,1,0,0,1
10087292,10087359,67,1,0,0,2
10087342,10087408,66,0,0,1,1
10087360,10087406,46,0,0,1,2
10087407,10087643,236,1,0,0,2
10087409,10087628,219,1,0,0,1
10087426,10087609,183,0,1,0,1
10087427,10087611,184,0,1,0,2
10087629,10087942,313,0,0,1,1
10087644,10087675,31,0,0,1,2
10087676,10087687,11,1,0,0,2
10087688,10087946,258,0,0,1,2
10087943,10087962,19,1,0,0,1
10087947,10087958,11,1,0,0,2
10087959,10089422,1463,0,0,1,2
10087963,10089423,1460,0,0,1,1
10089423,10089659,236,1,0,0,2
10089424,10089650,226,1,0,0,1
10089463,10089617,154,0,1,0,1
10089465,10089609,144,0,1,0,2
10089651,10090290,639,0,0,1,1
10089660,10089769,109,0,0,1,2
10089770,10089776,6,1,0,0,2
10089777,10090291,514,0,0,1,2
10090291,10090317,26,1,0,0,1
10090292,10090318,26,1,0,0,2
10090318,10090863,545,0,0,1,1
10090319,10090865,546,0,0,1,2
10090864,10090887,23,1,0,0,1
10090866,10090885,19,1,0,0,2
10090886,10091080,194,0,0,1,2
10090888,10091077,189,0,0,1,1
10091078,10091183,105,1,0,0,1
10091081,10091182,101,1,0,0,2
10091183,10091240,57,0,0,1,2
10091184,10091240,56,0,0,1,1
10091241,10091275,34,1,0,0,1
10091241,10091277,36,1,0,0,2
10091276,10091329,53,0,0,1,1
10091278,10091330,52,0,0,1,2
10091330,10091373,43,1,0,0,1
10091331,10091370,39,1,0,0,2
10091371,10091449,78,0,0,1,2
10091374,10091449,75,0,0,1,1
10091450,10091470,20,1,0,0,1
10091450,10091480,30,1,0,0,2
10091471,10091666,195,0,0,1,1
10091481,10091667,186,0,0,1,2
10091667,10091686,19,1,0,0,1
10091668,10091686,18,1,0,0,2
10091687,10092983,1296,0,0,1,2
10091687,10092986,1299,0,0,1,1
10092984,10093024,40,1,0,0,2
10092987,10093025,38,1,0,0,1
10093025,10093196,171,0,0,1,2
10093026,10094472,1446,0,0,1,1
10093197,10093207,10,1,0,0,2
10093208,10093529,321,0,0,1,2
10093530,10093556,26,1,0,0,2
10093557,10093582,25,0,0,1,2
10093583,10093691,108,1,0,0,2
10093692,10095011,1319,0,0,1,2
10094473,10094484,11,1,0,0,1
10094485,10095010,525,0,0,1,1
10095011,10095028,17,1,0,0,1
10095012,10095025,13,1,0,0,2
10095026,10095136,110,0,0,1,2
10095029,10095198,169,0,0,1,1
10095137,10095622,485,1,0,0,2
10095199,10095622,423,1,0,0,1
10095203,10095611,408,0,1,0,2
10095241,10095611,370,0,1,0,1
10095623,10095649,26,0,0,1,2
10095623,10096513,890,0,0,1,1
10095650,10095670,20,1,0,0,2
10095671,10096511,840,0,0,1,2
10096512,10096565,53,1,0,0,2
10096514,10096569,55,1,0,0,1
10096566,10096722,156,0,0,1,2
10096570,10096723,153,0,0,1,1
10096723,10096759,36,1,0,0,2
10096724,10096758,34,1,0,0,1
10096759,10096926,167,0,0,1,1
10096760,10096927,167,0,0,1,2
10096927,10096940,13,1,0,0,1
10096928,10096939,11,1,0,0,2
10096940,10097332,392,0,0,1,2
10096941,10097571,630,0,0,1,1
10097333,10097349,16,1,0,0,2
10097350,10097467,117,0,0,1,2
10097468,10097483,15,1,0,0,2
10097484,10098367,883,0,0,1,2
10097572,10097583,11,1,0,0,1
10097584,10099081,1497,0,0,1,1
10098368,10098461,93,1,0,0,2
10098462,10098506,44,0,0,1,2
10098507,10098551,44,1,0,0,2
10098552,10098694,142,0,0,1,2
10098695,10098716,21,1,0,0,2
10098717,10098835,118,0,0,1,2
10098836,10098935,99,1,0,0,2
10098936,10098982,46,0,0,1,2
10098983,10098994,11,1,0,0,2
10098995,10099025,30,0,0,1,2
10099026,10099037,11,1,0,0,2
10099038,10099060,22,0,0,1,2
10099061,10099401,340,1,0,0,2
10099082,10099369,287,1,0,0,1
10099094,10099352,258,0,1,0,2
10099097,10099350,253,0,1,0,1
10099370,10099516,146,0,0,1,1
10099402,10099486,84,0,0,1,2
10099487,10099549,62,1,0,0,2
10099517,10099550,33,1,0,0,1
10099550,10100141,591,0,0,1,2
10099551,10100140,589,0,0,1,1
10100141,10100170,29,1,0,0,1
10100142,10100161,19,1,0,0,2
10100162,10100467,305,0,0,1,2
10100171,10100468,297,0,0,1,1
10100468,10100499,31,1,0,0,2
10100469,10100489,20,1,0,0,1
10100490,10101138,648,0,0,1,1
10100500,10101118,618,0,0,1,2
10101119,10101448,329,1,0,0,2
10101139,10101428,289,1,0,0,1
10101155,10101406,251,0,1,0,1
10101156,10101410,254,0,1,0,2
10101429,10101551,122,0,0,1,1
10101449,10102027,578,0,0,1,2
10101552,10101562,10,1,0,0,1
10101563,10102027,464,0,0,1,1
10102028,10102086,58,1,0,0,1
10102028,10102086,58,1,0,0,2
10102087,10102958,871,0,0,1,1
10102087,10102958,871,0,0,1,2
10102959,10103014,55,1,0,0,2
10102959,10103017,58,1,0,0,1
10103015,10103142,127,0,0,1,2
10103018,10103141,123,0,0,1,1
10103142,10103176,34,1,0,0,1
10103143,10103175,32,1,0,0,2
10103176,10103499,323,0,0,1,2
10103177,10103499,322,0,0,1,1
10103500,10103519,19,1,0,0,2
10103500,10103524,24,1,0,0,1
10103520,10105305,1785,0,0,1,2
10103525,10105303,1778,0,0,1,1
10105304,10105536,232,1,0,0,1
10105306,10105535,229,1,0,0,2
10105360,10105468,108,0,1,0,2
10105361,10105470,109,0,1,0,1
10105536,10105697,161,0,0,1,2
10105537,10105696,159,0,0,1,1
10105697,10105711,14,1,0,0,1
10105698,10105712,14,1,0,0,2
10105712,10105863,151,0,0,1,1
10105713,10105865,152,0,0,1,2
10105864,10105886,22,1,0,0,1
10105866,10105885,19,1,0,0,2
10105886,10107339,1453,0,0,1,2
10105887,10106113,226,0,0,1,1
10106114,10106123,9,1,0,0,1
10106124,10107342,1218,0,0,1,1
10107340,10107368,28,1,0,0,2
10107343,10107368,25,1,0,0,1
10107369,10107403,34,0,0,1,2
10107369,10107431,62,0,0,1,1
10107404,10107809,405,1,0,0,2
10107432,10107760,328,1,0,0,1
10107460,10107716,256,0,1,0,1
10107461,10107724,263,0,1,0,2
10107761,10107976,215,0,0,1,1
10107810,10107977,167,0,0,1,2
10107977,10107990,13,1,0,0,1
10107978,10107992,14,1,0,0,2
10107991,10108219,228,0,0,1,1
10107993,10108220,227,0,0,1,2
10108220,10108244,24,1,0,0,1
10108221,10108244,23,1,0,0,2
10108245,10108419,174,0,0,1,1
10108245,10108419,174,0,0,1,2
10108420,10108446,26,1,0,0,1
10108420,10108448,28,1,0,0,2
10108447,10109281,834,0,0,1,1
10108449,10109279,830,0,0,1,2
10109280,10109344,64,1,0,0,2
10109282,10109336,54,1,0,0,1
10109337,10109605,268,0,0,1,1
10109345,10109611,266,0,0,1,2
10109606,10109626,20,1,0,0,1
10109612,10109624,12,1,0,0,2
10109625,10109931,306,0,0,1,2
10109627,10109932,305,0,0,1,1
10109932,10109946,14,1,0,0,2
10109933,10109945,12,1,0,0,1
10109946,10110831,885,0,0,1,1
10109947,10110826,879,0,0,1,2
10110827,10111042,215,1,0,0,2
10110832,10110996,164,1,0,0,1
10110848,10110976,128,0,1,0,2
10110851,10110959,108,0,1,0,1
10110997,10111098,101,0,0,1,1
10111043,10111102,59,0,0,1,2
10111099,10111117,18,1,0,0,1
10111103,10111111,8,1,0,0,2
10111112,10111503,391,0,0,1,2
10111118,10111501,383,0,0,1,1
10111502,10111571,69,1,0,0,1
10111504,10111573,69,1,0,0,2
10111572,10113644,2072,0,0,1,1
10111574,10113310,1736,0,0,1,2
10113311,10113338,27,1,0,0,2
10113339,10113408,69,0,0,1,2
10113409,10113449,40,1,0,0,2
10113450,10113498,48,0,0,1,2
10113499,10113730,231,1,0,0,2
10113645,10113662,17,1,0,0,1
10113663,10113945,282,0,0,1,1
10113731,10113945,214,0,0,1,2
10113946,10113987,41,1,0,0,2
10113946,10113997,51,1,0,0,1
10113988,10114119,131,0,0,1,2
10113998,10114119,121,0,0,1,1
10114120,10114167,47,1,0,0,2
10114120,10114176,56,1,0,0,1
10114168,10115344,1176,0,0,1,2
10114177,10115342,1165,0,0,1,1
10115343,10115379,36,1,0,0,1
10115345,10115375,30,1,0,0,2
10115376,10115591,215,0,0,1,2
10115380,10115592,212,0,0,1,1
10115592,10115608,16,1,0,0,2
10115593,10115604,11,1,0,0,1
10115605,10115763,158,0,0,1,1
10115609,10115765,156,0,0,1,2
10115764,10115968,204,1,0,0,1
10115766,10115995,229,1,0,0,2
10115785,10115936,151,0,1,0,1
10115785,10115939,154,0,1,0,2
10115969,10116665,696,0,0,1,1
10115996,10116668,672,0,0,1,2
10116666,10116692,26,1,0,0,1
10116669,10116684,15,1,0,0,2
10116685,10117331,646,0,0,1,2
10116693,10117329,636,0,0,1,1
10117330,10117594,264,1,0,0,1
10117332,10117583,251,1,0,0,2
10117377,10117572,195,0,1,0,1
10117381,10117555,174,0,1,0,2
10117584,10117750,166,0,0,1,2
10117595,10117749,154,0,0,1,1
10117750,10117768,18,1,0,0,1
10117751,10117778,27,1,0,0,2
10117769,10118153,384,0,0,1,1
10117779,10118154,375,0,0,1,2
10118154,10118165,11,1,0,0,1
10118155,10118166,11,1,0,0,2
10118166,10118281,115,0,0,1,1
10118167,10118281,114,0,0,1,2
10118282,10118299,17,1,0,0,2
10118282,10118301,19,1,0,0,1
10118300,10119362,1062,0,0,1,2
10118302,10119365,1063,0,0,1,1
10119363,10119742,379,1,0,0,2
10119366,10119708,342,1,0,0,1
10119412,10119687,275,0,1,0,1
10119414,10119687,273,0,1,0,2
10119709,10120181,472,0,0,1,1
10119743,10120186,443,0,0,1,2
10120182,10120202,20,1,0,0,1
10120187,10120196,9,1,0,0,2
10120197,10120327,130,0,0,1,2
10120203,10120328,125,0,0,1,1
10120328,10120355,27,1,0,0,2
10120329,10120356,27,1,0,0,1
10120356,10120381,25,0,0,1,2
10120357,10120395,38,0,0,1,1
10120382,10120411,29,1,0,0,2
10120396,10120406,10,1,0,0,1
10120407,10120787,380,0,0,1,1
10120412,10120787,375,0,0,1,2
10120788,10120823,35,1,0,0,1
10120788,10120824,36,1,0,0,2
10120824,10121061,237,0,0,1,1
10120825,10121062,237,0,0,1,2
10121062,10121108,46,1,0,0,1
10121063,10121108,45,1,0,0,2
10121109,10121237,128,0,0,1,2
10121109,10121238,129,0,0,1,1
10121238,10121265,27,1,0,0,2
10121239,10121256,17,1,0,0,1
10121257,10121438,181,0,0,1,1
10121266,10121446,180,0,0,1,2
10121439,10121451,12,1,0,0,1
10121447,10121452,5,1,0,0,2
10121452,10122732,1280,0,0,1,1
10121453,10122732,1279,0,0,1,2
10122733,10122801,68,1,0,0,1
10122733,10122821,88,1,0,0,2
10122802,10122908,106,0,0,1,1
10122822,10122910,88,0,0,1,2
10122909,10122945,36,1,0,0,1
10122911,10122937,26,1,0,0,2
10122938,10123144,206,0,0,1,2
10122946,10123142,196,0,0,1,1
10123143,10123426,283,1,0,0,1
10123145,10123431,286,1,0,0,2
10123156,10123411,255,0,1,0,1
10123159,10123405,246,0,1,0,2
10123427,10123470,43,0,0,1,1
10123432,10123470,38,0,0,1,2
10123471,10123491,20,1,0,0,2
10123471,10123495,24,1,0,0,1
10123492,10123680,188,0,0,1,2
10123496,10123680,184,0,0,1,1
10123681,10123700,19,1,0,0,1
10123681,10123702,21,1,0,0,2
10123701,10123897,196,0,0,1,1
10123703,10123900,197,0,0,1,2
10123898,10123922,24,1,0,0,1
10123901,10123922,21,1,0,0,2
10123923,10124048,125,0,0,1,2
10123923,10124052,129,0,0,1,1
10124049,10124070,21,1,0,0,2
10124053,10124068,15,1,0,0,1
10124069,10124814,745,0,0,1,1
10124071,10124203,132,0,0,1,2
10124204,10124217,13,1,0,0,2
10124218,10124804,586,0,0,1,2
10124805,10125220,415,1,0,0,2
10124815,10125248,433,1,0,0,1
10124867,10125237,370,0,1,0,1
10124875,10125208,333,0,1,0,2
10125221,10125617,396,0,0,1,2
10125249,10125615,366,0,0,1,1
10125616,10125632,16,1,0,0,1
10125618,10125630,12,1,0,0,2
10125631,10126223,592,0,0,1,2
10125633,10125819,186,0,0,1,1
10125820,10125826,6,1,0,0,1
10125827,10126221,394,0,0,1,1
10126222,10126291,69,1,0,0,1
10126224,10126285,61,1,0,0,2
10126286,10126367,81,0,0,1,2
10126292,10126364,72,0,0,1,1
10126365,10126408,43,1,0,0,1
10126368,10126408,40,1,0,0,2
10126409,10126488,79,0,0,1,2
10126409,10126490,81,0,0,1,1
10126489,10126525,36,1,0,0,2
10126491,10126514,23,1,0,0,1
10126515,10126643,128,0,0,1,1
10126526,10126643,117,0,0,1,2
10126644,10126664,20,1,0,0,1
10126644,10126665,21,1,0,0,2
10126665,10126947,282,0,0,1,1
10126666,10126953,287,0,0,1,2
10126948,10126965,17,1,0,0,1
10126954,10126968,14,1,0,0,2
10126966,10127629,663,0,0,1,1
10126969,10127631,662,0,0,1,2
10127630,10127643,13,1,0,0,1
10127632,10127641,9,1,0,0,2
10127642,10128097,455,0,0,1,2
10127644,10128096,452,0,0,1,1
10128097,10128157,60,1,0,0,1
10128098,10128155,57,1,0,0,2
10128156,10128295,139,0,0,1,2
10128158,10128296,138,0,0,1,1
10128296,10128312,16,1,0,0,2
10128297,10128311,14,1,0,0,1
10128312,10128722,410,0,0,1,1
10128313,10128721,408,0,0,1,2
10128722,10128735,13,1,0,0,2
10128723,10128735,12,1,0,0,1
10128736,10129254,518,0,0,1,2
10128736,10129255,519,0,0,1,1
10129255,10129268,13,1,0,0,2
10129256,10129269,13,1,0,0,1
10129269,10129654,385,0,0,1,2
10129270,10129656,386,0,0,1,1
10129655,10129668,13,1,0,0,2
10129657,10129665,8,1,0,0,1
10129666,10130302,636,0,0,1,1
10129669,10129986,317,0,0,1,2
10129987,10129992,5,1,0,0,2
10129993,10130326,333,0,0,1,2
10130303,10130732,429,1,0,0,1
10130327,10130723,396,1,0,0,2
10130351,10130721,370,0,1,0,1
10130373,10130706,333,0,1,0,2
10130724,10130760,36,0,0,1,2
10130733,10130763,30,0,0,1,1
10130761,10130775,14,1,0,0,2
10130764,10130775,11,1,0,0,1
10130776,10131181,405,0,0,1,2
10130776,10131650,874,0,0,1,1
10131182,10131201,19,1,0,0,2
10131202,10131652,450,0,0,1,2
10131651,10131677,26,1,0,0,1
10131653,10131673,20,1,0,0,2
10131674,10131854,180,0,0,1,2
10131678,10131854,176,0,0,1,1
10131855,10131928,73,1,0,0,2
10131855,10131931,76,1,0,0,1
10131929,10131975,46,0,0,1,2
10131932,10131973,41,0,0,1,1
10131974,10132000,26,1,0,0,1
10131976,10132000,24,1,0,0,2
10132001,10132066,65,0,0,1,2
10132001,10132067,66,0,0,1,1
10132067,10132116,49,1,0,0,2
10132068,10132116,48,1,0,0,1
10132117,10132238,121,0,0,1,2
10132117,10132240,123,0,0,1,1
10132239,10132279,40,1,0,0,2
10132241,10132282,41,1,0,0,1
10132280,10132427,147,0,0,1,2
10132283,10132429,146,0,0,1,1
10132428,10132454,26,1,0,0,2
10132430,10132450,20,1,0,0,1
10132451,10134038,1587,0,0,1,1
10132455,10134038,1583,0,0,1,2
10134039,10134126,87,1,0,0,1
10134039,10134127,88,1,0,0,2
10134127,10134216,89,0,0,1,1
10134128,10134217,89,0,0,1,2
10134217,10134243,26,1,0,0,1
10134218,10134242,24,1,0,0,2
10134243,10134326,83,0,0,1,2
10134244,10134324,80,0,0,1,1
10134325,10134350,25,1,0,0,1
10134327,10134362,35,1,0,0,2
10134351,10134635,284,0,0,1,1
10134363,10134637,274,0,0,1,2
10134636,10134651,15,1,0,0,1
10134638,10134652,14,1,0,0,2
10134652,10135043,391,0,0,1,1
10134653,10135042,389,0,0,1,2
10135043,10135057,14,1,0,0,2
10135044,10135056,12,1,0,0,1
10135057,10136166,1109,0,0,1,1
10135058,10136168,1110,0,0,1,2
10136167,10136407,240,1,0,0,1
10136169,10136411,242,1,0,0,2
10136196,10136374,178,0,1,0,1
10136198,10136368,170,0,1,0,2
10136408,10136477,69,0,0,1,1
10136412,10136475,63,0,0,1,2
10136476,10136501,25,1,0,0,2
10136478,10136500,22,1,0,0,1
10136501,10136731,230,0,0,1,1
10136502,10136730,228,0,0,1,2
10136731,10137005,274,1,0,0,2
10136732,10137014,282,1,0,0,1
10136755,10136961,206,0,1,0,1
10136757,10136966,209,0,1,0,2
10137006,10137643,637,0,0,1,2
10137015,10137644,629,0,0,1,1
10137644,10137699,55,1,0,0,2
10137645,10137692,47,1,0,0,1
10137693,10137839,146,0,0,1,1
10137700,10137839,139,0,0,1,2
10137840,10137858,18,1,0,0,2
10137840,10137869,29,1,0,0,1
10137859,10138614,755,0,0,1,2
10137870,10138613,743,0,0,1,1
10138614,10138627,13,1,0,0,1
10138615,10138627,12,1,0,0,2
10138628,10139141,513,0,0,1,2
10138628,10139148,520,0,0,1,1
10139142,10139159,17,1,0,0,2
10139149,10139158,9,1,0,0,1
10139159,10139995,836,0,0,1,1
10139160,10139997,837,0,0,1,2
10139996,10140282,286,1,0,0,1
10139998,10140299,301,1,0,0,2
10140083,10140245,162,0,1,0,2
10140083,10140248,165,0,1,0,1
10140283,10140397,114,0,0,1,1
10140300,10140397,97,0,0,1,2
10140398,10140418,20,1,0,0,1
10140398,10140418,20,1,0,0,2
10140419,10140542,123,0,0,1,1
10140419,10140544,125,0,0,1,2
10140543,10140556,13,1,0,0,1
10140545,10140555,10,1,0,0,2
10140556,10140664,108,0,0,1,2
10140557,10140660,103,0,0,1,1
10140661,10140682,21,1,0,0,1
10140665,10140680,15,1,0,0,2
10140681,10140794,113,0,0,1,2
10140683,10140795,112,0,0,1,1
10140795,10140808,13,1,0,0,2
10140796,10140809,13,1,0,0,1
10140809,10141796,987,0,0,1,2
10140810,10142213,1403,0,0,1,1
10141797,10141802,5,1,0,0,2
10141803,10142218,415,0,0,1,2
10142214,10142806,592,1,0,0,1
10142219,10142775,556,1,0,0,2
10142246,10142724,478,0,1,0,1
10142256,10142733,477,0,1,0,2
10142776,10142802,26,0,0,1,2
10142803,10142813,10,1,0,0,2
10142807,10143350,543,0,0,1,1
10142814,10143197,383,0,0,1,2
10143198,10143208,10,1,0,0,2
10143209,10143346,137,0,0,1,2
10143347,10143370,23,1,0,0,2
10143351,10143371,20,1,0,0,1
10143371,10143556,185,0,0,1,2
10143372,10143564,192,0,0,1,1
10143557,10143577,20,1,0,0,2
10143565,10143576,11,1,0,0,1
10143577,10144057,480,0,0,1,1
10143578,10143674,96,0,0,1,2
10143675,10143705,30,1,0,0,2
10143706,10144059,353,0,0,1,2
10144058,10144112,54,1,0,0,1
10144060,10144109,49,1,0,0,2
10144110,10144235,125,0,0,1,2
10144113,10144234,121,0,0,1,1
10144235,10144266,31,1,0,0,1
10144236,10144267,31,1,0,0,2
10144267,10144372,105,0,0,1,1
10144268,10144373,105,0,0,1,2
10144373,10144408,35,1,0,0,1
10144374,10144400,26,1,0,0,2
10144401,10144624,223,0,0,1,2
10144409,10144623,214,0,0,1,1
10144624,10144633,9,1,0,0,1
10144625,10144639,14,1,0,0,2
10144634,10144990,356,0,0,1,1
10144640,10144990,350,0,0,1,2
10144991,10145003,12,1,0,0,2
10144991,10145004,13,1,0,0,1
10145004,10145606,602,0,0,1,2
10145005,10146565,1560,0,0,1,1
10145607,10145618,11,1,0,0,2
10145619,10146573,954,0,0,1,2
10146566,10146846,280,1,0,0,1
10146574,10146841,267,1,0,0,2
10146630,10146783,153,0,1,0,1
10146633,10146775,142,0,1,0,2
10146842,10148291,1449,0,0,1,2
10146847,10148291,1444,0,0,1,1
10148292,10148311,19,1,0,0,1
10148292,10148311,19,1,0,0,2
10148312,10149269,957,0,0,1,1
10148312,10149278,966,0,0,1,2
10149270,10149514,244,1,0,0,1
10149279,10149536,257,1,0,0,2
10149301,10149458,157,0,1,0,1
10149306,10149458,152,0,1,0,2
10149515,10149667,152,0,0,1,1
10149537,10149668,131,0,0,1,2
10149668,10149694,26,1,0,0,1
10149669,10149694,25,1,0,0,2
10149695,10149921,226,0,0,1,1
10149695,10149923,228,0,0,1,2
10149922,10149945,23,1,0,0,1
10149924,10149943,19,1,0,0,2
10149944,10150607,663,0,0,1,2
10149946,10150607,661,0,0,1,1
10150608,10150700,92,1,0,0,2
10150608,10150701,93,1,0,0,1
10150701,10150812,111,0,0,1,2
10150702,10150813,111,0,0,1,1
10150813,10150905,92,1,0,0,2
10150814,10150837,23,1,0,0,1
10150838,10150970,132,0,0,1,1
10150906,10150939,33,0,0,1,2
10150940,10151067,127,1,0,0,2
10150971,10150992,21,1,0,0,1
10150993,10151154,161,0,0,1,1
10151068,10151107,39,0,0,1,2
10151108,10151612,504,1,0,0,2
10151155,10151424,269,1,0,0,1
10151159,10151423,264,0,1,0,2
10151167,10151401,234,0,1,0,1
10151425,10151516,91,0,0,1,1
10151517,10151538,21,1,0,0,1
10151539,10151650,111,0,0,1,1
10151613,10151648,35,0,0,1,2
10151649,10151683,34,1,0,0,2
10151651,10151678,27,1,0,0,1
10151679,10151798,119,0,0,1,1
10151684,10151709,25,0,0,1,2
10151710,10151724,14,1,0,0,2
10151725,10151801,76,0,0,1,2
10151799,10151811,12,1,0,0,1
10151802,10151813,11,1,0,0,2
10151812,10151959,147,0,0,1,1
10151814,10151956,142,0,0,1,2
10151957,10151978,21,1,0,0,2
10151960,10151978,18,1,0,0,1
10151979,10152169,190,0,0,1,2
10151979,10152801,822,0,0,1,1
10152170,10152175,5,1,0,0,2
10152176,10152800,624,0,0,1,2
10152801,10152836,35,1,0,0,2
10152802,10152837,35,1,0,0,1
10152837,10154040,1203,0,0,1,2
10152838,10153135,297,0,0,1,1
10153136,10153145,9,1,0,0,1
10153146,10154392,1246,0,0,1,1
10154041,10155028,987,1,0,0,2
10154183,10154924,741,0,1,0,2
10154393,10154749,356,1,0,0,1
10154517,10154524,7,0,1,0,1
10154551,10154658,107,0,1,0,1
10154750,10154779,29,0,0,1,1
10154780,10154812,32,1,0,0,1
10154813,10155007,194,0,0,1,1
10155008,10155038,30,1,0,0,1
10155029,10155065,36,0,0,1,2
10155039,10155064,25,0,0,1,1
10155065,10155093,28,1,0,0,1
10155066,10155078,12,1,0,0,2
10155079,10155421,342,0,0,1,2
10155094,10155407,313,0,0,1,1
10155408,10155467,59,1,0,0,1
10155422,10155479,57,1,0,0,2
10155468,10155931,463,0,0,1,1
10155480,10155673,193,0,0,1,2
10155674,10155679,5,1,0,0,2
10155680,10155926,246,0,0,1,2
10155927,10156207,280,1,0,0,2
10155932,10156200,268,1,0,0,1
10155948,10156134,186,0,1,0,2
10155950,10156131,181,0,1,0,1
10156201,10156267,66,0,0,1,1
10156208,10156266,58,0,0,1,2
10156267,10156315,48,1,0,0,2
10156268,10156300,32,1,0,0,1
10156301,10156432,131,0,0,1,1
10156316,10156430,114,0,0,1,2
10156431,10156506,75,1,0,0,2
10156433,10156498,65,1,0,0,1
10156499,10156634,135,0,0,1,1
10156507,10156635,128,0,0,1,2
10156635,10156662,27,1,0,0,1
10156636,10156661,25,1,0,0,2
10156662,10159416,2754,0,0,1,2
10156663,10158720,2057,0,0,1,1
10158721,10158732,11,1,0,0,1
10158733,10159419,686,0,0,1,1
10159417,10159665,248,1,0,0,2
10159420,10159657,237,1,0,0,1
10159459,10159626,167,0,1,0,2
10159461,10159620,159,0,1,0,1
10159658,10159778,120,0,0,1,1
10159666,10159777,111,0,0,1,2
10159778,10159809,31,1,0,0,2
10159779,10159805,26,1,0,0,1
10159806,10160035,229,0,0,1,1
10159810,10160042,232,0,0,1,2
10160036,10160052,16,1,0,0,1
10160043,10160051,8,1,0,0,2
10160052,10161515,1463,0,0,1,2
10160053,10161514,1461,0,0,1,1
10161515,10161802,287,1,0,0,1
10161516,10161820,304,1,0,0,2
10161549,10161776,227,0,1,0,2
10161550,10161775,225,0,1,0,1
10161803,10162154,351,0,0,1,1
10161821,10162153,332,0,0,1,2
10162154,10162178,24,1,0,0,2
10162155,10162191,36,1,0,0,1
10162179,10163247,1068,0,0,1,2
10162192,10163248,1056,0,0,1,1
10163248,10163277,29,1,0,0,2
10163249,10163287,38,1,0,0,1
10163278,10163398,120,0,0,1,2
10163288,10163399,111,0,0,1,1
10163399,10163420,21,1,0,0,2
10163400,10163418,18,1,0,0,1
10163419,10164673,1254,0,0,1,1
10163421,10164674,1253,0,0,1,2
10164674,10164717,43,1,0,0,1
10164675,10164718,43,1,0,0,2
10164718,10164832,114,0,0,1,1
10164719,10164833,114,0,0,1,2
10164833,10164864,31,1,0,0,1
10164834,10164856,22,1,0,0,2
10164857,10164968,111,0,0,1,2
10164865,10164970,105,0,0,1,1
10164969,10164987,18,1,0,0,2
10164971,10164987,16,1,0,0,1
10164988,10165709,721,0,0,1,2
10164988,10165712,724,0,0,1,1
10165710,10165723,13,1,0,0,2
10165713,10165718,5,1,0,0,1
10165719,10165863,144,0,0,1,1
10165724,10165861,137,0,0,1,2
10165862,10165870,8,1,0,0,2
10165864,10165870,6,1,0,0,1
10165871,10165987,116,0,0,1,2
10165871,10166816,945,0,0,1,1
10165988,10166002,14,1,0,0,2
10166003,10166823,820,0,0,1,2
10166817,10167095,278,1,0,0,1
10166824,10167110,286,1,0,0,2
10166839,10167055,216,0,1,0,1
10166847,10167052,205,0,1,0,2
10167096,10168259,1163,0,0,1,1
10167111,10168258,1147,0,0,1,2
10168259,10168319,60,1,0,0,2
10168260,10168335,75,1,0,0,1
10168320,10168496,176,0,0,1,2
10168336,10168502,166,0,0,1,1
10168497,10168519,22,1,0,0,2
10168503,10168517,14,1,0,0,1
10168518,10170087,1569,0,0,1,1
10168520,10170084,1564,0,0,1,2
10170085,10170348,263,1,0,0,2
10170088,10170305,217,1,0,0,1
10170117,10170303,186,0,1,0,2
10170124,10170281,157,0,1,0,1
10170306,10170384,78,0,0,1,1
10170349,10170387,38,0,0,1,2
10170385,10170411,26,1,0,0,1
10170388,10170411,23,1,0,0,2
10170412,10170554,142,0,0,1,1
10170412,10170554,142,0,0,1,2
10170555,10170576,21,1,0,0,2
10170555,10170581,26,1,0,0,1
10170577,10170676,99,0,0,1,2
10170582,10170673,91,0,0,1,1
10170674,10170693,19,1,0,0,1
10170677,10170695,18,1,0,0,2
10170694,10170959,265,0,0,1,1
10170696,10170724,28,0,0,1,2
10170725,10170851,126,1,0,0,2
10170852,10170953,101,0,0,1,2
10170954,10171245,291,1,0,0,2
10170960,10170974,14,1,0,0,1
10170975,10171134,159,0,0,1,1
10171135,10171156,21,1,0,0,1
10171157,10171593,436,0,0,1,1
10171246,10171408,162,0,0,1,2
10171409,10171448,39,1,0,0,2
10171449,10171499,50,0,0,1,2
10171500,10171510,10,1,0,0,2
10171511,10171593,82,0,0,1,2
10171594,10171607,13,1,0,0,1
10171594,10171608,14,1,0,0,2
10171608,10172056,448,0,0,1,1
10171609,10171669,60,0,0,1,2
10171670,10171700,30,1,0,0,2
10171701,10171773,72,0,0,1,2
10171774,10171789,15,1,0,0,2
10171790,10172053,263,0,0,1,2
10172054,10172058,4,1,0,0,2
10172057,10172463,406,1,0,0,1
10172059,10172079,20,0,0,1,2
10172080,10172452,372,1,0,0,2
10172106,10172440,334,0,1,0,1
10172113,10172407,294,0,1,0,2
10172453,10173443,990,0,0,1,2
10172464,10173447,983,0,0,1,1
10173444,10173496,52,1,0,0,2
10173448,10173468,20,1,0,0,1
10173469,10175340,1871,0,0,1,1
10173497,10174078,581,0,0,1,2
10174079,10174083,4,1,0,0,2
10174084,10175782,1698,0,0,1,2
10175341,10175896,555,1,0,0,1
10175783,10175793,10,1,0,0,2
10175794,10175859,65,0,0,1,2
10175860,10175876,16,1,0,0,2
10175877,10175923,46,0,0,1,2
10175897,10175938,41,0,0,1,1
10175924,10175948,24,1,0,0,2
10175939,10175957,18,1,0,0,1
10175949,10175986,37,0,0,1,2
10175958,10175981,23,0,0,1,1
10175987,10175998,11,1,0,0,2
10175992,10177029,1037,0,1,0,1
10175999,10176027,28,0,0,1,2
10176028,10176230,202,1,0,0,2
10176231,10176253,22,0,0,1,2
10176254,10176592,338,1,0,0,2
10176593,10176620,27,0,0,1,2
10176631,10176871,240,0,1,0,2
10176881,10177074,193,1,0,0,2
10177039,10177107,68,1,0,0,1
10177075,10177414,339,0,0,1,2
10177108,10177402,294,0,0,1,1
10177403,10177491,88,1,0,0,1
10177415,10177487,72,1,0,0,2
10177488,10177684,196,0,0,1,2
10177492,10177685,193,0,0,1,1
10177685,10177719,34,1,0,0,2
10177686,10177716,30,1,0,0,1
10177717,10178175,458,0,0,1,1
10177720,10178173,453,0,0,1,2
10178174,10178243,69,1,0,0,2
10178176,10178245,69,1,0,0,1
10178244,10178356,112,0,0,1,2
10178246,10178355,109,0,0,1,1
10178356,10178392,36,1,0,0,1
10178357,10178388,31,1,0,0,2
10178389,10178958,569,0,0,1,2
10178393,10178960,567,0,0,1,1
10178959,10178979,20,1,0,0,2
10178961,10178978,17,1,0,0,1
10178979,10179200,221,0,0,1,1
10178980,10179193,213,0,0,1,2
10179194,10179441,247,1,0,0,2
10179201,10179411,210,1,0,0,1
10179217,10179387,170,0,1,0,2
10179224,10179375,151,0,1,0,1
10179412,10179609,197,0,0,1,1
10179442,10179483,41,0,0,1,2
10179484,10179499,15,1,0,0,2
10179500,10179612,112,0,0,1,2
10179610,10179628,18,1,0,0,1
10179613,10179626,13,1,0,0,2
10179627,10180980,1353,0,0,1,2
10179629,10180979,1350,0,0,1,1
10180980,10181028,48,1,0,0,1
10180981,10181029,48,1,0,0,2
10181029,10181515,486,0,0,1,1
10181030,10181518,488,0,0,1,2
10181516,10181760,244,1,0,0,1
10181519,10181766,247,1,0,0,2
10181536,10181725,189,0,1,0,1
10181540,10181721,181,0,1,0,2
10181761,10183053,1292,0,0,1,1
10181767,10181793,26,0,0,1,2
10181794,10181809,15,1,0,0,2
10181810,10183052,1242,0,0,1,2
10183053,10183301,248,1,0,0,2
10183054,10183297,243,1,0,0,1
10183074,10183250,176,0,1,0,2
10183075,10183249,174,0,1,0,1
10183298,10184093,795,0,0,1,1
10183302,10183339,37,0,0,1,2
10183340,10183356,16,1,0,0,2
10183357,10184093,736,0,0,1,2
10184094,10184135,41,1,0,0,2
10184094,10184143,49,1,0,0,1
10184136,10184358,222,0,0,1,2
10184144,10184359,215,0,0,1,1
10184359,10184440,81,1,0,0,2
10184360,10184433,73,1,0,0,1
10184434,10184577,143,0,0,1,1
10184441,10184518,77,0,0,1,2
10184519,10184549,30,1,0,0,2
10184550,10184576,26,0,0,1,2
10184577,10184638,61,1,0,0,2
10184578,10184599,21,1,0,0,1
10184600,10184812,212,0,0,1,1
10184639,10184810,171,0,0,1,2
10184811,10184844,33,1,0,0,2
10184813,10184841,28,1,0,0,1
10184842,10184981,139,0,0,1,1
10184845,10184924,79,0,0,1,2
10184925,10184996,71,1,0,0,2
10184982,10184994,12,1,0,0,1
10184995,10185244,249,0,0,1,1
10184997,10185243,246,0,0,1,2
10185244,10185274,30,1,0,0,2
10185245,10185262,17,1,0,0,1
10185263,10186112,849,0,0,1,1
10185275,10185382,107,0,0,1,2
10185383,10185437,54,1,0,0,2
10185438,10185770,332,0,0,1,2
10185771,10185800,29,1,0,0,2
10185801,10185958,157,0,0,1,2
10185959,10185978,19,1,0,0,2
10185979,10186018,39,0,0,1,2
10186019,10186073,54,1,0,0,2
10186074,10186111,37,0,0,1,2
10186112,10186160,48,1,0,0,2
10186113,10186169,56,1,0,0,1
10186161,10186366,205,0,0,1,2
10186170,10186366,196,0,0,1,1
10186367,10186399,32,1,0,0,1
10186367,10186399,32,1,0,0,2
10186400,10186634,234,0,0,1,2
10186400,10186636,236,0,0,1,1
10186635,10186666,31,1,0,0,2
10186637,10186656,19,1,0,0,1
10186657,10188199,1542,0,0,1,1
10186667,10188199,1532,0,0,1,2
10188200,10188545,345,1,0,0,1
10188200,10188568,368,1,0,0,2
10188246,10188480,234,0,1,0,1
10188246,10188481,235,0,1,0,2
10188546,10188606,60,0,0,1,1
10188569,10188604,35,0,0,1,2
10188605,10188628,23,1,0,0,2
10188607,10188626,19,1,0,0,1
10188627,10188914,287,0,0,1,1
10188629,10188915,286,0,0,1,2
10188915,10188949,34,1,0,0,1
10188916,10188940,24,1,0,0,2
10188941,10189111,170,0,0,1,2
10188950,10189109,159,0,0,1,1
10189110,10189135,25,1,0,0,1
10189112,10189134,22,1,0,0,2
10189135,10189331,196,0,0,1,2
10189136,10189330,194,0,0,1,1
10189331,10189381,50,1,0,0,1
10189332,10189382,50,1,0,0,2
10189382,10189439,57,0,0,1,1
10189383,10189440,57,0,0,1,2
10189440,10189485,45,1,0,0,1
10189441,10189489,48,1,0,0,2
10189486,10189604,118,0,0,1,1
10189490,10189605,115,0,0,1,2
10189605,10189643,38,1,0,0,1
10189606,10189639,33,1,0,0,2
10189640,10189978,338,0,0,1,2
10189644,10189979,335,0,0,1,1
10189979,10189995,16,1,0,0,2
10189980,10189994,14,1,0,0,1
10189995,10190199,204,0,0,1,1
10189996,10190196,200,0,0,1,2
10190197,10190212,15,1,0,0,2
10190200,10190213,13,1,0,0,1
10190213,10191920,1707,0,0,1,2
10190214,10191921,1707,0,0,1,1
10191921,10192223,302,1,0,0,2
10191922,10192213,291,1,0,0,1
10191950,10192183,233,0,1,0,2
10191951,10192188,237,0,1,0,1
10192214,10192587,373,0,0,1,1
10192224,10192583,359,0,0,1,2
10192584,10192604,20,1,0,0,2
10192588,10192602,14,1,0,0,1
10192603,10192854,251,0,0,1,1
10192605,10192855,250,0,0,1,2
10192855,10192886,31,1,0,0,1
10192856,10192878,22,1,0,0,2
10192879,10193935,1056,0,0,1,2
10192887,10193937,1050,0,0,1,1
10193936,10194212,276,1,0,0,2
10193938,10194168,230,1,0,0,1
10193989,10194146,157,0,1,0,2
10193993,10194133,140,0,1,0,1
10194169,10194267,98,0,0,1,1
10194213,10194268,55,0,0,1,2
10194268,10194277,9,1,0,0,1
10194269,10194282,13,1,0,0,2
10194278,10194420,142,0,0,1,1
10194283,10194418,135,0,0,1,2
10194419,10194444,25,1,0,0,2
10194421,10194444,23,1,0,0,1
10194445,10194983,538,0,0,1,1
10194445,10194985,540,0,0,1,2
10194984,10195006,22,1,0,0,1
10194986,10195008,22,1,0,0,2
10195007,10195217,210,0,0,1,1
10195009,10195215,206,0,0,1,2
10195216,10195239,23,1,0,0,2
10195218,10195235,17,1,0,0,1
10195236,10195712,476,0,0,1,1
10195240,10195712,472,0,0,1,2
10195713,10195731,18,1,0,0,2
10195713,10195734,21,1,0,0,1
10195732,10195924,192,0,0,1,2
10195735,10195925,190,0,0,1,1
10195925,10195949,24,1,0,0,2
10195926,10195955,29,1,0,0,1
10195950,10196064,114,0,0,1,2
10195956,10196069,113,0,0,1,1
10196065,10196088,23,1,0,0,2
10196070,10196088,18,1,0,0,1
10196089,10196422,333,0,0,1,2
10196089,10196426,337,0,0,1,1
10196423,10196438,15,1,0,0,2
10196427,10196438,11,1,0,0,1
10196439,10196561,122,0,0,1,2
10196439,10196562,123,0,0,1,1
10196562,10196577,15,1,0,0,2
10196563,10196567,4,1,0,0,1
10196568,10197878,1310,0,0,1,1
10196578,10196930,352,0,0,1,2
10196931,10196943,12,1,0,0,2
10196944,10197253,309,0,0,1,2
10197254,10197265,11,1,0,0,2
10197266,10197877,611,0,0,1,2
10197878,10197907,29,1,0,0,2
10197879,10197905,26,1,0,0,1
10197906,10198004,98,0,0,1,1
10197908,10198016,108,0,0,1,2
10198005,10198019,14,1,0,0,1
10198017,10198165,148,1,0,0,2
10198020,10198086,66,0,0,1,1
10198087,10198126,39,1,0,0,1
10198127,10198497,370,0,0,1,1
10198166,10198516,350,0,0,1,2
10198498,10199056,558,1,0,0,1
10198517,10198521,4,1,0,0,2
10198522,10198574,52,0,0,1,2
10198575,10198970,395,1,0,0,2
10198582,10198975,393,0,1,0,1
10198588,10198959,371,0,1,0,2
10198971,10199854,883,0,0,1,2
10199057,10199579,522,0,0,1,1
10199580,10199622,42,1,0,0,1
10199623,10199854,231,0,0,1,1
10199855,10199870,15,1,0,0,2
10199855,10200223,368,1,0,0,1
10199871,10200035,164,0,0,1,2
10200036,10200061,25,1,0,0,2
10200062,10200104,42,0,0,1,2
10200105,10200366,261,1,0,0,2
10200224,10200274,50,0,0,1,1
10200275,10200301,26,1,0,0,1
10200302,10200361,59,0,0,1,1
10200362,10200381,19,1,0,0,1
10200367,10200459,92,0,0,1,2
10200382,10200459,77,0,0,1,1
10200460,10200484,24,1,0,0,1
10200460,10200484,24,1,0,0,2
10200485,10200611,126,0,0,1,2
10200485,10200616,131,0,0,1,1
10200612,10200653,41,1,0,0,2
10200617,10200654,37,1,0,0,1
10200654,10201295,641,0,0,1,2
10200655,10201298,643,0,0,1,1
10201296,10201369,73,1,0,0,2
10201299,10201368,69,1,0,0,1
10201369,10201918,549,0,0,1,1
10201370,10201919,549,0,0,1,2
10201919,10202005,86,1,0,0,1
10201920,10202007,87,1,0,0,2
10202006,10202101,95,0,0,1,1
10202008,10202103,95,0,0,1,2
10202102,10202137,35,1,0,0,1
10202104,10202135,31,1,0,0,2
10202136,10202193,57,0,0,1,2
10202138,10202193,55,0,0,1,1
10202194,10202214,20,1,0,0,2
10202194,10202216,22,1,0,0,1
10202215,10202377,162,0,0,1,2
10202217,10202365,148,0,0,1,1
10202366,10202671,305,1,0,0,1
10202378,10202643,265,1,0,0,2
10202388,10202618,230,0,1,0,1
10202389,10202607,218,0,1,0,2
10202644,10203504,860,0,0,1,2
10202672,10203502,830,0,0,1,1
10203503,10203524,21,1,0,0,1
10203505,10203523,18,1,0,0,2
10203524,10203797,273,0,0,1,2
10203525,10203797,272,0,0,1,1
10203798,10203814,16,1,0,0,1
10203798,10203815,17,1,0,0,2
10203815,10204606,791,0,0,1,1
10203816,10204606,790,0,0,1,2
10204607,10204836,229,1,0,0,1
10204607,10204856,249,1,0,0,2
10204641,10204810,169,0,1,0,2
10204641,10204813,172,0,1,0,1
10204837,10205060,223,0,0,1,1
10204857,10204894,37,0,0,1,2
10204895,10204900,5,1,0,0,2
10204901,10205061,160,0,0,1,2
10205061,10205084,23,1,0,0,1
10205062,10205085,23,1,0,0,2
10205085,10205248,163,0,0,1,1
10205086,10205248,162,0,0,1,2
10205249,10205271,22,1,0,0,1
10205249,10205272,23,1,0,0,2
10205272,10205732,460,0,0,1,1
10205273,10206527,1254,0,0,1,2
10205733,10205737,4,1,0,0,1
10205738,10206527,789,0,0,1,1
10206528,10206549,21,1,0,0,2
10206528,10206557,29,1,0,0,1
10206550,10206702,152,0,0,1,2
10206558,10206727,169,0,0,1,1
10206703,10207208,505,1,0,0,2
10206728,10207203,475,1,0,0,1
10206752,10207194,442,0,1,0,1
10206756,10207197,441,0,1,0,2
10207204,10207498,294,0,0,1,1
10207209,10207497,288,0,0,1,2
10207498,10207527,29,1,0,0,2
10207499,10207540,41,1,0,0,1
10207528,10207817,289,0,0,1,2
10207541,10207819,278,0,0,1,1
10207818,10207852,34,1,0,0,2
10207820,10207844,24,1,0,0,1
10207845,10208040,195,0,0,1,1
10207853,10208040,187,0,0,1,2
10208041,10208066,25,1,0,0,1
10208041,10208066,25,1,0,0,2
10208067,10208328,261,0,0,1,1
10208067,10208328,261,0,0,1,2
10208329,10208432,103,1,0,0,1
10208329,10208432,103,1,0,0,2
10208433,10209924,1491,0,0,1,1
10208433,10210620,2187,0,0,1,2
10209925,10209935,10,1,0,0,1
10209936,10210620,684,0,0,1,1
10210621,10210632,11,1,0,0,1
10210621,10210636,15,1,0,0,2
10210633,10211017,384,0,0,1,1
10210637,10211019,382,0,0,1,2
10211018,10211028,10,1,0,0,1
10211020,10211026,6,1,0,0,2
10211027,10211305,278,0,0,1,2
10211029,10211303,274,0,0,1,1
10211304,10211372,68,1,0,0,1
10211306,10211332,26,1,0,0,2
10211333,10211361,28,0,0,1,2
10211362,10211376,14,1,0,0,2
10211373,10212094,721,0,0,1,1
10211377,10212075,698,0,0,1,2
10212076,10212290,214,1,0,0,2
10212095,10212293,198,1,0,0,1
10212139,10212232,93,0,1,0,1
10212141,10212234,93,0,1,0,2
10212291,10212410,119,0,0,1,2
10212294,10212407,113,0,0,1,1
10212408,10212424,16,1,0,0,1
10212411,10212417,6,1,0,0,2
10212418,10212558,140,0,0,1,2
10212425,10212559,134,0,0,1,1
10212559,10212572,13,1,0,0,2
10212560,10212567,7,1,0,0,1
10212568,10213555,987,0,0,1,1
10212573,10213513,940,0,0,1,2
10213514,10213520,6,1,0,0,2
10213521,10213568,47,0,0,1,2
10213556,10213890,334,1,0,0,1
10213569,10213869,300,1,0,0,2
10213606,10213824,218,0,1,0,1
10213608,10213812,204,0,1,0,2
10213870,10214974,1104,0,0,1,2
10213891,10215137,1246,0,0,1,1
10214975,10215014,39,1,0,0,2
10215015,10215137,122,0,0,1,2
