start,end,duration,saccade,blink,fixation,eye
1322206,1322399,193,0,0,1,1
1322206,1322401,195,0,0,1,2
1322400,1322434,34,1,0,0,1
1322402,1322424,22,1,0,0,2
1322425,1322582,157,0,0,1,2
1322435,1322582,147,0,0,1,1
1322583,1322644,61,1,0,0,2
1322583,1322653,70,1,0,0,1
1322645,1322735,90,0,0,1,2
1322654,1322734,80,0,0,1,1
1322735,1322772,37,1,0,0,1
1322736,1322769,33,1,0,0,2
1322770,1324036,1266,0,0,1,2
1322773,1323168,395,0,0,1,1
1323169,1323193,24,1,0,0,1
1323194,1324035,841,0,0,1,1
1324036,1324063,27,1,0,0,1
1324037,1324053,16,1,0,0,2
1324054,1324859,805,0,0,1,2
1324064,1324857,793,0,0,1,1
1324858,1325025,167,1,0,0,1
1324860,1325008,148,1,0,0,2
1324986,1325006,20,0,1,0,1
1325009,1325323,314,0,0,1,2
1325026,1325062,36,0,0,1,1
1325063,1325077,14,1,0,0,1
1325078,1325324,246,0,0,1,1
1325324,1325386,62,1,0,0,2
1325325,1325395,70,1,0,0,1
1325387,1325772,385,0,0,1,2
1325396,1325770,374,0,0,1,1
1325771,1325858,87,1,0,0,1
1325773,1325843,70,1,0,0,2
1325844,1325941,97,0,0,1,2
1325859,1325940,81,0,0,1,1
1325941,1325980,39,1,0,0,1
1325942,1325975,33,1,0,0,2
1325976,1326503,527,0,0,1,2
1325981,1326502,521,0,0,1,1
1326503,1326535,32,1,0,0,1
1326504,1326530,26,1,0,0,2
1326531,1326677,146,0,0,1,2
1326536,1326677,141,0,0,1,1
1326678,1326706,28,1,0,0,1
1326678,1326707,29,1,0,0,2
1326707,1327047,340,0,0,1,1
1326708,1327053,345,0,0,1,2
1327048,1327076,28,1,0,0,1
1327054,1327064,10,1,0,0,2
1327065,1328249,1184,0,0,1,2
1327077,1327785,708,0,0,1,1
1327786,1327805,19,1,0,0,1
1327806,1328242,436,0,0,1,1
1328243,1328255,12,1,0,0,1
1328250,1328254,4,1,0,0,2
1328255,1330427,2172,0,0,1,2
1328256,1329329,1073,0,0,1,1
1329330,1329337,7,1,0,0,1
1329338,1330427,1089,0,0,1,1
1330428,1330522,94,1,0,0,1
1330428,1330522,94,1,0,0,2
1330523,1330622,99,0,0,1,1
1330523,1330624,101,0,0,1,2
1330623,1330709,86,1,0,0,1
1330625,1330708,83,1,0,0,2
1330709,1330780,71,0,0,1,2
1330710,1330779,69,0,0,1,1
1330780,1330815,35,1,0,0,1
1330781,1330814,33,1,0,0,2
1330815,1331008,193,0,0,1,2
1330816,1331007,191,0,0,1,1
1331008,1331037,29,1,0,0,1
1331009,1331029,20,1,0,0,2
1331030,1332294,1264,0,0,1,2
1331038,1332291,1253,0,0,1,1
1332292,1332316,24,1,0,0,1
1332295,1332313,18,1,0,0,2
1332314,1332534,220,0,0,1,2
1332317,1332534,217,0,0,1,1
1332535,1332622,87,1,0,0,2
1332535,1332632,97,1,0,0,1
1332623,1332920,297,0,0,1,2
1332633,1332920,287,0,0,1,1
1332921,1332981,60,1,0,0,2
1332921,1332983,62,1,0,0,1
1332982,1333083,101,0,0,1,2
1332984,1333083,99,0,0,1,1
1333084,1333106,22,1,0,0,2
1333084,1333112,28,1,0,0,1
1333107,1333484,377,0,0,1,2
1333113,1333484,371,0,0,1,1
1333485,1333495,10,1,0,0,1
1333485,1333505,20,1,0,0,2
1333496,1333860,364,0,0,1,1
1333506,1335082,1576,0,0,1,2
1333861,1333887,26,1,0,0,1
1333888,1334724,836,0,0,1,1
1334725,1334739,14,1,0,0,1
1334740,1335080,340,0,0,1,1
1335081,1335140,59,1,0,0,1
1335083,1335140,57,1,0,0,2
1335141,1335249,108,0,0,1,1
1335141,1335251,110,0,0,1,2
1335250,1335307,57,1,0,0,1
1335252,1335312,60,1,0,0,2
1335308,1335404,96,0,0,1,1
1335313,1335406,93,0,0,1,2
1335405,1335433,28,1,0,0,1
1335407,1335431,24,1,0,0,2
1335432,1335633,201,0,0,1,2
1335434,1335633,199,0,0,1,1
1335634,1335645,11,1,0,0,2
1335634,1335655,21,1,0,0,1
1335646,1336489,843,0,0,1,2
1335656,1336488,832,0,0,1,1
1336489,1336506,17,1,0,0,1
1336490,1336494,4,1,0,0,2
1336495,1337523,1028,0,0,1,2
1336507,1337523,1016,0,0,1,1
1337524,1337606,82,1,0,0,2
1337524,1337607,83,1,0,0,1
1337607,1337828,221,0,0,1,2
1337608,1337827,219,0,0,1,1
1337828,1337859,31,1,0,0,1
1337829,1337848,19,1,0,0,2
1337849,1338193,344,0,0,1,2
1337860,1338192,332,0,0,1,1
1338193,1338213,20,1,0,0,1
1338194,1338214,20,1,0,0,2
1338214,1340123,1909,0,0,1,1
1338215,1340122,1907,0,0,1,2
1340123,1340187,64,1,0,0,2
1340124,1340189,65,1,0,0,1
1340188,1340289,101,0,0,1,2
1340190,1340290,100,0,0,1,1
1340290,1340321,31,1,0,0,2
1340291,1340320,29,1,0,0,1
1340321,1341373,1052,0,0,1,1
1340322,1341372,1050,0,0,1,2
1341373,1341398,25,1,0,0,2
1341374,1341403,29,1,0,0,1
1341399,1341815,416,0,0,1,2
1341404,1341814,410,0,0,1,1
1341815,1341879,64,1,0,0,1
1341816,1341871,55,1,0,0,2
1341872,1341974,102,0,0,1,2
1341880,1341972,92,0,0,1,1
1341973,1342033,60,1,0,0,1
1341975,1342104,129,1,0,0,2
1342034,1342054,20,0,0,1,1
1342055,1342116,61,1,0,0,1
1342105,1342212,107,0,0,1,2
1342117,1342212,95,0,0,1,1
1342213,1342243,30,1,0,0,1
1342213,1342245,32,1,0,0,2
1342244,1343162,918,0,0,1,1
1342246,1343167,921,0,0,1,2
1343163,1343192,29,1,0,0,1
1343168,1343191,23,1,0,0,2
1343192,1344022,830,0,0,1,2
1343193,1344022,829,0,0,1,1
1344023,1344102,79,1,0,0,1
1344023,1344109,86,1,0,0,2
1344103,1344471,368,0,0,1,1
1344110,1344472,362,0,0,1,2
1344472,1344564,92,1,0,0,1
1344473,1344561,88,1,0,0,2
1344562,1344634,72,0,0,1,2
1344565,1344637,72,0,0,1,1
1344635,1344672,37,1,0,0,2
1344638,1344684,46,1,0,0,1
1344673,1344826,153,0,0,1,2
1344685,1344829,144,0,0,1,1
1344827,1344859,32,1,0,0,2
1344830,1344875,45,1,0,0,1
1344860,1345037,177,0,0,1,2
1344876,1345036,160,0,0,1,1
1345037,1345055,18,1,0,0,1
1345038,1345054,16,1,0,0,2
1345055,1345543,488,0,0,1,2
1345056,1345840,784,0,0,1,1
1345544,1345575,31,1,0,0,2
1345576,1345600,24,0,0,1,2
1345601,1345798,197,1,0,0,2
1345799,1345841,42,0,0,1,2
1345841,1345927,86,1,0,0,1
1345842,1345935,93,1,0,0,2
1345928,1346238,310,0,0,1,1
1345936,1346239,303,0,0,1,2
1346239,1346300,61,1,0,0,1
1346240,1346299,59,1,0,0,2
1346300,1346521,221,0,0,1,2
1346301,1346517,216,0,0,1,1
1346518,1346544,26,1,0,0,1
1346522,1346534,12,1,0,0,2
1346535,1347678,1143,0,0,1,2
1346545,1347676,1131,0,0,1,1
1347677,1347753,76,1,0,0,1
1347679,1347764,85,1,0,0,2
1347754,1347841,87,0,0,1,1
1347765,1347843,78,0,0,1,2
1347842,1347877,35,1,0,0,1
1347844,1347875,31,1,0,0,2
1347876,1348916,1040,0,0,1,2
1347878,1348915,1037,0,0,1,1
1348916,1348987,71,1,0,0,1
1348917,1348988,71,1,0,0,2
1348988,1349313,325,0,0,1,1
1348989,1349312,323,0,0,1,2
1349313,1349382,69,1,0,0,2
1349314,1349392,78,1,0,0,1
1349383,1349477,94,0,0,1,2
1349393,1349477,84,0,0,1,1
1349478,1349501,23,1,0,0,2
1349478,1349512,34,1,0,0,1
1349502,1350765,1263,0,0,1,2
1349513,1350764,1251,0,0,1,1
1350765,1350863,98,1,0,0,1
1350766,1350866,100,1,0,0,2
1350864,1351096,232,0,0,1,1
1350867,1351101,234,0,0,1,2
1351097,1351122,25,1,0,0,1
1351102,1351118,16,1,0,0,2
1351119,1352280,1161,0,0,1,2
1351123,1352281,1158,0,0,1,1
1352281,1352372,91,1,0,0,2
1352282,1352377,95,1,0,0,1
1352373,1352457,84,0,0,1,2
1352378,1352458,80,0,0,1,1
1352458,1352515,57,1,0,0,2
1352459,1352526,67,1,0,0,1
1352516,1353547,1031,0,0,1,2
1352527,1353546,1019,0,0,1,1
1353547,1353705,158,1,0,0,1
1353548,1353681,133,1,0,0,2
1353682,1353930,248,0,0,1,2
1353706,1353929,223,0,0,1,1
1353930,1354012,82,1,0,0,1
1353931,1354015,84,1,0,0,2
1354013,1354086,73,0,0,1,1
1354016,1354086,70,0,0,1,2
1354087,1354130,43,1,0,0,2
1354087,1354211,124,1,0,0,1
1354131,1354534,403,0,0,1,2
1354212,1354363,151,0,0,1,1
1354364,1354546,182,1,0,0,1
1354535,1354555,20,1,0,0,2
1354547,1354573,26,0,0,1,1
1354556,1355216,660,0,0,1,2
1354574,1354650,76,1,0,0,1
1354651,1354714,63,0,0,1,1
1354715,1354774,59,1,0,0,1
1354775,1355216,441,0,0,1,1
1355217,1355302,85,1,0,0,2
1355217,1355303,86,1,0,0,1
1355303,1355698,395,0,0,1,2
1355304,1355697,393,0,0,1,1
1355698,1355775,77,1,0,0,1
1355699,1355763,64,1,0,0,2
1355764,1355880,116,0,0,1,2
1355776,1355879,103,0,0,1,1
1355880,1355917,37,1,0,0,1
1355881,1355905,24,1,0,0,2
1355906,1357083,1177,0,0,1,2
1355918,1357083,1165,0,0,1,1
1357084,1357180,96,1,0,0,1
1357084,1357181,97,1,0,0,2
1357181,1357534,353,0,0,1,1
1357182,1357535,353,0,0,1,2
1357535,1357572,37,1,0,0,1
1357536,1357573,37,1,0,0,2
1357573,1358687,1114,0,0,1,1
1357574,1358689,1115,0,0,1,2
1358688,1358743,55,1,0,0,1
1358690,1358734,44,1,0,0,2
1358735,1358974,239,0,0,1,2
1358744,1358974,230,0,0,1,1
1358975,1359098,123,1,0,0,1
1358975,1359099,124,1,0,0,2
1359099,1359246,147,0,0,1,1
1359100,1359247,147,0,0,1,2
1359247,1359280,33,1,0,0,1
1359248,1359266,18,1,0,0,2
1359267,1359799,532,0,0,1,2
1359281,1359799,518,0,0,1,1
1359800,1359898,98,1,0,0,1
1359800,1359899,99,1,0,0,2
1359899,1360285,386,0,0,1,1
1359900,1360283,383,0,0,1,2
1360284,1360368,84,1,0,0,2
1360286,1360371,85,1,0,0,1
1360369,1360444,75,0,0,1,2
1360372,1360445,73,0,0,1,1
1360445,1360490,45,1,0,0,2
1360446,1360519,73,1,0,0,1
1360491,1360672,181,0,0,1,2
1360520,1360584,64,0,0,1,1
1360585,1360598,13,1,0,0,1
1360599,1360674,75,0,0,1,1
1360673,1360690,17,1,0,0,2
1360675,1360705,30,1,0,0,1
1360691,1361192,501,0,0,1,2
1360706,1361190,484,0,0,1,1
1361191,1361277,86,1,0,0,1
1361193,1361269,76,1,0,0,2
1361270,1361637,367,0,0,1,2
1361278,1361635,357,0,0,1,1
1361636,1361720,84,1,0,0,1
1361638,1361721,83,1,0,0,2
1361721,1361803,82,0,0,1,1
1361722,1361803,81,0,0,1,2
1361804,1361838,34,1,0,0,2
1361804,1361846,42,1,0,0,1
1361839,1362182,343,0,0,1,2
1361847,1362178,331,0,0,1,1
1362179,1362209,30,1,0,0,1
1362183,1362200,17,1,0,0,2
1362201,1362521,320,0,0,1,2
1362210,1362520,310,0,0,1,1
1362521,1362612,91,1,0,0,1
1362522,1362610,88,1,0,0,2
1362611,1362979,368,0,0,1,2
1362613,1362977,364,0,0,1,1
1362978,1363043,65,1,0,0,1
1362980,1363043,63,1,0,0,2
1363044,1363122,78,0,0,1,1
1363044,1363122,78,0,0,1,2
1363123,1363148,25,1,0,0,2
1363123,1363155,32,1,0,0,1
1363149,1363698,549,0,0,1,2
1363156,1363698,542,0,0,1,1
1363699,1363769,70,1,0,0,1
1363699,1363770,71,1,0,0,2
1363770,1364032,262,0,0,1,1
1363771,1364032,261,0,0,1,2
1364033,1364071,38,1,0,0,1
1364033,1364080,47,1,0,0,2
1364072,1364367,295,0,0,1,1
1364081,1364369,288,0,0,1,2
1364368,1364450,82,1,0,0,1
1364370,1364456,86,1,0,0,2
1364451,1364525,74,0,0,1,1
1364457,1364526,69,0,0,1,2
1364526,1364561,35,1,0,0,1
1364527,1364560,33,1,0,0,2
1364561,1365479,918,0,0,1,2
1364562,1365477,915,0,0,1,1
1365478,1365551,73,1,0,0,1
1365480,1365552,72,1,0,0,2
1365552,1365943,391,0,0,1,1
1365553,1365944,391,0,0,1,2
1365944,1366038,94,1,0,0,1
1365945,1366036,91,1,0,0,2
1366037,1366148,111,0,0,1,2
1366039,1366148,109,0,0,1,1
1366149,1366182,33,1,0,0,2
1366149,1366185,36,1,0,0,1
1366183,1367007,824,0,0,1,2
1366186,1366454,268,0,0,1,1
1366455,1366478,23,1,0,0,1
1366479,1367207,728,0,0,1,1
1367008,1367356,348,1,0,0,2
1367218,1367307,89,0,1,0,1
1367317,1367364,47,1,0,0,1
1367357,1367520,163,0,0,1,2
1367365,1367519,154,0,0,1,1
1367520,1367547,27,1,0,0,1
1367521,1367544,23,1,0,0,2
1367545,1368728,1183,0,0,1,2
1367548,1368728,1180,0,0,1,1
1368729,1368801,72,1,0,0,1
1368729,1368807,78,1,0,0,2
1368802,1369161,359,0,0,1,1
1368808,1369161,353,0,0,1,2
1369162,1369235,73,1,0,0,2
1369162,1369244,82,1,0,0,1
1369236,1369404,168,0,0,1,2
1369245,1369399,154,0,0,1,1
1369400,1369417,17,1,0,0,1
1369405,1369416,11,1,0,0,2
1369417,1370718,1301,0,0,1,2
1369418,1370717,1299,0,0,1,1
1370718,1370815,97,1,0,0,1
1370719,1370823,104,1,0,0,2
1370816,1370947,131,0,0,1,1
1370824,1370948,124,0,0,1,2
1370948,1371014,66,1,0,0,1
1370949,1371015,66,1,0,0,2
1371015,1371104,89,0,0,1,1
1371016,1371103,87,0,0,1,2
1371104,1371137,33,1,0,0,2
1371105,1371136,31,1,0,0,1
1371137,1371730,593,0,0,1,1
1371138,1371730,592,0,0,1,2
1371731,1371793,62,1,0,0,2
1371731,1371801,70,1,0,0,1
1371794,1372240,446,0,0,1,2
1371802,1372239,437,0,0,1,1
1372240,1372291,51,1,0,0,1
1372241,1372291,50,1,0,0,2
1372292,1372488,196,0,0,1,1
1372292,1372488,196,0,0,1,2
1372489,1372563,74,1,0,0,1
1372489,1372564,75,1,0,0,2
1372564,1372672,108,0,0,1,1
1372565,1372673,108,0,0,1,2
1372673,1372694,21,1,0,0,1
1372674,1372695,21,1,0,0,2
1372695,1373514,819,0,0,1,1
1372696,1373513,817,0,0,1,2
1373514,1373576,62,1,0,0,2
1373515,1373577,62,1,0,0,1
1373577,1373837,260,0,0,1,2
1373578,1373836,258,0,0,1,1
1373837,1373914,77,1,0,0,1
1373838,1373928,90,1,0,0,2
1373915,1374007,92,0,0,1,1
1373929,1374010,81,0,0,1,2
1374008,1374046,38,1,0,0,1
1374011,1374034,23,1,0,0,2
1374035,1374311,276,0,0,1,2
1374047,1374305,258,0,0,1,1
1374306,1374335,29,1,0,0,1
1374312,1374325,13,1,0,0,2
1374326,1374992,666,0,0,1,2
1374336,1374992,656,0,0,1,1
1374993,1375085,92,1,0,0,1
1374993,1375085,92,1,0,0,2
1375086,1375423,337,0,0,1,1
1375086,1375423,337,0,0,1,2
1375424,1375499,75,1,0,0,2
1375424,1375502,78,1,0,0,1
1375500,1375648,148,0,0,1,2
1375503,1375646,143,0,0,1,1
1375647,1375680,33,1,0,0,1
1375649,1375678,29,1,0,0,2
1375679,1376589,910,0,0,1,2
1375681,1376586,905,0,0,1,1
1376587,1376677,90,1,0,0,1
1376590,1376685,95,1,0,0,2
1376678,1376807,129,0,0,1,1
1376686,1376806,120,0,0,1,2
1376807,1376892,85,1,0,0,2
1376808,1376903,95,1,0,0,1
1376893,1377007,114,0,0,1,2
1376904,1377005,101,0,0,1,1
1377006,1377066,60,1,0,0,1
1377008,1377032,24,1,0,0,2
1377033,1377768,735,0,0,1,2
1377067,1377766,699,0,0,1,1
1377767,1377867,100,1,0,0,1
1377769,1377862,93,1,0,0,2
1377863,1378131,268,0,0,1,2
1377868,1378130,262,0,0,1,1
1378131,1378235,104,1,0,0,1
1378132,1378236,104,1,0,0,2
1378236,1378316,80,0,0,1,1
1378237,1378316,79,0,0,1,2
1378317,1378340,23,1,0,0,2
1378317,1378349,32,1,0,0,1
1378341,1378855,514,0,0,1,2
1378350,1378472,122,0,0,1,1
1378473,1379338,865,1,0,0,1
1378651,1379328,677,0,1,0,1
1378856,1378884,28,1,0,0,2
1378885,1379056,171,0,0,1,2
1379057,1379075,18,1,0,0,2
1379076,1379255,179,0,0,1,2
1379256,1379328,72,1,0,0,2
1379329,1379504,175,0,0,1,2
1379339,1379505,166,0,0,1,1
1379505,1379567,62,1,0,0,2
1379506,1379566,60,1,0,0,1
1379567,1379670,103,0,0,1,1
1379568,1379670,102,0,0,1,2
1379671,1379714,43,1,0,0,2
1379671,1379715,44,1,0,0,1
1379715,1381372,1657,0,0,1,2
1379716,1381372,1656,0,0,1,1
1381373,1381481,108,1,0,0,1
1381373,1381481,108,1,0,0,2
1381482,1381545,63,0,0,1,2
1381482,1381546,64,0,0,1,1
1381546,1381583,37,1,0,0,2
1381547,1381586,39,1,0,0,1
1381584,1382754,1170,0,0,1,2
1381587,1382752,1165,0,0,1,1
1382753,1382828,75,1,0,0,1
1382755,1382828,73,1,0,0,2
1382829,1383040,211,0,0,1,1
1382829,1383041,212,0,0,1,2
1383041,1383100,59,1,0,0,1
1383042,1383101,59,1,0,0,2
1383101,1383341,240,0,0,1,1
1383102,1383344,242,0,0,1,2
1383342,1383436,94,1,0,0,1
1383345,1383424,79,1,0,0,2
1383425,1383506,81,0,0,1,2
1383437,1383506,69,0,0,1,1
1383507,1383542,35,1,0,0,2
1383507,1383547,40,1,0,0,1
1383543,1383724,181,0,0,1,2
1383548,1383720,172,0,0,1,1
1383721,1383745,24,1,0,0,1
1383725,1383741,16,1,0,0,2
1383742,1384690,948,0,0,1,2
1383746,1383780,34,0,0,1,1
1383781,1384768,987,1,0,0,1
1383801,1383836,35,0,1,0,1
1383889,1383908,19,0,1,0,1
1383930,1384726,796,0,1,0,1
1384691,1384765,74,1,0,0,2
1384766,1385114,348,0,0,1,2
1384769,1385115,346,0,0,1,1
1385115,1385241,126,1,0,0,2
1385116,1385251,135,1,0,0,1
1385242,1385439,197,0,0,1,2
1385252,1385440,188,0,0,1,1
1385440,1385470,30,1,0,0,2
1385441,1385472,31,1,0,0,1
1385471,1385853,382,0,0,1,2
1385473,1385847,374,0,0,1,1
1385848,1385967,119,1,0,0,1
1385854,1385969,115,1,0,0,2
1385968,1386265,297,0,0,1,1
1385970,1386265,295,0,0,1,2
1386266,1386342,76,1,0,0,2
1386266,1386355,89,1,0,0,1
1386343,1386458,115,0,0,1,2
1386356,1386457,101,0,0,1,1
1386458,1386492,34,1,0,0,1
1386459,1386487,28,1,0,0,2
1386488,1387562,1074,0,0,1,2
1386493,1387560,1067,0,0,1,1
1387561,1387672,111,1,0,0,1
1387563,1387672,109,1,0,0,2
1387673,1387842,169,0,0,1,2
1387673,1387843,170,0,0,1,1
1387843,1387907,64,1,0,0,2
1387844,1387907,63,1,0,0,1
1387908,1388082,174,0,0,1,1
1387908,1388083,175,0,0,1,2
1388083,1389149,1066,1,0,0,1
1388084,1388115,31,1,0,0,2
1388116,1388611,495,0,0,1,2
1388190,1389133,943,0,1,0,1
1388612,1388813,201,1,0,0,2
1388814,1388902,88,0,0,1,2
1388903,1388916,13,1,0,0,2
1388917,1389063,146,0,0,1,2
1389064,1389146,82,1,0,0,2
1389147,1389450,303,0,0,1,2
1389150,1389451,301,0,0,1,1
1389451,1389523,72,1,0,0,2
1389452,1389526,74,1,0,0,1
1389524,1389615,91,0,0,1,2
1389527,1389616,89,0,0,1,1
1389616,1389649,33,1,0,0,2
1389617,1389648,31,1,0,0,1
1389649,1390633,984,0,0,1,1
1389650,1390635,985,0,0,1,2
1390634,1390726,92,1,0,0,1
1390636,1390723,87,1,0,0,2
1390724,1391042,318,0,0,1,2
1390727,1391040,313,0,0,1,1
1391041,1391107,66,1,0,0,1
1391043,1391100,57,1,0,0,2
1391101,1391177,76,0,0,1,2
1391108,1391178,70,0,0,1,1
1391178,1391209,31,1,0,0,2
1391179,1391212,33,1,0,0,1
1391210,1391479,269,0,0,1,2
1391213,1391472,259,0,0,1,1
1391473,1391495,22,1,0,0,1
1391480,1391492,12,1,0,0,2
1391493,1392203,710,0,0,1,2
1391496,1392205,709,0,0,1,1
1392204,1392292,88,1,0,0,2
1392206,1392295,89,1,0,0,1
1392293,1392604,311,0,0,1,2
1392296,1392604,308,0,0,1,1
1392605,1392666,61,1,0,0,2
1392605,1392673,68,1,0,0,1
1392667,1392745,78,0,0,1,2
1392674,1392747,73,0,0,1,1
1392746,1392781,35,1,0,0,2
1392748,1392783,35,1,0,0,1
1392782,1392950,168,0,0,1,2
1392784,1392954,170,0,0,1,1
1392951,1392979,28,1,0,0,2
1392955,1392970,15,1,0,0,1
1392971,1394018,1047,0,0,1,1
1392980,1394020,1040,0,0,1,2
1394019,1394093,74,1,0,0,1
1394021,1394094,73,1,0,0,2
1394094,1394260,166,0,0,1,1
1394095,1394261,166,0,0,1,2
1394261,1394309,48,1,0,0,1
1394262,1394309,47,1,0,0,2
1394310,1394482,172,0,0,1,2
1394310,1394895,585,0,0,1,1
1394483,1394493,10,1,0,0,2
1394494,1394893,399,0,0,1,2
1394894,1394924,30,1,0,0,2
1394896,1394916,20,1,0,0,1
1394917,1395107,190,0,0,1,1
1394925,1395110,185,0,0,1,2
1395108,1395138,30,1,0,0,1
1395111,1395127,16,1,0,0,2
1395128,1395973,845,0,0,1,2
1395139,1395974,835,0,0,1,1
1395974,1396024,50,1,0,0,2
1395975,1396032,57,1,0,0,1
1396025,1396193,168,0,0,1,2
1396033,1396190,157,0,0,1,1
1396191,1396221,30,1,0,0,1
1396194,1396213,19,1,0,0,2
1396214,1397359,1145,0,0,1,2
1396222,1397360,1138,0,0,1,1
1397360,1397414,54,1,0,0,2
1397361,1397412,51,1,0,0,1
1397413,1397500,87,0,0,1,1
1397415,1397500,85,0,0,1,2
1397501,1397536,35,1,0,0,2
1397501,1397537,36,1,0,0,1
1397537,1397736,199,0,0,1,2
1397538,1397736,198,0,0,1,1
1397737,1397762,25,1,0,0,1
1397737,1397767,30,1,0,0,2
1397763,1398744,981,0,0,1,1
1397768,1398744,976,0,0,1,2
1398745,1398848,103,1,0,0,2
1398745,1398862,117,1,0,0,1
1398849,1398934,85,0,0,1,2
1398863,1398937,74,0,0,1,1
1398935,1398983,48,1,0,0,2
1398938,1398989,51,1,0,0,1
1398984,1399587,603,0,0,1,2
1398990,1399586,596,0,0,1,1
1399587,1399665,78,1,0,0,1
1399588,1399666,78,1,0,0,2
1399666,1400032,366,0,0,1,1
1399667,1400034,367,0,0,1,2
1400033,1400152,119,1,0,0,1
1400035,1400140,105,1,0,0,2
1400141,1400227,86,0,0,1,2
1400153,1400223,70,0,0,1,1
1400224,1400304,80,1,0,0,1
1400228,1400264,36,1,0,0,2
1400265,1400402,137,0,0,1,2
1400305,1400348,43,0,0,1,1
1400349,1401251,902,1,0,0,1
1400403,1400435,32,1,0,0,2
1400436,1401160,724,0,0,1,2
1400608,1401230,622,0,1,0,1
1401161,1401245,84,1,0,0,2
1401246,1401562,316,0,0,1,2
1401252,1401563,311,0,0,1,1
1401563,1401618,55,1,0,0,2
1401564,1401629,65,1,0,0,1
1401619,1401696,77,0,0,1,2
1401630,1401695,65,0,0,1,1
1401696,1401780,84,1,0,0,1
1401697,1401774,77,1,0,0,2
1401775,1401865,90,0,0,1,2
1401781,1401864,83,0,0,1,1
1401865,1401900,35,1,0,0,1
1401866,1401902,36,1,0,0,2
1401901,1402171,270,0,0,1,1
1401903,1402171,268,0,0,1,2
1402172,1402183,11,1,0,0,2
1402172,1402184,12,1,0,0,1
1402184,1403514,1330,0,0,1,2
1402185,1403515,1330,0,0,1,1
1403515,1403596,81,1,0,0,2
1403516,1403590,74,1,0,0,1
1403591,1403738,147,0,0,1,1
1403597,1403739,142,0,0,1,2
1403739,1404951,1212,1,0,0,1
1403740,1403870,130,1,0,0,2
1403824,1404940,1116,0,1,0,1
1403871,1403948,77,0,0,1,2
1403949,1403983,34,1,0,0,2
1403984,1404213,229,0,0,1,2
1404214,1404236,22,1,0,0,2
1404237,1404867,630,0,0,1,2
1404868,1404941,73,1,0,0,2
1404942,1405327,385,0,0,1,2
1404952,1405328,376,0,0,1,1
1405328,1405419,91,1,0,0,2
1405329,1405421,92,1,0,0,1
1405420,1405507,87,0,0,1,2
1405422,1405510,88,0,0,1,1
1405508,1405533,25,1,0,0,2
1405511,1405543,32,1,0,0,1
1405534,1406767,1233,0,0,1,2
1405544,1406767,1223,0,0,1,1
1406768,1406842,74,1,0,0,2
1406768,1406843,75,1,0,0,1
1406843,1407186,343,0,0,1,2
1406844,1407187,343,0,0,1,1
1407187,1407241,54,1,0,0,2
1407188,1407239,51,1,0,0,1
1407240,1407393,153,0,0,1,1
1407242,1407395,153,0,0,1,2
1407394,1407414,20,1,0,0,1
1407396,1407413,17,1,0,0,2
1407414,1408512,1098,0,0,1,2
1407415,1408511,1096,0,0,1,1
1408512,1408562,50,1,0,0,1
1408513,1408565,52,1,0,0,2
1408563,1408899,336,0,0,1,1
1408566,1408899,333,0,0,1,2
1408900,1408965,65,1,0,0,1
1408900,1408967,67,1,0,0,2
1408966,1409035,69,0,0,1,1
1408968,1409037,69,0,0,1,2
1409036,1409069,33,1,0,0,1
1409038,1409069,31,1,0,0,2
1409070,1410637,1567,0,0,1,2
1409070,1410638,1568,0,0,1,1
1410638,1410705,67,1,0,0,2
1410639,1410706,67,1,0,0,1
1410706,1410959,253,0,0,1,2
1410707,1410958,251,0,0,1,1
1410959,1411006,47,1,0,0,1
1410960,1411007,47,1,0,0,2
1411007,1411230,223,0,0,1,1
1411008,1411230,222,0,0,1,2
1411231,1411291,60,1,0,0,2
1411231,1411292,61,1,0,0,1
1411292,1411446,154,0,0,1,2
1411293,1411445,152,0,0,1,1
1411446,1411502,56,1,0,0,1
1411447,1411503,56,1,0,0,2
1411503,1411770,267,0,0,1,1
1411504,1411771,267,0,0,1,2
1411771,1411843,72,1,0,0,1
1411772,1411834,62,1,0,0,2
1411835,1412104,269,0,0,1,2
1411844,1412104,260,0,0,1,1
1412105,1412182,77,1,0,0,2
1412105,1412192,87,1,0,0,1
1412183,1412462,279,0,0,1,2
1412193,1412460,267,0,0,1,1
1412461,1412577,116,1,0,0,1
1412463,1412562,99,1,0,0,2
1412563,1413095,532,0,0,1,2
1412578,1413094,516,0,0,1,1
1413095,1413152,57,1,0,0,1
1413096,1413151,55,1,0,0,2
1413152,1413546,394,0,0,1,2
1413153,1413547,394,0,0,1,1
1413547,1413604,57,1,0,0,2
1413548,1413610,62,1,0,0,1
1413605,1414367,762,0,0,1,2
1413611,1414369,758,0,0,1,1
1414368,1414403,35,1,0,0,2
1414370,1414403,33,1,0,0,1
1414404,1414831,427,0,0,1,1
1414404,1414831,427,0,0,1,2
1414832,1414854,22,1,0,0,2
1414832,1414862,30,1,0,0,1
1414855,1415169,314,0,0,1,2
1414863,1415168,305,0,0,1,1
1415169,1415218,49,1,0,0,1
1415170,1415212,42,1,0,0,2
1415213,1415685,472,0,0,1,2
1415219,1415685,466,0,0,1,1
1415686,1415719,33,1,0,0,2
1415686,1415731,45,1,0,0,1
1415720,1416464,744,0,0,1,2
1415732,1416464,732,0,0,1,1
1416465,1416534,69,1,0,0,1
1416465,1416534,69,1,0,0,2
1416535,1416660,125,0,0,1,1
1416535,1416661,126,0,0,1,2
1416661,1416686,25,1,0,0,1
1416662,1416693,31,1,0,0,2
1416687,1417642,955,0,0,1,1
1416694,1417637,943,0,0,1,2
1417638,1417656,18,1,0,0,2
1417643,1417655,12,1,0,0,1
1417656,1417882,226,0,0,1,1
1417657,1418779,1122,0,0,1,2
1417883,1417893,10,1,0,0,1
1417894,1418774,880,0,0,1,1
1418775,1418801,26,1,0,0,1
1418780,1418791,11,1,0,0,2
1418792,1419345,553,0,0,1,2
1418802,1419345,543,0,0,1,1
1419346,1419407,61,1,0,0,2
1419346,1419415,69,1,0,0,1
1419408,1419762,354,0,0,1,2
1419416,1419761,345,0,0,1,1
1419762,1419810,48,1,0,0,1
1419763,1419787,24,1,0,0,2
1419788,1420246,458,0,0,1,2
1419811,1420247,436,0,0,1,1
1420247,1420271,24,1,0,0,2
1420248,1420269,21,1,0,0,1
1420270,1420713,443,0,0,1,1
1420272,1420715,443,0,0,1,2
1420714,1420748,34,1,0,0,1
1420716,1420739,23,1,0,0,2
1420740,1422153,1413,0,0,1,2
1420749,1422148,1399,0,0,1,1
1422149,1422174,25,1,0,0,1
1422154,1422166,12,1,0,0,2
1422167,1422759,592,0,0,1,2
1422175,1422751,576,0,0,1,1
1422752,1422774,22,1,0,0,1
1422760,1422772,12,1,0,0,2
1422773,1422968,195,0,0,1,2
1422775,1422965,190,0,0,1,1
1422966,1423051,85,1,0,0,1
1422969,1423056,87,1,0,0,2
1423052,1423135,83,0,0,1,1
1423057,1423135,78,0,0,1,2
1423136,1423183,47,1,0,0,1
1423136,1423184,48,1,0,0,2
1423184,1423299,115,0,0,1,1
1423185,1423300,115,0,0,1,2
1423300,1423328,28,1,0,0,1
1423301,1423320,19,1,0,0,2
1423321,1423649,328,0,0,1,2
1423329,1423649,320,0,0,1,1
1423650,1423677,27,1,0,0,2
1423650,1423678,28,1,0,0,1
1423678,1424521,843,0,0,1,2
1423679,1424520,841,0,0,1,1
1424521,1424540,19,1,0,0,1
1424522,1424534,12,1,0,0,2
1424535,1425140,605,0,0,1,2
1424541,1425139,598,0,0,1,1
1425140,1425160,20,1,0,0,1
1425141,1425150,9,1,0,0,2
1425151,1425912,761,0,0,1,2
1425161,1425911,750,0,0,1,1
1425912,1425983,71,1,0,0,1
1425913,1425985,72,1,0,0,2
1425984,1426326,342,0,0,1,1
1425986,1426328,342,0,0,1,2
1426327,1426357,30,1,0,0,1
1426329,1426353,24,1,0,0,2
1426354,1428134,1780,0,0,1,2
1426358,1428134,1776,0,0,1,1
1428135,1428207,72,1,0,0,2
1428135,1428215,80,1,0,0,1
1428208,1429747,1539,0,0,1,2
1428216,1429748,1532,0,0,1,1
1429748,1429818,70,1,0,0,2
1429749,1429816,67,1,0,0,1
1429817,1429901,84,0,0,1,1
1429819,1429900,81,0,0,1,2
1429901,1429935,34,1,0,0,2
1429902,1429934,32,1,0,0,1
1429935,1430161,226,0,0,1,1
1429936,1430158,222,0,0,1,2
1430159,1430188,29,1,0,0,2
1430162,1430187,25,1,0,0,1
1430188,1431067,879,0,0,1,1
1430189,1431067,878,0,0,1,2
1431068,1431081,13,1,0,0,2
1431068,1431082,14,1,0,0,1
1431082,1431364,282,0,0,1,2
1431083,1431364,281,0,0,1,1
1431365,1431412,47,1,0,0,1
1431365,1431412,47,1,0,0,2
1431413,1431719,306,0,0,1,1
1431413,1431720,307,0,0,1,2
1431720,1431751,31,1,0,0,1
1431721,1431750,29,1,0,0,2
1431751,1433776,2025,0,0,1,2
1431752,1433775,2023,0,0,1,1
1433776,1433845,69,1,0,0,1
1433777,1433846,69,1,0,0,2
1433846,1434398,552,0,0,1,1
1433847,1434399,552,0,0,1,2
1434399,1434429,30,1,0,0,1
1434400,1434420,20,1,0,0,2
1434421,1434728,307,0,0,1,2
1434430,1434729,299,0,0,1,1
1434729,1434800,71,1,0,0,2
1434730,1434802,72,1,0,0,1
1434801,1434889,88,0,0,1,2
1434803,1434888,85,0,0,1,1
1434889,1434928,39,1,0,0,1
1434890,1434917,27,1,0,0,2
1434918,1435119,201,0,0,1,2
1434929,1435115,186,0,0,1,1
1435116,1435131,15,1,0,0,1
1435120,1435130,10,1,0,0,2
1435131,1436522,1391,0,0,1,2
1435132,1436521,1389,0,0,1,1
1436522,1436570,48,1,0,0,1
1436523,1436571,48,1,0,0,2
1436571,1437452,881,0,0,1,1
1436572,1437455,883,0,0,1,2
1437453,1437482,29,1,0,0,1
1437456,1437480,24,1,0,0,2
1437481,1439300,1819,0,0,1,2
1437483,1439300,1817,0,0,1,1
1439301,1439564,263,1,0,0,2
1439301,1439577,276,1,0,0,1
1439376,1439538,162,0,1,0,1
1439395,1439512,117,0,1,0,2
1439565,1439898,333,0,0,1,2
1439578,1439884,306,0,0,1,1
1439885,1440141,256,1,0,0,1
1439899,1440120,221,1,0,0,2
1439915,1440087,172,0,1,0,1
1439925,1440082,157,0,1,0,2
1440121,1440326,205,0,0,1,2
1440142,1440326,184,0,0,1,1
1440327,1440389,62,1,0,0,1
1440327,1440390,63,1,0,0,2
1440390,1440481,91,0,0,1,1
1440391,1440482,91,0,0,1,2
1440482,1440512,30,1,0,0,1
1440483,1440503,20,1,0,0,2
1440504,1440796,292,0,0,1,2
1440513,1441340,827,0,0,1,1
1440797,1440820,23,1,0,0,2
1440821,1441342,521,0,0,1,2
1441341,1441363,22,1,0,0,1
1441343,1441360,17,1,0,0,2
1441361,1442204,843,0,0,1,2
1441364,1442206,842,0,0,1,1
1442205,1442227,22,1,0,0,2
1442207,1442227,20,1,0,0,1
1442228,1442630,402,0,0,1,2
1442228,1442631,403,0,0,1,1
1442631,1442678,47,1,0,0,2
1442632,1442687,55,1,0,0,1
1442679,1442930,251,0,0,1,2
1442688,1442928,240,0,0,1,1
1442929,1442967,38,1,0,0,1
1442931,1442965,34,1,0,0,2
1442966,1443241,275,0,0,1,2
1442968,1443242,274,0,0,1,1
1443242,1443277,35,1,0,0,2
1443243,1443267,24,1,0,0,1
1443268,1446365,3097,0,0,1,1
1443278,1446364,3086,0,0,1,2
1446365,1446418,53,1,0,0,2
1446366,1446426,60,1,0,0,1
1446419,1446513,94,0,0,1,2
1446427,1446513,86,0,0,1,1
1446514,1446542,28,1,0,0,2
1446514,1446547,33,1,0,0,1
1446543,1446882,339,0,0,1,2
1446548,1446881,333,0,0,1,1
1446882,1446912,30,1,0,0,1
1446883,1446912,29,1,0,0,2
1446913,1447176,263,0,0,1,1
1446913,1447181,268,0,0,1,2
1447177,1447194,17,1,0,0,1
1447182,1447192,10,1,0,0,2
1447193,1447585,392,0,0,1,2
1447195,1447589,394,0,0,1,1
1447586,1447605,19,1,0,0,2
1447590,1447608,18,1,0,0,1
1447606,1447761,155,0,0,1,2
1447609,1447759,150,0,0,1,1
1447760,1447822,62,1,0,0,1
1447762,1447824,62,1,0,0,2
1447823,1448356,533,0,0,1,1
1447825,1448355,530,0,0,1,2
1448356,1448376,20,1,0,0,2
1448357,1448385,28,1,0,0,1
1448377,1451061,2684,0,0,1,2
1448386,1451060,2674,0,0,1,1
1451061,1451356,295,1,0,0,1
1451062,1451158,96,1,0,0,2
1451159,1451315,156,0,0,1,2
1451191,1451241,50,0,1,0,1
1451316,1451347,31,1,0,0,2
1451348,1453291,1943,0,0,1,2
1451357,1451692,335,0,0,1,1
1451693,1451886,193,1,0,0,1
1451887,1451928,41,0,0,1,1
1451929,1451943,14,1,0,0,1
1451944,1452044,100,0,0,1,1
1452045,1452110,65,1,0,0,1
1452111,1452148,37,0,0,1,1
1452159,1452164,5,0,1,0,1
1452174,1452189,15,1,0,0,1
1452190,1452291,101,0,0,1,1
1452302,1452375,73,0,1,0,1
1452385,1452773,388,1,0,0,1
1452473,1452716,243,0,1,0,1
1452750,1452750,0,0,1,0,1
1452774,1452813,39,0,0,1,1
1452814,1455911,3097,1,0,0,1
1452832,1453707,875,0,1,0,1
1453292,1453309,17,1,0,0,2
1453310,1453453,143,0,0,1,2
1453454,1453505,51,1,0,0,2
1453506,1453786,280,0,0,1,2
1453777,1453847,70,0,1,0,1
1453787,1453815,28,1,0,0,2
1453816,1454424,608,0,0,1,2
1453889,1453940,51,0,1,0,1
1454071,1454084,13,0,1,0,1
1454142,1454169,27,0,1,0,1
1454216,1455805,1589,0,1,0,1
1454425,1454435,10,1,0,0,2
1454436,1455743,1307,0,0,1,2
1455744,1455800,56,1,0,0,2
1455801,1456024,223,0,0,1,2
1455912,1455939,27,0,0,1,1
1455940,1455957,17,1,0,0,1
1455958,1456000,42,0,0,1,1
1456001,1456092,91,1,0,0,1
1456025,1456082,57,1,0,0,2
1456083,1456630,547,0,0,1,2
1456093,1456634,541,0,0,1,1
1456631,1456654,23,1,0,0,2
1456635,1456651,16,1,0,0,1
1456652,1457452,800,0,0,1,1
1456655,1457450,795,0,0,1,2
1457451,1457502,51,1,0,0,2
1457453,1457493,40,1,0,0,1
1457494,1457941,447,0,0,1,1
1457503,1457936,433,0,0,1,2
1457937,1457967,30,1,0,0,2
1457942,1457965,23,1,0,0,1
1457966,1458957,991,0,0,1,1
1457968,1458959,991,0,0,1,2
1458958,1459010,52,1,0,0,1
1458960,1459014,54,1,0,0,2
1459011,1459109,98,0,0,1,1
1459015,1459110,95,0,0,1,2
1459110,1459141,31,1,0,0,1
1459111,1459136,25,1,0,0,2
1459137,1459704,567,0,0,1,2
1459142,1459703,561,0,0,1,1
1459704,1459732,28,1,0,0,1
1459705,1459724,19,1,0,0,2
1459725,1461763,2038,0,0,1,2
1459733,1461763,2030,0,0,1,1
1461764,1461815,51,1,0,0,2
1461764,1461822,58,1,0,0,1
1461816,1462315,499,0,0,1,2
1461823,1462314,491,0,0,1,1
1462315,1462401,86,1,0,0,1
1462316,1462401,85,1,0,0,2
1462402,1462474,72,0,0,1,2
1462402,1462475,73,0,0,1,1
1462475,1462517,42,1,0,0,2
1462476,1462520,44,1,0,0,1
1462518,1463772,1254,0,0,1,2
1462521,1463770,1249,0,0,1,1
1463771,1463794,23,1,0,0,1
1463773,1463792,19,1,0,0,2
1463793,1464132,339,0,0,1,2
1463795,1464129,334,0,0,1,1
1464130,1464182,52,1,0,0,1
1464133,1464173,40,1,0,0,2
1464174,1464454,280,0,0,1,2
1464183,1464453,270,0,0,1,1
1464454,1464488,34,1,0,0,1
1464455,1464489,34,1,0,0,2
1464489,1464772,283,0,0,1,1
1464490,1465416,926,0,0,1,2
1464783,1464787,4,0,1,0,1
1464797,1464950,153,1,0,0,1
1464875,1464933,58,0,1,0,1
1464951,1465238,287,0,0,1,1
1465239,1466447,1208,1,0,0,1
1465283,1466112,829,0,1,0,1
1465417,1465434,17,1,0,0,2
1465435,1465638,203,0,0,1,2
1465639,1465777,138,1,0,0,2
1465778,1466041,263,0,0,1,2
1466042,1466111,69,1,0,0,2
1466112,1466345,233,0,0,1,2
1466226,1466241,15,0,1,0,1
1466346,1466405,59,1,0,0,2
1466406,1467033,627,0,0,1,2
1466448,1467034,586,0,0,1,1
1467034,1467094,60,1,0,0,2
1467035,1467088,53,1,0,0,1
1467089,1467652,563,0,0,1,1
1467095,1467654,559,0,0,1,2
1467653,1467708,55,1,0,0,1
1467655,1467710,55,1,0,0,2
1467709,1467806,97,0,0,1,1
1467711,1467808,97,0,0,1,2
1467807,1467840,33,1,0,0,1
1467809,1467837,28,1,0,0,2
1467838,1468287,449,0,0,1,2
1467841,1468285,444,0,0,1,1
1468286,1468316,30,1,0,0,1
1468288,1468308,20,1,0,0,2
1468309,1468828,519,0,0,1,2
1468317,1468829,512,0,0,1,1
1468829,1468861,32,1,0,0,2
1468830,1468858,28,1,0,0,1
1468859,1469045,186,0,0,1,1
1468862,1469047,185,0,0,1,2
1469046,1469068,22,1,0,0,1
1469048,1469067,19,1,0,0,2
1469068,1469279,211,0,0,1,2
1469069,1469280,211,0,0,1,1
1469280,1469330,50,1,0,0,2
1469281,1469340,59,1,0,0,1
1469331,1469445,114,0,0,1,2
1469341,1469446,105,0,0,1,1
1469446,1469477,31,1,0,0,2
1469447,1469478,31,1,0,0,1
1469478,1470637,1159,0,0,1,2
1469479,1470632,1153,0,0,1,1
1470633,1470659,26,1,0,0,1
1470638,1470657,19,1,0,0,2
1470658,1472111,1453,0,0,1,2
1470660,1472113,1453,0,0,1,1
1472112,1472167,55,1,0,0,2
1472114,1472167,53,1,0,0,1
1472168,1473016,848,0,0,1,2
1472168,1473017,849,0,0,1,1
1473017,1473122,105,1,0,0,2
1473018,1474604,1586,1,0,0,1
1473096,1473442,346,0,1,0,1
1473123,1473263,140,0,0,1,2
1473264,1473285,21,1,0,0,2
1473286,1474029,743,0,0,1,2
1473541,1473544,3,0,1,0,1
1473621,1473625,4,0,1,0,1
1473834,1473844,10,0,1,0,1
1473869,1473904,35,0,1,0,1
1473946,1473988,42,0,1,0,1
1474009,1474049,40,0,1,0,1
1474030,1474056,26,1,0,0,2
1474057,1474523,466,0,0,1,2
1474118,1474243,125,0,1,0,1
1474279,1474485,206,0,1,0,1
1474507,1474542,35,0,1,0,1
1474524,1474591,67,1,0,0,2
1474592,1474779,187,0,0,1,2
1474605,1474778,173,0,0,1,1
1474779,1474838,59,1,0,0,1
1474780,1474847,67,1,0,0,2
1474839,1475015,176,0,0,1,1
1474848,1475015,167,0,0,1,2
1475016,1475051,35,1,0,0,1
1475016,1475061,45,1,0,0,2
1475052,1475721,669,0,0,1,1
1475062,1476410,1348,0,0,1,2
1475722,1475847,125,1,0,0,1
1475848,1475918,70,0,0,1,1
1475919,1475963,44,1,0,0,1
1475964,1476410,446,0,0,1,1
1476411,1476459,48,1,0,0,1
1476411,1476461,50,1,0,0,2
1476460,1476557,97,0,0,1,1
1476462,1476858,396,0,0,1,2
1476558,1476573,15,1,0,0,1
1476574,1476634,60,0,0,1,1
1476635,1476724,89,1,0,0,1
1476725,1476778,53,0,0,1,1
1476779,1476813,34,1,0,0,1
1476814,1476857,43,0,0,1,1
1476858,1476923,65,1,0,0,1
1476859,1476920,61,1,0,0,2
1476921,1477587,666,0,0,1,2
1476924,1477588,664,0,0,1,1
1477588,1477642,54,1,0,0,2
1477589,1477643,54,1,0,0,1
1477643,1478458,815,0,0,1,2
1477644,1478458,814,0,0,1,1
1478459,1478552,93,1,0,0,1
1478459,1478552,93,1,0,0,2
1478553,1478666,113,0,0,1,1
1478553,1478668,115,0,0,1,2
1478667,1478703,36,1,0,0,1
1478669,1478683,14,1,0,0,2
1478684,1479433,749,0,0,1,2
1478704,1479434,730,0,0,1,1
1479434,1479740,306,1,0,0,2
1479435,1480339,904,1,0,0,1
1479458,1480325,867,0,1,0,1
1479472,1479719,247,0,1,0,2
1479741,1479778,37,0,0,1,2
1479779,1480339,560,1,0,0,2
1480340,1480405,65,0,0,1,1
1480340,1480443,103,0,0,1,2
1480406,1480532,126,1,0,0,1
1480444,1480477,33,1,0,0,2
1480478,1481516,1038,0,0,1,2
1480533,1481231,698,0,0,1,1
1481232,1481281,49,1,0,0,1
1481282,1481338,56,0,0,1,1
1481339,1481355,16,1,0,0,1
1481356,1481518,162,0,0,1,1
1481517,1481553,36,1,0,0,2
1481529,1481529,0,0,1,0,1
1481539,1482236,697,1,0,0,1
1481554,1481575,21,0,0,1,2
1481576,1481590,14,1,0,0,2
1481591,1482351,760,0,0,1,2
1482237,1482265,28,0,0,1,1
1482266,1482756,490,1,0,0,1
1482352,1482406,54,1,0,0,2
1482407,1482617,210,0,0,1,2
1482618,1482674,56,1,0,0,2
1482675,1484185,1510,0,0,1,2
1482757,1484187,1430,0,0,1,1
1484186,1484248,62,1,0,0,2
1484188,1484250,62,1,0,0,1
1484249,1484345,96,0,0,1,2
1484251,1484345,94,0,0,1,1
1484346,1484380,34,1,0,0,1
1484346,1484380,34,1,0,0,2
1484381,1484688,307,0,0,1,1
1484381,1485636,1255,0,0,1,2
1484689,1484709,20,1,0,0,1
1484710,1485326,616,0,0,1,1
1485327,1485344,17,1,0,0,1
1485345,1485636,291,0,0,1,1
1485637,1485687,50,1,0,0,1
1485637,1485688,51,1,0,0,2
1485688,1486128,440,0,0,1,1
1485689,1486128,439,0,0,1,2
1486129,1486165,36,1,0,0,2
1486129,1486175,46,1,0,0,1
1486166,1486814,648,0,0,1,2
1486176,1486814,638,0,0,1,1
1486815,1486841,26,1,0,0,2
1486815,1486850,35,1,0,0,1
1486842,1487272,430,0,0,1,2
1486851,1487272,421,0,0,1,1
1487273,1487298,25,1,0,0,2
1487273,1487309,36,1,0,0,1
1487299,1488513,1214,0,0,1,2
1487310,1488512,1202,0,0,1,1
1488513,1488563,50,1,0,0,1
1488514,1488567,53,1,0,0,2
1488564,1488979,415,0,0,1,1
1488568,1488979,411,0,0,1,2
1488980,1489034,54,1,0,0,1
1488980,1489049,69,1,0,0,2
1489035,1489136,101,0,0,1,1
1489050,1489136,86,0,0,1,2
1489137,1489173,36,1,0,0,2
1489137,1489182,45,1,0,0,1
1489174,1489458,284,0,0,1,2
1489183,1489453,270,0,0,1,1
1489454,1489482,28,1,0,0,1
1489459,1489481,22,1,0,0,2
1489482,1490947,1465,0,0,1,2
1489483,1490946,1463,0,0,1,1
1490947,1490997,50,1,0,0,1
1490948,1490996,48,1,0,0,2
1490997,1491172,175,0,0,1,2
1490998,1491172,174,0,0,1,1
1491173,1491194,21,1,0,0,2
1491173,1491199,26,1,0,0,1
1491195,1492312,1117,0,0,1,2
1491200,1492310,1110,0,0,1,1
1492311,1492334,23,1,0,0,1
1492313,1492330,17,1,0,0,2
1492331,1493352,1021,0,0,1,2
1492335,1493351,1016,0,0,1,1
1493352,1493409,57,1,0,0,1
1493353,1493410,57,1,0,0,2
1493410,1494338,928,0,0,1,1
1493411,1494337,926,0,0,1,2
1494338,1494392,54,1,0,0,2
1494339,1494393,54,1,0,0,1
1494393,1494832,439,0,0,1,2
1494394,1494832,438,0,0,1,1
1494833,1494884,51,1,0,0,1
1494833,1494888,55,1,0,0,2
1494885,1495059,174,0,0,1,1
1494889,1495064,175,0,0,1,2
1495060,1495084,24,1,0,0,1
1495065,1495075,10,1,0,0,2
1495076,1495402,326,0,0,1,2
1495085,1495398,313,0,0,1,1
1495399,1495422,23,1,0,0,1
1495403,1495415,12,1,0,0,2
1495416,1496177,761,0,0,1,2
1495423,1496176,753,0,0,1,1
1496177,1496229,52,1,0,0,1
1496178,1496229,51,1,0,0,2
1496230,1496540,310,0,0,1,1
1496230,1496540,310,0,0,1,2
1496541,1496572,31,1,0,0,2
1496541,1496575,34,1,0,0,1
1496573,1498587,2014,0,0,1,2
1496576,1498589,2013,0,0,1,1
1498588,1498630,42,1,0,0,2
1498590,1498629,39,1,0,0,1
1498630,1498672,42,0,0,1,1
1498631,1498676,45,0,0,1,2
1498673,1498703,30,1,0,0,1
1498677,1498698,21,1,0,0,2
1498699,1499559,860,0,0,1,2
1498704,1499560,856,0,0,1,1
1499560,1499618,58,1,0,0,2
1499561,1499626,65,1,0,0,1
1499619,1499739,120,0,0,1,2
1499627,1499738,111,0,0,1,1
1499739,1499762,23,1,0,0,1
1499740,1499760,20,1,0,0,2
1499761,1499937,176,0,0,1,2
1499763,1499936,173,0,0,1,1
1499937,1499966,29,1,0,0,1
1499938,1499967,29,1,0,0,2
1499967,1500507,540,0,0,1,1
1499968,1500512,544,0,0,1,2
1500508,1500536,28,1,0,0,1
1500513,1500524,11,1,0,0,2
1500525,1500978,453,0,0,1,2
1500537,1500977,440,0,0,1,1
1500978,1501032,54,1,0,0,1
1500979,1501032,53,1,0,0,2
1501033,1501294,261,0,0,1,1
1501033,1501295,262,0,0,1,2
1501295,1501330,35,1,0,0,1
1501296,1501320,24,1,0,0,2
1501321,1501812,491,0,0,1,2
1501331,1501808,477,0,0,1,1
1501809,1501839,30,1,0,0,1
1501813,1501832,19,1,0,0,2
1501833,1503723,1890,0,0,1,2
1501840,1503724,1884,0,0,1,1
1503724,1503780,56,1,0,0,2
1503725,1503780,55,1,0,0,1
1503781,1504350,569,0,0,1,1
1503781,1504352,571,0,0,1,2
1504351,1504384,33,1,0,0,1
1504353,1504383,30,1,0,0,2
1504384,1504578,194,0,0,1,2
1504385,1504579,194,0,0,1,1
1504579,1504661,82,1,0,0,2
1504580,1504664,84,1,0,0,1
1504662,1504738,76,0,0,1,2
1504665,1504738,73,0,0,1,1
1504739,1504764,25,1,0,0,2
1504739,1504774,35,1,0,0,1
1504765,1505039,274,0,0,1,2
1504775,1505038,263,0,0,1,1
1505039,1505067,28,1,0,0,1
1505040,1505069,29,1,0,0,2
1505068,1505337,269,0,0,1,1
1505070,1505338,268,0,0,1,2
1505338,1505353,15,1,0,0,1
1505339,1505353,14,1,0,0,2
1505354,1505622,268,0,0,1,1
1505354,1505626,272,0,0,1,2
1505623,1505654,31,1,0,0,1
1505627,1505655,28,1,0,0,2
1505655,1506060,405,0,0,1,1
1505656,1506060,404,0,0,1,2
1506061,1506121,60,1,0,0,1
1506061,1506121,60,1,0,0,2
1506122,1506711,589,0,0,1,1
1506122,1508275,2153,0,0,1,2
1506712,1506739,27,1,0,0,1
1506740,1508273,1533,0,0,1,1
1508274,1508388,114,1,0,0,1
1508276,1508390,114,1,0,0,2
1508389,1508626,237,0,0,1,1
1508391,1508625,234,0,0,1,2
1508626,1508683,57,1,0,0,2
1508627,1508680,53,1,0,0,1
1508681,1509640,959,0,0,1,1
1508684,1509641,957,0,0,1,2
1509641,1509920,279,1,0,0,1
1509642,1509767,125,1,0,0,2
1509753,1509761,8,0,1,0,1
1509768,1510052,284,0,0,1,2
1509921,1510051,130,0,0,1,1
1510052,1510079,27,1,0,0,1
1510053,1510071,18,1,0,0,2
1510072,1511455,1383,0,0,1,2
1510080,1510248,168,0,0,1,1
1510249,1510273,24,1,0,0,1
1510274,1510388,114,0,0,1,1
1510389,1510433,44,1,0,0,1
1510434,1510492,58,0,0,1,1
1510493,1510519,26,1,0,0,1
1510520,1510593,73,0,0,1,1
1510594,1510754,160,1,0,0,1
1510755,1510813,58,0,0,1,1
1510814,1510842,28,1,0,0,1
1510843,1510996,153,0,0,1,1
1510997,1511001,4,1,0,0,1
1511002,1511100,98,0,0,1,1
1511101,1511221,120,1,0,0,1
1511222,1511250,28,0,0,1,1
1511251,1511271,20,1,0,0,1
1511272,1511354,82,0,0,1,1
1511355,1511429,74,1,0,0,1
1511430,1511455,25,0,0,1,1
1511456,1511517,61,1,0,0,2
1511456,1511566,110,1,0,0,1
1511518,1511664,146,0,0,1,2
1511567,1511665,98,0,0,1,1
1511665,1511686,21,1,0,0,2
1511666,1511695,29,1,0,0,1
1511687,1512194,507,0,0,1,2
1511696,1512190,494,0,0,1,1
1512191,1512233,42,1,0,0,1
1512195,1512204,9,1,0,0,2
1512205,1514109,1904,0,0,1,2
1512234,1514108,1874,0,0,1,1
1514109,1514151,42,1,0,0,1
1514110,1514151,41,1,0,0,2
1514152,1514335,183,0,0,1,1
1514152,1514335,183,0,0,1,2
1514336,1514393,57,1,0,0,1
1514336,1514395,59,1,0,0,2
1514394,1515259,865,0,0,1,1
1514396,1515258,862,0,0,1,2
1515259,1515333,74,1,0,0,2
1515260,1515335,75,1,0,0,1
1515334,1515389,55,0,0,1,2
1515336,1515386,50,0,0,1,1
1515387,1515422,35,1,0,0,1
1515390,1515423,33,1,0,0,2
1515423,1515445,22,0,0,1,1
1515424,1515447,23,0,0,1,2
1515446,1515500,54,1,0,0,1
1515448,1515488,40,1,0,0,2
1515489,1515612,123,0,0,1,2
1515501,1515611,110,0,0,1,1
1515612,1515651,39,1,0,0,1
1515613,1515633,20,1,0,0,2
1515634,1516405,771,0,0,1,2
1515652,1516405,753,0,0,1,1
1516406,1516476,70,1,0,0,1
1516406,1516477,71,1,0,0,2
1516477,1516816,339,0,0,1,1
1516478,1516817,339,0,0,1,2
1516817,1516853,36,1,0,0,1
1516818,1516853,35,1,0,0,2
1516854,1517086,232,0,0,1,1
1516854,1517090,236,0,0,1,2
1517087,1517108,21,1,0,0,1
1517091,1517106,15,1,0,0,2
1517107,1518256,1149,0,0,1,2
1517109,1518254,1145,0,0,1,1
1518255,1518278,23,1,0,0,1
1518257,1518274,17,1,0,0,2
1518275,1519683,1408,0,0,1,2
1518279,1519682,1403,0,0,1,1
1519683,1519737,54,1,0,0,1
1519684,1519738,54,1,0,0,2
1519738,1519828,90,0,0,1,1
1519739,1519825,86,0,0,1,2
1519826,1519900,74,1,0,0,2
1519829,1519874,45,1,0,0,1
1519875,1521443,1568,0,0,1,1
1519901,1521454,1553,0,0,1,2
1521444,1521723,279,1,0,0,1
1521455,1521663,208,1,0,0,2
1521485,1521611,126,0,1,0,1
1521513,1521564,51,0,1,0,2
1521664,1521709,45,0,0,1,2
1521710,1521725,15,1,0,0,2
1521724,1521809,85,0,0,1,1
1521726,1521809,83,0,0,1,2
1521810,1521836,26,1,0,0,1
1521810,1521839,29,1,0,0,2
1521837,1522084,247,0,0,1,1
1521840,1522084,244,0,0,1,2
1522085,1522132,47,1,0,0,1
1522085,1522133,48,1,0,0,2
1522133,1522350,217,0,0,1,1
1522134,1522351,217,0,0,1,2
1522351,1522381,30,1,0,0,1
1522352,1522372,20,1,0,0,2
1522373,1523161,788,0,0,1,2
1522382,1523160,778,0,0,1,1
1523161,1523192,31,1,0,0,1
1523162,1523184,22,1,0,0,2
1523185,1523585,400,0,0,1,2
1523193,1523585,392,0,0,1,1
1523586,1523615,29,1,0,0,1
1523586,1523617,31,1,0,0,2
1523616,1524428,812,0,0,1,1
1523618,1524427,809,0,0,1,2
1524428,1524497,69,1,0,0,2
1524429,1524499,70,1,0,0,1
1524498,1525531,1033,0,0,1,2
1524500,1525529,1029,0,0,1,1
1525530,1525560,30,1,0,0,1
1525532,1525562,30,1,0,0,2
1525561,1525849,288,0,0,1,1
1525563,1525849,286,0,0,1,2
1525850,1525886,36,1,0,0,2
1525850,1525891,41,1,0,0,1
1525887,1526133,246,0,0,1,2
1525892,1526133,241,0,0,1,1
1526134,1526158,24,1,0,0,2
1526134,1526159,25,1,0,0,1
1526159,1527112,953,0,0,1,2
1526160,1527110,950,0,0,1,1
1527111,1527123,12,1,0,0,1
1527113,1527124,11,1,0,0,2
1527124,1527630,506,0,0,1,1
1527125,1527632,507,0,0,1,2
1527631,1527697,66,1,0,0,1
1527633,1527699,66,1,0,0,2
1527698,1527855,157,0,0,1,1
1527700,1527855,155,0,0,1,2
1527856,1527876,20,1,0,0,2
1527856,1527885,29,1,0,0,1
1527877,1528533,656,0,0,1,2
1527886,1528531,645,0,0,1,1
1528532,1528560,28,1,0,0,1
1528534,1528559,25,1,0,0,2
1528560,1529863,1303,0,0,1,2
1528561,1529863,1302,0,0,1,1
1529864,1529931,67,1,0,0,1
1529864,1529939,75,1,0,0,2
1529932,1531290,1358,0,0,1,1
1529940,1531290,1350,0,0,1,2
1531291,1531340,49,1,0,0,1
1531291,1531340,49,1,0,0,2
1531341,1531555,214,0,0,1,1
1531341,1531555,214,0,0,1,2
1531556,1531608,52,1,0,0,1
1531556,1531609,53,1,0,0,2
1531609,1531844,235,0,0,1,1
1531610,1531841,231,0,0,1,2
1531842,1531870,28,1,0,0,2
1531845,1531869,24,1,0,0,1
1531870,1532520,650,0,0,1,1
1531871,1532525,654,0,0,1,2
1532521,1532545,24,1,0,0,1
1532526,1532534,8,1,0,0,2
1532535,1532832,297,0,0,1,2
1532546,1532830,284,0,0,1,1
1532831,1532885,54,1,0,0,1
1532833,1532886,53,1,0,0,2
1532886,1533259,373,0,0,1,1
1532887,1533259,372,0,0,1,2
1533260,1533293,33,1,0,0,2
1533260,1533296,36,1,0,0,1
1533294,1533504,210,0,0,1,2
1533297,1533503,206,0,0,1,1
1533504,1533534,30,1,0,0,1
1533505,1533526,21,1,0,0,2
1533527,1534173,646,0,0,1,2
1533535,1534175,640,0,0,1,1
1534174,1534224,50,1,0,0,2
1534176,1534212,36,1,0,0,1
1534213,1534858,645,0,0,1,1
1534225,1534859,634,0,0,1,2
1534859,1534925,66,1,0,0,1
1534860,1534927,67,1,0,0,2
1534926,1535800,874,0,0,1,1
1534928,1535800,872,0,0,1,2
1535801,1535851,50,1,0,0,1
1535801,1535854,53,1,0,0,2
1535852,1536020,168,0,0,1,1
1535855,1536021,166,0,0,1,2
1536021,1536083,62,1,0,0,1
1536022,1536076,54,1,0,0,2
1536077,1536290,213,0,0,1,2
1536084,1536291,207,0,0,1,1
1536291,1536321,30,1,0,0,2
1536292,1536319,27,1,0,0,1
1536320,1537151,831,0,0,1,1
1536322,1537153,831,0,0,1,2
1537152,1537183,31,1,0,0,1
1537154,1537180,26,1,0,0,2
1537181,1537812,631,0,0,1,2
1537184,1537813,629,0,0,1,1
1537813,1537876,63,1,0,0,2
1537814,1537890,76,1,0,0,1
1537877,1538123,246,0,0,1,2
1537891,1538123,232,0,0,1,1
1538124,1538153,29,1,0,0,2
1538124,1538164,40,1,0,0,1
1538154,1538439,285,0,0,1,2
1538165,1538439,274,0,0,1,1
1538440,1538458,18,1,0,0,2
1538440,1538467,27,1,0,0,1
1538459,1539065,606,0,0,1,2
1538468,1539064,596,0,0,1,1
1539065,1539102,37,1,0,0,1
1539066,1539102,36,1,0,0,2
1539103,1539584,481,0,0,1,1
1539103,1539585,482,0,0,1,2
1539585,1539616,31,1,0,0,1
1539586,1539605,19,1,0,0,2
1539606,1540554,948,0,0,1,2
1539617,1540552,935,0,0,1,1
1540553,1540616,63,1,0,0,1
1540555,1540617,62,1,0,0,2
1540617,1541160,543,0,0,1,1
1540618,1541160,542,0,0,1,2
1541161,1541228,67,1,0,0,2
1541161,1541230,69,1,0,0,1
1541229,1541626,397,0,0,1,2
1541231,1541625,394,0,0,1,1
1541626,1541681,55,1,0,0,1
1541627,1541679,52,1,0,0,2
1541680,1541844,164,0,0,1,2
1541682,1541843,161,0,0,1,1
1541844,1541889,45,1,0,0,1
1541845,1541881,36,1,0,0,2
1541882,1542105,223,0,0,1,2
1541890,1542111,221,0,0,1,1
1542106,1542135,29,1,0,0,2
1542112,1542124,12,1,0,0,1
1542125,1542875,750,0,0,1,1
1542136,1542880,744,0,0,1,2
1542876,1542905,29,1,0,0,1
1542881,1542904,23,1,0,0,2
1542905,1543480,575,0,0,1,2
1542906,1543480,574,0,0,1,1
1543481,1543530,49,1,0,0,1
1543481,1543530,49,1,0,0,2
1543531,1543762,231,0,0,1,1
1543531,1543763,232,0,0,1,2
1543763,1543797,34,1,0,0,1
1543764,1543793,29,1,0,0,2
1543794,1544117,323,0,0,1,2
1543798,1544117,319,0,0,1,1
1544118,1544141,23,1,0,0,1
1544118,1544143,25,1,0,0,2
1544142,1546143,2001,0,0,1,1
1544144,1546141,1997,0,0,1,2
1546142,1546178,36,1,0,0,2
1546144,1546177,33,1,0,0,1
1546178,1546568,390,0,0,1,1
1546179,1546567,388,0,0,1,2
1546568,1546607,39,1,0,0,2
1546569,1546606,37,1,0,0,1
1546607,1547163,556,0,0,1,1
1546608,1547164,556,0,0,1,2
1547164,1547210,46,1,0,0,1
1547165,1547213,48,1,0,0,2
1547211,1547415,204,0,0,1,1
1547214,1547416,202,0,0,1,2
1547416,1547488,72,1,0,0,1
1547417,1547479,62,1,0,0,2
1547480,1547639,159,0,0,1,2
1547489,1547636,147,0,0,1,1
1547637,1547665,28,1,0,0,1
1547640,1547656,16,1,0,0,2
1547657,1548924,1267,0,0,1,2
1547666,1548655,989,0,0,1,1
1548656,1548672,16,1,0,0,1
1548673,1549079,406,0,0,1,1
1548925,1548934,9,1,0,0,2
1548935,1549086,151,0,0,1,2
1549080,1549099,19,1,0,0,1
1549087,1549098,11,1,0,0,2
1549099,1549175,76,0,0,1,2
1549100,1549175,75,0,0,1,1
1549176,1549242,66,1,0,0,2
1549176,1549243,67,1,0,0,1
1549243,1549598,355,0,0,1,2
1549244,1549587,343,0,0,1,1
1549588,1549630,42,1,0,0,1
1549599,1549630,31,1,0,0,2
1549631,1550633,1002,0,0,1,1
1549631,1550633,1002,0,0,1,2
1550634,1550659,25,1,0,0,1
1550634,1550668,34,1,0,0,2
1550660,1551379,719,0,0,1,1
1550669,1551381,712,0,0,1,2
1551380,1551414,34,1,0,0,1
1551382,1551412,30,1,0,0,2
1551413,1552225,812,0,0,1,2
1551415,1552224,809,0,0,1,1
1552225,1552303,78,1,0,0,1
1552226,1552304,78,1,0,0,2
1552304,1552827,523,0,0,1,1
1552305,1552825,520,0,0,1,2
1552826,1552890,64,1,0,0,2
1552828,1552895,67,1,0,0,1
1552891,1552982,91,0,0,1,2
1552896,1552981,85,0,0,1,1
1552982,1553023,41,1,0,0,1
1552983,1553022,39,1,0,0,2
1553023,1554158,1135,0,0,1,2
1553024,1554158,1134,0,0,1,1
1554159,1554168,9,1,0,0,2
1554159,1554170,11,1,0,0,1
1554169,1554365,196,0,0,1,2
1554171,1554365,194,0,0,1,1
1554366,1554418,52,1,0,0,1
1554366,1554420,54,1,0,0,2
1554419,1555020,601,0,0,1,1
1554421,1555021,600,0,0,1,2
1555021,1555053,32,1,0,0,1
1555022,1555051,29,1,0,0,2
1555052,1556723,1671,0,0,1,2
1555054,1556722,1668,0,0,1,1
1556723,1556864,141,1,0,0,1
1556724,1556772,48,1,0,0,2
1556773,1556794,21,0,0,1,2
1556795,1556829,34,1,0,0,2
1556830,1557014,184,0,0,1,2
1556865,1557016,151,0,0,1,1
1557015,1557071,56,1,0,0,2
1557017,1557071,54,1,0,0,1
1557072,1557566,494,0,0,1,1
1557072,1557566,494,0,0,1,2
1557567,1557622,55,1,0,0,1
1557567,1557631,64,1,0,0,2
1557623,1557808,185,0,0,1,1
1557632,1557809,177,0,0,1,2
1557809,1557838,29,1,0,0,1
1557810,1557831,21,1,0,0,2
1557832,1558612,780,0,0,1,2
1557839,1558617,778,0,0,1,1
1558613,1558634,21,1,0,0,2
1558618,1558627,9,1,0,0,1
1558628,1559579,951,0,0,1,1
1558635,1559578,943,0,0,1,2
1559579,1559641,62,1,0,0,2
1559580,1559648,68,1,0,0,1
1559642,1559830,188,0,0,1,2
1559649,1559831,182,0,0,1,1
1559831,1559861,30,1,0,0,2
1559832,1559873,41,1,0,0,1
1559862,1561628,1766,0,0,1,2
1559874,1561627,1753,0,0,1,1
1561628,1561799,171,1,0,0,1
1561629,1561768,139,1,0,0,2
1561769,1562120,351,0,0,1,2
1561800,1562121,321,0,0,1,1
1562121,1562174,53,1,0,0,2
1562122,1562172,50,1,0,0,1
1562173,1563117,944,0,0,1,1
1562175,1563116,941,0,0,1,2
1563117,1563167,50,1,0,0,2
1563118,1563164,46,1,0,0,1
1563165,1563578,413,0,0,1,1
1563168,1563576,408,0,0,1,2
1563577,1563638,61,1,0,0,2
1563579,1563648,69,1,0,0,1
1563639,1563818,179,0,0,1,2
1563649,1563816,167,0,0,1,1
1563817,1563843,26,1,0,0,1
1563819,1563842,23,1,0,0,2
1563843,1564901,1058,0,0,1,2
1563844,1564895,1051,0,0,1,1
1564896,1564923,27,1,0,0,1
1564902,1564921,19,1,0,0,2
1564922,1565175,253,0,0,1,2
1564924,1565174,250,0,0,1,1
1565175,1565238,63,1,0,0,1
1565176,1565235,59,1,0,0,2
1565236,1566228,992,0,0,1,2
1565239,1566228,989,0,0,1,1
1566229,1566249,20,1,0,0,2
1566229,1566257,28,1,0,0,1
1566250,1567011,761,0,0,1,2
1566258,1567006,748,0,0,1,1
1567007,1567166,159,1,0,0,1
1567012,1567084,72,1,0,0,2
1567085,1567342,257,0,0,1,2
1567167,1567227,60,0,0,1,1
1567228,1567255,27,1,0,0,1
1567256,1567340,84,0,0,1,1
1567341,1567399,58,1,0,0,1
1567343,1567399,56,1,0,0,2
1567400,1567640,240,0,0,1,1
1567400,1567640,240,0,0,1,2
1567641,1567691,50,1,0,0,1
1567641,1567694,53,1,0,0,2
1567692,1568410,718,0,0,1,1
1567695,1568411,716,0,0,1,2
1568411,1568448,37,1,0,0,1
1568412,1568448,36,1,0,0,2
1568449,1568742,293,0,0,1,1
1568449,1568743,294,0,0,1,2
1568743,1568789,46,1,0,0,1
1568744,1568789,45,1,0,0,2
1568790,1568927,137,0,0,1,2
1568790,1568929,139,0,0,1,1
1568928,1568978,50,1,0,0,2
1568930,1568977,47,1,0,0,1
1568978,1569163,185,0,0,1,1
1568979,1569156,177,0,0,1,2
1569157,1569183,26,1,0,0,2
1569164,1569181,17,1,0,0,1
1569182,1569432,250,0,0,1,1
1569184,1569432,248,0,0,1,2
1569433,1569454,21,1,0,0,2
1569433,1569459,26,1,0,0,1
1569455,1569581,126,0,0,1,2
1569460,1569582,122,0,0,1,1
1569582,1569612,30,1,0,0,2
1569583,1569611,28,1,0,0,1
1569612,1570003,391,0,0,1,1
1569613,1570004,391,0,0,1,2
1570004,1570054,50,1,0,0,1
1570005,1570051,46,1,0,0,2
1570052,1570251,199,0,0,1,2
1570055,1570251,196,0,0,1,1
1570252,1570275,23,1,0,0,2
1570252,1570284,32,1,0,0,1
1570276,1570599,323,0,0,1,2
1570285,1570601,316,0,0,1,1
1570600,1570642,42,1,0,0,2
1570602,1570641,39,1,0,0,1
1570642,1570832,190,0,0,1,1
1570643,1570838,195,0,0,1,2
1570833,1571133,300,1,0,0,1
1570839,1571121,282,1,0,0,2
1570861,1571078,217,0,1,0,1
1570868,1571044,176,0,1,0,2
1571122,1571358,236,0,0,1,2
1571134,1571357,223,0,0,1,1
1571358,1571389,31,1,0,0,1
1571359,1571379,20,1,0,0,2
1571380,1571635,255,0,0,1,2
1571390,1571634,244,0,0,1,1
1571635,1571676,41,1,0,0,1
1571636,1571664,28,1,0,0,2
1571665,1571971,306,0,0,1,2
1571677,1571972,295,0,0,1,1
1571972,1572006,34,1,0,0,2
1571973,1572003,30,1,0,0,1
1572004,1572542,538,0,0,1,1
1572007,1572542,535,0,0,1,2
1608254,1608502,248,0,0,1,1
1608254,1608502,248,0,0,1,2
1608503,1608528,25,1,0,0,1
1608503,1608540,37,1,0,0,2
1608529,1609481,952,0,0,1,1
1608541,1610156,1615,0,0,1,2
1609482,1609496,14,1,0,0,1
1609497,1610157,660,0,0,1,1
1610157,1610169,12,1,0,0,2
1610158,1610179,21,1,0,0,1
1610170,1610803,633,0,0,1,2
1610180,1610803,623,0,0,1,1
1610804,1611030,226,1,0,0,2
1610804,1612533,1729,1,0,0,1
1610864,1612145,1281,0,1,0,1
1611031,1612198,1167,0,0,1,2
1612184,1612200,16,0,1,0,1
1612199,1612308,109,1,0,0,2
1612246,1612491,245,0,1,0,1
1612309,1612459,150,0,0,1,2
1612460,1612532,72,1,0,0,2
1612533,1612774,241,0,0,1,2
1612534,1612775,241,0,0,1,1
1612775,1612831,56,1,0,0,2
1612776,1612830,54,1,0,0,1
1612831,1612867,36,0,0,1,1
1612832,1612868,36,0,0,1,2
1612868,1612970,102,1,0,0,1
1612869,1612951,82,1,0,0,2
1612952,1613042,90,0,0,1,2
1612971,1613038,67,0,0,1,1
1613039,1613076,37,1,0,0,1
1613043,1613066,23,1,0,0,2
1613067,1614221,1154,0,0,1,2
1613077,1614223,1146,0,0,1,1
1614222,1614324,102,1,0,0,2
1614224,1614325,101,1,0,0,1
1614325,1614612,287,0,0,1,2
1614326,1614612,286,0,0,1,1
1614613,1614684,71,1,0,0,1
1614613,1614684,71,1,0,0,2
1614685,1614760,75,0,0,1,1
1614685,1614760,75,0,0,1,2
1614761,1614806,45,1,0,0,2
1614761,1614807,46,1,0,0,1
1614807,1615234,427,0,0,1,2
1614808,1615230,422,0,0,1,1
1615231,1615255,24,1,0,0,1
1615235,1615245,10,1,0,0,2
1615246,1616118,872,0,0,1,2
1615256,1616117,861,0,0,1,1
1616118,1616205,87,1,0,0,1
1616119,1616206,87,1,0,0,2
1616206,1616398,192,0,0,1,1
1616207,1616399,192,0,0,1,2
1616399,1616461,62,1,0,0,1
1616400,1616462,62,1,0,0,2
1616462,1616580,118,0,0,1,1
1616463,1616579,116,0,0,1,2
1616580,1616660,80,1,0,0,2
1616581,1616664,83,1,0,0,1
1616661,1616824,163,0,0,1,2
1616665,1616822,157,0,0,1,1
1616823,1616854,31,1,0,0,1
1616825,1616854,29,1,0,0,2
1616855,1618009,1154,0,0,1,2
1616855,1618010,1155,0,0,1,1
1618010,1618113,103,1,0,0,2
1618011,1618111,100,1,0,0,1
1618112,1618355,243,0,0,1,1
1618114,1618354,240,0,0,1,2
1618355,1618507,152,1,0,0,2
1618356,1618508,152,1,0,0,1
1618508,1618612,104,0,0,1,2
1618509,1618613,104,0,0,1,1
1618613,1618647,34,1,0,0,2
1618614,1618653,39,1,0,0,1
1618648,1620067,1419,0,0,1,2
1618654,1620067,1413,0,0,1,1
1620068,1620182,114,1,0,0,1
1620068,1620183,115,1,0,0,2
1620183,1620243,60,0,0,1,1
1620184,1620245,61,0,0,1,2
1620244,1620300,56,1,0,0,1
1620246,1620309,63,1,0,0,2
1620301,1620388,87,0,0,1,1
1620310,1620389,79,0,0,1,2
1620389,1620423,34,1,0,0,1
1620390,1620426,36,1,0,0,2
1620424,1620721,297,0,0,1,1
1620427,1620727,300,0,0,1,2
1620722,1620749,27,1,0,0,1
1620728,1620745,17,1,0,0,2
1620746,1621601,855,0,0,1,2
1620750,1621601,851,0,0,1,1
1621602,1621672,70,1,0,0,1
1621602,1621673,71,1,0,0,2
1621673,1622030,357,0,0,1,1
1621674,1622030,356,0,0,1,2
1622031,1622082,51,1,0,0,1
1622031,1622083,52,1,0,0,2
1622083,1623646,1563,0,0,1,1
1622084,1623647,1563,0,0,1,2
1623647,1623726,79,1,0,0,1
1623648,1623713,65,1,0,0,2
1623714,1623890,176,0,0,1,2
1623727,1623887,160,0,0,1,1
1623888,1623914,26,1,0,0,1
1623891,1623917,26,1,0,0,2
1623915,1625136,1221,0,0,1,1
1623918,1625166,1248,0,0,1,2
1625137,1625146,9,1,0,0,1
1625147,1625167,20,0,0,1,1
1625167,1625289,122,1,0,0,2
1625168,1625288,120,1,0,0,1
1625289,1625456,167,0,0,1,1
1625290,1625457,167,0,0,1,2
1625457,1625545,88,1,0,0,1
1625458,1625536,78,1,0,0,2
1625537,1625629,92,0,0,1,2
1625546,1625626,80,0,0,1,1
1625627,1625661,34,1,0,0,1
1625630,1625661,31,1,0,0,2
1625662,1625929,267,0,0,1,1
1625662,1625931,269,0,0,1,2
1625930,1625962,32,1,0,0,1
1625932,1625960,28,1,0,0,2
1625961,1626302,341,0,0,1,2
1625963,1626300,337,0,0,1,1
1626301,1626323,22,1,0,0,1
1626303,1626330,27,1,0,0,2
1626324,1626940,616,0,0,1,1
1626331,1626941,610,0,0,1,2
1626941,1627024,83,1,0,0,1
1626942,1627021,79,1,0,0,2
1627022,1627430,408,0,0,1,2
1627025,1627430,405,0,0,1,1
1627431,1627515,84,1,0,0,1
1627431,1627518,87,1,0,0,2
1627516,1627616,100,0,0,1,1
1627519,1627616,97,0,0,1,2
1627617,1627652,35,1,0,0,2
1627617,1627658,41,1,0,0,1
1627653,1628758,1105,0,0,1,2
1627659,1628757,1098,0,0,1,1
1628758,1628841,83,1,0,0,1
1628759,1628842,83,1,0,0,2
1628842,1629230,388,0,0,1,1
1628843,1629229,386,0,0,1,2
1629230,1629329,99,1,0,0,2
1629231,1630657,1426,1,0,0,1
1629330,1630564,1234,0,0,1,2
1629384,1629394,10,0,1,0,1
1629440,1630636,1196,0,1,0,1
1630565,1630652,87,1,0,0,2
1630653,1630971,318,0,0,1,2
1630658,1630972,314,0,0,1,1
1630972,1631034,62,1,0,0,2
1630973,1631034,61,1,0,0,1
1631035,1631123,88,0,0,1,1
1631035,1631123,88,0,0,1,2
1631124,1631156,32,1,0,0,2
1631124,1631175,51,1,0,0,1
1631157,1631290,133,0,0,1,2
1631176,1631288,112,0,0,1,1
1631289,1631304,15,1,0,0,1
1631291,1631305,14,1,0,0,2
1631305,1631916,611,0,0,1,1
1631306,1631917,611,0,0,1,2
1631917,1632001,84,1,0,0,1
1631918,1631993,75,1,0,0,2
1631994,1632362,368,0,0,1,2
1632002,1632363,361,0,0,1,1
1632363,1632448,85,1,0,0,2
1632364,1632513,149,1,0,0,1
1632449,1632547,98,0,0,1,2
1632514,1632626,112,0,0,1,1
1632548,1632675,127,1,0,0,2
1632627,1632683,56,1,0,0,1
1632676,1632706,30,0,0,1,2
1632684,1632829,145,0,0,1,1
1632707,1632754,47,1,0,0,2
1632755,1632822,67,0,0,1,2
1632823,1632853,30,1,0,0,2
1632830,1632886,56,1,0,0,1
1632854,1633144,290,0,0,1,2
1632887,1632939,52,0,0,1,1
1632940,1632990,50,1,0,0,1
1632991,1633143,152,0,0,1,1
1633144,1633166,22,1,0,0,1
1633145,1633162,17,1,0,0,2
1633163,1633340,177,0,0,1,2
1633167,1633199,32,0,0,1,1
1633200,1633257,57,1,0,0,1
1633258,1633698,440,0,0,1,1
1633341,1633368,27,1,0,0,2
1633369,1633699,330,0,0,1,2
1633699,1633787,88,1,0,0,1
1633700,1633781,81,1,0,0,2
1633782,1633853,71,0,0,1,2
1633788,1633854,66,0,0,1,1
1633854,1633897,43,1,0,0,2
1633855,1633898,43,1,0,0,1
1633898,1634117,219,0,0,1,2
1633899,1634113,214,0,0,1,1
1634114,1634291,177,1,0,0,1
1634118,1634280,162,1,0,0,2
1634135,1634246,111,0,1,0,1
1634141,1634224,83,0,1,0,2
1634281,1634423,142,0,0,1,2
1634292,1634423,131,0,0,1,1
1634424,1634451,27,1,0,0,1
1634424,1634452,28,1,0,0,2
1634452,1635527,1075,0,0,1,1
1634453,1635525,1072,0,0,1,2
1635526,1635612,86,1,0,0,2
1635528,1635615,87,1,0,0,1
1635613,1635665,52,0,0,1,2
1635616,1635666,50,0,0,1,1
1635666,1635714,48,1,0,0,2
1635667,1635715,48,1,0,0,1
1635715,1635889,174,0,0,1,2
1635716,1635891,175,0,0,1,1
1635890,1635920,30,1,0,0,2
1635892,1635919,27,1,0,0,1
1635920,1636819,899,0,0,1,1
1635921,1636819,898,0,0,1,2
1636820,1636915,95,1,0,0,1
1636820,1636916,96,1,0,0,2
1636916,1637267,351,0,0,1,1
1636917,1637267,350,0,0,1,2
1637268,1637321,53,1,0,0,2
1637268,1637322,54,1,0,0,1
1637322,1637504,182,0,0,1,2
1637323,1637504,181,0,0,1,1
1637505,1637533,28,1,0,0,2
1637505,1637541,36,1,0,0,1
1637534,1638694,1160,0,0,1,2
1637542,1638695,1153,0,0,1,1
1638695,1638786,91,1,0,0,2
1638696,1638786,90,1,0,0,1
1638787,1638996,209,0,0,1,2
1638787,1638998,211,0,0,1,1
1638997,1639054,57,1,0,0,2
1638999,1639055,56,1,0,0,1
1639055,1639333,278,0,0,1,2
1639056,1639327,271,0,0,1,1
1639328,1639354,26,1,0,0,1
1639334,1639352,18,1,0,0,2
1639353,1640371,1018,0,0,1,2
1639355,1640370,1015,0,0,1,1
1640371,1640422,51,1,0,0,1
1640372,1640425,53,1,0,0,2
1640423,1640698,275,0,0,1,1
1640426,1640699,273,0,0,1,2
1640699,1640758,59,1,0,0,1
1640700,1640751,51,1,0,0,2
1640752,1640924,172,0,0,1,2
1640759,1640919,160,0,0,1,1
1640920,1640944,24,1,0,0,1
1640925,1640937,12,1,0,0,2
1640938,1641931,993,0,0,1,2
1640945,1641930,985,0,0,1,1
1641931,1641996,65,1,0,0,1
1641932,1641988,56,1,0,0,2
1641989,1642324,335,0,0,1,2
1641997,1642323,326,0,0,1,1
1642324,1642403,79,1,0,0,1
1642325,1642394,69,1,0,0,2
1642395,1642472,77,0,0,1,2
1642404,1642470,66,0,0,1,1
1642471,1642509,38,1,0,0,1
1642473,1642513,40,1,0,0,2
1642510,1642689,179,0,0,1,1
1642514,1642696,182,0,0,1,2
1642690,1642708,18,1,0,0,1
1642697,1642706,9,1,0,0,2
1642707,1643343,636,0,0,1,2
1642709,1643343,634,0,0,1,1
1643344,1643408,64,1,0,0,2
1643344,1643418,74,1,0,0,1
1643409,1643763,354,0,0,1,2
1643419,1643763,344,0,0,1,1
1643764,1643807,43,1,0,0,1
1643764,1643815,51,1,0,0,2
1643808,1644918,1110,0,0,1,1
1643816,1644919,1103,0,0,1,2
1644919,1644983,64,1,0,0,1
1644920,1644980,60,1,0,0,2
1644981,1645315,334,0,0,1,2
1644984,1645316,332,0,0,1,1
1645316,1645450,134,1,0,0,2
1645317,1645447,130,1,0,0,1
1645448,1645564,116,0,0,1,1
1645451,1645565,114,0,0,1,2
1645565,1645595,30,1,0,0,1
1645566,1645598,32,1,0,0,2
1645596,1645872,276,0,0,1,1
1645599,1645873,274,0,0,1,2
1645873,1645901,28,1,0,0,1
1645874,1645893,19,1,0,0,2
1645894,1646553,659,0,0,1,2
1645902,1646553,651,0,0,1,1
1646554,1646629,75,1,0,0,1
1646554,1646640,86,1,0,0,2
1646630,1647051,421,0,0,1,1
1646641,1647048,407,0,0,1,2
1647049,1647157,108,1,0,0,2
1647052,1648416,1364,1,0,0,1
1647128,1648400,1272,0,1,0,1
1647158,1647258,100,0,0,1,2
1647259,1647288,29,1,0,0,2
1647289,1647460,171,0,0,1,2
1647461,1647486,25,1,0,0,2
1647487,1647671,184,0,0,1,2
1647672,1647880,208,1,0,0,2
1647881,1647912,31,0,0,1,2
1647913,1648073,160,1,0,0,2
1648074,1648147,73,0,0,1,2
1648148,1648235,87,1,0,0,2
1648236,1648304,68,0,0,1,2
1648305,1648397,92,1,0,0,2
1648398,1648792,394,0,0,1,2
1648417,1648443,26,0,0,1,1
1648444,1648463,19,1,0,0,1
1648464,1648793,329,0,0,1,1
1648793,1648855,62,1,0,0,2
1648794,1648854,60,1,0,0,1
1648855,1648960,105,0,0,1,1
1648856,1648960,104,0,0,1,2
1648961,1648982,21,1,0,0,1
1648961,1648991,30,1,0,0,2
1648983,1649250,267,0,0,1,1
1648992,1649256,264,0,0,1,2
1649251,1649263,12,1,0,0,1
1649257,1649261,4,1,0,0,2
1649262,1650236,974,0,0,1,2
1649264,1650233,969,0,0,1,1
1650234,1650318,84,1,0,0,1
1650237,1650319,82,1,0,0,2
1650319,1650390,71,0,0,1,1
1650320,1650390,70,0,0,1,2
1650391,1650425,34,1,0,0,2
1650391,1650426,35,1,0,0,1
1650426,1650947,521,0,0,1,2
1650427,1650944,517,0,0,1,1
1650945,1650965,20,1,0,0,1
1650948,1650964,16,1,0,0,2
1650965,1651427,462,0,0,1,2
1650966,1651429,463,0,0,1,1
1651428,1651495,67,1,0,0,2
1651430,1651494,64,1,0,0,1
1651495,1651934,439,0,0,1,1
1651496,1651933,437,0,0,1,2
1651934,1652320,386,1,0,0,2
1651935,1652132,197,1,0,0,1
1652023,1652078,55,0,1,0,1
1652133,1652153,20,0,0,1,1
1652154,1653488,1334,1,0,0,1
1652307,1653470,1163,0,1,0,1
1652321,1652387,66,0,0,1,2
1652388,1652419,31,1,0,0,2
1652420,1652536,116,0,0,1,2
1652537,1652678,141,1,0,0,2
1652679,1652848,169,0,0,1,2
1652849,1652884,35,1,0,0,2
1652885,1653186,301,0,0,1,2
1653187,1653196,9,1,0,0,2
1653197,1653389,192,0,0,1,2
1653390,1653480,90,1,0,0,2
1653481,1653878,397,0,0,1,2
1653489,1653878,389,0,0,1,1
1653879,1653940,61,1,0,0,1
1653879,1653942,63,1,0,0,2
1653941,1654046,105,0,0,1,1
1653943,1654046,103,0,0,1,2
1654047,1654080,33,1,0,0,2
1654047,1654081,34,1,0,0,1
1654081,1654797,716,0,0,1,2
1654082,1654798,716,0,0,1,1
1654798,1654909,111,1,0,0,2
1654799,1654908,109,1,0,0,1
1654909,1655323,414,0,0,1,1
1654910,1655324,414,0,0,1,2
1655324,1655425,101,1,0,0,1
1655325,1655413,88,1,0,0,2
1655414,1655504,90,0,0,1,2
1655426,1655502,76,0,0,1,1
1655503,1655544,41,1,0,0,1
1655505,1655536,31,1,0,0,2
1655537,1655852,315,0,0,1,2
1655545,1655851,306,0,0,1,1
1655852,1655873,21,1,0,0,1
1655853,1655863,10,1,0,0,2
1655864,1656567,703,0,0,1,2
1655874,1656566,692,0,0,1,1
1656567,1656660,93,1,0,0,1
1656568,1656668,100,1,0,0,2
1656661,1657034,373,0,0,1,1
1656669,1657035,366,0,0,1,2
1657035,1657100,65,1,0,0,1
1657036,1657096,60,1,0,0,2
1657097,1657211,114,0,0,1,2
1657101,1657210,109,0,0,1,1
1657211,1657249,38,1,0,0,1
1657212,1657249,37,1,0,0,2
1657250,1657935,685,0,0,1,1
1657250,1657936,686,0,0,1,2
1657936,1658009,73,1,0,0,1
1657937,1658018,81,1,0,0,2
1658010,1658416,406,0,0,1,1
1658019,1658417,398,0,0,1,2
1658417,1658608,191,1,0,0,1
1658418,1658574,156,1,0,0,2
1658520,1658527,7,0,1,0,1
1658575,1658693,118,0,0,1,2
1658609,1658692,83,0,0,1,1
1658693,1658721,28,1,0,0,1
1658694,1658713,19,1,0,0,2
1658714,1658964,250,0,0,1,2
1658722,1658958,236,0,0,1,1
1658959,1658986,27,1,0,0,1
1658965,1658985,20,1,0,0,2
1658986,1659737,751,0,0,1,2
1658987,1659736,749,0,0,1,1
1659737,1659807,70,1,0,0,1
1659738,1659808,70,1,0,0,2
1659808,1660197,389,0,0,1,1
1659809,1660196,387,0,0,1,2
1660197,1660257,60,1,0,0,2
1660198,1660256,58,1,0,0,1
1660257,1660358,101,0,0,1,1
1660258,1660359,101,0,0,1,2
1660359,1660393,34,1,0,0,1
1660360,1660394,34,1,0,0,2
1660394,1661336,942,0,0,1,1
1660395,1661337,942,0,0,1,2
1661337,1661417,80,1,0,0,1
1661338,1661425,87,1,0,0,2
1661418,1661582,164,0,0,1,1
1661426,1661581,155,0,0,1,2
1661582,1661664,82,1,0,0,2
1661583,1661670,87,1,0,0,1
1661665,1661747,82,0,0,1,2
1661671,1661748,77,0,0,1,1
1661748,1661781,33,1,0,0,2
1661749,1661784,35,1,0,0,1
1661782,1662500,718,0,0,1,2
1661785,1662494,709,0,0,1,1
1662495,1662523,28,1,0,0,1
1662501,1662522,21,1,0,0,2
1662523,1663097,574,0,0,1,2
1662524,1663096,572,0,0,1,1
1663097,1663386,289,1,0,0,1
1663098,1663235,137,1,0,0,2
1663236,1664131,895,0,0,1,2
1663387,1664128,741,0,0,1,1
1664129,1664144,15,1,0,0,1
1664132,1664143,11,1,0,0,2
1664144,1664374,230,0,0,1,2
1664145,1664375,230,0,0,1,1
1664375,1664455,80,1,0,0,2
1664376,1664458,82,1,0,0,1
1664456,1664745,289,0,0,1,2
1664459,1664747,288,0,0,1,1
1664746,1664833,87,1,0,0,2
1664748,1664833,85,1,0,0,1
1664834,1664862,28,0,0,1,2
1664834,1664863,29,0,0,1,1
1664863,1664956,93,1,0,0,2
1664864,1665164,300,1,0,0,1
1664945,1664982,37,0,1,0,1
1664957,1665070,113,0,0,1,2
1665013,1665048,35,0,1,0,1
1665071,1665113,42,1,0,0,2
1665079,1665140,61,0,1,0,1
1665114,1665136,22,0,0,1,2
1665137,1665478,341,1,0,0,2
1665165,1665207,42,0,0,1,1
1665218,1665338,120,0,1,0,1
1665348,1665823,475,1,0,0,1
1665383,1665407,24,0,1,0,1
1665431,1665753,322,0,1,0,1
1665479,1665726,247,0,0,1,2
1665727,1665826,99,1,0,0,2
1665824,1666211,387,0,0,1,1
1665827,1666210,383,0,0,1,2
1666211,1666274,63,1,0,0,2
1666212,1666266,54,1,0,0,1
1666267,1666315,48,0,0,1,1
1666275,1666315,40,0,0,1,2
1666316,1666439,123,1,0,0,2
1666316,1666440,124,1,0,0,1
1666440,1666522,82,0,0,1,2
1666441,1666521,80,0,0,1,1
1666522,1666563,41,1,0,0,1
1666523,1666551,28,1,0,0,2
1666552,1666852,300,0,0,1,2
1666564,1666851,287,0,0,1,1
1666852,1666870,18,1,0,0,1
1666853,1666862,9,1,0,0,2
1666863,1667475,612,0,0,1,2
1666871,1667471,600,0,0,1,1
1667472,1667622,150,1,0,0,1
1667476,1667629,153,1,0,0,2
1667623,1667910,287,0,0,1,1
1667630,1667911,281,0,0,1,2
1667911,1668003,92,1,0,0,1
1667912,1667999,87,1,0,0,2
1668000,1668163,163,0,0,1,2
1668004,1668035,31,0,0,1,1
1668036,1668046,10,1,0,0,1
1668047,1668068,21,0,0,1,1
1668069,1668080,11,1,0,0,1
1668081,1668107,26,0,0,1,1
1668118,1668287,169,0,1,0,1
1668164,1668255,91,1,0,0,2
1668256,1668322,66,0,0,1,2
1668297,1668575,278,1,0,0,1
1668323,1668734,411,1,0,0,2
1668576,1668643,67,0,0,1,1
1668644,1668733,89,1,0,0,1
1668673,1668684,11,0,1,0,1
1668734,1669337,603,0,0,1,1
1668735,1669339,604,0,0,1,2
1669338,1669397,59,1,0,0,1
1669340,1669395,55,1,0,0,2
1669396,1669509,113,0,0,1,2
1669398,1669508,110,0,0,1,1
1669509,1669539,30,1,0,0,1
1669510,1669530,20,1,0,0,2
1669531,1670324,793,0,0,1,2
1669540,1670324,784,0,0,1,1
1670325,1670400,75,1,0,0,2
1670325,1670403,78,1,0,0,1
1670401,1670674,273,0,0,1,2
1670404,1670673,269,0,0,1,1
1670674,1670748,74,1,0,0,1
1670675,1670748,73,1,0,0,2
1670749,1670814,65,0,0,1,1
1670749,1670815,66,0,0,1,2
1670815,1670849,34,1,0,0,1
1670816,1670852,36,1,0,0,2
1670850,1671092,242,0,0,1,1
1670853,1671098,245,0,0,1,2
1671093,1671112,19,1,0,0,1
1671099,1671108,9,1,0,0,2
1671109,1671955,846,0,0,1,2
1671113,1671956,843,0,0,1,1
1671956,1672012,56,1,0,0,2
1671957,1672022,65,1,0,0,1
1672013,1672378,365,0,0,1,2
1672023,1672379,356,0,0,1,1
1672379,1672548,169,1,0,0,2
1672380,1672512,132,1,0,0,1
1672513,1672595,82,0,0,1,1
1672549,1672598,49,0,0,1,2
1672596,1672639,43,1,0,0,1
1672599,1672635,36,1,0,0,2
1672636,1673649,1013,0,0,1,2
1672640,1673648,1008,0,0,1,1
1673649,1673761,112,1,0,0,1
1673650,1673756,106,1,0,0,2
1673757,1674152,395,0,0,1,2
1673762,1674152,390,0,0,1,1
1674153,1674231,78,1,0,0,2
1674153,1674239,86,1,0,0,1
1674232,1674327,95,0,0,1,2
1674240,1674324,84,0,0,1,1
1674325,1674361,36,1,0,0,1
1674328,1674358,30,1,0,0,2
1674359,1675342,983,0,0,1,2
1674362,1674594,232,0,0,1,1
1674595,1674917,322,1,0,0,1
1674918,1675101,183,0,0,1,1
1675102,1675141,39,1,0,0,1
1675142,1675270,128,0,0,1,1
1675271,1675284,13,1,0,0,1
1675285,1675343,58,0,0,1,1
1675343,1675418,75,1,0,0,2
1675344,1675417,73,1,0,0,1
1675418,1675821,403,0,0,1,1
1675419,1675820,401,0,0,1,2
1675821,1675858,37,1,0,0,2
1675822,1675870,48,1,0,0,1
1675859,1676269,410,0,0,1,2
1675871,1676268,397,0,0,1,1
1676269,1676298,29,1,0,0,1
1676270,1676297,27,1,0,0,2
1676298,1676960,662,0,0,1,2
1676299,1676958,659,0,0,1,1
1676959,1677016,57,1,0,0,1
1676961,1677017,56,1,0,0,2
1677017,1677400,383,0,0,1,1
1677018,1677401,383,0,0,1,2
1677401,1677489,88,1,0,0,1
1677402,1677474,72,1,0,0,2
1677475,1677643,168,0,0,1,2
1677490,1677645,155,0,0,1,1
1677644,1677673,29,1,0,0,2
1677646,1677664,18,1,0,0,1
1677665,1678888,1223,0,0,1,1
1677674,1678887,1213,0,0,1,2
1678888,1678984,96,1,0,0,2
1678889,1678998,109,1,0,0,1
1678985,1679263,278,0,0,1,2
1678999,1679264,265,0,0,1,1
1679264,1679338,74,1,0,0,2
1679265,1679340,75,1,0,0,1
1679339,1679423,84,0,0,1,2
1679341,1679425,84,0,0,1,1
1679424,1679463,39,1,0,0,2
1679426,1679457,31,1,0,0,1
1679458,1680446,988,0,0,1,1
1679464,1680445,981,0,0,1,2
1680446,1680572,126,1,0,0,2
1680447,1680575,128,1,0,0,1
1680573,1681019,446,0,0,1,2
1680576,1681018,442,0,0,1,1
1681019,1682649,1630,1,0,0,1
1681020,1681129,109,1,0,0,2
1681115,1682628,1513,0,1,0,1
1681130,1681150,20,0,0,1,2
1681151,1681170,19,1,0,0,2
1681171,1681272,101,0,0,1,2
1681273,1681305,32,1,0,0,2
1681306,1682535,1229,0,0,1,2
1682536,1682621,85,1,0,0,2
1682622,1682991,369,0,0,1,2
1682650,1682991,341,0,0,1,1
1682992,1683046,54,1,0,0,1
1682992,1683055,63,1,0,0,2
1683047,1683185,138,0,0,1,1
1683056,1683183,127,0,0,1,2
1683184,1683200,16,1,0,0,2
1683186,1683201,15,1,0,0,1
1683201,1684218,1017,0,0,1,2
1683202,1684216,1014,0,0,1,1
1684217,1684290,73,1,0,0,1
1684219,1684291,72,1,0,0,2
1684291,1684725,434,0,0,1,1
1684292,1684724,432,0,0,1,2
1684725,1684806,81,1,0,0,2
1684726,1684814,88,1,0,0,1
1684807,1684901,94,0,0,1,2
1684815,1684902,87,0,0,1,1
1684902,1684937,35,1,0,0,2
1684903,1684935,32,1,0,0,1
1684936,1685867,931,0,0,1,1
1684938,1685868,930,0,0,1,2
1685868,1685955,87,1,0,0,1
1685869,1685955,86,1,0,0,2
1685956,1686345,389,0,0,1,1
1685956,1686345,389,0,0,1,2
1686346,1686409,63,1,0,0,2
1686346,1686412,66,1,0,0,1
1686410,1686500,90,0,0,1,2
1686413,1686500,87,0,0,1,1
1686501,1686526,25,1,0,0,2
1686501,1686531,30,1,0,0,1
1686527,1687548,1021,0,0,1,2
1686532,1687190,658,0,0,1,1
1687191,1687208,17,1,0,0,1
1687209,1687549,340,0,0,1,1
1687549,1687611,62,1,0,0,2
1687550,1687619,69,1,0,0,1
1687612,1687952,340,0,0,1,2
1687620,1687953,333,0,0,1,1
1687953,1688011,58,1,0,0,2
1687954,1688022,68,1,0,0,1
1688012,1688099,87,0,0,1,2
1688023,1688099,76,0,0,1,1
1688100,1688133,33,1,0,0,2
1688100,1688137,37,1,0,0,1
1688134,1689118,984,0,0,1,2
1688138,1689116,978,0,0,1,1
1689117,1689204,87,1,0,0,1
1689119,1689179,60,1,0,0,2
1689180,1689546,366,0,0,1,2
1689205,1689544,339,0,0,1,1
1689545,1689626,81,1,0,0,1
1689547,1689620,73,1,0,0,2
1689621,1689688,67,0,0,1,2
1689627,1689688,61,0,0,1,1
1689689,1689737,48,1,0,0,2
1689689,1689753,64,1,0,0,1
1689738,1689911,173,0,0,1,2
1689754,1689908,154,0,0,1,1
1689909,1689936,27,1,0,0,1
1689912,1689928,16,1,0,0,2
1689929,1690817,888,0,0,1,2
1689937,1690815,878,0,0,1,1
1690816,1690892,76,1,0,0,1
1690818,1690890,72,1,0,0,2
1690891,1691391,500,0,0,1,2
1690893,1691390,497,0,0,1,1
1691391,1691465,74,1,0,0,1
1691392,1691455,63,1,0,0,2
1691456,1691566,110,0,0,1,2
1691466,1691566,100,0,0,1,1
1691567,1691600,33,1,0,0,2
1691567,1691601,34,1,0,0,1
1691601,1691858,257,0,0,1,2
1691602,1691860,258,0,0,1,1
1691859,1691883,24,1,0,0,2
1691861,1691878,17,1,0,0,1
1691879,1692904,1025,0,0,1,1
1691884,1694101,2217,0,0,1,2
1692905,1692918,13,1,0,0,1
1692919,1693611,692,0,0,1,1
1693612,1693624,12,1,0,0,1
1693625,1694102,477,0,0,1,1
1694102,1694168,66,1,0,0,2
1694103,1694168,65,1,0,0,1
1694169,1696600,2431,0,0,1,1
1694169,1696603,2434,0,0,1,2
1696601,1696637,36,1,0,0,1
1696604,1696673,69,1,0,0,2
1696638,1696660,22,0,0,1,1
1696661,1696672,11,1,0,0,1
1696673,1697361,688,0,0,1,1
1696674,1697360,686,0,0,1,2
1697361,1697406,45,1,0,0,2
1697362,1697404,42,1,0,0,1
1697405,1697745,340,0,0,1,1
1697407,1697747,340,0,0,1,2
1697746,1697779,33,1,0,0,1
1697748,1697777,29,1,0,0,2
1697778,1697972,194,0,0,1,2
1697780,1697971,191,0,0,1,1
1697972,1698040,68,1,0,0,1
1697973,1698041,68,1,0,0,2
1698041,1698148,107,0,0,1,1
1698042,1698146,104,0,0,1,2
1698147,1698178,31,1,0,0,2
1698149,1698167,18,1,0,0,1
1698168,1698388,220,0,0,1,1
1698179,1698386,207,0,0,1,2
1698387,1698415,28,1,0,0,2
1698389,1698408,19,1,0,0,1
1698409,1698551,142,0,0,1,1
1698416,1698556,140,0,0,1,2
1698552,1698578,26,1,0,0,1
1698557,1698568,11,1,0,0,2
1698569,1699370,801,0,0,1,2
1698579,1699370,791,0,0,1,1
1699371,1699433,62,1,0,0,2
1699371,1699444,73,1,0,0,1
1699434,1699792,358,0,0,1,2
1699445,1699792,347,0,0,1,1
1699793,1699818,25,1,0,0,2
1699793,1699827,34,1,0,0,1
1699819,1700480,661,0,0,1,2
1699828,1700479,651,0,0,1,1
1700480,1700509,29,1,0,0,1
1700481,1700500,19,1,0,0,2
1700501,1702536,2035,0,0,1,2
1700510,1702534,2024,0,0,1,1
1702535,1702777,242,1,0,0,1
1702537,1702752,215,1,0,0,2
1702578,1702721,143,0,1,0,1
1702642,1702642,0,0,1,0,2
1702753,1702942,189,0,0,1,2
1702778,1702943,165,0,0,1,1
1702943,1703020,77,1,0,0,2
1702944,1703015,71,1,0,0,1
1703016,1703122,106,0,0,1,1
1703021,1703122,101,0,0,1,2
1703123,1703152,29,1,0,0,2
1703123,1703160,37,1,0,0,1
1703153,1703359,206,0,0,1,2
1703161,1703246,85,0,0,1,1
1703247,1703468,221,1,0,0,1
1703360,1703382,22,1,0,0,2
1703383,1704289,906,0,0,1,2
1703469,1703704,235,0,0,1,1
1703705,1703712,7,1,0,0,1
1703713,1703894,181,0,0,1,1
1703895,1704546,651,1,0,0,1
1704067,1704067,0,0,1,0,1
1704229,1704236,7,0,1,0,1
1704261,1704266,5,0,1,0,1
1704289,1704318,29,0,1,0,1
1704290,1704312,22,1,0,0,2
1704313,1704452,139,0,0,1,2
1704342,1704346,4,0,1,0,1
1704453,1704522,69,1,0,0,2
1704523,1705124,601,0,0,1,2
1704547,1705123,576,0,0,1,1
1705124,1705148,24,1,0,0,1
1705125,1705154,29,1,0,0,2
1705149,1707182,2033,0,0,1,1
1705155,1707183,2028,0,0,1,2
1707183,1707239,56,1,0,0,1
1707184,1707233,49,1,0,0,2
1707234,1707944,710,0,0,1,2
1707240,1707943,703,0,0,1,1
1707944,1708032,88,1,0,0,1
1707945,1708031,86,1,0,0,2
1708032,1708143,111,0,0,1,2
1708033,1708145,112,0,0,1,1
1708144,1708175,31,1,0,0,2
1708146,1708173,27,1,0,0,1
1708174,1708944,770,0,0,1,1
1708176,1708567,391,0,0,1,2
1708568,1708899,331,1,0,0,2
1708900,1708940,40,0,0,1,2
1708941,1709075,134,1,0,0,2
1708945,1708957,12,1,0,0,1
1708958,1709849,891,0,0,1,1
1709076,1709380,304,0,0,1,2
1709381,1709385,4,1,0,0,2
1709386,1709777,391,0,0,1,2
1709778,1709978,200,1,0,0,2
1709850,1709928,78,1,0,0,1
1709929,1710430,501,0,0,1,1
1709979,1710436,457,0,0,1,2
1710431,1710464,33,1,0,0,1
1710437,1710449,12,1,0,0,2
1710450,1710911,461,0,0,1,2
1710465,1710900,435,0,0,1,1
1710901,1710932,31,1,0,0,1
1710912,1710929,17,1,0,0,2
1710930,1711227,297,0,0,1,2
1710933,1711228,295,0,0,1,1
1711228,1711263,35,1,0,0,2
1711229,1711265,36,1,0,0,1
1711264,1712084,820,0,0,1,2
1711266,1712084,818,0,0,1,1
1712085,1712218,133,1,0,0,2
1712085,1712227,142,1,0,0,1
1712219,1713137,918,0,0,1,2
1712228,1713139,911,0,0,1,1
1713138,1713174,36,1,0,0,2
1713140,1713174,34,1,0,0,1
1713175,1713948,773,0,0,1,2
1713175,1713949,774,0,0,1,1
1713949,1714020,71,1,0,0,2
1713950,1714018,68,1,0,0,1
1714019,1714188,169,0,0,1,1
1714021,1714189,168,0,0,1,2
1714189,1714212,23,1,0,0,1
1714190,1714214,24,1,0,0,2
1714213,1715551,1338,0,0,1,1
1714215,1715551,1336,0,0,1,2
1715552,1715601,49,1,0,0,2
1715552,1715621,69,1,0,0,1
1715602,1716178,576,0,0,1,2
1715622,1716177,555,0,0,1,1
1716178,1716216,38,1,0,0,1
1716179,1716208,29,1,0,0,2
1716209,1717804,1595,0,0,1,2
1716217,1717803,1586,0,0,1,1
1717804,1717914,110,1,0,0,1
1717805,1717915,110,1,0,0,2
1717915,1718926,1011,0,0,1,1
1717916,1718925,1009,0,0,1,2
1718926,1718962,36,1,0,0,2
1718927,1718970,43,1,0,0,1
1718963,1719334,371,0,0,1,2
1718971,1719335,364,0,0,1,1
1719335,1719407,72,1,0,0,2
1719336,1719409,73,1,0,0,1
1719408,1719520,112,0,0,1,2
1719410,1719519,109,0,0,1,1
1719520,1719545,25,1,0,0,1
1719521,1719542,21,1,0,0,2
1719543,1720756,1213,0,0,1,2
1719546,1720757,1211,0,0,1,1
1720757,1720810,53,1,0,0,2
1720758,1720811,53,1,0,0,1
1720811,1720932,121,0,0,1,2
1720812,1720933,121,0,0,1,1
1720933,1720957,24,1,0,0,2
1720934,1720968,34,1,0,0,1
1720958,1722867,1909,0,0,1,2
1720969,1722866,1897,0,0,1,1
1722867,1722999,132,1,0,0,1
1722868,1722929,61,1,0,0,2
1722930,1723600,670,0,0,1,2
1723000,1723600,600,0,0,1,1
1723601,1723629,28,1,0,0,1
1723601,1723651,50,1,0,0,2
1723630,1724263,633,0,0,1,1
1723652,1724260,608,0,0,1,2
1724261,1724324,63,1,0,0,2
1724264,1724325,61,1,0,0,1
1724325,1724437,112,0,0,1,2
1724326,1724438,112,0,0,1,1
1724438,1724470,32,1,0,0,2
1724439,1724468,29,1,0,0,1
1724469,1724743,274,0,0,1,1
1724471,1725424,953,0,0,1,2
1724744,1724757,13,1,0,0,1
1724758,1725272,514,0,0,1,1
1725273,1725278,5,1,0,0,1
1725279,1725423,144,0,0,1,1
1725424,1725474,50,1,0,0,1
1725425,1725473,48,1,0,0,2
1725474,1725974,500,0,0,1,2
1725475,1725974,499,0,0,1,1
1725975,1726003,28,1,0,0,2
1725975,1726004,29,1,0,0,1
1726004,1727005,1001,0,0,1,2
1726005,1727005,1000,0,0,1,1
1727006,1727036,30,1,0,0,2
1727006,1727039,33,1,0,0,1
1727037,1727891,854,0,0,1,2
1727040,1727890,850,0,0,1,1
1727891,1727956,65,1,0,0,1
1727892,1727956,64,1,0,0,2
1727957,1728404,447,0,0,1,1
1727957,1728405,448,0,0,1,2
1728405,1728460,55,1,0,0,1
1728406,1728450,44,1,0,0,2
1728451,1728681,230,0,0,1,2
1728461,1728681,220,0,0,1,1
1728682,1728751,69,1,0,0,2
1728682,1728753,71,1,0,0,1
1728752,1728849,97,0,0,1,2
1728754,1728848,94,0,0,1,1
1728849,1728889,40,1,0,0,1
1728850,1728884,34,1,0,0,2
1728885,1730150,1265,0,0,1,2
1728890,1730150,1260,0,0,1,1
1730151,1730219,68,1,0,0,2
1730151,1730221,70,1,0,0,1
1730220,1730311,91,0,0,1,2
1730222,1730312,90,0,0,1,1
1730312,1730339,27,1,0,0,2
1730313,1730346,33,1,0,0,1
1730340,1731613,1273,0,0,1,2
1730347,1731609,1262,0,0,1,1
1731610,1731640,30,1,0,0,1
1731614,1731648,34,1,0,0,2
1731641,1732224,583,0,0,1,1
1731649,1732226,577,0,0,1,2
1732225,1732340,115,1,0,0,1
1732227,1732336,109,1,0,0,2
1732337,1733237,900,0,0,1,2
1732341,1733238,897,0,0,1,1
1733238,1733287,49,1,0,0,2
1733239,1733286,47,1,0,0,1
1733287,1733653,366,0,0,1,1
1733288,1733654,366,0,0,1,2
1733654,1733689,35,1,0,0,1
1733655,1733690,35,1,0,0,2
1733690,1733872,182,0,0,1,1
1733691,1733871,180,0,0,1,2
1733872,1733897,25,1,0,0,2
1733873,1733905,32,1,0,0,1
1733898,1734120,222,0,0,1,2
1733906,1734124,218,0,0,1,1
1734121,1734136,15,1,0,0,2
1734125,1734130,5,1,0,0,1
1734131,1735212,1081,0,0,1,1
1734137,1735214,1077,0,0,1,2
1735213,1735232,19,1,0,0,1
1735215,1735232,17,1,0,0,2
1735233,1735701,468,0,0,1,2
1735233,1735702,469,0,0,1,1
1735702,1735760,58,1,0,0,2
1735703,1735761,58,1,0,0,1
1735761,1736037,276,0,0,1,2
1735762,1736037,275,0,0,1,1
1736038,1736065,27,1,0,0,2
1736038,1736070,32,1,0,0,1
1736066,1736612,546,0,0,1,2
1736071,1736610,539,0,0,1,1
1736611,1736643,32,1,0,0,1
1736613,1736634,21,1,0,0,2
1736635,1737276,641,0,0,1,2
1736644,1737278,634,0,0,1,1
1737277,1737317,40,1,0,0,2
1737279,1737310,31,1,0,0,1
1737311,1737807,496,0,0,1,1
1737318,1737814,496,0,0,1,2
1737808,1738017,209,1,0,0,1
1737815,1737858,43,1,0,0,2
1737859,1738123,264,0,0,1,2
1738018,1738120,102,0,0,1,1
1738121,1738186,65,1,0,0,1
1738124,1738177,53,1,0,0,2
1738178,1738689,511,0,0,1,2
1738187,1738688,501,0,0,1,1
1738689,1738720,31,1,0,0,1
1738690,1738719,29,1,0,0,2
1738720,1739440,720,0,0,1,2
1738721,1739441,720,0,0,1,1
1739441,1739505,64,1,0,0,2
1739442,1739502,60,1,0,0,1
1739503,1739603,100,0,0,1,1
1739506,1739604,98,0,0,1,2
1739604,1739665,61,1,0,0,1
1739605,1739665,60,1,0,0,2
1739666,1739773,107,0,0,1,1
1739666,1739773,107,0,0,1,2
1739774,1739802,28,1,0,0,2
1739774,1739803,29,1,0,0,1
1739803,1740080,277,0,0,1,2
1739804,1740081,277,0,0,1,1
1740081,1740109,28,1,0,0,2
1740082,1740102,20,1,0,0,1
1740103,1740519,416,0,0,1,1
1740110,1740520,410,0,0,1,2
1740520,1740544,24,1,0,0,1
1740521,1740539,18,1,0,0,2
1740540,1741288,748,0,0,1,2
1740545,1741289,744,0,0,1,1
1741289,1741339,50,1,0,0,2
1741290,1741340,50,1,0,0,1
1741340,1741635,295,0,0,1,2
1741341,1741634,293,0,0,1,1
1741635,1741668,33,1,0,0,1
1741636,1741657,21,1,0,0,2
1741658,1742638,980,0,0,1,2
1741669,1742631,962,0,0,1,1
1742632,1742660,28,1,0,0,1
1742639,1742650,11,1,0,0,2
1742651,1743447,796,0,0,1,2
1742661,1743449,788,0,0,1,1
1743448,1743507,59,1,0,0,2
1743450,1743516,66,1,0,0,1
1743508,1744095,587,0,0,1,2
1743517,1744094,577,0,0,1,1
1744095,1744143,48,1,0,0,1
1744096,1744143,47,1,0,0,2
1744144,1744438,294,0,0,1,1
1744144,1744438,294,0,0,1,2
1744439,1744478,39,1,0,0,1
1744439,1744487,48,1,0,0,2
1744479,1745256,777,0,0,1,1
1744488,1745255,767,0,0,1,2
1745256,1745449,193,1,0,0,2
1745257,1745404,147,1,0,0,1
1745405,1745540,135,0,0,1,1
1745450,1745538,88,0,0,1,2
1745539,1745559,20,1,0,0,2
1745541,1745567,26,1,0,0,1
1745560,1746951,1391,0,0,1,2
1745568,1746951,1383,0,0,1,1
1746952,1746983,31,1,0,0,2
1746952,1746984,32,1,0,0,1
1746984,1747095,111,0,0,1,2
1746985,1747094,109,0,0,1,1
1747095,1747164,69,1,0,0,1
1747096,1747166,70,1,0,0,2
1747165,1747366,201,0,0,1,1
1747167,1747366,199,0,0,1,2
1747367,1747396,29,1,0,0,1
1747367,1747399,32,1,0,0,2
1747397,1747866,469,0,0,1,1
1747400,1747866,466,0,0,1,2
1747867,1747890,23,1,0,0,2
1747867,1747898,31,1,0,0,1
1747891,1749217,1326,0,0,1,2
1747899,1749216,1317,0,0,1,1
1749217,1749358,141,1,0,0,1
1749218,1749317,99,1,0,0,2
1749318,1749631,313,0,0,1,2
1749359,1749630,271,0,0,1,1
1749631,1749683,52,1,0,0,1
1749632,1749683,51,1,0,0,2
1749684,1750844,1160,0,0,1,1
1749684,1750844,1160,0,0,1,2
1750845,1750881,36,1,0,0,2
1750845,1750889,44,1,0,0,1
1750882,1751141,259,0,0,1,2
1750890,1751143,253,0,0,1,1
1751142,1751213,71,1,0,0,2
1751144,1751220,76,1,0,0,1
1751214,1751302,88,0,0,1,2
1751221,1751299,78,0,0,1,1
1751300,1751336,36,1,0,0,1
1751303,1751336,33,1,0,0,2
1751337,1752110,773,0,0,1,1
1751337,1752112,775,0,0,1,2
1752111,1752145,34,1,0,0,1
1752113,1752142,29,1,0,0,2
1752143,1752276,133,0,0,1,2
1752146,1752278,132,0,0,1,1
1752277,1752307,30,1,0,0,2
1752279,1752298,19,1,0,0,1
1752299,1752819,520,0,0,1,1
1752308,1752821,513,0,0,1,2
1752820,1752870,50,1,0,0,1
1752822,1752871,49,1,0,0,2
1752871,1753206,335,0,0,1,1
1752872,1753207,335,0,0,1,2
1753207,1753248,41,1,0,0,1
1753208,1753236,28,1,0,0,2
1753237,1753886,649,0,0,1,2
1753249,1753884,635,0,0,1,1
1753885,1753917,32,1,0,0,1
1753887,1753913,26,1,0,0,2
1753914,1754870,956,0,0,1,2
1753918,1754870,952,0,0,1,1
1754871,1754978,107,1,0,0,1
1754871,1754980,109,1,0,0,2
1754979,1755220,241,0,0,1,1
1754981,1755220,239,0,0,1,2
1755221,1755270,49,1,0,0,1
1755221,1755274,53,1,0,0,2
1755271,1756125,854,0,0,1,1
1755275,1756126,851,0,0,1,2
1756126,1756155,29,1,0,0,1
1756127,1756149,22,1,0,0,2
1756150,1756696,546,0,0,1,2
1756156,1756696,540,0,0,1,1
1756697,1756732,35,1,0,0,1
1756697,1756732,35,1,0,0,2
1756733,1756849,116,0,0,1,1
1756733,1756850,117,0,0,1,2
1756850,1756967,117,1,0,0,1
1756851,1756932,81,1,0,0,2
1756933,1757044,111,0,0,1,2
1756968,1757045,77,0,0,1,1
1757045,1757079,34,1,0,0,2
1757046,1757078,32,1,0,0,1
1757079,1757273,194,0,0,1,1
1757080,1757986,906,0,0,1,2
1757274,1757391,117,1,0,0,1
1757392,1757417,25,0,0,1,1
1757418,1757447,29,1,0,0,1
1757448,1757580,132,0,0,1,1
1757581,1757666,85,1,0,0,1
1757667,1757688,21,0,0,1,1
1757689,1757736,47,1,0,0,1
1757737,1757833,96,0,0,1,1
1757834,1757849,15,1,0,0,1
1757850,1757899,49,0,0,1,1
1757900,1758048,148,1,0,0,1
1757987,1758040,53,1,0,0,2
1758041,1758280,239,0,0,1,2
1758049,1758078,29,0,0,1,1
1758079,1758099,20,1,0,0,1
1758100,1758280,180,0,0,1,1
1758281,1758307,26,1,0,0,1
1758281,1758308,27,1,0,0,2
1758308,1759074,766,0,0,1,1
1758309,1759075,766,0,0,1,2
1759075,1759119,44,1,0,0,1
1759076,1759094,18,1,0,0,2
1759095,1760227,1132,0,0,1,2
1759120,1759968,848,0,0,1,1
1759969,1760069,100,1,0,0,1
1760070,1760199,129,0,0,1,1
1760200,1760456,256,1,0,0,1
1760228,1760374,146,1,0,0,2
1760275,1760346,71,0,1,0,1
1760375,1760557,182,0,0,1,2
1760457,1760555,98,0,0,1,1
1760556,1760615,59,1,0,0,1
1760558,1760615,57,1,0,0,2
1760616,1760785,169,0,0,1,1
1760616,1760796,180,0,0,1,2
1760786,1760996,210,1,0,0,1
1760797,1760971,174,1,0,0,2
1760817,1760941,124,0,1,0,1
1760825,1760914,89,0,1,0,2
1760972,1761523,551,0,0,1,2
1760997,1761522,525,0,0,1,1
1761523,1761630,107,1,0,0,1
1761524,1761614,90,1,0,0,2
1761615,1761692,77,0,0,1,2
1761631,1761694,63,0,0,1,1
1761693,1761731,38,1,0,0,2
1761695,1761757,62,1,0,0,1
1761732,1762643,911,0,0,1,2
1761758,1761855,97,0,0,1,1
1761856,1761860,4,1,0,0,1
1761861,1761922,61,0,0,1,1
1761923,1761952,29,1,0,0,1
1761953,1762260,307,0,0,1,1
1762261,1762325,64,1,0,0,1
1762326,1762402,76,0,0,1,1
1762403,1762520,117,1,0,0,1
1762521,1762642,121,0,0,1,1
1762643,1762770,127,1,0,0,1
1762644,1762695,51,1,0,0,2
1762696,1764711,2015,0,0,1,2
1762771,1762812,41,0,0,1,1
1762813,1762876,63,1,0,0,1
1762877,1763160,283,0,0,1,1
1763161,1763188,27,1,0,0,1
1763189,1763220,31,0,0,1,1
1763221,1763306,85,1,0,0,1
1763307,1764220,913,0,0,1,1
1764221,1764251,30,1,0,0,1
1764252,1764713,461,0,0,1,1
1764712,1764771,59,1,0,0,2
1764714,1764783,69,1,0,0,1
1764772,1765240,468,0,0,1,2
1764784,1765242,458,0,0,1,1
1765241,1765274,33,1,0,0,2
1765243,1765286,43,1,0,0,1
1765275,1766009,734,0,0,1,2
1765287,1766006,719,0,0,1,1
1766007,1766074,67,1,0,0,1
1766010,1766072,62,1,0,0,2
1766073,1766168,95,0,0,1,2
1766075,1766167,92,0,0,1,1
1766168,1766204,36,1,0,0,1
1766169,1766203,34,1,0,0,2
1766204,1766464,260,0,0,1,2
1766205,1766457,252,0,0,1,1
1766458,1766486,28,1,0,0,1
1766465,1766479,14,1,0,0,2
1766480,1767500,1020,0,0,1,2
1766487,1767501,1014,0,0,1,1
1767501,1767613,112,1,0,0,2
1767502,1767657,155,1,0,0,1
1767614,1767741,127,0,0,1,2
1767658,1767738,80,0,0,1,1
1767739,1767763,24,1,0,0,1
1767742,1767759,17,1,0,0,2
1767760,1768364,604,0,0,1,2
1767764,1769401,1637,0,0,1,1
1768365,1768382,17,1,0,0,2
1768383,1769402,1019,0,0,1,2
1769402,1769472,70,1,0,0,1
1769403,1769472,69,1,0,0,2
1769473,1770144,671,0,0,1,2
1769473,1770145,672,0,0,1,1
1770145,1770183,38,1,0,0,2
1770146,1770178,32,1,0,0,1
1770179,1771196,1017,0,0,1,1
1770184,1771198,1014,0,0,1,2
1771197,1771264,67,1,0,0,1
1771199,1771265,66,1,0,0,2
1771265,1771403,138,0,0,1,1
1771266,1771405,139,0,0,1,2
1771404,1771429,25,1,0,0,1
1771406,1771436,30,1,0,0,2
1771430,1772490,1060,0,0,1,1
1771437,1772489,1052,0,0,1,2
1772490,1772557,67,1,0,0,2
1772491,1772559,68,1,0,0,1
1772558,1772756,198,0,0,1,2
1772560,1772754,194,0,0,1,1
1772755,1772802,47,1,0,0,1
1772757,1772804,47,1,0,0,2
1772803,1773238,435,0,0,1,1
1772805,1773239,434,0,0,1,2
1773239,1773284,45,1,0,0,1
1773240,1773272,32,1,0,0,2
1773273,1773956,683,0,0,1,2
1773285,1773955,670,0,0,1,1
1773956,1774002,46,1,0,0,1
1773957,1773990,33,1,0,0,2
1773991,1774439,448,0,0,1,2
1774003,1774437,434,0,0,1,1
1774438,1774470,32,1,0,0,1
1774440,1774469,29,1,0,0,2
1774470,1774627,157,0,0,1,2
1774471,1774623,152,0,0,1,1
1774624,1774739,115,1,0,0,1
1774628,1774749,121,1,0,0,2
1774740,1774910,170,0,0,1,1
1774750,1774910,160,0,0,1,2
1774911,1774965,54,1,0,0,1
1774911,1774965,54,1,0,0,2
1774966,1776107,1141,0,0,1,1
1774966,1776107,1141,0,0,1,2
1776108,1776187,79,1,0,0,1
1776108,1776198,90,1,0,0,2
1776188,1776279,91,0,0,1,1
1776199,1776278,79,0,0,1,2
1776279,1776314,35,1,0,0,2
1776280,1776314,34,1,0,0,1
1776315,1776544,229,0,0,1,1
1776315,1777379,1064,0,0,1,2
1776545,1776587,42,1,0,0,1
1776588,1777528,940,0,0,1,1
1777380,1777439,59,1,0,0,2
1777440,1777530,90,0,0,1,2
1777529,1777594,65,1,0,0,1
1777531,1777598,67,1,0,0,2
1777595,1777871,276,0,0,1,1
1777599,1777873,274,0,0,1,2
1777872,1777904,32,1,0,0,1
1777874,1777897,23,1,0,0,2
1777898,1778176,278,0,0,1,2
1777905,1778176,271,0,0,1,1
1778177,1778208,31,1,0,0,1
1778177,1778225,48,1,0,0,2
1778209,1778850,641,0,0,1,1
1778226,1778851,625,0,0,1,2
1778851,1778890,39,1,0,0,1
1778852,1778881,29,1,0,0,2
1778882,1779431,549,0,0,1,2
1778891,1779429,538,0,0,1,1
1779430,1779464,34,1,0,0,1
1779432,1779454,22,1,0,0,2
1779455,1779726,271,0,0,1,2
1779465,1779725,260,0,0,1,1
1779726,1779789,63,1,0,0,1
1779727,1779781,54,1,0,0,2
1779782,1780292,510,0,0,1,2
1779790,1780293,503,0,0,1,1
1780293,1780334,41,1,0,0,2
1780294,1780333,39,1,0,0,1
1780334,1781221,887,0,0,1,1
1780335,1781220,885,0,0,1,2
1781221,1781406,185,1,0,0,2
1781222,1781372,150,1,0,0,1
1781373,1781468,95,0,0,1,1
1781407,1781467,60,0,0,1,2
1781468,1781488,20,1,0,0,2
1781469,1781497,28,1,0,0,1
1781489,1782854,1365,0,0,1,2
1781498,1782851,1353,0,0,1,1
1782852,1782941,89,1,0,0,1
1782855,1782937,82,1,0,0,2
1782938,1783172,234,0,0,1,2
1782942,1783188,246,0,0,1,1
1783173,1783441,268,1,0,0,2
1783189,1783435,246,1,0,0,1
1783244,1783400,156,0,1,0,1
1783247,1783383,136,0,1,0,2
1783436,1783819,383,0,0,1,1
1783442,1783819,377,0,0,1,2
1783820,1783849,29,1,0,0,2
1783820,1783854,34,1,0,0,1
1783850,1785003,1153,0,0,1,2
1783855,1785001,1146,0,0,1,1
1785002,1785068,66,1,0,0,1
1785004,1785067,63,1,0,0,2
1785068,1785419,351,0,0,1,2
1785069,1785421,352,0,0,1,1
1785420,1785471,51,1,0,0,2
1785422,1785470,48,1,0,0,1
1785471,1786629,1158,0,0,1,1
1785472,1786630,1158,0,0,1,2
1786630,1786702,72,1,0,0,1
1786631,1786703,72,1,0,0,2
1786703,1786916,213,0,0,1,1
1786704,1786917,213,0,0,1,2
1786917,1786944,27,1,0,0,1
1786918,1786946,28,1,0,0,2
1786945,1787231,286,0,0,1,1
1786947,1787237,290,0,0,1,2
1787232,1787258,26,1,0,0,1
1787238,1787255,17,1,0,0,2
1787256,1788438,1182,0,0,1,2
1787259,1788435,1176,0,0,1,1
1788436,1788604,168,1,0,0,1
1788439,1788545,106,1,0,0,2
1788546,1788675,129,0,0,1,2
1788605,1788675,70,0,0,1,1
1788676,1788703,27,1,0,0,1
1788676,1788704,28,1,0,0,2
1788704,1788846,142,0,0,1,1
1788705,1788863,158,0,0,1,2
1788847,1789078,231,1,0,0,1
1788864,1789047,183,1,0,0,2
1788877,1789028,151,0,1,0,1
1788887,1788999,112,0,1,0,2
1789048,1789328,280,0,0,1,2
1789079,1789327,248,0,0,1,1
1789328,1789361,33,1,0,0,1
1789329,1789369,40,1,0,0,2
1789362,1790469,1107,0,0,1,1
1789370,1790469,1099,0,0,1,2
1790470,1790531,61,1,0,0,2
1790470,1790532,62,1,0,0,1
1790532,1791434,902,0,0,1,2
1790533,1791433,900,0,0,1,1
1791434,1791461,27,1,0,0,1
1791435,1791455,20,1,0,0,2
1791456,1791905,449,0,0,1,2
1791462,1791905,443,0,0,1,1
1791906,1791964,58,1,0,0,1
1791906,1791967,61,1,0,0,2
1791965,1792188,223,0,0,1,1
1791968,1792183,215,0,0,1,2
1792184,1792213,29,1,0,0,2
1792189,1792203,14,1,0,0,1
1792204,1792692,488,0,0,1,1
1792214,1792686,472,0,0,1,2
1792687,1792697,10,1,0,0,2
1792693,1792706,13,1,0,0,1
1792698,1793343,645,0,0,1,2
1792707,1793344,637,0,0,1,1
1793344,1793415,71,1,0,0,2
1793345,1793417,72,1,0,0,1
1793416,1793526,110,0,0,1,2
1793418,1793526,108,0,0,1,1
1793527,1793549,22,1,0,0,2
1793527,1793559,32,1,0,0,1
1793550,1794179,629,0,0,1,2
1793560,1794178,618,0,0,1,1
1794179,1794202,23,1,0,0,1
1794180,1794199,19,1,0,0,2
1794200,1794572,372,0,0,1,2
1794203,1794571,368,0,0,1,1
1794572,1794598,26,1,0,0,1
1794573,1794592,19,1,0,0,2
1794593,1795237,644,0,0,1,2
1794599,1795242,643,0,0,1,1
1795238,1795269,31,1,0,0,2
1795243,1795258,15,1,0,0,1
1795259,1796343,1084,0,0,1,1
1795270,1796342,1072,0,0,1,2
1796343,1796406,63,1,0,0,2
1796344,1796398,54,1,0,0,1
1796399,1796998,599,0,0,1,1
1796407,1796999,592,0,0,1,2
1796999,1797064,65,1,0,0,1
1797000,1797065,65,1,0,0,2
1797065,1797131,66,0,0,1,1
1797066,1797130,64,0,0,1,2
1797131,1797201,70,1,0,0,2
1797132,1797205,73,1,0,0,1
1797202,1798477,1275,0,0,1,2
1797206,1797370,164,0,0,1,1
1797371,1797382,11,1,0,0,1
1797383,1797992,609,0,0,1,1
1797993,1798009,16,1,0,0,1
1798010,1798476,466,0,0,1,1
1798477,1798541,64,1,0,0,1
1798478,1798542,64,1,0,0,2
1798542,1798731,189,0,0,1,1
1798543,1798727,184,0,0,1,2
1798728,1798744,16,1,0,0,2
1798732,1798737,5,1,0,0,1
1798738,1799892,1154,0,0,1,1
1798745,1799895,1150,0,0,1,2
1799893,1799915,22,1,0,0,1
1799896,1799914,18,1,0,0,2
1799915,1800247,332,0,0,1,2
1799916,1800245,329,0,0,1,1
1800246,1800298,52,1,0,0,1
1800248,1800299,51,1,0,0,2
1800299,1801215,916,0,0,1,1
1800300,1801214,914,0,0,1,2
1801215,1801260,45,1,0,0,2
1801216,1801259,43,1,0,0,1
1801260,1801872,612,0,0,1,1
1801261,1801874,613,0,0,1,2
1801873,1801906,33,1,0,0,1
1801875,1801899,24,1,0,0,2
1801900,1802169,269,0,0,1,2
1801907,1802168,261,0,0,1,1
1802169,1802202,33,1,0,0,1
1802170,1802224,54,1,0,0,2
1802203,1802938,735,0,0,1,1
1802225,1802514,289,0,0,1,2
1802515,1802525,10,1,0,0,2
1802526,1802938,412,0,0,1,2
1802939,1802961,22,1,0,0,2
1802939,1802962,23,1,0,0,1
1802962,1803147,185,0,0,1,2
1802963,1803144,181,0,0,1,1
1803145,1803162,17,1,0,0,1
1803148,1803162,14,1,0,0,2
1803163,1803291,128,0,0,1,1
1803163,1803293,130,0,0,1,2
1803292,1803337,45,1,0,0,1
1803294,1803340,46,1,0,0,2
1803338,1806644,3306,0,0,1,1
1803341,1806119,2778,0,0,1,2
1806120,1806137,17,1,0,0,2
1806138,1806644,506,0,0,1,2
1806645,1806692,47,1,0,0,1
1806645,1806694,49,1,0,0,2
1806693,1806816,123,0,0,1,1
1806695,1806817,122,0,0,1,2
1806817,1806846,29,1,0,0,1
1806818,1806842,24,1,0,0,2
1806843,1808544,1701,0,0,1,2
1806847,1807592,745,0,0,1,1
1807593,1807597,4,1,0,0,1
1807598,1808544,946,0,0,1,1
1808545,1808594,49,1,0,0,2
1808545,1808595,50,1,0,0,1
1808595,1808857,262,0,0,1,2
1808596,1808856,260,0,0,1,1
1808857,1808872,15,1,0,0,1
1808858,1808867,9,1,0,0,2
1808868,1810069,1201,0,0,1,2
1808873,1810066,1193,0,0,1,1
1810067,1810087,20,1,0,0,1
1810070,1810085,15,1,0,0,2
1810086,1812564,2478,0,0,1,2
1810088,1812562,2474,0,0,1,1
1812563,1812747,184,1,0,0,1
1812565,1812708,143,1,0,0,2
1812709,1812785,76,0,0,1,2
1812748,1812786,38,0,0,1,1
1812786,1812818,32,1,0,0,2
1812787,1812857,70,1,0,0,1
1812819,1812983,164,0,0,1,2
1812858,1812931,73,0,0,1,1
1812932,1812954,22,1,0,0,1
1812955,1812983,28,0,0,1,1
1812984,1813009,25,1,0,0,2
1812984,1813115,131,1,0,0,1
1813010,1814601,1591,0,0,1,2
1813116,1813170,54,0,0,1,1
1813171,1813204,33,1,0,0,1
1813205,1813285,80,0,0,1,1
1813286,1813333,47,1,0,0,1
1813334,1813454,120,0,0,1,1
1813455,1813691,236,1,0,0,1
1813692,1813802,110,0,0,1,1
1813803,1813891,88,1,0,0,1
1813892,1813940,48,0,0,1,1
1813941,1814681,740,1,0,0,1
1814602,1814657,55,1,0,0,2
1814658,1814905,247,0,0,1,2
1814682,1814901,219,0,0,1,1
1814902,1815079,177,1,0,0,1
1814906,1814937,31,1,0,0,2
1814938,1815205,267,0,0,1,2
1815080,1815123,43,0,0,1,1
1815124,1815235,111,1,0,0,1
1815206,1815227,21,1,0,0,2
1815228,1816709,1481,0,0,1,2
1815236,1815258,22,0,0,1,1
1815259,1815275,16,1,0,0,1
1815276,1815320,44,0,0,1,1
1815321,1815330,9,1,0,0,1
1815331,1815438,107,0,0,1,1
1815439,1815517,78,1,0,0,1
1815518,1815538,20,0,0,1,1
1815539,1817087,1548,1,0,0,1
1816710,1817080,370,1,0,0,2
1816753,1816845,92,0,1,0,1
1816869,1817043,174,0,1,0,1
1816899,1817021,122,0,1,0,2
1817081,1818250,1169,0,0,1,2
1817088,1818249,1161,0,0,1,1
1818250,1818295,45,1,0,0,1
1818251,1818281,30,1,0,0,2
1818282,1818730,448,0,0,1,2
1818296,1818731,435,0,0,1,1
1818731,1818796,65,1,0,0,2
1818732,1818795,63,1,0,0,1
1818796,1818881,85,0,0,1,1
1818797,1818882,85,0,0,1,2
1818882,1818924,42,1,0,0,1
1818883,1818912,29,1,0,0,2
1818913,1819199,286,0,0,1,2
1818925,1819199,274,0,0,1,1
1819200,1819219,19,1,0,0,1
1819200,1819226,26,1,0,0,2
1819220,1820219,999,0,0,1,1
1819227,1820218,991,0,0,1,2
1820219,1820269,50,1,0,0,2
1820220,1820268,48,1,0,0,1
1820269,1822336,2067,0,0,1,1
1820270,1822337,2067,0,0,1,2
1822337,1822628,291,1,0,0,1
1822338,1822558,220,1,0,0,2
1822414,1822538,124,0,1,0,1
1822434,1822492,58,0,1,0,2
1822559,1823056,497,0,0,1,2
1822629,1823058,429,0,0,1,1
1823057,1823095,38,1,0,0,2
1823059,1823094,35,1,0,0,1
1823095,1823961,866,0,0,1,1
1823096,1823960,864,0,0,1,2
1823961,1824042,81,1,0,0,2
1823962,1824039,77,1,0,0,1
1824040,1824148,108,0,0,1,1
1824043,1824147,104,0,0,1,2
1824148,1824183,35,1,0,0,2
1824149,1824189,40,1,0,0,1
1824184,1824457,273,0,0,1,2
1824190,1824460,270,0,0,1,1
1824458,1824481,23,1,0,0,2
1824461,1824491,30,1,0,0,1
1824482,1824983,501,0,0,1,2
1824492,1824980,488,0,0,1,1
1824981,1825014,33,1,0,0,1
1824984,1825026,42,1,0,0,2
1825015,1825212,197,0,0,1,1
1825027,1825106,79,0,0,1,2
1825107,1825451,344,1,0,0,2
1825213,1825239,26,1,0,0,1
1825240,1825387,147,0,0,1,1
1825388,1825461,73,1,0,0,1
1825452,1827276,1824,0,0,1,2
1825462,1827275,1813,0,0,1,1
1827276,1827322,46,1,0,0,1
1827277,1827325,48,1,0,0,2
1827323,1827632,309,0,0,1,1
1827326,1827634,308,0,0,1,2
1827633,1827679,46,1,0,0,1
1827635,1827670,35,1,0,0,2
1827671,1828177,506,0,0,1,2
1827680,1828178,498,0,0,1,1
1828178,1828231,53,1,0,0,2
1828179,1828230,51,1,0,0,1
1828231,1829106,875,0,0,1,1
1828232,1829106,874,0,0,1,2
1829107,1829277,170,1,0,0,2
1829107,1831078,1971,1,0,0,1
1829184,1829413,229,0,1,0,1
1829278,1829344,66,0,0,1,2
1829345,1829374,29,1,0,0,2
1829375,1829592,217,0,0,1,2
1829593,1829611,18,1,0,0,2
1829612,1830645,1033,0,0,1,2
1830646,1830710,64,1,0,0,2
1830711,1830795,84,0,0,1,2
1830796,1830829,33,1,0,0,2
1830830,1832555,1725,0,0,1,2
1831079,1831231,152,0,0,1,1
1831232,1831245,13,1,0,0,1
1831246,1831573,327,0,0,1,1
1831574,1831614,40,1,0,0,1
1831615,1831982,367,0,0,1,1
1831983,1832105,122,1,0,0,1
1832106,1832177,71,0,0,1,1
1832178,1832373,195,1,0,0,1
1832374,1832403,29,0,0,1,1
1832404,1832607,203,1,0,0,1
1832556,1832578,22,1,0,0,2
1832579,1832809,230,0,0,1,2
1832608,1832729,121,0,0,1,1
1832730,1832886,156,1,0,0,1
1832810,1832886,76,1,0,0,2
1832887,1833613,726,0,0,1,1
1832887,1833614,727,0,0,1,2
1833614,1833645,31,1,0,0,1
1833615,1833654,39,1,0,0,2
1833646,1834349,703,0,0,1,1
1833655,1834348,693,0,0,1,2
1834349,1834431,82,1,0,0,2
1834350,1834466,116,1,0,0,1
1834432,1834452,20,0,0,1,2
1834453,1834492,39,1,0,0,2
1834467,1834614,147,0,0,1,1
1834493,1834611,118,0,0,1,2
1834612,1834628,16,1,0,0,2
1834615,1834628,13,1,0,0,1
1834629,1835353,724,0,0,1,2
1834629,1835359,730,0,0,1,1
1835354,1835382,28,1,0,0,2
1835360,1835381,21,1,0,0,1
1835382,1835537,155,0,0,1,1
1835383,1835536,153,0,0,1,2
1835537,1835564,27,1,0,0,2
1835538,1835559,21,1,0,0,1
1835560,1835776,216,0,0,1,1
1835565,1835777,212,0,0,1,2
1835777,1835901,124,1,0,0,1
1835778,1835870,92,1,0,0,2
1835871,1836109,238,0,0,1,2
1835902,1836110,208,0,0,1,1
1836110,1836142,32,1,0,0,2
1836111,1836137,26,1,0,0,1
1836138,1836811,673,0,0,1,1
1836143,1836811,668,0,0,1,2
1836812,1836833,21,1,0,0,2
1836812,1836841,29,1,0,0,1
1836834,1837960,1126,0,0,1,2
1836842,1837959,1117,0,0,1,1
1837960,1838046,86,1,0,0,1
1837961,1838041,80,1,0,0,2
1838042,1838203,161,0,0,1,2
1838047,1838205,158,0,0,1,1
1838204,1838264,60,1,0,0,2
1838206,1838262,56,1,0,0,1
1838263,1838729,466,0,0,1,1
1838265,1838730,465,0,0,1,2
1838730,1838764,34,1,0,0,1
1838731,1838761,30,1,0,0,2
1838762,1839291,529,0,0,1,2
1838765,1839289,524,0,0,1,1
1839290,1839324,34,1,0,0,1
1839292,1839318,26,1,0,0,2
1839319,1839539,220,0,0,1,2
1839325,1839540,215,0,0,1,1
1839540,1839578,38,1,0,0,2
1839541,1839576,35,1,0,0,1
1839577,1839811,234,0,0,1,1
1839579,1839812,233,0,0,1,2
1839812,1839839,27,1,0,0,1
1839813,1839840,27,1,0,0,2
1839840,1840043,203,0,0,1,1
1839841,1840043,202,0,0,1,2
1840044,1840084,40,1,0,0,1
1840044,1840092,48,1,0,0,2
1840085,1840349,264,0,0,1,1
1840093,1840351,258,0,0,1,2
1840350,1840405,55,1,0,0,1
1840352,1840397,45,1,0,0,2
1840398,1840568,170,0,0,1,2
1840406,1840566,160,0,0,1,1
1840567,1840601,34,1,0,0,1
1840569,1840593,24,1,0,0,2
1840594,1840843,249,0,0,1,2
1840602,1840836,234,0,0,1,1
1840837,1841048,211,1,0,0,1
1840844,1841045,201,1,0,0,2
1840860,1841009,149,0,1,0,1
1840868,1840984,116,0,1,0,2
1841046,1841344,298,0,0,1,2
1841049,1841348,299,0,0,1,1
1841345,1841364,19,1,0,0,2
1841349,1841364,15,1,0,0,1
1841365,1841853,488,0,0,1,1
1841365,1841853,488,0,0,1,2
1841854,1841881,27,1,0,0,1
1841854,1841885,31,1,0,0,2
1841882,1842127,245,0,0,1,1
1841886,1842127,241,0,0,1,2
1842128,1842175,47,1,0,0,2
1842128,1842183,55,1,0,0,1
1842176,1842389,213,0,0,1,2
1842184,1842381,197,0,0,1,1
1842382,1842706,324,1,0,0,1
1842390,1842641,251,1,0,0,2
1842415,1842567,152,0,1,0,2
1842415,1842596,181,0,1,0,1
1842642,1842780,138,0,0,1,2
1842707,1842779,72,0,0,1,1
1842780,1842814,34,1,0,0,1
1842781,1842804,23,1,0,0,2
1842805,1843068,263,0,0,1,2
1842815,1843069,254,0,0,1,1
1843069,1843124,55,1,0,0,2
1843070,1843124,54,1,0,0,1
1843125,1843426,301,0,0,1,1
1843125,1843426,301,0,0,1,2
1843427,1843470,43,1,0,0,2
1843427,1843480,53,1,0,0,1
1843471,1843748,277,0,0,1,2
1843481,1843747,266,0,0,1,1
1843748,1843773,25,1,0,0,1
1843749,1843780,31,1,0,0,2
1843774,1844078,304,0,0,1,1
1843781,1844078,297,0,0,1,2
1844079,1844104,25,1,0,0,1
1844079,1844104,25,1,0,0,2
1844105,1844704,599,0,0,1,2
1844105,1844706,601,0,0,1,1
1844705,1844735,30,1,0,0,2
1844707,1844735,28,1,0,0,1
1844736,1844994,258,0,0,1,1
1844736,1844996,260,0,0,1,2
1844995,1845050,55,1,0,0,1
1844997,1845051,54,1,0,0,2
1845051,1845148,97,0,0,1,1
1845052,1845148,96,0,0,1,2
1891722,1891755,33,0,0,1,2
1891722,1891757,35,0,0,1,1
1891756,1891787,31,1,0,0,2
1891758,1891777,19,1,0,0,1
1891778,1892103,325,0,0,1,1
1891788,1892111,323,0,0,1,2
1892104,1892252,148,1,0,0,1
1892112,1892210,98,1,0,0,2
1892211,1892304,93,0,0,1,2
1892253,1892308,55,0,0,1,1
1892305,1892341,36,1,0,0,2
1892309,1892371,62,1,0,0,1
1892342,1893692,1350,0,0,1,2
1892372,1893312,940,0,0,1,1
1893313,1893319,6,1,0,0,1
1893320,1893392,72,0,0,1,1
1893393,1893397,4,1,0,0,1
1893398,1893466,68,0,0,1,1
1893467,1893480,13,1,0,0,1
1893481,1893734,253,0,0,1,1
1893693,1893711,18,1,0,0,2
1893712,1893735,23,0,0,1,2
1893735,1893853,118,1,0,0,1
1893736,1893816,80,1,0,0,2
1893817,1894024,207,0,0,1,2
1893854,1894023,169,0,0,1,1
1894024,1895187,1163,1,0,0,1
1894025,1894116,91,1,0,0,2
1894117,1894189,72,0,0,1,2
1894190,1894224,34,1,0,0,2
1894225,1895111,886,0,0,1,2
1894294,1895161,867,0,1,0,1
1895112,1895187,75,1,0,0,2
1895188,1895591,403,0,0,1,1
1895188,1895591,403,0,0,1,2
1895592,1895681,89,1,0,0,1
1895592,1895740,148,1,0,0,2
1895682,1895706,24,0,0,1,1
1895707,1895762,55,1,0,0,1
1895741,1895846,105,0,0,1,2
1895763,1895788,25,0,0,1,1
1895789,1897464,1675,1,0,0,1
1895800,1896481,681,0,1,0,1
1895847,1895893,46,1,0,0,2
1895894,1896291,397,0,0,1,2
1896292,1897470,1178,1,0,0,2
1896504,1896806,302,0,1,0,1
1896849,1897420,571,0,1,0,1
1897465,1897512,47,0,0,1,1
1897471,1897512,41,0,0,1,2
1897513,1897556,43,1,0,0,2
1897513,1897558,45,1,0,0,1
1897557,1897947,390,0,0,1,2
1897559,1897944,385,0,0,1,1
1897945,1897971,26,1,0,0,1
1897948,1897964,16,1,0,0,2
1897965,1898082,117,0,0,1,2
1897972,1898087,115,0,0,1,1
1898083,1898101,18,1,0,0,2
1898088,1898100,12,1,0,0,1
1898101,1899052,951,0,0,1,1
1898102,1899050,948,0,0,1,2
1899051,1899120,69,1,0,0,2
1899053,1899119,66,1,0,0,1
1899120,1899181,61,0,0,1,1
1899121,1899181,60,0,0,1,2
1899182,1899218,36,1,0,0,1
1899182,1899221,39,1,0,0,2
1899219,1899741,522,0,0,1,1
1899222,1899742,520,0,0,1,2
1899742,1899767,25,1,0,0,1
1899743,1899767,24,1,0,0,2
1899768,1900667,899,0,0,1,1
1899768,1900669,901,0,0,1,2
1900668,1900791,123,1,0,0,1
1900670,1900785,115,1,0,0,2
1900786,1900932,146,0,0,1,2
1900792,1900932,140,0,0,1,1
1900933,1901037,104,1,0,0,1
1900933,1901037,104,1,0,0,2
1901038,1901120,82,0,0,1,2
1901038,1901122,84,0,0,1,1
1901121,1901156,35,1,0,0,2
1901123,1901159,36,1,0,0,1
1901157,1901317,160,0,0,1,2
1901160,1901204,44,0,0,1,1
1901215,1901223,8,0,1,0,1
1901233,1901562,329,1,0,0,1
1901245,1901553,308,0,1,0,1
1901318,1901352,34,1,0,0,2
1901353,1901407,54,0,0,1,2
1901408,1901843,435,1,0,0,2
1901563,1901604,41,0,0,1,1
1901615,1902217,602,0,1,0,1
1901844,1901864,20,0,0,1,2
1901865,1902256,391,1,0,0,2
1902227,1902253,26,1,0,0,1
1902254,1902657,403,0,0,1,1
1902257,1902658,401,0,0,1,2
1902658,1902802,144,1,0,0,1
1902659,1902778,119,1,0,0,2
1902779,1902891,112,0,0,1,2
1902803,1902891,88,0,0,1,1
1902892,1902926,34,1,0,0,2
1902892,1902928,36,1,0,0,1
1902927,1904031,1104,0,0,1,2
1902929,1904029,1100,0,0,1,1
1904030,1904111,81,1,0,0,1
1904032,1904123,91,1,0,0,2
1904112,1904498,386,0,0,1,1
1904124,1904499,375,0,0,1,2
1904499,1904597,98,1,0,0,1
1904500,1904607,107,1,0,0,2
1904598,1904679,81,0,0,1,1
1904608,1904680,72,0,0,1,2
1904680,1904718,38,1,0,0,1
1904681,1904709,28,1,0,0,2
1904710,1904740,30,0,0,1,2
1904719,1904852,133,0,0,1,1
1904741,1904902,161,1,0,0,2
1904853,1905953,1100,1,0,0,1
1904864,1904879,15,0,1,0,1
1904903,1904961,58,0,0,1,2
1904912,1905879,967,0,1,0,1
1904962,1905003,41,1,0,0,2
1905004,1905061,57,0,0,1,2
1905062,1905066,4,1,0,0,2
1905067,1905260,193,0,0,1,2
1905261,1905595,334,1,0,0,2
1905596,1905639,43,0,0,1,2
1905640,1905930,290,1,0,0,2
1905931,1906311,380,0,0,1,2
1905954,1906311,357,0,0,1,1
1906312,1906364,52,1,0,0,2
1906312,1906366,54,1,0,0,1
1906365,1906631,266,0,0,1,2
1906367,1906628,261,0,0,1,1
1906629,1906647,18,1,0,0,1
1906632,1906643,11,1,0,0,2
1906644,1907541,897,0,0,1,2
1906648,1907542,894,0,0,1,1
1907542,1907585,43,1,0,0,2
1907543,1907593,50,1,0,0,1
1907586,1907945,359,0,0,1,2
1907594,1907946,352,0,0,1,1
1907946,1908029,83,1,0,0,2
1907947,1908035,88,1,0,0,1
1908030,1908111,81,0,0,1,2
1908036,1908112,76,0,0,1,1
1908112,1908151,39,1,0,0,2
1908113,1908152,39,1,0,0,1
1908152,1908579,427,0,0,1,2
1908153,1908579,426,0,0,1,1
1908580,1908597,17,1,0,0,2
1908580,1908601,21,1,0,0,1
1908598,1909320,722,0,0,1,2
1908602,1909318,716,0,0,1,1
1909319,1909399,80,1,0,0,1
1909321,1909390,69,1,0,0,2
1909391,1909595,204,0,0,1,2
1909400,1909593,193,0,0,1,1
1909594,1909686,92,1,0,0,1
1909596,1909677,81,1,0,0,2
1909678,1909749,71,0,0,1,2
1909687,1909748,61,0,0,1,1
1909749,1909792,43,1,0,0,1
1909750,1909786,36,1,0,0,2
1909787,1910015,228,0,0,1,2
1909793,1910014,221,0,0,1,1
1910015,1910046,31,1,0,0,1
1910016,1910033,17,1,0,0,2
1910034,1910798,764,0,0,1,2
1910047,1910798,751,0,0,1,1
1910799,1910882,83,1,0,0,1
1910799,1910883,84,1,0,0,2
1910883,1911196,313,0,0,1,1
1910884,1911195,311,0,0,1,2
1911196,1911280,84,1,0,0,2
1911197,1911282,85,1,0,0,1
1911281,1911362,81,0,0,1,2
1911283,1911363,80,0,0,1,1
1911363,1911395,32,1,0,0,2
1911364,1911394,30,1,0,0,1
1911395,1912343,948,0,0,1,1
1911396,1912344,948,0,0,1,2
1912344,1912434,90,1,0,0,1
1912345,1912427,82,1,0,0,2
1912428,1912823,395,0,0,1,2
1912435,1912822,387,0,0,1,1
1912823,1912908,85,1,0,0,1
1912824,1912909,85,1,0,0,2
1912909,1913007,98,0,0,1,1
1912910,1913008,98,0,0,1,2
1913008,1913041,33,1,0,0,1
1913009,1913042,33,1,0,0,2
1913042,1913843,801,0,0,1,1
1913043,1913843,800,0,0,1,2
1913844,1913910,66,1,0,0,1
1913844,1913917,73,1,0,0,2
1913911,1914291,380,0,0,1,1
1913918,1914291,373,0,0,1,2
1914292,1914382,90,1,0,0,2
1914292,1914456,164,1,0,0,1
1914383,1914480,97,0,0,1,2
1914457,1914478,21,0,0,1,1
1914479,1914513,34,1,0,0,1
1914481,1914507,26,1,0,0,2
1914508,1915254,746,0,0,1,2
1914514,1914946,432,0,0,1,1
1914947,1914971,24,1,0,0,1
1914972,1915066,94,0,0,1,1
1915067,1915338,271,1,0,0,1
1915255,1915335,80,1,0,0,2
1915336,1915716,380,0,0,1,2
1915339,1915716,377,0,0,1,1
1915717,1915755,38,1,0,0,2
1915717,1915761,44,1,0,0,1
1915756,1915994,238,0,0,1,2
1915762,1915996,234,0,0,1,1
1915995,1916010,15,1,0,0,2
1915997,1916006,9,1,0,0,1
1916007,1917226,1219,0,0,1,1
1916011,1917228,1217,0,0,1,2
1917227,1918468,1241,1,0,0,1
1917229,1917326,97,1,0,0,2
1917290,1918444,1154,0,1,0,1
1917327,1917449,122,0,0,1,2
1917450,1917486,36,1,0,0,2
1917487,1918348,861,0,0,1,2
1918349,1918434,85,1,0,0,2
1918435,1918840,405,0,0,1,2
1918469,1918838,369,0,0,1,1
1918839,1918953,114,1,0,0,1
1918841,1918911,70,1,0,0,2
1918912,1919033,121,0,0,1,2
1918954,1919033,79,0,0,1,1
1919034,1919056,22,1,0,0,2
1919034,1919064,30,1,0,0,1
1919057,1920128,1071,0,0,1,2
1919065,1920128,1063,0,0,1,1
1920129,1920205,76,1,0,0,2
1920129,1920206,77,1,0,0,1
1920206,1920439,233,0,0,1,2
1920207,1920440,233,0,0,1,1
1920440,1920511,71,1,0,0,2
1920441,1920511,70,1,0,0,1
1920512,1920579,67,0,0,1,1
1920512,1920579,67,0,0,1,2
1920580,1920607,27,1,0,0,2
1920580,1920608,28,1,0,0,1
1920608,1920813,205,0,0,1,2
1920609,1920815,206,0,0,1,1
1920814,1920828,14,1,0,0,2
1920816,1920828,12,1,0,0,1
1920829,1921434,605,0,0,1,1
1920829,1921435,606,0,0,1,2
1921435,1921521,86,1,0,0,1
1921436,1921521,85,1,0,0,2
1921522,1921856,334,0,0,1,2
1921522,1921857,335,0,0,1,1
1921857,1921966,109,1,0,0,2
1921858,1921946,88,1,0,0,1
1921947,1922076,129,0,0,1,1
1921967,1922077,110,0,0,1,2
1922077,1922105,28,1,0,0,1
1922078,1922098,20,1,0,0,2
1922099,1922874,775,0,0,1,2
1922106,1922873,767,0,0,1,1
1922874,1922962,88,1,0,0,1
1922875,1922956,81,1,0,0,2
1922957,1923327,370,0,0,1,2
1922963,1923328,365,0,0,1,1
1923328,1923401,73,1,0,0,2
1923329,1923391,62,1,0,0,1
1923392,1923502,110,0,0,1,1
1923402,1923503,101,0,0,1,2
1923503,1923536,33,1,0,0,1
1923504,1923537,33,1,0,0,2
1923537,1924670,1133,0,0,1,1
1923538,1924673,1135,0,0,1,2
1924671,1924810,139,1,0,0,1
1924674,1924812,138,1,0,0,2
1924811,1925057,246,0,0,1,1
1924813,1925059,246,0,0,1,2
1925058,1925138,80,1,0,0,1
1925060,1925135,75,1,0,0,2
1925136,1925236,100,0,0,1,2
1925139,1925237,98,0,0,1,1
1925237,1925270,33,1,0,0,2
1925238,1925268,30,1,0,0,1
1925269,1925436,167,0,0,1,1
1925271,1925439,168,0,0,1,2
1925437,1925459,22,1,0,0,1
1925440,1925457,17,1,0,0,2
1925458,1926407,949,0,0,1,2
1925460,1926407,947,0,0,1,1
1926408,1926479,71,1,0,0,2
1926408,1926489,81,1,0,0,1
1926480,1926763,283,0,0,1,2
1926490,1926764,274,0,0,1,1
1926764,1926835,71,1,0,0,2
1926765,1926827,62,1,0,0,1
1926828,1926896,68,0,0,1,1
1926836,1926897,61,0,0,1,2
1926897,1926932,35,1,0,0,1
1926898,1926932,34,1,0,0,2
1926933,1927237,304,0,0,1,1
1926933,1928151,1218,0,0,1,2
1927238,1927248,10,1,0,0,1
1927249,1928152,903,0,0,1,1
1928152,1928211,59,1,0,0,2
1928153,1928195,42,1,0,0,1
1928196,1929283,1087,0,0,1,1
1928212,1929283,1071,0,0,1,2
1929284,1929404,120,1,0,0,1
1929284,1929405,121,1,0,0,2
1929405,1929531,126,0,0,1,1
1929406,1929533,127,0,0,1,2
1929532,1929619,87,1,0,0,1
1929534,1929591,57,1,0,0,2
1929592,1929678,86,0,0,1,2
1929620,1929676,56,0,0,1,1
1929677,1929718,41,1,0,0,1
1929679,1929714,35,1,0,0,2
1929715,1930721,1006,0,0,1,2
1929719,1930475,756,0,0,1,1
1930476,1930781,305,1,0,0,1
1930722,1930783,61,1,0,0,2
1930782,1931031,249,0,0,1,1
1930784,1931029,245,0,0,1,2
1931030,1931098,68,1,0,0,2
1931032,1931109,77,1,0,0,1
1931099,1931171,72,0,0,1,2
1931110,1931172,62,0,0,1,1
1931172,1931209,37,1,0,0,2
1931173,1931220,47,1,0,0,1
1931210,1931485,275,0,0,1,2
1931221,1931485,264,0,0,1,1
1931486,1931512,26,1,0,0,1
1931486,1931512,26,1,0,0,2
1931513,1932014,501,0,0,1,1
1931513,1932015,502,0,0,1,2
1932015,1932101,86,1,0,0,1
1932016,1932099,83,1,0,0,2
1932100,1932396,296,0,0,1,2
1932102,1932397,295,0,0,1,1
1932397,1932480,83,1,0,0,2
1932398,1932482,84,1,0,0,1
1932481,1932640,159,0,0,1,2
1932483,1932640,157,0,0,1,1
1932641,1932673,32,1,0,0,1
1932641,1932673,32,1,0,0,2
1932674,1933497,823,0,0,1,1
1932674,1933498,824,0,0,1,2
1933498,1933560,62,1,0,0,1
1933499,1933559,60,1,0,0,2
1933560,1933777,217,0,0,1,2
1933561,1933778,217,0,0,1,1
1933778,1933863,85,1,0,0,2
1933779,1933862,83,1,0,0,1
1933863,1933964,101,0,0,1,1
1933864,1933963,99,0,0,1,2
1933964,1933999,35,1,0,0,2
1933965,1933996,31,1,0,0,1
1933997,1934568,571,0,0,1,1
1934000,1934568,568,0,0,1,2
1934569,1934595,26,1,0,0,1
1934569,1934595,26,1,0,0,2
1934596,1934900,304,0,0,1,1
1934596,1934900,304,0,0,1,2
1934901,1934957,56,1,0,0,2
1934901,1934971,70,1,0,0,1
1934958,1935343,385,0,0,1,2
1934972,1935343,371,0,0,1,1
1935344,1935401,57,1,0,0,1
1935344,1935410,66,1,0,0,2
1935402,1935506,104,0,0,1,1
1935411,1935500,89,0,0,1,2
1935501,1935530,29,1,0,0,2
1935507,1935521,14,1,0,0,1
1935522,1935817,295,0,0,1,1
1935531,1935816,285,0,0,1,2
1935817,1935840,23,1,0,0,2
1935818,1935841,23,1,0,0,1
1935841,1936380,539,0,0,1,2
1935842,1936382,540,0,0,1,1
1936381,1936442,61,1,0,0,2
1936383,1936432,49,1,0,0,1
1936433,1936724,291,0,0,1,1
1936443,1936724,281,0,0,1,2
1936725,1936784,59,1,0,0,2
1936725,1937864,1139,1,0,0,1
1936785,1936871,86,0,0,1,2
1936872,1936913,41,1,0,0,2
1936914,1937140,226,0,0,1,2
1937141,1937152,11,1,0,0,2
1937153,1937805,652,0,0,1,2
1937806,1937861,55,1,0,0,2
1937862,1938259,397,0,0,1,2
1937865,1938260,395,0,0,1,1
1938260,1938316,56,1,0,0,2
1938261,1938326,65,1,0,0,1
1938317,1938434,117,0,0,1,2
1938327,1938433,106,0,0,1,1
1938434,1938458,24,1,0,0,1
1938435,1938459,24,1,0,0,2
1938459,1939628,1169,0,0,1,1
1938460,1939629,1169,0,0,1,2
1939629,1939718,89,1,0,0,1
1939630,1939716,86,1,0,0,2
1939717,1939792,75,0,0,1,2
1939719,1939792,73,0,0,1,1
1939793,1939826,33,1,0,0,1
1939793,1939828,35,1,0,0,2
1939827,1940529,702,0,0,1,1
1939829,1940528,699,0,0,1,2
1940529,1940599,70,1,0,0,2
1940530,1940599,69,1,0,0,1
1940600,1940992,392,0,0,1,1
1940600,1940993,393,0,0,1,2
1940993,1941057,64,1,0,0,1
1940994,1941058,64,1,0,0,2
1941058,1941185,127,0,0,1,1
1941059,1941186,127,0,0,1,2
1941186,1941215,29,1,0,0,1
1941187,1941205,18,1,0,0,2
1941206,1941908,702,0,0,1,2
1941216,1941909,693,0,0,1,1
1941909,1941965,56,1,0,0,2
1941910,1941962,52,1,0,0,1
1941963,1942379,416,0,0,1,1
1941966,1942379,413,0,0,1,2
1942380,1942451,71,1,0,0,2
1942380,1942464,84,1,0,0,1
1942452,1942568,116,0,0,1,2
1942465,1942529,64,0,0,1,1
1942530,1942538,8,1,0,0,1
1942539,1942569,30,0,0,1,1
1942569,1942601,32,1,0,0,2
1942570,1942598,28,1,0,0,1
1942599,1942651,52,0,0,1,1
1942602,1943061,459,0,0,1,2
1942652,1943139,487,1,0,0,1
1942666,1942668,2,0,1,0,1
1942707,1943107,400,0,1,0,1
1943062,1943139,77,1,0,0,2
1943140,1943634,494,0,0,1,1
1943140,1943634,494,0,0,1,2
1943635,1943706,71,1,0,0,1
1943635,1943708,73,1,0,0,2
1943707,1943790,83,0,0,1,1
1943709,1943792,83,0,0,1,2
1943791,1943827,36,1,0,0,1
1943793,1943818,25,1,0,0,2
1943819,1944851,1032,0,0,1,2
1943828,1944058,230,0,0,1,1
1944059,1944078,19,1,0,0,1
1944079,1944852,773,0,0,1,1
1944852,1944924,72,1,0,0,2
1944853,1944918,65,1,0,0,1
1944919,1945162,243,0,0,1,1
1944925,1945163,238,0,0,1,2
1945163,1945233,70,1,0,0,1
1945164,1945235,71,1,0,0,2
1945234,1945410,176,0,0,1,1
1945236,1945411,175,0,0,1,2
1945411,1945434,23,1,0,0,1
1945412,1945434,22,1,0,0,2
1945435,1946482,1047,0,0,1,2
1945435,1946483,1048,0,0,1,1
1946483,1946627,144,1,0,0,2
1946484,1946653,169,1,0,0,1
1946628,1946787,159,0,0,1,2
1946654,1946786,132,0,0,1,1
1946787,1946909,122,1,0,0,1
1946788,1946876,88,1,0,0,2
1946877,1946958,81,0,0,1,2
1946910,1946956,46,0,0,1,1
1946957,1947368,411,1,0,0,1
1946959,1946996,37,1,0,0,2
1946997,1947144,147,0,0,1,2
1947145,1947161,16,1,0,0,2
1947162,1948106,944,0,0,1,2
1947369,1947411,42,0,0,1,1
1947412,1948188,776,1,0,0,1
1948107,1948170,63,1,0,0,2
1948171,1948548,377,0,0,1,2
1948189,1948549,360,0,0,1,1
1948549,1948602,53,1,0,0,2
1948550,1948611,61,1,0,0,1
1948603,1948803,200,0,0,1,2
1948612,1948803,191,0,0,1,1
1948804,1948822,18,1,0,0,1
1948804,1948834,30,1,0,0,2
1948823,1949136,313,0,0,1,1
1948835,1949136,301,0,0,1,2
1949137,1949150,13,1,0,0,1
1949137,1949150,13,1,0,0,2
1949151,1949633,482,0,0,1,1
1949151,1949635,484,0,0,1,2
1949634,1949704,70,1,0,0,1
1949636,1949703,67,1,0,0,2
1949704,1950048,344,0,0,1,2
1949705,1950049,344,0,0,1,1
1950049,1950117,68,1,0,0,2
1950050,1950126,76,1,0,0,1
1950118,1950228,110,0,0,1,2
1950127,1950227,100,0,0,1,1
1950228,1950264,36,1,0,0,1
1950229,1950263,34,1,0,0,2
1950264,1951033,769,0,0,1,2
1950265,1951032,767,0,0,1,1
1951033,1951206,173,1,0,0,1
1951034,1951109,75,1,0,0,2
1951110,1951386,276,0,0,1,2
1951207,1951386,179,0,0,1,1
1951387,1951427,40,1,0,0,1
1951387,1951430,43,1,0,0,2
1951428,1951580,152,0,0,1,1
1951431,1951582,151,0,0,1,2
1951581,1951601,20,1,0,0,1
1951583,1951602,19,1,0,0,2
1951602,1952822,1220,0,0,1,1
1951603,1952821,1218,0,0,1,2
1952822,1952941,119,1,0,0,2
1952823,1953094,271,1,0,0,1
1952898,1953046,148,0,1,0,1
1952942,1953035,93,0,0,1,2
1953036,1953064,28,1,0,0,2
1953065,1953290,225,0,0,1,2
1953095,1953149,54,0,0,1,1
1953150,1953185,35,1,0,0,1
1953186,1953207,21,0,0,1,1
1953208,1953900,692,1,0,0,1
1953254,1953855,601,0,1,0,1
1953291,1953890,599,1,0,0,2
1953891,1954256,365,0,0,1,2
1953901,1954256,355,0,0,1,1
1954257,1954327,70,1,0,0,1
1954257,1954328,71,1,0,0,2
1954328,1954430,102,0,0,1,1
1954329,1954429,100,0,0,1,2
1954430,1954461,31,1,0,0,2
1954431,1954458,27,1,0,0,1
1954459,1955759,1300,0,0,1,1
1954462,1955757,1295,0,0,1,2
1955758,1955955,197,1,0,0,2
1955760,1955952,192,1,0,0,1
1955953,1956053,100,0,0,1,1
1955956,1956050,94,0,0,1,2
1956051,1956090,39,1,0,0,2
1956054,1956089,35,1,0,0,1
1956090,1956560,470,0,0,1,1
1956091,1956569,478,0,0,1,2
1956561,1956593,32,1,0,0,1
1956570,1956593,23,1,0,0,2
1956594,1957082,488,0,0,1,1
1956594,1957082,488,0,0,1,2
1957083,1957159,76,1,0,0,1
1957083,1957161,78,1,0,0,2
1957160,1957558,398,0,0,1,1
1957162,1957560,398,0,0,1,2
1957559,1957620,61,1,0,0,1
1957561,1957627,66,1,0,0,2
1957621,1957732,111,0,0,1,1
1957628,1957734,106,0,0,1,2
1957733,1957754,21,1,0,0,1
1957735,1957755,20,1,0,0,2
1957755,1958748,993,0,0,1,1
1957756,1958749,993,0,0,1,2
1958749,1958865,116,1,0,0,1
1958750,1958866,116,1,0,0,2
1958866,1959162,296,0,0,1,1
1958867,1959161,294,0,0,1,2
1959162,1959200,38,1,0,0,2
1959163,1959202,39,1,0,0,1
1959201,1959350,149,0,0,1,2
1959203,1959355,152,0,0,1,1
1959351,1959371,20,1,0,0,2
1959356,1959368,12,1,0,0,1
1959369,1960397,1028,0,0,1,1
1959372,1960398,1026,0,0,1,2
1960398,1960455,57,1,0,0,1
1960399,1960467,68,1,0,0,2
1960456,1960721,265,0,0,1,1
1960468,1960722,254,0,0,1,2
1960722,1960805,83,1,0,0,1
1960723,1960806,83,1,0,0,2
1960806,1961900,1094,0,0,1,1
1960807,1961900,1093,0,0,1,2
1961901,1961968,67,1,0,0,1
1961901,1961977,76,1,0,0,2
1961969,1962291,322,0,0,1,1
1961978,1962291,313,0,0,1,2
1962292,1962341,49,1,0,0,2
1962292,1962354,62,1,0,0,1
1962342,1962622,280,0,0,1,2
1962355,1962617,262,0,0,1,1
1962618,1962637,19,1,0,0,1
1962623,1962633,10,1,0,0,2
1962634,1963746,1112,0,0,1,2
1962638,1963745,1107,0,0,1,1
1963746,1963823,77,1,0,0,1
1963747,1963816,69,1,0,0,2
1963817,1963997,180,0,0,1,2
1963824,1963999,175,0,0,1,1
1963998,1964028,30,1,0,0,2
1964000,1964019,19,1,0,0,1
1964020,1965144,1124,0,0,1,1
1964029,1965144,1115,0,0,1,2
1965145,1965398,253,1,0,0,2
1965145,1965541,396,1,0,0,1
1965399,1965820,421,0,0,1,2
1965542,1965818,276,0,0,1,1
1965819,1965891,72,1,0,0,1
1965821,1965893,72,1,0,0,2
1965892,1966293,401,0,0,1,1
1965894,1966294,400,0,0,1,2
1966294,1966325,31,1,0,0,1
1966295,1966324,29,1,0,0,2
1966325,1966660,335,0,0,1,2
1966326,1966660,334,0,0,1,1
1966661,1966782,121,1,0,0,2
1966661,1966830,169,1,0,0,1
1966783,1966869,86,0,0,1,2
1966831,1966867,36,0,0,1,1
1966868,1966901,33,1,0,0,1
1966870,1966893,23,1,0,0,2
1966894,1967314,420,0,0,1,2
1966902,1967313,411,0,0,1,1
1967314,1967340,26,1,0,0,1
1967315,1967341,26,1,0,0,2
1967341,1968122,781,0,0,1,1
1967342,1968121,779,0,0,1,2
1968122,1968220,98,1,0,0,2
1968123,1968221,98,1,0,0,1
1968221,1968564,343,0,0,1,2
1968222,1968563,341,0,0,1,1
1968564,1968620,56,1,0,0,1
1968565,1968612,47,1,0,0,2
1968613,1970636,2023,0,0,1,2
1968621,1969407,786,0,0,1,1
1969408,1969420,12,1,0,0,1
1969421,1970633,1212,0,0,1,1
1970634,1970655,21,1,0,0,1
1970637,1970655,18,1,0,0,2
1970656,1970922,266,0,0,1,1
1970656,1970923,267,0,0,1,2
1970923,1970973,50,1,0,0,1
1970924,1970973,49,1,0,0,2
1970974,1971959,985,0,0,1,1
1970974,1971959,985,0,0,1,2
1971960,1971992,32,1,0,0,2
1971960,1971993,33,1,0,0,1
1971993,1972126,133,0,0,1,2
1971994,1972129,135,0,0,1,1
1972127,1972146,19,1,0,0,2
1972130,1972146,16,1,0,0,1
1972147,1973180,1033,0,0,1,2
1972147,1973182,1035,0,0,1,1
1973181,1973229,48,1,0,0,2
1973183,1973228,45,1,0,0,1
1973229,1973866,637,0,0,1,1
1973230,1973866,636,0,0,1,2
1973867,1973906,39,1,0,0,2
1973867,1973930,63,1,0,0,1
1973907,1974372,465,0,0,1,2
1973931,1974371,440,0,0,1,1
1974372,1974425,53,1,0,0,1
1974373,1974423,50,1,0,0,2
1974424,1974702,278,0,0,1,2
1974426,1974688,262,0,0,1,1
1974689,1974778,89,1,0,0,1
1974703,1974738,35,1,0,0,2
1974739,1974937,198,0,0,1,2
1974779,1974938,159,0,0,1,1
1974938,1975005,67,1,0,0,2
1974939,1975015,76,1,0,0,1
1975006,1975101,95,0,0,1,2
1975016,1975102,86,0,0,1,1
1975102,1975136,34,1,0,0,2
1975103,1975133,30,1,0,0,1
1975134,1975678,544,0,0,1,1
1975137,1975678,541,0,0,1,2
1975679,1975698,19,1,0,0,1
1975679,1975705,26,1,0,0,2
1975699,1976067,368,0,0,1,1
1975706,1977258,1552,0,0,1,2
1976068,1976080,12,1,0,0,1
1976081,1977256,1175,0,0,1,1
1977257,1977306,49,1,0,0,1
1977259,1977307,48,1,0,0,2
1977307,1977525,218,0,0,1,1
1977308,1977527,219,0,0,1,2
1977526,1977880,354,1,0,0,1
1977528,1977852,324,1,0,0,2
1977558,1977808,250,0,1,0,1
1977565,1977771,206,0,1,0,2
1977853,1978077,224,0,0,1,2
1977881,1978076,195,0,0,1,1
1978077,1978115,38,1,0,0,1
1978078,1978114,36,1,0,0,2
1978115,1978883,768,0,0,1,2
1978116,1978286,170,0,0,1,1
1978287,1978656,369,1,0,0,1
1978657,1978880,223,0,0,1,1
1978881,1978912,31,1,0,0,1
1978884,1978902,18,1,0,0,2
1978903,1979371,468,0,0,1,2
1978913,1978961,48,0,0,1,1
1978962,1979073,111,1,0,0,1
1979074,1979369,295,0,0,1,1
1979370,1979431,61,1,0,0,1
1979372,1979434,62,1,0,0,2
1979432,1979985,553,0,0,1,1
1979435,1979985,550,0,0,1,2
1979986,1980023,37,1,0,0,2
1979986,1980031,45,1,0,0,1
1980024,1981041,1017,0,0,1,2
1980032,1981042,1010,0,0,1,1
1981042,1981118,76,1,0,0,2
1981043,1981127,84,1,0,0,1
1981119,1981232,113,0,0,1,2
1981128,1981230,102,0,0,1,1
1981231,1981263,32,1,0,0,1
1981233,1981255,22,1,0,0,2
1981256,1981743,487,0,0,1,2
1981264,1982076,812,0,0,1,1
1981744,1981760,16,1,0,0,2
1981761,1982075,314,0,0,1,2
1982076,1982103,27,1,0,0,2
1982077,1982104,27,1,0,0,1
1982104,1982854,750,0,0,1,2
1982105,1982853,748,0,0,1,1
1982854,1982925,71,1,0,0,1
1982855,1982926,71,1,0,0,2
1982926,1984100,1174,0,0,1,1
1982927,1984101,1174,0,0,1,2
1984101,1984132,31,1,0,0,1
1984102,1984121,19,1,0,0,2
1984122,1984633,511,0,0,1,2
1984133,1984630,497,0,0,1,1
1984631,1984660,29,1,0,0,1
1984634,1984659,25,1,0,0,2
1984660,1984941,281,0,0,1,2
1984661,1984940,279,0,0,1,1
1984941,1985203,262,1,0,0,1
1984942,1985068,126,1,0,0,2
1985069,1986229,1160,0,0,1,2
1985204,1986230,1026,0,0,1,1
1986230,1986280,50,1,0,0,2
1986231,1986280,49,1,0,0,1
1986281,1986735,454,0,0,1,1
1986281,1986735,454,0,0,1,2
1986736,1986805,69,1,0,0,1
1986736,1986815,79,1,0,0,2
1986806,1986991,185,0,0,1,1
1986816,1986989,173,0,0,1,2
1986990,1987021,31,1,0,0,2
1986992,1987010,18,1,0,0,1
1987011,1987223,212,0,0,1,1
1987022,1987225,203,0,0,1,2
1987224,1987246,22,1,0,0,1
1987226,1987244,18,1,0,0,2
1987245,1988003,758,0,0,1,2
1987247,1988001,754,0,0,1,1
1988002,1988065,63,1,0,0,1
1988004,1988056,52,1,0,0,2
1988057,1988224,167,0,0,1,2
1988066,1988207,141,0,0,1,1
1988208,1988558,350,1,0,0,1
1988225,1988489,264,1,0,0,2
1988239,1988503,264,0,1,0,1
1988255,1988419,164,0,1,0,2
1988490,1989351,861,0,0,1,2
1988559,1989132,573,0,0,1,1
1989133,1989161,28,1,0,0,1
1989162,1989333,171,0,0,1,1
1989334,1989568,234,1,0,0,1
1989352,1989384,32,1,0,0,2
1989385,1989706,321,0,0,1,2
1989569,1989590,21,0,0,1,1
1989591,1990122,531,1,0,0,1
1989707,1989728,21,1,0,0,2
1989729,1990064,335,0,0,1,2
1990065,1990122,57,1,0,0,2
1990123,1990326,203,0,0,1,1
1990123,1990327,204,0,0,1,2
1990327,1990392,65,1,0,0,1
1990328,1990391,63,1,0,0,2
1990392,1990929,537,0,0,1,2
1990393,1990930,537,0,0,1,1
1990930,1990986,56,1,0,0,2
1990931,1990987,56,1,0,0,1
1990987,1991349,362,0,0,1,2
1990988,1991348,360,0,0,1,1
1991349,1991413,64,1,0,0,1
1991350,1991417,67,1,0,0,2
1991414,1991494,80,0,0,1,1
1991418,1991495,77,0,0,1,2
1991495,1991535,40,1,0,0,1
1991496,1991534,38,1,0,0,2
1991535,1991726,191,0,0,1,2
1991536,1991724,188,0,0,1,1
1991725,1991753,28,1,0,0,1
1991727,1991746,19,1,0,0,2
1991747,1992462,715,0,0,1,2
1991754,1992462,708,0,0,1,1
1992463,1992512,49,1,0,0,1
1992463,1992514,51,1,0,0,2
1992513,1992995,482,0,0,1,1
1992515,1992999,484,0,0,1,2
1992996,1993016,20,1,0,0,1
1993000,1993011,11,1,0,0,2
1993012,1994493,1481,0,0,1,2
1993017,1994495,1478,0,0,1,1
1994494,1994619,125,1,0,0,2
1994496,1994617,121,1,0,0,1
1994618,1995263,645,0,0,1,1
1994620,1995266,646,0,0,1,2
1995264,1995323,59,1,0,0,1
1995267,1995315,48,1,0,0,2
1995316,1995693,377,0,0,1,2
1995324,1995695,371,0,0,1,1
1995694,1995778,84,1,0,0,2
1995696,1995779,83,1,0,0,1
1995779,1995859,80,0,0,1,2
1995780,1995857,77,0,0,1,1
1995858,1995901,43,1,0,0,1
1995860,1995898,38,1,0,0,2
1995899,1997264,1365,0,0,1,2
1995902,1997264,1362,0,0,1,1
1997265,1997323,58,1,0,0,1
1997265,1997328,63,1,0,0,2
1997324,1997443,119,0,0,1,1
1997329,1997443,114,0,0,1,2
1997444,1997465,21,1,0,0,2
1997444,1997475,31,1,0,0,1
1997466,1999189,1723,0,0,1,2
1997476,1999184,1708,0,0,1,1
1999185,1999214,29,1,0,0,1
1999190,1999211,21,1,0,0,2
1999212,1999316,104,0,0,1,2
1999215,1999317,102,0,0,1,1
1999317,1999405,88,1,0,0,2
1999318,1999402,84,1,0,0,1
1999403,2001062,1659,0,0,1,1
1999406,2001061,1655,0,0,1,2
2001062,2001144,82,1,0,0,2
2001063,2001147,84,1,0,0,1
2001145,2001221,76,0,0,1,2
2001148,2001220,72,0,0,1,1
2001221,2001255,34,1,0,0,1
2001222,2001255,33,1,0,0,2
2001256,2001477,221,0,0,1,1
2001256,2001477,221,0,0,1,2
2001478,2001488,10,1,0,0,1
2001478,2001488,10,1,0,0,2
2001489,2002927,1438,0,0,1,1
2001489,2002928,1439,0,0,1,2
2002928,2002978,50,1,0,0,1
2002929,2002982,53,1,0,0,2
2002979,2003315,336,0,0,1,1
2002983,2003316,333,0,0,1,2
2003316,2003340,24,1,0,0,1
2003317,2003344,27,1,0,0,2
2003341,2004110,769,0,0,1,1
2003345,2004110,765,0,0,1,2
2004111,2004134,23,1,0,0,2
2004111,2004145,34,1,0,0,1
2004135,2005039,904,0,0,1,2
2004146,2005039,893,0,0,1,1
2005040,2005167,127,1,0,0,1
2005040,2005170,130,1,0,0,2
2005168,2005363,195,0,0,1,1
2005171,2005362,191,0,0,1,2
2005363,2005419,56,1,0,0,2
2005364,2005425,61,1,0,0,1
2005420,2005738,318,0,0,1,2
2005426,2005739,313,0,0,1,1
2005739,2005775,36,1,0,0,2
2005740,2005773,33,1,0,0,1
2005774,2006949,1175,0,0,1,1
2005776,2006950,1174,0,0,1,2
2006950,2007023,73,1,0,0,1
2006951,2007018,67,1,0,0,2
2007019,2007119,100,0,0,1,2
2007024,2007119,95,0,0,1,1
2007120,2007142,22,1,0,0,2
2007120,2007151,31,1,0,0,1
2007143,2007911,768,0,0,1,2
2007152,2007908,756,0,0,1,1
2007909,2007923,14,1,0,0,1
2007912,2007925,13,1,0,0,2
2007924,2008844,920,0,0,1,1
2007926,2008846,920,0,0,1,2
2008845,2008899,54,1,0,0,1
2008847,2008901,54,1,0,0,2
2008900,2009101,201,0,0,1,1
2008902,2009101,199,0,0,1,2
2009102,2009151,49,1,0,0,1
2009102,2009152,50,1,0,0,2
2009152,2009865,713,0,0,1,1
2009153,2009866,713,0,0,1,2
2009866,2009904,38,1,0,0,1
2009867,2009902,35,1,0,0,2
2009903,2010893,990,0,0,1,2
2009905,2010893,988,0,0,1,1
2010894,2010979,85,1,0,0,2
2010894,2010985,91,1,0,0,1
2010980,2012798,1818,0,0,1,2
2010986,2012798,1812,0,0,1,1
2012799,2012834,35,1,0,0,2
2012799,2012838,39,1,0,0,1
2012835,2013035,200,0,0,1,2
2012839,2013037,198,0,0,1,1
2013036,2013063,27,1,0,0,2
2013038,2013062,24,1,0,0,1
2013063,2013820,757,0,0,1,1
2013064,2013828,764,0,0,1,2
2013821,2013835,14,1,0,0,1
2013829,2013838,9,1,0,0,2
2013836,2014186,350,0,0,1,1
2013839,2014187,348,0,0,1,2
2014187,2014240,53,1,0,0,1
2014188,2014240,52,1,0,0,2
2014241,2016363,2122,0,0,1,2
2014241,2016365,2124,0,0,1,1
2016364,2016420,56,1,0,0,2
2016366,2016418,52,1,0,0,1
2016419,2016800,381,0,0,1,1
2016421,2016800,379,0,0,1,2
2016801,2016838,37,1,0,0,2
2016801,2016839,38,1,0,0,1
2016839,2017548,709,0,0,1,2
2016840,2017549,709,0,0,1,1
2017549,2017577,28,1,0,0,2
2017550,2017565,15,1,0,0,1
2017566,2017779,213,0,0,1,1
2017578,2017779,201,0,0,1,2
2017780,2017870,90,1,0,0,2
2017780,2018012,232,1,0,0,1
2017871,2018086,215,0,0,1,2
2018013,2018095,82,0,0,1,1
2018087,2018117,30,1,0,0,2
2018096,2018204,108,1,0,0,1
2018118,2018639,521,0,0,1,2
2018205,2018271,66,0,0,1,1
2018272,2018458,186,1,0,0,1
2018459,2018529,70,0,0,1,1
2018530,2018565,35,1,0,0,1
2018566,2018640,74,0,0,1,1
2018640,2018712,72,1,0,0,2
2018641,2018738,97,1,0,0,1
2018713,2018937,224,0,0,1,2
2018739,2018936,197,0,0,1,1
2018937,2018981,44,1,0,0,1
2018938,2018969,31,1,0,0,2
2018970,2019595,625,0,0,1,2
2018982,2019595,613,0,0,1,1
2019596,2019623,27,1,0,0,2
2019596,2019629,33,1,0,0,1
2019624,2020810,1186,0,0,1,2
2019630,2020811,1181,0,0,1,1
2020811,2020859,48,1,0,0,2
2020812,2020850,38,1,0,0,1
2020851,2021278,427,0,0,1,1
2020860,2021278,418,0,0,1,2
2021279,2021330,51,1,0,0,1
2021279,2021330,51,1,0,0,2
2021331,2021899,568,0,0,1,1
2021331,2021900,569,0,0,1,2
2021900,2022394,494,1,0,0,1
2021901,2021955,54,1,0,0,2
2021956,2022078,122,0,0,1,2
2022079,2022099,20,1,0,0,2
2022100,2022263,163,0,0,1,2
2022264,2022286,22,1,0,0,2
2022287,2023035,748,0,0,1,2
2022395,2022921,526,0,0,1,1
2022922,2025177,2255,1,0,0,1
2023036,2023146,110,1,0,0,2
2023095,2023174,79,0,1,0,1
2023147,2023482,335,0,0,1,2
2023483,2023506,23,1,0,0,2
2023507,2023905,398,0,0,1,2
2023906,2023921,15,1,0,0,2
2023922,2024892,970,0,0,1,2
2024826,2024840,14,0,1,0,1
2024862,2024862,0,0,1,0,1
2024893,2024942,49,1,0,0,2
2024904,2024905,1,0,1,0,1
2024943,2025111,168,0,0,1,2
2025025,2025040,15,0,1,0,1
2025112,2025177,65,1,0,0,2
2025136,2025136,0,0,1,0,1
2025178,2026106,928,0,0,1,1
2025178,2026107,929,0,0,1,2
2026107,2026158,51,1,0,0,1
2026108,2026161,53,1,0,0,2
2026159,2026334,175,0,0,1,1
2026162,2026333,171,0,0,1,2
2026334,2026412,78,1,0,0,2
2026335,2026414,79,1,0,0,1
2026413,2026514,101,0,0,1,2
2026415,2026517,102,0,0,1,1
2026515,2026547,32,1,0,0,2
2026518,2026538,20,1,0,0,1
2026539,2028038,1499,0,0,1,1
2026548,2028039,1491,0,0,1,2
2028039,2028108,69,1,0,0,1
2028040,2028102,62,1,0,0,2
2028103,2028431,328,0,0,1,2
2028109,2028428,319,0,0,1,1
2028429,2028460,31,1,0,0,1
2028432,2028447,15,1,0,0,2
2028448,2029069,621,0,0,1,2
2028461,2029062,601,0,0,1,1
2029063,2029092,29,1,0,0,1
2029070,2029082,12,1,0,0,2
2029083,2030121,1038,0,0,1,2
2029093,2030120,1027,0,0,1,1
2030121,2030193,72,1,0,0,1
2030122,2030199,77,1,0,0,2
2030194,2030465,271,0,0,1,1
2030200,2030464,264,0,0,1,2
2030465,2030515,50,1,0,0,2
2030466,2030512,46,1,0,0,1
2030513,2031609,1096,0,0,1,1
2030516,2031610,1094,0,0,1,2
2031610,2031646,36,1,0,0,1
2031611,2031644,33,1,0,0,2
2031645,2032045,400,0,0,1,2
2031647,2032046,399,0,0,1,1
2032046,2032117,71,1,0,0,2
2032047,2032120,73,1,0,0,1
2032118,2032214,96,0,0,1,2
2032121,2032214,93,0,0,1,1
2032215,2032245,30,1,0,0,2
2032215,2032247,32,1,0,0,1
2032246,2032929,683,0,0,1,2
2032248,2032930,682,0,0,1,1
2032930,2032959,29,1,0,0,2
2032931,2032963,32,1,0,0,1
2032960,2033103,143,0,0,1,2
2032964,2033109,145,0,0,1,1
2033104,2033121,17,1,0,0,2
2033110,2033120,10,1,0,0,1
2033121,2033314,193,0,0,1,1
2033122,2033315,193,0,0,1,2
2033315,2033384,69,1,0,0,1
2033316,2033388,72,1,0,0,2
2033385,2033875,490,0,0,1,1
2033389,2034358,969,0,0,1,2
2033876,2033896,20,1,0,0,1
2033897,2034360,463,0,0,1,1
2034359,2034375,16,1,0,0,2
2034361,2034386,25,1,0,0,1
2034376,2035700,1324,0,0,1,2
2034387,2035699,1312,0,0,1,1
2035700,2035758,58,1,0,0,1
2035701,2035750,49,1,0,0,2
2035751,2036875,1124,0,0,1,2
2035759,2036874,1115,0,0,1,1
2036875,2037244,369,1,0,0,1
2036876,2036993,117,1,0,0,2
2036961,2036991,30,0,1,0,1
2036994,2037167,173,0,0,1,2
2037168,2037190,22,1,0,0,2
2037191,2037799,608,0,0,1,2
2037245,2037291,46,0,0,1,1
2037292,2039132,1840,1,0,0,1
2037800,2037811,11,1,0,0,2
2037812,2038575,763,0,0,1,2
2038576,2038632,56,1,0,0,2
2038633,2038913,280,0,0,1,2
2038914,2038954,40,1,0,0,2
2038955,2039252,297,0,0,1,2
2039133,2039249,116,0,0,1,1
2039250,2039282,32,1,0,0,1
2039253,2039274,21,1,0,0,2
2039275,2040298,1023,0,0,1,2
2039283,2039478,195,0,0,1,1
2039479,2040744,1265,1,0,0,1
2040299,2040342,43,1,0,0,2
2040343,2040667,324,0,0,1,2
2040668,2040730,62,1,0,0,2
2040731,2041543,812,0,0,1,2
2040745,2041543,798,0,0,1,1
2041544,2041573,29,1,0,0,1
2041544,2041577,33,1,0,0,2
2041574,2042438,864,0,0,1,1
2041578,2042437,859,0,0,1,2
2042438,2042503,65,1,0,0,2
2042439,2042506,67,1,0,0,1
2042504,2042603,99,0,0,1,2
2042507,2042604,97,0,0,1,1
2042604,2042639,35,1,0,0,2
2042605,2042629,24,1,0,0,1
2042630,2044022,1392,0,0,1,1
2042640,2044025,1385,0,0,1,2
2044023,2044046,23,1,0,0,1
2044026,2044035,9,1,0,0,2
2044036,2044267,231,0,0,1,2
2044047,2044267,220,0,0,1,1
2044268,2044315,47,1,0,0,2
2044268,2044316,48,1,0,0,1
2044316,2044558,242,0,0,1,2
2044317,2044558,241,0,0,1,1
2044559,2044586,27,1,0,0,2
2044559,2044593,34,1,0,0,1
2044587,2044786,199,0,0,1,2
2044594,2044784,190,0,0,1,1
2044785,2044815,30,1,0,0,1
2044787,2044806,19,1,0,0,2
2044807,2046445,1638,0,0,1,2
2044816,2046442,1626,0,0,1,1
2046443,2046687,244,1,0,0,1
2046446,2046552,106,1,0,0,2
2046553,2046980,427,0,0,1,2
2046688,2046981,293,0,0,1,1
2046981,2047035,54,1,0,0,2
2046982,2047017,35,1,0,0,1
2047018,2047083,65,0,0,1,1
2047036,2047353,317,0,0,1,2
2047084,2047092,8,1,0,0,1
2047093,2047353,260,0,0,1,1
2047354,2047379,25,1,0,0,1
2047354,2047381,27,1,0,0,2
2047380,2047751,371,0,0,1,1
2047382,2047754,372,0,0,1,2
2047752,2047874,122,1,0,0,1
2047755,2047781,26,1,0,0,2
2047782,2048369,587,0,0,1,2
2047875,2048368,493,0,0,1,1
2048369,2048449,80,1,0,0,1
2048370,2048438,68,1,0,0,2
2048439,2048620,181,0,0,1,2
2048450,2048583,133,0,0,1,1
2048584,2048661,77,1,0,0,1
2048621,2048654,33,1,0,0,2
2048655,2049162,507,0,0,1,2
2048662,2048719,57,0,0,1,1
2048720,2049042,322,1,0,0,1
2049043,2049081,38,0,0,1,1
2049082,2049211,129,1,0,0,1
2049163,2049181,18,1,0,0,2
2049182,2049432,250,0,0,1,2
2049212,2049232,20,0,0,1,1
2049233,2049379,146,1,0,0,1
2049380,2049404,24,0,0,1,1
2049405,2049505,100,1,0,0,1
2049433,2049498,65,1,0,0,2
2049499,2049657,158,0,0,1,2
2049506,2049657,151,0,0,1,1
2049658,2049677,19,1,0,0,2
2049658,2049685,27,1,0,0,1
2049678,2050056,378,0,0,1,2
2049686,2050052,366,0,0,1,1
2050053,2050081,28,1,0,0,1
2050057,2050069,12,1,0,0,2
2050070,2051549,1479,0,0,1,2
2050082,2051550,1468,0,0,1,1
2051550,2051610,60,1,0,0,2
2051551,2051609,58,1,0,0,1
2051610,2052220,610,0,0,1,1
2051611,2052221,610,0,0,1,2
2052221,2052273,52,1,0,0,1
2052222,2052273,51,1,0,0,2
2052274,2052845,571,0,0,1,1
2052274,2052846,572,0,0,1,2
2052846,2052927,81,1,0,0,1
2052847,2052917,70,1,0,0,2
2052918,2053008,90,0,0,1,2
2052928,2053008,80,0,0,1,1
2053009,2053044,35,1,0,0,1
2053009,2053044,35,1,0,0,2
2053045,2053098,53,0,0,1,1
2053045,2054169,1124,0,0,1,2
2053099,2053103,4,1,0,0,1
2053104,2053224,120,0,0,1,1
2053225,2053297,72,1,0,0,1
2053298,2053348,50,0,0,1,1
2053349,2053359,10,1,0,0,1
2053360,2053467,107,0,0,1,1
2053468,2053502,34,1,0,0,1
2053503,2053547,44,0,0,1,1
2053548,2053570,22,1,0,0,1
2053571,2053676,105,0,0,1,1
2053677,2054230,553,1,0,0,1
2054170,2054222,52,1,0,0,2
2054223,2054479,256,0,0,1,2
2054231,2054427,196,0,0,1,1
2054428,2056804,2376,1,0,0,1
2054480,2054512,32,1,0,0,2
2054513,2055169,656,0,0,1,2
2055170,2055201,31,1,0,0,2
2055202,2056354,1152,0,0,1,2
2056355,2056422,67,1,0,0,2
2056423,2056910,487,0,0,1,2
2056805,2056911,106,0,0,1,1
2056911,2056964,53,1,0,0,2
2056912,2056960,48,1,0,0,1
2056961,2057734,773,0,0,1,1
2056965,2057733,768,0,0,1,2
2057734,2057820,86,1,0,0,2
2057735,2057815,80,1,0,0,1
2057816,2057913,97,0,0,1,1
2057821,2057914,93,0,0,1,2
2057914,2057938,24,1,0,0,1
2057915,2057982,67,1,0,0,2
2057939,2058954,1015,0,0,1,1
2057983,2058097,114,0,0,1,2
2058098,2058113,15,1,0,0,2
2058114,2058258,144,0,0,1,2
2058259,2058277,18,1,0,0,2
2058278,2058501,223,0,0,1,2
2058502,2059727,1225,1,0,0,2
2058955,2059007,52,1,0,0,1
2059008,2059105,97,0,0,1,1
2059106,2059167,61,1,0,0,1
2059168,2059232,64,0,0,1,1
2059233,2059390,157,1,0,0,1
2059391,2059421,30,0,0,1,1
2059422,2059555,133,1,0,0,1
2059556,2059658,102,0,0,1,1
2059659,2059741,82,1,0,0,1
2059728,2059922,194,0,0,1,2
2059742,2059921,179,0,0,1,1
2059922,2059952,30,1,0,0,1
2059923,2059948,25,1,0,0,2
2059949,2060496,547,0,0,1,2
2059953,2060496,543,0,0,1,1
2060497,2060517,20,1,0,0,2
2060497,2060526,29,1,0,0,1
2060518,2061182,664,0,0,1,2
2060527,2061187,660,0,0,1,1
2061183,2061225,42,1,0,0,2
2061188,2061212,24,1,0,0,1
2061213,2061750,537,0,0,1,1
2061226,2061750,524,0,0,1,2
2061751,2061880,129,1,0,0,2
2061751,2062078,327,1,0,0,1
2061881,2063446,1565,0,0,1,2
2062079,2063445,1366,0,0,1,1
2063446,2063484,38,1,0,0,1
2063447,2063481,34,1,0,0,2
2063482,2063719,237,0,0,1,2
2063485,2063719,234,0,0,1,1
2063720,2063785,65,1,0,0,1
2063720,2063798,78,1,0,0,2
2063786,2064685,899,0,0,1,1
2063799,2064705,906,0,0,1,2
2064686,2064690,4,1,0,0,1
2064691,2064739,48,0,0,1,1
2064706,2064813,107,1,0,0,2
2064740,2065051,311,1,0,0,1
2064814,2065285,471,0,0,1,2
2065052,2065103,51,0,0,1,1
2065104,2065491,387,1,0,0,1
2065286,2065308,22,1,0,0,2
2065309,2066272,963,0,0,1,2
2065492,2065533,41,0,0,1,1
2065534,2065575,41,1,0,0,1
2065576,2065634,58,0,0,1,1
2065635,2066612,977,1,0,0,1
2066273,2066293,20,1,0,0,2
2066294,2066867,573,0,0,1,2
2066613,2066636,23,0,0,1,1
2066637,2067073,436,1,0,0,1
2066868,2066933,65,1,0,0,2
2066934,2067642,708,0,0,1,2
2067074,2067644,570,0,0,1,1
2067643,2067695,52,1,0,0,2
2067645,2067687,42,1,0,0,1
2067688,2068121,433,0,0,1,1
2067696,2068121,425,0,0,1,2
2068122,2068192,70,1,0,0,2
2068122,2068194,72,1,0,0,1
2068193,2068423,230,0,0,1,2
2068195,2068426,231,0,0,1,1
2068424,2068455,31,1,0,0,2
2068427,2068454,27,1,0,0,1
2068455,2069321,866,0,0,1,1
2068456,2069320,864,0,0,1,2
2069321,2069373,52,1,0,0,2
2069322,2069373,51,1,0,0,1
2069374,2069634,260,0,0,1,2
2069374,2069646,272,0,0,1,1
2069635,2069754,119,1,0,0,2
2069647,2069927,280,1,0,0,1
2069755,2070141,386,0,0,1,2
2069928,2070143,215,0,0,1,1
2070142,2070374,232,1,0,0,2
2070144,2070395,251,1,0,0,1
2070188,2070305,117,0,1,0,1
2070200,2070280,80,0,1,0,2
2070375,2070785,410,0,0,1,2
2070396,2070785,389,0,0,1,1
2070786,2070806,20,1,0,0,2
2070786,2070815,29,1,0,0,1
2070807,2071776,969,0,0,1,2
2070816,2071775,959,0,0,1,1
2071776,2071805,29,1,0,0,1
2071777,2071797,20,1,0,0,2
2071798,2072131,333,0,0,1,2
2071806,2072134,328,0,0,1,1
2072132,2072157,25,1,0,0,2
2072135,2072227,92,1,0,0,1
2072158,2072502,344,0,0,1,2
2072228,2072501,273,0,0,1,1
2072502,2072547,45,1,0,0,1
2072503,2072539,36,1,0,0,2
2072540,2072797,257,0,0,1,2
2072548,2072796,248,0,0,1,1
2072797,2072880,83,1,0,0,1
2072798,2072879,81,1,0,0,2
2072880,2073131,251,0,0,1,2
2072881,2073137,256,0,0,1,1
2073132,2073158,26,1,0,0,2
2073138,2073153,15,1,0,0,1
2073154,2073459,305,0,0,1,1
2073159,2073593,434,0,0,1,2
2073460,2073501,41,1,0,0,1
2073502,2073592,90,0,0,1,1
2073593,2073626,33,1,0,0,1
2073594,2073612,18,1,0,0,2
2073613,2074119,506,0,0,1,2
2073627,2074046,419,0,0,1,1
2074047,2074078,31,1,0,0,1
2074079,2074172,93,0,0,1,1
2074120,2074124,4,1,0,0,2
2074125,2074147,22,0,0,1,2
2074148,2074236,88,1,0,0,2
2074173,2074246,73,1,0,0,1
2074237,2074535,298,0,0,1,2
2074247,2074535,288,0,0,1,1
2074536,2074567,31,1,0,0,2
2074536,2074568,32,1,0,0,1
2074568,2075682,1114,0,0,1,2
2074569,2075068,499,0,0,1,1
2075069,2075097,28,1,0,0,1
2075098,2075683,585,0,0,1,1
2075683,2075726,43,1,0,0,2
2075684,2075727,43,1,0,0,1
2075727,2076021,294,0,0,1,2
2075728,2076021,293,0,0,1,1
2076022,2076047,25,1,0,0,1
2076022,2076047,25,1,0,0,2
2076048,2076501,453,0,0,1,1
2076048,2076503,455,0,0,1,2
2076502,2076559,57,1,0,0,1
2076504,2076550,46,1,0,0,2
2076551,2077855,1304,0,0,1,2
2076560,2077856,1296,0,0,1,1
2077856,2077972,116,1,0,0,2
2077857,2077945,88,1,0,0,1
2077946,2078023,77,0,0,1,1
2077973,2078022,49,0,0,1,2
2078023,2078065,42,1,0,0,2
2078024,2078060,36,1,0,0,1
2078061,2079726,1665,0,0,1,1
2078066,2079727,1661,0,0,1,2
2079727,2079790,63,1,0,0,1
2079728,2079792,64,1,0,0,2
2079791,2080062,271,0,0,1,1
2079793,2080063,270,0,0,1,2
2080063,2080098,35,1,0,0,1
2080064,2080096,32,1,0,0,2
2080097,2081780,1683,0,0,1,2
2080099,2081779,1680,0,0,1,1
2081780,2081857,77,1,0,0,1
2081781,2081858,77,1,0,0,2
2081858,2083077,1219,0,0,1,1
2081859,2083077,1218,0,0,1,2
2083078,2083105,27,1,0,0,2
2083078,2083108,30,1,0,0,1
2083106,2083720,614,0,0,1,2
2083109,2083718,609,0,0,1,1
2083719,2083777,58,1,0,0,1
2083721,2083774,53,1,0,0,2
2083775,2084020,245,0,0,1,2
2083778,2084014,236,0,0,1,1
2084015,2084041,26,1,0,0,1
2084021,2084039,18,1,0,0,2
2084040,2084314,274,0,0,1,2
2084042,2084309,267,0,0,1,1
2084310,2084336,26,1,0,0,1
2084315,2084327,12,1,0,0,2
2084328,2085147,819,0,0,1,2
2084337,2085147,810,0,0,1,1
2085148,2085197,49,1,0,0,1
2085148,2085199,51,1,0,0,2
2085198,2085315,117,0,0,1,1
2085200,2085316,116,0,0,1,2
2085316,2085346,30,1,0,0,1
2085317,2085338,21,1,0,0,2
2085339,2086151,812,0,0,1,2
2085347,2086151,804,0,0,1,1
2086152,2086165,13,1,0,0,2
2086152,2086173,21,1,0,0,1
2086166,2087311,1145,0,0,1,2
2086174,2087312,1138,0,0,1,1
2087312,2087367,55,1,0,0,2
2087313,2087367,54,1,0,0,1
2087368,2087646,278,0,0,1,1
2087368,2087646,278,0,0,1,2
2087647,2087699,52,1,0,0,2
2087647,2087711,64,1,0,0,1
2087700,2088798,1098,0,0,1,2
2087712,2088799,1087,0,0,1,1
2088799,2088840,41,1,0,0,2
2088800,2088840,40,1,0,0,1
2088841,2088894,53,0,0,1,1
2088841,2088894,53,0,0,1,2
2088895,2088990,95,1,0,0,2
2088895,2089313,418,1,0,0,1
2088991,2089104,113,0,0,1,2
2089105,2089136,31,1,0,0,2
2089137,2089456,319,0,0,1,2
2089314,2089341,27,0,0,1,1
2089342,2090023,681,1,0,0,1
2089457,2089484,27,1,0,0,2
2089485,2090437,952,0,0,1,2
2090024,2090100,76,0,0,1,1
2090101,2090382,281,1,0,0,1
2090383,2090437,54,0,0,1,1
2090438,2090482,44,1,0,0,2
2090438,2090818,380,1,0,0,1
2090483,2090756,273,0,0,1,2
2090757,2090787,30,1,0,0,2
2090788,2091080,292,0,0,1,2
2090819,2091049,230,0,0,1,1
2091050,2092913,1863,1,0,0,1
2091081,2091104,23,1,0,0,2
2091105,2091578,473,0,0,1,2
2091579,2091583,4,1,0,0,2
2091584,2092845,1261,0,0,1,2
2092846,2092901,55,1,0,0,2
2092902,2093652,750,0,0,1,2
2092914,2093650,736,0,0,1,1
2093651,2093690,39,1,0,0,1
2093653,2093702,49,1,0,0,2
2093691,2093954,263,0,0,1,1
2093703,2093955,252,0,0,1,2
2093955,2093999,44,1,0,0,1
2093956,2094010,54,1,0,0,2
2094000,2094775,775,0,0,1,1
2094011,2094776,765,0,0,1,2
2094776,2094853,77,1,0,0,1
2094777,2094855,78,1,0,0,2
2094854,2094949,95,0,0,1,1
2094856,2094951,95,0,0,1,2
2094950,2094980,30,1,0,0,1
2094952,2094980,28,1,0,0,2
2094981,2095146,165,0,0,1,1
2094981,2095581,600,0,0,1,2
2095147,2095161,14,1,0,0,1
2095162,2095510,348,0,0,1,1
2095511,2096497,986,1,0,0,1
2095582,2095611,29,1,0,0,2
2095612,2095778,166,0,0,1,2
2095779,2095795,16,1,0,0,2
2095796,2096389,593,0,0,1,2
2096390,2096451,61,1,0,0,2
2096452,2096618,166,0,0,1,2
2096498,2096615,117,0,0,1,1
2096616,2096650,34,1,0,0,1
2096619,2096641,22,1,0,0,2
2096642,2097511,869,0,0,1,2
2096651,2096885,234,0,0,1,1
2096886,2097002,116,1,0,0,1
2097003,2097066,63,0,0,1,1
2097067,2097083,16,1,0,0,1
2097084,2097138,54,0,0,1,1
2097139,2097168,29,1,0,0,1
2097169,2097512,343,0,0,1,1
2097512,2097746,234,1,0,0,2
2097513,2098662,1149,1,0,0,1
2097524,2097626,102,0,1,0,1
2097652,2097693,41,0,1,0,1
2097715,2098591,876,0,1,0,1
2097747,2097776,29,0,0,1,2
2097777,2098038,261,1,0,0,2
2098039,2098175,136,0,0,1,2
2098176,2098306,130,1,0,0,2
2098307,2098398,91,0,0,1,2
2098399,2098504,105,1,0,0,2
2098505,2098546,41,0,0,1,2
2098547,2098622,75,1,0,0,2
2098623,2099851,1228,0,0,1,2
2098663,2099850,1187,0,0,1,1
2099851,2099885,34,1,0,0,1
2099852,2099890,38,1,0,0,2
2099886,2100394,508,0,0,1,1
2099891,2100396,505,0,0,1,2
2100395,2100460,65,1,0,0,1
2100397,2100460,63,1,0,0,2
2100461,2100541,80,0,0,1,1
2100461,2100547,86,0,0,1,2
2100542,2100629,87,1,0,0,1
2100548,2100595,47,1,0,0,2
2100596,2100852,256,0,0,1,2
2100630,2100854,224,0,0,1,1
2100853,2100874,21,1,0,0,2
2100855,2100866,11,1,0,0,1
2100867,2101517,650,0,0,1,1
2100875,2101516,641,0,0,1,2
2101517,2101578,61,1,0,0,2
2101518,2101589,71,1,0,0,1
2101579,2101896,317,0,0,1,2
2101590,2101897,307,0,0,1,1
2101897,2101923,26,1,0,0,2
2101898,2101930,32,1,0,0,1
2101924,2102067,143,0,0,1,2
2101931,2102066,135,0,0,1,1
2102067,2102240,173,1,0,0,1
2102068,2102237,169,1,0,0,2
2102101,2102183,82,0,1,0,1
2102109,2102178,69,0,1,0,2
2102238,2102642,404,0,0,1,2
2102241,2102643,402,0,0,1,1
2102643,2102686,43,1,0,0,2
2102644,2102676,32,1,0,0,1
2102677,2103617,940,0,0,1,1
2102687,2103616,929,0,0,1,2
2103617,2103696,79,1,0,0,2
2103618,2103695,77,1,0,0,1
2103696,2104194,498,0,0,1,1
2103697,2104195,498,0,0,1,2
2104195,2104239,44,1,0,0,1
2104196,2104240,44,1,0,0,2
2104240,2104657,417,0,0,1,1
2104241,2104656,415,0,0,1,2
2104657,2104687,30,1,0,0,2
2104658,2104688,30,1,0,0,1
2104688,2104912,224,0,0,1,2
2104689,2104913,224,0,0,1,1
2104913,2104999,86,1,0,0,2
2104914,2104998,84,1,0,0,1
2104999,2105103,104,0,0,1,1
2105000,2105101,101,0,0,1,2
2105102,2105140,38,1,0,0,2
2105104,2105134,30,1,0,0,1
2105135,2105653,518,0,0,1,1
2105141,2105660,519,0,0,1,2
2105654,2105684,30,1,0,0,1
2105661,2105680,19,1,0,0,2
2105681,2106017,336,0,0,1,2
2105685,2106016,331,0,0,1,1
2106017,2106092,75,1,0,0,1
2106018,2106093,75,1,0,0,2
2106093,2106361,268,0,0,1,1
2106094,2106359,265,0,0,1,2
2106360,2106435,75,1,0,0,2
2106362,2106435,73,1,0,0,1
2106436,2106614,178,0,0,1,1
2106436,2106614,178,0,0,1,2
2106615,2106651,36,1,0,0,2
2106615,2106655,40,1,0,0,1
2106652,2107139,487,0,0,1,2
2106656,2107137,481,0,0,1,1
2107138,2107173,35,1,0,0,1
2107140,2107162,22,1,0,0,2
2107163,2107850,687,0,0,1,2
2107174,2107848,674,0,0,1,1
2107849,2107924,75,1,0,0,1
2107851,2107925,74,1,0,0,2
2107925,2108410,485,0,0,1,1
2107926,2108410,484,0,0,1,2
2108411,2108455,44,1,0,0,1
2108411,2108455,44,1,0,0,2
2108456,2108790,334,0,0,1,1
2108456,2108791,335,0,0,1,2
2108791,2108819,28,1,0,0,1
2108792,2108814,22,1,0,0,2
2108815,2109882,1067,0,0,1,2
2108820,2109883,1063,0,0,1,1
2109883,2110028,145,1,0,0,2
2109884,2110059,175,1,0,0,1
2110029,2110060,31,0,0,1,2
2110060,2110231,171,0,0,1,1
2110061,2110095,34,1,0,0,2
2110096,2110229,133,0,0,1,2
2110230,2110253,23,1,0,0,2
2110232,2110253,21,1,0,0,1
2110254,2111267,1013,0,0,1,1
2110254,2111267,1013,0,0,1,2
2111268,2111330,62,1,0,0,1
2111268,2111331,63,1,0,0,2
2111331,2111502,171,0,0,1,1
2111332,2111503,171,0,0,1,2
2111503,2111524,21,1,0,0,1
2111504,2111525,21,1,0,0,2
2111525,2112576,1051,0,0,1,1
2111526,2112572,1046,0,0,1,2
2112573,2112593,20,1,0,0,2
2112577,2112590,13,1,0,0,1
2112591,2113341,750,0,0,1,1
2112594,2113342,748,0,0,1,2
2113342,2113424,82,1,0,0,1
2113343,2113426,83,1,0,0,2
2113425,2114084,659,0,0,1,1
2113427,2114085,658,0,0,1,2
2114085,2114129,44,1,0,0,1
2114086,2114130,44,1,0,0,2
2114130,2114826,696,0,0,1,1
2114131,2114839,708,0,0,1,2
2114827,2114845,18,1,0,0,1
2114840,2114850,10,1,0,0,2
2114846,2114919,73,0,0,1,1
2114851,2114919,68,0,0,1,2
2114920,2114960,40,1,0,0,1
2114920,2114961,41,1,0,0,2
2114961,2115224,263,0,0,1,1
2114962,2115225,263,0,0,1,2
2115225,2115268,43,1,0,0,1
2115226,2115270,44,1,0,0,2
2115269,2115548,279,0,0,1,1
2115271,2115547,276,0,0,1,2
2115548,2115591,43,1,0,0,2
2115549,2115593,44,1,0,0,1
2115592,2115973,381,0,0,1,2
2115594,2115971,377,0,0,1,1
2115972,2116025,53,1,0,0,1
2115974,2116024,50,1,0,0,2
2116025,2116396,371,0,0,1,2
2116026,2116397,371,0,0,1,1
2116397,2116434,37,1,0,0,2
2116398,2116424,26,1,0,0,1
2116425,2116775,350,0,0,1,1
2116435,2116774,339,0,0,1,2
2116775,2116800,25,1,0,0,2
2116776,2116799,23,1,0,0,1
2116800,2117158,358,0,0,1,1
2116801,2117159,358,0,0,1,2
2117159,2117518,359,1,0,0,1
2117160,2117455,295,1,0,0,2
2117217,2117412,195,0,1,0,1
2117231,2117401,170,0,1,0,2
2117456,2117645,189,0,0,1,2
2117519,2117638,119,0,0,1,1
2117639,2117660,21,1,0,0,1
2117646,2122698,5052,1,0,0,2
2117661,2117685,24,0,0,1,1
2117686,2122706,5020,1,0,0,1
2117780,2122495,4715,0,1,0,2
2117785,2117787,2,0,1,0,1
2117814,2122620,4806,0,1,0,1
2122534,2122569,35,0,1,0,2
2122699,2122801,102,0,0,1,2
2122707,2122859,152,0,0,1,1
2122802,2122850,48,1,0,0,2
2122851,2122911,60,0,0,1,2
2122860,2122873,13,1,0,0,1
2122874,2122912,38,0,0,1,1
2122912,2122964,52,1,0,0,2
2122913,2122940,27,1,0,0,1
2122941,2123270,329,0,0,1,1
2122965,2123273,308,0,0,1,2
2123271,2123318,47,1,0,0,1
2123274,2123308,34,1,0,0,2
2123309,2123522,213,0,0,1,2
2123319,2123517,198,0,0,1,1
2123518,2123754,236,1,0,0,1
2123523,2123707,184,1,0,0,2
2123557,2123675,118,0,1,0,1
2123560,2123659,99,0,1,0,2
2123708,2124252,544,0,0,1,2
2123755,2124253,498,0,0,1,1
2124253,2124275,22,1,0,0,2
2124254,2124283,29,1,0,0,1
2124276,2124514,238,0,0,1,2
2124284,2124514,230,0,0,1,1
2124515,2124537,22,1,0,0,2
2124515,2124546,31,1,0,0,1
2124538,2124854,316,0,0,1,2
2124547,2124702,155,0,0,1,1
2124703,2124754,51,1,0,0,1
2124755,2124821,66,0,0,1,1
2124822,2124900,78,1,0,0,1
2124855,2124892,37,1,0,0,2
2124893,2125265,372,0,0,1,2
2124901,2125267,366,0,0,1,1
2125266,2125305,39,1,0,0,2
2125268,2125294,26,1,0,0,1
2125295,2125654,359,0,0,1,1
2125306,2125655,349,0,0,1,2
2125655,2125684,29,1,0,0,1
2125656,2125673,17,1,0,0,2
2125674,2126055,381,0,0,1,2
2125685,2126056,371,0,0,1,1
2126056,2126093,37,1,0,0,2
2126057,2126091,34,1,0,0,1
2126092,2126330,238,0,0,1,1
2126094,2126332,238,0,0,1,2
2126331,2126519,188,1,0,0,1
2126333,2126514,181,1,0,0,2
2126351,2126472,121,0,1,0,1
2126355,2126453,98,0,1,0,2
2126515,2126827,312,0,0,1,2
2126520,2126563,43,0,0,1,1
2126564,2126592,28,1,0,0,1
2126593,2126827,234,0,0,1,1
2126828,2126861,33,1,0,0,1
2126828,2126876,48,1,0,0,2
2126862,2127027,165,0,0,1,1
2126877,2127155,278,0,0,1,2
2127028,2127155,127,1,0,0,1
2179718,2179940,222,0,0,1,1
2179718,2179940,222,0,0,1,2
2179941,2179990,49,1,0,0,1
2179941,2179990,49,1,0,0,2
2179991,2180167,176,0,0,1,2
2179991,2180168,177,0,0,1,1
2180168,2180186,18,1,0,0,2
2180169,2180223,54,1,0,0,1
2180187,2181336,1149,0,0,1,2
2180224,2180279,55,0,0,1,1
2180280,2180288,8,1,0,0,1
2180289,2181336,1047,0,0,1,1
2181337,2181346,9,1,0,0,1
2181337,2181353,16,1,0,0,2
2181347,2181699,352,0,0,1,1
2181354,2181699,345,0,0,1,2
2181700,2181753,53,1,0,0,2
2181700,2181754,54,1,0,0,1
2181754,2181933,179,0,0,1,2
2181755,2181934,179,0,0,1,1
2181934,2182006,72,1,0,0,2
2181935,2182011,76,1,0,0,1
2182007,2182077,70,0,0,1,2
2182012,2182076,64,0,0,1,1
2182077,2182119,42,1,0,0,1
2182078,2182106,28,1,0,0,2
2182107,2182314,207,0,0,1,2
2182120,2182312,192,0,0,1,1
2182313,2182335,22,1,0,0,1
2182315,2182333,18,1,0,0,2
2182334,2183266,932,0,0,1,2
2182336,2183263,927,0,0,1,1
2183264,2183380,116,1,0,0,1
2183267,2183385,118,1,0,0,2
2183381,2183434,53,0,0,1,1
2183386,2183746,360,0,0,1,2
2183435,2183443,8,1,0,0,1
2183444,2183745,301,0,0,1,1
2183746,2183825,79,1,0,0,1
2183747,2183817,70,1,0,0,2
2183818,2184066,248,0,0,1,2
2183826,2184065,239,0,0,1,1
2184066,2184092,26,1,0,0,1
2184067,2184090,23,1,0,0,2
2184091,2184987,896,0,0,1,2
2184093,2184985,892,0,0,1,1
2184986,2185083,97,1,0,0,1
2184988,2185085,97,1,0,0,2
2185084,2185409,325,0,0,1,1
2185086,2185409,323,0,0,1,2
2185410,2185486,76,1,0,0,1
2185410,2185486,76,1,0,0,2
2185487,2185586,99,0,0,1,2
2185487,2185587,100,0,0,1,1
2185587,2185621,34,1,0,0,2
2185588,2185673,85,1,0,0,1
2185622,2186698,1076,0,0,1,2
2185674,2185789,115,0,0,1,1
2185790,2185803,13,1,0,0,1
2185804,2186697,893,0,0,1,1
2186698,2186789,91,1,0,0,1
2186699,2186784,85,1,0,0,2
2186785,2187153,368,0,0,1,2
2186790,2187152,362,0,0,1,1
2187153,2187255,102,1,0,0,1
2187154,2187238,84,1,0,0,2
2187239,2187340,101,0,0,1,2
2187256,2187339,83,0,0,1,1
2187340,2187443,103,1,0,0,1
2187341,2187373,32,1,0,0,2
2187374,2188534,1160,0,0,1,2
2187444,2187804,360,0,0,1,1
2187805,2187862,57,1,0,0,1
2187863,2187903,40,0,0,1,1
2187904,2187994,90,1,0,0,1
2187995,2188019,24,0,0,1,1
2188020,2188631,611,1,0,0,1
2188535,2188617,82,1,0,0,2
2188618,2189029,411,0,0,1,2
2188632,2189028,396,0,0,1,1
2189029,2190353,1324,1,0,0,1
2189030,2189412,382,1,0,0,2
2189106,2190344,1238,0,1,0,1
2189413,2189440,27,0,0,1,2
2189441,2189531,90,1,0,0,2
2189532,2189630,98,0,0,1,2
2189631,2189645,14,1,0,0,2
2189646,2189816,170,0,0,1,2
2189817,2190345,528,1,0,0,2
2190346,2190687,341,0,0,1,2
2190354,2190668,314,0,0,1,1
2190669,2190774,105,1,0,0,1
2190688,2190759,71,1,0,0,2
2190760,2190878,118,0,0,1,2
2190775,2190876,101,0,0,1,1
2190877,2190899,22,1,0,0,1
2190879,2190906,27,1,0,0,2
2190900,2191123,223,0,0,1,1
2190907,2191125,218,0,0,1,2
2191124,2191139,15,1,0,0,1
2191126,2191136,10,1,0,0,2
2191137,2191845,708,0,0,1,2
2191140,2191847,707,0,0,1,1
2191846,2191990,144,1,0,0,2
2191848,2192132,284,1,0,0,1
2191937,2191973,36,0,1,0,1
2191991,2192288,297,0,0,1,2
2192133,2192287,154,0,0,1,1
2192288,2192356,68,1,0,0,1
2192289,2192360,71,1,0,0,2
2192357,2192432,75,0,0,1,1
2192361,2192433,72,0,0,1,2
2192433,2192501,68,1,0,0,1
2192434,2192501,67,1,0,0,2
2192502,2192581,79,0,0,1,2
2192502,2192582,80,0,0,1,1
2192582,2192607,25,1,0,0,2
2192583,2192619,36,1,0,0,1
2192608,2193918,1310,0,0,1,2
2192620,2193917,1297,0,0,1,1
2193918,2194013,95,1,0,0,1
2193919,2194014,95,1,0,0,2
2194014,2194159,145,0,0,1,1
2194015,2194159,144,0,0,1,2
2194160,2194229,69,1,0,0,2
2194160,2194236,76,1,0,0,1
2194230,2194359,129,0,0,1,2
2194237,2194336,99,0,0,1,1
2194337,2194427,90,1,0,0,1
2194360,2194383,23,1,0,0,2
2194384,2195408,1024,0,0,1,2
2194428,2195407,979,0,0,1,1
2195408,2195474,66,1,0,0,1
2195409,2195475,66,1,0,0,2
2195475,2195798,323,0,0,1,1
2195476,2195857,381,0,0,1,2
2195799,2195815,16,1,0,0,1
2195816,2195855,39,0,0,1,1
2195856,2195937,81,1,0,0,1
2195858,2195926,68,1,0,0,2
2195927,2196249,322,0,0,1,2
2195938,2196248,310,0,0,1,1
2196249,2196277,28,1,0,0,1
2196250,2196268,18,1,0,0,2
2196269,2196446,177,0,0,1,2
2196278,2196413,135,0,0,1,1
2196414,2196604,190,1,0,0,1
2196447,2196459,12,1,0,0,2
2196460,2197107,647,0,0,1,2
2196605,2197107,502,0,0,1,1
2197108,2197195,87,1,0,0,1
2197108,2197196,88,1,0,0,2
2197196,2197642,446,0,0,1,1
2197197,2197643,446,0,0,1,2
2197643,2197737,94,1,0,0,1
2197644,2197728,84,1,0,0,2
2197729,2197804,75,0,0,1,2
2197738,2197804,66,0,0,1,1
2197805,2197849,44,1,0,0,1
2197805,2197850,45,1,0,0,2
2197850,2198003,153,0,0,1,1
2197851,2198004,153,0,0,1,2
2198004,2198033,29,1,0,0,1
2198005,2198023,18,1,0,0,2
2198024,2198819,795,0,0,1,2
2198034,2198818,784,0,0,1,1
2198819,2198916,97,1,0,0,1
2198820,2198915,95,1,0,0,2
2198916,2199359,443,0,0,1,2
2198917,2199358,441,0,0,1,1
2199359,2200364,1005,1,0,0,1
2199360,2199447,87,1,0,0,2
2199448,2199608,160,0,0,1,2
2199592,2200322,730,0,1,0,1
2199609,2199645,36,1,0,0,2
2199646,2199984,338,0,0,1,2
2199985,2199992,7,1,0,0,2
2199993,2200021,28,0,0,1,2
2200022,2200091,69,1,0,0,2
2200092,2200127,35,0,0,1,2
2200128,2200363,235,1,0,0,2
2200364,2201107,743,0,0,1,2
2200365,2201107,742,0,0,1,1
2201108,2201185,77,1,0,0,2
2201108,2201225,117,1,0,0,1
2201186,2201286,100,0,0,1,2
2201226,2201282,56,0,0,1,1
2201283,2202880,1597,1,0,0,1
2201287,2201320,33,1,0,0,2
2201321,2202186,865,0,0,1,2
2202187,2202255,68,1,0,0,2
2202256,2202599,343,0,0,1,2
2202600,2202672,72,1,0,0,2
2202673,2203076,403,0,0,1,2
2202881,2203997,1116,0,0,1,1
2203077,2203087,10,1,0,0,2
2203088,2203995,907,0,0,1,2
2203996,2204081,85,1,0,0,2
2203998,2204081,83,1,0,0,1
2204082,2204459,377,0,0,1,1
2204082,2204460,378,0,0,1,2
2204460,2204541,81,1,0,0,1
2204461,2204539,78,1,0,0,2
2204540,2204731,191,0,0,1,2
2204542,2204626,84,0,0,1,1
2204627,2205597,970,1,0,0,1
2204732,2204765,33,1,0,0,2
2204766,2205024,258,0,0,1,2
2205025,2205036,11,1,0,0,2
2205037,2205510,473,0,0,1,2
2205511,2205594,83,1,0,0,2
2205595,2206021,426,0,0,1,2
2205598,2205749,151,0,0,1,1
2205750,2205761,11,1,0,0,1
2205762,2206020,258,0,0,1,1
2206021,2207705,1684,1,0,0,1
2206022,2206166,144,1,0,0,2
2206087,2207499,1412,0,1,0,1
2206167,2206252,85,0,0,1,2
2206253,2206285,32,1,0,0,2
2206286,2206391,105,0,0,1,2
2206392,2206407,15,1,0,0,2
2206408,2206704,296,0,0,1,2
2206705,2207040,335,1,0,0,2
2207041,2207234,193,0,0,1,2
2207235,2207529,294,1,0,0,2
2207299,2207432,133,0,1,0,2
2207530,2207733,203,0,0,1,2
2207706,2207732,26,0,0,1,1
2207733,2208955,1222,1,0,0,1
2207734,2207959,225,1,0,0,2
2207825,2208944,1119,0,1,0,1
2207960,2208064,104,0,0,1,2
2208065,2209112,1047,1,0,0,2
2208455,2208861,406,0,1,0,2
2208956,2208982,26,0,0,1,1
2208983,2209007,24,1,0,0,1
2209008,2209042,34,0,0,1,1
2209043,2209052,9,1,0,0,1
2209053,2209146,93,0,0,1,1
2209113,2209145,32,0,0,1,2
2209146,2209194,48,1,0,0,2
2209147,2209223,76,1,0,0,1
2209195,2209275,80,0,0,1,2
2209224,2209275,51,0,0,1,1
2209276,2209358,82,1,0,0,1
2209276,2209398,122,1,0,0,2
2209359,2209500,141,0,0,1,1
2209399,2209504,105,0,0,1,2
2209501,2209518,17,1,0,0,1
2209505,2209519,14,1,0,0,2
2209519,2210282,763,0,0,1,1
2209520,2210283,763,0,0,1,2
2210283,2210374,91,1,0,0,1
2210284,2210375,91,1,0,0,2
2210375,2210706,331,0,0,1,1
2210376,2210706,330,0,0,1,2
2210707,2210797,90,1,0,0,1
2210707,2210797,90,1,0,0,2
2210798,2210868,70,0,0,1,2
2210798,2210869,71,0,0,1,1
2210869,2210904,35,1,0,0,2
2210870,2210908,38,1,0,0,1
2210905,2211410,505,0,0,1,2
2210909,2211069,160,0,0,1,1
2211070,2211097,27,1,0,0,1
2211098,2211637,539,0,0,1,1
2211411,2211461,50,1,0,0,2
2211462,2211637,175,0,0,1,2
2211638,2211713,75,1,0,0,2
2211638,2211720,82,1,0,0,1
2211714,2212045,331,0,0,1,2
2211721,2212046,325,0,0,1,1
2212046,2212106,60,1,0,0,2
2212047,2212100,53,1,0,0,1
2212101,2212316,215,0,0,1,1
2212107,2213067,960,0,0,1,2
2212317,2212335,18,1,0,0,1
2212336,2213066,730,0,0,1,1
2213067,2213112,45,1,0,0,1
2213068,2213102,34,1,0,0,2
2213103,2213509,406,0,0,1,2
2213113,2213508,395,0,0,1,1
2213509,2213636,127,1,0,0,1
2213510,2213587,77,1,0,0,2
2213588,2213666,78,0,0,1,2
2213637,2213663,26,0,0,1,1
2213664,2213704,40,1,0,0,1
2213667,2213693,26,1,0,0,2
2213694,2214704,1010,0,0,1,2
2213705,2214703,998,0,0,1,1
2214704,2214768,64,1,0,0,1
2214705,2214768,63,1,0,0,2
2214769,2215013,244,0,0,1,1
2214769,2215014,245,0,0,1,2
2215014,2215123,109,1,0,0,1
2215015,2215117,102,1,0,0,2
2215118,2215211,93,0,0,1,2
2215124,2215211,87,0,0,1,1
2215212,2215245,33,1,0,0,1
2215212,2215247,35,1,0,0,2
2215246,2215507,261,0,0,1,1
2215248,2215506,258,0,0,1,2
2215507,2215519,12,1,0,0,2
2215508,2215529,21,1,0,0,1
2215520,2216013,493,0,0,1,2
2215530,2215789,259,0,0,1,1
2215790,2216148,358,1,0,0,1
2216014,2216089,75,1,0,0,2
2216090,2216534,444,0,0,1,2
2216149,2216535,386,0,0,1,1
2216535,2216615,80,1,0,0,2
2216536,2216624,88,1,0,0,1
2216616,2216731,115,0,0,1,2
2216625,2216732,107,0,0,1,1
2216732,2216765,33,1,0,0,2
2216733,2216763,30,1,0,0,1
2216764,2217463,699,0,0,1,1
2216766,2217464,698,0,0,1,2
2217464,2217564,100,1,0,0,1
2217465,2217557,92,1,0,0,2
2217558,2217922,364,0,0,1,2
2217565,2217922,357,0,0,1,1
2217923,2218059,136,1,0,0,2
2217923,2218078,155,1,0,0,1
2218060,2218134,74,0,0,1,2
2218079,2218113,34,0,0,1,1
2218114,2218140,26,1,0,0,1
2218135,2218202,67,1,0,0,2
2218141,2218170,29,0,0,1,1
2218171,2218200,29,1,0,0,1
2218201,2219340,1139,0,0,1,1
2218203,2219340,1137,0,0,1,2
2219341,2219410,69,1,0,0,2
2219341,2219411,70,1,0,0,1
2219411,2219555,144,0,0,1,2
2219412,2219556,144,0,0,1,1
2219556,2219613,57,1,0,0,2
2219557,2219622,65,1,0,0,1
2219614,2219759,145,0,0,1,2
2219623,2219758,135,0,0,1,1
2219759,2219791,32,1,0,0,1
2219760,2219789,29,1,0,0,2
2219790,2220420,630,0,0,1,2
2219792,2220419,627,0,0,1,1
2220420,2220482,62,1,0,0,1
2220421,2220480,59,1,0,0,2
2220481,2220796,315,0,0,1,2
2220483,2220796,313,0,0,1,1
2220797,2220863,66,1,0,0,2
2220797,2220865,68,1,0,0,1
2220864,2220949,85,0,0,1,2
2220866,2220950,84,0,0,1,1
2220950,2220983,33,1,0,0,2
2220951,2220981,30,1,0,0,1
2220982,2222265,1283,0,0,1,1
2220984,2222266,1282,0,0,1,2
2222266,2222410,144,1,0,0,1
2222267,2222387,120,1,0,0,2
2222388,2223192,804,0,0,1,2
2222411,2222483,72,0,0,1,1
2222484,2222496,12,1,0,0,1
2222497,2223187,690,0,0,1,1
2223188,2223215,27,1,0,0,1
2223193,2223204,11,1,0,0,2
2223205,2223757,552,0,0,1,2
2223216,2223756,540,0,0,1,1
2223757,2225508,1751,1,0,0,1
2223758,2223846,88,1,0,0,2
2223847,2224291,444,0,0,1,2
2224292,2224319,27,1,0,0,2
2224320,2224963,643,0,0,1,2
2224964,2224997,33,1,0,0,2
2224998,2225067,69,0,0,1,2
2225068,2225484,416,1,0,0,2
2225485,2225602,117,0,0,1,2
2225509,2225601,92,0,0,1,1
2225602,2225647,45,1,0,0,1
2225603,2225638,35,1,0,0,2
2225639,2225844,205,0,0,1,2
2225648,2225846,198,0,0,1,1
2225845,2225856,11,1,0,0,2
2225847,2225865,18,1,0,0,1
2225857,2226667,810,0,0,1,2
2225866,2226666,800,0,0,1,1
2226667,2226754,87,1,0,0,1
2226668,2226756,88,1,0,0,2
2226755,2227000,245,0,0,1,1
2226757,2226999,242,0,0,1,2
2227000,2227054,54,1,0,0,2
2227001,2227052,51,1,0,0,1
2227053,2227184,131,0,0,1,1
2227055,2227184,129,0,0,1,2
2227185,2227220,35,1,0,0,1
2227185,2227220,35,1,0,0,2
2227221,2228766,1545,0,0,1,1
2227221,2228766,1545,0,0,1,2
2228767,2228865,98,1,0,0,2
2228767,2228941,174,1,0,0,1
2228866,2228932,66,0,0,1,2
2228933,2229752,819,1,0,0,2
2228942,2228972,30,0,0,1,1
2228973,2229908,935,1,0,0,1
2228992,2229155,163,0,1,0,1
2229187,2229192,5,0,1,0,1
2229251,2229839,588,0,1,0,1
2229753,2229793,40,0,0,1,2
2229794,2229913,119,1,0,0,2
2229909,2230390,481,0,0,1,1
2229914,2230392,478,0,0,1,2
2230391,2230442,51,1,0,0,1
2230393,2230441,48,1,0,0,2
2230442,2230621,179,0,0,1,2
2230443,2230620,177,0,0,1,1
2230621,2230648,27,1,0,0,1
2230622,2230640,18,1,0,0,2
2230641,2231881,1240,0,0,1,2
2230649,2231883,1234,0,0,1,1
2231882,2231937,55,1,0,0,2
2231884,2231947,63,1,0,0,1
2231938,2233318,1380,0,0,1,2
2231948,2233316,1368,0,0,1,1
2233317,2234398,1081,1,0,0,1
2233319,2233360,41,1,0,0,2
2233361,2233521,160,0,0,1,2
2233522,2233544,22,1,0,0,2
2233545,2234323,778,0,0,1,2
2234324,2234405,81,1,0,0,2
2234399,2234762,363,0,0,1,1
2234406,2234764,358,0,0,1,2
2234763,2234819,56,1,0,0,1
2234765,2234817,52,1,0,0,2
2234818,2234942,124,0,0,1,2
2234820,2234939,119,0,0,1,1
2234940,2234968,28,1,0,0,1
2234943,2234958,15,1,0,0,2
2234959,2235361,402,0,0,1,2
2234969,2235360,391,0,0,1,1
2235361,2235390,29,1,0,0,1
2235362,2235380,18,1,0,0,2
2235381,2235504,123,0,0,1,2
2235391,2235505,114,0,0,1,1
2235505,2235535,30,1,0,0,2
2235506,2235526,20,1,0,0,1
2235527,2236189,662,0,0,1,1
2235536,2236188,652,0,0,1,2
2236189,2236248,59,1,0,0,2
2236190,2236254,64,1,0,0,1
2236249,2236471,222,0,0,1,2
2236255,2236472,217,0,0,1,1
2236472,2236501,29,1,0,0,2
2236473,2236499,26,1,0,0,1
2236500,2236860,360,0,0,1,1
2236502,2237567,1065,0,0,1,2
2236861,2236871,10,1,0,0,1
2236872,2237568,696,0,0,1,1
2237568,2237657,89,1,0,0,2
2237569,2237657,88,1,0,0,1
2237658,2237848,190,0,0,1,2
2237658,2237850,192,0,0,1,1
2237849,2237883,34,1,0,0,2
2237851,2237882,31,1,0,0,1
2237883,2238903,1020,0,0,1,1
2237884,2238904,1020,0,0,1,2
2238904,2239032,128,1,0,0,1
2238905,2239019,114,1,0,0,2
2239020,2239140,120,0,0,1,2
2239033,2239140,107,0,0,1,1
2239141,2239162,21,1,0,0,2
2239141,2239171,30,1,0,0,1
2239163,2240973,1810,0,0,1,2
2239172,2240974,1802,0,0,1,1
2240974,2241056,82,1,0,0,2
2240975,2241056,81,1,0,0,1
2241057,2241130,73,0,0,1,1
2241057,2241130,73,0,0,1,2
2241131,2241164,33,1,0,0,1
2241131,2241166,35,1,0,0,2
2241165,2241441,276,0,0,1,1
2241167,2241441,274,0,0,1,2
2241442,2241469,27,1,0,0,1
2241442,2241470,28,1,0,0,2
2241470,2241802,332,0,0,1,1
2241471,2241807,336,0,0,1,2
2241803,2241823,20,1,0,0,1
2241808,2241820,12,1,0,0,2
2241821,2242768,947,0,0,1,2
2241824,2242766,942,0,0,1,1
2242767,2242850,83,1,0,0,1
2242769,2242851,82,1,0,0,2
2242851,2242916,65,0,0,1,1
2242852,2242917,65,0,0,1,2
2242917,2242962,45,1,0,0,1
2242918,2242965,47,1,0,0,2
2242963,2243328,365,0,0,1,1
2242966,2243327,361,0,0,1,2
2243328,2243343,15,1,0,0,2
2243329,2243344,15,1,0,0,1
2243344,2244014,670,0,0,1,2
2243345,2244014,669,0,0,1,1
2244015,2244086,71,1,0,0,1
2244015,2244086,71,1,0,0,2
2244087,2244330,243,0,0,1,2
2244087,2244331,244,0,0,1,1
2244331,2244386,55,1,0,0,2
2244332,2244395,63,1,0,0,1
2244387,2244505,118,0,0,1,2
2244396,2244506,110,0,0,1,1
2244506,2244573,67,1,0,0,2
2244507,2244586,79,1,0,0,1
2244574,2244660,86,0,0,1,2
2244587,2244660,73,0,0,1,1
2244661,2244697,36,1,0,0,2
2244661,2244699,38,1,0,0,1
2244698,2245179,481,0,0,1,2
2244700,2245180,480,0,0,1,1
2245180,2245203,23,1,0,0,2
2245181,2245216,35,1,0,0,1
2245204,2245310,106,0,0,1,2
2245217,2245310,93,0,0,1,1
2245311,2245419,108,1,0,0,1
2245311,2245421,110,1,0,0,2
2245420,2245820,400,0,0,1,1
2245422,2245821,399,0,0,1,2
2245821,2245905,84,1,0,0,1
2245822,2245904,82,1,0,0,2
2245905,2245970,65,0,0,1,2
2245906,2245969,63,0,0,1,1
2245970,2246010,40,1,0,0,1
2245971,2246015,44,1,0,0,2
2246011,2246353,342,0,0,1,1
2246016,2246351,335,0,0,1,2
2246352,2246366,14,1,0,0,2
2246354,2246363,9,1,0,0,1
2246364,2247203,839,0,0,1,1
2246367,2247203,836,0,0,1,2
2247204,2247268,64,1,0,0,1
2247204,2247269,65,1,0,0,2
2247269,2247669,400,0,0,1,1
2247270,2247668,398,0,0,1,2
2247669,2247754,85,1,0,0,2
2247670,2247755,85,1,0,0,1
2247755,2247879,124,0,0,1,2
2247756,2247879,123,0,0,1,1
2247880,2247910,30,1,0,0,1
2247880,2247910,30,1,0,0,2
2247911,2248418,507,0,0,1,1
2247911,2248427,516,0,0,1,2
2248419,2248451,32,1,0,0,1
2248428,2248446,18,1,0,0,2
2248447,2249057,610,0,0,1,2
2248452,2249056,604,0,0,1,1
2249057,2249147,90,1,0,0,1
2249058,2249141,83,1,0,0,2
2249142,2249510,368,0,0,1,2
2249148,2249511,363,0,0,1,1
2249511,2249578,67,1,0,0,2
2249512,2249581,69,1,0,0,1
2249579,2249669,90,0,0,1,2
2249582,2249670,88,0,0,1,1
2249670,2249702,32,1,0,0,2
2249671,2249694,23,1,0,0,1
2249695,2251072,1377,0,0,1,1
2249703,2251073,1370,0,0,1,2
2251073,2251153,80,1,0,0,1
2251074,2251154,80,1,0,0,2
2251154,2251270,116,0,0,1,1
2251155,2251269,114,0,0,1,2
2251270,2251328,58,1,0,0,2
2251271,2251312,41,1,0,0,1
2251313,2251432,119,0,0,1,1
2251329,2251433,104,0,0,1,2
2251433,2251465,32,1,0,0,1
2251434,2251455,21,1,0,0,2
2251456,2252255,799,0,0,1,2
2251466,2252252,786,0,0,1,1
2252253,2252273,20,1,0,0,1
2252256,2252269,13,1,0,0,2
2252270,2253098,828,0,0,1,2
2252274,2253097,823,0,0,1,1
2253098,2253199,101,1,0,0,1
2253099,2253175,76,1,0,0,2
2253176,2253625,449,0,0,1,2
2253200,2253615,415,0,0,1,1
2253616,2253783,167,1,0,0,1
2253626,2253796,170,1,0,0,2
2253658,2253731,73,0,1,0,1
2253658,2253736,78,0,1,0,2
2253784,2254135,351,0,0,1,1
2253797,2254138,341,0,0,1,2
2254136,2254173,37,1,0,0,1
2254139,2254153,14,1,0,0,2
2254154,2254500,346,0,0,1,2
2254174,2254497,323,0,0,1,1
2254498,2254593,95,1,0,0,1
2254501,2254594,93,1,0,0,2
2254594,2254997,403,0,0,1,1
2254595,2254997,402,0,0,1,2
2254998,2255109,111,1,0,0,1
2254998,2255128,130,1,0,0,2
2255110,2255169,59,0,0,1,1
2255129,2255168,39,0,0,1,2
2255169,2255209,40,1,0,0,2
2255170,2255202,32,1,0,0,1
2255203,2255685,482,0,0,1,1
2255210,2255312,102,0,0,1,2
2255313,2255554,241,1,0,0,2
2255555,2255760,205,0,0,1,2
2255696,2255770,74,0,1,0,1
2255761,2255770,9,1,0,0,2
2255771,2255945,174,0,0,1,2
2255780,2257234,1454,1,0,0,1
2255803,2255837,34,0,1,0,1
2255878,2256445,567,0,1,0,1
2255946,2255955,9,1,0,0,2
2255956,2256197,241,0,0,1,2
2256198,2256259,61,1,0,0,2
2256260,2256336,76,0,0,1,2
2256337,2256443,106,1,0,0,2
2256444,2256807,363,0,0,1,2
2256808,2256854,46,1,0,0,2
2256855,2257073,218,0,0,1,2
2257074,2257112,38,1,0,0,2
2257113,2257191,78,0,0,1,2
2257192,2257383,191,1,0,0,2
2257235,2257293,58,0,0,1,1
2257294,2257395,101,1,0,0,1
2257384,2257471,87,0,0,1,2
2257396,2257417,21,0,0,1,1
2257418,2257736,318,1,0,0,1
2257472,2257533,61,1,0,0,2
2257534,2257564,30,0,0,1,2
2257565,2257599,34,1,0,0,2
2257600,2257646,46,0,0,1,2
2257647,2257931,284,1,0,0,2
2257737,2257775,38,0,0,1,1
2257776,2257828,52,1,0,0,1
2257829,2257853,24,0,0,1,1
2257854,2257986,132,1,0,0,1
2257932,2258064,132,0,0,1,2
2257987,2258066,79,0,0,1,1
2258065,2258108,43,1,0,0,2
2258067,2258137,70,1,0,0,1
2258109,2258425,316,0,0,1,2
2258138,2258231,93,0,0,1,1
2258232,2258271,39,1,0,0,1
2258272,2258425,153,0,0,1,1
2258426,2258504,78,1,0,0,2
2258426,2258535,109,1,0,0,1
2258505,2258781,276,0,0,1,2
2258536,2258593,57,0,0,1,1
2258594,2258741,147,1,0,0,1
2258742,2258841,99,0,0,1,1
2258782,2258801,19,1,0,0,2
2258802,2258857,55,0,0,1,2
2258842,2258884,42,1,0,0,1
2258858,2258879,21,1,0,0,2
2258880,2258918,38,0,0,1,2
2258885,2258951,66,0,0,1,1
2258919,2258986,67,1,0,0,2
2258952,2258967,15,1,0,0,1
2258968,2259232,264,0,0,1,1
2258987,2259008,21,0,0,1,2
2259009,2259134,125,1,0,0,2
2259135,2259182,47,0,0,1,2
2259183,2259226,43,1,0,0,2
2259227,2259290,63,0,0,1,2
2259233,2260036,803,1,0,0,1
2259250,2259266,16,0,1,0,1
2259291,2259360,69,1,0,0,2
2259361,2259382,21,0,0,1,2
2259375,2259891,516,0,1,0,1
2259383,2260001,618,1,0,0,2
2259744,2259773,29,0,1,0,2
2260002,2260239,237,0,0,1,2
2260037,2260239,202,0,0,1,1
2260240,2260309,69,1,0,0,2
2260240,2260315,75,1,0,0,1
2260310,2260409,99,0,0,1,2
2260316,2260408,92,0,0,1,1
2260409,2260433,24,1,0,0,1
2260410,2260441,31,1,0,0,2
2260434,2262116,1682,0,0,1,1
2260442,2262377,1935,0,0,1,2
2262117,2262137,20,1,0,0,1
2262138,2262378,240,0,0,1,1
2262378,2262427,49,1,0,0,2
2262379,2262426,47,1,0,0,1
2262427,2262681,254,0,0,1,1
2262428,2262682,254,0,0,1,2
2262682,2262714,32,1,0,0,1
2262683,2262709,26,1,0,0,2
2262710,2263819,1109,0,0,1,2
2262715,2263813,1098,0,0,1,1
2263814,2263844,30,1,0,0,1
2263820,2263841,21,1,0,0,2
2263842,2265598,1756,0,0,1,2
2263845,2264840,995,0,0,1,1
2264841,2264917,76,1,0,0,1
2264918,2264992,74,0,0,1,1
2264993,2265003,10,1,0,0,1
2265004,2265596,592,0,0,1,1
2265597,2265665,68,1,0,0,1
2265599,2265659,60,1,0,0,2
2265660,2265851,191,0,0,1,2
2265666,2265849,183,0,0,1,1
2265850,2265915,65,1,0,0,1
2265852,2265917,65,1,0,0,2
2265916,2266008,92,0,0,1,1
2265918,2266008,90,0,0,1,2
2266009,2266032,23,1,0,0,2
2266009,2266038,29,1,0,0,1
2266033,2266370,337,0,0,1,2
2266039,2266370,331,0,0,1,1
2266371,2266392,21,1,0,0,1
2266371,2266398,27,1,0,0,2
2266393,2266794,401,0,0,1,1
2266399,2266796,397,0,0,1,2
2266795,2266823,28,1,0,0,1
2266797,2266823,26,1,0,0,2
2266824,2266965,141,0,0,1,2
2266824,2266970,146,0,0,1,1
2266966,2266984,18,1,0,0,2
2266971,2266982,11,1,0,0,1
2266983,2267159,176,0,0,1,1
2266985,2267158,173,0,0,1,2
2267159,2267210,51,1,0,0,2
2267160,2267212,52,1,0,0,1
2267211,2269471,2260,0,0,1,2
2267213,2269471,2258,0,0,1,1
2269472,2269532,60,1,0,0,1
2269472,2269533,61,1,0,0,2
2269533,2270534,1001,0,0,1,1
2269534,2270536,1002,0,0,1,2
2270535,2270589,54,1,0,0,1
2270537,2270592,55,1,0,0,2
2270590,2270702,112,0,0,1,1
2270593,2270703,110,0,0,1,2
2270703,2270734,31,1,0,0,1
2270704,2270725,21,1,0,0,2
2270726,2272009,1283,0,0,1,2
2270735,2272008,1273,0,0,1,1
2272009,2272201,192,1,0,0,1
2272010,2272108,98,1,0,0,2
2272109,2272325,216,0,0,1,2
2272202,2272323,121,0,0,1,1
2272324,2272363,39,1,0,0,1
2272326,2272358,32,1,0,0,2
2272359,2274964,2605,0,0,1,2
2272364,2274964,2600,0,0,1,1
2274965,2275029,64,1,0,0,1
2274965,2275036,71,1,0,0,2
2275030,2275339,309,0,0,1,1
2275037,2275339,302,0,0,1,2
2275340,2275378,38,1,0,0,1
2275340,2275388,48,1,0,0,2
2275379,2275585,206,0,0,1,1
2275389,2275586,197,0,0,1,2
2275586,2275667,81,1,0,0,1
2275587,2275666,79,1,0,0,2
2275667,2275751,84,0,0,1,2
2275668,2275752,84,0,0,1,1
2275752,2275800,48,1,0,0,2
2275753,2275798,45,1,0,0,1
2275799,2275992,193,0,0,1,1
2275801,2275990,189,0,0,1,2
2275991,2276017,26,1,0,0,2
2275993,2276010,17,1,0,0,1
2276011,2277000,989,0,0,1,1
2276018,2277241,1223,0,0,1,2
2277001,2277057,56,1,0,0,1
2277058,2277343,285,0,0,1,1
2277242,2277269,27,1,0,0,2
2277270,2277299,29,0,0,1,2
2277300,2277316,16,1,0,0,2
2277317,2277345,28,0,0,1,2
2277344,2277415,71,1,0,0,1
2277346,2277418,72,1,0,0,2
2277416,2277718,302,0,0,1,1
2277419,2277717,298,0,0,1,2
2277718,2277753,35,1,0,0,2
2277719,2277751,32,1,0,0,1
2277752,2278146,394,0,0,1,1
2277754,2278147,393,0,0,1,2
2278147,2278183,36,1,0,0,1
2278148,2278179,31,1,0,0,2
2278180,2278559,379,0,0,1,2
2278184,2278557,373,0,0,1,1
2278558,2278582,24,1,0,0,1
2278560,2278585,25,1,0,0,2
2278583,2279494,911,0,0,1,1
2278586,2279496,910,0,0,1,2
2279495,2279741,246,1,0,0,1
2279497,2279587,90,1,0,0,2
2279588,2280031,443,0,0,1,2
2279742,2280032,290,0,0,1,1
2280032,2280084,52,1,0,0,2
2280033,2280147,114,1,0,0,1
2280085,2280262,177,0,0,1,2
2280148,2280173,25,0,0,1,1
2280174,2280320,146,1,0,0,1
2280263,2280319,56,1,0,0,2
2280320,2280970,650,0,0,1,2
2280321,2280971,650,0,0,1,1
2280971,2281022,51,1,0,0,2
2280972,2281021,49,1,0,0,1
2281022,2281340,318,0,0,1,1
2281023,2281340,317,0,0,1,2
2281341,2281400,59,1,0,0,2
2281341,2281408,67,1,0,0,1
2281401,2281570,169,0,0,1,2
2281409,2281569,160,0,0,1,1
2281570,2281597,27,1,0,0,1
2281571,2281600,29,1,0,0,2
2281598,2282754,1156,0,0,1,1
2281601,2282756,1155,0,0,1,2
2282755,2282809,54,1,0,0,1
2282757,2282808,51,1,0,0,2
2282809,2283104,295,0,0,1,2
2282810,2283103,293,0,0,1,1
2283104,2283146,42,1,0,0,1
2283105,2283145,40,1,0,0,2
2283146,2284204,1058,0,0,1,2
2283147,2284205,1058,0,0,1,1
2284205,2284264,59,1,0,0,2
2284206,2284264,58,1,0,0,1
2284265,2284469,204,0,0,1,1
2284265,2284470,205,0,0,1,2
2284470,2284519,49,1,0,0,1
2284471,2284528,57,1,0,0,2
2284520,2284794,274,0,0,1,1
2284529,2284794,265,0,0,1,2
2284795,2284867,72,1,0,0,2
2284795,2284870,75,1,0,0,1
2284868,2285617,749,0,0,1,2
2284871,2285617,746,0,0,1,1
2285618,2285649,31,1,0,0,2
2285618,2285658,40,1,0,0,1
2285650,2286011,361,0,0,1,2
2285659,2286013,354,0,0,1,1
2286012,2286045,33,1,0,0,2
2286014,2286044,30,1,0,0,1
2286045,2286239,194,0,0,1,1
2286046,2286241,195,0,0,1,2
2286240,2286311,71,1,0,0,1
2286242,2286319,77,1,0,0,2
2286312,2286682,370,0,0,1,1
2286320,2286683,363,0,0,1,2
2286683,2286715,32,1,0,0,1
2286684,2286706,22,1,0,0,2
2286707,2288570,1863,0,0,1,2
2286716,2288568,1852,0,0,1,1
2288569,2288616,47,1,0,0,1
2288571,2288624,53,1,0,0,2
2288617,2289097,480,0,0,1,1
2288625,2289094,469,0,0,1,2
2289095,2289121,26,1,0,0,2
2289098,2289122,24,1,0,0,1
2289122,2289848,726,0,0,1,2
2289123,2289844,721,0,0,1,1
2289845,2289875,30,1,0,0,1
2289849,2289875,26,1,0,0,2
2289876,2290222,346,0,0,1,1
2289876,2290228,352,0,0,1,2
2290223,2290253,30,1,0,0,1
2290229,2290250,21,1,0,0,2
2290251,2291175,924,0,0,1,2
2290254,2291175,921,0,0,1,1
2291176,2291242,66,1,0,0,1
2291176,2291249,73,1,0,0,2
2291243,2291827,584,0,0,1,1
2291250,2291827,577,0,0,1,2
2291828,2291872,44,1,0,0,1
2291828,2291882,54,1,0,0,2
2291873,2292170,297,0,0,1,1
2291883,2292171,288,0,0,1,2
2292171,2292219,48,1,0,0,1
2292172,2292220,48,1,0,0,2
2292220,2292579,359,0,0,1,1
2292221,2292579,358,0,0,1,2
2292580,2292615,35,1,0,0,2
2292580,2292622,42,1,0,0,1
2292616,2292794,178,0,0,1,2
2292623,2292797,174,0,0,1,1
2292795,2292819,24,1,0,0,2
2292798,2292810,12,1,0,0,1
2292811,2293535,724,0,0,1,1
2292820,2293536,716,0,0,1,2
2293536,2293568,32,1,0,0,1
2293537,2293567,30,1,0,0,2
2293568,2293813,245,0,0,1,2
2293569,2293812,243,0,0,1,1
2293813,2293868,55,1,0,0,1
2293814,2293859,45,1,0,0,2
2293860,2294227,367,0,0,1,2
2293869,2294224,355,0,0,1,1
2294225,2294263,38,1,0,0,1
2294228,2294262,34,1,0,0,2
2294263,2294534,271,0,0,1,2
2294264,2294533,269,0,0,1,1
2294534,2294562,28,1,0,0,1
2294535,2294554,19,1,0,0,2
2294555,2295612,1057,0,0,1,2
2294563,2295614,1051,0,0,1,1
2295613,2295664,51,1,0,0,2
2295615,2295655,40,1,0,0,1
2295656,2295947,291,0,0,1,1
2295665,2295946,281,0,0,1,2
2295947,2296030,83,1,0,0,2
2295948,2296034,86,1,0,0,1
2296031,2296294,263,0,0,1,2
2296035,2296294,259,0,0,1,1
2296295,2296370,75,1,0,0,1
2296295,2296370,75,1,0,0,2
2296371,2297098,727,0,0,1,2
2296371,2297099,728,0,0,1,1
2297099,2297179,80,1,0,0,2
2297100,2297181,81,1,0,0,1
2297180,2297399,219,0,0,1,2
2297182,2297400,218,0,0,1,1
2297400,2297431,31,1,0,0,2
2297401,2297431,30,1,0,0,1
2297432,2297679,247,0,0,1,2
2297432,2297684,252,0,0,1,1
2297680,2297708,28,1,0,0,2
2297685,2297705,20,1,0,0,1
2297706,2298183,477,0,0,1,1
2297709,2298588,879,0,0,1,2
2298184,2298205,21,1,0,0,1
2298206,2298586,380,0,0,1,1
2298587,2298649,62,1,0,0,1
2298589,2298650,61,1,0,0,2
2298650,2299087,437,0,0,1,1
2298651,2299088,437,0,0,1,2
2299088,2299116,28,1,0,0,1
2299089,2299115,26,1,0,0,2
2299116,2300316,1200,0,0,1,2
2299117,2300314,1197,0,0,1,1
2300315,2300348,33,1,0,0,1
2300317,2300350,33,1,0,0,2
2300349,2301656,1307,0,0,1,1
2300351,2301658,1307,0,0,1,2
2301657,2301709,52,1,0,0,1
2301659,2301700,41,1,0,0,2
2301701,2302188,487,0,0,1,2
2301710,2302189,479,0,0,1,1
2302189,2302337,148,1,0,0,2
2302190,2302333,143,1,0,0,1
2302334,2302479,145,0,0,1,1
2302338,2302480,142,0,0,1,2
2302480,2302509,29,1,0,0,1
2302481,2302510,29,1,0,0,2
2302510,2302860,350,0,0,1,1
2302511,2302989,478,0,0,1,2
2302861,2302881,20,1,0,0,1
2302882,2303910,1028,0,0,1,1
2302990,2303670,680,1,0,0,2
2303671,2303788,117,0,0,1,2
2303789,2303836,47,1,0,0,2
2303837,2303945,108,0,0,1,2
2303911,2304158,247,1,0,0,1
2303946,2304064,118,1,0,0,2
2304065,2304091,26,0,0,1,2
2304092,2304146,54,1,0,0,2
2304147,2304622,475,0,0,1,2
2304159,2304623,464,0,0,1,1
2304623,2304839,216,1,0,0,2
2304624,2304802,178,1,0,0,1
2304673,2304772,99,0,1,0,2
2304673,2304774,101,0,1,0,1
2304803,2305244,441,0,0,1,1
2304840,2305244,404,0,0,1,2
2305245,2305267,22,1,0,0,2
2305245,2305276,31,1,0,0,1
2305268,2306120,852,0,0,1,2
2305277,2306120,843,0,0,1,1
2306121,2306204,83,1,0,0,1
2306121,2306207,86,1,0,0,2
2306205,2306425,220,0,0,1,1
2306208,2306424,216,0,0,1,2
2306425,2306477,52,1,0,0,2
2306426,2306475,49,1,0,0,1
2306476,2306832,356,0,0,1,1
2306478,2306833,355,0,0,1,2
2306833,2306870,37,1,0,0,1
2306834,2306877,43,1,0,0,2
2306871,2307873,1002,0,0,1,1
2306878,2307874,996,0,0,1,2
2307874,2307950,76,1,0,0,1
2307875,2307950,75,1,0,0,2
2307951,2308028,77,0,0,1,1
2307951,2308029,78,0,0,1,2
2308029,2308080,51,1,0,0,1
2308030,2308079,49,1,0,0,2
2308080,2309583,1503,0,0,1,2
2308081,2309584,1503,0,0,1,1
2309584,2309632,48,1,0,0,2
2309585,2309640,55,1,0,0,1
2309633,2309892,259,0,0,1,2
2309641,2309891,250,0,0,1,1
2309892,2309922,30,1,0,0,1
2309893,2309915,22,1,0,0,2
2309916,2311818,1902,0,0,1,2
2309923,2311819,1896,0,0,1,1
2311819,2311930,111,1,0,0,2
2311820,2311932,112,1,0,0,1
2311931,2312298,367,0,0,1,2
2311933,2312296,363,0,0,1,1
2312297,2312331,34,1,0,0,1
2312299,2312338,39,1,0,0,2
2312332,2313313,981,0,0,1,1
2312339,2313314,975,0,0,1,2
2313314,2313400,86,1,0,0,1
2313315,2313395,80,1,0,0,2
2313396,2313456,60,0,0,1,2
2313401,2313456,55,0,0,1,1
2313457,2313484,27,1,0,0,2
2313457,2313491,34,1,0,0,1
2313485,2313705,220,0,0,1,2
2313492,2313705,213,0,0,1,1
2313706,2313729,23,1,0,0,2
2313706,2313737,31,1,0,0,1
2313730,2314714,984,0,0,1,2
2313738,2314307,569,0,0,1,1
2314308,2315048,740,1,0,0,1
2314715,2314769,54,1,0,0,2
2314770,2314871,101,0,0,1,2
2314872,2314961,89,1,0,0,2
2314962,2315046,84,0,0,1,2
2315047,2315152,105,1,0,0,2
2315049,2315079,30,0,0,1,1
2315080,2315176,96,1,0,0,1
2315153,2315274,121,0,0,1,2
2315177,2315282,105,0,0,1,1
2315275,2315366,91,1,0,0,2
2315283,2315360,77,1,0,0,1
2315361,2315415,54,0,0,1,1
2315367,2316340,973,0,0,1,2
2315416,2315431,15,1,0,0,1
2315432,2315554,122,0,0,1,1
2315555,2315583,28,1,0,0,1
2315584,2316345,761,0,0,1,1
2316341,2316358,17,1,0,0,2
2316346,2316402,56,1,0,0,1
2316359,2316730,371,0,0,1,2
2316403,2316730,327,0,0,1,1
2316731,2316750,19,1,0,0,1
2316731,2316760,29,1,0,0,2
2316751,2317078,327,0,0,1,1
2316761,2317079,318,0,0,1,2
2317079,2317106,27,1,0,0,1
2317080,2317097,17,1,0,0,2
2317098,2317469,371,0,0,1,2
2317107,2317469,362,0,0,1,1
2317470,2317532,62,1,0,0,2
2317470,2317546,76,1,0,0,1
2317533,2317798,265,0,0,1,2
2317547,2317589,42,0,0,1,1
2317590,2317603,13,1,0,0,1
2317604,2317797,193,0,0,1,1
2317798,2317849,51,1,0,0,1
2317799,2317850,51,1,0,0,2
2317850,2318321,471,0,0,1,1
2317851,2318321,470,0,0,1,2
2318322,2318376,54,1,0,0,2
2318322,2318377,55,1,0,0,1
2318377,2319046,669,0,0,1,2
2318378,2319045,667,0,0,1,1
2319046,2319082,36,1,0,0,1
2319047,2319082,35,1,0,0,2
2319083,2319308,225,0,0,1,2
2319083,2319309,226,0,0,1,1
2319309,2319328,19,1,0,0,2
2319310,2319327,17,1,0,0,1
2319328,2320336,1008,0,0,1,1
2319329,2320341,1012,0,0,1,2
2320337,2320365,28,1,0,0,1
2320342,2320353,11,1,0,0,2
2320354,2320577,223,0,0,1,2
2320366,2320578,212,0,0,1,1
2320578,2320600,22,1,0,0,2
2320579,2320596,17,1,0,0,1
2320597,2320906,309,0,0,1,1
2320601,2321193,592,0,0,1,2
2320907,2320918,11,1,0,0,1
2320919,2321191,272,0,0,1,1
2321192,2321260,68,1,0,0,1
2321194,2321252,58,1,0,0,2
2321253,2321550,297,0,0,1,2
2321261,2321550,289,0,0,1,1
2321551,2321576,25,1,0,0,2
2321551,2321586,35,1,0,0,1
2321577,2322188,611,0,0,1,2
2321587,2322186,599,0,0,1,1
2322187,2322222,35,1,0,0,1
2322189,2322219,30,1,0,0,2
2322220,2323313,1093,0,0,1,2
2322223,2323314,1091,0,0,1,1
2323314,2323399,85,1,0,0,2
2323315,2323445,130,1,0,0,1
2323400,2324125,725,0,0,1,2
2323446,2324126,680,0,0,1,1
2324126,2324170,44,1,0,0,2
2324127,2324170,43,1,0,0,1
2324171,2324511,340,0,0,1,1
2324171,2324512,341,0,0,1,2
2324512,2324548,36,1,0,0,1
2324513,2324556,43,1,0,0,2
2324549,2325189,640,0,0,1,1
2324557,2325188,631,0,0,1,2
2325189,2325278,89,1,0,0,2
2325190,2325270,80,1,0,0,1
2325271,2325363,92,0,0,1,1
2325279,2325363,84,0,0,1,2
2325364,2325419,55,1,0,0,2
2325364,2325426,62,1,0,0,1
2325420,2325588,168,0,0,1,2
2325427,2325535,108,0,0,1,1
2325536,2325609,73,1,0,0,1
2325589,2325608,19,1,0,0,2
2325609,2326202,593,0,0,1,2
2325610,2326719,1109,0,0,1,1
2326203,2326791,588,1,0,0,2
2326720,2326866,146,1,0,0,1
2326792,2327108,316,0,0,1,2
2326867,2326892,25,0,0,1,1
2326893,2327091,198,1,0,0,1
2327092,2327260,168,0,0,1,1
2327109,2327137,28,1,0,0,2
2327138,2327399,261,0,0,1,2
2327261,2327296,35,1,0,0,1
2327297,2327481,184,0,0,1,1
2327400,2327529,129,1,0,0,2
2327482,2327501,19,1,0,0,1
2327502,2327553,51,0,0,1,1
2327530,2327744,214,0,0,1,2
2327554,2328913,1359,1,0,0,1
2327745,2327913,168,1,0,0,2
2327788,2327799,11,0,1,0,1
2327838,2328882,1044,0,1,0,1
2327914,2327994,80,0,0,1,2
2327995,2328036,41,1,0,0,2
2328037,2328174,137,0,0,1,2
2328175,2328233,58,1,0,0,2
2328234,2328276,42,0,0,1,2
2328277,2328294,17,1,0,0,2
2328295,2328352,57,0,0,1,2
2328353,2328385,32,1,0,0,2
2328386,2328741,355,0,0,1,2
2328742,2328881,139,1,0,0,2
2328882,2330064,1182,0,0,1,2
2328914,2330066,1152,0,0,1,1
2330065,2330120,55,1,0,0,2
2330067,2330118,51,1,0,0,1
2330119,2330224,105,0,0,1,1
2330121,2330239,118,0,0,1,2
2330225,2330335,110,1,0,0,1
2330240,2330338,98,1,0,0,2
2330336,2330415,79,0,0,1,1
2330339,2330417,78,0,0,1,2
2330416,2330448,32,1,0,0,1
2330418,2330621,203,1,0,0,2
2330449,2330702,253,0,0,1,1
2330622,2330648,26,0,0,1,2
2330649,2331051,402,1,0,0,2
2330703,2330731,28,1,0,0,1
2330732,2330953,221,0,0,1,1
2330954,2330968,14,1,0,0,1
2330969,2331252,283,0,0,1,1
2331052,2331308,256,0,0,1,2
2331253,2331283,30,1,0,0,1
2331284,2331355,71,0,0,1,1
2331309,2331417,108,1,0,0,2
2331356,2331389,33,1,0,0,1
2331368,2331368,0,0,1,0,1
2331390,2331452,62,0,0,1,1
2331418,2331514,96,0,0,1,2
2331453,2331470,17,1,0,0,1
2331471,2331519,48,0,0,1,1
2331515,2331546,31,1,0,0,2
2331520,2331619,99,1,0,0,1
2331547,2331679,132,0,0,1,2
2331605,2331607,2,0,1,0,1
2331620,2331646,26,0,0,1,1
2331647,2331701,54,1,0,0,1
2331658,2331692,34,0,1,0,1
2331680,2331684,4,1,0,0,2
2331685,2332042,357,0,0,1,2
2331702,2331737,35,0,0,1,1
2331748,2332482,734,0,1,0,1
2332043,2332146,103,1,0,0,2
2332147,2332197,50,0,0,1,2
2332198,2332236,38,1,0,0,2
2332237,2332327,90,0,0,1,2
2332328,2332418,90,1,0,0,2
2332419,2332535,116,0,0,1,2
2332492,2332492,0,1,0,0,1
2332493,2332513,20,0,0,1,1
2332514,2333319,805,1,0,0,1
2332536,2332607,71,1,0,0,2
2332608,2333034,426,0,0,1,2
2333035,2333056,21,1,0,0,2
2333057,2333170,113,0,0,1,2
2333171,2333187,16,1,0,0,2
2333188,2333263,75,0,0,1,2
2333264,2333328,64,1,0,0,2
2333320,2333389,69,0,0,1,1
2333329,2333838,509,0,0,1,2
2333390,2334612,1222,1,0,0,1
2333839,2333870,31,1,0,0,2
2333871,2333905,34,0,0,1,2
2333906,2333910,4,1,0,0,2
2333911,2334337,426,0,0,1,2
2334338,2334381,43,1,0,0,2
2334382,2334517,135,0,0,1,2
2334518,2334594,76,1,0,0,2
2334595,2336092,1497,0,0,1,2
2334613,2336087,1474,0,0,1,1
2336088,2337768,1680,1,0,0,1
2336093,2336245,152,1,0,0,2
2336131,2336377,246,0,1,0,1
2336246,2336372,126,0,0,1,2
2336373,2336528,155,1,0,0,2
2336417,2337711,1294,0,1,0,1
2336529,2336600,71,0,0,1,2
2336601,2336608,7,1,0,0,2
2336609,2336714,105,0,0,1,2
2336715,2336919,204,1,0,0,2
2336920,2336963,43,0,0,1,2
2336964,2337049,85,1,0,0,2
2337050,2337151,101,0,0,1,2
2337152,2337742,590,1,0,0,2
2337743,2337763,20,0,0,1,2
2337764,2338098,334,1,0,0,2
2337769,2337869,100,0,0,1,1
2337870,2338089,219,1,0,0,1
2337901,2338044,143,0,1,0,1
2337911,2338026,115,0,1,0,2
2338090,2338602,512,0,0,1,1
2338099,2338676,577,0,0,1,2
2338603,2338616,13,1,0,0,1
2338617,2338658,41,0,0,1,1
2338659,2338758,99,1,0,0,1
2338677,2338725,48,1,0,0,2
2338726,2339070,344,0,0,1,2
2338759,2338825,66,0,0,1,1
2338826,2338842,16,1,0,0,1
2338843,2339690,847,0,0,1,1
2339071,2340892,1821,1,0,0,2
2339691,2339695,4,1,0,0,1
2339696,2339904,208,0,0,1,1
2339905,2339916,11,1,0,0,1
2339917,2339985,68,0,0,1,1
2339986,2340047,61,1,0,0,1
2340048,2340297,249,0,0,1,1
2340298,2340302,4,1,0,0,1
2340303,2340619,316,0,0,1,1
2340620,2340646,26,1,0,0,1
2340647,2340809,162,0,0,1,1
2340810,2341290,480,1,0,0,1
2340893,2341176,283,0,0,1,2
2341177,2341232,55,1,0,0,2
2341233,2341425,192,0,0,1,2
2341291,2341316,25,0,0,1,1
2341317,2341333,16,1,0,0,1
2341334,2341431,97,0,0,1,1
2341426,2341446,20,1,0,0,2
2341432,2341444,12,1,0,0,1
2341445,2341844,399,0,0,1,1
2341447,2342630,1183,0,0,1,2
2341845,2341898,53,1,0,0,1
2341899,2341924,25,0,0,1,1
2341925,2341929,4,1,0,0,1
2341930,2342072,142,0,0,1,1
2342073,2342094,21,1,0,0,1
2342095,2342629,534,0,0,1,1
2342630,2342707,77,1,0,0,1
2342631,2342691,60,1,0,0,2
2342692,2342996,304,0,0,1,2
2342708,2342994,286,0,0,1,1
2342995,2343263,268,1,0,0,1
2342997,2343026,29,1,0,0,2
2343027,2344784,1757,0,0,1,2
2343264,2343516,252,0,0,1,1
2343517,2343568,51,1,0,0,1
2343569,2343630,61,0,0,1,1
2343631,2343703,72,1,0,0,1
2343704,2343767,63,0,0,1,1
2343768,2343840,72,1,0,0,1
2343841,2343989,148,0,0,1,1
2343990,2344100,110,1,0,0,1
2344101,2344349,248,0,0,1,1
2344350,2344683,333,1,0,0,1
2344684,2344783,99,0,0,1,1
2344784,2344915,131,1,0,0,1
2344785,2344846,61,1,0,0,2
2344847,2345901,1054,0,0,1,2
2344916,2345901,985,0,0,1,1
2345902,2345962,60,1,0,0,1
2345902,2345979,77,1,0,0,2
2345963,2345984,21,0,0,1,1
2345980,2346054,74,0,0,1,2
2345985,2346003,18,1,0,0,1
2346004,2346055,51,0,0,1,1
2346055,2346097,42,1,0,0,2
2346056,2346099,43,1,0,0,1
2346098,2347775,1677,0,0,1,2
2346100,2347774,1674,0,0,1,1
2347775,2347837,62,1,0,0,1
2347776,2347845,69,1,0,0,2
2347838,2348004,166,0,0,1,1
2347846,2348007,161,0,0,1,2
2348005,2348050,45,1,0,0,1
2348008,2348050,42,1,0,0,2
2348051,2348566,515,0,0,1,1
2348051,2348568,517,0,0,1,2
2348567,2348604,37,1,0,0,1
2348569,2348593,24,1,0,0,2
2348594,2349893,1299,0,0,1,2
2348605,2349894,1289,0,0,1,1
2349894,2350013,119,1,0,0,2
2349895,2350084,189,1,0,0,1
2350014,2350513,499,0,0,1,2
2350085,2350514,429,0,0,1,1
2350514,2350552,38,1,0,0,2
2350515,2350553,38,1,0,0,1
2350553,2351606,1053,0,0,1,2
2350554,2351606,1052,0,0,1,1
2351607,2351686,79,1,0,0,2
2351607,2351691,84,1,0,0,1
2351687,2351771,84,0,0,1,2
2351692,2351771,79,0,0,1,1
2351772,2351801,29,1,0,0,2
2351772,2351820,48,1,0,0,1
2351802,2352032,230,0,0,1,2
2351821,2352034,213,0,0,1,1
2352033,2352055,22,1,0,0,2
2352035,2352062,27,1,0,0,1
2352056,2352990,934,0,0,1,2
2352063,2352179,116,0,0,1,1
2352180,2352208,28,1,0,0,1
2352209,2352438,229,0,0,1,1
2352439,2352454,15,1,0,0,1
2352455,2352481,26,0,0,1,1
2352482,2352509,27,1,0,0,1
2352510,2353111,601,0,0,1,1
2352991,2353006,15,1,0,0,2
2353007,2353177,170,0,0,1,2
2353112,2353184,72,1,0,0,1
2353178,2353194,16,1,0,0,2
2353185,2353246,61,0,0,1,1
2353195,2353239,44,0,0,1,2
2353240,2353352,112,1,0,0,2
2353247,2353352,105,1,0,0,1
2353353,2353420,67,0,0,1,1
2353353,2353471,118,0,0,1,2
2353421,2353523,102,1,0,0,1
2353472,2353505,33,1,0,0,2
2353506,2353528,22,0,0,1,2
2353524,2353546,22,0,0,1,1
2353529,2353850,321,1,0,0,2
2353547,2353679,132,1,0,0,1
2353680,2353762,82,0,0,1,1
2353763,2355582,1819,1,0,0,1
2353851,2354253,402,0,0,1,2
2354209,2354406,197,0,1,0,1
2354254,2354341,87,1,0,0,2
2354342,2354584,242,0,0,1,2
2354432,2355527,1095,0,1,0,1
2354585,2355556,971,1,0,0,2
2355557,2357083,1526,0,0,1,2
2355583,2355789,206,0,0,1,1
2355790,2355800,10,1,0,0,1
2355801,2356605,804,0,0,1,1
2356606,2356813,207,1,0,0,1
2356814,2356954,140,0,0,1,1
2356955,2357053,98,1,0,0,1
2357054,2357083,29,0,0,1,1
2357084,2357291,207,1,0,0,1
2357084,2357462,378,1,0,0,2
2357292,2357353,61,0,0,1,1
2357354,2357363,9,1,0,0,1
2357364,2357775,411,0,0,1,1
2357463,2357488,25,0,0,1,2
2357489,2357592,103,1,0,0,2
2357593,2357874,281,0,0,1,2
2357776,2357785,9,1,0,0,1
2357786,2357900,114,0,0,1,1
2357875,2357913,38,1,0,0,2
2357901,2357916,15,1,0,0,1
2357914,2357948,34,0,0,1,2
2357917,2357976,59,0,0,1,1
2357949,2358029,80,1,0,0,2
2357977,2358007,30,1,0,0,1
2358008,2358391,383,0,0,1,1
2358030,2358054,24,0,0,1,2
2358055,2358122,67,1,0,0,2
2358123,2358245,122,0,0,1,2
2358246,2358285,39,1,0,0,2
2358286,2358375,89,0,0,1,2
2358376,2358501,125,1,0,0,2
2358392,2358438,46,1,0,0,1
2358439,2358668,229,0,0,1,1
2358502,2358566,64,0,0,1,2
2358567,2358596,29,1,0,0,2
2358597,2358618,21,0,0,1,2
2358619,2358651,32,1,0,0,2
2358652,2358701,49,0,0,1,2
2358679,2358681,2,0,1,0,1
2358691,2358691,0,1,0,0,1
2358692,2358747,55,0,0,1,1
2358702,2358853,151,1,0,0,2
2358748,2359520,772,1,0,0,1
2358759,2358777,18,0,1,0,1
2358821,2359128,307,0,1,0,1
2358854,2359104,250,0,0,1,2
2359105,2361604,2499,1,0,0,2
2359149,2359153,4,0,1,0,1
2359225,2359509,284,0,1,0,1
2359521,2359555,34,0,0,1,1
2359556,2359774,218,1,0,0,1
2359569,2359619,50,0,1,0,1
2359654,2359765,111,0,1,0,1
2359775,2359798,23,0,0,1,1
2359809,2359873,64,0,1,0,1
2359883,2361625,1742,1,0,0,1
2359894,2361344,1450,0,1,0,1
2361160,2361275,115,0,1,0,2
2361404,2361554,150,0,1,0,1
2361417,2361530,113,0,1,0,2
2361605,2362625,1020,0,0,1,2
2361626,2362623,997,0,0,1,1
2362624,2362666,42,1,0,0,1
2362626,2362678,52,1,0,0,2
2362667,2363129,462,0,0,1,1
2362679,2363130,451,0,0,1,2
2363130,2363211,81,1,0,0,1
2363131,2363201,70,1,0,0,2
2363202,2363275,73,0,0,1,2
2363212,2363274,62,0,0,1,1
2363275,2363322,47,1,0,0,1
2363276,2363322,46,1,0,0,2
2363323,2363444,121,0,0,1,1
2363323,2363453,130,0,0,1,2
2363445,2363475,30,1,0,0,1
2363454,2363465,11,1,0,0,2
2363466,2364639,1173,0,0,1,2
2363476,2364636,1160,0,0,1,1
2364637,2364687,50,1,0,0,1
2364640,2364689,49,1,0,0,2
2364688,2365356,668,0,0,1,1
2364690,2365358,668,0,0,1,2
2365357,2365385,28,1,0,0,1
2365359,2365378,19,1,0,0,2
2365379,2366702,1323,0,0,1,2
2365386,2366703,1317,0,0,1,1
2366703,2366768,65,1,0,0,2
2366704,2366768,64,1,0,0,1
2366769,2368144,1375,0,0,1,1
2366769,2368144,1375,0,0,1,2
2368145,2368204,59,1,0,0,2
2368145,2368214,69,1,0,0,1
2368205,2368324,119,0,0,1,2
2368215,2368324,109,0,0,1,1
2368325,2368354,29,1,0,0,1
2368325,2368355,30,1,0,0,2
2368355,2368551,196,0,0,1,1
2368356,2368552,196,0,0,1,2
2368552,2368572,20,1,0,0,1
2368553,2368572,19,1,0,0,2
2368573,2369525,952,0,0,1,1
2368573,2369526,953,0,0,1,2
2369526,2369585,59,1,0,0,1
2369527,2369578,51,1,0,0,2
2369579,2369895,316,0,0,1,2
2369586,2369893,307,0,0,1,1
2369894,2369925,31,1,0,0,1
2369896,2369923,27,1,0,0,2
2369924,2371656,1732,0,0,1,2
2369926,2371655,1729,0,0,1,1
2371656,2371719,63,1,0,0,1
2371657,2371724,67,1,0,0,2
2371720,2371973,253,0,0,1,1
2371725,2371972,247,0,0,1,2
2371973,2372025,52,1,0,0,2
2371974,2372025,51,1,0,0,1
2372026,2372603,577,0,0,1,1
2372026,2372604,578,0,0,1,2
2372604,2372655,51,1,0,0,1
2372605,2372649,44,1,0,0,2
2372650,2372953,303,0,0,1,2
2372656,2372952,296,0,0,1,1
2372953,2373022,69,1,0,0,1
2372954,2373021,67,1,0,0,2
2373022,2373108,86,0,0,1,2
2373023,2373107,84,0,0,1,1
2373108,2373151,43,1,0,0,1
2373109,2373148,39,1,0,0,2
2373149,2373390,241,0,0,1,2
2373152,2373388,236,0,0,1,1
2373389,2373404,15,1,0,0,1
2373391,2373403,12,1,0,0,2
2373404,2374902,1498,0,0,1,2
2373405,2374899,1494,0,0,1,1
2374900,2374962,62,1,0,0,1
2374903,2374962,59,1,0,0,2
2374963,2375522,559,0,0,1,1
2374963,2375522,559,0,0,1,2
2375523,2375547,24,1,0,0,2
2375523,2375565,42,1,0,0,1
2375548,2377017,1469,0,0,1,2
2375566,2377017,1451,0,0,1,1
2377018,2377123,105,1,0,0,2
2377018,2377155,137,1,0,0,1
2377124,2378755,1631,0,0,1,2
2377156,2378756,1600,0,0,1,1
2378756,2378785,29,1,0,0,2
2378757,2378776,19,1,0,0,1
2378777,2380004,1227,0,0,1,1
2378786,2380005,1219,0,0,1,2
2380005,2380068,63,1,0,0,1
2380006,2380070,64,1,0,0,2
2380069,2381343,1274,0,0,1,1
2380071,2381412,1341,0,0,1,2
2381344,2381382,38,1,0,0,1
2381383,2381413,30,0,0,1,1
2381413,2381447,34,1,0,0,2
2381414,2381447,33,1,0,0,1
2381448,2381505,57,0,0,1,1
2381448,2381969,521,0,0,1,2
2381506,2381557,51,1,0,0,1
2381558,2381702,144,0,0,1,1
2381703,2381718,15,1,0,0,1
2381719,2381969,250,0,0,1,1
2381970,2382029,59,1,0,0,2
2381970,2382036,66,1,0,0,1
2382030,2382932,902,0,0,1,2
2382037,2382931,894,0,0,1,1
2382932,2382957,25,1,0,0,1
2382933,2382959,26,1,0,0,2
2382958,2383202,244,0,0,1,1
2382960,2383203,243,0,0,1,2
2383203,2383294,91,1,0,0,1
2383204,2383236,32,1,0,0,2
2383237,2383468,231,0,0,1,2
2383295,2383316,21,0,0,1,1
2383317,2383337,20,1,0,0,1
2383338,2383466,128,0,0,1,1
2383467,2383482,15,1,0,0,1
2383469,2383485,16,1,0,0,2
2383483,2384353,870,0,0,1,1
2383486,2384358,872,0,0,1,2
2384354,2384378,24,1,0,0,1
2384359,2384378,19,1,0,0,2
2384379,2384875,496,0,0,1,1
2384379,2384875,496,0,0,1,2
2384876,2384927,51,1,0,0,1
2384876,2384936,60,1,0,0,2
2384928,2385889,961,0,0,1,1
2384937,2385891,954,0,0,1,2
2385890,2385930,40,1,0,0,1
2385892,2385920,28,1,0,0,2
2385921,2387090,1169,0,0,1,2
2385931,2387090,1159,0,0,1,1
2387091,2387144,53,1,0,0,2
2387091,2387152,61,1,0,0,1
2387145,2387585,440,0,0,1,2
2387153,2387275,122,0,0,1,1
2387276,2387291,15,1,0,0,1
2387292,2387585,293,0,0,1,1
2387586,2387625,39,1,0,0,1
2387586,2387626,40,1,0,0,2
2387626,2388601,975,0,0,1,1
2387627,2388603,976,0,0,1,2
2388602,2388756,154,1,0,0,1
2388604,2388659,55,1,0,0,2
2388660,2388980,320,0,0,1,2
2388757,2388982,225,0,0,1,1
2388981,2389011,30,1,0,0,2
2388983,2389012,29,1,0,0,1
2389012,2389217,205,0,0,1,2
2389013,2389213,200,0,0,1,1
2389214,2389240,26,1,0,0,1
2389218,2389229,11,1,0,0,2
2389230,2389695,465,0,0,1,2
2389241,2389688,447,0,0,1,1
2389689,2389711,22,1,0,0,1
2389696,2389706,10,1,0,0,2
2389707,2390213,506,0,0,1,2
2389712,2390213,501,0,0,1,1
2390214,2390264,50,1,0,0,1
2390214,2390264,50,1,0,0,2
2390265,2391557,1292,0,0,1,1
2390265,2391559,1294,0,0,1,2
2391558,2391577,19,1,0,0,1
2391560,2391578,18,1,0,0,2
2391578,2392329,751,0,0,1,1
2391579,2392329,750,0,0,1,2
2392330,2392387,57,1,0,0,2
2392330,2392452,122,1,0,0,1
2392388,2392872,484,0,0,1,2
2392453,2392588,135,0,0,1,1
2392589,2392639,50,1,0,0,1
2392640,2392743,103,0,0,1,1
2392744,2392759,15,1,0,0,1
2392760,2392871,111,0,0,1,1
2392872,2392902,30,1,0,0,1
2392873,2392900,27,1,0,0,2
2392901,2393619,718,0,0,1,2
2392903,2393618,715,0,0,1,1
2393619,2393665,46,1,0,0,1
2393620,2393657,37,1,0,0,2
2393658,2393935,277,0,0,1,2
2393666,2393935,269,0,0,1,1
2393936,2394004,68,1,0,0,2
2393936,2394031,95,1,0,0,1
2394005,2394120,115,0,0,1,2
2394032,2394122,90,0,0,1,1
2394121,2394155,34,1,0,0,2
2394123,2394150,27,1,0,0,1
2394151,2394464,313,0,0,1,1
2394156,2395764,1608,0,0,1,2
2394465,2394489,24,1,0,0,1
2394490,2394819,329,0,0,1,1
2394820,2394826,6,1,0,0,1
2394827,2395139,312,0,0,1,1
2395140,2395392,252,1,0,0,1
2395393,2395599,206,0,0,1,1
2395600,2395632,32,1,0,0,1
2395633,2395720,87,0,0,1,1
2395721,2395791,70,1,0,0,1
2395765,2395796,31,1,0,0,2
2395792,2395912,120,0,0,1,1
2395797,2395923,126,0,0,1,2
2395913,2396039,126,1,0,0,1
2395924,2396186,262,1,0,0,2
2396040,2396310,270,0,0,1,1
2396187,2396311,124,0,0,1,2
2396311,2396722,411,1,0,0,1
2396312,2396701,389,1,0,0,2
2396338,2396711,373,0,1,0,1
2396341,2396475,134,0,1,0,2
2396518,2396652,134,0,1,0,2
2396702,2397470,768,0,0,1,2
2396723,2397466,743,0,0,1,1
2397467,2397499,32,1,0,0,1
2397471,2397489,18,1,0,0,2
2397490,2398089,599,0,0,1,2
2397500,2397773,273,0,0,1,1
2397774,2398138,364,1,0,0,1
2398090,2398143,53,1,0,0,2
2398139,2398681,542,0,0,1,1
2398144,2398682,538,0,0,1,2
2398682,2398837,155,1,0,0,1
2398683,2398735,52,1,0,0,2
2398736,2399137,401,0,0,1,2
2398838,2399136,298,0,0,1,1
2399137,2399172,35,1,0,0,1
2399138,2399158,20,1,0,0,2
2399159,2399807,648,0,0,1,2
2399173,2399806,633,0,0,1,1
2399807,2399861,54,1,0,0,1
2399808,2399858,50,1,0,0,2
2399859,2400008,149,0,0,1,2
2399862,2400009,147,0,0,1,1
2400009,2400058,49,1,0,0,2
2400010,2400056,46,1,0,0,1
2400057,2400144,87,0,0,1,1
2400059,2400222,163,0,0,1,2
2400145,2400169,24,1,0,0,1
2400170,2400219,49,0,0,1,1
2400220,2400255,35,1,0,0,1
2400223,2400252,29,1,0,0,2
2400253,2400449,196,0,0,1,2
2400256,2400447,191,0,0,1,1
2400448,2400492,44,1,0,0,1
2400450,2400474,24,1,0,0,2
2400475,2401356,881,0,0,1,2
2400493,2400630,137,0,0,1,1
2400631,2400645,14,1,0,0,1
2400646,2401354,708,0,0,1,1
2401355,2401418,63,1,0,0,1
2401357,2401420,63,1,0,0,2
2401419,2401665,246,0,0,1,1
2401421,2401665,244,0,0,1,2
2401666,2401713,47,1,0,0,2
2401666,2401714,48,1,0,0,1
2401714,2402083,369,0,0,1,2
2401715,2402082,367,0,0,1,1
2402083,2402121,38,1,0,0,1
2402084,2402116,32,1,0,0,2
2402117,2402602,485,0,0,1,2
2402122,2402599,477,0,0,1,1
2402600,2402628,28,1,0,0,1
2402603,2402625,22,1,0,0,2
2402626,2402901,275,0,0,1,2
2402629,2402901,272,0,0,1,1
2402902,2402948,46,1,0,0,1
2402902,2402957,55,1,0,0,2
2402949,2403257,308,0,0,1,1
2402958,2403258,300,0,0,1,2
2403258,2403300,42,1,0,0,1
2403259,2403300,41,1,0,0,2
2403301,2403736,435,0,0,1,1
2403301,2403737,436,0,0,1,2
2403737,2403888,151,1,0,0,1
2403738,2403793,55,1,0,0,2
2403794,2404584,790,0,0,1,2
2403889,2404582,693,0,0,1,1
2404583,2404656,73,1,0,0,1
2404585,2404655,70,1,0,0,2
2404656,2404744,88,0,0,1,2
2404657,2404743,86,0,0,1,1
2404744,2404783,39,1,0,0,1
2404745,2404783,38,1,0,0,2
2404784,2406556,1772,0,0,1,1
2404784,2406556,1772,0,0,1,2
2406557,2406621,64,1,0,0,2
2406557,2406627,70,1,0,0,1
2406622,2409032,2410,0,0,1,2
2406628,2409033,2405,0,0,1,1
2409033,2409058,25,1,0,0,2
2409034,2409070,36,1,0,0,1
2409059,2409581,522,0,0,1,2
2409071,2409581,510,0,0,1,1
2409582,2409621,39,1,0,0,1
2409582,2409621,39,1,0,0,2
2409622,2409967,345,0,0,1,1
2409622,2409968,346,0,0,1,2
2409968,2410004,36,1,0,0,1
2409969,2410004,35,1,0,0,2
2410005,2410414,409,0,0,1,1
2410005,2410414,409,0,0,1,2
2410415,2410443,28,1,0,0,2
2410415,2410448,33,1,0,0,1
2410444,2410599,155,0,0,1,2
2410449,2410597,148,0,0,1,1
2410598,2410631,33,1,0,0,1
2410600,2410622,22,1,0,0,2
2410623,2410780,157,0,0,1,2
2410632,2410781,149,0,0,1,1
2410781,2410825,44,1,0,0,2
2410782,2410813,31,1,0,0,1
2410814,2410948,134,0,0,1,1
2410826,2410944,118,0,0,1,2
2410945,2411162,217,1,0,0,2
2410949,2411159,210,1,0,0,1
2410971,2411112,141,0,1,0,1
2410972,2411095,123,0,1,0,2
2411160,2411431,271,0,0,1,1
2411163,2411432,269,0,0,1,2
2411432,2411486,54,1,0,0,1
2411433,2411485,52,1,0,0,2
2411486,2411706,220,0,0,1,2
2411487,2411685,198,0,0,1,1
2411686,2418866,7180,1,0,0,1
2411707,2418167,6460,1,0,0,2
2411724,2418239,6515,0,1,0,1
2411733,2411951,218,0,1,0,2
2412052,2417893,5841,0,1,0,2
2418168,2418256,88,0,0,1,2
2418257,2418339,82,1,0,0,2
2418263,2418266,3,0,1,0,1
2418340,2418373,33,0,0,1,2
2418374,2418405,31,1,0,0,2
2418406,2418751,345,0,0,1,2
2418752,2418785,33,1,0,0,2
2418786,2419090,304,0,0,1,2
2418867,2419092,225,0,0,1,1
2419091,2419118,27,1,0,0,2
2419093,2419124,31,1,0,0,1
2419119,2419399,280,0,0,1,2
2419125,2419399,274,0,0,1,1
2419400,2419455,55,1,0,0,2
2419400,2420127,727,1,0,0,1
2419456,2419661,205,0,0,1,2
2419662,2419879,217,1,0,0,2
2419680,2419808,128,0,1,0,1
2419689,2419780,91,0,1,0,2
2419880,2420077,197,0,0,1,2
2420078,2420113,35,1,0,0,2
2420114,2420399,285,0,0,1,2
2420128,2420157,29,0,0,1,1
2420158,2420327,169,1,0,0,1
2420328,2420400,72,0,0,1,1
2420400,2420435,35,1,0,0,2
2420401,2420512,111,1,0,0,1
2420436,2420718,282,0,0,1,2
2420513,2420720,207,0,0,1,1
2420719,2421352,633,1,0,0,2
2420721,2421397,676,1,0,0,1
2420764,2421357,593,0,1,0,1
2421173,2421285,112,0,1,0,2
2421353,2421839,486,0,0,1,2
2421398,2421784,386,0,0,1,1
2421785,2421809,24,1,0,0,1
2421810,2421838,28,0,0,1,1
2421839,2421866,27,1,0,0,1
2421840,2421867,27,1,0,0,2
2421867,2421890,23,0,0,1,1
2421868,2422402,534,0,0,1,2
2421891,2422004,113,1,0,0,1
2422005,2422295,290,0,0,1,1
2422296,2422347,51,1,0,0,1
2422348,2422401,53,0,0,1,1
2422402,2422441,39,1,0,0,1
2422403,2422453,50,1,0,0,2
2422442,2422718,276,0,0,1,1
2422454,2422719,265,0,0,1,2
2422719,2422771,52,1,0,0,1
2422720,2422763,43,1,0,0,2
2422764,2422933,169,0,0,1,2
2422772,2422933,161,0,0,1,1
2487059,2487399,340,0,0,1,1
2487059,2487401,342,0,0,1,2
2487400,2489042,1642,1,0,0,1
2487402,2487484,82,1,0,0,2
2487485,2487666,181,0,0,1,2
2487667,2487693,26,1,0,0,2
2487694,2488313,619,0,0,1,2
2488314,2488330,16,1,0,0,2
2488331,2488570,239,0,0,1,2
2488571,2488586,15,1,0,0,2
2488587,2489393,806,0,0,1,2
2489043,2489218,175,0,0,1,1
2489219,2489539,320,1,0,0,1
2489394,2489473,79,1,0,0,2
2489474,2489789,315,0,0,1,2
2489540,2489789,249,0,0,1,1
2489790,2489847,57,1,0,0,2
2489790,2489878,88,1,0,0,1
2489848,2489948,100,0,0,1,2
2489879,2489947,68,0,0,1,1
2489948,2489971,23,1,0,0,1
2489949,2489980,31,1,0,0,2
2489972,2491068,1096,0,0,1,1
2489981,2491067,1086,0,0,1,2
2491068,2491142,74,1,0,0,2
2491069,2491145,76,1,0,0,1
2491143,2491514,371,0,0,1,2
2491146,2491513,367,0,0,1,1
2491514,2491587,73,1,0,0,1
2491515,2491591,76,1,0,0,2
2491588,2491673,85,0,0,1,1
2491592,2491673,81,0,0,1,2
2491674,2491704,30,1,0,0,2
2491674,2491768,94,1,0,0,1
2491705,2491945,240,0,0,1,2
2491769,2491805,36,0,0,1,1
2491806,2491826,20,1,0,0,1
2491827,2492992,1165,0,0,1,1
2491946,2491955,9,1,0,0,2
2491956,2492993,1037,0,0,1,2
2492993,2493069,76,1,0,0,1
2492994,2493070,76,1,0,0,2
2493070,2493433,363,0,0,1,1
2493071,2493431,360,0,0,1,2
2493432,2493498,66,1,0,0,2
2493434,2493500,66,1,0,0,1
2493499,2493609,110,0,0,1,2
2493501,2493609,108,0,0,1,1
2493610,2493628,18,1,0,0,1
2493610,2493631,21,1,0,0,2
2493629,2495236,1607,0,0,1,1
2493632,2495236,1604,0,0,1,2
2495237,2495361,124,1,0,0,1
2495237,2495372,135,1,0,0,2
2495362,2495434,72,0,0,1,1
2495373,2495433,60,0,0,1,2
2495434,2495474,40,1,0,0,2
2495435,2495475,40,1,0,0,1
2495475,2495970,495,0,0,1,2
2495476,2495964,488,0,0,1,1
2495965,2495984,19,1,0,0,1
2495971,2495982,11,1,0,0,2
2495983,2497084,1101,0,0,1,2
2495985,2497084,1099,0,0,1,1
2497085,2497173,88,1,0,0,1
2497085,2497174,89,1,0,0,2
2497174,2497313,139,0,0,1,1
2497175,2497314,139,0,0,1,2
2497314,2497397,83,1,0,0,1
2497315,2497391,76,1,0,0,2
2497392,2497483,91,0,0,1,2
2497398,2497483,85,0,0,1,1
2497484,2497513,29,1,0,0,1
2497484,2497516,32,1,0,0,2
2497514,2498783,1269,0,0,1,1
2497517,2498783,1266,0,0,1,2
2498784,2498854,70,1,0,0,2
2498784,2498863,79,1,0,0,1
2498855,2499184,329,0,0,1,2
2498864,2499184,320,0,0,1,1
2499185,2499277,92,1,0,0,2
2499185,2499278,93,1,0,0,1
2499278,2499356,78,0,0,1,2
2499279,2499357,78,0,0,1,1
2499357,2499403,46,1,0,0,2
2499358,2499411,53,1,0,0,1
2499404,2499622,218,0,0,1,2
2499412,2499635,223,0,0,1,1
2499623,2499672,49,1,0,0,2
2499636,2499677,41,1,0,0,1
2499673,2499707,34,0,0,1,2
2499678,2499708,30,0,0,1,1
2499708,2499831,123,1,0,0,2
2499719,2500019,300,0,1,0,1
2499832,2499927,95,0,0,1,2
2499928,2500642,714,1,0,0,2
2500029,2500823,794,1,0,0,1
2500058,2500578,520,0,1,0,1
2500599,2500615,16,0,1,0,1
2500643,2500956,313,0,0,1,2
2500824,2500949,125,0,0,1,1
2500950,2501043,93,1,0,0,1
2500957,2501024,67,1,0,0,2
2501025,2501115,90,0,0,1,2
2501044,2501111,67,0,0,1,1
2501112,2501159,47,1,0,0,1
2501116,2501508,392,1,0,0,2
2501160,2501990,830,0,0,1,1
2501509,2501569,60,0,0,1,2
2501570,2501739,169,1,0,0,2
2501740,2501834,94,0,0,1,2
2501835,2501938,103,1,0,0,2
2501939,2501980,41,0,0,1,2
2501981,2502202,221,1,0,0,2
2501991,2502042,51,1,0,0,1
2502043,2502081,38,0,0,1,1
2502082,2502205,123,1,0,0,1
2502203,2502630,427,0,0,1,2
2502206,2502630,424,0,0,1,1
2502631,2502750,119,1,0,0,2
2502631,2502786,155,1,0,0,1
2502751,2502850,99,0,0,1,2
2502787,2502851,64,0,0,1,1
2502851,2502892,41,1,0,0,2
2502852,2502889,37,1,0,0,1
2502890,2503052,162,0,0,1,1
2502893,2503051,158,0,0,1,2
2503052,2503071,19,1,0,0,2
2503053,2503071,18,1,0,0,1
2503072,2504108,1036,0,0,1,2
2503072,2504116,1044,0,0,1,1
2504109,2504297,188,1,0,0,2
2504117,2504320,203,1,0,0,1
2504152,2504251,99,0,1,0,1
2504168,2504226,58,0,1,0,2
2504298,2504556,258,0,0,1,2
2504321,2504555,234,0,0,1,1
2504556,2504637,81,1,0,0,1
2504557,2504631,74,1,0,0,2
2504632,2504783,151,0,0,1,2
2504638,2504779,141,0,0,1,1
2504780,2504852,72,1,0,0,1
2504784,2504810,26,1,0,0,2
2504811,2505348,537,0,0,1,2
2504853,2504963,110,0,0,1,1
2504964,2505867,903,1,0,0,1
2505349,2505371,22,1,0,0,2
2505372,2505788,416,0,0,1,2
2505611,2505806,195,0,1,0,1
2505789,2505849,60,1,0,0,2
2505850,2506164,314,0,0,1,2
2505868,2506166,298,0,0,1,1
2506165,2506218,53,1,0,0,2
2506167,2506231,64,1,0,0,1
2506219,2506393,174,0,0,1,2
2506232,2506393,161,0,0,1,1
2506394,2506422,28,1,0,0,2
2506394,2506430,36,1,0,0,1
2506423,2506728,305,0,0,1,2
2506431,2506724,293,0,0,1,1
2506725,2506746,21,1,0,0,1
2506729,2506743,14,1,0,0,2
2506744,2507688,944,0,0,1,2
2506747,2507685,938,0,0,1,1
2507686,2507756,70,1,0,0,1
2507689,2507747,58,1,0,0,2
2507748,2507938,190,0,0,1,2
2507757,2507857,100,0,0,1,1
2507858,2507865,7,1,0,0,1
2507866,2507909,43,0,0,1,1
2507910,2508041,131,1,0,0,1
2507939,2508046,107,1,0,0,2
2508042,2508093,51,0,0,1,1
2508047,2508091,44,0,0,1,2
2508092,2508137,45,1,0,0,2
2508094,2508146,52,1,0,0,1
2508138,2508241,103,0,0,1,2
2508147,2508239,92,0,0,1,1
2508240,2508273,33,1,0,0,1
2508242,2508261,19,1,0,0,2
2508262,2509525,1263,0,0,1,2
2508274,2509523,1249,0,0,1,1
2509524,2509621,97,1,0,0,1
2509526,2509622,96,1,0,0,2
2509622,2509909,287,0,0,1,1
2509623,2509910,287,0,0,1,2
2509910,2511275,1365,1,0,0,1
2509911,2510004,93,1,0,0,2
2510005,2510101,96,0,0,1,2
2510102,2510134,32,1,0,0,2
2510135,2511189,1054,0,0,1,2
2510615,2510844,229,0,1,0,1
2511093,2511213,120,0,1,0,1
2511190,2511272,82,1,0,0,2
2511273,2511651,378,0,0,1,2
2511276,2511362,86,0,0,1,1
2511363,2511401,38,1,0,0,1
2511402,2511563,161,0,0,1,1
2511564,2511705,141,1,0,0,1
2511652,2511702,50,1,0,0,2
2511703,2511782,79,0,0,1,2
2511706,2511781,75,0,0,1,1
2511782,2511849,67,1,0,0,1
2511783,2511850,67,1,0,0,2
2511850,2512050,200,0,0,1,1
2511851,2512048,197,0,0,1,2
2512049,2512078,29,1,0,0,2
2512051,2512078,27,1,0,0,1
2512079,2512352,273,0,0,1,1
2512079,2513319,1240,0,0,1,2
2512353,2512467,114,1,0,0,1
2512468,2513317,849,0,0,1,1
2513318,2513404,86,1,0,0,1
2513320,2513403,83,1,0,0,2
2513404,2513480,76,0,0,1,2
2513405,2513477,72,0,0,1,1
2513478,2513579,101,1,0,0,1
2513481,2513530,49,1,0,0,2
2513531,2513684,153,0,0,1,2
2513580,2513627,47,0,0,1,1
2513628,2513769,141,1,0,0,1
2513685,2513715,30,1,0,0,2
2513716,2514488,772,0,0,1,2
2513770,2513939,169,0,0,1,1
2513940,2514151,211,1,0,0,1
2514152,2514178,26,0,0,1,1
2514179,2514564,385,1,0,0,1
2514489,2514555,66,1,0,0,2
2514556,2514940,384,0,0,1,2
2514565,2514939,374,0,0,1,1
2514940,2514990,50,1,0,0,1
2514941,2514995,54,1,0,0,2
2514991,2515117,126,0,0,1,1
2514996,2515117,121,0,0,1,2
2515118,2515141,23,1,0,0,2
2515118,2515147,29,1,0,0,1
2515142,2515419,277,0,0,1,2
2515148,2515416,268,0,0,1,1
2515417,2515433,16,1,0,0,1
2515420,2515433,13,1,0,0,2
2515434,2516388,954,0,0,1,2
2515434,2516389,955,0,0,1,1
2516389,2516447,58,1,0,0,2
2516390,2516454,64,1,0,0,1
2516448,2516621,173,0,0,1,2
2516455,2516622,167,0,0,1,1
2516622,2516757,135,1,0,0,2
2516623,2516704,81,1,0,0,1
2516705,2516805,100,0,0,1,1
2516758,2516804,46,0,0,1,2
2516805,2516839,34,1,0,0,2
2516806,2516837,31,1,0,0,1
2516838,2517570,732,0,0,1,1
2516840,2517571,731,0,0,1,2
2517571,2517868,297,1,0,0,1
2517572,2517646,74,1,0,0,2
2517647,2518027,380,0,0,1,2
2517869,2517890,21,0,0,1,1
2517891,2518127,236,1,0,0,1
2518028,2518227,199,1,0,0,2
2518128,2518345,217,0,0,1,1
2518228,2518345,117,0,0,1,2
2518346,2518380,34,1,0,0,1
2518346,2518384,38,1,0,0,2
2518381,2518415,34,0,0,1,1
2518385,2518654,269,0,0,1,2
2518426,2518558,132,0,1,0,1
2518568,2519579,1011,1,0,0,1
2518594,2519173,579,0,1,0,1
2518655,2519578,923,1,0,0,2
2519579,2519628,49,0,0,1,2
2519580,2519698,118,0,0,1,1
2519629,2519722,93,1,0,0,2
2519699,2519728,29,1,0,0,1
2519723,2521043,1320,0,0,1,2
2519729,2521082,1353,0,0,1,1
2521044,2521213,169,1,0,0,2
2521083,2521224,141,1,0,0,1
2521214,2521333,119,0,0,1,2
2521225,2521333,108,0,0,1,1
2521334,2521360,26,1,0,0,2
2521334,2521366,32,1,0,0,1
2521361,2522548,1187,0,0,1,2
2521367,2522551,1184,0,0,1,1
2522549,2522639,90,1,0,0,2
2522552,2522640,88,1,0,0,1
2522640,2522782,142,0,0,1,2
2522641,2522780,139,0,0,1,1
2522781,2522837,56,1,0,0,1
2522783,2522838,55,1,0,0,2
2522838,2522957,119,0,0,1,1
2522839,2522959,120,0,0,1,2
2522958,2522987,29,1,0,0,1
2522960,2522980,20,1,0,0,2
2522981,2523492,511,0,0,1,2
2522988,2523488,500,0,0,1,1
2523489,2523513,24,1,0,0,1
2523493,2523502,9,1,0,0,2
2523503,2524477,974,0,0,1,2
2523514,2524476,962,0,0,1,1
2524477,2525919,1442,1,0,0,1
2524478,2524582,104,1,0,0,2
2524550,2525840,1290,0,1,0,1
2524583,2524608,25,0,0,1,2
2524609,2524613,4,1,0,0,2
2524614,2524707,93,0,0,1,2
2524708,2524845,137,1,0,0,2
2524846,2524939,93,0,0,1,2
2524940,2525092,152,1,0,0,2
2525093,2525147,54,0,0,1,2
2525148,2525169,21,1,0,0,2
2525170,2525216,46,0,0,1,2
2525217,2525245,28,1,0,0,2
2525246,2525269,23,0,0,1,2
2525270,2525639,369,1,0,0,2
2525640,2525772,132,0,0,1,2
2525773,2525870,97,1,0,0,2
2525871,2526304,433,0,0,1,2
2525920,2526281,361,0,0,1,1
2526282,2526439,157,1,0,0,1
2526305,2526411,106,1,0,0,2
2526412,2526547,135,0,0,1,2
2526440,2526546,106,0,0,1,1
2526547,2526579,32,1,0,0,1
2526548,2526578,30,1,0,0,2
2526579,2527609,1030,0,0,1,2
2526580,2527610,1030,0,0,1,1
2527610,2527704,94,1,0,0,2
2527611,2527704,93,1,0,0,1
2527705,2528198,493,0,0,1,1
2527705,2528199,494,0,0,1,2
2528199,2528260,61,1,0,0,1
2528200,2528263,63,1,0,0,2
2528261,2528378,117,0,0,1,1
2528264,2528378,114,0,0,1,2
2528379,2528407,28,1,0,0,1
2528379,2528408,29,1,0,0,2
2528408,2528858,450,0,0,1,1
2528409,2528859,450,0,0,1,2
2528859,2528886,27,1,0,0,1
2528860,2528876,16,1,0,0,2
2528877,2529170,293,0,0,1,2
2528887,2529174,287,0,0,1,1
2529171,2529189,18,1,0,0,2
2529175,2529187,12,1,0,0,1
2529188,2529873,685,0,0,1,1
2529190,2529872,682,0,0,1,2
2529873,2530016,143,1,0,0,2
2529874,2530015,141,1,0,0,1
2530016,2530098,82,0,0,1,1
2530017,2530097,80,0,0,1,2
2530098,2530533,435,1,0,0,2
2530099,2530150,51,1,0,0,1
2530151,2530186,35,0,0,1,1
2530187,2531385,1198,1,0,0,1
2530247,2530273,26,0,1,0,1
2530296,2530315,19,0,1,0,1
2530373,2530965,592,0,1,0,1
2530534,2530621,87,0,0,1,2
2530622,2531792,1170,1,0,0,2
2531007,2531301,294,0,1,0,1
2531323,2531359,36,0,1,0,1
2531386,2531671,285,0,0,1,1
2531672,2531820,148,1,0,0,1
2531793,2531832,39,0,0,1,2
2531821,2531882,61,0,0,1,1
2531833,2531856,23,1,0,0,2
2531857,2531884,27,0,0,1,2
2531883,2531936,53,1,0,0,1
2531885,2531986,101,1,0,0,2
2531937,2531970,33,0,0,1,1
2531971,2531989,18,1,0,0,1
2531987,2532071,84,0,0,1,2
2531990,2532600,610,0,0,1,1
2532072,2532116,44,1,0,0,2
2532117,2532732,615,0,0,1,2
2532601,2532692,91,1,0,0,1
2532693,2532757,64,0,0,1,1
2532733,2532746,13,1,0,0,2
2532747,2532799,52,0,0,1,2
2532758,2532923,165,1,0,0,1
2532800,2532892,92,1,0,0,2
2532893,2533249,356,0,0,1,2
2532924,2533249,325,0,0,1,1
2533250,2533326,76,1,0,0,1
2533250,2533326,76,1,0,0,2
2533327,2533470,143,0,0,1,2
2533327,2533472,145,0,0,1,1
2533471,2533480,9,1,0,0,2
2533473,2533483,10,1,0,0,1
2533481,2534924,1443,0,0,1,2
2533484,2534923,1439,0,0,1,1
2534924,2535009,85,1,0,0,1
2534925,2535006,81,1,0,0,2
2535007,2535140,133,0,0,1,2
2535010,2535139,129,0,0,1,1
2535140,2535171,31,1,0,0,1
2535141,2535163,22,1,0,0,2
2535164,2535355,191,0,0,1,2
2535172,2535352,180,0,0,1,1
2535353,2535381,28,1,0,0,1
2535356,2535378,22,1,0,0,2
2535379,2536624,1245,0,0,1,2
2535382,2536625,1243,0,0,1,1
2536625,2536686,61,1,0,0,2
2536626,2536703,77,1,0,0,1
2536687,2536782,95,0,0,1,2
2536704,2536778,74,0,0,1,1
2536779,2537086,307,1,0,0,1
2536783,2536845,62,1,0,0,2
2536846,2536889,43,0,0,1,2
2536890,2537078,188,1,0,0,2
2536908,2537047,139,0,1,0,1
2536916,2537028,112,0,1,0,2
2537079,2537245,166,0,0,1,2
2537087,2537247,160,0,0,1,1
2537246,2537264,18,1,0,0,2
2537248,2537263,15,1,0,0,1
2537264,2538544,1280,0,0,1,1
2537265,2538547,1282,0,0,1,2
2538545,2538607,62,1,0,0,1
2538548,2538611,63,1,0,0,2
2538608,2538726,118,0,0,1,1
2538612,2538726,114,0,0,1,2
2538727,2538751,24,1,0,0,2
2538727,2538757,30,1,0,0,1
2538752,2539832,1080,0,0,1,2
2538758,2539833,1075,0,0,1,1
2539833,2539910,77,1,0,0,2
2539834,2539902,68,1,0,0,1
2539903,2540355,452,0,0,1,1
2539911,2540355,444,0,0,1,2
2540356,2540452,96,1,0,0,2
2540356,2541533,1177,1,0,0,1
2540422,2541516,1094,0,1,0,1
2540453,2540682,229,0,0,1,2
2540683,2540737,54,1,0,0,2
2540738,2540801,63,0,0,1,2
2540802,2541518,716,1,0,0,2
2541519,2541969,450,0,0,1,2
2541534,2541855,321,0,0,1,1
2541856,2541867,11,1,0,0,1
2541868,2541922,54,0,0,1,1
2541923,2542035,112,1,0,0,1
2541970,2542034,64,1,0,0,2
2542035,2542141,106,0,0,1,2
2542036,2542141,105,0,0,1,1
2542142,2542172,30,1,0,0,1
2542142,2542175,33,1,0,0,2
2542173,2542734,561,0,0,1,1
2542176,2542739,563,0,0,1,2
2542735,2542757,22,1,0,0,1
2542740,2542749,9,1,0,0,2
2542750,2543232,482,0,0,1,2
2542758,2543231,473,0,0,1,1
2543232,2543302,70,1,0,0,1
2543233,2543302,69,1,0,0,2
2543303,2543555,252,0,0,1,1
2543303,2543555,252,0,0,1,2
2543556,2543619,63,1,0,0,1
2543556,2543620,64,1,0,0,2
2543620,2543780,160,0,0,1,1
2543621,2543782,161,0,0,1,2
2543781,2543813,32,1,0,0,1
2543783,2543806,23,1,0,0,2
2543807,2545103,1296,0,0,1,2
2543814,2545102,1288,0,0,1,1
2545103,2545186,83,1,0,0,1
2545104,2545181,77,1,0,0,2
2545182,2545283,101,0,0,1,2
2545187,2545282,95,0,0,1,1
2545283,2545319,36,1,0,0,1
2545284,2545310,26,1,0,0,2
2545311,2546276,965,0,0,1,2
2545320,2546276,956,0,0,1,1
2546277,2546335,58,1,0,0,1
2546277,2546336,59,1,0,0,2
2546336,2546717,381,0,0,1,1
2546337,2546716,379,0,0,1,2
2546717,2546787,70,1,0,0,2
2546718,2546788,70,1,0,0,1
2546788,2546935,147,0,0,1,2
2546789,2546934,145,0,0,1,1
2546935,2546964,29,1,0,0,1
2546936,2546967,31,1,0,0,2
2546965,2548248,1283,0,0,1,1
2546968,2548248,1280,0,0,1,2
2548249,2548343,94,1,0,0,1
2548249,2548343,94,1,0,0,2
2548344,2548412,68,0,0,1,1
2548344,2548414,70,0,0,1,2
2548413,2548488,75,1,0,0,1
2548415,2548486,71,1,0,0,2
2548487,2548655,168,0,0,1,2
2548489,2548652,163,0,0,1,1
2548653,2548685,32,1,0,0,1
2548656,2548679,23,1,0,0,2
2548680,2549370,690,0,0,1,2
2548686,2549370,684,0,0,1,1
2549371,2549439,68,1,0,0,2
2549371,2549449,78,1,0,0,1
2549440,2549941,501,0,0,1,2
2549450,2549941,491,0,0,1,1
2549942,2550034,92,1,0,0,2
2549942,2550059,117,1,0,0,1
2550035,2550148,113,0,0,1,2
2550060,2550145,85,0,0,1,1
2550146,2550178,32,1,0,0,1
2550149,2550167,18,1,0,0,2
2550168,2550483,315,0,0,1,2
2550179,2550280,101,0,0,1,1
2550281,2550294,13,1,0,0,1
2550295,2550478,183,0,0,1,1
2550479,2550519,40,1,0,0,1
2550484,2550496,12,1,0,0,2
2550497,2551048,551,0,0,1,2
2550520,2551047,527,0,0,1,1
2551048,2551139,91,1,0,0,1
2551049,2551132,83,1,0,0,2
2551133,2551508,375,0,0,1,2
2551140,2551508,368,0,0,1,1
2551509,2551570,61,1,0,0,2
2551509,2551571,62,1,0,0,1
2551571,2551650,79,0,0,1,2
2551572,2551650,78,0,0,1,1
2551651,2551688,37,1,0,0,1
2551651,2551694,43,1,0,0,2
2551689,2553003,1314,0,0,1,1
2551695,2553004,1309,0,0,1,2
2553004,2553082,78,1,0,0,1
2553005,2553083,78,1,0,0,2
2553083,2553115,32,0,0,1,1
2553084,2553110,26,0,0,1,2
2553111,2553147,36,1,0,0,2
2553116,2553138,22,1,0,0,1
2553139,2553258,119,0,0,1,1
2553148,2553258,110,0,0,1,2
2553259,2553334,75,1,0,0,2
2553259,2553340,81,1,0,0,1
2553335,2553458,123,0,0,1,2
2553341,2553455,114,0,0,1,1
2553456,2553481,25,1,0,0,1
2553459,2553489,30,1,0,0,2
2553482,2554553,1071,0,0,1,1
2553490,2554554,1064,0,0,1,2
2554554,2554650,96,1,0,0,1
2554555,2554654,99,1,0,0,2
2554651,2554799,148,0,0,1,1
2554655,2554799,144,0,0,1,2
2554800,2554903,103,1,0,0,2
2554800,2555860,1060,1,0,0,1
2554904,2555012,108,0,0,1,2
2555013,2555048,35,1,0,0,2
2555049,2555509,460,0,0,1,2
2555174,2555181,7,0,1,0,1
2555204,2555209,5,0,1,0,1
2555232,2555850,618,0,1,0,1
2555510,2555542,32,1,0,0,2
2555543,2555757,214,0,0,1,2
2555758,2555845,87,1,0,0,2
2555846,2556259,413,0,0,1,2
2555861,2556259,398,0,0,1,1
2556260,2556316,56,1,0,0,1
2556260,2556320,60,1,0,0,2
2556317,2557879,1562,0,0,1,1
2556321,2557882,1561,0,0,1,2
2557880,2559732,1852,1,0,0,1
2557883,2559020,1137,1,0,0,2
2557971,2559385,1414,0,1,0,1
2559021,2559045,24,0,0,1,2
2559046,2559158,112,1,0,0,2
2559159,2559227,68,0,0,1,2
2559228,2559447,219,1,0,0,2
2559448,2559581,133,0,0,1,2
2559582,2559631,49,1,0,0,2
2559602,2559603,1,0,1,0,1
2559632,2559761,129,0,0,1,2
2559733,2559756,23,0,0,1,1
2559757,2559787,30,1,0,0,1
2559762,2559779,17,1,0,0,2
2559780,2559892,112,0,0,1,2
2559788,2559859,71,0,0,1,1
2559860,2560095,235,1,0,0,1
2559893,2560062,169,1,0,0,2
2559905,2560037,132,0,1,0,1
2559918,2560002,84,0,1,0,2
2560063,2560888,825,0,0,1,2
2560096,2560268,172,0,0,1,1
2560269,2560331,62,1,0,0,1
2560332,2560371,39,0,0,1,1
2560372,2560388,16,1,0,0,1
2560389,2560428,39,0,0,1,1
2560429,2560627,198,1,0,0,1
2560628,2560687,59,0,0,1,1
2560688,2560831,143,1,0,0,1
2560832,2560878,46,0,0,1,1
2560879,2560953,74,1,0,0,1
2560889,2560950,61,1,0,0,2
2560951,2561158,207,0,0,1,2
2560954,2561158,204,0,0,1,1
2561159,2561227,68,1,0,0,2
2561159,2561228,69,1,0,0,1
2561228,2561323,95,0,0,1,2
2561229,2561327,98,0,0,1,1
2561324,2561357,33,1,0,0,2
2561328,2561363,35,1,0,0,1
2561358,2562097,739,0,0,1,2
2561364,2561899,535,0,0,1,1
2561900,2561904,4,1,0,0,1
2561905,2562020,115,0,0,1,1
2562021,2562056,35,1,0,0,1
2562057,2562115,58,0,0,1,1
2562098,2562192,94,1,0,0,2
2562116,2562751,635,1,0,0,1
2562193,2562292,99,0,0,1,2
2562255,2562740,485,0,1,0,1
2562293,2562749,456,1,0,0,2
2562750,2564376,1626,0,0,1,2
2562752,2564375,1623,0,0,1,1
2564376,2564472,96,1,0,0,1
2564377,2564440,63,1,0,0,2
2564441,2564525,84,0,0,1,2
2564473,2564526,53,0,0,1,1
2564526,2564564,38,1,0,0,2
2564527,2564565,38,1,0,0,1
2564565,2564808,243,0,0,1,2
2564566,2564807,241,0,0,1,1
2564808,2564822,14,1,0,0,1
2564809,2564817,8,1,0,0,2
2564818,2565551,733,0,0,1,2
2564823,2565554,731,0,0,1,1
2565552,2565628,76,1,0,0,2
2565555,2565630,75,1,0,0,1
2565629,2565884,255,0,0,1,2
2565631,2565881,250,0,0,1,1
2565882,2565954,72,1,0,0,1
2565885,2565965,80,1,0,0,2
2565955,2566217,262,0,0,1,1
2565966,2566218,252,0,0,1,2
2566218,2566246,28,1,0,0,1
2566219,2566247,28,1,0,0,2
2566247,2567239,992,0,0,1,1
2566248,2567238,990,0,0,1,2
2567239,2567324,85,1,0,0,2
2567240,2567324,84,1,0,0,1
2567325,2567442,117,0,0,1,1
2567325,2567442,117,0,0,1,2
2567443,2567517,74,1,0,0,2
2567443,2567518,75,1,0,0,1
2567518,2567632,114,0,0,1,2
2567519,2567632,113,0,0,1,1
2567633,2567659,26,1,0,0,2
2567633,2567670,37,1,0,0,1
2567660,2568712,1052,0,0,1,2
2567671,2568713,1042,0,0,1,1
2568713,2568852,139,1,0,0,2
2568714,2568837,123,1,0,0,1
2568838,2569087,249,0,0,1,1
2568853,2569086,233,0,0,1,2
2569087,2569134,47,1,0,0,2
2569088,2569134,46,1,0,0,1
2569135,2570555,1420,0,0,1,2
2569135,2570557,1422,0,0,1,1
2570556,2570626,70,1,0,0,2
2570558,2570628,70,1,0,0,1
2570627,2570816,189,0,0,1,2
2570629,2570814,185,0,0,1,1
2570815,2570842,27,1,0,0,1
2570817,2570833,16,1,0,0,2
2570834,2571770,936,0,0,1,2
2570843,2571770,927,0,0,1,1
2571771,2571784,13,1,0,0,2
2571771,2571785,14,1,0,0,1
2571785,2572410,625,0,0,1,2
2571786,2572408,622,0,0,1,1
2572409,2572481,72,1,0,0,1
2572411,2572468,57,1,0,0,2
2572469,2573159,690,0,0,1,2
2572482,2573159,677,0,0,1,1
2573160,2573178,18,1,0,0,2
2573160,2573187,27,1,0,0,1
2573179,2574565,1386,0,0,1,2
2573188,2574562,1374,0,0,1,1
2574563,2574654,91,1,0,0,1
2574566,2574648,82,1,0,0,2
2574649,2576051,1402,0,0,1,2
2574655,2576051,1396,0,0,1,1
2576052,2576095,43,1,0,0,1
2576052,2576095,43,1,0,0,2
2576096,2576352,256,0,0,1,2
2576096,2576353,257,0,0,1,1
2576353,2576424,71,1,0,0,2
2576354,2576424,70,1,0,0,1
2576425,2576554,129,0,0,1,1
2576425,2576554,129,0,0,1,2
2576555,2576574,19,1,0,0,2
2576555,2576581,26,1,0,0,1
2576575,2576821,246,0,0,1,2
2576582,2576824,242,0,0,1,1
2576822,2576848,26,1,0,0,2
2576825,2576838,13,1,0,0,1
2576839,2577163,324,0,0,1,1
2576849,2577163,314,0,0,1,2
2577164,2577171,7,1,0,0,2
2577164,2577188,24,1,0,0,1
2577172,2577613,441,0,0,1,2
2577189,2577614,425,0,0,1,1
2577614,2577665,51,1,0,0,2
2577615,2577676,61,1,0,0,1
2577666,2577816,150,0,0,1,2
2577677,2577816,139,0,0,1,1
2577817,2577835,18,1,0,0,1
2577817,2577835,18,1,0,0,2
2577836,2578784,948,0,0,1,1
2577836,2579993,2157,0,0,1,2
2578785,2578809,24,1,0,0,1
2578810,2579055,245,0,0,1,1
2579056,2579182,126,1,0,0,1
2579183,2579276,93,0,0,1,1
2579277,2579462,185,1,0,0,1
2579463,2579534,71,0,0,1,1
2579535,2579632,97,1,0,0,1
2579633,2579683,50,0,0,1,1
2579684,2579688,4,1,0,0,1
2579689,2579993,304,0,0,1,1
2579994,2580054,60,1,0,0,2
2579994,2580099,105,1,0,0,1
2580055,2581259,1204,0,0,1,2
2580100,2581258,1158,0,0,1,1
2581259,2581455,196,1,0,0,1
2581260,2581341,81,1,0,0,2
2581342,2581427,85,0,0,1,2
2581428,2581466,38,1,0,0,2
2581456,2581564,108,0,0,1,1
2581467,2583107,1640,0,0,1,2
2581565,2581584,19,1,0,0,1
2581585,2581610,25,0,0,1,1
2581611,2583197,1586,1,0,0,1
2582270,2582878,608,0,1,0,1
2582933,2582951,18,0,1,0,1
2582990,2583013,23,0,1,0,1
2583035,2583062,27,0,1,0,1
2583108,2583170,62,1,0,0,2
2583121,2583122,1,0,1,0,1
2583171,2583554,383,0,0,1,2
2583198,2583554,356,0,0,1,1
2583555,2583578,23,1,0,0,2
2583555,2583597,42,1,0,0,1
2583579,2587318,3739,0,0,1,2
2583598,2584274,676,0,0,1,1
2584275,2584296,21,1,0,0,1
2584297,2584373,76,0,0,1,1
2584374,2584438,64,1,0,0,1
2584439,2584586,147,0,0,1,1
2584587,2584668,81,1,0,0,1
2584669,2584709,40,0,0,1,1
2584710,2584730,20,1,0,0,1
2584731,2584798,67,0,0,1,1
2584799,2584832,33,1,0,0,1
2584833,2584873,40,0,0,1,1
2584874,2584899,25,1,0,0,1
2584900,2584936,36,0,0,1,1
2584937,2585058,121,1,0,0,1
2585059,2585110,51,0,0,1,1
2585111,2585574,463,1,0,0,1
2585575,2585597,22,0,0,1,1
2585598,2587475,1877,1,0,0,1
2587319,2587404,85,1,0,0,2
2587405,2587426,21,0,0,1,2
2587427,2587477,50,1,0,0,2
2587476,2587588,112,0,0,1,1
2587478,2587588,110,0,0,1,2
2587589,2587607,18,1,0,0,1
2587589,2587608,19,1,0,0,2
2587608,2588709,1101,0,0,1,1
2587609,2588709,1100,0,0,1,2
2588710,2588757,47,1,0,0,1
2588710,2588758,48,1,0,0,2
2588758,2592280,3522,0,0,1,1
2588759,2592280,3521,0,0,1,2
2592281,2592349,68,1,0,0,2
2592281,2592356,75,1,0,0,1
2592350,2592461,111,0,0,1,2
2592357,2592461,104,0,0,1,1
2592462,2592485,23,1,0,0,1
2592462,2592493,31,1,0,0,2
2592486,2593730,1244,0,0,1,1
2592494,2593731,1237,0,0,1,2
2593731,2593791,60,1,0,0,1
2593732,2593797,65,1,0,0,2
2593792,2593915,123,0,0,1,1
2593798,2593919,121,0,0,1,2
2593916,2593963,47,1,0,0,1
2593920,2593974,54,1,0,0,2
2593964,2596318,2354,0,0,1,1
2593975,2594050,75,0,0,1,2
2594051,2594055,4,1,0,0,2
2594056,2594448,392,0,0,1,2
2594449,2594459,10,1,0,0,2
2594460,2594534,74,0,0,1,2
2594535,2594565,30,1,0,0,2
2594566,2594598,32,0,0,1,2
2594599,2596460,1861,1,0,0,2
2596319,2596328,9,1,0,0,1
2596329,2596394,65,0,0,1,1
2596395,2596471,76,1,0,0,1
2596461,2596902,441,0,0,1,2
2596472,2596904,432,0,0,1,1
2596903,2596979,76,1,0,0,2
2596905,2596981,76,1,0,0,1
2596980,2597003,23,0,0,1,2
2596982,2597163,181,0,0,1,1
2597004,2598002,998,1,0,0,2
2597164,2597197,33,1,0,0,1
2597198,2598421,1223,0,0,1,1
2598003,2598064,61,0,0,1,2
2598065,2598296,231,1,0,0,2
2598297,2598337,40,0,0,1,2
2598338,2598684,346,1,0,0,2
2598422,2598668,246,1,0,0,1
2598669,2598704,35,0,0,1,1
2598685,2598764,79,0,0,1,2
2598705,2598764,59,1,0,0,1
2598765,2598838,73,1,0,0,2
2598765,2598880,115,0,0,1,1
2598839,2598929,90,0,0,1,2
2598881,2599177,296,1,0,0,1
2598930,2599077,147,1,0,0,2
2599078,2599135,57,0,0,1,2
2599136,2599391,255,1,0,0,2
2599178,2599238,60,0,0,1,1
2599239,2599317,78,1,0,0,1
2599267,2599270,3,0,1,0,1
2599318,2599351,33,0,0,1,1
2599352,2599435,83,1,0,0,1
2599392,2599445,53,0,0,1,2
2599436,2599530,94,0,0,1,1
2599446,2599799,353,1,0,0,2
2599531,2599663,132,1,0,0,1
2599664,2599705,41,0,0,1,1
2599706,2600508,802,1,0,0,1
2599800,2599849,49,0,0,1,2
2599850,2600103,253,1,0,0,2
2600104,2600124,20,0,0,1,2
2600125,2601037,912,1,0,0,2
2600509,2600565,56,0,0,1,1
2600566,2601394,828,1,0,0,1
2601038,2602728,1690,0,0,1,2
2601395,2602728,1333,0,0,1,1
2602729,2602770,41,1,0,0,2
2602729,2602872,143,1,0,0,1
2602771,2604256,1485,0,0,1,2
2602873,2604255,1382,0,0,1,1
2604256,2604315,59,1,0,0,1
2604257,2604307,50,1,0,0,2
2604308,2604441,133,0,0,1,2
2604316,2604441,125,0,0,1,1
2604442,2604462,20,1,0,0,1
2604442,2604473,31,1,0,0,2
2604463,2604718,255,0,0,1,1
2604474,2604719,245,0,0,1,2
2604719,2604737,18,1,0,0,1
2604720,2604747,27,1,0,0,2
2604738,2604827,89,0,0,1,1
2604748,2604827,79,0,0,1,2
2604828,2604851,23,1,0,0,2
2604828,2604861,33,1,0,0,1
2604852,2604922,70,0,0,1,2
2604862,2604912,50,0,0,1,1
2604913,2605054,141,1,0,0,1
2604923,2604958,35,1,0,0,2
2604959,2605097,138,0,0,1,2
2605055,2605083,28,0,0,1,1
2605084,2605279,195,1,0,0,1
2605098,2605244,146,1,0,0,2
2605119,2605210,91,0,1,0,1
2605130,2605188,58,0,1,0,2
2605245,2605469,224,0,0,1,2
2605280,2605473,193,0,0,1,1
2605470,2605492,22,1,0,0,2
2605474,2605489,15,1,0,0,1
2605490,2605629,139,0,0,1,1
2605493,2605628,135,0,0,1,2
2605629,2605644,15,1,0,0,2
2605630,2605653,23,1,0,0,1
2605645,2606292,647,0,0,1,2
2605654,2606293,639,0,0,1,1
2606293,2606352,59,1,0,0,2
2606294,2606351,57,1,0,0,1
2606352,2606544,192,0,0,1,1
2606353,2606544,191,0,0,1,2
2606545,2606600,55,1,0,0,1
2606545,2606602,57,1,0,0,2
2606601,2606960,359,0,0,1,1
2606603,2606959,356,0,0,1,2
2606960,2606990,30,1,0,0,2
2606961,2606983,22,1,0,0,1
2606984,2607248,264,0,0,1,1
2606991,2607249,258,0,0,1,2
2607249,2607303,54,1,0,0,1
2607250,2607302,52,1,0,0,2
2607303,2607711,408,0,0,1,2
2607304,2607711,407,0,0,1,1
2607712,2607750,38,1,0,0,1
2607712,2607750,38,1,0,0,2
2607751,2608001,250,0,0,1,1
2607751,2608003,252,0,0,1,2
2608002,2608050,48,1,0,0,1
2608004,2608050,46,1,0,0,2
2608051,2608101,50,0,0,1,2
2608051,2608102,51,0,0,1,1
2608102,2608179,77,1,0,0,2
2608103,2608189,86,1,0,0,1
2608180,2608266,86,0,0,1,2
2608190,2608267,77,0,0,1,1
2608267,2608302,35,1,0,0,2
2608268,2608297,29,1,0,0,1
2608298,2608540,242,0,0,1,1
2608303,2608535,232,0,0,1,2
2608536,2608548,12,1,0,0,2
2608541,2608568,27,1,0,0,1
2608549,2609168,619,0,0,1,2
2608569,2609171,602,0,0,1,1
2609169,2609184,15,1,0,0,2
2609172,2609194,22,1,0,0,1
2609185,2609553,368,0,0,1,2
2609195,2609558,363,0,0,1,1
2609554,2609580,26,1,0,0,2
2609559,2609574,15,1,0,0,1
2609575,2609787,212,0,0,1,1
2609581,2609789,208,0,0,1,2
2609788,2609801,13,1,0,0,1
2609790,2609798,8,1,0,0,2
2609799,2609905,106,0,0,1,2
2609802,2609904,102,0,0,1,1
2609905,2609966,61,1,0,0,1
2609906,2609956,50,1,0,0,2
2609957,2610212,255,0,0,1,2
2609967,2610204,237,0,0,1,1
2610205,2610403,198,1,0,0,1
2610213,2610398,185,1,0,0,2
2610230,2610382,152,0,1,0,1
2610239,2610355,116,0,1,0,2
2610399,2610771,372,0,0,1,2
2610404,2610770,366,0,0,1,1
2610771,2610802,31,1,0,0,1
2610772,2610795,23,1,0,0,2
2610796,2611232,436,0,0,1,2
2610803,2611233,430,0,0,1,1
2611233,2611264,31,1,0,0,2
2611234,2611257,23,1,0,0,1
2611258,2611604,346,0,0,1,1
2611265,2611605,340,0,0,1,2
2611605,2611625,20,1,0,0,1
2611606,2611621,15,1,0,0,2
2611622,2612031,409,0,0,1,2
2611626,2612032,406,0,0,1,1
2612032,2612064,32,1,0,0,2
2612033,2612064,31,1,0,0,1
2612065,2612383,318,0,0,1,1
2612065,2612383,318,0,0,1,2
2612384,2612433,49,1,0,0,2
2612384,2612439,55,1,0,0,1
2612434,2612883,449,0,0,1,2
2612440,2612884,444,0,0,1,1
2612884,2612924,40,1,0,0,2
2612885,2612924,39,1,0,0,1
2612925,2613154,229,0,0,1,1
2612925,2613155,230,0,0,1,2
2613155,2613188,33,1,0,0,1
2613156,2613187,31,1,0,0,2
2613188,2613615,427,0,0,1,2
2613189,2613617,428,0,0,1,1
2613616,2613652,36,1,0,0,2
2613618,2613649,31,1,0,0,1
2613650,2614777,1127,0,0,1,1
2613653,2614088,435,0,0,1,2
2614089,2614098,9,1,0,0,2
2614099,2614782,683,0,0,1,2
2614778,2614801,23,1,0,0,1
2614783,2614792,9,1,0,0,2
2614793,2614940,147,0,0,1,2
2614802,2614940,138,0,0,1,1
2614941,2614991,50,1,0,0,2
2614941,2614992,51,1,0,0,1
2614992,2615231,239,0,0,1,2
2614993,2615230,237,0,0,1,1
2615231,2615261,30,1,0,0,1
2615232,2615252,20,1,0,0,2
2615253,2616116,863,0,0,1,2
2615262,2616117,855,0,0,1,1
2616117,2616147,30,1,0,0,2
2616118,2616138,20,1,0,0,1
2616139,2616652,513,0,0,1,1
2616148,2616654,506,0,0,1,2
2616653,2616685,32,1,0,0,1
2616655,2616684,29,1,0,0,2
2616685,2617187,502,0,0,1,2
2616686,2617187,501,0,0,1,1
2617188,2617212,24,1,0,0,1
2617188,2617214,26,1,0,0,2
2617213,2617838,625,0,0,1,1
2617215,2617837,622,0,0,1,2
2617838,2617885,47,1,0,0,2
2617839,2617919,80,1,0,0,1
2617886,2618157,271,0,0,1,2
2617920,2618159,239,0,0,1,1
2618158,2618227,69,1,0,0,2
2618160,2618231,71,1,0,0,1
2618228,2618306,78,0,0,1,2
2618232,2618305,73,0,0,1,1
2618306,2618353,47,1,0,0,1
2618307,2618350,43,1,0,0,2
2618351,2618580,229,0,0,1,2
2618354,2618580,226,0,0,1,1
2618581,2618600,19,1,0,0,2
2618581,2618605,24,1,0,0,1
2618601,2619860,1259,0,0,1,2
2618606,2619858,1252,0,0,1,1
2619859,2619928,69,1,0,0,1
2619861,2619929,68,1,0,0,2
2619929,2620174,245,0,0,1,1
2619930,2620177,247,0,0,1,2
2620175,2620206,31,1,0,0,1
2620178,2620202,24,1,0,0,2
2620203,2621263,1060,0,0,1,2
2620207,2621259,1052,0,0,1,1
2621260,2621281,21,1,0,0,1
2621264,2621280,16,1,0,0,2
2621281,2622385,1104,0,0,1,2
2621282,2622383,1101,0,0,1,1
2622384,2622407,23,1,0,0,1
2622386,2622405,19,1,0,0,2
2622406,2623056,650,0,0,1,2
2622408,2623055,647,0,0,1,1
2623056,2623117,61,1,0,0,1
2623057,2623109,52,1,0,0,2
2623110,2623554,444,0,0,1,2
2623118,2623555,437,0,0,1,1
2623555,2623589,34,1,0,0,2
2623556,2623589,33,1,0,0,1
2623590,2623740,150,0,0,1,1
2623590,2623741,151,0,0,1,2
2623741,2623876,135,1,0,0,1
2623742,2623827,85,1,0,0,2
2623828,2623866,38,0,0,1,2
2623867,2623871,4,1,0,0,2
2623872,2623969,97,0,0,1,2
2623877,2623970,93,0,0,1,1
2623970,2624000,30,1,0,0,2
2623971,2623989,18,1,0,0,1
2623990,2624437,447,0,0,1,1
2624001,2624867,866,0,0,1,2
2624438,2624497,59,1,0,0,1
2624498,2624840,342,0,0,1,1
2624841,2624962,121,1,0,0,1
2624868,2624911,43,1,0,0,2
2624912,2625224,312,0,0,1,2
2624963,2625109,146,0,0,1,1
2625110,2625184,74,1,0,0,1
2625185,2625215,30,0,0,1,1
2625216,2625507,291,1,0,0,1
2625225,2625255,30,1,0,0,2
2625256,2625467,211,0,0,1,2
2625468,2625488,20,1,0,0,2
2625489,2627041,1552,0,0,1,2
2625508,2625544,36,0,0,1,1
2625555,2625576,21,0,1,0,1
2625586,2628529,2943,1,0,0,1
2625700,2625745,45,0,1,0,1
2625812,2625824,12,0,1,0,1
2625939,2625947,8,0,1,0,1
2626005,2626021,16,0,1,0,1
2626073,2626158,85,0,1,0,1
2626201,2627110,909,0,1,0,1
2627042,2627104,62,1,0,0,2
2627105,2628333,1228,0,0,1,2
2628334,2628469,135,1,0,0,2
2628395,2628442,47,0,1,0,1
2628470,2628564,94,0,0,1,2
2628530,2628564,34,0,0,1,1
2628565,2628607,42,1,0,0,1
2628565,2628609,44,1,0,0,2
2628608,2629837,1229,0,0,1,1
2628610,2629838,1228,0,0,1,2
2629838,2629899,61,1,0,0,1
2629839,2629899,60,1,0,0,2
2629900,2631241,1341,0,0,1,1
2629900,2631241,1341,0,0,1,2
2631242,2631276,34,1,0,0,1
2631242,2631286,44,1,0,0,2
2631277,2631924,647,0,0,1,1
2631287,2631924,637,0,0,1,2
2631925,2632017,92,1,0,0,2
2631925,2632018,93,1,0,0,1
2632018,2632857,839,0,0,1,2
2632019,2632858,839,0,0,1,1
2632858,2632915,57,1,0,0,2
2632859,2632915,56,1,0,0,1
2632916,2633281,365,0,0,1,1
2632916,2633284,368,0,0,1,2
2633282,2633346,64,1,0,0,1
2633285,2633347,62,1,0,0,2
2633347,2633528,181,0,0,1,1
2633348,2633530,182,0,0,1,2
2633529,2633615,86,1,0,0,1
2633531,2633619,88,1,0,0,2
2633616,2633713,97,0,0,1,1
2633620,2633714,94,0,0,1,2
2633714,2634081,367,1,0,0,1
2633715,2633744,29,1,0,0,2
2633745,2633920,175,0,0,1,2
2633921,2633933,12,1,0,0,2
2633934,2635133,1199,0,0,1,2
2634082,2634277,195,0,0,1,1
2634278,2634302,24,1,0,0,1
2634303,2634490,187,0,0,1,1
2634491,2634551,60,1,0,0,1
2634552,2634640,88,0,0,1,1
2634641,2634650,9,1,0,0,1
2634651,2634742,91,0,0,1,1
2634743,2635501,758,1,0,0,1
2635134,2635184,50,1,0,0,2
2635185,2635303,118,0,0,1,2
2635304,2635477,173,1,0,0,2
2635320,2635452,132,0,1,0,1
2635335,2635434,99,0,1,0,2
2635478,2635892,414,0,0,1,2
2635502,2635595,93,0,0,1,1
2635596,2635620,24,1,0,0,1
2635621,2635893,272,0,0,1,1
2635893,2635933,40,1,0,0,2
2635894,2635933,39,1,0,0,1
2635934,2636165,231,0,0,1,1
2635934,2636167,233,0,0,1,2
2636166,2636199,33,1,0,0,1
2636168,2636199,31,1,0,0,2
2636200,2636808,608,0,0,1,1
2636200,2636809,609,0,0,1,2
2636809,2636842,33,1,0,0,1
2636810,2636830,20,1,0,0,2
2636831,2637301,470,0,0,1,2
2636843,2637302,459,0,0,1,1
2637302,2637384,82,1,0,0,2
2637303,2637387,84,1,0,0,1
2637385,2637803,418,0,0,1,2
2637388,2637802,414,0,0,1,1
2637803,2637847,44,1,0,0,1
2637804,2637847,43,1,0,0,2
2637848,2638746,898,0,0,1,1
2637848,2638746,898,0,0,1,2
2638747,2638780,33,1,0,0,1
2638747,2638788,41,1,0,0,2
2638781,2638981,200,0,0,1,1
2638789,2638983,194,0,0,1,2
2638982,2639068,86,1,0,0,1
2638984,2639069,85,1,0,0,2
2639069,2639163,94,0,0,1,1
2639070,2639166,96,0,0,1,2
2639164,2639649,485,1,0,0,1
2639167,2639202,35,1,0,0,2
2639203,2639362,159,0,0,1,2
2639363,2639394,31,1,0,0,2
2639395,2639948,553,0,0,1,2
2639650,2639683,33,0,0,1,1
2639684,2639818,134,1,0,0,1
2639819,2639857,38,0,0,1,1
2639858,2639864,6,1,0,0,1
2639865,2639929,64,0,0,1,1
2639930,2640614,684,1,0,0,1
2639949,2639971,22,1,0,0,2
2639972,2640498,526,0,0,1,2
2640499,2640568,69,1,0,0,2
2640569,2640809,240,0,0,1,2
2640615,2640808,193,0,0,1,1
2640809,2642033,1224,1,0,0,1
2640810,2640908,98,1,0,0,2
2640909,2640996,87,0,0,1,2
2640962,2642023,1061,0,1,0,1
2640997,2641025,28,1,0,0,2
2641026,2641070,44,0,0,1,2
2641071,2641115,44,1,0,0,2
2641116,2641186,70,0,0,1,2
2641187,2641195,8,1,0,0,2
2641196,2641286,90,0,0,1,2
2641287,2642013,726,1,0,0,2
2641821,2641960,139,0,1,0,2
2642014,2642132,118,0,0,1,2
2642034,2642132,98,0,0,1,1
2642133,2642218,85,1,0,0,2
2642133,2643047,914,1,0,0,1
2642219,2642653,434,0,0,1,2
2642221,2643032,811,0,1,0,1
2642654,2643028,374,1,0,0,2
2643029,2644064,1035,0,0,1,2
2643048,2644063,1015,0,0,1,1
2644064,2644095,31,1,0,0,1
2644065,2644084,19,1,0,0,2
2644085,2644775,690,0,0,1,2
2644096,2644777,681,0,0,1,1
2644776,2644864,88,1,0,0,2
2644778,2644858,80,1,0,0,1
2644859,2644941,82,0,0,1,1
2644865,2644942,77,0,0,1,2
2644942,2644979,37,1,0,0,1
2644943,2644985,42,1,0,0,2
2644980,2645257,277,0,0,1,1
2644986,2645265,279,0,0,1,2
2645258,2645281,23,1,0,0,1
2645266,2645271,5,1,0,0,2
2645272,2646139,867,0,0,1,2
2645282,2646138,856,0,0,1,1
2646139,2646208,69,1,0,0,1
2646140,2646210,70,1,0,0,2
2646209,2646487,278,0,0,1,1
2646211,2646488,277,0,0,1,2
2646488,2646518,30,1,0,0,1
2646489,2646518,29,1,0,0,2
2646519,2646733,214,0,0,1,2
2646519,2646734,215,0,0,1,1
2646734,2646751,17,1,0,0,2
2646735,2646759,24,1,0,0,1
2646752,2647623,871,0,0,1,2
2646760,2647623,863,0,0,1,1
2647624,2647690,66,1,0,0,1
2647624,2647690,66,1,0,0,2
2647691,2647945,254,0,0,1,1
2647691,2647945,254,0,0,1,2
2647946,2648012,66,1,0,0,2
2647946,2648014,68,1,0,0,1
2648013,2648277,264,0,0,1,2
2648015,2648275,260,0,0,1,1
2648276,2648445,169,1,0,0,1
2648278,2648377,99,1,0,0,2
2648378,2648670,292,0,0,1,2
2648446,2648671,225,0,0,1,1
2648671,2648743,72,1,0,0,2
2648672,2648746,74,1,0,0,1
2648744,2649584,840,0,0,1,2
2648747,2649582,835,0,0,1,1
2649583,2649630,47,1,0,0,1
2649585,2649634,49,1,0,0,2
2649631,2649820,189,0,0,1,1
2649635,2649820,185,0,0,1,2
2649821,2649840,19,1,0,0,2
2649821,2649841,20,1,0,0,1
2649841,2651386,1545,0,0,1,2
2649842,2651386,1544,0,0,1,1
2651387,2651397,10,1,0,0,2
2651387,2651398,11,1,0,0,1
2651398,2651570,172,0,0,1,2
2651399,2651571,172,0,0,1,1
2651571,2651614,43,1,0,0,2
2651572,2651622,50,1,0,0,1
2651615,2651990,375,0,0,1,2
2651623,2651989,366,0,0,1,1
2651990,2652025,35,1,0,0,1
2651991,2652022,31,1,0,0,2
2652023,2652969,946,0,0,1,2
2652026,2652971,945,0,0,1,1
2652970,2652996,26,1,0,0,2
2652972,2652995,23,1,0,0,1
2652996,2653703,707,0,0,1,1
2652997,2653702,705,0,0,1,2
2653703,2653781,78,1,0,0,2
2653704,2653795,91,1,0,0,1
2653782,2654699,917,0,0,1,2
2653796,2654698,902,0,0,1,1
2654699,2654750,51,1,0,0,1
2654700,2654744,44,1,0,0,2
2654745,2655248,503,0,0,1,2
2654751,2655248,497,0,0,1,1
2655249,2655306,57,1,0,0,1
2655249,2655307,58,1,0,0,2
2655307,2655600,293,0,0,1,1
2655308,2655599,291,0,0,1,2
2655600,2655665,65,1,0,0,2
2655601,2655668,67,1,0,0,1
2655666,2655788,122,0,0,1,2
2655669,2655789,120,0,0,1,1
2655789,2655822,33,1,0,0,2
2655790,2655818,28,1,0,0,1
2655819,2657159,1340,0,0,1,1
2655823,2657159,1336,0,0,1,2
2657160,2657185,25,1,0,0,1
2657160,2657188,28,1,0,0,2
2657186,2657344,158,0,0,1,1
2657189,2657345,156,0,0,1,2
2657345,2657397,52,1,0,0,1
2657346,2657398,52,1,0,0,2
2657398,2657640,242,0,0,1,1
2657399,2657641,242,0,0,1,2
2657641,2657675,34,1,0,0,1
2657642,2657673,31,1,0,0,2
2657674,2657936,262,0,0,1,2
2657676,2657936,260,0,0,1,1
2657937,2657957,20,1,0,0,2
2657937,2657965,28,1,0,0,1
2657958,2658973,1015,0,0,1,2
2657966,2658969,1003,0,0,1,1
2658970,2658998,28,1,0,0,1
2658974,2659007,33,1,0,0,2
2658999,2659190,191,0,0,1,1
2659008,2659192,184,0,0,1,2
2659191,2659224,33,1,0,0,1
2659193,2659212,19,1,0,0,2
2659213,2659532,319,0,0,1,2
2659225,2659530,305,0,0,1,1
2659531,2659584,53,1,0,0,1
2659533,2659582,49,1,0,0,2
2659583,2660156,573,0,0,1,2
2659585,2660154,569,0,0,1,1
2660155,2660193,38,1,0,0,1
2660157,2660194,37,1,0,0,2
2660194,2660884,690,0,0,1,1
2660195,2660886,691,0,0,1,2
2660885,2660908,23,1,0,0,1
2660887,2660908,21,1,0,0,2
2660909,2661330,421,0,0,1,2
2660909,2661331,422,0,0,1,1
2661331,2661411,80,1,0,0,2
2661332,2661410,78,1,0,0,1
2661411,2661498,87,0,0,1,1
2661412,2661499,87,0,0,1,2
2661499,2661534,35,1,0,0,1
2661500,2661537,37,1,0,0,2
2661535,2662368,833,0,0,1,1
2661538,2662374,836,0,0,1,2
2662369,2662393,24,1,0,0,1
2662375,2662390,15,1,0,0,2
2662391,2662557,166,0,0,1,2
2662394,2662556,162,0,0,1,1
2662557,2662620,63,1,0,0,1
2662558,2662630,72,1,0,0,2
2662621,2663006,385,0,0,1,1
2662631,2663008,377,0,0,1,2
2663007,2663037,30,1,0,0,1
2663009,2663031,22,1,0,0,2
2663032,2663351,319,0,0,1,2
2663038,2663345,307,0,0,1,1
2663346,2663364,18,1,0,0,1
2663352,2663362,10,1,0,0,2
2663363,2664283,920,0,0,1,2
2663365,2664284,919,0,0,1,1
2664284,2664320,36,1,0,0,2
2664285,2664317,32,1,0,0,1
2664318,2664774,456,0,0,1,1
2664321,2664772,451,0,0,1,2
2664773,2664860,87,1,0,0,2
2664775,2664884,109,1,0,0,1
2664861,2665364,503,0,0,1,2
2664885,2665365,480,0,0,1,1
2665365,2665420,55,1,0,0,2
2665366,2665418,52,1,0,0,1
2665419,2665820,401,0,0,1,1
2665421,2665820,399,0,0,1,2
2665821,2665861,40,1,0,0,1
2665821,2665863,42,1,0,0,2
2665862,2666107,245,0,0,1,1
2665864,2666102,238,0,0,1,2
2666103,2666131,28,1,0,0,2
2666108,2666128,20,1,0,0,1
2666129,2666490,361,0,0,1,1
2666132,2666491,359,0,0,1,2
2666491,2666515,24,1,0,0,1
2666492,2666514,22,1,0,0,2
2666515,2667436,921,0,0,1,2
2666516,2667425,909,0,0,1,1
2667426,2667453,27,1,0,0,1
2667437,2667445,8,1,0,0,2
2667446,2667654,208,0,0,1,2
2667454,2667654,200,0,0,1,1
2667655,2667725,70,1,0,0,1
2667655,2667725,70,1,0,0,2
2667726,2668196,470,0,0,1,1
2667726,2668197,471,0,0,1,2
2668197,2668238,41,1,0,0,1
2668198,2668230,32,1,0,0,2
2668231,2668480,249,0,0,1,2
2668239,2668304,65,0,0,1,1
2668305,2668371,66,1,0,0,1
2668372,2668438,66,0,0,1,1
2668439,2668449,10,1,0,0,1
2668450,2668471,21,0,0,1,1
2668472,2668718,246,1,0,0,1
2668481,2668500,19,1,0,0,2
2668501,2668921,420,0,0,1,2
2668719,2668797,78,0,0,1,1
2668798,2668866,68,1,0,0,1
2668867,2668920,53,0,0,1,1
2668921,2669102,181,1,0,0,1
2668922,2668961,39,1,0,0,2
2668962,2669905,943,0,0,1,2
2669103,2669164,61,0,0,1,1
2669165,2670012,847,1,0,0,1
2669906,2669960,54,1,0,0,2
2669961,2670832,871,0,0,1,2
2670013,2670248,235,0,0,1,1
2670249,2670276,27,1,0,0,1
2670277,2670304,27,0,0,1,1
2670305,2670346,41,1,0,0,1
2670347,2670702,355,0,0,1,1
2670703,2670744,41,1,0,0,1
2670745,2670833,88,0,0,1,1
2670833,2670867,34,1,0,0,2
2670834,2670883,49,1,0,0,1
2670868,2671193,325,0,0,1,2
2670884,2671193,309,0,0,1,1
2671194,2671225,31,1,0,0,2
2671194,2671236,42,1,0,0,1
2671226,2671815,589,0,0,1,2
2671237,2671815,578,0,0,1,1
2671816,2671902,86,1,0,0,2
2671816,2671903,87,1,0,0,1
2671903,2672015,112,0,0,1,2
2671904,2672008,104,0,0,1,1
2672009,2672041,32,1,0,0,1
2672016,2672027,11,1,0,0,2
2672028,2672211,183,0,0,1,2
2672042,2672213,171,0,0,1,1
2672212,2672239,27,1,0,0,2
2672214,2672232,18,1,0,0,1
2672233,2673359,1126,0,0,1,1
2672240,2673257,1017,0,0,1,2
2673258,2673436,178,1,0,0,2
2673360,2673438,78,1,0,0,1
2673437,2673701,264,0,0,1,2
2673439,2673699,260,0,0,1,1
2673700,2673734,34,1,0,0,1
2673702,2673726,24,1,0,0,2
2673727,2673852,125,0,0,1,2
2673735,2673854,119,0,0,1,1
2673853,2674105,252,1,0,0,2
2673855,2674087,232,1,0,0,1
2673887,2674041,154,0,1,0,1
2673893,2674034,141,0,1,0,2
2674088,2674763,675,0,0,1,1
2674106,2674763,657,0,0,1,2
2674764,2674785,21,1,0,0,2
2674764,2674792,28,1,0,0,1
2674786,2675509,723,0,0,1,2
2674793,2675606,813,0,0,1,1
2675510,2675685,175,1,0,0,2
2675607,2675685,78,1,0,0,1
2675686,2676141,455,0,0,1,1
2675686,2676141,455,0,0,1,2
2676142,2676186,44,1,0,0,1
2676142,2676193,51,1,0,0,2
2676187,2676237,50,0,0,1,1
2676194,2676756,562,0,0,1,2
2676238,2676254,16,1,0,0,1
2676255,2676755,500,0,0,1,1
2676756,2676800,44,1,0,0,1
2676757,2676801,44,1,0,0,2
2676801,2677199,398,0,0,1,1
2676802,2677198,396,0,0,1,2
2677199,2677270,71,1,0,0,2
2677200,2677269,69,1,0,0,1
2677270,2677501,231,0,0,1,1
2677271,2677501,230,0,0,1,2
2677502,2677529,27,1,0,0,1
2677502,2677530,28,1,0,0,2
2677530,2678843,1313,0,0,1,1
2677531,2678842,1311,0,0,1,2
2678843,2678903,60,1,0,0,2
2678844,2678903,59,1,0,0,1
2678904,2679406,502,0,0,1,1
2678904,2679406,502,0,0,1,2
2679407,2679439,32,1,0,0,2
2679407,2679442,35,1,0,0,1
2679440,2681103,1663,0,0,1,2
2679443,2681104,1661,0,0,1,1
2681104,2681179,75,1,0,0,2
2681105,2681179,74,1,0,0,1
2681180,2682438,1258,0,0,1,2
2681180,2682439,1259,0,0,1,1
2682439,2682518,79,1,0,0,2
2682440,2682522,82,1,0,0,1
2682519,2682635,116,0,0,1,2
2682523,2682634,111,0,0,1,1
2682635,2682666,31,1,0,0,1
2682636,2682667,31,1,0,0,2
2682667,2682834,167,0,0,1,1
2682668,2682839,171,0,0,1,2
2682835,2682851,16,1,0,0,1
2682840,2682849,9,1,0,0,2
2682850,2683667,817,0,0,1,2
2682852,2683666,814,0,0,1,1
2683667,2683718,51,1,0,0,1
2683668,2683717,49,1,0,0,2
2683718,2683921,203,0,0,1,2
2683719,2683918,199,0,0,1,1
2683919,2684132,213,1,0,0,1
2683922,2684123,201,1,0,0,2
2683938,2684094,156,0,1,0,1
2683946,2684079,133,0,1,0,2
2684124,2684331,207,0,0,1,2
2684133,2684329,196,0,0,1,1
2684330,2684389,59,1,0,0,1
2684332,2684383,51,1,0,0,2
2684384,2684677,293,0,0,1,2
2684390,2684678,288,0,0,1,1
2684678,2684738,60,1,0,0,2
2684679,2684749,70,1,0,0,1
2684739,2685010,271,0,0,1,2
2684750,2685009,259,0,0,1,1
2685010,2685043,33,1,0,0,1
2685011,2685041,30,1,0,0,2
2685042,2685890,848,0,0,1,2
2685044,2685888,844,0,0,1,1
2685889,2685946,57,1,0,0,1
2685891,2685946,55,1,0,0,2
2685947,2686537,590,0,0,1,1
2685947,2686537,590,0,0,1,2
2686538,2686589,51,1,0,0,2
2686538,2686590,52,1,0,0,1
2686590,2687057,467,0,0,1,2
2686591,2687055,464,0,0,1,1
2687056,2687138,82,1,0,0,1
2687058,2687129,71,1,0,0,2
2687130,2687220,90,0,0,1,2
2687139,2687222,83,0,0,1,1
2687221,2687262,41,1,0,0,2
2687223,2687266,43,1,0,0,1
2687263,2687574,311,0,0,1,2
2687267,2687574,307,0,0,1,1
2687575,2687600,25,1,0,0,1
2687575,2687603,28,1,0,0,2
2687601,2688423,822,0,0,1,1
2687604,2688423,819,0,0,1,2
2688424,2688490,66,1,0,0,2
2688424,2688491,67,1,0,0,1
2688491,2688668,177,0,0,1,2
2688492,2688668,176,0,0,1,1
2688669,2688714,45,1,0,0,2
2688669,2688716,47,1,0,0,1
2688715,2689019,304,0,0,1,2
2688717,2689018,301,0,0,1,1
2689019,2689052,33,1,0,0,1
2689020,2689050,30,1,0,0,2
2689051,2689319,268,0,0,1,2
2689053,2689317,264,0,0,1,1
2689318,2689349,31,1,0,0,1
2689320,2689339,19,1,0,0,2
2689340,2689820,480,0,0,1,2
2689350,2689820,470,0,0,1,1
2689821,2689855,34,1,0,0,2
2689821,2689858,37,1,0,0,1
2689856,2690255,399,0,0,1,2
2689859,2690253,394,0,0,1,1
2690254,2690291,37,1,0,0,1
2690256,2690282,26,1,0,0,2
2690283,2690590,307,0,0,1,2
2690292,2690591,299,0,0,1,1
2690591,2690678,87,1,0,0,2
2690592,2690676,84,1,0,0,1
2690677,2691268,591,0,0,1,1
2690679,2691269,590,0,0,1,2
2691269,2691341,72,1,0,0,1
2691270,2691335,65,1,0,0,2
2691336,2691817,481,0,0,1,2
2691342,2691818,476,0,0,1,1
2691818,2691870,52,1,0,0,2
2691819,2691870,51,1,0,0,1
2691871,2691973,102,0,0,1,1
2691871,2691973,102,0,0,1,2
2691974,2692052,78,1,0,0,2
2691974,2692062,88,1,0,0,1
2692053,2692159,106,0,0,1,2
2692063,2692158,95,0,0,1,1
2692159,2692202,43,1,0,0,1
2692160,2692196,36,1,0,0,2
2692197,2692645,448,0,0,1,2
2692203,2692634,431,0,0,1,1
2692635,2692656,21,1,0,0,1
2692646,2692656,10,1,0,0,2
2692657,2693105,448,0,0,1,1
2692657,2693106,449,0,0,1,2
2693106,2693168,62,1,0,0,1
2693107,2693169,62,1,0,0,2
2693169,2693366,197,0,0,1,1
2693170,2693362,192,0,0,1,2
2693363,2693384,21,1,0,0,2
2693367,2693406,39,1,0,0,1
2693385,2694536,1151,0,0,1,2
2693407,2694532,1125,0,0,1,1
2694533,2694563,30,1,0,0,1
2694537,2694555,18,1,0,0,2
2694556,2695270,714,0,0,1,2
2694564,2694630,66,0,0,1,1
2694631,2694658,27,1,0,0,1
2694659,2694694,35,0,0,1,1
2694695,2695397,702,1,0,0,1
2695271,2695296,25,1,0,0,2
2695297,2695493,196,0,0,1,2
2695398,2695447,49,0,0,1,1
2695448,2696366,918,1,0,0,1
2695494,2695525,31,1,0,0,2
2695526,2695921,395,0,0,1,2
2695922,2695953,31,1,0,0,2
2695954,2696281,327,0,0,1,2
2696282,2696326,44,1,0,0,2
2696327,2696535,208,0,0,1,2
2696367,2696533,166,0,0,1,1
2696534,2697954,1420,1,0,0,1
2696536,2696591,55,1,0,0,2
2696592,2696703,111,0,0,1,2
2696704,2696723,19,1,0,0,2
2696724,2697589,865,0,0,1,2
2697590,2697603,13,1,0,0,2
2697604,2697901,297,0,0,1,2
2697902,2697953,51,1,0,0,2
2697954,2698309,355,0,0,1,2
2697955,2698307,352,0,0,1,1
2698308,2698340,32,1,0,0,1
2698310,2698332,22,1,0,0,2
2698333,2698781,448,0,0,1,2
2698341,2698781,440,0,0,1,1
2698782,2698806,24,1,0,0,1
2698782,2698816,34,1,0,0,2
2698807,2700378,1571,0,0,1,1
2698817,2700377,1560,0,0,1,2
2700378,2700437,59,1,0,0,2
2700379,2700430,51,1,0,0,1
2700431,2700716,285,0,0,1,1
2700438,2700715,277,0,0,1,2
2700716,2700772,56,1,0,0,2
2700717,2700761,44,1,0,0,1
2700762,2701152,390,0,0,1,1
2700773,2701150,377,0,0,1,2
2701151,2701177,26,1,0,0,2
2701153,2701188,35,1,0,0,1
2701178,2701441,263,0,0,1,2
2701189,2701440,251,0,0,1,1
2701441,2701972,531,1,0,0,1
2701442,2701550,108,1,0,0,2
2701525,2701723,198,0,1,0,1
2701551,2701707,156,0,0,1,2
2701708,2701733,25,1,0,0,2
2701734,2703291,1557,0,0,1,2
2701906,2701915,9,0,1,0,1
2701973,2702000,27,0,0,1,1
2702001,2703384,1383,1,0,0,1
2702111,2702957,846,0,1,0,1
2703016,2703090,74,0,1,0,1
2703292,2703362,70,1,0,0,2
2703307,2703321,14,0,1,0,1
2703363,2703506,143,0,0,1,2
2703385,2703509,124,0,0,1,1
2703507,2703590,83,1,0,0,2
2703510,2703576,66,1,0,0,1
2703551,2703553,2,0,1,0,1
2703577,2703628,51,0,0,1,1
2703591,2703742,151,0,0,1,2
2703639,2706740,3101,0,1,0,1
2703743,2703763,20,1,0,0,2
2703764,2704187,423,0,0,1,2
2704188,2704200,12,1,0,0,2
2704201,2704691,490,0,0,1,2
2704692,2704738,46,1,0,0,2
2704739,2704912,173,0,0,1,2
2704913,2705175,262,1,0,0,2
2705176,2705302,126,0,0,1,2
2705303,2705331,28,1,0,0,2
2705332,2705378,46,0,0,1,2
2705379,2706682,1303,1,0,0,2
2706683,2706836,153,0,0,1,2
2706750,2706917,167,1,0,0,1
2706818,2706843,25,0,1,0,1
2706837,2706880,43,1,0,0,2
2706881,2707345,464,0,0,1,2
2706918,2707346,428,0,0,1,1
2707346,2707376,30,1,0,0,2
2707347,2707370,23,1,0,0,1
2707371,2708343,972,0,0,1,1
2707377,2708343,966,0,0,1,2
2708344,2708349,5,1,0,0,2
2708344,2708355,11,1,0,0,1
2708350,2709018,668,0,0,1,2
2708356,2709017,661,0,0,1,1
2709018,2709076,58,1,0,0,1
2709019,2709087,68,1,0,0,2
2709077,2709873,796,0,0,1,1
2709088,2709879,791,0,0,1,2
2709874,2709903,29,1,0,0,1
2709880,2709896,16,1,0,0,2
2709897,2711387,1490,0,0,1,2
2709904,2711386,1482,0,0,1,1
2711387,2711635,248,1,0,0,1
2711388,2711599,211,1,0,0,2
2711432,2711553,121,0,1,0,1
2711450,2711524,74,0,1,0,2
2711600,2712450,850,0,0,1,2
2711636,2712451,815,0,0,1,1
2712451,2712506,55,1,0,0,2
2712452,2712511,59,1,0,0,1
2712507,2712945,438,0,0,1,2
2712512,2712945,433,0,0,1,1
2712946,2713036,90,1,0,0,2
2712946,2713043,97,1,0,0,1
2713037,2713085,48,0,0,1,2
2713044,2713087,43,0,0,1,1
2713086,2713132,46,1,0,0,2
2713088,2713128,40,1,0,0,1
2713129,2713381,252,0,0,1,1
2713133,2713381,248,0,0,1,2
2713382,2713405,23,1,0,0,2
2713382,2713446,64,1,0,0,1
2713406,2714071,665,0,0,1,2
2713447,2713592,145,0,0,1,1
2713593,2713597,4,1,0,0,1
2713598,2713625,27,0,0,1,1
2713626,2713681,55,1,0,0,1
2713682,2713731,49,0,0,1,1
2713732,2714938,1206,1,0,0,1
2714010,2714033,23,0,1,0,1
2714060,2714451,391,0,1,0,1
2714072,2714096,24,1,0,0,2
2714097,2714429,332,0,0,1,2
2714430,2714478,48,1,0,0,2
2714479,2714767,288,0,0,1,2
2714768,2714935,167,1,0,0,2
2714781,2714920,139,0,1,0,1
2714793,2714898,105,0,1,0,2
2714936,2715267,331,0,0,1,2
2714939,2715270,331,0,0,1,1
2715268,2715293,25,1,0,0,2
2715271,2715286,15,1,0,0,1
2715287,2715670,383,0,0,1,1
2715294,2715667,373,0,0,1,2
2715668,2715698,30,1,0,0,2
2715671,2715689,18,1,0,0,1
2715690,2716036,346,0,0,1,1
2715699,2716043,344,0,0,1,2
2716037,2716056,19,1,0,0,1
2716044,2716055,11,1,0,0,2
2716056,2716668,612,0,0,1,2
2716057,2716669,612,0,0,1,1
2716669,2716723,54,1,0,0,2
2716670,2716721,51,1,0,0,1
2716722,2717141,419,0,0,1,1
2716724,2717142,418,0,0,1,2
2717142,2717324,182,1,0,0,1
2717143,2717293,150,1,0,0,2
2717180,2717266,86,0,1,0,1
2717192,2717239,47,0,1,0,2
2717294,2717611,317,0,0,1,2
2717325,2717610,285,0,0,1,1
2717611,2717645,34,1,0,0,1
2717612,2717641,29,1,0,0,2
2717642,2717874,232,0,0,1,2
2717646,2717874,228,0,0,1,1
