start,end,duration,saccade,blink,fixation,eye
740848,740866,18,0,0,1,1
740867,741061,194,1,0,0,1
740878,741037,159,0,1,0,2
740882,741036,154,0,1,0,1
741062,741225,163,0,0,1,1
741066,741224,158,0,0,1,2
741225,741299,74,1,0,0,2
741226,741299,73,1,0,0,1
741300,741380,80,0,0,1,2
741300,741381,81,0,0,1,1
741381,741410,29,1,0,0,2
741382,741411,29,1,0,0,1
741411,741526,115,0,0,1,2
741412,741545,133,0,0,1,1
741527,741715,188,1,0,0,2
741546,741695,149,1,0,0,1
741555,741674,119,0,1,0,2
741561,741669,108,0,1,0,1
741696,741799,103,0,0,1,1
741716,741799,83,0,0,1,2
741800,741811,11,1,0,0,2
741800,741818,18,1,0,0,1
741812,741981,169,0,0,1,2
741819,741981,162,0,0,1,1
741982,741986,4,1,0,0,1
741982,741986,4,1,0,0,2
741987,743933,1946,0,0,1,2
741987,743934,1947,0,0,1,1
743934,744034,100,1,0,0,2
743935,744020,85,1,0,0,1
744021,744098,77,0,0,1,1
744035,744096,61,0,0,1,2
744097,744131,34,1,0,0,2
744099,744131,32,1,0,0,1
744132,744233,101,0,0,1,1
744132,744235,103,0,0,1,2
744234,744267,33,1,0,0,1
744236,744267,31,1,0,0,2
744268,744471,203,0,0,1,1
744268,744472,204,0,0,1,2
744472,744487,15,1,0,0,1
744473,744492,19,1,0,0,2
744488,746094,1606,0,0,1,1
744493,746091,1598,0,0,1,2
746092,746178,86,1,0,0,2
746095,746177,82,1,0,0,1
746178,746227,49,0,0,1,1
746179,746226,47,0,0,1,2
746227,746262,35,1,0,0,2
746228,746264,36,1,0,0,1
746263,747648,1385,0,0,1,2
746265,747666,1401,0,0,1,1
747649,747826,177,1,0,0,2
747667,747828,161,1,0,0,1
747684,747786,102,0,1,0,1
747685,747792,107,0,1,0,2
747827,748085,258,0,0,1,2
747829,748086,257,0,0,1,1
748086,748179,93,1,0,0,2
748087,748178,91,1,0,0,1
748179,748238,59,0,0,1,1
748180,748236,56,0,0,1,2
748237,748283,46,1,0,0,2
748239,748285,46,1,0,0,1
748284,750115,1831,0,0,1,2
748286,750113,1827,0,0,1,1
750114,750212,98,1,0,0,1
750116,750216,100,1,0,0,2
750213,750271,58,0,0,1,1
750217,750274,57,0,0,1,2
750272,750305,33,1,0,0,1
750275,750306,31,1,0,0,2
750306,751690,1384,0,0,1,1
750307,751691,1384,0,0,1,2
751691,751839,148,1,0,0,1
751692,751857,165,1,0,0,2
751710,751814,104,0,1,0,1
751712,751816,104,0,1,0,2
751840,752101,261,0,0,1,1
751858,752102,244,0,0,1,2
752102,752161,59,1,0,0,1
752103,752177,74,1,0,0,2
752162,752318,156,0,0,1,1
752178,752320,142,0,0,1,2
752319,752349,30,1,0,0,1
752321,752340,19,1,0,0,2
752341,753955,1614,0,0,1,2
752350,753957,1607,0,0,1,1
753956,754063,107,1,0,0,2
753958,754065,107,1,0,0,1
754064,754122,58,0,0,1,2
754066,754124,58,0,0,1,1
754123,754161,38,1,0,0,2
754125,754169,44,1,0,0,1
754162,754297,135,0,0,1,2
754170,754297,127,0,0,1,1
754298,754318,20,1,0,0,1
754298,754333,35,1,0,0,2
754319,755477,1158,0,0,1,1
754334,755474,1140,0,0,1,2
755475,755648,173,1,0,0,2
755478,755641,163,1,0,0,1
755496,755613,117,0,1,0,2
755498,755608,110,0,1,0,1
755642,755797,155,0,0,1,1
755649,755798,149,0,0,1,2
755798,755877,79,1,0,0,1
755799,755888,89,1,0,0,2
755878,755959,81,0,0,1,1
755889,755960,71,0,0,1,2
755960,755988,28,1,0,0,1
755961,755986,25,1,0,0,2
755987,757462,1475,0,0,1,2
755989,757462,1473,0,0,1,1
757463,757536,73,1,0,0,1
757463,757560,97,1,0,0,2
757537,757618,81,0,0,1,1
757561,757620,59,0,0,1,2
757619,757654,35,1,0,0,1
757621,757656,35,1,0,0,2
757655,757794,139,0,0,1,1
757657,757788,131,0,0,1,2
757789,757807,18,1,0,0,2
757795,757821,26,1,0,0,1
757808,759094,1286,0,0,1,2
757822,759113,1291,0,0,1,1
759095,759266,171,1,0,0,2
759114,759280,166,1,0,0,1
759137,759237,100,0,1,0,1
759141,759237,96,0,1,0,2
759267,759465,198,0,0,1,2
759281,759468,187,0,0,1,1
759466,759575,109,1,0,0,2
759469,759570,101,1,0,0,1
759571,759627,56,0,0,1,1
759576,759626,50,0,0,1,2
759627,759680,53,1,0,0,2
759628,759654,26,1,0,0,1
759655,761088,1433,0,0,1,1
759681,759851,170,0,0,1,2
759852,759861,9,1,0,0,2
759862,761080,1218,0,0,1,2
761081,761267,186,1,0,0,2
761089,761250,161,1,0,0,1
761104,761227,123,0,1,0,2
761109,761232,123,0,1,0,1
761251,761461,210,0,0,1,1
761268,761463,195,0,0,1,2
761462,761552,90,1,0,0,1
761464,761556,92,1,0,0,2
761553,761576,23,0,0,1,1
761557,761613,56,0,0,1,2
761577,761592,15,1,0,0,1
761593,761613,20,0,0,1,1
761614,761655,41,1,0,0,2
761614,761656,42,1,0,0,1
761656,761804,148,0,0,1,2
761657,761803,146,0,0,1,1
761804,761834,30,1,0,0,1
761805,761820,15,1,0,0,2
761821,763473,1652,0,0,1,2
761835,762961,1126,0,0,1,1
762962,763015,53,1,0,0,1
763016,763474,458,0,0,1,1
763474,763572,98,1,0,0,2
763475,763571,96,1,0,0,1
763572,763720,148,0,0,1,1
763573,763728,155,0,0,1,2
763721,763751,30,1,0,0,1
763729,763750,21,1,0,0,2
763751,763996,245,0,0,1,2
763752,763998,246,0,0,1,1
763997,764026,29,1,0,0,2
763999,764024,25,1,0,0,1
764025,765035,1010,0,0,1,1
764027,765035,1008,0,0,1,2
765036,765217,181,1,0,0,2
765036,765223,187,1,0,0,1
765064,765187,123,0,1,0,2
765064,765188,124,0,1,0,1
765218,765406,188,0,0,1,2
765224,765406,182,0,0,1,1
765407,765475,68,1,0,0,1
765407,765475,68,1,0,0,2
765476,765545,69,0,0,1,1
765476,765545,69,0,0,1,2
765546,765586,40,1,0,0,1
765546,765587,41,1,0,0,2
765587,766387,800,0,0,1,1
765588,766387,799,0,0,1,2
766388,766417,29,1,0,0,1
766388,766417,29,1,0,0,2
766418,767386,968,0,0,1,2
766418,767387,969,0,0,1,1
767387,767491,104,1,0,0,2
767388,767489,101,1,0,0,1
767490,767543,53,0,0,1,1
767492,767543,51,0,0,1,2
767544,767586,42,1,0,0,2
767544,767587,43,1,0,0,1
767587,768700,1113,0,0,1,2
767588,768707,1119,0,0,1,1
768701,768863,162,1,0,0,2
768708,768851,143,1,0,0,1
768732,768819,87,0,1,0,2
768738,768807,69,0,1,0,1
768852,769174,322,0,0,1,1
768864,769174,310,0,0,1,2
769175,769273,98,1,0,0,1
769175,769273,98,1,0,0,2
769274,769338,64,0,0,1,2
769274,769339,65,0,0,1,1
769339,769372,33,1,0,0,2
769340,769375,35,1,0,0,1
769373,769554,181,0,0,1,2
769376,771025,1649,0,0,1,1
769555,769566,11,1,0,0,2
769567,771026,1459,0,0,1,2
771026,771377,351,1,0,0,1
771027,771308,281,1,0,0,2
771077,771257,180,0,1,0,2
771080,771272,192,0,1,0,1
771309,771344,35,0,0,1,2
771345,771375,30,1,0,0,2
771376,772886,1510,0,0,1,2
771378,772890,1512,0,0,1,1
772887,772969,82,1,0,0,2
772891,772956,65,1,0,0,1
772957,773025,68,0,0,1,1
772970,773024,54,0,0,1,2
773025,773058,33,1,0,0,2
773026,773059,33,1,0,0,1
773059,774269,1210,0,0,1,2
773060,774271,1211,0,0,1,1
774270,774498,228,1,0,0,2
774272,774478,206,1,0,0,1
774297,774454,157,0,1,0,2
774299,774457,158,0,1,0,1
774479,774791,312,0,0,1,1
774499,774789,290,0,0,1,2
774790,774883,93,1,0,0,2
774792,774879,87,1,0,0,1
774880,774936,56,0,0,1,1
774884,774933,49,0,0,1,2
774934,774970,36,1,0,0,2
774937,774961,24,1,0,0,1
774962,775102,140,0,0,1,1
774971,775099,128,0,0,1,2
775100,775115,15,1,0,0,2
775103,775116,13,1,0,0,1
775116,776831,1715,0,0,1,2
775117,776828,1711,0,0,1,1
776829,776898,69,1,0,0,1
776832,776912,80,1,0,0,2
776899,776973,74,0,0,1,1
776913,776973,60,0,0,1,2
776974,776997,23,1,0,0,1
776974,777009,35,1,0,0,2
776998,778445,1447,0,0,1,1
777010,778433,1423,0,0,1,2
778434,778658,224,1,0,0,2
778446,778650,204,1,0,0,1
778463,778623,160,0,1,0,2
778466,778619,153,0,1,0,1
778651,778834,183,0,0,1,1
778659,778834,175,0,0,1,2
778835,778884,49,1,0,0,1
778835,778900,65,1,0,0,2
778885,778984,99,0,0,1,1
778901,778982,81,0,0,1,2
778983,779018,35,1,0,0,2
778985,779015,30,1,0,0,1
779016,779122,106,0,0,1,1
779019,780379,1360,0,0,1,2
779123,779140,17,1,0,0,1
779141,780381,1240,0,0,1,1
780380,780590,210,1,0,0,2
780382,780587,205,1,0,0,1
780398,780560,162,0,1,0,2
780402,780559,157,0,1,0,1
780588,780860,272,0,0,1,1
780591,780861,270,0,0,1,2
780861,780949,88,1,0,0,1
780862,780957,95,1,0,0,2
780950,781022,72,0,0,1,1
780958,781018,60,0,0,1,2
781019,781058,39,1,0,0,2
781023,781054,31,1,0,0,1
781055,782553,1498,0,0,1,1
781059,782544,1485,0,0,1,2
782545,782733,188,1,0,0,2
782554,782725,171,1,0,0,1
782565,782693,128,0,1,0,2
782570,782697,127,0,1,0,1
782726,782913,187,0,0,1,1
782734,782913,179,0,0,1,2
782914,783000,86,1,0,0,2
782914,783001,87,1,0,0,1
783001,783057,56,0,0,1,2
783002,783059,57,0,0,1,1
783058,783099,41,1,0,0,2
783060,783102,42,1,0,0,1
783100,783197,97,0,0,1,2
783103,783200,97,0,0,1,1
783198,783233,35,1,0,0,2
783201,783231,30,1,0,0,1
783232,785023,1791,0,0,1,1
783234,785020,1786,0,0,1,2
785021,785198,177,1,0,0,2
785024,785200,176,1,0,0,1
785199,785244,45,0,0,1,2
785201,785245,44,0,0,1,1
785245,785285,40,1,0,0,2
785246,785284,38,1,0,0,1
785285,785408,123,0,0,1,1
785286,785399,113,0,0,1,2
785400,785422,22,1,0,0,2
785409,785419,10,1,0,0,1
785420,786720,1300,0,0,1,1
785423,786712,1289,0,0,1,2
786713,786945,232,1,0,0,2
786721,786929,208,1,0,0,1
786734,786908,174,0,1,0,2
786738,786912,174,0,1,0,1
786930,787157,227,0,0,1,1
786946,787157,211,0,0,1,2
787158,787256,98,1,0,0,1
787158,787257,99,1,0,0,2
787257,787313,56,0,0,1,1
787258,787312,54,0,0,1,2
787313,787365,52,1,0,0,2
787314,787354,40,1,0,0,1
787355,787527,172,0,0,1,1
787366,787525,159,0,0,1,2
787526,787556,30,1,0,0,2
787528,787555,27,1,0,0,1
787556,789156,1600,0,0,1,1
787557,789158,1601,0,0,1,2
789157,789212,55,1,0,0,1
789159,789234,75,1,0,0,2
789213,789308,95,0,0,1,1
789235,789309,74,0,0,1,2
789309,789339,30,1,0,0,1
789310,789330,20,1,0,0,2
789331,790678,1347,0,0,1,2
789340,790675,1335,0,0,1,1
790676,790900,224,1,0,0,1
790679,790914,235,1,0,0,2
790705,790878,173,0,1,0,2
790706,790875,169,0,1,0,1
790901,791115,214,0,0,1,1
790915,791115,200,0,0,1,2
791116,791186,70,1,0,0,1
791116,791202,86,1,0,0,2
791187,791293,106,0,0,1,1
791203,791293,90,0,0,1,2
791294,791326,32,1,0,0,2
791294,791341,47,1,0,0,1
791327,793054,1727,0,0,1,2
791342,793050,1708,0,0,1,1
793051,793396,345,1,0,0,1
793055,793393,338,1,0,0,2
793078,793200,122,0,1,0,1
793078,793206,128,0,1,0,2
793394,793488,94,0,0,1,2
793397,793489,92,0,0,1,1
793489,793506,17,1,0,0,2
793490,793516,26,1,0,0,1
793507,793710,203,0,0,1,2
793517,793713,196,0,0,1,1
793711,793736,25,1,0,0,2
793714,793725,11,1,0,0,1
793726,795253,1527,0,0,1,1
793737,795253,1516,0,0,1,2
795254,795496,242,1,0,0,1
795254,795496,242,1,0,0,2
795497,795555,58,0,0,1,2
795497,795556,59,0,0,1,1
795556,795595,39,1,0,0,2
795557,795592,35,1,0,0,1
795593,797176,1583,0,0,1,1
795596,797176,1580,0,0,1,2
797177,797357,180,1,0,0,1
797177,797359,182,1,0,0,2
797211,797328,117,0,1,0,2
797214,797331,117,0,1,0,1
797358,797511,153,0,0,1,1
797360,797510,150,0,0,1,2
797511,797590,79,1,0,0,2
797512,797591,79,1,0,0,1
797591,797667,76,0,0,1,2
797592,797668,76,0,0,1,1
797668,797700,32,1,0,0,2
797669,797696,27,1,0,0,1
797697,797871,174,0,0,1,1
797701,797858,157,0,0,1,2
797859,797891,32,1,0,0,2
797872,797877,5,1,0,0,1
797878,799631,1753,0,0,1,1
797892,798004,112,0,0,1,2
798005,798014,9,1,0,0,2
798015,799626,1611,0,0,1,2
799627,799834,207,1,0,0,2
799632,799796,164,1,0,0,1
799656,799785,129,0,1,0,2
799661,799770,109,0,1,0,1
799797,800053,256,0,0,1,1
799835,800057,222,0,0,1,2
800054,800083,29,1,0,0,1
800058,800071,13,1,0,0,2
800072,801750,1678,0,0,1,2
800084,801750,1666,0,0,1,1
801751,801827,76,1,0,0,2
801751,801838,87,1,0,0,1
801828,801906,78,0,0,1,2
801839,801906,67,0,0,1,1
801907,801952,45,1,0,0,1
801907,801957,50,1,0,0,2
801953,802046,93,0,0,1,1
801958,802044,86,0,0,1,2
802045,802074,29,1,0,0,2
802047,802078,31,1,0,0,1
802075,802251,176,0,0,1,2
802079,802257,178,0,0,1,1
802252,802277,25,1,0,0,2
802258,802263,5,1,0,0,1
802264,803902,1638,0,0,1,1
802278,803897,1619,0,0,1,2
803898,804145,247,1,0,0,2
803903,804108,205,1,0,0,1
803931,804095,164,0,1,0,2
803935,804066,131,0,1,0,1
804109,804169,60,0,0,1,1
804146,804166,20,0,0,1,2
804167,804222,55,1,0,0,2
804170,804213,43,1,0,0,1
804214,804850,636,0,0,1,1
804223,804846,623,0,0,1,2
804847,804877,30,1,0,0,2
804851,804870,19,1,0,0,1
804871,805840,969,0,0,1,1
804878,805840,962,0,0,1,2
805841,805922,81,1,0,0,2
805841,805925,84,1,0,0,1
805923,805989,66,0,0,1,2
805926,805987,61,0,0,1,1
805988,806025,37,1,0,0,1
805990,806024,34,1,0,0,2
806025,807690,1665,0,0,1,2
806026,807690,1664,0,0,1,1
807691,807891,200,1,0,0,2
807691,807895,204,1,0,0,1
807722,807848,126,0,1,0,2
807723,807857,134,0,1,0,1
807892,807953,61,0,0,1,2
807896,807953,57,0,0,1,1
807954,807976,22,1,0,0,1
807954,807985,31,1,0,0,2
807977,809786,1809,0,0,1,1
807986,809786,1800,0,0,1,2
809787,809884,97,1,0,0,1
809787,809896,109,1,0,0,2
809885,809956,71,0,0,1,1
809897,809954,57,0,0,1,2
809955,809994,39,1,0,0,2
809957,809994,37,1,0,0,1
809995,810140,145,0,0,1,1
809995,810140,145,0,0,1,2
810141,810158,17,1,0,0,1
810141,810166,25,1,0,0,2
810159,811528,1369,0,0,1,1
810167,811522,1355,0,0,1,2
811523,811746,223,1,0,0,2
811529,811725,196,1,0,0,1
811560,811709,149,0,1,0,1
811560,811713,153,0,1,0,2
811726,811799,73,0,0,1,1
811747,811799,52,0,0,1,2
811800,811862,62,1,0,0,1
811800,811868,68,1,0,0,2
811863,811934,71,0,0,1,1
811869,811934,65,0,0,1,2
811935,811969,34,1,0,0,1
811935,811969,34,1,0,0,2
811970,812480,510,0,0,1,1
811970,812487,517,0,0,1,2
812481,812499,18,1,0,0,1
812488,812492,4,1,0,0,2
812493,813645,1152,0,0,1,2
812500,813647,1147,0,0,1,1
813646,813754,108,1,0,0,2
813648,813754,106,1,0,0,1
813755,813810,55,0,0,1,1
813755,813810,55,0,0,1,2
813811,813866,55,1,0,0,2
813811,813870,59,1,0,0,1
813867,813942,75,0,0,1,2
813871,813942,71,0,0,1,1
813943,813974,31,1,0,0,1
813943,813975,32,1,0,0,2
813975,815755,1780,0,0,1,1
813976,815765,1789,0,0,1,2
815756,815949,193,1,0,0,1
815766,815967,201,1,0,0,2
815794,815934,140,0,1,0,2
815797,815932,135,0,1,0,1
815950,816000,50,0,0,1,1
815968,815998,30,0,0,1,2
815999,816038,39,1,0,0,2
816001,816039,38,1,0,0,1
816039,816085,46,0,0,1,2
816040,816084,44,0,0,1,1
816085,816124,39,1,0,0,1
816086,816124,38,1,0,0,2
816125,816289,164,0,0,1,2
816125,816291,166,0,0,1,1
816290,816317,27,1,0,0,2
816292,816316,24,1,0,0,1
816317,816494,177,0,0,1,1
816318,816494,176,0,0,1,2
816495,816511,16,1,0,0,2
816495,816521,26,1,0,0,1
816512,817904,1392,0,0,1,2
816522,817905,1383,0,0,1,1
817905,817973,68,1,0,0,2
817906,817972,66,1,0,0,1
817973,818043,70,0,0,1,1
817974,818045,71,0,0,1,2
818044,818080,36,1,0,0,1
818046,818069,23,1,0,0,2
818070,818224,154,0,0,1,2
818081,818218,137,0,0,1,1
818219,818249,30,1,0,0,1
818225,818246,21,1,0,0,2
818247,819391,1144,0,0,1,2
818250,819384,1134,0,0,1,1
819385,819629,244,1,0,0,1
819392,819638,246,1,0,0,2
819412,819605,193,0,1,0,1
819413,819608,195,0,1,0,2
819630,819805,175,0,0,1,1
819639,819804,165,0,0,1,2
819805,819853,48,1,0,0,2
819806,819854,48,1,0,0,1
819854,819943,89,0,0,1,2
819855,819942,87,0,0,1,1
819943,819965,22,1,0,0,1
819944,819978,34,1,0,0,2
819966,820288,322,0,0,1,1
819979,820288,309,0,0,1,2
820289,820300,11,1,0,0,1
820289,820311,22,1,0,0,2
820301,821782,1481,0,0,1,1
820312,821783,1471,0,0,1,2
821783,821849,66,1,0,0,1
821784,822066,282,1,0,0,2
821850,821879,29,0,0,1,1
821880,822077,197,1,0,0,1
821898,822032,134,0,1,0,2
821898,822044,146,0,1,0,1
822067,822124,57,0,0,1,2
822078,822124,46,0,0,1,1
822125,822155,30,1,0,0,1
822125,822156,31,1,0,0,2
822156,823743,1587,0,0,1,1
822157,823744,1587,0,0,1,2
823744,823844,100,1,0,0,1
823745,823848,103,1,0,0,2
823845,823909,64,0,0,1,1
823849,823906,57,0,0,1,2
823907,824055,148,1,0,0,2
823910,823946,36,1,0,0,1
823947,824086,139,0,0,1,1
824056,824086,30,0,0,1,2
824087,824097,10,1,0,0,1
824087,824099,12,1,0,0,2
824098,825433,1335,0,0,1,1
824100,825425,1325,0,0,1,2
825426,825682,256,1,0,0,2
825434,825652,218,1,0,0,1
825445,825642,197,0,1,0,2
825451,825642,191,0,1,0,1
825653,825783,130,0,0,1,1
825683,825784,101,0,0,1,2
825784,825891,107,1,0,0,1
825785,825892,107,1,0,0,2
825892,825949,57,0,0,1,1
825893,825949,56,0,0,1,2
825950,825987,37,1,0,0,2
825950,825988,38,1,0,0,1
825988,827685,1697,0,0,1,2
825989,827686,1697,0,0,1,1
827686,827791,105,1,0,0,2
827687,827794,107,1,0,0,1
827792,827842,50,0,0,1,2
827795,827843,48,0,0,1,1
827843,827902,59,1,0,0,2
827844,827893,49,1,0,0,1
827894,827975,81,0,0,1,1
827903,827974,71,0,0,1,2
827975,828008,33,1,0,0,2
827976,828014,38,1,0,0,1
828009,828202,193,0,0,1,2
828015,828200,185,0,0,1,1
828201,828223,22,1,0,0,1
828203,828232,29,1,0,0,2
828224,829431,1207,0,0,1,1
828233,829414,1181,0,0,1,2
829415,829618,203,1,0,0,2
829432,829597,165,1,0,0,1
829456,829577,121,0,1,0,2
829460,829567,107,0,1,0,1
829598,829672,74,0,0,1,1
829619,829672,53,0,0,1,2
829673,829707,34,1,0,0,1
829673,829709,36,1,0,0,2
829708,829873,165,0,0,1,1
829710,829870,160,0,0,1,2
829871,829894,23,1,0,0,2
829874,829900,26,1,0,0,1
829895,831291,1396,0,0,1,2
829901,831290,1389,0,0,1,1
831291,831379,88,1,0,0,1
831292,831376,84,1,0,0,2
831377,831435,58,0,0,1,2
831380,831434,54,0,0,1,1
831435,831477,42,1,0,0,1
831436,831478,42,1,0,0,2
831478,832894,1416,0,0,1,1
831479,832906,1427,0,0,1,2
832895,833074,179,1,0,0,1
832907,833096,189,1,0,0,2
832920,833049,129,0,1,0,1
832926,833061,135,0,1,0,2
833075,833180,105,0,0,1,1
833097,833178,81,0,0,1,2
833179,833261,82,1,0,0,2
833181,833261,80,1,0,0,1
833262,833318,56,0,0,1,2
833262,833319,57,0,0,1,1
833319,833357,38,1,0,0,2
833320,833357,37,1,0,0,1
833358,834943,1585,0,0,1,2
833358,834944,1586,0,0,1,1
834944,835020,76,1,0,0,2
834945,835028,83,1,0,0,1
835021,835096,75,0,0,1,2
835029,835097,68,0,0,1,1
835097,835136,39,1,0,0,2
835098,835154,56,1,0,0,1
835137,835240,103,0,0,1,2
835155,835236,81,0,0,1,1
835237,835288,51,1,0,0,1
835241,835268,27,1,0,0,2
835269,836611,1342,0,0,1,2
835289,836599,1310,0,0,1,1
836600,836830,230,1,0,0,1
836612,836851,239,1,0,0,2
836639,836802,163,0,1,0,1
836639,836813,174,0,1,0,2
836831,836941,110,0,0,1,1
836852,836940,88,0,0,1,2
836941,837016,75,1,0,0,2
836942,837010,68,1,0,0,1
837011,837065,54,0,0,1,1
837017,837063,46,0,0,1,2
837064,837101,37,1,0,0,2
837066,837101,35,1,0,0,1
837102,837259,157,0,0,1,2
837102,837260,158,0,0,1,1
837260,837289,29,1,0,0,2
837261,837290,29,1,0,0,1
837290,838663,1373,0,0,1,2
837291,838670,1379,0,0,1,1
838664,838825,161,1,0,0,2
838671,838809,138,1,0,0,1
838683,838784,101,0,1,0,2
838687,838786,99,0,1,0,1
838810,839314,504,0,0,1,1
838826,839308,482,0,0,1,2
839309,839709,400,1,0,0,2
839315,839705,390,1,0,0,1
839326,839698,372,0,1,0,2
839331,839694,363,0,1,0,1
839706,839753,47,0,0,1,1
839710,839740,30,0,0,1,2
839741,839951,210,1,0,0,2
839754,839928,174,1,0,0,1
839765,839913,148,0,1,0,2
839770,839911,141,0,1,0,1
839929,839977,48,0,0,1,1
839952,839972,20,0,0,1,2
839973,840351,378,1,0,0,2
839978,840124,146,1,0,0,1
839989,840112,123,0,1,0,2
839992,840108,116,0,1,0,1
840125,840163,38,0,0,1,1
840164,840341,177,1,0,0,1
840177,840327,150,0,1,0,2
840180,840325,145,0,1,0,1
840342,840438,96,0,0,1,1
840352,840437,85,0,0,1,2
840438,840618,180,1,0,0,2
840439,840603,164,1,0,0,1
840454,840586,132,0,1,0,2
840457,840584,127,0,1,0,1
840604,841207,603,0,0,1,1
840619,841208,589,0,0,1,2
841208,841256,48,1,0,0,1
841209,841273,64,1,0,0,2
841257,841412,155,0,0,1,1
841274,841414,140,0,0,1,2
841413,841430,17,1,0,0,1
841415,841442,27,1,0,0,2
841431,841653,222,0,0,1,1
841443,841647,204,0,0,1,2
841648,841805,157,1,0,0,2
841654,841787,133,1,0,0,1
841665,841769,104,0,1,0,2
841670,841765,95,0,1,0,1
841788,841932,144,0,0,1,1
841806,841920,114,0,0,1,2
841921,841947,26,1,0,0,2
841933,841937,4,1,0,0,1
841938,844083,2145,0,0,1,1
841948,842034,86,0,0,1,2
842035,842039,4,1,0,0,2
842040,844083,2043,0,0,1,2
844084,844136,52,1,0,0,1
844084,844153,69,1,0,0,2
844137,846158,2021,0,0,1,1
844154,846169,2015,0,0,1,2
846159,846357,198,1,0,0,1
846170,846368,198,1,0,0,2
846190,846330,140,0,1,0,2
846192,846330,138,0,1,0,1
846358,846438,80,0,0,1,1
846369,846438,69,0,0,1,2
846439,846621,182,1,0,0,1
846439,846624,185,1,0,0,2
846459,846591,132,0,1,0,2
846461,846596,135,0,1,0,1
846622,847417,795,0,0,1,1
846625,847411,786,0,0,1,2
847412,847600,188,1,0,0,2
847418,847578,160,1,0,0,1
847432,847558,126,0,1,0,2
847437,847552,115,0,1,0,1
847579,848094,515,0,0,1,1
847601,848093,492,0,0,1,2
848094,848169,75,1,0,0,2
848095,848171,76,1,0,0,1
848170,848240,70,0,0,1,2
848172,848243,71,0,0,1,1
848241,848262,21,1,0,0,2
848244,848263,19,1,0,0,1
848263,848415,152,0,0,1,2
848264,848421,157,0,0,1,1
848416,848445,29,1,0,0,2
848422,848434,12,1,0,0,1
848435,849860,1425,0,0,1,1
848446,849860,1414,0,0,1,2
849861,849912,51,1,0,0,1
849861,849916,55,1,0,0,2
849913,850067,154,0,0,1,1
849917,850063,146,0,0,1,2
850064,850106,42,1,0,0,2
850068,850095,27,1,0,0,1
850096,851031,935,0,0,1,1
850107,851032,925,0,0,1,2
851032,851036,4,1,0,0,1
851033,851049,16,1,0,0,2
851037,852013,976,0,0,1,1
851050,852003,953,0,0,1,2
852004,852261,257,1,0,0,2
852014,852248,234,1,0,0,1
852032,852226,194,0,1,0,2
852036,852226,190,0,1,0,1
852249,852473,224,0,0,1,1
852262,852470,208,0,0,1,2
852471,852670,199,1,0,0,2
852474,852650,176,1,0,0,1
852487,852626,139,0,1,0,2
852490,852629,139,0,1,0,1
852651,853788,1137,0,0,1,1
852671,853786,1115,0,0,1,2
853787,853873,86,1,0,0,2
853789,853886,97,1,0,0,1
853874,853954,80,0,0,1,2
853887,853956,69,0,0,1,1
853955,853984,29,1,0,0,2
853957,853976,19,1,0,0,1
853977,855495,1518,0,0,1,1
853985,855495,1510,0,0,1,2
855496,855557,61,1,0,0,1
855496,855575,79,1,0,0,2
855558,855615,57,0,0,1,1
855576,855617,41,0,0,1,2
855616,855657,41,1,0,0,1
855618,855656,38,1,0,0,2
855657,855688,31,0,0,1,2
855658,855691,33,0,0,1,1
855689,855735,46,1,0,0,2
855692,855726,34,1,0,0,1
855727,857617,1890,0,0,1,1
855736,857603,1867,0,0,1,2
857604,857884,280,1,0,0,2
857618,857872,254,1,0,0,1
857635,857845,210,0,1,0,2
857639,857848,209,0,1,0,1
857873,858064,191,0,0,1,1
857885,858066,181,0,0,1,2
858065,858226,161,1,0,0,1
858067,858230,163,1,0,0,2
858085,858193,108,0,1,0,2
858087,858195,108,0,1,0,1
858227,859111,884,0,0,1,1
858231,859109,878,0,0,1,2
859110,859192,82,1,0,0,2
859112,859194,82,1,0,0,1
859193,859256,63,0,0,1,2
859195,859256,61,0,0,1,1
859257,859291,34,1,0,0,1
859257,859292,35,1,0,0,2
859292,859411,119,0,0,1,1
859293,859411,118,0,0,1,2
859412,859431,19,1,0,0,1
859412,859443,31,1,0,0,2
859432,860808,1376,0,0,1,1
859444,860808,1364,0,0,1,2
860809,860880,71,1,0,0,1
860809,860886,77,1,0,0,2
860881,862866,1985,0,0,1,1
860887,862867,1980,0,0,1,2
862867,863276,409,1,0,0,1
862868,863256,388,1,0,0,2
862894,863229,335,0,1,0,2
862900,863265,365,0,1,0,1
863257,863362,105,0,0,1,2
863277,863369,92,0,0,1,1
863363,863568,205,1,0,0,2
863370,863546,176,1,0,0,1
863383,863519,136,0,1,0,2
863387,863520,133,0,1,0,1
863547,864445,898,0,0,1,1
863569,864445,876,0,0,1,2
864446,864507,61,1,0,0,1
864446,864515,69,1,0,0,2
864508,865722,1214,0,0,1,1
864516,865722,1206,0,0,1,2
865723,865798,75,1,0,0,2
865723,865802,79,1,0,0,1
865799,865862,63,0,0,1,2
865803,865861,58,0,0,1,1
865862,865902,40,1,0,0,1
865863,865900,37,1,0,0,2
865901,865951,50,0,0,1,2
865903,865953,50,0,0,1,1
865952,865986,34,1,0,0,2
865954,865987,33,1,0,0,1
865987,867794,1807,0,0,1,2
865988,867791,1803,0,0,1,1
867792,867980,188,1,0,0,1
867795,867977,182,1,0,0,2
867824,867942,118,0,1,0,2
867827,867943,116,0,1,0,1
867978,869141,1163,0,0,1,2
867981,869140,1159,0,0,1,1
869141,869224,83,1,0,0,1
869142,869211,69,1,0,0,2
869212,869284,72,0,0,1,2
869225,869283,58,0,0,1,1
869284,869316,32,1,0,0,1
869285,869316,31,1,0,0,2
869317,870874,1557,0,0,1,2
869317,870876,1559,0,0,1,1
870875,870946,71,1,0,0,2
870877,870953,76,1,0,0,1
870947,872895,1948,0,0,1,2
870954,872906,1952,0,0,1,1
872896,873177,281,1,0,0,2
872907,873182,275,1,0,0,1
872934,873150,216,0,1,0,2
872937,873152,215,0,1,0,1
873178,873335,157,0,0,1,2
873183,873338,155,0,0,1,1
873336,873534,198,1,0,0,2
873339,873510,171,1,0,0,1
873355,873481,126,0,1,0,2
873357,873484,127,0,1,0,1
873511,874617,1106,0,0,1,1
873535,874616,1081,0,0,1,2
874617,874689,72,1,0,0,2
874618,874695,77,1,0,0,1
874690,874754,64,0,0,1,2
874696,874756,60,0,0,1,1
874755,874794,39,1,0,0,2
874757,874781,24,1,0,0,1
874782,875845,1063,0,0,1,1
874795,875845,1050,0,0,1,2
875846,875920,74,1,0,0,2
875846,875922,76,1,0,0,1
875921,876027,106,0,0,1,2
875923,876027,104,0,0,1,1
876028,876065,37,1,0,0,1
876028,876076,48,1,0,0,2
876066,877904,1838,0,0,1,1
876077,877903,1826,0,0,1,2
877904,878157,253,1,0,0,2
877905,878147,242,1,0,0,1
877934,878119,185,0,1,0,2
877938,878123,185,0,1,0,1
878148,878398,250,0,0,1,1
878158,878395,237,0,0,1,2
878396,878581,185,1,0,0,2
878399,878573,174,1,0,0,1
878414,878543,129,0,1,0,2
878416,878544,128,0,1,0,1
878574,879099,525,0,0,1,1
878582,879100,518,0,0,1,2
879100,879165,65,1,0,0,1
879101,879177,76,1,0,0,2
879166,879252,86,0,0,1,1
879178,879254,76,0,0,1,2
879253,879292,39,1,0,0,1
879255,879293,38,1,0,0,2
879293,881216,1923,0,0,1,1
879294,881214,1920,0,0,1,2
881215,881288,73,1,0,0,2
881217,881288,71,1,0,0,1
881289,881360,71,0,0,1,2
881289,881362,73,0,0,1,1
881361,881400,39,1,0,0,2
881363,881397,34,1,0,0,1
881398,883273,1875,0,0,1,1
881401,883271,1870,0,0,1,2
883272,883520,248,1,0,0,2
883274,883520,246,1,0,0,1
883296,883491,195,0,1,0,2
883296,883497,201,0,1,0,1
883521,884998,1477,0,0,1,1
883521,884998,1477,0,0,1,2
884999,885182,183,1,0,0,1
884999,885186,187,1,0,0,2
885019,885143,124,0,1,0,2
885020,885152,132,0,1,0,1
885183,885318,135,0,0,1,1
885187,885317,130,0,0,1,2
885318,885365,47,1,0,0,2
885319,885363,44,1,0,0,1
885364,885485,121,0,0,1,1
885366,885484,118,0,0,1,2
885485,885516,31,1,0,0,2
885486,885513,27,1,0,0,1
885514,887555,2041,0,0,1,1
885517,887556,2039,0,0,1,2
887556,887634,78,1,0,0,1
887557,887631,74,1,0,0,2
887632,887780,148,0,0,1,2
887635,887782,147,0,0,1,1
887781,887814,33,1,0,0,2
887783,887814,31,1,0,0,1
887815,889581,1766,0,0,1,1
887815,889585,1770,0,0,1,2
889582,889896,314,1,0,0,1
889586,889906,320,1,0,0,2
889605,889871,266,0,1,0,2
889609,889872,263,0,1,0,1
889897,890061,164,0,0,1,1
889907,890053,146,0,0,1,2
890054,890240,186,1,0,0,2
890062,890228,166,1,0,0,1
890075,890205,130,0,1,0,2
890078,890204,126,0,1,0,1
890229,891583,1354,0,0,1,1
890241,891583,1342,0,0,1,2
891584,891654,70,1,0,0,2
891584,891657,73,1,0,0,1
891655,891721,66,0,0,1,2
891658,891723,65,0,0,1,1
891722,891777,55,1,0,0,2
891724,891763,39,1,0,0,1
891764,891853,89,0,0,1,1
891778,891854,76,0,0,1,2
891854,891886,32,1,0,0,1
891855,891889,34,1,0,0,2
891887,893153,1266,0,0,1,1
891890,893151,1261,0,0,1,2
893152,893217,65,1,0,0,2
893154,893214,60,1,0,0,1
893215,893332,117,0,0,1,1
893218,893331,113,0,0,1,2
893332,893374,42,1,0,0,2
893333,893359,26,1,0,0,1
893360,895203,1843,0,0,1,1
893375,895199,1824,0,0,1,2
895200,895450,250,1,0,0,2
895204,895453,249,1,0,0,1
895222,895423,201,0,1,0,2
895226,895427,201,0,1,0,1
895451,896782,1331,0,0,1,2
895454,896781,1327,0,0,1,1
896782,896874,92,1,0,0,1
896783,896872,89,1,0,0,2
896873,896942,69,0,0,1,2
896875,896941,66,0,0,1,1
896942,896979,37,1,0,0,1
896943,896978,35,1,0,0,2
896979,897179,200,0,0,1,2
896980,897185,205,0,0,1,1
897180,897191,11,1,0,0,2
897186,897191,5,1,0,0,1
897192,898305,1113,0,0,1,2
897192,898306,1114,0,0,1,1
898306,898353,47,1,0,0,2
898307,898358,51,1,0,0,1
898354,900335,1981,0,0,1,2
898359,900329,1970,0,0,1,1
900330,900585,255,1,0,0,1
900336,900584,248,1,0,0,2
900350,900551,201,0,1,0,2
900350,900556,206,0,1,0,1
900585,900859,274,0,0,1,2
900586,900863,277,0,0,1,1
900860,901050,190,1,0,0,2
900864,901038,174,1,0,0,1
900879,901006,127,0,1,0,2
900880,901009,129,0,1,0,1
901039,901694,655,0,0,1,1
901051,901695,644,0,0,1,2
901695,901757,62,1,0,0,1
901696,901765,69,1,0,0,2
901758,901959,201,0,0,1,1
901766,901960,194,0,0,1,2
901960,901987,27,1,0,0,1
901961,901970,9,1,0,0,2
901971,903041,1070,0,0,1,2
901988,903042,1054,0,0,1,1
903042,903118,76,1,0,0,2
903043,903121,78,1,0,0,1
903119,903172,53,0,0,1,2
903122,903173,51,0,0,1,1
903173,903211,38,1,0,0,2
903174,903208,34,1,0,0,1
903209,903271,62,0,0,1,1
903212,903269,57,0,0,1,2
903270,903302,32,1,0,0,2
903272,903290,18,1,0,0,1
903291,905075,1784,0,0,1,1
903303,905074,1771,0,0,1,2
905075,905292,217,1,0,0,2
905076,905296,220,1,0,0,1
905099,905256,157,0,1,0,2
905099,905259,160,0,1,0,1
905293,906529,1236,0,0,1,2
905297,906530,1233,0,0,1,1
906530,906578,48,1,0,0,2
906531,906579,48,1,0,0,1
906579,907100,521,0,0,1,2
906580,907808,1228,0,0,1,1
907101,907117,16,1,0,0,2
907118,907808,690,0,0,1,2
907809,907854,45,1,0,0,1
907809,907868,59,1,0,0,2
907855,909825,1970,0,0,1,1
907869,909821,1952,0,0,1,2
909822,910088,266,1,0,0,2
909826,910085,259,1,0,0,1
909848,910053,205,0,1,0,2
909850,910060,210,0,1,0,1
910086,910237,151,0,0,1,1
910089,910240,151,0,0,1,2
910238,910402,164,1,0,0,1
910241,910404,163,1,0,0,2
910259,910373,114,0,1,0,2
910260,910380,120,0,1,0,1
910403,911192,789,0,0,1,1
910405,911190,785,0,0,1,2
911191,911252,61,1,0,0,2
911193,911276,83,1,0,0,1
911253,911347,94,0,0,1,2
911277,911348,71,0,0,1,1
911348,911383,35,1,0,0,2
911349,911376,27,1,0,0,1
911377,912393,1016,0,0,1,1
911384,912392,1008,0,0,1,2
912393,912471,78,1,0,0,2
912394,912470,76,1,0,0,1
912471,912575,104,0,0,1,1
912472,912574,102,0,0,1,2
912575,912608,33,1,0,0,2
912576,912609,33,1,0,0,1
912609,914432,1823,0,0,1,2
912610,914419,1809,0,0,1,1
914420,914639,219,1,0,0,1
914433,914638,205,1,0,0,2
914457,914612,155,0,1,0,2
914459,914613,154,0,1,0,1
914639,915674,1035,0,0,1,2
914640,915677,1037,0,0,1,1
915675,915752,77,1,0,0,2
915678,915756,78,1,0,0,1
915753,916093,340,0,0,1,2
915757,916105,348,0,0,1,1
916094,916122,28,1,0,0,2
916106,916110,4,1,0,0,1
916111,916914,803,0,0,1,1
916123,916914,791,0,0,1,2
916915,916981,66,1,0,0,1
916915,916985,70,1,0,0,2
916982,917168,186,0,0,1,1
916986,917168,182,0,0,1,2
917169,917201,32,1,0,0,2
917169,917203,34,1,0,0,1
917202,919038,1836,0,0,1,2
917204,919044,1840,0,0,1,1
919039,919258,219,1,0,0,2
919045,919236,191,1,0,0,1
919063,919215,152,0,1,0,2
919066,919208,142,0,1,0,1
919237,920303,1066,0,0,1,1
919259,920304,1045,0,0,1,2
920304,920376,72,1,0,0,1
920305,920378,73,1,0,0,2
920377,920449,72,0,0,1,1
920379,920448,69,0,0,1,2
920449,920485,36,1,0,0,2
920450,920483,33,1,0,0,1
920484,920649,165,0,0,1,1
920486,920648,162,0,0,1,2
920649,920662,13,1,0,0,2
920650,920661,11,1,0,0,1
920662,921773,1111,0,0,1,1
920663,921771,1108,0,0,1,2
921772,921835,63,1,0,0,2
921774,921835,61,1,0,0,1
921836,921919,83,0,0,1,2
921836,921921,85,0,0,1,1
921920,921954,34,1,0,0,2
921922,921952,30,1,0,0,1
921953,923248,1295,0,0,1,1
921955,923244,1289,0,0,1,2
923245,923526,281,1,0,0,2
923249,923511,262,1,0,0,1
923270,923485,215,0,1,0,2
923275,923480,205,0,1,0,1
923512,925272,1760,0,0,1,1
923527,925273,1746,0,0,1,2
925273,925335,62,1,0,0,1
925274,925344,70,1,0,0,2
925336,925425,89,0,0,1,1
925345,925424,79,0,0,1,2
925425,925462,37,1,0,0,2
925426,925462,36,1,0,0,1
925463,925639,176,0,0,1,1
925463,925646,183,0,0,1,2
925640,925663,23,1,0,0,1
925647,925659,12,1,0,0,2
925660,926686,1026,0,0,1,2
925664,926688,1024,0,0,1,1
926687,926738,51,1,0,0,2
926689,926751,62,1,0,0,1
926739,928718,1979,0,0,1,2
926752,928717,1965,0,0,1,1
928718,928999,281,1,0,0,1
928719,929007,288,1,0,0,2
928761,928974,213,0,1,0,2
928762,928972,210,0,1,0,1
929000,929113,113,0,0,1,1
929008,929109,101,0,0,1,2
929110,929299,189,1,0,0,2
929114,929295,181,1,0,0,1
929127,929266,139,0,1,0,2
929130,929264,134,0,1,0,1
929296,929838,542,0,0,1,1
929300,929837,537,0,0,1,2
929838,929886,48,1,0,0,2
929839,929889,50,1,0,0,1
929887,930176,289,0,0,1,2
929890,930175,285,0,0,1,1
930176,930240,64,1,0,0,1
930177,930249,72,1,0,0,2
930241,931157,916,0,0,1,1
930250,931155,905,0,0,1,2
931156,931190,34,1,0,0,2
931158,931187,29,1,0,0,1
931188,932058,870,0,0,1,1
931191,932060,869,0,0,1,2
932059,932134,75,1,0,0,1
932061,932127,66,1,0,0,2
932128,934090,1962,0,0,1,2
932135,934075,1940,0,0,1,1
934076,934297,221,1,0,0,1
934091,934303,212,1,0,0,2
934109,934268,159,0,1,0,1
934109,934269,160,0,1,0,2
934298,934540,242,0,0,1,1
934304,934540,236,0,0,1,2
934541,934609,68,1,0,0,2
934541,934611,70,1,0,0,1
934610,936079,1469,0,0,1,2
934612,936078,1466,0,0,1,1
936079,936143,64,1,0,0,1
936080,936152,72,1,0,0,2
936144,936234,90,0,0,1,1
936153,936233,80,0,0,1,2
936234,936268,34,1,0,0,2
936235,936267,32,1,0,0,1
936268,936489,221,0,0,1,1
936269,936482,213,0,0,1,2
936483,936670,187,1,0,0,2
936490,936670,180,1,0,0,1
936513,936630,117,0,1,0,2
936514,936636,122,0,1,0,1
936671,936792,121,0,0,1,1
936671,936792,121,0,0,1,2
936793,936814,21,1,0,0,2
936793,936825,32,1,0,0,1
936815,937818,1003,0,0,1,2
936826,937819,993,0,0,1,1
937819,937892,73,1,0,0,2
937820,937892,72,1,0,0,1
937893,939827,1934,0,0,1,1
937893,939834,1941,0,0,1,2
939828,940318,490,1,0,0,1
939835,940320,485,1,0,0,2
939851,940067,216,0,1,0,2
939852,940078,226,0,1,0,1
940139,940283,144,0,1,0,2
940140,940287,147,0,1,0,1
940319,941565,1246,0,0,1,1
940321,941564,1243,0,0,1,2
941565,941637,72,1,0,0,2
941566,941645,79,1,0,0,1
941638,941701,63,0,0,1,2
941646,941703,57,0,0,1,1
941702,941744,42,1,0,0,2
941704,941729,25,1,0,0,1
941730,941853,123,0,0,1,1
941745,941853,108,0,0,1,2
941854,941884,30,1,0,0,1
941854,941886,32,1,0,0,2
941885,943342,1457,0,0,1,1
941887,943342,1455,0,0,1,2
943343,943409,66,1,0,0,1
943343,943410,67,1,0,0,2
943410,945399,1989,0,0,1,1
943411,945382,1971,0,0,1,2
945383,945632,249,1,0,0,2
945400,945613,213,1,0,0,1
945417,945584,167,0,1,0,2
945419,945590,171,0,1,0,1
945614,947125,1511,0,0,1,1
945633,946246,613,0,0,1,2
946247,946260,13,1,0,0,2
946261,947122,861,0,0,1,2
947123,947207,84,1,0,0,2
947126,947206,80,1,0,0,1
947207,947267,60,0,0,1,1
947208,947266,58,0,0,1,2
947267,947308,41,1,0,0,2
947268,947300,32,1,0,0,1
947301,947437,136,0,0,1,1
947309,947436,127,0,0,1,2
947437,947470,33,1,0,0,2
947438,947459,21,1,0,0,1
947460,948522,1062,0,0,1,1
947471,948521,1050,0,0,1,2
948522,948598,76,1,0,0,2
948523,948576,53,1,0,0,1
948577,950512,1935,0,0,1,1
948599,950509,1910,0,0,1,2
950510,950837,327,1,0,0,2
950513,950837,324,1,0,0,1
950547,950809,262,0,1,0,2
950547,950810,263,0,1,0,1
950838,951011,173,0,0,1,2
950838,951015,177,0,0,1,1
951012,951172,160,1,0,0,2
951016,951171,155,1,0,0,1
951032,951138,106,0,1,0,2
951034,951134,100,0,1,0,1
951172,951555,383,0,0,1,1
951173,951551,378,0,0,1,2
951552,951734,182,1,0,0,2
951556,951713,157,1,0,0,1
951588,951680,92,0,1,0,2
951589,951683,94,0,1,0,1
951714,951891,177,0,0,1,1
951735,951891,156,0,0,1,2
951892,951961,69,1,0,0,1
951892,951965,73,1,0,0,2
951962,952031,69,0,0,1,1
951966,952032,66,0,0,1,2
952032,952067,35,1,0,0,1
952033,952068,35,1,0,0,2
952068,952262,194,0,0,1,1
952069,952257,188,0,0,1,2
952258,952289,31,1,0,0,2
952263,952277,14,1,0,0,1
952278,953268,990,0,0,1,1
952290,953266,976,0,0,1,2
953267,953325,58,1,0,0,2
953269,953318,49,1,0,0,1
953319,953550,231,0,0,1,1
953326,953548,222,0,0,1,2
953549,953582,33,1,0,0,2
953551,953580,29,1,0,0,1
953581,955392,1811,0,0,1,1
953583,955372,1789,0,0,1,2
955373,955520,147,1,0,0,2
955393,955511,118,1,0,0,1
955407,955490,83,0,1,0,2
955412,955481,69,0,1,0,1
955512,956529,1017,0,0,1,1
955521,956530,1009,0,0,1,2
956530,956596,66,1,0,0,1
956531,956600,69,1,0,0,2
956597,956702,105,0,0,1,1
956601,956701,100,0,0,1,2
956702,956736,34,1,0,0,2
956703,956736,33,1,0,0,1
956737,956871,134,0,0,1,2
956737,956878,141,0,0,1,1
956872,956893,21,1,0,0,2
956879,956893,14,1,0,0,1
956894,958754,1860,0,0,1,2
956894,958756,1862,0,0,1,1
958755,958829,74,1,0,0,2
958757,958833,76,1,0,0,1
958830,959080,250,0,0,1,2
958834,959081,247,0,0,1,1
959081,959113,32,1,0,0,2
959082,959114,32,1,0,0,1
959114,960777,1663,0,0,1,2
959115,960773,1658,0,0,1,1
960774,961024,250,1,0,0,1
960778,961038,260,1,0,0,2
960811,961000,189,0,1,0,2
960812,960998,186,0,1,0,1
961025,962776,1751,0,0,1,1
961039,962776,1737,0,0,1,2
962777,962849,72,1,0,0,2
962777,962855,78,1,0,0,1
962850,963012,162,0,0,1,2
962856,963017,161,0,0,1,1
963013,963040,27,1,0,0,2
963018,963029,11,1,0,0,1
963030,964239,1209,0,0,1,1
963041,964239,1198,0,0,1,2
964240,964286,46,1,0,0,2
964240,964290,50,1,0,0,1
964287,964405,118,0,0,1,2
964291,964407,116,0,0,1,1
964406,964443,37,1,0,0,2
964408,964432,24,1,0,0,1
964433,964589,156,0,0,1,1
964444,964589,145,0,0,1,2
964590,964610,20,1,0,0,2
964590,964622,32,1,0,0,1
964611,966235,1624,0,0,1,2
964623,966240,1617,0,0,1,1
966236,966521,285,1,0,0,2
966241,966521,280,1,0,0,1
966270,966491,221,0,1,0,2
966271,966493,222,0,1,0,1
966522,967024,502,0,0,1,2
966522,967025,503,0,0,1,1
967025,967094,69,1,0,0,2
967026,967073,47,1,0,0,1
967074,967734,660,0,0,1,1
967095,967735,640,0,0,1,2
967735,967818,83,1,0,0,1
967736,967817,81,1,0,0,2
967818,967892,74,0,0,1,2
967819,967892,73,0,0,1,1
967893,967914,21,1,0,0,2
967893,967922,29,1,0,0,1
967915,969547,1632,0,0,1,2
967923,969547,1624,0,0,1,1
969548,969632,84,1,0,0,1
969548,969707,159,1,0,0,2
969633,969654,21,0,0,1,1
969655,969711,56,1,0,0,1
969708,969736,28,0,0,1,2
969712,969735,23,0,0,1,1
969736,969776,40,1,0,0,1
969737,969787,50,1,0,0,2
969777,971586,1809,0,0,1,1
969788,971579,1791,0,0,1,2
971580,971875,295,1,0,0,2
971587,971868,281,1,0,0,1
971611,971837,226,0,1,0,2
971614,971842,228,0,1,0,1
971869,973306,1437,0,0,1,1
971876,973307,1431,0,0,1,2
973307,973391,84,1,0,0,1
973308,973392,84,1,0,0,2
973392,973452,60,0,0,1,1
973393,973453,60,0,0,1,2
973453,973491,38,1,0,0,1
973454,973490,36,1,0,0,2
973491,975521,2030,0,0,1,2
973492,974043,551,0,0,1,1
974044,974065,21,1,0,0,1
974066,975522,1456,0,0,1,1
975522,975598,76,1,0,0,2
975523,975598,75,1,0,0,1
975599,975756,157,0,0,1,1
975599,975758,159,0,0,1,2
975757,975788,31,1,0,0,1
975759,975790,31,1,0,0,2
975789,977552,1763,0,0,1,1
975791,977554,1763,0,0,1,2
977553,977882,329,1,0,0,1
977555,977882,327,1,0,0,2
977575,977836,261,0,1,0,2
977577,977851,274,0,1,0,1
977883,979430,1547,0,0,1,1
977883,979432,1549,0,0,1,2
979431,979494,63,1,0,0,1
979433,979487,54,1,0,0,2
979488,979572,84,0,0,1,2
979495,979573,78,0,0,1,1
979573,979602,29,1,0,0,2
979574,979612,38,1,0,0,1
979603,979675,72,0,0,1,2
979613,979670,57,0,0,1,1
979671,979871,200,1,0,0,1
979676,979865,189,1,0,0,2
979691,979837,146,0,1,0,1
979693,979831,138,0,1,0,2
979866,979952,86,0,0,1,2
979872,979952,80,0,0,1,1
979953,979984,31,1,0,0,1
979953,979984,31,1,0,0,2
979985,981100,1115,0,0,1,2
979985,981104,1119,0,0,1,1
981101,981180,79,1,0,0,2
981105,981182,77,1,0,0,1
981181,981243,62,0,0,1,2
981183,981245,62,0,0,1,1
981244,981284,40,1,0,0,2
981246,981285,39,1,0,0,1
981285,983237,1952,0,0,1,2
981286,983226,1940,0,0,1,1
983227,983577,350,1,0,0,1
983238,983577,339,1,0,0,2
983259,983540,281,0,1,0,2
983260,983547,287,0,1,0,1
983578,983732,154,0,0,1,2
983578,983736,158,0,0,1,1
983733,983919,186,1,0,0,2
983737,983915,178,1,0,0,1
983754,983880,126,0,1,0,2
983756,983878,122,0,1,0,1
983916,984364,448,0,0,1,1
983920,984363,443,0,0,1,2
984364,984448,84,1,0,0,2
984365,984448,83,1,0,0,1
984449,984517,68,0,0,1,2
984449,984518,69,0,0,1,1
984518,984549,31,1,0,0,2
984519,984544,25,1,0,0,1
984545,986073,1528,0,0,1,1
984550,986073,1523,0,0,1,2
986074,986117,43,1,0,0,1
986074,986149,75,1,0,0,2
986118,988163,2045,0,0,1,1
986150,988157,2007,0,0,1,2
988158,988409,251,1,0,0,2
988164,988392,228,1,0,0,1
988179,988364,185,0,1,0,2
988180,988363,183,0,1,0,1
988393,988567,174,0,0,1,1
988410,988567,157,0,0,1,2
988568,988646,78,1,0,0,1
988568,988662,94,1,0,0,2
988647,989878,1231,0,0,1,1
988663,989876,1213,0,0,1,2
989877,989916,39,1,0,0,2
989879,989916,37,1,0,0,1
989917,990170,253,0,0,1,2
989917,990185,268,0,0,1,1
990171,990388,217,1,0,0,2
990186,990381,195,1,0,0,1
990203,990346,143,0,1,0,2
990206,990349,143,0,1,0,1
990382,991098,716,0,0,1,1
990389,991098,709,0,0,1,2
1067391,1067664,273,0,0,1,2
1067391,1067667,276,0,0,1,1
1067665,1067866,201,1,0,0,2
1067668,1067882,214,1,0,0,1
1067682,1067829,147,0,1,0,2
1067683,1067842,159,0,1,0,1
1067867,1067911,44,0,0,1,2
1067883,1067910,27,0,0,1,1
1067911,1067943,32,1,0,0,1
1067912,1067936,24,1,0,0,2
1067937,1069952,2015,0,0,1,2
1067944,1069952,2008,0,0,1,1
1069953,1070035,82,1,0,0,2
1069953,1070036,83,1,0,0,1
1070036,1070098,62,0,0,1,2
1070037,1070101,64,0,0,1,1
1070099,1070158,59,1,0,0,2
1070102,1070143,41,1,0,0,1
1070144,1070239,95,0,0,1,1
1070159,1070236,77,0,0,1,2
1070237,1070271,34,1,0,0,2
1070240,1070275,35,1,0,0,1
1070272,1071621,1349,0,0,1,2
1070276,1071620,1344,0,0,1,1
1071621,1071767,146,1,0,0,1
1071622,1071784,162,1,0,0,2
1071646,1071729,83,0,1,0,1
1071648,1071725,77,0,1,0,2
1071768,1071917,149,0,0,1,1
1071785,1071917,132,0,0,1,2
1071918,1072003,85,1,0,0,1
1071918,1072006,88,1,0,0,2
1072004,1072128,124,0,0,1,1
1072007,1072127,120,0,0,1,2
1072128,1072159,31,1,0,0,2
1072129,1072158,29,1,0,0,1
1072159,1073900,1741,0,0,1,1
1072160,1072480,320,0,0,1,2
1072481,1072495,14,1,0,0,2
1072496,1073901,1405,0,0,1,2
1073901,1074077,176,1,0,0,1
1073902,1074082,180,1,0,0,2
1073936,1074041,105,0,1,0,2
1073937,1074040,103,0,1,0,1
1074078,1074158,80,0,0,1,1
1074083,1074156,73,0,0,1,2
1074157,1074213,56,1,0,0,2
1074159,1074198,39,1,0,0,1
1074199,1074289,90,0,0,1,1
1074214,1074290,76,0,0,1,2
1074290,1074310,20,1,0,0,1
1074291,1074322,31,1,0,0,2
1074311,1075946,1635,0,0,1,1
1074323,1075944,1621,0,0,1,2
1075945,1076028,83,1,0,0,2
1075947,1076032,85,1,0,0,1
1076029,1076089,60,0,0,1,2
1076033,1076091,58,0,0,1,1
1076090,1076147,57,1,0,0,2
1076092,1076131,39,1,0,0,1
1076132,1076209,77,0,0,1,1
1076148,1076212,64,0,0,1,2
1076210,1076277,67,1,0,0,1
1076213,1076245,32,1,0,0,2
1076246,1077543,1297,0,0,1,2
1076278,1077553,1275,0,0,1,1
1077544,1077737,193,1,0,0,2
1077554,1077723,169,1,0,0,1
1077572,1077704,132,0,1,0,2
1077577,1077703,126,0,1,0,1
1077724,1077975,251,0,0,1,1
1077738,1077975,237,0,0,1,2
1077976,1078133,157,1,0,0,1
1077976,1078133,157,1,0,0,2
1077994,1078101,107,0,1,0,2
1077997,1078095,98,0,1,0,1
1078134,1078202,68,0,0,1,1
1078134,1078203,69,0,0,1,2
1078203,1078241,38,1,0,0,1
1078204,1078256,52,1,0,0,2
1078242,1079775,1533,0,0,1,1
1078257,1079775,1518,0,0,1,2
1079776,1079861,85,1,0,0,1
1079776,1079867,91,1,0,0,2
1079862,1080003,141,0,0,1,1
1079868,1080001,133,0,0,1,2
1080002,1080082,80,1,0,0,2
1080004,1080084,80,1,0,0,1
1080083,1080177,94,0,0,1,2
1080085,1080175,90,0,0,1,1
1080176,1080210,34,1,0,0,1
1080178,1080210,32,1,0,0,2
1080211,1081623,1412,0,0,1,2
1080211,1081624,1413,0,0,1,1
1081625,1081817,192,1,0,0,1
1081634,1081789,155,0,1,0,2
1081641,1081787,146,0,1,0,1
1081799,1081823,24,1,0,0,2
1081818,1081982,164,0,0,1,1
1081824,1081983,159,0,0,1,2
1081983,1082057,74,1,0,0,1
1081984,1082063,79,1,0,0,2
1082058,1082137,79,0,0,1,1
1082064,1082135,71,0,0,1,2
1082136,1082170,34,1,0,0,2
1082138,1082161,23,1,0,0,1
1082162,1082492,330,0,0,1,1
1082171,1082493,322,0,0,1,2
1082493,1082508,15,1,0,0,1
1082494,1082505,11,1,0,0,2
1082506,1083792,1286,0,0,1,2
1082509,1083793,1284,0,0,1,1
1083793,1083875,82,1,0,0,2
1083794,1083860,66,1,0,0,1
1083861,1083952,91,0,0,1,1
1083876,1083953,77,0,0,1,2
1083953,1083989,36,1,0,0,1
1083954,1083990,36,1,0,0,2
1083990,1085363,1373,0,0,1,1
1083991,1085366,1375,0,0,1,2
1085364,1085585,221,1,0,0,1
1085367,1085588,221,1,0,0,2
1085386,1085536,150,0,1,0,1
1085389,1085544,155,0,1,0,2
1085586,1085692,106,0,0,1,1
1085589,1085692,103,0,0,1,2
1085693,1085781,88,1,0,0,1
1085693,1085792,99,1,0,0,2
1085782,1085880,98,0,0,1,1
1085793,1085880,87,0,0,1,2
1085881,1085898,17,1,0,0,1
1085881,1085900,19,1,0,0,2
1085899,1087475,1576,0,0,1,1
1085901,1087475,1574,0,0,1,2
1087476,1087572,96,1,0,0,2
1087476,1087573,97,1,0,0,1
1087573,1087621,48,0,0,1,2
1087574,1087624,50,0,0,1,1
1087622,1087660,38,1,0,0,2
1087625,1087664,39,1,0,0,1
1087661,1087778,117,0,0,1,2
1087665,1087779,114,0,0,1,1
1087779,1087811,32,1,0,0,2
1087780,1087814,34,1,0,0,1
1087812,1088960,1148,0,0,1,2
1087815,1088947,1132,0,0,1,1
1088948,1089192,244,1,0,0,1
1088961,1089194,233,1,0,0,2
1088974,1089151,177,0,1,0,1
1088977,1089163,186,0,1,0,2
1089193,1089370,177,0,0,1,1
1089195,1089368,173,0,0,1,2
1089369,1089464,95,1,0,0,2
1089371,1089462,91,1,0,0,1
1089463,1089529,66,0,0,1,1
1089465,1089528,63,0,0,1,2
1089529,1089566,37,1,0,0,2
1089530,1089568,38,1,0,0,1
1089567,1091170,1603,0,0,1,2
1089569,1091169,1600,0,0,1,1
1091170,1091225,55,1,0,0,1
1091171,1091249,78,1,0,0,2
1091226,1091334,108,0,0,1,1
1091250,1091330,80,0,0,1,2
1091331,1091373,42,1,0,0,2
1091335,1091346,11,1,0,0,1
1091347,1092519,1172,0,0,1,1
1091374,1092514,1140,0,0,1,2
1092515,1092725,210,1,0,0,2
1092520,1092725,205,1,0,0,1
1092534,1092692,158,0,1,0,2
1092538,1092686,148,0,1,0,1
1092726,1092889,163,0,0,1,2
1092726,1092890,164,0,0,1,1
1092890,1092992,102,1,0,0,2
1092891,1092988,97,1,0,0,1
1092989,1093055,66,0,0,1,1
1092993,1093052,59,0,0,1,2
1093053,1093111,58,1,0,0,2
1093056,1093095,39,1,0,0,1
1093096,1093174,78,0,0,1,1
1093112,1093173,61,0,0,1,2
1093174,1093209,35,1,0,0,2
1093175,1093207,32,1,0,0,1
1093208,1094687,1479,0,0,1,1
1093210,1094687,1477,0,0,1,2
1094688,1094743,55,1,0,0,2
1094688,1094744,56,1,0,0,1
1094744,1094827,83,0,0,1,2
1094745,1094827,82,0,0,1,1
1094828,1094863,35,1,0,0,2
1094828,1094864,36,1,0,0,1
1094864,1094971,107,0,0,1,2
1094865,1094972,107,0,0,1,1
1094972,1095004,32,1,0,0,2
1094973,1095003,30,1,0,0,1
1095004,1096062,1058,0,0,1,1
1095005,1096057,1052,0,0,1,2
1096058,1096226,168,1,0,0,2
1096063,1096219,156,1,0,0,1
1096086,1096193,107,0,1,0,2
1096090,1096190,100,0,1,0,1
1096220,1096509,289,0,0,1,1
1096227,1096509,282,0,0,1,2
1096510,1096609,99,1,0,0,1
1096510,1096611,101,1,0,0,2
1096610,1096692,82,0,0,1,1
1096612,1096693,81,0,0,1,2
1096693,1096718,25,1,0,0,1
1096694,1096730,36,1,0,0,2
1096719,1096882,163,0,0,1,1
1096731,1096880,149,0,0,1,2
1096881,1096911,30,1,0,0,2
1096883,1096901,18,1,0,0,1
1096902,1098235,1333,0,0,1,1
1096912,1098235,1323,0,0,1,2
1098236,1098309,73,1,0,0,1
1098236,1098323,87,1,0,0,2
1098310,1098375,65,0,0,1,1
1098324,1098376,52,0,0,1,2
1098376,1098416,40,1,0,0,1
1098377,1098415,38,1,0,0,2
1098416,1098958,542,0,0,1,2
1098417,1098959,542,0,0,1,1
1098959,1098982,23,1,0,0,2
1098960,1098971,11,1,0,0,1
1098972,1099505,533,0,0,1,1
1098983,1099502,519,0,0,1,2
1099503,1099700,197,1,0,0,2
1099506,1099698,192,1,0,0,1
1099524,1099663,139,0,1,0,2
1099526,1099657,131,0,1,0,1
1099699,1099959,260,0,0,1,1
1099701,1099961,260,0,0,1,2
1099960,1100020,60,1,0,0,1
1099962,1100027,65,1,0,0,2
1100021,1101678,1657,0,0,1,1
1100028,1101679,1651,0,0,1,2
1101679,1101942,263,1,0,0,1
1101680,1101765,85,1,0,0,2
1101766,1101823,57,0,0,1,2
1101824,1101861,37,1,0,0,2
1101862,1103306,1444,0,0,1,2
1101943,1102075,132,0,0,1,1
1102076,1102092,16,1,0,0,1
1102093,1103299,1206,0,0,1,1
1103300,1103480,180,1,0,0,1
1103307,1103484,177,1,0,0,2
1103324,1103438,114,0,1,0,1
1103325,1103445,120,0,1,0,2
1103481,1103576,95,0,0,1,1
1103485,1103575,90,0,0,1,2
1103576,1103649,73,1,0,0,2
1103577,1103647,70,1,0,0,1
1103648,1103708,60,0,0,1,1
1103650,1103707,57,0,0,1,2
1103708,1103748,40,1,0,0,2
1103709,1103743,34,1,0,0,1
1103744,1103866,122,0,0,1,1
1103749,1103861,112,0,0,1,2
1103862,1103890,28,1,0,0,2
1103867,1103880,13,1,0,0,1
1103881,1105411,1530,0,0,1,1
1103891,1105414,1523,0,0,1,2
1105412,1105494,82,1,0,0,1
1105415,1105499,84,1,0,0,2
1105495,1105557,62,0,0,1,1
1105500,1105559,59,0,0,1,2
1105558,1105594,36,1,0,0,1
1105560,1105598,38,1,0,0,2
1105595,1107204,1609,0,0,1,1
1105599,1107203,1604,0,0,1,2
1107204,1107410,206,1,0,0,2
1107205,1107411,206,1,0,0,1
1107238,1107370,132,0,1,0,1
1107238,1107375,137,0,1,0,2
1107411,1107508,97,0,0,1,2
1107412,1107507,95,0,0,1,1
1107508,1107535,27,1,0,0,1
1107509,1107559,50,1,0,0,2
1107536,1107728,192,0,0,1,1
1107560,1107730,170,0,0,1,2
1107729,1107744,15,1,0,0,1
1107731,1107742,11,1,0,0,2
1107743,1109054,1311,0,0,1,2
1107745,1109058,1313,0,0,1,1
1109055,1109149,94,1,0,0,2
1109059,1109153,94,1,0,0,1
1109150,1109216,66,0,0,1,2
1109154,1109217,63,0,0,1,1
1109217,1109251,34,1,0,0,2
1109218,1109251,33,1,0,0,1
1109252,1110613,1361,0,0,1,2
1109252,1110624,1372,0,0,1,1
1110614,1110842,228,1,0,0,2
1110625,1110846,221,1,0,0,1
1110638,1110805,167,0,1,0,2
1110646,1110805,159,0,1,0,1
1110843,1110957,114,0,0,1,2
1110847,1110956,109,0,0,1,1
1110957,1111044,87,1,0,0,1
1110958,1111041,83,1,0,0,2
1111042,1111098,56,0,0,1,2
1111045,1111098,53,0,0,1,1
1111099,1111135,36,1,0,0,2
1111099,1111137,38,1,0,0,1
1111136,1111277,141,0,0,1,2
1111138,1111282,144,0,0,1,1
1111278,1111300,22,1,0,0,2
1111283,1111310,27,1,0,0,1
1111301,1112835,1534,0,0,1,2
1111311,1112837,1526,0,0,1,1
1112836,1112936,100,1,0,0,2
1112838,1112941,103,1,0,0,1
1112937,1112995,58,0,0,1,2
1112942,1112996,54,0,0,1,1
1112996,1113033,37,1,0,0,2
1112997,1113033,36,1,0,0,1
1113034,1114216,1182,0,0,1,2
1113034,1114230,1196,0,0,1,1
1114217,1114454,237,1,0,0,2
1114231,1114451,220,1,0,0,1
1114247,1114420,173,0,1,0,2
1114254,1114422,168,0,1,0,1
1114452,1114607,155,0,0,1,1
1114455,1114608,153,0,0,1,2
1114608,1114684,76,1,0,0,1
1114609,1114683,74,1,0,0,2
1114684,1114816,132,0,0,1,2
1114685,1114823,138,0,0,1,1
1114817,1114849,32,1,0,0,2
1114824,1114840,16,1,0,0,1
1114841,1116364,1523,0,0,1,1
1114850,1116363,1513,0,0,1,2
1116364,1116445,81,1,0,0,2
1116365,1116444,79,1,0,0,1
1116445,1116501,56,0,0,1,1
1116446,1116501,55,0,0,1,2
1116502,1116534,32,1,0,0,1
1116502,1116537,35,1,0,0,2
1116535,1117702,1167,0,0,1,1
1116538,1116682,144,0,0,1,2
1116683,1116695,12,1,0,0,2
1116696,1117702,1006,0,0,1,2
1117703,1117922,219,1,0,0,1
1117703,1117931,228,1,0,0,2
1117724,1117893,169,0,1,0,2
1117728,1117894,166,0,1,0,1
1117923,1118112,189,0,0,1,1
1117932,1118114,182,0,0,1,2
1118113,1118207,94,1,0,0,1
1118115,1118204,89,1,0,0,2
1118205,1118260,55,0,0,1,2
1118208,1118262,54,0,0,1,1
1118261,1118298,37,1,0,0,2
1118263,1118302,39,1,0,0,1
1118299,1119845,1546,0,0,1,2
1118303,1119847,1544,0,0,1,1
1119846,1119936,90,1,0,0,2
1119848,1119923,75,1,0,0,1
1119924,1120000,76,0,0,1,1
1119937,1119998,61,0,0,1,2
1119999,1120040,41,1,0,0,2
1120001,1120039,38,1,0,0,1
1120040,1120201,161,0,0,1,1
1120041,1120198,157,0,0,1,2
1120199,1120233,34,1,0,0,2
1120202,1120224,22,1,0,0,1
1120225,1121694,1469,0,0,1,1
1120234,1121690,1456,0,0,1,2
1121691,1121806,115,1,0,0,2
1121695,1121800,105,1,0,0,1
1121801,1121865,64,0,0,1,1
1121807,1121865,58,0,0,1,2
1121866,1121905,39,1,0,0,1
1121866,1121905,39,1,0,0,2
1121906,1122004,98,0,0,1,1
1121906,1122005,99,0,0,1,2
1122005,1122040,35,1,0,0,1
1122006,1122039,33,1,0,0,2
1122040,1123185,1145,0,0,1,2
1122041,1123187,1146,0,0,1,1
1123186,1123404,218,1,0,0,2
1123188,1123398,210,1,0,0,1
1123205,1123372,167,0,1,0,2
1123206,1123365,159,0,1,0,1
1123399,1123510,111,0,0,1,1
1123405,1123507,102,0,0,1,2
1123508,1123592,84,1,0,0,2
1123511,1123595,84,1,0,0,1
1123593,1123743,150,0,0,1,2
1123596,1123743,147,0,0,1,1
1123744,1123774,30,1,0,0,1
1123744,1123774,30,1,0,0,2
1123775,1125243,1468,0,0,1,1
1123775,1125244,1469,0,0,1,2
1125244,1125339,95,1,0,0,1
1125245,1125353,108,1,0,0,2
1125340,1125406,66,0,0,1,1
1125354,1125406,52,0,0,1,2
1125407,1125447,40,1,0,0,1
1125407,1125447,40,1,0,0,2
1125448,1127033,1585,0,0,1,1
1125448,1127036,1588,0,0,1,2
1127034,1127141,107,1,0,0,1
1127037,1127147,110,1,0,0,2
1127142,1127210,68,0,0,1,1
1127148,1127208,60,0,0,1,2
1127209,1127250,41,1,0,0,2
1127211,1127249,38,1,0,0,1
1127250,1128860,1610,0,0,1,1
1127251,1128858,1607,0,0,1,2
1128859,1129093,234,1,0,0,2
1128861,1129140,279,1,0,0,1
1128883,1129052,169,0,1,0,2
1128887,1129064,177,0,1,0,1
1129094,1129181,87,0,0,1,2
1129141,1129182,41,0,0,1,1
1129182,1129213,31,1,0,0,2
1129183,1129212,29,1,0,0,1
1129213,1130606,1393,0,0,1,1
1129214,1130605,1391,0,0,1,2
1130606,1130686,80,1,0,0,2
1130607,1130687,80,1,0,0,1
1130687,1130767,80,0,0,1,2
1130688,1132245,1557,0,0,1,1
1130768,1130785,17,1,0,0,2
1130786,1132245,1459,0,0,1,2
1132246,1132507,261,1,0,0,2
1132246,1132519,273,1,0,0,1
1132321,1132477,156,0,1,0,1
1132322,1132473,151,0,1,0,2
1132508,1132612,104,0,0,1,2
1132520,1132614,94,0,0,1,1
1132613,1132645,32,1,0,0,2
1132615,1132643,28,1,0,0,1
1132644,1134082,1438,0,0,1,1
1132646,1134083,1437,0,0,1,2
1134083,1134171,88,1,0,0,1
1134084,1134173,89,1,0,0,2
1134172,1134305,133,0,0,1,1
1134174,1134304,130,0,0,1,2
1134305,1134330,25,1,0,0,2
1134306,1134332,26,1,0,0,1
1134331,1135773,1442,0,0,1,2
1134333,1135776,1443,0,0,1,1
1135774,1135876,102,1,0,0,2
1135777,1135878,101,1,0,0,1
1135877,1135938,61,0,0,1,2
1135879,1135937,58,0,0,1,1
1135938,1135961,23,1,0,0,1
1135939,1135966,27,1,0,0,2
1135962,1136507,545,0,0,1,1
1135967,1136500,533,0,0,1,2
1136501,1136531,30,1,0,0,2
1136508,1136519,11,1,0,0,1
1136520,1137597,1077,0,0,1,1
1136532,1137598,1066,0,0,1,2
1137598,1137810,212,1,0,0,1
1137599,1137825,226,1,0,0,2
1137620,1137783,163,0,1,0,2
1137625,1137790,165,0,1,0,1
1137811,1137862,51,0,0,1,1
1137826,1137860,34,0,0,1,2
1137861,1137896,35,1,0,0,2
1137863,1137884,21,1,0,0,1
1137885,1138022,137,0,0,1,1
1137897,1138022,125,0,0,1,2
1138023,1138051,28,1,0,0,1
1138023,1138052,29,1,0,0,2
1138052,1139387,1335,0,0,1,1
1138053,1139387,1334,0,0,1,2
1139388,1139482,94,1,0,0,2
1139388,1139483,95,1,0,0,1
1139483,1139546,63,0,0,1,2
1139484,1139547,63,0,0,1,1
1139547,1139589,42,1,0,0,2
1139548,1139588,40,1,0,0,1
1139589,1139675,86,0,0,1,1
1139590,1139674,84,0,0,1,2
1139675,1139705,30,1,0,0,2
1139676,1139695,19,1,0,0,1
1139696,1141163,1467,0,0,1,1
1139706,1141162,1456,0,0,1,2
1141163,1141253,90,1,0,0,2
1141164,1141258,94,1,0,0,1
1141254,1141311,57,0,0,1,2
1141259,1141310,51,0,0,1,1
1141311,1141371,60,1,0,0,1
1141312,1141356,44,1,0,0,2
1141357,1141493,136,0,0,1,2
1141372,1141493,121,0,0,1,1
1141494,1141522,28,1,0,0,1
1141494,1141523,29,1,0,0,2
1141523,1142000,477,0,0,1,1
1141524,1141999,475,0,0,1,2
1142000,1142033,33,1,0,0,2
1142001,1142039,38,1,0,0,1
1142034,1142510,476,0,0,1,2
1142040,1142517,477,0,0,1,1
1142511,1142719,208,1,0,0,2
1142518,1142693,175,1,0,0,1
1142542,1142670,128,0,1,0,2
1142549,1142664,115,0,1,0,1
1142694,1142834,140,0,0,1,1
1142720,1142834,114,0,0,1,2
1142835,1142925,90,1,0,0,1
1142835,1142935,100,1,0,0,2
1142926,1143006,80,0,0,1,1
1142936,1143006,70,0,0,1,2
1143007,1143047,40,1,0,0,1
1143007,1143048,41,1,0,0,2
1143048,1144766,1718,0,0,1,1
1143049,1144766,1717,0,0,1,2
1144767,1144884,117,1,0,0,2
1144767,1144905,138,1,0,0,1
1144885,1144939,54,0,0,1,2
1144906,1144941,35,0,0,1,1
1144940,1144985,45,1,0,0,2
1144942,1144988,46,1,0,0,1
1144986,1145092,106,0,0,1,2
1144989,1145095,106,0,0,1,1
1145093,1145124,31,1,0,0,2
1145096,1145128,32,1,0,0,1
1145125,1146457,1332,0,0,1,2
1145129,1146454,1325,0,0,1,1
1146455,1146544,89,1,0,0,1
1146458,1146543,85,1,0,0,2
1146544,1146601,57,0,0,1,2
1146545,1146603,58,0,0,1,1
1146602,1146641,39,1,0,0,2
1146604,1146639,35,1,0,0,1
1146640,1146702,62,0,0,1,1
1146642,1146703,61,0,0,1,2
1146703,1146906,203,1,0,0,1
1146704,1146896,192,1,0,0,2
1146723,1146869,146,0,1,0,2
1146727,1146863,136,0,1,0,1
1146897,1146981,84,0,0,1,2
1146907,1146969,62,0,0,1,1
1146970,1147004,34,1,0,0,1
1146982,1146998,16,1,0,0,2
1146999,1148528,1529,0,0,1,2
1147005,1148529,1524,0,0,1,1
1148529,1148577,48,1,0,0,2
1148530,1148578,48,1,0,0,1
1148578,1149274,696,0,0,1,2
1148579,1150191,1612,0,0,1,1
1149275,1149297,22,1,0,0,2
1149298,1150193,895,0,0,1,2
1150192,1150274,82,1,0,0,1
1150194,1150278,84,1,0,0,2
1150275,1150355,80,0,0,1,1
1150279,1150352,73,0,0,1,2
1150353,1150384,31,1,0,0,2
1150356,1150375,19,1,0,0,1
1150376,1151856,1480,0,0,1,1
1150385,1151855,1470,0,0,1,2
1151856,1152037,181,1,0,0,2
1151857,1152028,171,1,0,0,1
1151890,1151996,106,0,1,0,2
1151893,1151991,98,0,1,0,1
1152029,1152215,186,0,0,1,1
1152038,1152213,175,0,0,1,2
1152214,1152225,11,1,0,0,2
1152216,1152228,12,1,0,0,1
1152226,1153171,945,0,0,1,2
1152229,1153177,948,0,0,1,1
1153172,1153419,247,1,0,0,2
1153178,1153455,277,1,0,0,1
1153204,1153394,190,0,1,0,2
1153207,1153395,188,0,1,0,1
1153420,1153536,116,0,0,1,2
1153456,1153537,81,0,0,1,1
1153537,1153698,161,1,0,0,2
1153538,1153686,148,1,0,0,1
1153556,1153649,93,0,1,0,2
1153560,1153647,87,0,1,0,1
1153687,1153754,67,0,0,1,1
1153699,1153754,55,0,0,1,2
1153755,1153775,20,1,0,0,2
1153755,1153784,29,1,0,0,1
1153776,1153980,204,0,0,1,2
1153785,1153979,194,0,0,1,1
1153980,1154010,30,1,0,0,1
1153981,1153998,17,1,0,0,2
1153999,1155381,1382,0,0,1,2
1154011,1155381,1370,0,0,1,1
1155382,1155464,82,1,0,0,1
1155382,1155472,90,1,0,0,2
1155465,1157036,1571,0,0,1,1
1155473,1157034,1561,0,0,1,2
1157035,1157183,148,1,0,0,2
1157037,1157177,140,1,0,0,1
1157057,1157127,70,0,1,0,1
1157057,1157137,80,0,1,0,2
1157178,1157251,73,0,0,1,1
1157184,1157251,67,0,0,1,2
1157252,1157290,38,1,0,0,2
1157252,1157292,40,1,0,0,1
1157291,1157406,115,0,0,1,2
1157293,1157404,111,0,0,1,1
1157405,1157424,19,1,0,0,1
1157407,1157425,18,1,0,0,2
1157425,1158022,597,0,0,1,1
1157426,1158022,596,0,0,1,2
1158023,1158041,18,1,0,0,1
1158023,1158054,31,1,0,0,2
1158042,1159142,1100,0,0,1,1
1158055,1159145,1090,0,0,1,2
1159143,1159191,48,1,0,0,1
1159146,1159197,51,1,0,0,2
1159192,1161204,2012,0,0,1,1
1159198,1161204,2006,0,0,1,2
1161205,1161459,254,1,0,0,2
1161205,1161475,270,1,0,0,1
1161226,1161421,195,0,1,0,1
1161226,1161423,197,0,1,0,2
1161460,1161531,71,0,0,1,2
1161476,1161543,67,0,0,1,1
1161532,1161735,203,1,0,0,2
1161544,1161726,182,1,0,0,1
1161563,1161702,139,0,1,0,2
1161564,1161693,129,0,1,0,1
1161727,1162301,574,0,0,1,1
1161736,1162298,562,0,0,1,2
1162299,1162479,180,1,0,0,2
1162302,1162472,170,1,0,0,1
1162314,1162443,129,0,1,0,2
1162316,1162438,122,0,1,0,1
1162473,1162647,174,0,0,1,1
1162480,1162645,165,0,0,1,2
1162646,1162723,77,1,0,0,2
1162648,1162722,74,1,0,0,1
1162723,1162799,76,0,0,1,1
1162724,1162797,73,0,0,1,2
1162798,1162832,34,1,0,0,2
1162800,1162820,20,1,0,0,1
1162821,1164257,1436,0,0,1,1
1162833,1164255,1422,0,0,1,2
1164256,1164310,54,1,0,0,2
1164258,1164311,53,1,0,0,1
1164311,1166310,1999,0,0,1,2
1164312,1166313,2001,0,0,1,1
1166311,1166489,178,1,0,0,2
1166314,1166495,181,1,0,0,1
1166330,1166448,118,0,1,0,2
1166335,1166445,110,0,1,0,1
1166490,1166908,418,0,0,1,2
1166496,1166908,412,0,0,1,1
1166909,1166968,59,1,0,0,1
1166909,1166982,73,1,0,0,2
1166969,1167613,644,0,0,1,1
1166983,1167613,630,0,0,1,2
1167614,1167669,55,1,0,0,2
1167614,1167688,74,1,0,0,1
1167670,1168022,352,0,0,1,2
1167689,1168021,332,0,0,1,1
1168022,1168105,83,1,0,0,1
1168023,1168113,90,1,0,0,2
1168106,1168179,73,0,0,1,1
1168114,1168178,64,0,0,1,2
1168179,1168217,38,1,0,0,2
1168180,1168219,39,1,0,0,1
1168218,1168340,122,0,0,1,2
1168220,1168348,128,0,0,1,1
1168341,1168370,29,1,0,0,2
1168349,1168362,13,1,0,0,1
1168363,1169783,1420,0,0,1,1
1168371,1169780,1409,0,0,1,2
1169781,1169848,67,1,0,0,2
1169784,1169842,58,1,0,0,1
1169843,1171810,1967,0,0,1,1
1169849,1170225,376,0,0,1,2
1170226,1170255,29,1,0,0,2
1170256,1171798,1542,0,0,1,2
1171799,1172008,209,1,0,0,2
1171811,1172023,212,1,0,0,1
1171830,1171981,151,0,1,0,1
1171831,1171980,149,0,1,0,2
1172009,1172114,105,0,0,1,2
1172024,1172107,83,0,0,1,1
1172108,1172293,185,1,0,0,1
1172115,1172296,181,1,0,0,2
1172132,1172256,124,0,1,0,1
1172133,1172264,131,0,1,0,2
1172294,1172508,214,0,0,1,1
1172297,1172508,211,0,0,1,2
1172509,1172574,65,1,0,0,2
1172509,1172575,66,1,0,0,1
1172575,1173403,828,0,0,1,2
1172576,1173404,828,0,0,1,1
1173404,1173491,87,1,0,0,2
1173405,1173484,79,1,0,0,1
1173485,1174628,1143,0,0,1,1
1173492,1174628,1136,0,0,1,2
1174629,1174703,74,1,0,0,1
1174629,1174708,79,1,0,0,2
1174704,1174819,115,0,0,1,1
1174709,1174820,111,0,0,1,2
1174820,1174859,39,1,0,0,1
1174821,1174860,39,1,0,0,2
1174860,1176667,1807,0,0,1,1
1174861,1176675,1814,0,0,1,2
1176668,1176842,174,1,0,0,1
1176676,1176855,179,1,0,0,2
1176693,1176821,128,0,1,0,2
1176698,1176818,120,0,1,0,1
1176843,1177175,332,0,0,1,1
1176856,1177176,320,0,0,1,2
1177176,1177257,81,1,0,0,1
1177177,1177257,80,1,0,0,2
1177258,1177990,732,0,0,1,2
1177258,1177992,734,0,0,1,1
1177991,1178065,74,1,0,0,2
1177993,1178049,56,1,0,0,1
1178050,1178277,227,0,0,1,1
1178066,1178276,210,0,0,1,2
1178277,1178308,31,1,0,0,2
1178278,1178306,28,1,0,0,1
1178307,1179740,1433,0,0,1,1
1178309,1179740,1431,0,0,1,2
1179741,1179940,199,1,0,0,1
1179741,1179946,205,1,0,0,2
1179793,1179909,116,0,1,0,2
1179796,1179907,111,0,1,0,1
1179941,1181770,1829,0,0,1,1
1179947,1181763,1816,0,0,1,2
1181764,1181947,183,1,0,0,2
1181771,1181944,173,1,0,0,1
1181789,1181907,118,0,1,0,1
1181789,1181910,121,0,1,0,2
1181945,1182042,97,0,0,1,1
1181948,1182042,94,0,0,1,2
1182043,1182268,225,1,0,0,1
1182043,1182275,232,1,0,0,2
1182064,1182233,169,0,1,0,2
1182067,1182236,169,0,1,0,1
1182269,1183502,1233,0,0,1,1
1182276,1183502,1226,0,0,1,2
1183503,1183582,79,1,0,0,1
1183503,1183597,94,1,0,0,2
1183583,1183862,279,0,0,1,1
1183598,1183858,260,0,0,1,2
1183859,1183892,33,1,0,0,2
1183863,1183891,28,1,0,0,1
1183892,1184768,876,0,0,1,1
1183893,1184766,873,0,0,1,2
1184767,1184818,51,1,0,0,2
1184769,1184821,52,1,0,0,1
1184819,1184938,119,0,0,1,2
1184822,1184939,117,0,0,1,1
1184939,1184981,42,1,0,0,2
1184940,1184962,22,1,0,0,1
1184963,1185081,118,0,0,1,1
1184982,1185080,98,0,0,1,2
1185081,1185110,29,1,0,0,2
1185082,1185110,28,1,0,0,1
1185111,1185202,91,0,0,1,2
1185111,1185531,420,0,0,1,1
1185203,1185232,29,1,0,0,2
1185233,1185529,296,0,0,1,2
1185530,1185554,24,1,0,0,2
1185532,1185554,22,1,0,0,1
1185555,1186783,1228,0,0,1,2
1185555,1186793,1238,0,0,1,1
1186784,1186999,215,1,0,0,2
1186794,1187003,209,1,0,0,1
1186821,1186959,138,0,1,0,2
1186823,1186962,139,0,1,0,1
1187000,1187174,174,0,0,1,2
1187004,1187173,169,0,0,1,1
1187174,1187355,181,1,0,0,1
1187175,1187358,183,1,0,0,2
1187195,1187321,126,0,1,0,2
1187198,1187316,118,0,1,0,1
1187356,1188034,678,0,0,1,1
1187359,1188035,676,0,0,1,2
1188035,1188124,89,1,0,0,1
1188036,1188124,88,1,0,0,2
1188125,1188204,79,0,0,1,2
1188125,1188206,81,0,0,1,1
1188205,1188239,34,1,0,0,2
1188207,1188229,22,1,0,0,1
1188230,1189816,1586,0,0,1,1
1188240,1189813,1573,0,0,1,2
1189814,1189863,49,1,0,0,2
1189817,1189866,49,1,0,0,1
1189864,1190105,241,0,0,1,2
1189867,1190106,239,0,0,1,1
1190106,1190136,30,1,0,0,2
1190107,1190123,16,1,0,0,1
1190124,1191881,1757,0,0,1,1
1190137,1191885,1748,0,0,1,2
1191882,1192114,232,1,0,0,1
1191886,1192107,221,1,0,0,2
1191902,1192081,179,0,1,0,1
1191903,1192072,169,0,1,0,2
1192108,1192493,385,0,0,1,2
1192115,1192494,379,0,0,1,1
1192494,1192561,67,1,0,0,2
1192495,1192562,67,1,0,0,1
1192562,1193723,1161,0,0,1,2
1192563,1193724,1161,0,0,1,1
1193724,1193811,87,1,0,0,2
1193725,1193810,85,1,0,0,1
1193811,1193885,74,0,0,1,1
1193812,1193885,73,0,0,1,2
1193886,1193917,31,1,0,0,1
1193886,1193920,34,1,0,0,2
1193918,1195977,2059,0,0,1,1
1193921,1195974,2053,0,0,1,2
1195975,1196051,76,1,0,0,2
1195978,1196051,73,1,0,0,1
1196052,1196176,124,0,0,1,1
1196052,1196176,124,0,0,1,2
1196177,1196212,35,1,0,0,1
1196177,1196214,37,1,0,0,2
1196213,1198028,1815,0,0,1,1
1196215,1198012,1797,0,0,1,2
1198013,1198428,415,1,0,0,2
1198029,1198445,416,1,0,0,1
1198046,1198417,371,0,1,0,2
1198050,1198413,363,0,1,0,1
1198429,1198496,67,0,0,1,2
1198446,1198515,69,0,0,1,1
1198497,1198699,202,1,0,0,2
1198516,1198697,181,1,0,0,1
1198529,1198670,141,0,1,0,2
1198531,1198667,136,0,1,0,1
1198698,1198983,285,0,0,1,1
1198700,1198982,282,0,0,1,2
1198983,1199057,74,1,0,0,2
1198984,1199055,71,1,0,0,1
1199056,1199306,250,0,0,1,1
1199058,1199303,245,0,0,1,2
1199304,1199469,165,1,0,0,2
1199307,1199448,141,1,0,0,1
1199322,1199417,95,0,1,0,2
1199323,1199410,87,0,1,0,1
1199449,1199985,536,0,0,1,1
1199470,1199983,513,0,0,1,2
1199984,1200063,79,1,0,0,2
1199986,1200067,81,1,0,0,1
1200064,1200135,71,0,0,1,2
1200068,1200136,68,0,0,1,1
1200136,1200170,34,1,0,0,2
1200137,1200173,36,1,0,0,1
1200171,1200347,176,0,0,1,2
1200174,1200347,173,0,0,1,1
1200348,1200377,29,1,0,0,1
1200348,1200379,31,1,0,0,2
1200378,1201615,1237,0,0,1,1
1200380,1201616,1236,0,0,1,2
1201616,1201689,73,1,0,0,1
1201617,1201696,79,1,0,0,2
1201690,1203645,1955,0,0,1,1
1201697,1203637,1940,0,0,1,2
1203638,1203818,180,1,0,0,2
1203646,1203815,169,1,0,0,1
1203661,1203782,121,0,1,0,2
1203666,1203775,109,0,1,0,1
1203816,1205359,1543,0,0,1,1
1203819,1205359,1540,0,0,1,2
1205360,1205408,48,1,0,0,1
1205360,1205409,49,1,0,0,2
1205409,1206974,1565,0,0,1,1
1205410,1206975,1565,0,0,1,2
1206975,1207024,49,1,0,0,1
1206976,1207029,53,1,0,0,2
1207025,1208995,1970,0,0,1,1
1207030,1208984,1954,0,0,1,2
1208985,1209194,209,1,0,0,2
1208996,1209190,194,1,0,0,1
1209012,1209151,139,0,1,0,1
1209012,1209158,146,0,1,0,2
1209191,1210757,1566,0,0,1,1
1209195,1210758,1563,0,0,1,2
1210758,1210832,74,1,0,0,1
1210759,1210837,78,1,0,0,2
1210833,1211005,172,0,0,1,1
1210838,1211003,165,0,0,1,2
1211004,1211026,22,1,0,0,2
1211006,1211029,23,1,0,0,1
1211027,1212334,1307,0,0,1,2
1211030,1212335,1305,0,0,1,1
1212335,1212415,80,1,0,0,2
1212336,1212417,81,1,0,0,1
1212416,1214361,1945,0,0,1,2
1212418,1214357,1939,0,0,1,1
1214358,1214573,215,1,0,0,1
1214362,1214571,209,1,0,0,2
1214376,1214539,163,0,1,0,1
1214378,1214536,158,0,1,0,2
1214572,1214733,161,0,0,1,2
1214574,1214733,159,0,0,1,1
1214734,1214804,70,1,0,0,1
1214734,1214805,71,1,0,0,2
1214805,1215826,1021,0,0,1,1
1214806,1215826,1020,0,0,1,2
1215827,1215857,30,1,0,0,1
1215827,1215873,46,1,0,0,2
1215858,1216107,249,0,0,1,1
1215874,1216106,232,0,0,1,2
1216107,1216126,19,1,0,0,2
1216108,1216128,20,1,0,0,1
1216127,1217441,1314,0,0,1,2
1216129,1217439,1310,0,0,1,1
1217440,1217511,71,1,0,0,1
1217442,1217519,77,1,0,0,2
1217512,1218092,580,0,0,1,1
1217520,1218091,571,0,0,1,2
1218092,1218125,33,1,0,0,2
1218093,1218123,30,1,0,0,1
1218124,1219475,1351,0,0,1,1
1218126,1219468,1342,0,0,1,2
1219469,1219711,242,1,0,0,2
1219476,1219711,235,1,0,0,1
1219497,1219664,167,0,1,0,1
1219500,1219669,169,0,1,0,2
1219712,1220024,312,0,0,1,1
1219712,1220024,312,0,0,1,2
1220025,1220074,49,1,0,0,1
1220025,1220076,51,1,0,0,2
1220075,1221361,1286,0,0,1,1
1220077,1221359,1282,0,0,1,2
1221360,1221596,236,1,0,0,2
1221362,1221578,216,1,0,0,1
1221446,1221545,99,0,1,0,2
1221448,1221541,93,0,1,0,1
1221579,1221653,74,0,0,1,1
1221597,1221654,57,0,0,1,2
1221654,1221684,30,1,0,0,1
1221655,1221679,24,1,0,0,2
1221680,1223448,1768,0,0,1,2
1221685,1223449,1764,0,0,1,1
1223449,1223514,65,1,0,0,2
1223450,1223520,70,1,0,0,1
1223515,1225479,1964,0,0,1,2
1223521,1225488,1967,0,0,1,1
1225480,1225736,256,1,0,0,2
1225489,1225742,253,1,0,0,1
1225508,1225703,195,0,1,0,2
1225514,1225698,184,0,1,0,1
1225737,1225870,133,0,0,1,2
1225743,1225871,128,0,0,1,1
1225871,1226063,192,1,0,0,2
1225872,1226063,191,1,0,0,1
1225892,1226025,133,0,1,0,2
1225893,1226024,131,0,1,0,1
1226064,1227367,1303,0,0,1,2
1226064,1227376,1312,0,0,1,1
1227368,1227544,176,1,0,0,2
1227377,1227546,169,1,0,0,1
1227394,1227482,88,0,1,0,2
1227397,1227485,88,0,1,0,1
1227545,1227616,71,0,0,1,2
1227547,1227616,69,0,0,1,1
1227617,1227653,36,1,0,0,1
1227617,1227654,37,1,0,0,2
1227654,1227764,110,0,0,1,1
1227655,1227762,107,0,0,1,2
1227763,1227796,33,1,0,0,2
1227765,1227798,33,1,0,0,1
1227797,1229476,1679,0,0,1,2
1227799,1229477,1678,0,0,1,1
1229477,1229542,65,1,0,0,2
1229478,1229543,65,1,0,0,1
1229543,1231488,1945,0,0,1,2
1229544,1231490,1946,0,0,1,1
1231489,1231746,257,1,0,0,2
1231491,1231770,279,1,0,0,1
1231515,1231714,199,0,1,0,1
1231515,1231715,200,0,1,0,2
1231747,1231833,86,0,0,1,2
1231771,1231836,65,0,0,1,1
1231834,1232034,200,1,0,0,2
1231837,1232025,188,1,0,0,1
1231857,1231993,136,0,1,0,1
1231858,1232003,145,0,1,0,2
1232026,1232283,257,0,0,1,1
1232035,1232283,248,0,0,1,2
1232284,1232353,69,1,0,0,1
1232284,1232360,76,1,0,0,2
1232354,1232584,230,0,0,1,1
1232361,1232584,223,0,0,1,2
1232585,1232638,53,1,0,0,2
1232585,1232641,56,1,0,0,1
1232639,1232856,217,0,0,1,2
1232642,1232862,220,0,0,1,1
1232857,1233018,161,1,0,0,2
1232863,1233014,151,1,0,0,1
1232877,1232981,104,0,1,0,2
1232878,1232974,96,0,1,0,1
1233015,1233474,459,0,0,1,1
1233019,1233475,456,0,0,1,2
1233475,1233508,33,1,0,0,1
1233476,1233511,35,1,0,0,2
1233509,1235239,1730,0,0,1,1
1233512,1235238,1726,0,0,1,2
1235239,1235321,82,1,0,0,2
1235240,1235304,64,1,0,0,1
1235305,1235366,61,0,0,1,1
1235322,1235368,46,0,0,1,2
1235367,1235407,40,1,0,0,1
1235369,1235406,37,1,0,0,2
1235407,1237240,1833,0,0,1,2
1235408,1237246,1838,0,0,1,1
1237241,1237509,268,1,0,0,2
1237247,1237502,255,1,0,0,1
1237263,1237460,197,0,1,0,2
1237264,1237469,205,0,1,0,1
1237503,1237766,263,0,0,1,1
1237510,1237764,254,0,0,1,2
1237765,1237838,73,1,0,0,2
1237767,1237839,72,1,0,0,1
1237839,1239129,1290,0,0,1,2
1237840,1239131,1291,0,0,1,1
1239130,1239215,85,1,0,0,2
1239132,1239211,79,1,0,0,1
1239212,1239291,79,0,0,1,1
1239216,1239289,73,0,0,1,2
1239290,1239327,37,1,0,0,2
1239292,1239327,35,1,0,0,1
1239328,1241087,1759,0,0,1,1
1239328,1241088,1760,0,0,1,2
1241088,1241137,49,1,0,0,1
1241089,1241140,51,1,0,0,2
1241138,1243086,1948,0,0,1,1
1241141,1243086,1945,0,0,1,2
1243087,1243413,326,1,0,0,1
1243087,1243420,333,1,0,0,2
1243111,1243390,279,0,1,0,2
1243115,1243397,282,0,1,0,1
1243414,1243541,127,0,0,1,1
1243421,1243529,108,0,0,1,2
1243530,1243747,217,1,0,0,2
1243542,1243741,199,1,0,0,1
1243553,1243713,160,0,1,0,2
1243556,1243708,152,0,1,0,1
1243742,1243917,175,0,0,1,1
1243748,1243917,169,0,0,1,2
1243918,1243972,54,1,0,0,1
1243918,1243983,65,1,0,0,2
1243973,1245065,1092,0,0,1,1
1243984,1245061,1077,0,0,1,2
1245062,1245234,172,1,0,0,2
1245066,1245252,186,1,0,0,1
1245080,1245203,123,0,1,0,2
1245085,1245203,118,0,1,0,1
1245235,1245327,92,0,0,1,2
1245253,1245326,73,0,0,1,1
1245327,1245361,34,1,0,0,1
1245328,1245346,18,1,0,0,2
1245347,1246635,1288,0,0,1,2
1245362,1246636,1274,0,0,1,1
1246636,1246710,74,1,0,0,2
1246637,1246713,76,1,0,0,1
1246711,1246772,61,0,0,1,2
1246714,1246773,59,0,0,1,1
1246773,1246810,37,1,0,0,2
1246774,1246805,31,1,0,0,1
1246806,1248678,1872,0,0,1,1
1246811,1248675,1864,0,0,1,2
1248676,1248865,189,1,0,0,2
1248679,1248865,186,1,0,0,1
1248697,1248830,133,0,1,0,2
1248698,1248830,132,0,1,0,1
1248866,1250153,1287,0,0,1,1
1248866,1250154,1288,0,0,1,2
1250154,1250214,60,1,0,0,1
1250155,1250216,61,1,0,0,2
1250215,1250308,93,0,0,1,1
1250217,1250307,90,0,0,1,2
1250308,1250339,31,1,0,0,2
1250309,1250331,22,1,0,0,1
1250332,1251492,1160,0,0,1,1
1250340,1251492,1152,0,0,1,2
1251493,1251546,53,1,0,0,1
1251493,1251552,59,1,0,0,2
1251547,1251884,337,0,0,1,1
1251553,1251881,328,0,0,1,2
1251882,1251914,32,1,0,0,2
1251885,1251910,25,1,0,0,1
1251911,1253532,1621,0,0,1,1
1251915,1253532,1617,0,0,1,2
1253533,1253730,197,1,0,0,1
1253533,1253730,197,1,0,0,2
1253566,1253696,130,0,1,0,2
1253566,1253698,132,0,1,0,1
1253731,1253949,218,0,0,1,2
1253731,1253950,219,0,0,1,1
1253950,1254151,201,1,0,0,2
1253951,1254150,199,1,0,0,1
1253966,1254112,146,0,1,0,1
1253966,1254117,151,0,1,0,2
1254151,1254874,723,0,0,1,1
1254152,1254875,723,0,0,1,2
1254875,1254948,73,1,0,0,1
1254876,1254949,73,1,0,0,2
1254949,1255063,114,0,0,1,1
1254950,1255059,109,0,0,1,2
1255060,1255088,28,1,0,0,2
1255064,1255076,12,1,0,0,1
1255077,1256799,1722,0,0,1,1
1255089,1256800,1711,0,0,1,2
1256800,1257013,213,1,0,0,1
1256801,1256999,198,1,0,0,2
1256839,1256977,138,0,1,0,1
1256841,1256967,126,0,1,0,2
1257000,1257084,84,0,0,1,2
1257014,1257081,67,0,0,1,1
1257082,1257114,32,1,0,0,1
1257085,1257111,26,1,0,0,2
1257112,1257344,232,0,0,1,2
1257115,1257340,225,0,0,1,1
1257341,1257371,30,1,0,0,1
1257345,1257364,19,1,0,0,2
1257365,1258851,1486,0,0,1,2
1257372,1258846,1474,0,0,1,1
1258847,1259069,222,1,0,0,1
1258852,1259062,210,1,0,0,2
1258870,1259032,162,0,1,0,1
1258872,1259031,159,0,1,0,2
1259063,1260838,1775,0,0,1,2
1259070,1260838,1768,0,0,1,1
1260839,1260923,84,1,0,0,1
1260839,1260931,92,1,0,0,2
1260924,1261014,90,0,0,1,1
1260932,1261013,81,0,0,1,2
1261014,1261048,34,1,0,0,2
1261015,1261048,33,1,0,0,1
1261049,1262175,1126,0,0,1,1
1261049,1262175,1126,0,0,1,2
1262176,1262249,73,1,0,0,2
1262176,1262253,77,1,0,0,1
1262250,1262314,64,0,0,1,2
1262254,1262315,61,0,0,1,1
1262315,1262350,35,1,0,0,2
1262316,1262349,33,1,0,0,1
1262350,1264246,1896,0,0,1,1
1262351,1264234,1883,0,0,1,2
1264235,1264439,204,1,0,0,2
1264247,1264426,179,1,0,0,1
1264268,1264390,122,0,1,0,2
1264269,1264388,119,0,1,0,1
1264427,1264685,258,0,0,1,1
1264440,1264683,243,0,0,1,2
1264684,1264864,180,1,0,0,2
1264686,1264858,172,1,0,0,1
1264702,1264823,121,0,1,0,1
1264702,1264825,123,0,1,0,2
1264859,1265449,590,0,0,1,1
1264865,1265447,582,0,0,1,2
1265448,1265527,79,1,0,0,2
1265450,1265527,77,1,0,0,1
1265528,1265588,60,0,0,1,2
1265528,1265590,62,0,0,1,1
1265589,1265624,35,1,0,0,2
1265591,1265624,33,1,0,0,1
1265625,1265720,95,0,0,1,2
1265625,1265722,97,0,0,1,1
1265721,1265752,31,1,0,0,2
1265723,1265755,32,1,0,0,1
1265753,1266686,933,0,0,1,2
1265756,1266686,930,0,0,1,1
1266687,1266734,47,1,0,0,1
1266687,1266735,48,1,0,0,2
1266735,1266820,85,0,0,1,1
1266736,1266820,84,0,0,1,2
1266821,1266856,35,1,0,0,1
1266821,1266857,36,1,0,0,2
1266857,1267051,194,0,0,1,1
1266858,1267052,194,0,0,1,2
1267052,1267065,13,1,0,0,1
1267053,1267064,11,1,0,0,2
1267065,1268717,1652,0,0,1,2
1267066,1268718,1652,0,0,1,1
1268718,1268942,224,1,0,0,2
1268719,1268937,218,1,0,0,1
1268738,1268908,170,0,1,0,2
1268742,1268898,156,0,1,0,1
1268938,1269925,987,0,0,1,1
1268943,1269924,981,0,0,1,2
1269925,1270006,81,1,0,0,2
1269926,1270009,83,1,0,0,1
1270007,1270077,70,0,0,1,2
1270010,1270078,68,0,0,1,1
1270078,1270115,37,1,0,0,2
1270079,1270115,36,1,0,0,1
1270116,1271944,1828,0,0,1,2
1270116,1271945,1829,0,0,1,1
1271945,1272000,55,1,0,0,2
1271946,1271998,52,1,0,0,1
1271999,1273951,1952,0,0,1,1
1272001,1273952,1951,0,0,1,2
1273952,1274167,215,1,0,0,1
1273953,1274166,213,1,0,0,2
1273970,1274131,161,0,1,0,2
1273974,1274129,155,0,1,0,1
1274167,1274402,235,0,0,1,2
1274168,1274400,232,0,0,1,1
1274401,1274606,205,1,0,0,1
1274403,1274608,205,1,0,0,2
1274420,1274569,149,0,1,0,2
1274421,1274562,141,0,1,0,1
1274607,1275929,1322,0,0,1,1
1274609,1275929,1320,0,0,1,2
1275930,1275997,67,1,0,0,1
1275930,1275998,68,1,0,0,2
1275998,1276082,84,0,0,1,1
1275999,1276081,82,0,0,1,2
1276082,1276119,37,1,0,0,2
1276083,1276117,34,1,0,0,1
1276118,1277926,1808,0,0,1,1
1276120,1277926,1806,0,0,1,2
1277927,1277979,52,1,0,0,1
1277927,1277997,70,1,0,0,2
1277980,1278242,262,0,0,1,1
1277998,1278241,243,0,0,1,2
1278242,1278276,34,1,0,0,2
1278243,1278263,20,1,0,0,1
1278264,1279988,1724,0,0,1,1
1278277,1279994,1717,0,0,1,2
1279989,1280211,222,1,0,0,1
1279995,1280210,215,1,0,0,2
1280013,1280174,161,0,1,0,2
1280014,1280169,155,0,1,0,1
1280211,1280559,348,0,0,1,2
1280212,1280559,347,0,0,1,1
1280560,1280788,228,1,0,0,2
1280560,1280790,230,1,0,0,1
1280577,1280749,172,0,1,0,2
1280578,1280748,170,0,1,0,1
1280789,1281899,1110,0,0,1,2
1280791,1281901,1110,0,0,1,1
1281900,1281984,84,1,0,0,2
1281902,1281975,73,1,0,0,1
1281976,1282096,120,0,0,1,1
1281985,1282093,108,0,0,1,2
1282094,1282124,30,1,0,0,2
1282097,1282127,30,1,0,0,1
1282125,1283929,1804,0,0,1,2
1282128,1283929,1801,0,0,1,1
1283930,1283987,57,1,0,0,1
1283930,1284002,72,1,0,0,2
1283988,1284112,124,0,0,1,1
1284003,1284110,107,0,0,1,2
1284111,1284145,34,1,0,0,2
1284113,1284142,29,1,0,0,1
1284143,1285947,1804,0,0,1,1
1284146,1285937,1791,0,0,1,2
1285938,1286285,347,1,0,0,2
1285948,1286272,324,1,0,0,1
1285967,1286249,282,0,1,0,2
1285969,1286244,275,0,1,0,1
1286273,1286367,94,0,0,1,1
1286286,1286359,73,0,0,1,2
1286360,1286547,187,1,0,0,2
1286368,1286548,180,1,0,0,1
1286384,1286518,134,0,1,0,2
1286386,1286517,131,0,1,0,1
1286548,1286679,131,0,0,1,2
1286549,1286681,132,0,0,1,1
1286680,1286850,170,1,0,0,2
1286682,1286844,162,1,0,0,1
1286700,1286818,118,0,1,0,2
1286703,1286809,106,0,1,0,1
1286845,1287366,521,0,0,1,1
1286851,1287366,515,0,0,1,2
1287367,1287422,55,1,0,0,1
1287367,1287436,69,1,0,0,2
1287423,1287939,516,0,0,1,1
1287437,1287940,503,0,0,1,2
1287940,1288022,82,1,0,0,1
1287941,1288025,84,1,0,0,2
1288023,1289636,1613,0,0,1,1
1288026,1289635,1609,0,0,1,2
1289636,1289712,76,1,0,0,2
1289637,1289713,76,1,0,0,1
1289713,1289849,136,0,0,1,2
1289714,1289849,135,0,0,1,1
1289850,1289881,31,1,0,0,1
1289850,1289881,31,1,0,0,2
1289882,1291691,1809,0,0,1,2
1289882,1291692,1810,0,0,1,1
1291692,1291892,200,1,0,0,2
1291693,1291893,200,1,0,0,1
1291708,1291855,147,0,1,0,2
1291713,1291856,143,0,1,0,1
1291893,1293415,1522,0,0,1,2
1291894,1293417,1523,0,0,1,1
1293416,1293497,81,1,0,0,2
1293418,1293488,70,1,0,0,1
1293489,1293588,99,0,0,1,1
1293498,1293584,86,0,0,1,2
1293585,1293616,31,1,0,0,2
1293589,1293607,18,1,0,0,1
1293608,1293758,150,0,0,1,1
1293617,1293754,137,0,0,1,2
1293755,1293935,180,1,0,0,2
1293759,1293916,157,1,0,0,1
1293771,1293893,122,0,1,0,2
1293777,1293885,108,0,1,0,1
1293917,1295193,1276,0,0,1,1
1293936,1294199,263,0,0,1,2
1294200,1294217,17,1,0,0,2
1294218,1295193,975,0,0,1,2
1295194,1295242,48,1,0,0,1
1295194,1295261,67,1,0,0,2
1295243,1297193,1950,0,0,1,1
1295262,1297189,1927,0,0,1,2
1297190,1297391,201,1,0,0,2
1297194,1297391,197,1,0,0,1
1297217,1297356,139,0,1,0,2
1297222,1297351,129,0,1,0,1
1297392,1298447,1055,0,0,1,1
1297392,1298447,1055,0,0,1,2
1298448,1298477,29,1,0,0,1
1298448,1298492,44,1,0,0,2
1298478,1298624,146,0,0,1,1
1298493,1298624,131,0,0,1,2
1298625,1298651,26,1,0,0,2
1298625,1298652,27,1,0,0,1
1298652,1298748,96,0,0,1,2
1298653,1298749,96,0,0,1,1
1298749,1298938,189,1,0,0,2
1298750,1298919,169,1,0,0,1
1298766,1298892,126,0,1,0,2
1298770,1298879,109,0,1,0,1
1298920,1300264,1344,0,0,1,1
1298939,1300265,1326,0,0,1,2
1300265,1300341,76,1,0,0,1
1300266,1300402,136,1,0,0,2
1300342,1300365,23,0,0,1,1
1300366,1300403,37,1,0,0,1
1300403,1302433,2030,0,0,1,2
1300404,1302428,2024,0,0,1,1
1302429,1302611,182,1,0,0,1
1302434,1302622,188,1,0,0,2
1302450,1302582,132,0,1,0,2
1302453,1302584,131,0,1,0,1
1302612,1303669,1057,0,0,1,1
1302623,1303668,1045,0,0,1,2
1303669,1303761,92,1,0,0,2
1303670,1303756,86,1,0,0,1
1303757,1303837,80,0,0,1,1
1303762,1303837,75,0,0,1,2
1303838,1303875,37,1,0,0,1
1303838,1303877,39,1,0,0,2
1303876,1303978,102,0,0,1,1
1303878,1303977,99,0,0,1,2
1303978,1304011,33,1,0,0,2
1303979,1304013,34,1,0,0,1
1304012,1304952,940,0,0,1,2
1304014,1304954,940,0,0,1,1
1304953,1305014,61,1,0,0,2
1304955,1305032,77,1,0,0,1
1305015,1307013,1998,0,0,1,2
1305033,1307033,2000,0,0,1,1
1307014,1307222,208,1,0,0,2
1307034,1307208,174,1,0,0,1
1307040,1307179,139,0,1,0,2
1307049,1307178,129,0,1,0,1
1307209,1307309,100,0,0,1,1
1307223,1307300,77,0,0,1,2
1307301,1307490,189,1,0,0,2
1307310,1307479,169,1,0,0,1
1307321,1307457,136,0,1,0,2
1307329,1307445,116,0,1,0,1
1307480,1308371,891,0,0,1,1
1307491,1308372,881,0,0,1,2
1308372,1308417,45,1,0,0,1
1308373,1308407,34,1,0,0,2
1308408,1308734,326,0,0,1,2
1308418,1308733,315,0,0,1,1
1308734,1308926,192,1,0,0,1
1308735,1308927,192,1,0,0,2
1308754,1308893,139,0,1,0,2
1308755,1308892,137,0,1,0,1
1308927,1309118,191,0,0,1,1
1308928,1309118,190,0,0,1,2
1387841,1388034,193,0,0,1,1
1387841,1388035,194,0,0,1,2
1388035,1388099,64,1,0,0,1
1388036,1388111,75,1,0,0,2
1388100,1388233,133,0,0,1,1
1388112,1388234,122,0,0,1,2
1388234,1388251,17,1,0,0,1
1388235,1388255,20,1,0,0,2
1388252,1390014,1762,0,0,1,1
1388256,1390013,1757,0,0,1,2
1390014,1390092,78,1,0,0,2
1390015,1390080,65,1,0,0,1
1390081,1390158,77,0,0,1,1
1390093,1390157,64,0,0,1,2
1390158,1390190,32,1,0,0,2
1390159,1390178,19,1,0,0,1
1390179,1391383,1204,0,0,1,1
1390191,1391386,1195,0,0,1,2
1391384,1391646,262,1,0,0,1
1391387,1391617,230,1,0,0,2
1391400,1391601,201,0,1,0,1
1391404,1391581,177,0,1,0,2
1391618,1391854,236,0,0,1,2
1391647,1391856,209,0,0,1,1
1391855,1391974,119,1,0,0,2
1391857,1391978,121,1,0,0,1
1391975,1392020,45,0,0,1,2
1391979,1392020,41,0,0,1,1
1392021,1392069,48,1,0,0,2
1392021,1392084,63,1,0,0,1
1392070,1392161,91,0,0,1,2
1392085,1392162,77,0,0,1,1
1392162,1392194,32,1,0,0,2
1392163,1392195,32,1,0,0,1
1392195,1393916,1721,0,0,1,2
1392196,1392498,302,0,0,1,1
1392499,1392503,4,1,0,0,1
1392504,1393918,1414,0,0,1,1
1393917,1394025,108,1,0,0,2
1393919,1394006,87,1,0,0,1
1394007,1394070,63,0,0,1,1
1394026,1394069,43,0,0,1,2
1394070,1394102,32,1,0,0,2
1394071,1394104,33,1,0,0,1
1394103,1394279,176,0,0,1,2
1394105,1394278,173,0,0,1,1
1394279,1394298,19,1,0,0,1
1394280,1394298,18,1,0,0,2
1394299,1394699,400,0,0,1,1
1394299,1394699,400,0,0,1,2
1394700,1394719,19,1,0,0,1
1394700,1394734,34,1,0,0,2
1394720,1395739,1019,0,0,1,1
1394735,1395739,1004,0,0,1,2
1395740,1395913,173,1,0,0,2
1395740,1395930,190,1,0,0,1
1395769,1395880,111,0,1,0,2
1395771,1395893,122,0,1,0,1
1395914,1395984,70,0,0,1,2
1395931,1395986,55,0,0,1,1
1395985,1396022,37,1,0,0,2
1395987,1396020,33,1,0,0,1
1396021,1396227,206,0,0,1,1
1396023,1396223,200,0,0,1,2
1396224,1396251,27,1,0,0,2
1396228,1396238,10,1,0,0,1
1396239,1397570,1331,0,0,1,1
1396252,1397570,1318,0,0,1,2
1397571,1397628,57,1,0,0,2
1397571,1397630,59,1,0,0,1
1397629,1397748,119,0,0,1,2
1397631,1397746,115,0,0,1,1
1397747,1397768,21,1,0,0,1
1397749,1397765,16,1,0,0,2
1397766,1399242,1476,0,0,1,2
1397769,1399241,1472,0,0,1,1
1399242,1399322,80,1,0,0,1
1399243,1399323,80,1,0,0,2
1399323,1399374,51,0,0,1,1
1399324,1399384,60,0,0,1,2
1399375,1399596,221,1,0,0,1
1399385,1399572,187,1,0,0,2
1399409,1399542,133,0,1,0,1
1399410,1399527,117,0,1,0,2
1399573,1399649,76,0,0,1,2
1399597,1399651,54,0,0,1,1
1399650,1399682,32,1,0,0,2
1399652,1399671,19,1,0,0,1
1399672,1401224,1552,0,0,1,1
1399683,1401223,1540,0,0,1,2
1401224,1401322,98,1,0,0,2
1401225,1401326,101,1,0,0,1
1401323,1401383,60,0,0,1,2
1401327,1401383,56,0,0,1,1
1401384,1401407,23,1,0,0,1
1401384,1401407,23,1,0,0,2
1401408,1401545,137,0,0,1,2
1401408,1401548,140,0,0,1,1
1401546,1401573,27,1,0,0,2
1401549,1401587,38,1,0,0,1
1401574,1403100,1526,0,0,1,2
1401588,1403102,1514,0,0,1,1
1403101,1403268,167,1,0,0,2
1403103,1403277,174,1,0,0,1
1403127,1403236,109,0,1,0,2
1403129,1403247,118,0,1,0,1
1403269,1403383,114,0,0,1,2
1403278,1403383,105,0,0,1,1
1403384,1403411,27,1,0,0,1
1403384,1403417,33,1,0,0,2
1403412,1404854,1442,0,0,1,1
1403418,1404851,1433,0,0,1,2
1404852,1404922,70,1,0,0,2
1404855,1404913,58,1,0,0,1
1404914,1405112,198,0,0,1,1
1404923,1405118,195,0,0,1,2
1405113,1405138,25,1,0,0,1
1405119,1405138,19,1,0,0,2
1405139,1406271,1132,0,0,1,1
1405139,1406274,1135,0,0,1,2
1406272,1406461,189,1,0,0,1
1406275,1406464,189,1,0,0,2
1406292,1406425,133,0,1,0,2
1406293,1406433,140,0,1,0,1
1406462,1406588,126,0,0,1,1
1406465,1406589,124,0,0,1,2
1406589,1406661,72,1,0,0,1
1406590,1406676,86,1,0,0,2
1406662,1406745,83,0,0,1,1
1406677,1406746,69,0,0,1,2
1406746,1406779,33,1,0,0,1
1406747,1406780,33,1,0,0,2
1406780,1408194,1414,0,0,1,1
1406781,1408193,1412,0,0,1,2
1408194,1408283,89,1,0,0,2
1408195,1408280,85,1,0,0,1
1408281,1408341,60,0,0,1,1
1408284,1408342,58,0,0,1,2
1408342,1408370,28,1,0,0,1
1408343,1408378,35,1,0,0,2
1408371,1408516,145,0,0,1,1
1408379,1408515,136,0,0,1,2
1408516,1408535,19,1,0,0,2
1408517,1408536,19,1,0,0,1
1408536,1409840,1304,0,0,1,2
1408537,1409851,1314,0,0,1,1
1409841,1410022,181,1,0,0,2
1409852,1410017,165,1,0,0,1
1409864,1409988,124,0,1,0,2
1409866,1409992,126,0,1,0,1
1410018,1410103,85,0,0,1,1
1410023,1410103,80,0,0,1,2
1410104,1410138,34,1,0,0,1
1410104,1410138,34,1,0,0,2
1410139,1410617,478,0,0,1,2
1410139,1410619,480,0,0,1,1
1410618,1410650,32,1,0,0,2
1410620,1410636,16,1,0,0,1
1410637,1411613,976,0,0,1,1
1410651,1411612,961,0,0,1,2
1411613,1411702,89,1,0,0,2
1411614,1411692,78,1,0,0,1
1411693,1411756,63,0,0,1,1
1411703,1411757,54,0,0,1,2
1411757,1411793,36,1,0,0,1
1411758,1411792,34,1,0,0,2
1411793,1411975,182,0,0,1,2
1411794,1411975,181,0,0,1,1
1411976,1411988,12,1,0,0,2
1411976,1411990,14,1,0,0,1
1411989,1413317,1328,0,0,1,2
1411991,1413311,1320,0,0,1,1
1413312,1413501,189,1,0,0,1
1413318,1413597,279,1,0,0,2
1413352,1413488,136,0,1,0,2
1413357,1413468,111,0,1,0,1
1413502,1413559,57,0,0,1,1
1413560,1413597,37,1,0,0,1
1413598,1415063,1465,0,0,1,1
1413598,1415063,1465,0,0,1,2
1415064,1415134,70,1,0,0,1
1415064,1415152,88,1,0,0,2
1415135,1415207,72,0,0,1,1
1415153,1415205,52,0,0,1,2
1415206,1415247,41,1,0,0,2
1415208,1415244,36,1,0,0,1
1415245,1415457,212,0,0,1,1
1415248,1416752,1504,0,0,1,2
1415458,1415469,11,1,0,0,1
1415470,1416750,1280,0,0,1,1
1416751,1416979,228,1,0,0,1
1416753,1417023,270,1,0,0,2
1416768,1416947,179,0,1,0,1
1416769,1416959,190,0,1,0,2
1416980,1417000,20,0,0,1,1
1417001,1417023,22,1,0,0,1
1417024,1417206,182,0,0,1,2
1417024,1417212,188,0,0,1,1
1417207,1417225,18,1,0,0,2
1417213,1417223,10,1,0,0,1
1417224,1418532,1308,0,0,1,1
1417226,1418535,1309,0,0,1,2
1418533,1418619,86,1,0,0,1
1418536,1418633,97,1,0,0,2
1418620,1418757,137,0,0,1,1
1418634,1418756,122,0,0,1,2
1418757,1418789,32,1,0,0,2
1418758,1418778,20,1,0,0,1
1418779,1420199,1420,0,0,1,1
1418790,1420194,1404,0,0,1,2
1420195,1420253,58,1,0,0,2
1420200,1420268,68,1,0,0,1
1420254,1420334,80,0,0,1,2
1420269,1420335,66,0,0,1,1
1420335,1420368,33,1,0,0,2
1420336,1420359,23,1,0,0,1
1420360,1421494,1134,0,0,1,1
1420369,1421491,1122,0,0,1,2
1421492,1421771,279,1,0,0,2
1421495,1421769,274,1,0,0,1
1421510,1421725,215,0,1,0,2
1421513,1421736,223,0,1,0,1
1421770,1421894,124,0,0,1,1
1421772,1421892,120,0,0,1,2
1421893,1421939,46,1,0,0,2
1421895,1421944,49,1,0,0,1
1421940,1422028,88,0,0,1,2
1421945,1422027,82,0,0,1,1
1422028,1422048,20,1,0,0,1
1422029,1422056,27,1,0,0,2
1422049,1422202,153,0,0,1,1
1422057,1422195,138,0,0,1,2
1422196,1422210,14,1,0,0,2
1422203,1422212,9,1,0,0,1
1422211,1423635,1424,0,0,1,2
1422213,1423634,1421,0,0,1,1
1423635,1423703,68,1,0,0,1
1423636,1423729,93,1,0,0,2
1423704,1423790,86,0,0,1,1
1423730,1423790,60,0,0,1,2
1423791,1423849,58,1,0,0,2
1423791,1423850,59,1,0,0,1
1423850,1423921,71,0,0,1,2
1423851,1423922,71,0,0,1,1
1423922,1423955,33,1,0,0,2
1423923,1423956,33,1,0,0,1
1423956,1425267,1311,0,0,1,2
1423957,1425273,1316,0,0,1,1
1425268,1425496,228,1,0,0,2
1425274,1425463,189,1,0,0,1
1425296,1425439,143,0,1,0,1
1425298,1425435,137,0,1,0,2
1425464,1425578,114,0,0,1,1
1425497,1425579,82,0,0,1,2
1425579,1425670,91,1,0,0,1
1425580,1425675,95,1,0,0,2
1425671,1425748,77,0,0,1,1
1425676,1425745,69,0,0,1,2
1425746,1425782,36,1,0,0,2
1425749,1425784,35,1,0,0,1
1425783,1426020,237,0,0,1,2
1425785,1426021,236,0,0,1,1
1426021,1426044,23,1,0,0,2
1426022,1426053,31,1,0,0,1
1426045,1427446,1401,0,0,1,2
1426054,1427446,1392,0,0,1,1
1427447,1427547,100,1,0,0,1
1427447,1427562,115,1,0,0,2
1427548,1427611,63,0,0,1,1
1427563,1427611,48,0,0,1,2
1427612,1427660,48,1,0,0,1
1427612,1427662,50,1,0,0,2
1427661,1427773,112,0,0,1,1
1427663,1427773,110,0,0,1,2
1427774,1427805,31,1,0,0,1
1427774,1427805,31,1,0,0,2
1427806,1429296,1490,0,0,1,2
1427806,1429297,1491,0,0,1,1
1429297,1429404,107,1,0,0,2
1429298,1429400,102,1,0,0,1
1429401,1429475,74,0,0,1,1
1429405,1429473,68,0,0,1,2
1429474,1429512,38,1,0,0,2
1429476,1429512,36,1,0,0,1
1429513,1429685,172,0,0,1,2
1429513,1430607,1094,0,0,1,1
1429686,1429707,21,1,0,0,2
1429708,1430603,895,0,0,1,2
1430604,1430842,238,1,0,0,2
1430608,1430840,232,1,0,0,1
1430623,1430813,190,0,1,0,2
1430626,1430821,195,0,1,0,1
1430841,1430992,151,0,0,1,1
1430843,1430991,148,0,0,1,2
1430992,1431085,93,1,0,0,2
1430993,1431077,84,1,0,0,1
1431078,1431143,65,0,0,1,1
1431086,1431142,56,0,0,1,2
1431143,1431194,51,1,0,0,2
1431144,1431183,39,1,0,0,1
1431184,1432743,1559,0,0,1,1
1431195,1432745,1550,0,0,1,2
1432744,1432842,98,1,0,0,1
1432746,1432845,99,1,0,0,2
1432843,1432928,85,0,0,1,1
1432846,1432929,83,0,0,1,2
1432929,1432967,38,1,0,0,1
1432930,1432968,38,1,0,0,2
1432968,1434432,1464,0,0,1,1
1432969,1434432,1463,0,0,1,2
1434433,1434616,183,1,0,0,1
1434433,1434621,188,1,0,0,2
1434480,1434587,107,0,1,0,2
1434485,1434585,100,0,1,0,1
1434617,1434716,99,0,0,1,1
1434622,1434714,92,0,0,1,2
1434715,1434749,34,1,0,0,2
1434717,1434739,22,1,0,0,1
1434740,1436172,1432,0,0,1,1
1434750,1436173,1423,0,0,1,2
1436173,1436275,102,1,0,0,1
1436174,1436291,117,1,0,0,2
1436276,1436353,77,0,0,1,1
1436292,1436349,57,0,0,1,2
1436350,1436396,46,1,0,0,2
1436354,1436413,59,1,0,0,1
1436397,1436465,68,0,0,1,2
1436414,1436465,51,0,0,1,1
1436466,1436501,35,1,0,0,2
1436466,1436503,37,1,0,0,1
1436502,1437871,1369,0,0,1,2
1436504,1437255,751,0,0,1,1
1437256,1437279,23,1,0,0,1
1437280,1437873,593,0,0,1,1
1437872,1437961,89,1,0,0,2
1437874,1437965,91,1,0,0,1
1437962,1438021,59,0,0,1,2
1437966,1438023,57,0,0,1,1
1438022,1438058,36,1,0,0,2
1438024,1438058,34,1,0,0,1
1438059,1438154,95,0,0,1,1
1438059,1438156,97,0,0,1,2
1438155,1438185,30,1,0,0,1
1438157,1438186,29,1,0,0,2
1438186,1439076,890,0,0,1,1
1438187,1439063,876,0,0,1,2
1439064,1439371,307,1,0,0,2
1439077,1439362,285,1,0,0,1
1439106,1439335,229,0,1,0,2
1439107,1439339,232,0,1,0,1
1439363,1439468,105,0,0,1,1
1439372,1439470,98,0,0,1,2
1439469,1439653,184,1,0,0,1
1439471,1439639,168,1,0,0,2
1439489,1439608,119,0,1,0,2
1439493,1439620,127,0,1,0,1
1439640,1439715,75,0,0,1,2
1439654,1439715,61,0,0,1,1
1439716,1439751,35,1,0,0,1
1439716,1439752,36,1,0,0,2
1439752,1440857,1105,0,0,1,1
1439753,1440853,1100,0,0,1,2
1440854,1440920,66,1,0,0,2
1440858,1440912,54,1,0,0,1
1440913,1441231,318,0,0,1,1
1440921,1441228,307,0,0,1,2
1441229,1441310,81,1,0,0,2
1441232,1441312,80,1,0,0,1
1441311,1441360,49,0,0,1,2
1441313,1441360,47,0,0,1,1
1441361,1441423,62,1,0,0,1
1441361,1441440,79,1,0,0,2
1441424,1441516,92,0,0,1,1
1441441,1441515,74,0,0,1,2
1441516,1441551,35,1,0,0,2
1441517,1441549,32,1,0,0,1
1441550,1442973,1423,0,0,1,1
1441552,1442971,1419,0,0,1,2
1442972,1443052,80,1,0,0,2
1442974,1443050,76,1,0,0,1
1443051,1443119,68,0,0,1,1
1443053,1443117,64,0,0,1,2
1443118,1443165,47,1,0,0,2
1443120,1443159,39,1,0,0,1
1443160,1443413,253,0,0,1,1
1443166,1443402,236,0,0,1,2
1443403,1443433,30,1,0,0,2
1443414,1443430,16,1,0,0,1
1443431,1444564,1133,0,0,1,1
1443434,1444537,1103,0,0,1,2
1444538,1444739,201,1,0,0,2
1444565,1444723,158,1,0,0,1
1444575,1444702,127,0,1,0,2
1444579,1444703,124,0,1,0,1
1444724,1444812,88,0,0,1,1
1444740,1444810,70,0,0,1,2
1444811,1444907,96,1,0,0,2
1444813,1444906,93,1,0,0,1
1444907,1444999,92,0,0,1,1
1444908,1444999,91,0,0,1,2
1445000,1445035,35,1,0,0,1
1445000,1445037,37,1,0,0,2
1445036,1446452,1416,0,0,1,1
1445038,1446453,1415,0,0,1,2
1446453,1446560,107,1,0,0,1
1446454,1446567,113,1,0,0,2
1446561,1446629,68,0,0,1,1
1446568,1446629,61,0,0,1,2
1446630,1446682,52,1,0,0,2
1446630,1446686,56,1,0,0,1
1446683,1446993,310,0,0,1,2
1446687,1448118,1431,0,0,1,1
1446994,1446998,4,1,0,0,2
1446999,1448106,1107,0,0,1,2
1448107,1448403,296,1,0,0,2
1448119,1448313,194,1,0,0,1
1448138,1448285,147,0,1,0,1
1448139,1448301,162,0,1,0,2
1448314,1448359,45,0,0,1,1
1448360,1448397,37,1,0,0,1
1448398,1448493,95,0,0,1,1
1448404,1448492,88,0,0,1,2
1448493,1448528,35,1,0,0,2
1448494,1448526,32,1,0,0,1
1448527,1449938,1411,0,0,1,1
1448529,1449939,1410,0,0,1,2
1449939,1450026,87,1,0,0,1
1449940,1450025,85,1,0,0,2
1450026,1450098,72,0,0,1,2
1450027,1450099,72,0,0,1,1
1450099,1450137,38,1,0,0,2
1450100,1450142,42,1,0,0,1
1450138,1450200,62,0,0,1,2
1450143,1450203,60,0,0,1,1
1450201,1450239,38,1,0,0,2
1450204,1450240,36,1,0,0,1
1450240,1451811,1571,0,0,1,2
1450241,1451799,1558,0,0,1,1
1451800,1451982,182,1,0,0,1
1451812,1451971,159,1,0,0,2
1451832,1451922,90,0,1,0,1
1451834,1451932,98,0,1,0,2
1451972,1452001,29,0,0,1,2
1451983,1452003,20,0,0,1,1
1452002,1452042,40,1,0,0,2
1452004,1452043,39,1,0,0,1
1452043,1452128,85,0,0,1,2
1452044,1452131,87,0,0,1,1
1452129,1452162,33,1,0,0,2
1452132,1452169,37,1,0,0,1
1452163,1453610,1447,0,0,1,2
1452170,1453609,1439,0,0,1,1
1453610,1453718,108,1,0,0,1
1453611,1453722,111,1,0,0,2
1453719,1453779,60,0,0,1,1
1453723,1453779,56,0,0,1,2
1453780,1453818,38,1,0,0,1
1453780,1453820,40,1,0,0,2
1453819,1453953,134,0,0,1,1
1453821,1453949,128,0,0,1,2
1453950,1453969,19,1,0,0,2
1453954,1453966,12,1,0,0,1
1453967,1455244,1277,0,0,1,1
1453970,1455249,1279,0,0,1,2
1455245,1455609,364,1,0,0,1
1455250,1455472,222,1,0,0,2
1455261,1455467,206,0,1,0,1
1455266,1455438,172,0,1,0,2
1455473,1455508,35,0,0,1,2
1455509,1455545,36,1,0,0,2
1455546,1455741,195,0,0,1,2
1455610,1455747,137,0,0,1,1
1455742,1455768,26,1,0,0,2
1455748,1455778,30,1,0,0,1
1455769,1457060,1291,0,0,1,2
1455779,1457061,1282,0,0,1,1
1457061,1457169,108,1,0,0,2
1457062,1457171,109,1,0,0,1
1457170,1457229,59,0,0,1,2
1457172,1457231,59,0,0,1,1
1457230,1457277,47,1,0,0,2
1457232,1457281,49,1,0,0,1
1457278,1457368,90,0,0,1,2
1457282,1457369,87,0,0,1,1
1457369,1457398,29,1,0,0,2
1457370,1457390,20,1,0,0,1
1457391,1458938,1547,0,0,1,1
1457399,1458937,1538,0,0,1,2
1458938,1459022,84,1,0,0,2
1458939,1459027,88,1,0,0,1
1459023,1459159,136,0,0,1,2
1459028,1459160,132,0,0,1,1
1459160,1459191,31,1,0,0,2
1459161,1459192,31,1,0,0,1
1459192,1460319,1127,0,0,1,2
1459193,1460313,1120,0,0,1,1
1460314,1460523,209,1,0,0,1
1460320,1460527,207,1,0,0,2
1460335,1460499,164,0,1,0,2
1460340,1460501,161,0,1,0,1
1460524,1460687,163,0,0,1,1
1460528,1460685,157,0,0,1,2
1460686,1460770,84,1,0,0,2
1460688,1460772,84,1,0,0,1
1460771,1460853,82,0,0,1,2
1460773,1460853,80,0,0,1,1
1460854,1460887,33,1,0,0,1
1460854,1460888,34,1,0,0,2
1460888,1462544,1656,0,0,1,1
1460889,1462545,1656,0,0,1,2
1462545,1462682,137,1,0,0,1
1462546,1462661,115,1,0,0,2
1462662,1462719,57,0,0,1,2
1462683,1462720,37,0,0,1,1
1462720,1462783,63,1,0,0,2
1462721,1462783,62,1,0,0,1
1462784,1464345,1561,0,0,1,2
1462784,1464346,1562,0,0,1,1
1464346,1464426,80,1,0,0,2
1464347,1464431,84,1,0,0,1
1464427,1464458,31,0,0,1,2
1464432,1464459,27,0,0,1,1
1464459,1464522,63,1,0,0,2
1464460,1464527,67,1,0,0,1
1464523,1464596,73,0,0,1,2
1464528,1464599,71,0,0,1,1
1464597,1464631,34,1,0,0,2
1464600,1464621,21,1,0,0,1
1464622,1466120,1498,0,0,1,1
1464632,1466123,1491,0,0,1,2
1466121,1466330,209,1,0,0,1
1466124,1466333,209,1,0,0,2
1466157,1466301,144,0,1,0,2
1466159,1466292,133,0,1,0,1
1466331,1466412,81,0,0,1,1
1466334,1466410,76,0,0,1,2
1466411,1466443,32,1,0,0,2
1466413,1466448,35,1,0,0,1
1466444,1466522,78,0,0,1,2
1466449,1466520,71,0,0,1,1
1466521,1466581,60,1,0,0,1
1466523,1466543,20,1,0,0,2
1466544,1467952,1408,0,0,1,2
1466582,1467950,1368,0,0,1,1
1467951,1468051,100,1,0,0,1
1467953,1468054,101,1,0,0,2
1468052,1468110,58,0,0,1,1
1468055,1468113,58,0,0,1,2
1468111,1468153,42,1,0,0,1
1468114,1468154,40,1,0,0,2
1468154,1469694,1540,0,0,1,1
1468155,1469694,1539,0,0,1,2
1469695,1469889,194,1,0,0,1
1469695,1469892,197,1,0,0,2
1469742,1469852,110,0,1,0,1
1469743,1469852,109,0,1,0,2
1469890,1469958,68,0,0,1,1
1469893,1469925,32,0,0,1,2
1469926,1469930,4,1,0,0,2
1469931,1469956,25,0,0,1,2
1469957,1470000,43,1,0,0,2
1469959,1470002,43,1,0,0,1
1470001,1470126,125,0,0,1,2
1470003,1470127,124,0,0,1,1
1470127,1470162,35,1,0,0,2
1470128,1470159,31,1,0,0,1
1470160,1471536,1376,0,0,1,1
1470163,1471535,1372,0,0,1,2
1471536,1471648,112,1,0,0,2
1471537,1471645,108,1,0,0,1
1471646,1473148,1502,0,0,1,1
1471649,1473153,1504,0,0,1,2
1473149,1473434,285,1,0,0,1
1473154,1473435,281,1,0,0,2
1473167,1473362,195,0,1,0,1
1473171,1473368,197,0,1,0,2
1473435,1473663,228,0,0,1,1
1473436,1473662,226,0,0,1,2
1473663,1473692,29,1,0,0,2
1473664,1473692,28,1,0,0,1
1473693,1474944,1251,0,0,1,2
1473693,1474946,1253,0,0,1,1
1474945,1475038,93,1,0,0,2
1474947,1475037,90,1,0,0,1
1475038,1475177,139,0,0,1,1
1475039,1475174,135,0,0,1,2
1475175,1475264,89,1,0,0,2
1475178,1475264,86,1,0,0,1
1475265,1475336,71,0,0,1,1
1475265,1475337,72,0,0,1,2
1475337,1475983,646,1,0,0,1
1475338,1475787,449,1,0,0,2
1475405,1475776,371,0,1,0,2
1475411,1475774,363,0,1,0,1
1475788,1475810,22,0,0,1,2
1475811,1476183,372,1,0,0,2
1475831,1475955,124,0,1,0,2
1475836,1475953,117,0,1,0,1
1475984,1476005,21,0,0,1,1
1476006,1476178,172,1,0,0,1
1476025,1476147,122,0,1,0,2
1476029,1476147,118,0,1,0,1
1476179,1476312,133,0,0,1,1
1476184,1476306,122,0,0,1,2
1476307,1476478,171,1,0,0,2
1476313,1476484,171,1,0,0,1
1476329,1476445,116,0,1,0,2
1476333,1476447,114,0,1,0,1
1476479,1476710,231,0,0,1,2
1476485,1476711,226,0,0,1,1
1476711,1476782,71,1,0,0,2
1476712,1476781,69,1,0,0,1
1476782,1476873,91,0,0,1,1
1476783,1476871,88,0,0,1,2
1476872,1476908,36,1,0,0,2
1476874,1476907,33,1,0,0,1
1476908,1477098,190,0,0,1,1
1476909,1477097,188,0,0,1,2
1477098,1477250,152,1,0,0,2
1477099,1477262,163,1,0,0,1
1477121,1477222,101,0,1,0,2
1477128,1477216,88,0,1,0,1
1477251,1477483,232,0,0,1,2
1477263,1477482,219,0,0,1,1
1477483,1477502,19,1,0,0,1
1477484,1477515,31,1,0,0,2
1477503,1479480,1977,0,0,1,1
1477516,1479479,1963,0,0,1,2
1479480,1479540,60,1,0,0,2
1479481,1479535,54,1,0,0,1
1479536,1479639,103,0,0,1,1
1479541,1479636,95,0,0,1,2
1479637,1479670,33,1,0,0,2
1479640,1479667,27,1,0,0,1
1479668,1481528,1860,0,0,1,1
1479671,1481517,1846,0,0,1,2
1481518,1481739,221,1,0,0,2
1481529,1481703,174,1,0,0,1
1481552,1481674,122,0,1,0,2
1481557,1481674,117,0,1,0,1
1481704,1482027,323,0,0,1,1
1481740,1482027,287,0,0,1,2
1482028,1482082,54,1,0,0,2
1482028,1482086,58,1,0,0,1
1482083,1482796,713,0,0,1,2
1482087,1482793,706,0,0,1,1
1482794,1482964,170,1,0,0,1
1482797,1482967,170,1,0,0,2
1482817,1482936,119,0,1,0,2
1482820,1482940,120,0,1,0,1
1482965,1483509,544,0,0,1,1
1482968,1483507,539,0,0,1,2
1483508,1483566,58,1,0,0,2
1483510,1483584,74,1,0,0,1
1483567,1483734,167,0,0,1,2
1483585,1483735,150,0,0,1,1
1483735,1483768,33,1,0,0,2
1483736,1483756,20,1,0,0,1
1483757,1484794,1037,0,0,1,1
1483769,1484794,1025,0,0,1,2
1484795,1484850,55,1,0,0,1
1484795,1484867,72,1,0,0,2
1484851,1484945,94,0,0,1,1
1484868,1484946,78,0,0,1,2
1484946,1484977,31,1,0,0,1
1484947,1484982,35,1,0,0,2
1484978,1486811,1833,0,0,1,1
1484983,1486811,1828,0,0,1,2
1486812,1487031,219,1,0,0,2
1486812,1487040,228,1,0,0,1
1486835,1487001,166,0,1,0,1
1486835,1487001,166,0,1,0,2
1487032,1487403,371,0,0,1,2
1487041,1487402,361,0,0,1,1
1487403,1487432,29,1,0,0,1
1487404,1487450,46,1,0,0,2
1487433,1488153,720,0,0,1,1
1487451,1488152,701,0,0,1,2
1488153,1488243,90,1,0,0,2
1488154,1488240,86,1,0,0,1
1488241,1488314,73,0,0,1,1
1488244,1488313,69,0,0,1,2
1488314,1488346,32,1,0,0,2
1488315,1488336,21,1,0,0,1
1488337,1489827,1490,0,0,1,1
1488347,1489828,1481,0,0,1,2
1489828,1489888,60,1,0,0,1
1489829,1489906,77,1,0,0,2
1489889,1491858,1969,0,0,1,1
1489907,1491858,1951,0,0,1,2
1491859,1492059,200,1,0,0,2
1491859,1492061,202,1,0,0,1
1491882,1492017,135,0,1,0,2
1491883,1492017,134,0,1,0,1
1492060,1492673,613,0,0,1,2
1492062,1492675,613,0,0,1,1
1492674,1492713,39,1,0,0,2
1492676,1492703,27,1,0,0,1
1492704,1493467,763,0,0,1,1
1492714,1493466,752,0,0,1,2
1493467,1493544,77,1,0,0,2
1493468,1493528,60,1,0,0,1
1493529,1493650,121,0,0,1,1
1493545,1493658,113,0,0,1,2
1493651,1493673,22,1,0,0,1
1493659,1493680,21,1,0,0,2
1493674,1495043,1369,0,0,1,1
1493681,1495042,1361,0,0,1,2
1495043,1495114,71,1,0,0,2
1495044,1495099,55,1,0,0,1
1495100,1497079,1979,0,0,1,1
1495115,1497073,1958,0,0,1,2
1497074,1497325,251,1,0,0,2
1497080,1497318,238,1,0,0,1
1497097,1497284,187,0,1,0,2
1497100,1497293,193,0,1,0,1
1497319,1498007,688,0,0,1,1
1497326,1498006,680,0,0,1,2
1498007,1498061,54,1,0,0,2
1498008,1498062,54,1,0,0,1
1498062,1498809,747,0,0,1,2
1498063,1498808,745,0,0,1,1
1498809,1498873,64,1,0,0,1
1498810,1498878,68,1,0,0,2
1498874,1498956,82,0,0,1,1
1498879,1498954,75,0,0,1,2
1498955,1498996,41,1,0,0,2
1498957,1498997,40,1,0,0,1
1498997,1499592,595,0,0,1,2
1498998,1499586,588,0,0,1,1
1499587,1499824,237,1,0,0,1
1499593,1499777,184,1,0,0,2
1499609,1499756,147,0,1,0,1
1499611,1499755,144,0,1,0,2
1499778,1499959,181,0,0,1,2
1499825,1499964,139,0,0,1,1
1499960,1499976,16,1,0,0,2
1499965,1499979,14,1,0,0,1
1499977,1501689,1712,0,0,1,2
1499980,1501690,1710,0,0,1,1
1501690,1501765,75,1,0,0,2
1501691,1501762,71,1,0,0,1
1501763,1501872,109,0,0,1,1
1501766,1501874,108,0,0,1,2
1501873,1501895,22,1,0,0,1
1501875,1501908,33,1,0,0,2
1501896,1503693,1797,0,0,1,1
1501909,1503700,1791,0,0,1,2
1503694,1503976,282,1,0,0,1
1503701,1503968,267,1,0,0,2
1503722,1503927,205,0,1,0,2
1503724,1503940,216,0,1,0,1
1503969,1505370,1401,0,0,1,2
1503977,1505371,1394,0,0,1,1
1505371,1505464,93,1,0,0,2
1505372,1505465,93,1,0,0,1
1505465,1505563,98,0,0,1,2
1505466,1505564,98,0,0,1,1
1505564,1505587,23,1,0,0,2
1505565,1505596,31,1,0,0,1
1505588,1507262,1674,0,0,1,2
1505597,1507262,1665,0,0,1,1
1507263,1507319,56,1,0,0,1
1507263,1507332,69,1,0,0,2
1507320,1509314,1994,0,0,1,1
1507333,1509310,1977,0,0,1,2
1509311,1509750,439,1,0,0,2
1509315,1509746,431,1,0,0,1
1509330,1509739,409,0,1,0,2
1509339,1509735,396,0,1,0,1
1509747,1509876,129,0,0,1,1
1509751,1509876,125,0,0,1,2
1509877,1510064,187,1,0,0,1
1509877,1510079,202,1,0,0,2
1509896,1510029,133,0,1,0,2
1509898,1510039,141,0,1,0,1
1510065,1510442,377,0,0,1,1
1510080,1510442,362,0,0,1,2
1510443,1510493,50,1,0,0,2
1510443,1510495,52,1,0,0,1
1510494,1511319,825,0,0,1,2
1510496,1511319,823,0,0,1,1
1511320,1511400,80,1,0,0,1
1511320,1511407,87,1,0,0,2
1511401,1511477,76,0,0,1,1
1511408,1511476,68,0,0,1,2
1511477,1511510,33,1,0,0,2
1511478,1511509,31,1,0,0,1
1511510,1513038,1528,0,0,1,1
1511511,1513038,1527,0,0,1,2
1513039,1513099,60,1,0,0,1
1513039,1513117,78,1,0,0,2
1513100,1515082,1982,0,0,1,1
1513118,1515090,1972,0,0,1,2
1515083,1515273,190,1,0,0,1
1515091,1515288,197,1,0,0,2
1515114,1515244,130,0,1,0,2
1515119,1515245,126,0,1,0,1
1515274,1515354,80,0,0,1,1
1515289,1515357,68,0,0,1,2
1515355,1515538,183,1,0,0,1
1515358,1515543,185,1,0,0,2
1515377,1515506,129,0,1,0,2
1515378,1515514,136,0,1,0,1
1515539,1515899,360,0,0,1,1
1515544,1515899,355,0,0,1,2
1515900,1515976,76,1,0,0,1
1515900,1515979,79,1,0,0,2
1515977,1516962,985,0,0,1,1
1515980,1516963,983,0,0,1,2
1516963,1517043,80,1,0,0,1
1516964,1517041,77,1,0,0,2
1517042,1517116,74,0,0,1,2
1517044,1517115,71,0,0,1,1
1517116,1517153,37,1,0,0,1
1517117,1517152,35,1,0,0,2
1517153,1518841,1688,0,0,1,2
1517154,1518840,1686,0,0,1,1
1518841,1518903,62,1,0,0,1
1518842,1518921,79,1,0,0,2
1518904,1520910,2006,0,0,1,1
1518922,1520895,1973,0,0,1,2
1520896,1521100,204,1,0,0,2
1520911,1521102,191,1,0,0,1
1520927,1521066,139,0,1,0,2
1520928,1521070,142,0,1,0,1
1521101,1521394,293,0,0,1,2
1521103,1521394,291,0,0,1,1
1521395,1521578,183,1,0,0,1
1521395,1521600,205,1,0,0,2
1521415,1521543,128,0,1,0,2
1521415,1521549,134,0,1,0,1
1521579,1522762,1183,0,0,1,1
1521601,1522763,1162,0,0,1,2
1522763,1522856,93,1,0,0,1
1522764,1522843,79,1,0,0,2
1522844,1524509,1665,0,0,1,2
1522857,1524509,1652,0,0,1,1
1524510,1524592,82,1,0,0,2
1524510,1524593,83,1,0,0,1
1524593,1526527,1934,0,0,1,2
1524594,1526530,1936,0,0,1,1
1526528,1526754,226,1,0,0,2
1526531,1526757,226,1,0,0,1
1526554,1526720,166,0,1,0,2
1526555,1526729,174,0,1,0,1
1526755,1526923,168,0,0,1,2
1526758,1526923,165,0,0,1,1
1526924,1527111,187,1,0,0,1
1526924,1527113,189,1,0,0,2
1526942,1527079,137,0,1,0,2
1526944,1527084,140,0,1,0,1
1527112,1528392,1280,0,0,1,1
1527114,1528391,1277,0,0,1,2
1528392,1528437,45,1,0,0,2
1528393,1528436,43,1,0,0,1
1528437,1529745,1308,0,0,1,1
1528438,1529746,1308,0,0,1,2
1529746,1529818,72,1,0,0,1
1529747,1529824,77,1,0,0,2
1529819,1531789,1970,0,0,1,1
1529825,1531787,1962,0,0,1,2
1531788,1531972,184,1,0,0,2
1531790,1531970,180,1,0,0,1
1531808,1531937,129,0,1,0,2
1531808,1531942,134,0,1,0,1
1531971,1532143,172,0,0,1,1
1531973,1532141,168,0,0,1,2
1532142,1532362,220,1,0,0,2
1532144,1532358,214,1,0,0,1
1532162,1532324,162,0,1,0,2
1532164,1532328,164,0,1,0,1
1532359,1533252,893,0,0,1,1
1532363,1533252,889,0,0,1,2
1533253,1533294,41,1,0,0,2
1533253,1533299,46,1,0,0,1
1533295,1533518,223,0,0,1,2
1533300,1533517,217,0,0,1,1
1533518,1533539,21,1,0,0,1
1533519,1533529,10,1,0,0,2
1533530,1534779,1249,0,0,1,2
1533540,1534777,1237,0,0,1,1
1534778,1534825,47,1,0,0,1
1534780,1534843,63,1,0,0,2
1534826,1534968,142,0,0,1,1
1534844,1534967,123,0,0,1,2
1534968,1534999,31,1,0,0,2
1534969,1534992,23,1,0,0,1
1534993,1536823,1830,0,0,1,1
1535000,1536822,1822,0,0,1,2
1536823,1537060,237,1,0,0,2
1536824,1537066,242,1,0,0,1
1536856,1537027,171,0,1,0,2
1536857,1537037,180,0,1,0,1
1537061,1537252,191,0,0,1,2
1537067,1537256,189,0,0,1,1
1537253,1537446,193,1,0,0,2
1537257,1537447,190,1,0,0,1
1537274,1537412,138,0,1,0,2
1537275,1537419,144,0,1,0,1
1537447,1538581,1134,0,0,1,2
1537448,1538580,1132,0,0,1,1
1538581,1538657,76,1,0,0,1
1538582,1538660,78,1,0,0,2
1538658,1538804,146,0,0,1,1
1538661,1538802,141,0,0,1,2
1538803,1538833,30,1,0,0,2
1538805,1538832,27,1,0,0,1
1538833,1540167,1334,0,0,1,1
1538834,1540165,1331,0,0,1,2
1540166,1540215,49,1,0,0,2
1540168,1540218,50,1,0,0,1
1540216,1540436,220,0,0,1,2
1540219,1540438,219,0,0,1,1
1540437,1540481,44,1,0,0,2
1540439,1540470,31,1,0,0,1
1540471,1542209,1738,0,0,1,1
1540482,1542208,1726,0,0,1,2
1542209,1542507,298,1,0,0,2
1542210,1542517,307,1,0,0,1
1542226,1542490,264,0,1,0,1
1542227,1542476,249,0,1,0,2
1542508,1542596,88,0,0,1,2
1542518,1542597,79,0,0,1,1
1542597,1542810,213,1,0,0,2
1542598,1542820,222,1,0,0,1
1542614,1542777,163,0,1,0,2
1542616,1542789,173,0,1,0,1
1542811,1543234,423,0,0,1,2
1542821,1543234,413,0,0,1,1
1543235,1543265,30,1,0,0,2
1543235,1543281,46,1,0,0,1
1543266,1543845,579,0,0,1,2
1543282,1543844,562,0,0,1,1
1543845,1543903,58,1,0,0,1
1543846,1543918,72,1,0,0,2
1543904,1544130,226,0,0,1,1
1543919,1544130,211,0,0,1,2
1544131,1544143,12,1,0,0,2
1544131,1544156,25,1,0,0,1
1544144,1545004,860,0,0,1,2
1544157,1545004,847,0,0,1,1
1545005,1545083,78,1,0,0,1
1545005,1545083,78,1,0,0,2
1545084,1545177,93,0,0,1,1
1545084,1545177,93,0,0,1,2
1545178,1545210,32,1,0,0,1
1545178,1545211,33,1,0,0,2
1545211,1547199,1988,0,0,1,1
1545212,1547197,1985,0,0,1,2
1547198,1547423,225,1,0,0,2
1547200,1547421,221,1,0,0,1
1547216,1547384,168,0,1,0,2
1547217,1547390,173,0,1,0,1
1547422,1547642,220,0,0,1,1
1547424,1547641,217,0,0,1,2
1547642,1547821,179,1,0,0,2
1547643,1547821,178,1,0,0,1
1547663,1547784,121,0,1,0,2
1547664,1547791,127,0,1,0,1
1547822,1548308,486,0,0,1,1
1547822,1548308,486,0,0,1,2
1548309,1548357,48,1,0,0,1
1548309,1548366,57,1,0,0,2
1548358,1548621,263,0,0,1,1
1548367,1548625,258,0,0,1,2
1548622,1548647,25,1,0,0,1
1548626,1548644,18,1,0,0,2
1548645,1549349,704,0,0,1,2
1548648,1549349,701,0,0,1,1
1549350,1549411,61,1,0,0,2
1549350,1549426,76,1,0,0,1
1549412,1551418,2006,0,0,1,2
1549427,1551412,1985,0,0,1,1
1551413,1551622,209,1,0,0,1
1551419,1551607,188,1,0,0,2
1551434,1551582,148,0,1,0,1
1551436,1551578,142,0,1,0,2
1551608,1551838,230,0,0,1,2
1551623,1551840,217,0,0,1,1
1551839,1551911,72,1,0,0,2
1551841,1551902,61,1,0,0,1
1551903,1552610,707,0,0,1,1
1551912,1552610,698,0,0,1,2
1552611,1552690,79,1,0,0,1
1552611,1552691,80,1,0,0,2
1552691,1552779,88,0,0,1,1
1552692,1552777,85,0,0,1,2
1552778,1552806,28,1,0,0,2
1552780,1552814,34,1,0,0,1
1552807,1553697,890,0,0,1,2
1552815,1553698,883,0,0,1,1
1553698,1553733,35,1,0,0,2
1553699,1553733,34,1,0,0,1
1553734,1553844,110,0,0,1,2
1553734,1553846,112,0,0,1,1
1553845,1553923,78,1,0,0,2
1553847,1553923,76,1,0,0,1
1553924,1554111,187,0,0,1,1
1553924,1554111,187,0,0,1,2
1554112,1554135,23,1,0,0,2
1554112,1554145,33,1,0,0,1
1554136,1555870,1734,0,0,1,2
1554146,1555867,1721,0,0,1,1
1555868,1556176,308,1,0,0,1
1555871,1556179,308,1,0,0,2
1555899,1556141,242,0,1,0,2
1555901,1556148,247,0,1,0,1
1556177,1556278,101,0,0,1,1
1556180,1556278,98,0,0,1,2
1556279,1556451,172,1,0,0,1
1556279,1556453,174,1,0,0,2
1556298,1556421,123,0,1,0,2
1556300,1556424,124,0,1,0,1
1556452,1557196,744,0,0,1,1
1556454,1557198,744,0,0,1,2
1557197,1557264,67,1,0,0,1
1557199,1557271,72,1,0,0,2
1557265,1557361,96,0,0,1,1
1557272,1557361,89,0,0,1,2
1557362,1557394,32,1,0,0,2
1557362,1557399,37,1,0,0,1
1557395,1557547,152,0,0,1,2
1557400,1557551,151,0,0,1,1
1557548,1557564,16,1,0,0,2
1557552,1557571,19,1,0,0,1
1557565,1558575,1010,0,0,1,2
1557572,1558573,1001,0,0,1,1
1558574,1558650,76,1,0,0,1
1558576,1558651,75,1,0,0,2
1558651,1560588,1937,0,0,1,1
1558652,1560595,1943,0,0,1,2
1560589,1560824,235,1,0,0,1
1560596,1560824,228,1,0,0,2
1560614,1560794,180,0,1,0,1
1560617,1560786,169,0,1,0,2
1560825,1560915,90,0,0,1,2
1560825,1560918,93,0,0,1,1
1560916,1561121,205,1,0,0,2
1560919,1561109,190,1,0,0,1
1560934,1561080,146,0,1,0,2
1560937,1561084,147,0,1,0,1
1561110,1562074,964,0,0,1,1
1561122,1562074,952,0,0,1,2
1562075,1562122,47,1,0,0,1
1562075,1562129,54,1,0,0,2
1562123,1562233,110,0,0,1,1
1562130,1562235,105,0,0,1,2
1562234,1562259,25,1,0,0,1
1562236,1562251,15,1,0,0,2
1562252,1563131,879,0,0,1,2
1562260,1563132,872,0,0,1,1
1563132,1563195,63,1,0,0,2
1563133,1563191,58,1,0,0,1
1563192,1563332,140,0,0,1,1
1563196,1563333,137,0,0,1,2
1563333,1563371,38,1,0,0,1
1563334,1563384,50,1,0,0,2
1563372,1563928,556,0,0,1,1
1563385,1563928,543,0,0,1,2
1563929,1563948,19,1,0,0,2
1563929,1563958,29,1,0,0,1
1563949,1565182,1233,0,0,1,2
1563959,1565191,1232,0,0,1,1
1565183,1565406,223,1,0,0,2
1565192,1565401,209,1,0,0,1
1565214,1565372,158,0,1,0,2
1565214,1565374,160,0,1,0,1
1565402,1565562,160,0,0,1,1
1565407,1565560,153,0,0,1,2
1565561,1565753,192,1,0,0,2
1565563,1565751,188,1,0,0,1
1565580,1565719,139,0,1,0,2
1565581,1565726,145,0,1,0,1
1565752,1566416,664,0,0,1,1
1565754,1566414,660,0,0,1,2
1566415,1566486,71,1,0,0,2
1566417,1566495,78,1,0,0,1
1566487,1566585,98,0,0,1,2
1566496,1566587,91,0,0,1,1
1566586,1566607,21,1,0,0,2
1566588,1566618,30,1,0,0,1
1566608,1567838,1230,0,0,1,2
1566619,1567838,1219,0,0,1,1
1567839,1567889,50,1,0,0,1
1567839,1567906,67,1,0,0,2
1567890,1568053,163,0,0,1,1
1567907,1568052,145,0,0,1,2
1568053,1568088,35,1,0,0,2
1568054,1568087,33,1,0,0,1
1568088,1569918,1830,0,0,1,1
1568089,1569915,1826,0,0,1,2
1569916,1570140,224,1,0,0,2
1569919,1570118,199,1,0,0,1
1569933,1570097,164,0,1,0,2
1569938,1570093,155,0,1,0,1
1570119,1570294,175,0,0,1,1
1570141,1570294,153,0,0,1,2
1570295,1570367,72,1,0,0,2
1570295,1570369,74,1,0,0,1
1570368,1571475,1107,0,0,1,2
1570370,1571476,1106,0,0,1,1
1571476,1571804,328,1,0,0,2
1571477,1571552,75,1,0,0,1
1571553,1571576,23,0,0,1,1
1571577,1571790,213,1,0,0,1
1571596,1571765,169,0,1,0,2
1571604,1571758,154,0,1,0,1
1571791,1571841,50,0,0,1,1
1571805,1571842,37,0,0,1,2
1571842,1571860,18,1,0,0,1
1571843,1571859,16,1,0,0,2
1571860,1573422,1562,0,0,1,2
1571861,1573423,1562,0,0,1,1
1573423,1573504,81,1,0,0,2
1573424,1573485,61,1,0,0,1
1573486,1573705,219,0,0,1,1
1573505,1573704,199,0,0,1,2
1573705,1573739,34,1,0,0,2
1573706,1573735,29,1,0,0,1
1573736,1575466,1730,0,0,1,1
1573740,1575466,1726,0,0,1,2
1575467,1575680,213,1,0,0,1
1575467,1575683,216,1,0,0,2
1575492,1575647,155,0,1,0,2
1575493,1575651,158,0,1,0,1
1575681,1575824,143,0,0,1,1
1575684,1575819,135,0,0,1,2
1575820,1576033,213,1,0,0,2
1575825,1576025,200,1,0,0,1
1575839,1575991,152,0,1,0,2
1575843,1575998,155,0,1,0,1
1576026,1577204,1178,0,0,1,1
1576034,1577202,1168,0,0,1,2
1577203,1577272,69,1,0,0,2
1577205,1577269,64,1,0,0,1
1577270,1577343,73,0,0,1,1
1577273,1577342,69,0,0,1,2
1577343,1577382,39,1,0,0,2
1577344,1577382,38,1,0,0,1
1577383,1577574,191,0,0,1,2
1577383,1577578,195,0,0,1,1
1577575,1577600,25,1,0,0,2
1577579,1577592,13,1,0,0,1
1577593,1578650,1057,0,0,1,1
1577601,1578648,1047,0,0,1,2
1578649,1578890,241,1,0,0,2
1578651,1578875,224,1,0,0,1
1578710,1578847,137,0,1,0,2
1578713,1578851,138,0,1,0,1
1578876,1579061,185,0,0,1,1
1578891,1579061,170,0,0,1,2
1579062,1579092,30,1,0,0,1
1579062,1579095,33,1,0,0,2
1579093,1580726,1633,0,0,1,1
1579096,1580731,1635,0,0,1,2
1580727,1580934,207,1,0,0,1
1580732,1580941,209,1,0,0,2
1580749,1580898,149,0,1,0,2
1580754,1580904,150,0,1,0,1
1580935,1582180,1245,0,0,1,1
1580942,1582176,1234,0,0,1,2
1582177,1582258,81,1,0,0,2
1582181,1582262,81,1,0,0,1
1582259,1582391,132,0,0,1,2
1582263,1582391,128,0,0,1,1
1582392,1582421,29,1,0,0,2
1582392,1582422,30,1,0,0,1
1582422,1583462,1040,0,0,1,2
1582423,1583461,1038,0,0,1,1
1583462,1583540,78,1,0,0,1
1583463,1583539,76,1,0,0,2
1583540,1583638,98,0,0,1,2
1583541,1583637,96,0,0,1,1
1583638,1583676,38,1,0,0,1
1583639,1583679,40,1,0,0,2
1583677,1585488,1811,0,0,1,1
1583680,1585477,1797,0,0,1,2
1585478,1585715,237,1,0,0,2
1585489,1585712,223,1,0,0,1
1585509,1585679,170,0,1,0,2
1585514,1585685,171,0,1,0,1
1585713,1586018,305,0,0,1,1
1585716,1586001,285,0,0,1,2
1586002,1586259,257,1,0,0,2
1586019,1586247,228,1,0,0,1
1586036,1586211,175,0,1,0,2
1586039,1586215,176,0,1,0,1
1586248,1586825,577,0,0,1,1
1586260,1586825,565,0,0,1,2
1586826,1586893,67,1,0,0,1
1586826,1586898,72,1,0,0,2
1586894,1586989,95,0,0,1,1
1586899,1586988,89,0,0,1,2
1586989,1587024,35,1,0,0,2
1586990,1587023,33,1,0,0,1
1587024,1588432,1408,0,0,1,1
1587025,1588432,1407,0,0,1,2
1588433,1588490,57,1,0,0,1
1588433,1588508,75,1,0,0,2
1588491,1588613,122,0,0,1,1
1588509,1588611,102,0,0,1,2
1588612,1588662,50,1,0,0,2
1588614,1588652,38,1,0,0,1
1588653,1590252,1599,0,0,1,1
1588663,1590262,1599,0,0,1,2
1590253,1590529,276,1,0,0,1
1590263,1590528,265,1,0,0,2
1590284,1590489,205,0,1,0,2
1590285,1590498,213,0,1,0,1
1590529,1592200,1671,0,0,1,2
1590530,1592195,1665,0,0,1,1
1592196,1592390,194,1,0,0,1
1592201,1592390,189,1,0,0,2
1592221,1592358,137,0,1,0,2
1592221,1592365,144,0,1,0,1
1592391,1592497,106,0,0,1,2
1592391,1592498,107,0,0,1,1
1592498,1592596,98,1,0,0,2
1592499,1592594,95,1,0,0,1
1592595,1592660,65,0,0,1,1
1592597,1592659,62,0,0,1,2
1592660,1592718,58,1,0,0,2
1592661,1592725,64,1,0,0,1
1592719,1592798,79,0,0,1,2
1592726,1592799,73,0,0,1,1
1592799,1592834,35,1,0,0,2
1592800,1592836,36,1,0,0,1
1592835,1593041,206,0,0,1,2
1592837,1593047,210,0,0,1,1
1593042,1593071,29,1,0,0,2
1593048,1593060,12,1,0,0,1
1593061,1593212,151,0,0,1,1
1593072,1593217,145,0,0,1,2
1593213,1593240,27,1,0,0,1
1593218,1593241,23,1,0,0,2
1593241,1594205,964,0,0,1,1
1593242,1594204,962,0,0,1,2
1594205,1594256,51,1,0,0,2
1594206,1594259,53,1,0,0,1
1594257,1596278,2021,0,0,1,2
1594260,1596260,2000,0,0,1,1
1596261,1596511,250,1,0,0,1
1596279,1596517,238,1,0,0,2
1596297,1596484,187,0,1,0,2
1596300,1596485,185,0,1,0,1
1596512,1596555,43,0,0,1,1
1596518,1596555,37,0,0,1,2
1596556,1596761,205,1,0,0,1
1596556,1596761,205,1,0,0,2
1596574,1596729,155,0,1,0,2
1596574,1596737,163,0,1,0,1
1596762,1596944,182,0,0,1,2
1596762,1596951,189,0,0,1,1
1596945,1597145,200,1,0,0,2
1596952,1597135,183,1,0,0,1
1596964,1597107,143,0,1,0,2
1596969,1597111,142,0,1,0,1
1597136,1597628,492,0,0,1,1
1597146,1597627,481,0,0,1,2
1597628,1597685,57,1,0,0,2
1597629,1597705,76,1,0,0,1
1597686,1597777,91,0,0,1,2
1597706,1597780,74,0,0,1,1
1597778,1597807,29,1,0,0,2
1597781,1597799,18,1,0,0,1
1597800,1599251,1451,0,0,1,1
1597808,1599251,1443,0,0,1,2
1599252,1599322,70,1,0,0,1
1599252,1599333,81,1,0,0,2
1599323,1599903,580,0,0,1,1
1599334,1599901,567,0,0,1,2
1599902,1599930,28,1,0,0,2
1599904,1599929,25,1,0,0,1
1599930,1601306,1376,0,0,1,1
1599931,1601305,1374,0,0,1,2
1601306,1601531,225,1,0,0,2
1601307,1601529,222,1,0,0,1
1601323,1601493,170,0,1,0,2
1601325,1601500,175,0,1,0,1
1601530,1601690,160,0,0,1,1
1601532,1601690,158,0,0,1,2
1601691,1601748,57,1,0,0,1
1601691,1601761,70,1,0,0,2
1601749,1603028,1279,0,0,1,1
1601762,1603027,1265,0,0,1,2
1603028,1603067,39,1,0,0,2
1603029,1603067,38,1,0,0,1
1603068,1604445,1377,0,0,1,2
1603068,1604446,1378,0,0,1,1
1604446,1604509,63,1,0,0,2
1604447,1604495,48,1,0,0,1
1604496,1606452,1956,0,0,1,1
1604510,1606452,1942,0,0,1,2
1606453,1606663,210,1,0,0,2
1606453,1606668,215,1,0,0,1
1606471,1606629,158,0,1,0,2
1606471,1606637,166,0,1,0,1
1606664,1606785,121,0,0,1,2
1606669,1606786,117,0,0,1,1
1606786,1606977,191,1,0,0,2
1606787,1606978,191,1,0,0,1
1606803,1606943,140,0,1,0,2
1606804,1606951,147,0,1,0,1
1606978,1607932,954,0,0,1,2
1606979,1607932,953,0,0,1,1
1607933,1607961,28,1,0,0,2
1607933,1607984,51,1,0,0,1
1607962,1608088,126,0,0,1,2
1607985,1608087,102,0,0,1,1
1608088,1608118,30,1,0,0,1
1608089,1608117,28,1,0,0,2
1608118,1609272,1154,0,0,1,2
1608119,1609272,1153,0,0,1,1
1609273,1609320,47,1,0,0,1
1609273,1609336,63,1,0,0,2
1609321,1609448,127,0,0,1,1
1609337,1609450,113,0,0,1,2
1609449,1609479,30,1,0,0,1
1609451,1609480,29,1,0,0,2
1609480,1611274,1794,0,0,1,1
1609481,1611289,1808,0,0,1,2
1611275,1611513,238,1,0,0,1
1611290,1611510,220,1,0,0,2
1611307,1611482,175,0,1,0,1
1611308,1611473,165,0,1,0,2
1611511,1611754,243,0,0,1,2
1611514,1611755,241,0,0,1,1
1611755,1611817,62,1,0,0,2
1611756,1611804,48,1,0,0,1
1611805,1612633,828,0,0,1,1
1611818,1612631,813,0,0,1,2
1612632,1612708,76,1,0,0,2
1612634,1612712,78,1,0,0,1
1612709,1612850,141,0,0,1,2
1612713,1612850,137,0,0,1,1
1612851,1612879,28,1,0,0,1
1612851,1612881,30,1,0,0,2
1612880,1614265,1385,0,0,1,1
1612882,1614265,1383,0,0,1,2
1614266,1614348,82,1,0,0,1
1614266,1614349,83,1,0,0,2
1614349,1614479,130,0,0,1,1
1614350,1614479,129,0,0,1,2
1614480,1614513,33,1,0,0,2
1614480,1614514,34,1,0,0,1
1614514,1616307,1793,0,0,1,2
1614515,1616306,1791,0,0,1,1
1616307,1616535,228,1,0,0,1
1616308,1616545,237,1,0,0,2
1616337,1616501,164,0,1,0,2
1616341,1616504,163,0,1,0,1
1616536,1616665,129,0,0,1,1
1616546,1616666,120,0,0,1,2
1616666,1616863,197,1,0,0,1
1616667,1616863,196,1,0,0,2
1616687,1616830,143,0,1,0,2
1616690,1616834,144,0,1,0,1
1616864,1618037,1173,0,0,1,1
1616864,1618039,1175,0,0,1,2
1618038,1618105,67,1,0,0,1
1618040,1618113,73,1,0,0,2
1618106,1619275,1169,0,0,1,1
1618114,1619275,1161,0,0,1,2
1619276,1619334,58,1,0,0,1
1619276,1619342,66,1,0,0,2
1619335,1619543,208,0,0,1,1
1619343,1619544,201,0,0,1,2
1619544,1619578,34,1,0,0,1
1619545,1619565,20,1,0,0,2
1619566,1621336,1770,0,0,1,2
1619579,1621328,1749,0,0,1,1
1621329,1621554,225,1,0,0,1
1621337,1621548,211,1,0,0,2
1621351,1621523,172,0,1,0,1
1621353,1621513,160,0,1,0,2
1621549,1622627,1078,0,0,1,2
1621555,1622627,1072,0,0,1,1
1622628,1622670,42,1,0,0,2
1622628,1622671,43,1,0,0,1
1622671,1622973,302,0,0,1,2
1622672,1622965,293,0,0,1,1
1622966,1623157,191,1,0,0,1
1622974,1623167,193,1,0,0,2
1622991,1623121,130,0,1,0,2
1622991,1623129,138,0,1,0,1
1623158,1623490,332,0,0,1,1
1623168,1623490,322,0,0,1,2
1671670,1671795,125,0,1,0,1
1671670,1671795,125,0,1,0,2
1671830,1671916,86,0,0,1,2
1671833,1671918,85,0,0,1,1
1671917,1672126,209,1,0,0,2
1671919,1672118,199,1,0,0,1
1671938,1672098,160,0,1,0,2
1671940,1672088,148,0,1,0,1
1672119,1672160,41,0,0,1,1
1672127,1672160,33,0,0,1,2
1672161,1672194,33,1,0,0,1
1672161,1672196,35,1,0,0,2
1672195,1674007,1812,0,0,1,1
1672197,1674008,1811,0,0,1,2
1674008,1674106,98,1,0,0,1
1674009,1674105,96,1,0,0,2
1674106,1674173,67,0,0,1,2
1674107,1674173,66,0,0,1,1
1674174,1674213,39,1,0,0,1
1674174,1674213,39,1,0,0,2
1674214,1674258,44,0,0,1,1
1674214,1674258,44,0,0,1,2
1674259,1674294,35,1,0,0,1
1674259,1674294,35,1,0,0,2
1674295,1676033,1738,0,0,1,2
1674295,1676034,1739,0,0,1,1
1676034,1676191,157,1,0,0,2
1676035,1676205,170,1,0,0,1
1676066,1676159,93,0,1,0,1
1676067,1676164,97,0,1,0,2
1676192,1676285,93,0,0,1,2
1676206,1676284,78,0,0,1,1
1676285,1676306,21,1,0,0,1
1676286,1676315,29,1,0,0,2
1676307,1677913,1606,0,0,1,1
1676316,1677912,1596,0,0,1,2
1677913,1677967,54,1,0,0,2
1677914,1677969,55,1,0,0,1
1677968,1678038,70,0,0,1,2
1677970,1678039,69,0,0,1,1
1678039,1678076,37,1,0,0,2
1678040,1678077,37,1,0,0,1
1678077,1678189,112,0,0,1,2
1678078,1678191,113,0,0,1,1
1678190,1678219,29,1,0,0,2
1678192,1678219,27,1,0,0,1
1678220,1679398,1178,0,0,1,2
1678220,1679405,1185,0,0,1,1
1679399,1679584,185,1,0,0,2
1679406,1679574,168,1,0,0,1
1679428,1679534,106,0,1,0,2
1679429,1679535,106,0,1,0,1
1679575,1679692,117,0,0,1,1
1679585,1679692,107,0,0,1,2
1679693,1679777,84,1,0,0,2
1679693,1679781,88,1,0,0,1
1679778,1679841,63,0,0,1,2
1679782,1679841,59,0,0,1,1
1679842,1679879,37,1,0,0,1
1679842,1679879,37,1,0,0,2
1679880,1681539,1659,0,0,1,2
1679880,1681540,1660,0,0,1,1
1681540,1681637,97,1,0,0,2
1681541,1681626,85,1,0,0,1
1681627,1681688,61,0,0,1,1
1681638,1681689,51,0,0,1,2
1681689,1681727,38,1,0,0,1
1681690,1681730,40,1,0,0,2
1681728,1681820,92,0,0,1,1
1681731,1681821,90,0,0,1,2
1681821,1681841,20,1,0,0,1
1681822,1681881,59,1,0,0,2
1681842,1682943,1101,0,0,1,1
1681882,1682249,367,0,0,1,2
1682250,1682258,8,1,0,0,2
1682259,1682941,682,0,0,1,2
1682942,1683204,262,1,0,0,2
1682944,1683204,260,1,0,0,1
1682959,1683170,211,0,1,0,2
1682964,1683176,212,0,1,0,1
1683205,1683379,174,0,0,1,1
1683205,1683379,174,0,0,1,2
1683380,1683471,91,1,0,0,2
1683380,1683476,96,1,0,0,1
1683472,1683534,62,0,0,1,2
1683477,1683534,57,0,0,1,1
1683535,1683567,32,1,0,0,1
1683535,1683572,37,1,0,0,2
1683568,1683921,353,0,0,1,1
1683573,1683912,339,0,0,1,2
1683913,1683933,20,1,0,0,2
1683922,1683934,12,1,0,0,1
1683934,1685161,1227,0,0,1,2
1683935,1685161,1226,0,0,1,1
1685162,1685241,79,1,0,0,1
1685162,1685241,79,1,0,0,2
1685242,1685303,61,0,0,1,2
1685242,1685306,64,0,0,1,1
1685304,1685340,36,1,0,0,2
1685307,1685339,32,1,0,0,1
1685340,1685493,153,0,0,1,1
1685341,1685493,152,0,0,1,2
1685494,1685525,31,1,0,0,1
1685494,1685527,33,1,0,0,2
1685526,1686469,943,0,0,1,1
1685528,1686468,940,0,0,1,2
1686469,1686657,188,1,0,0,2
1686470,1686658,188,1,0,0,1
1686501,1686626,125,0,1,0,2
1686504,1686631,127,0,1,0,1
1686658,1686919,261,0,0,1,2
1686659,1686919,260,0,0,1,1
1686920,1687005,85,1,0,0,2
1686920,1687006,86,1,0,0,1
1687006,1687075,69,0,0,1,2
1687007,1687075,68,0,0,1,1
1687076,1687099,23,1,0,0,1
1687076,1687107,31,1,0,0,2
1687100,1687286,186,0,0,1,1
1687108,1687284,176,0,0,1,2
1687285,1687315,30,1,0,0,2
1687287,1687317,30,1,0,0,1
1687316,1688819,1503,0,0,1,2
1687318,1688821,1503,0,0,1,1
1688820,1688929,109,1,0,0,2
1688822,1688926,104,1,0,0,1
1688927,1688986,59,0,0,1,1
1688930,1688985,55,0,0,1,2
1688986,1689023,37,1,0,0,2
1688987,1689024,37,1,0,0,1
1689024,1689153,129,0,0,1,2
1689025,1689156,131,0,0,1,1
1689154,1689183,29,1,0,0,2
1689157,1689185,28,1,0,0,1
1689184,1690113,929,0,0,1,2
1689186,1690127,941,0,0,1,1
1690114,1690324,210,1,0,0,2
1690128,1690315,187,1,0,0,1
1690140,1690289,149,0,1,0,2
1690144,1690294,150,0,1,0,1
1690316,1690526,210,0,0,1,1
1690325,1690525,200,0,0,1,2
1690526,1690602,76,1,0,0,2
1690527,1690598,71,1,0,0,1
1690599,1690691,92,0,0,1,1
1690603,1690690,87,0,0,1,2
1690691,1690726,35,1,0,0,2
1690692,1690723,31,1,0,0,1
1690724,1692312,1588,0,0,1,1
1690727,1692308,1581,0,0,1,2
1692309,1692422,113,1,0,0,2
1692313,1692428,115,1,0,0,1
1692423,1692477,54,0,0,1,2
1692429,1692479,50,0,0,1,1
1692478,1692518,40,1,0,0,2
1692480,1692549,69,1,0,0,1
1692519,1694130,1611,0,0,1,2
1692550,1694132,1582,0,0,1,1
1694131,1694225,94,1,0,0,2
1694133,1694225,92,1,0,0,1
1694226,1694324,98,0,0,1,1
1694226,1694324,98,0,0,1,2
1694325,1694357,32,1,0,0,2
1694325,1694359,34,1,0,0,1
1694358,1694665,307,0,0,1,2
1694360,1694666,306,0,0,1,1
1694666,1694697,31,1,0,0,2
1694667,1694694,27,1,0,0,1
1694695,1695438,743,0,0,1,1
1694698,1695426,728,0,0,1,2
1695427,1695651,224,1,0,0,2
1695439,1695650,211,1,0,0,1
1695451,1695627,176,0,1,0,1
1695453,1695622,169,0,1,0,2
1695651,1695857,206,0,0,1,1
1695652,1695856,204,0,0,1,2
1695857,1695906,49,1,0,0,2
1695858,1695907,49,1,0,0,1
1695907,1696049,142,0,0,1,2
1695908,1696042,134,0,0,1,1
1696043,1696070,27,1,0,0,1
1696050,1696061,11,1,0,0,2
1696062,1696748,686,0,0,1,2
1696071,1696753,682,0,0,1,1
1696749,1696775,26,1,0,0,2
1696754,1696763,9,1,0,0,1
1696764,1697583,819,0,0,1,1
1696776,1697584,808,0,0,1,2
1697584,1697657,73,1,0,0,1
1697585,1697653,68,1,0,0,2
1697654,1697721,67,0,0,1,2
1697658,1697721,63,0,0,1,1
1697722,1697751,29,1,0,0,2
1697722,1697753,31,1,0,0,1
1697752,1697992,240,0,0,1,2
1697754,1697997,243,0,0,1,1
1697993,1698008,15,1,0,0,2
1697998,1698009,11,1,0,0,1
1698009,1699336,1327,0,0,1,2
1698010,1699335,1325,0,0,1,1
1699336,1699413,77,1,0,0,1
1699337,1699422,85,1,0,0,2
1699414,1699487,73,0,0,1,1
1699423,1699487,64,0,0,1,2
1699488,1699542,54,1,0,0,2
1699488,1699543,55,1,0,0,1
1699543,1699722,179,0,0,1,2
1699544,1699727,183,0,0,1,1
1699723,1699752,29,1,0,0,2
1699728,1699750,22,1,0,0,1
1699751,1700784,1033,0,0,1,1
1699753,1700789,1036,0,0,1,2
1700785,1700994,209,1,0,0,1
1700790,1701008,218,1,0,0,2
1700805,1700976,171,0,1,0,1
1700811,1700972,161,0,1,0,2
1700995,1701172,177,0,0,1,1
1701009,1701171,162,0,0,1,2
1701172,1701256,84,1,0,0,2
1701173,1701268,95,1,0,0,1
1701257,1701340,83,0,0,1,2
1701269,1701340,71,0,0,1,1
1701341,1701379,38,1,0,0,1
1701341,1701397,56,1,0,0,2
1701380,1701456,76,0,0,1,1
1701398,1701458,60,0,0,1,2
1701457,1701477,20,1,0,0,1
1701459,1701488,29,1,0,0,2
1701478,1702952,1474,0,0,1,1
1701489,1702952,1463,0,0,1,2
1702953,1703030,77,1,0,0,2
1702953,1703036,83,1,0,0,1
1703031,1703088,57,0,0,1,2
1703037,1703090,53,0,0,1,1
1703089,1703129,40,1,0,0,2
1703091,1703132,41,1,0,0,1
1703130,1703215,85,0,0,1,2
1703133,1703215,82,0,0,1,1
1703216,1703247,31,1,0,0,1
1703216,1703248,32,1,0,0,2
1703248,1704414,1166,0,0,1,1
1703249,1704413,1164,0,0,1,2
1704414,1704641,227,1,0,0,2
1704415,1704640,225,1,0,0,1
1704432,1704612,180,0,1,0,2
1704433,1704615,182,0,1,0,1
1704641,1704806,165,0,0,1,1
1704642,1704804,162,0,0,1,2
1704805,1704890,85,1,0,0,2
1704807,1704893,86,1,0,0,1
1704891,1704969,78,0,0,1,2
1704894,1704969,75,0,0,1,1
1704970,1705003,33,1,0,0,1
1704970,1705003,33,1,0,0,2
1705004,1705177,173,0,0,1,2
1705004,1705181,177,0,0,1,1
1705178,1705206,28,1,0,0,2
1705182,1705202,20,1,0,0,1
1705203,1706268,1065,0,0,1,1
1705207,1706266,1059,0,0,1,2
1706269,1706433,164,1,0,0,1
1706277,1706400,123,0,1,0,2
1706283,1706402,119,0,1,0,1
1706410,1706437,27,1,0,0,2
1706434,1706605,171,0,0,1,1
1706438,1706604,166,0,0,1,2
1706605,1706687,82,1,0,0,2
1706606,1706708,102,1,0,0,1
1706688,1706903,215,0,0,1,2
1706709,1706907,198,0,0,1,1
1706904,1706932,28,1,0,0,2
1706908,1706920,12,1,0,0,1
1706921,1708319,1398,0,0,1,1
1706933,1708319,1386,0,0,1,2
1708320,1708370,50,1,0,0,1
1708320,1708388,68,1,0,0,2
1708371,1710063,1692,0,0,1,1
1708389,1710063,1674,0,0,1,2
1710064,1710165,101,1,0,0,1
1710064,1710174,110,1,0,0,2
1710166,1710291,125,0,0,1,1
1710175,1710288,113,0,0,1,2
1710289,1710328,39,1,0,0,2
1710292,1710324,32,1,0,0,1
1710325,1711492,1167,0,0,1,1
1710329,1711482,1153,0,0,1,2
1711483,1711731,248,1,0,0,2
1711493,1711712,219,1,0,0,1
1711503,1711700,197,0,1,0,2
1711509,1711687,178,0,1,0,1
1711713,1711814,101,0,0,1,1
1711732,1711812,80,0,0,1,2
1711813,1711921,108,1,0,0,2
1711815,1711915,100,1,0,0,1
1711916,1712047,131,0,0,1,1
1711922,1712046,124,0,0,1,2
1712047,1712070,23,1,0,0,2
1712048,1712068,20,1,0,0,1
1712069,1713635,1566,0,0,1,1
1712071,1713637,1566,0,0,1,2
1713636,1713739,103,1,0,0,1
1713638,1713739,101,1,0,0,2
1713740,1713804,64,0,0,1,2
1713740,1713805,65,0,0,1,1
1713805,1713848,43,1,0,0,2
1713806,1713845,39,1,0,0,1
1713846,1714031,185,0,0,1,1
1713849,1714029,180,0,0,1,2
1714030,1714064,34,1,0,0,2
1714032,1714061,29,1,0,0,1
1714062,1715339,1277,0,0,1,1
1714065,1715338,1273,0,0,1,2
1715339,1715675,336,1,0,0,2
1715340,1715662,322,1,0,0,1
1715417,1715635,218,0,1,0,2
1715419,1715635,216,0,1,0,1
1715663,1715756,93,0,0,1,1
1715676,1715753,77,0,0,1,2
1715754,1715789,35,1,0,0,2
1715757,1715788,31,1,0,0,1
1715789,1717285,1496,0,0,1,1
1715790,1717286,1496,0,0,1,2
1717286,1717369,83,1,0,0,1
1717287,1717369,82,1,0,0,2
1717370,1718989,1619,0,0,1,1
1717370,1718989,1619,0,0,1,2
1718990,1719088,98,1,0,0,2
1718990,1719100,110,1,0,0,1
1719019,1719041,22,0,1,0,1
1719089,1719168,79,0,0,1,2
1719101,1719168,67,0,0,1,1
1719169,1719202,33,1,0,0,1
1719169,1719204,35,1,0,0,2
1719203,1719386,183,0,0,1,1
1719205,1719384,179,0,0,1,2
1719385,1719397,12,1,0,0,2
1719387,1719403,16,1,0,0,1
1719398,1719567,169,0,0,1,2
1719404,1719574,170,0,0,1,1
1719568,1719578,10,1,0,0,2
1719575,1719589,14,1,0,0,1
1719579,1720670,1091,0,0,1,2
1719590,1720671,1081,0,0,1,1
1720671,1720755,84,1,0,0,2
1720672,1720765,93,1,0,0,1
1720756,1720820,64,0,0,1,2
1720766,1720819,53,0,0,1,1
1720820,1720844,24,1,0,0,1
1720821,1720851,30,1,0,0,2
1720845,1722464,1619,0,0,1,1
1720852,1722464,1612,0,0,1,2
1722465,1722659,194,1,0,0,1
1722465,1722665,200,1,0,0,2
1722512,1722612,100,0,1,0,2
1722515,1722608,93,0,1,0,1
1722660,1722763,103,0,0,1,1
1722666,1722762,96,0,0,1,2
1722763,1722798,35,1,0,0,2
1722764,1722793,29,1,0,0,1
1722794,1724242,1448,0,0,1,1
1722799,1724240,1441,0,0,1,2
1724241,1724343,102,1,0,0,2
1724243,1724338,95,1,0,0,1
1724339,1724386,47,0,0,1,1
1724344,1724387,43,0,0,1,2
1724387,1724425,38,1,0,0,1
1724388,1724425,37,1,0,0,2
1724426,1724523,97,0,0,1,1
1724426,1724523,97,0,0,1,2
1724524,1724553,29,1,0,0,1
1724524,1724554,30,1,0,0,2
1724554,1725893,1339,0,0,1,1
1724555,1725894,1339,0,0,1,2
1725894,1725984,90,1,0,0,1
1725895,1725987,92,1,0,0,2
1725985,1726044,59,0,0,1,1
1725988,1726045,57,0,0,1,2
1726045,1726085,40,1,0,0,1
1726046,1726088,42,1,0,0,2
1726086,1727206,1120,0,0,1,1
1726089,1727227,1138,0,0,1,2
1727207,1727447,240,1,0,0,1
1727228,1727455,227,1,0,0,2
1727240,1727428,188,0,1,0,1
1727245,1727423,178,0,1,0,2
1727448,1727647,199,0,0,1,1
1727456,1727648,192,0,0,1,2
1727648,1727705,57,1,0,0,1
1727649,1727723,74,1,0,0,2
1727706,1727808,102,0,0,1,1
1727724,1727809,85,0,0,1,2
1727809,1727829,20,1,0,0,1
1727810,1727839,29,1,0,0,2
1727830,1728079,249,0,0,1,1
1727840,1728070,230,0,0,1,2
1728071,1728098,27,1,0,0,2
1728080,1728091,11,1,0,0,1
1728092,1729117,1025,0,0,1,1
1728099,1729116,1017,0,0,1,2
1729117,1729205,88,1,0,0,2
1729118,1729189,71,1,0,0,1
1729190,1729314,124,0,0,1,1
1729206,1729313,107,0,0,1,2
1729314,1729388,74,1,0,0,2
1729315,1729388,73,1,0,0,1
1729389,1729450,61,0,0,1,2
1729389,1729453,64,0,0,1,1
1729451,1729489,38,1,0,0,2
1729454,1729488,34,1,0,0,1
1729489,1729556,67,0,0,1,1
1729490,1729554,64,0,0,1,2
1729555,1729577,22,1,0,0,2
1729557,1729589,32,1,0,0,1
1729578,1731060,1482,0,0,1,2
1729590,1731062,1472,0,0,1,1
1731061,1731128,67,1,0,0,2
1731063,1731129,66,1,0,0,1
1731129,1731163,34,0,0,1,2
1731130,1731162,32,0,0,1,1
1731163,1731239,76,1,0,0,1
1731164,1731237,73,1,0,0,2
1731238,1731291,53,0,0,1,2
1731240,1731292,52,0,0,1,1
1731292,1731342,50,1,0,0,2
1731293,1731332,39,1,0,0,1
1731333,1731414,81,0,0,1,1
1731343,1731413,70,0,0,1,2
1731414,1731448,34,1,0,0,2
1731415,1731449,34,1,0,0,1
1731449,1731644,195,0,0,1,2
1731450,1731639,189,0,0,1,1
1731640,1731651,11,1,0,0,1
1731645,1731649,4,1,0,0,2
1731650,1732562,912,0,0,1,2
1731652,1732566,914,0,0,1,1
1732563,1732782,219,1,0,0,2
1732567,1732774,207,1,0,0,1
1732593,1732753,160,0,1,0,2
1732594,1732750,156,0,1,0,1
1732775,1732992,217,0,0,1,1
1732783,1732992,209,0,0,1,2
1732993,1733070,77,1,0,0,1
1732993,1733085,92,1,0,0,2
1733071,1733147,76,0,0,1,1
1733086,1733146,60,0,0,1,2
1733147,1733195,48,1,0,0,2
1733148,1733188,40,1,0,0,1
1733189,1734653,1464,0,0,1,1
1733196,1734652,1456,0,0,1,2
1734653,1734741,88,1,0,0,2
1734654,1734752,98,1,0,0,1
1734742,1734789,47,0,0,1,2
1734753,1734790,37,0,0,1,1
1734790,1734836,46,1,0,0,2
1734791,1734841,50,1,0,0,1
1734837,1734904,67,0,0,1,2
1734842,1734905,63,0,0,1,1
1734905,1734948,43,1,0,0,2
1734906,1734942,36,1,0,0,1
1734943,1735248,305,0,0,1,1
1734949,1735237,288,0,0,1,2
1735238,1735255,17,1,0,0,2
1735249,1735253,4,1,0,0,1
1735254,1736169,915,0,0,1,1
1735256,1736161,905,0,0,1,2
1736162,1736362,200,1,0,0,2
1736170,1736342,172,1,0,0,1
1736184,1736307,123,0,1,0,2
1736187,1736304,117,0,1,0,1
1736343,1736446,103,0,0,1,1
1736363,1736437,74,0,0,1,2
1736438,1736627,189,1,0,0,2
1736447,1736619,172,1,0,0,1
1736461,1736594,133,0,1,0,2
1736464,1736596,132,0,1,0,1
1736620,1737875,1255,0,0,1,1
1736628,1737874,1246,0,0,1,2
1737875,1737952,77,1,0,0,2
1737876,1737959,83,1,0,0,1
1737953,1738032,79,0,0,1,2
1737960,1738031,71,0,0,1,1
1738032,1738063,31,1,0,0,1
1738033,1738062,29,1,0,0,2
1738063,1739099,1036,0,0,1,2
1738064,1739100,1036,0,0,1,1
1739100,1739305,205,1,0,0,2
1739101,1739272,171,1,0,0,1
1739117,1739252,135,0,1,0,2
1739121,1739252,131,0,1,0,1
1739273,1739517,244,0,0,1,1
1739306,1739518,212,0,0,1,2
1739518,1739593,75,1,0,0,1
1739519,1739603,84,1,0,0,2
1739594,1739683,89,0,0,1,1
1739604,1739683,79,0,0,1,2
1739684,1739734,50,1,0,0,1
1739684,1739752,68,1,0,0,2
1739735,1739810,75,0,0,1,1
1739753,1739811,58,0,0,1,2
1739811,1739847,36,1,0,0,1
1739812,1739848,36,1,0,0,2
1739848,1741258,1410,0,0,1,1
1739849,1741257,1408,0,0,1,2
1741258,1741368,110,1,0,0,2
1741259,1741353,94,1,0,0,1
1741354,1741403,49,0,0,1,1
1741369,1741403,34,0,0,1,2
1741404,1741458,54,1,0,0,1
1741404,1741465,61,1,0,0,2
1741459,1741535,76,0,0,1,1
1741466,1741532,66,0,0,1,2
1741533,1741568,35,1,0,0,2
1741536,1741558,22,1,0,0,1
1741559,1743051,1492,0,0,1,1
1741569,1743052,1483,0,0,1,2
1743052,1743153,101,1,0,0,1
1743053,1743158,105,1,0,0,2
1743154,1743228,74,0,0,1,1
1743159,1743229,70,0,0,1,2
1743229,1743266,37,1,0,0,1
1743230,1743267,37,1,0,0,2
1743267,1744729,1462,0,0,1,1
1743268,1744728,1460,0,0,1,2
1744729,1744826,97,1,0,0,2
1744730,1744823,93,1,0,0,1
1744824,1744871,47,0,0,1,1
1744827,1744873,46,0,0,1,2
1744872,1744916,44,1,0,0,1
1744874,1744914,40,1,0,0,2
1744915,1744975,60,0,0,1,2
1744917,1744975,58,0,0,1,1
1744976,1745012,36,1,0,0,1
1744976,1745014,38,1,0,0,2
1745013,1745122,109,0,0,1,1
1745015,1745124,109,0,0,1,2
1745123,1745149,26,1,0,0,1
1745125,1745154,29,1,0,0,2
1745150,1745948,798,0,0,1,1
1745155,1745944,789,0,0,1,2
1745945,1746204,259,1,0,0,2
1745949,1746192,243,1,0,0,1
1745965,1746168,203,0,1,0,2
1745968,1746170,202,0,1,0,1
1746193,1746382,189,0,0,1,1
1746205,1746381,176,0,0,1,2
1746382,1746457,75,1,0,0,2
1746383,1746453,70,1,0,0,1
1746454,1746538,84,0,0,1,1
1746458,1746536,78,0,0,1,2
1746537,1746571,34,1,0,0,2
1746539,1746558,19,1,0,0,1
1746559,1747762,1203,0,0,1,1
1746572,1747762,1190,0,0,1,2
1747763,1747818,55,1,0,0,1
1747763,1747831,68,1,0,0,2
1747819,1748085,266,0,0,1,1
1747832,1748085,253,0,0,1,2
1748086,1748142,56,1,0,0,1
1748086,1748166,80,1,0,0,2
1748143,1748355,212,0,0,1,1
1748167,1748359,192,0,0,1,2
1748356,1748380,24,1,0,0,1
1748360,1748384,24,1,0,0,2
1748381,1749747,1366,0,0,1,1
1748385,1749746,1361,0,0,1,2
1749747,1749815,68,1,0,0,2
1749748,1749813,65,1,0,0,1
1749814,1749859,45,0,0,1,1
1749816,1749859,43,0,0,1,2
1749860,1749897,37,1,0,0,1
1749860,1749898,38,1,0,0,2
1749898,1749978,80,0,0,1,1
1749899,1749980,81,0,0,1,2
1749979,1750013,34,1,0,0,1
1749981,1750013,32,1,0,0,2
1750014,1751046,1032,0,0,1,1
1750014,1751050,1036,0,0,1,2
1751047,1751281,234,1,0,0,1
1751051,1751289,238,1,0,0,2
1751079,1751251,172,0,1,0,1
1751081,1751249,168,0,1,0,2
1751282,1751446,164,0,0,1,1
1751290,1751444,154,0,0,1,2
1751445,1751505,60,1,0,0,2
1751447,1751516,69,1,0,0,1
1751506,1751583,77,0,0,1,2
1751517,1751584,67,0,0,1,1
1751584,1751617,33,1,0,0,2
1751585,1751608,23,1,0,0,1
1751609,1753249,1640,0,0,1,1
1751618,1753249,1631,0,0,1,2
1753250,1753317,67,1,0,0,1
1753250,1753338,88,1,0,0,2
1753318,1753397,79,0,0,1,1
1753339,1753396,57,0,0,1,2
1753397,1753457,60,1,0,0,2
1753398,1753438,40,1,0,0,1
1753439,1753516,77,0,0,1,1
1753458,1753514,56,0,0,1,2
1753515,1753547,32,1,0,0,2
1753517,1753545,28,1,0,0,1
1753546,1753750,204,0,0,1,1
1753548,1753747,199,0,0,1,2
1753748,1753776,28,1,0,0,2
1753751,1753776,25,1,0,0,1
1753777,1755078,1301,0,0,1,2
1753777,1755079,1302,0,0,1,1
1755079,1755207,128,1,0,0,2
1755080,1755205,125,1,0,0,1
1755206,1755248,42,0,0,1,1
1755208,1755248,40,0,0,1,2
1755249,1755291,42,1,0,0,1
1755249,1755292,43,1,0,0,2
1755292,1755387,95,0,0,1,1
1755293,1755386,93,0,0,1,2
1755387,1755423,36,1,0,0,2
1755388,1755422,34,1,0,0,1
1755423,1756338,915,0,0,1,1
1755424,1756339,915,0,0,1,2
1756339,1756589,250,1,0,0,1
1756340,1756577,237,1,0,0,2
1756356,1756557,201,0,1,0,1
1756358,1756548,190,0,1,0,2
1756578,1756747,169,0,0,1,2
1756590,1756748,158,0,0,1,1
1756748,1756843,95,1,0,0,2
1756749,1756871,122,1,0,0,1
1756844,1756914,70,0,0,1,2
1756872,1756915,43,0,0,1,1
1756915,1756959,44,1,0,0,2
1756916,1756976,60,1,0,0,1
1756960,1758300,1340,0,0,1,2
1756977,1758302,1325,0,0,1,1
1758301,1758370,69,1,0,0,2
1758303,1758373,70,1,0,0,1
1758371,1758578,207,0,0,1,2
1758374,1758580,206,0,0,1,1
1758579,1758660,81,1,0,0,2
1758581,1758657,76,1,0,0,1
1758658,1758740,82,0,0,1,1
1758661,1758739,78,0,0,1,2
1758740,1758781,41,1,0,0,2
1758741,1758777,36,1,0,0,1
1758778,1758893,115,0,0,1,1
1758782,1758892,110,0,0,1,2
1758893,1758924,31,1,0,0,2
1758894,1758922,28,1,0,0,1
1758923,1759304,381,0,0,1,1
1758925,1759298,373,0,0,1,2
1759299,1759327,28,1,0,0,2
1759305,1759317,12,1,0,0,1
1759318,1760017,699,0,0,1,1
1759328,1760026,698,0,0,1,2
1760018,1760300,282,1,0,0,1
1760027,1760306,279,1,0,0,2
1760047,1760274,227,0,1,0,1
1760051,1760273,222,0,1,0,2
1760301,1760520,219,0,0,1,1
1760307,1760520,213,0,0,1,2
1760521,1760602,81,1,0,0,1
1760521,1760603,82,1,0,0,2
1760603,1760687,84,0,0,1,1
1760604,1760686,82,0,0,1,2
1760687,1760720,33,1,0,0,2
1760688,1760721,33,1,0,0,1
1760721,1760914,193,0,0,1,2
1760722,1760914,192,0,0,1,1
1760915,1761281,366,1,0,0,1
1760915,1761281,366,1,0,0,2
1760936,1761270,334,0,1,0,2
1760940,1761270,330,0,1,0,1
1761282,1761311,29,0,0,1,2
1761282,1761315,33,0,0,1,1
1761312,1761501,189,1,0,0,2
1761316,1761489,173,1,0,0,1
1761333,1761470,137,0,1,0,2
1761337,1761467,130,0,1,0,1
1761490,1761543,53,0,0,1,1
1761502,1761534,32,0,0,1,2
1761535,1761728,193,1,0,0,2
1761544,1761704,160,1,0,0,1
1761559,1761679,120,0,1,0,2
1761560,1761681,121,0,1,0,1
1761705,1761828,123,0,0,1,1
1761729,1761828,99,0,0,1,2
1761829,1761908,79,1,0,0,1
1761829,1761910,81,1,0,0,2
1761909,1761991,82,0,0,1,1
1761911,1761992,81,0,0,1,2
1761992,1762017,25,1,0,0,1
1761993,1762025,32,1,0,0,2
1762018,1762779,761,0,0,1,1
1762026,1762776,750,0,0,1,2
1762777,1762808,31,1,0,0,2
1762780,1762804,24,1,0,0,1
1762805,1762960,155,0,0,1,1
1762809,1762971,162,0,0,1,2
1762961,1762978,17,1,0,0,1
1762972,1762987,15,1,0,0,2
1762979,1764375,1396,0,0,1,1
1762988,1764374,1386,0,0,1,2
1764375,1764442,67,1,0,0,2
1764376,1764430,54,1,0,0,1
1764431,1764591,160,0,0,1,1
1764443,1764586,143,0,0,1,2
1764587,1764620,33,1,0,0,2
1764592,1764604,12,1,0,0,1
1764605,1766443,1838,0,0,1,1
1764621,1766443,1822,0,0,1,2
1766444,1766746,302,1,0,0,1
1766444,1766757,313,1,0,0,2
1766470,1766724,254,0,1,0,2
1766472,1766724,252,0,1,0,1
1766747,1766949,202,0,0,1,1
1766758,1766943,185,0,0,1,2
1766944,1767122,178,1,0,0,2
1766950,1767091,141,1,0,0,1
1766963,1767070,107,0,1,0,2
1766966,1767071,105,0,1,0,1
1767092,1768387,1295,0,0,1,1
1767123,1768386,1263,0,0,1,2
1768387,1768458,71,1,0,0,2
1768388,1768436,48,1,0,0,1
1768437,1768647,210,0,0,1,1
1768459,1768647,188,0,0,1,2
1768648,1768666,18,1,0,0,1
1768648,1768677,29,1,0,0,2
1768667,1770056,1389,0,0,1,1
1768678,1770056,1378,0,0,1,2
1770057,1770106,49,1,0,0,1
1770057,1770132,75,1,0,0,2
1770107,1772088,1981,0,0,1,1
1770133,1772102,1969,0,0,1,2
1772089,1772346,257,1,0,0,1
1772103,1772345,242,1,0,0,2
1772123,1772311,188,0,1,0,1
1772125,1772306,181,0,1,0,2
1772346,1772768,422,0,0,1,2
1772347,1772764,417,0,0,1,1
1772765,1772940,175,1,0,0,1
1772769,1772952,183,1,0,0,2
1772787,1772917,130,0,1,0,2
1772788,1772918,130,0,1,0,1
1772941,1773940,999,0,0,1,1
1772953,1773940,987,0,0,1,2
1773941,1774001,60,1,0,0,1
1773941,1774017,76,1,0,0,2
1774002,1774135,133,0,0,1,1
1774018,1774133,115,0,0,1,2
1774134,1774164,30,1,0,0,2
1774136,1774158,22,1,0,0,1
1774159,1775529,1370,0,0,1,1
1774165,1775529,1364,0,0,1,2
1775530,1775611,81,1,0,0,1
1775530,1775623,93,1,0,0,2
1775612,1775645,33,0,0,1,1
1775624,1775646,22,0,0,1,2
1775646,1775685,39,1,0,0,1
1775647,1775684,37,1,0,0,2
1775685,1775730,45,0,0,1,2
1775686,1775729,43,0,0,1,1
1775730,1775766,36,1,0,0,1
1775731,1775766,35,1,0,0,2
1775767,1777555,1788,0,0,1,2
1775767,1777556,1789,0,0,1,1
1777556,1777811,255,1,0,0,2
1777557,1777816,259,1,0,0,1
1777580,1777788,208,0,1,0,1
1777582,1777780,198,0,1,0,2
1777812,1778010,198,0,0,1,2
1777817,1778009,192,0,0,1,1
1778010,1778078,68,1,0,0,1
1778011,1778081,70,1,0,0,2
1778079,1779174,1095,0,0,1,1
1778082,1779172,1090,0,0,1,2
1779173,1779250,77,1,0,0,2
1779175,1779248,73,1,0,0,1
1779249,1779323,74,0,0,1,1
1779251,1779322,71,0,0,1,2
1779323,1779358,35,1,0,0,2
1779324,1779357,33,1,0,0,1
1779358,1779542,184,0,0,1,1
1779359,1779545,186,0,0,1,2
1779543,1779561,18,1,0,0,1
1779546,1779572,26,1,0,0,2
1779562,1780684,1122,0,0,1,1
1779573,1780684,1111,0,0,1,2
1780685,1780751,66,1,0,0,2
1780685,1780752,67,1,0,0,1
1780752,1782901,2149,0,0,1,2
1780753,1782909,2156,0,0,1,1
1782902,1783279,377,1,0,0,2
1782910,1783277,367,1,0,0,1
1782934,1783268,334,0,1,0,2
1782936,1783266,330,0,1,0,1
1783278,1783372,94,0,0,1,1
1783280,1783353,73,0,0,1,2
1783354,1783557,203,1,0,0,2
1783373,1783552,179,1,0,0,1
1783394,1783526,132,0,1,0,2
1783394,1783529,135,0,1,0,1
1783553,1783790,237,0,0,1,1
1783558,1783783,225,0,0,1,2
1783784,1783967,183,1,0,0,2
1783791,1783949,158,1,0,0,1
1783804,1783926,122,0,1,0,2
1783806,1783928,122,0,1,0,1
1783950,1784102,152,0,0,1,1
1783968,1784103,135,0,0,1,2
1784103,1784172,69,1,0,0,1
1784104,1784178,74,1,0,0,2
1784173,1784305,132,0,0,1,1
1784179,1784305,126,0,0,1,2
1784306,1784337,31,1,0,0,2
1784306,1784338,32,1,0,0,1
1784338,1785260,922,0,0,1,2
1784339,1785259,920,0,0,1,1
1785260,1785326,66,1,0,0,1
1785261,1785313,52,1,0,0,2
1785314,1787313,1999,0,0,1,2
1785327,1787320,1993,0,0,1,1
1787314,1787528,214,1,0,0,2
1787321,1787539,218,1,0,0,1
1787343,1787496,153,0,1,0,2
1787343,1787505,162,0,1,0,1
1787529,1787910,381,0,0,1,2
1787540,1787912,372,0,0,1,1
1787911,1787965,54,1,0,0,2
1787913,1787965,52,1,0,0,1
1787966,1788557,591,0,0,1,1
1787966,1788558,592,0,0,1,2
1788558,1788632,74,1,0,0,1
1788559,1788639,80,1,0,0,2
1788633,1788734,101,0,0,1,1
1788640,1788733,93,0,0,1,2
1788734,1788769,35,1,0,0,2
1788735,1788758,23,1,0,0,1
1788759,1788988,229,0,0,1,1
1788770,1789745,975,0,0,1,2
1788989,1789000,11,1,0,0,1
1789001,1789748,747,0,0,1,1
1789746,1789817,71,1,0,0,2
1789749,1789822,73,1,0,0,1
1789818,1790062,244,0,0,1,2
1789823,1790063,240,0,0,1,1
1790063,1790099,36,1,0,0,2
1790064,1790095,31,1,0,0,1
1790096,1791836,1740,0,0,1,1
1790100,1791838,1738,0,0,1,2
1791837,1792237,400,1,0,0,1
1791839,1792238,399,1,0,0,2
1791857,1792228,371,0,1,0,2
1791863,1792226,363,0,1,0,1
1792238,1792450,212,0,0,1,1
1792239,1792434,195,0,0,1,2
1792435,1792624,189,1,0,0,2
1792451,1792616,165,1,0,0,1
1792465,1792587,122,0,1,0,2
1792466,1792594,128,0,1,0,1
1792617,1793136,519,0,0,1,1
1792625,1793136,511,0,0,1,2
1793137,1793212,75,1,0,0,1
1793137,1793217,80,1,0,0,2
1793213,1793318,105,0,0,1,1
1793218,1793316,98,0,0,1,2
1793317,1793347,30,1,0,0,2
1793319,1793337,18,1,0,0,1
1793338,1794357,1019,0,0,1,1
1793348,1794357,1009,0,0,1,2
1794358,1794413,55,1,0,0,1
1794358,1794413,55,1,0,0,2
1794414,1796332,1918,0,0,1,2
1794414,1796334,1920,0,0,1,1
1796333,1796580,247,1,0,0,2
1796335,1796561,226,1,0,0,1
1796351,1796527,176,0,1,0,2
1796354,1796535,181,0,1,0,1
1796562,1797588,1026,0,0,1,1
1796581,1797586,1005,0,0,1,2
1797587,1797666,79,1,0,0,2
1797589,1797668,79,1,0,0,1
1797667,1799371,1704,0,0,1,2
1797669,1799371,1702,0,0,1,1
1799372,1799431,59,1,0,0,1
1799372,1799443,71,1,0,0,2
1799432,1799634,202,0,0,1,1
1799444,1799634,190,0,0,1,2
1799635,1799657,22,1,0,0,2
1799635,1799667,32,1,0,0,1
1799658,1801419,1761,0,0,1,2
1799668,1801426,1758,0,0,1,1
1801420,1801673,253,1,0,0,2
1801427,1801662,235,1,0,0,1
1801443,1801632,189,0,1,0,2
1801446,1801636,190,0,1,0,1
1801663,1801769,106,0,0,1,1
1801674,1801766,92,0,0,1,2
1801767,1801996,229,1,0,0,2
1801770,1801992,222,1,0,0,1
1801792,1801960,168,0,1,0,2
1801793,1801968,175,0,1,0,1
1801993,1802822,829,0,0,1,1
1801997,1802821,824,0,0,1,2
1802822,1802893,71,1,0,0,2
1802823,1802899,76,1,0,0,1
1802894,1803278,384,0,0,1,2
1802900,1803278,378,0,0,1,1
1803279,1803354,75,1,0,0,1
1803279,1803358,79,1,0,0,2
1803355,1803445,90,0,0,1,1
1803359,1803446,87,0,0,1,2
1803446,1803481,35,1,0,0,1
1803447,1803482,35,1,0,0,2
1803482,1804652,1170,0,0,1,1
1803483,1804653,1170,0,0,1,2
1804653,1804729,76,1,0,0,1
1804654,1804727,73,1,0,0,2
1804728,1804854,126,0,0,1,2
1804730,1804856,126,0,0,1,1
1804855,1804893,38,1,0,0,2
1804857,1804889,32,1,0,0,1
1804890,1806676,1786,0,0,1,1
1804894,1806692,1798,0,0,1,2
1806677,1806931,254,1,0,0,1
1806693,1806928,235,1,0,0,2
1806707,1806906,199,0,1,0,1
1806710,1806893,183,0,1,0,2
1806929,1807027,98,0,0,1,2
1806932,1807021,89,0,0,1,1
1807022,1807231,209,1,0,0,1
1807028,1807221,193,1,0,0,2
1807043,1807203,160,0,1,0,1
1807044,1807188,144,0,1,0,2
1807222,1808170,948,0,0,1,2
1807232,1808170,938,0,0,1,1
1808171,1808235,64,1,0,0,1
1808171,1808238,67,1,0,0,2
1808236,1809838,1602,0,0,1,1
1808239,1808418,179,0,0,1,2
1808419,1808443,24,1,0,0,2
1808444,1809837,1393,0,0,1,2
1809838,1810055,217,1,0,0,2
1809839,1810049,210,1,0,0,1
1809878,1810015,137,0,1,0,2
1809879,1810016,137,0,1,0,1
1810050,1811901,1851,0,0,1,1
1810056,1811902,1846,0,0,1,2
1811902,1812085,183,1,0,0,1
1811903,1812099,196,1,0,0,2
1811920,1812058,138,0,1,0,2
1811923,1812059,136,0,1,0,1
1812086,1813480,1394,0,0,1,1
1812100,1813479,1379,0,0,1,2
1813480,1813560,80,1,0,0,2
1813481,1813557,76,1,0,0,1
1813558,1813715,157,0,0,1,1
1813561,1813713,152,0,0,1,2
1813714,1813743,29,1,0,0,2
1813716,1813737,21,1,0,0,1
1813738,1814768,1030,0,0,1,1
1813744,1814768,1024,0,0,1,2
1814769,1814835,66,1,0,0,1
1814769,1814836,67,1,0,0,2
1814836,1814968,132,0,0,1,1
1814837,1814968,131,0,0,1,2
1814969,1815002,33,1,0,0,1
1814969,1815003,34,1,0,0,2
1815003,1816829,1826,0,0,1,1
1815004,1816814,1810,0,0,1,2
1816815,1817042,227,1,0,0,2
1816830,1817032,202,1,0,0,1
1816843,1817006,163,0,1,0,2
1816846,1817009,163,0,1,0,1
1817033,1817160,127,0,0,1,1
1817043,1817152,109,0,0,1,2
1817153,1817358,205,1,0,0,2
1817161,1817361,200,1,0,0,1
1817177,1817321,144,0,1,0,2
1817177,1817335,158,0,1,0,1
1817359,1817589,230,0,0,1,2
1817362,1817590,228,0,0,1,1
1817590,1817635,45,1,0,0,2
1817591,1817633,42,1,0,0,1
1817634,1818173,539,0,0,1,1
1817636,1818174,538,0,0,1,2
1818174,1818244,70,1,0,0,1
1818175,1818254,79,1,0,0,2
1818245,1818369,124,0,0,1,1
1818255,1818370,115,0,0,1,2
1818370,1818398,28,1,0,0,1
1818371,1818398,27,1,0,0,2
1818399,1819227,828,0,0,1,1
1818399,1819228,829,0,0,1,2
1819228,1819304,76,1,0,0,1
1819229,1819305,76,1,0,0,2
1819305,1819423,118,0,0,1,1
1819306,1819423,117,0,0,1,2
1819424,1819458,34,1,0,0,2
1819424,1819461,37,1,0,0,1
1819459,1821291,1832,0,0,1,2
1819462,1821278,1816,0,0,1,1
1821279,1821547,268,1,0,0,1
1821292,1821535,243,1,0,0,2
1821301,1821518,217,0,1,0,1
1821307,1821505,198,0,1,0,2
1821536,1821695,159,0,0,1,2
1821548,1821689,141,0,0,1,1
1821690,1821898,208,1,0,0,1
1821696,1821887,191,1,0,0,2
1821713,1821850,137,0,1,0,2
1821713,1821870,157,0,1,0,1
1821888,1822469,581,0,0,1,2
1821899,1822471,572,0,0,1,1
1822470,1822521,51,1,0,0,2
1822472,1822521,49,1,0,0,1
1822522,1822614,92,0,0,1,1
1822522,1822614,92,0,0,1,2
1822615,1822645,30,1,0,0,1
1822615,1822645,30,1,0,0,2
1822646,1824226,1580,0,0,1,1
1822646,1824227,1581,0,0,1,2
1824227,1824295,68,1,0,0,1
1824228,1824300,72,1,0,0,2
1824296,1824344,48,0,0,1,1
1824301,1824343,42,0,0,1,2
1824344,1824379,35,1,0,0,2
1824345,1824376,31,1,0,0,1
1824377,1826294,1917,0,0,1,1
1824380,1826295,1915,0,0,1,2
1826295,1826532,237,1,0,0,1
1826296,1826533,237,1,0,0,2
1826322,1826492,170,0,1,0,2
1826322,1826503,181,0,1,0,1
1826533,1826770,237,0,0,1,1
1826534,1826768,234,0,0,1,2
1826769,1826834,65,1,0,0,2
1826771,1826822,51,1,0,0,1
1826823,1828030,1207,0,0,1,1
1826835,1828031,1196,0,0,1,2
1828031,1828087,56,1,0,0,1
1828032,1828088,56,1,0,0,2
1828088,1828155,67,0,0,1,1
1828089,1828154,65,0,0,1,2
1828155,1828219,64,1,0,0,2
1828156,1828241,85,1,0,0,1
1828220,1828284,64,0,0,1,2
1828242,1828285,43,0,0,1,1
1828285,1828344,59,1,0,0,2
1828286,1828331,45,1,0,0,1
1828332,1828392,60,0,0,1,1
1828345,1828391,46,0,0,1,2
1828392,1828448,56,1,0,0,2
1828393,1828432,39,1,0,0,1
1828433,1828528,95,0,0,1,1
1828449,1828529,80,0,0,1,2
1828529,1828560,31,1,0,0,1
1828530,1828561,31,1,0,0,2
1828561,1829999,1438,0,0,1,1
1828562,1829999,1437,0,0,1,2
1830000,1830060,60,1,0,0,1
1830000,1830064,64,1,0,0,2
1830061,1830265,204,0,0,1,1
1830065,1830267,202,0,0,1,2
1830266,1830298,32,1,0,0,1
1830268,1830295,27,1,0,0,2
1830296,1832030,1734,0,0,1,2
1830299,1832038,1739,0,0,1,1
1832031,1832246,215,1,0,0,2
1832039,1832248,209,1,0,0,1
1832056,1832217,161,0,1,0,2
1832058,1832222,164,0,1,0,1
1832247,1832340,93,0,0,1,2
1832249,1832342,93,0,0,1,1
1832341,1832557,216,1,0,0,2
1832343,1832555,212,1,0,0,1
1832363,1832524,161,0,1,0,2
1832364,1832529,165,0,1,0,1
1832556,1833615,1059,0,0,1,1
1832558,1833614,1056,0,0,1,2
1833615,1833687,72,1,0,0,2
1833616,1833693,77,1,0,0,1
1833688,1833756,68,0,0,1,2
1833694,1833756,62,0,0,1,1
1833757,1833777,20,1,0,0,2
1833757,1833779,22,1,0,0,1
1833778,1835441,1663,0,0,1,2
1833780,1835442,1662,0,0,1,1
1835442,1835518,76,1,0,0,2
1835443,1835515,72,1,0,0,1
1835516,1835760,244,0,0,1,1
1835519,1835766,247,0,0,1,2
1835761,1835790,29,1,0,0,1
1835767,1835791,24,1,0,0,2
1835791,1837474,1683,0,0,1,1
1835792,1837463,1671,0,0,1,2
1837464,1837732,268,1,0,0,2
1837475,1837723,248,1,0,0,1
1837487,1837700,213,0,1,0,2
1837491,1837702,211,0,1,0,1
1837724,1838106,382,0,0,1,1
1837733,1838106,373,0,0,1,2
1838107,1838157,50,1,0,0,2
1838107,1838158,51,1,0,0,1
1838158,1838803,645,0,0,1,2
1838159,1838804,645,0,0,1,1
1838804,1839015,211,1,0,0,2
1838805,1838992,187,1,0,0,1
1838823,1838972,149,0,1,0,2
1838825,1838973,148,0,1,0,1
1838993,1839080,87,0,0,1,1
1839016,1839069,53,0,0,1,2
1839070,1839276,206,1,0,0,2
1839081,1839258,177,1,0,0,1
1839096,1839239,143,0,1,0,2
1839099,1839240,141,0,1,0,1
1839259,1839456,197,0,0,1,1
1839277,1839457,180,0,0,1,2
1839457,1839530,73,1,0,0,1
1839458,1839537,79,1,0,0,2
1839531,1839599,68,0,0,1,1
1839538,1839600,62,0,0,1,2
1839600,1839634,34,1,0,0,1
1839601,1839634,33,1,0,0,2
1839635,1839870,235,0,0,1,2
1839635,1839876,241,0,0,1,1
1839871,1839901,30,1,0,0,2
1839877,1839900,23,1,0,0,1
1839901,1840772,871,0,0,1,1
1839902,1840771,869,0,0,1,2
1840772,1840818,46,1,0,0,2
1840773,1840836,63,1,0,0,1
1840819,1842803,1984,0,0,1,2
1840837,1842802,1965,0,0,1,1
1842803,1843054,251,1,0,0,1
1842804,1843053,249,1,0,0,2
1842821,1843019,198,0,1,0,2
1842821,1843031,210,0,1,0,1
1843054,1843251,197,0,0,1,2
1843055,1843252,197,0,0,1,1
1843252,1843305,53,1,0,0,2
1843253,1843305,52,1,0,0,1
1843306,1844001,695,0,0,1,2
1843306,1844003,697,0,0,1,1
1844002,1844073,71,1,0,0,2
1844004,1844066,62,1,0,0,1
1844067,1844152,85,0,0,1,1
1844074,1844152,78,0,0,1,2
1844153,1844175,22,1,0,0,1
1844153,1844185,32,1,0,0,2
1844176,1845118,942,0,0,1,1
1844186,1845117,931,0,0,1,2
1845118,1845197,79,1,0,0,2
1845119,1845195,76,1,0,0,1
1845196,1845677,481,0,0,1,1
1845198,1845676,478,0,0,1,2
1845677,1845710,33,1,0,0,2
1845678,1845698,20,1,0,0,1
1845699,1847159,1460,0,0,1,1
1845711,1847151,1440,0,0,1,2
1847152,1847447,295,1,0,0,2
1847160,1847439,279,1,0,0,1
1847170,1847409,239,0,1,0,2
1847174,1847413,239,0,1,0,1
1847440,1847509,69,0,0,1,1
1847448,1847508,60,0,0,1,2
1847509,1847709,200,1,0,0,2
1847510,1847700,190,1,0,0,1
1847531,1847673,142,0,1,0,2
1847533,1847677,144,0,1,0,1
1847701,1848377,676,0,0,1,1
1847710,1848378,668,0,0,1,2
1848378,1848467,89,1,0,0,1
1848379,1848433,54,1,0,0,2
1848434,1848459,25,0,0,1,2
1848460,1848464,4,1,0,0,2
1848465,1848526,61,0,0,1,2
1848468,1848526,58,0,0,1,1
1848527,1848581,54,1,0,0,2
1848527,1848584,57,1,0,0,1
1848582,1848687,105,0,0,1,2
1848585,1848687,102,0,0,1,1
1848688,1848707,19,1,0,0,1
1848688,1848716,28,1,0,0,2
1848708,1850034,1326,0,0,1,1
1848717,1850034,1317,0,0,1,2
1850035,1850092,57,1,0,0,2
1850035,1850093,58,1,0,0,1
1850093,1850210,117,0,0,1,2
1850094,1850209,115,0,0,1,1
1850210,1850244,34,1,0,0,1
1850211,1850246,35,1,0,0,2
1850245,1852059,1814,0,0,1,1
1850247,1852058,1811,0,0,1,2
1852059,1852266,207,1,0,0,2
1852060,1852260,200,1,0,0,1
1852081,1852227,146,0,1,0,1
1852083,1852229,146,0,1,0,2
1852261,1852332,71,0,0,1,1
1852267,1852336,69,0,0,1,2
1852333,1852541,208,1,0,0,1
1852337,1852545,208,1,0,0,2
1852354,1852511,157,0,1,0,2
1852357,1852514,157,0,1,0,1
1852542,1853645,1103,0,0,1,1
1852546,1853647,1101,0,0,1,2
1853646,1853727,81,1,0,0,1
1853648,1853727,79,1,0,0,2
1853728,1853782,54,0,0,1,1
1853728,1853783,55,0,0,1,2
1853783,1853816,33,1,0,0,1
1853784,1853817,33,1,0,0,2
1853817,1854022,205,0,0,1,1
1853818,1854015,197,0,0,1,2
1854016,1854048,32,1,0,0,2
1854023,1854037,14,1,0,0,1
1854038,1855176,1138,0,0,1,1
1854049,1855177,1128,0,0,1,2
1855177,1855227,50,1,0,0,1
1855178,1855240,62,1,0,0,2
1855228,1857233,2005,0,0,1,1
1855241,1857241,2000,0,0,1,2
1857234,1857546,312,1,0,0,1
1857242,1857533,291,1,0,0,2
1857272,1857503,231,0,1,0,2
1857272,1857511,239,0,1,0,1
1857534,1857633,99,0,0,1,2
1857547,1857618,71,0,0,1,1
1857619,1857815,196,1,0,0,1
1857634,1857817,183,1,0,0,2
1857653,1857784,131,0,1,0,2
1857654,1857784,130,0,1,0,1
1857816,1858545,729,0,0,1,1
1857818,1858544,726,0,0,1,2
1858545,1858626,81,1,0,0,2
1858546,1858626,80,1,0,0,1
1858627,1858836,209,0,0,1,1
1858627,1858836,209,0,0,1,2
1858837,1858911,74,1,0,0,2
1858837,1858920,83,1,0,0,1
1858912,1858994,82,0,0,1,2
1858921,1858994,73,0,0,1,1
1858995,1859050,55,1,0,0,2
1858995,1859063,68,1,0,0,1
1859051,1859129,78,0,0,1,2
1859064,1859126,62,0,0,1,1
1859127,1859160,33,1,0,0,1
1859130,1859161,31,1,0,0,2
1859161,1860859,1698,0,0,1,1
1859162,1860860,1698,0,0,1,2
1860860,1860935,75,1,0,0,1
1860861,1860937,76,1,0,0,2
1860936,1861148,212,0,0,1,1
1860938,1861146,208,0,0,1,2
1861147,1861164,17,1,0,0,2
1861149,1861164,15,1,0,0,1
1861165,1862915,1750,0,0,1,1
1861165,1862923,1758,0,0,1,2
1862916,1863130,214,1,0,0,1
1862924,1863115,191,1,0,0,2
1862939,1863091,152,0,1,0,1
1862940,1863088,148,0,1,0,2
1863116,1863303,187,0,0,1,2
1863131,1863304,173,0,0,1,1
1863304,1863371,67,1,0,0,2
1863305,1863359,54,1,0,0,1
1863360,1863621,261,0,0,1,1
1863372,1863619,247,0,0,1,2
1863620,1863807,187,1,0,0,2
1863622,1863807,185,1,0,0,1
1863638,1863781,143,0,1,0,1
1863640,1863770,130,0,1,0,2
1863808,1864875,1067,0,0,1,1
1863808,1864875,1067,0,0,1,2
1864876,1864941,65,1,0,0,2
1864876,1864960,84,1,0,0,1
1864942,1865021,79,0,0,1,2
1864961,1865022,61,0,0,1,1
1865022,1865045,23,1,0,0,2
1865023,1865045,22,1,0,0,1
1865046,1865188,142,0,0,1,1
1865046,1865192,146,0,0,1,2
1865189,1865216,27,1,0,0,1
1865193,1865214,21,1,0,0,2
1865215,1866678,1463,0,0,1,2
1865217,1866678,1461,0,0,1,1
1866679,1866747,68,1,0,0,2
1866679,1866749,70,1,0,0,1
1866748,1866856,108,0,0,1,2
1866750,1866856,106,0,0,1,1
1866857,1866894,37,1,0,0,1
1866857,1866894,37,1,0,0,2
1866895,1866966,71,0,0,1,2
1866895,1866967,72,0,0,1,1
1866967,1866986,19,1,0,0,2
1866968,1866988,20,1,0,0,1
1866987,1867205,218,0,0,1,2
1866989,1867213,224,0,0,1,1
1867206,1867236,30,1,0,0,2
1867214,1867225,11,1,0,0,1
1867226,1867432,206,0,0,1,1
1867237,1867428,191,0,0,1,2
1867429,1867450,21,1,0,0,2
1867433,1867460,27,1,0,0,1
1867451,1867702,251,0,0,1,2
1867461,1867705,244,0,0,1,1
1867703,1867738,35,1,0,0,2
1867706,1867734,28,1,0,0,1
1867735,1868723,988,0,0,1,1
1867739,1868708,969,0,0,1,2
1868709,1869081,372,1,0,0,2
1868724,1869081,357,1,0,0,1
1868735,1869070,335,0,1,0,2
1868740,1869070,330,0,1,0,1
1869082,1869199,117,0,0,1,2
1869082,1869204,122,0,0,1,1
1869200,1869396,196,1,0,0,2
1869205,1869383,178,1,0,0,1
1869231,1869361,130,0,1,0,2
1869233,1869360,127,0,1,0,1
1869384,1869788,404,0,0,1,1
1869397,1869787,390,0,0,1,2
1869788,1869831,43,1,0,0,2
1869789,1869833,44,1,0,0,1
1869832,1870567,735,0,0,1,2
1869834,1870568,734,0,0,1,1
1870568,1870636,68,1,0,0,2
1870569,1870641,72,1,0,0,1
1870637,1870729,92,0,0,1,2
1870642,1870729,87,0,0,1,1
1870730,1870760,30,1,0,0,1
1870730,1870761,31,1,0,0,2
1870761,1872442,1681,0,0,1,1
1870762,1872442,1680,0,0,1,2
1872443,1872508,65,1,0,0,1
1872443,1872519,76,1,0,0,2
1872509,1874477,1968,0,0,1,1
1872520,1874478,1958,0,0,1,2
1874478,1874708,230,1,0,0,1
1874479,1874717,238,1,0,0,2
1874497,1874683,186,0,1,0,2
1874499,1874684,185,0,1,0,1
1874709,1874896,187,0,0,1,1
1874718,1874891,173,0,0,1,2
1874892,1875087,195,1,0,0,2
1874897,1875072,175,1,0,0,1
1874911,1875046,135,0,1,0,2
1874914,1875048,134,0,1,0,1
1875073,1875638,565,0,0,1,1
1875088,1875637,549,0,0,1,2
1875638,1875698,60,1,0,0,2
1875639,1875697,58,1,0,0,1
1875698,1876353,655,0,0,1,1
1875699,1876353,654,0,0,1,2
1876354,1876437,83,1,0,0,2
1876354,1876453,99,1,0,0,1
1876438,1876515,77,0,0,1,2
1876454,1876515,61,0,0,1,1
1876516,1876549,33,1,0,0,2
1876516,1876569,53,1,0,0,1
1876550,1876713,163,0,0,1,2
1876570,1876712,142,0,0,1,1
1876713,1876722,9,1,0,0,1
1876714,1876724,10,1,0,0,2
1876723,1878041,1318,0,0,1,1
1876725,1878043,1318,0,0,1,2
1878042,1878100,58,1,0,0,1
1878044,1878097,53,1,0,0,2
1878098,1880069,1971,0,0,1,2
1878101,1880057,1956,0,0,1,1
1880058,1880364,306,1,0,0,1
1880070,1880379,309,1,0,0,2
1880089,1880340,251,0,1,0,1
1880090,1880338,248,0,1,0,2
1880365,1880448,83,0,0,1,1
1880380,1880452,72,0,0,1,2
1880449,1880637,188,1,0,0,1
1880453,1880645,192,1,0,0,2
1880472,1880613,141,0,1,0,2
1880473,1880614,141,0,1,0,1
1880638,1881798,1160,0,0,1,1
1880646,1881796,1150,0,0,1,2
1881797,1881880,83,1,0,0,2
1881799,1881881,82,1,0,0,1
1881881,1881979,98,0,0,1,2
1881882,1881983,101,0,0,1,1
1881980,1882009,29,1,0,0,2
1881984,1882003,19,1,0,0,1
1882004,1883068,1064,0,0,1,1
1882010,1883069,1059,0,0,1,2
1883069,1883123,54,1,0,0,1
1883070,1883124,54,1,0,0,2
1883124,1885026,1902,0,0,1,1
1883125,1885020,1895,0,0,1,2
1885021,1885281,260,1,0,0,2
1885027,1885257,230,1,0,0,1
1885039,1885239,200,0,1,0,2
1885042,1885239,197,0,1,0,1
1885258,1885363,105,0,0,1,1
1885282,1885364,82,0,0,1,2
1885364,1885447,83,1,0,0,1
1885365,1885448,83,1,0,0,2
1885448,1886248,800,0,0,1,1
1885449,1886245,796,0,0,1,2
1886246,1886291,45,1,0,0,2
1886249,1886276,27,1,0,0,1
1886277,1887807,1530,0,0,1,1
1886292,1887808,1516,0,0,1,2
1887808,1887876,68,1,0,0,1
1887809,1887874,65,1,0,0,2
1887875,1888088,213,0,0,1,2
1887877,1888088,211,0,0,1,1
1888089,1888112,23,1,0,0,2
1888089,1888119,30,1,0,0,1
1888113,1889852,1739,0,0,1,2
1888120,1889850,1730,0,0,1,1
1889851,1890109,258,1,0,0,1
1889853,1890116,263,1,0,0,2
1889873,1890079,206,0,1,0,2
1889874,1890083,209,0,1,0,1
1890110,1890208,98,0,0,1,1
1890117,1890217,100,0,0,1,2
1890209,1890417,208,1,0,0,1
1890218,1890424,206,1,0,0,2
1890239,1890378,139,0,1,0,2
1890240,1890389,149,0,1,0,1
1890418,1891459,1041,0,0,1,1
1890425,1891458,1033,0,0,1,2
1891459,1891554,95,1,0,0,2
1891460,1891537,77,1,0,0,1
1891538,1891602,64,0,0,1,1
1891555,1891600,45,0,0,1,2
1891601,1891640,39,1,0,0,2
1891603,1891639,36,1,0,0,1
1891640,1891782,142,0,0,1,1
1891641,1891781,140,0,0,1,2
1891782,1891946,164,1,0,0,2
1891783,1891939,156,1,0,0,1
1891805,1891902,97,0,1,0,2
1891806,1891906,100,0,1,0,1
1891940,1892194,254,0,0,1,1
1891947,1892196,249,0,0,1,2
1892195,1892215,20,1,0,0,1
1892197,1892220,23,1,0,0,2
1892216,1893998,1782,0,0,1,1
1892221,1893997,1776,0,0,1,2
1893998,1894068,70,1,0,0,2
1893999,1894076,77,1,0,0,1
1894069,1894965,896,0,0,1,2
1894077,1894968,891,0,0,1,1
1894966,1895000,34,1,0,0,2
1894969,1894999,30,1,0,0,1
1895000,1896063,1063,0,0,1,1
1895001,1896050,1049,0,0,1,2
1896051,1896272,221,1,0,0,2
1896064,1896254,190,1,0,0,1
1896081,1896230,149,0,1,0,2
1896085,1896231,146,0,1,0,1
1896255,1896354,99,0,0,1,1
1896273,1896355,82,0,0,1,2
1896355,1896541,186,1,0,0,1
1896356,1896541,185,1,0,0,2
1896376,1896512,136,0,1,0,2
1896377,1896515,138,0,1,0,1
1896542,1896878,336,0,0,1,1
1896542,1896878,336,0,0,1,2
1896879,1896943,64,1,0,0,1
1896879,1896947,68,1,0,0,2
1896944,1897946,1002,0,0,1,1
1896948,1897944,996,0,0,1,2
1897945,1898038,93,1,0,0,2
1897947,1898035,88,1,0,0,1
1898036,1898170,134,0,0,1,1
1898039,1898169,130,0,0,1,2
1898170,1898202,32,1,0,0,2
1898171,1898199,28,1,0,0,1
1898200,1899434,1234,0,0,1,1
1898203,1899434,1231,0,0,1,2
1899435,1899500,65,1,0,0,2
1899435,1899501,66,1,0,0,1
1899501,1899641,140,0,0,1,2
1899502,1899639,137,0,0,1,1
1899640,1899672,32,1,0,0,1
1899642,1899675,33,1,0,0,2
1899673,1901580,1907,0,0,1,1
1899676,1901573,1897,0,0,1,2
1901574,1901790,216,1,0,0,2
1901581,1901777,196,1,0,0,1
1901600,1901755,155,0,1,0,2
1901605,1901755,150,0,1,0,1
1901778,1902964,1186,0,0,1,1
1901791,1902963,1172,0,0,1,2
1902964,1903038,74,1,0,0,2
1902965,1903041,76,1,0,0,1
1903039,1903138,99,0,0,1,2
1903042,1903140,98,0,0,1,1
1903139,1903171,32,1,0,0,2
1903141,1903172,31,1,0,0,1
1903172,1904096,924,0,0,1,2
1903173,1904096,923,0,0,1,1
1904097,1904151,54,1,0,0,1
1904097,1904163,66,1,0,0,2
1904152,1906108,1956,0,0,1,1
1904164,1906096,1932,0,0,1,2
1906097,1906464,367,1,0,0,2
1906109,1906466,357,1,0,0,1
1906118,1906453,335,0,1,0,2
1906124,1906455,331,0,1,0,1
1906465,1906522,57,0,0,1,2
1906467,1906526,59,0,0,1,1
1906523,1906712,189,1,0,0,2
1906527,1906704,177,1,0,0,1
1906541,1906685,144,0,1,0,2
1906542,1906685,143,0,1,0,1
1906705,1906985,280,0,0,1,1
1906713,1906979,266,0,0,1,2
1906980,1907168,188,1,0,0,2
1906986,1907159,173,1,0,0,1
1906997,1907140,143,0,1,0,2
1907000,1907138,138,0,1,0,1
1907160,1907343,183,0,0,1,1
1907169,1907343,174,0,0,1,2
1907344,1907393,49,1,0,0,1
1907344,1907395,51,1,0,0,2
1907394,1907529,135,0,0,1,1
1907396,1907531,135,0,0,1,2
1907530,1907575,45,1,0,0,1
1907532,1907578,46,1,0,0,2
1907576,1908000,424,0,0,1,1
1907579,1907996,417,0,0,1,2
1907997,1908042,45,1,0,0,2
1908001,1908029,28,1,0,0,1
1908030,1908154,124,0,0,1,1
1908043,1908154,111,0,0,1,2
1960229,1960283,54,0,1,0,1
1960229,1960285,56,0,1,0,2
1960229,1960317,88,1,0,0,2
1960229,1960318,89,1,0,0,1
1960318,1960479,161,0,0,1,2
1960319,1960478,159,0,0,1,1
1960479,1960568,89,1,0,0,1
1960480,1960564,84,1,0,0,2
1960565,1960632,67,0,0,1,2
1960569,1960632,63,0,0,1,1
1960633,1960666,33,1,0,0,2
1960633,1960668,35,1,0,0,1
1960667,1960827,160,0,0,1,2
1960669,1960827,158,0,0,1,1
1960828,1960855,27,1,0,0,2
1960828,1960857,29,1,0,0,1
1960856,1962408,1552,0,0,1,2
1960858,1962409,1551,0,0,1,1
1962409,1962516,107,1,0,0,2
1962410,1962509,99,1,0,0,1
1962510,1962566,56,0,0,1,1
1962517,1962567,50,0,0,1,2
1962567,1962600,33,1,0,0,1
1962568,1962602,34,1,0,0,2
1962601,1962753,152,0,0,1,1
1962603,1962749,146,0,0,1,2
1962750,1962777,27,1,0,0,2
1962754,1962780,26,1,0,0,1
1962778,1964198,1420,0,0,1,2
1962781,1964200,1419,0,0,1,1
1964199,1964252,53,1,0,0,2
1964201,1964253,52,1,0,0,1
1964253,1964419,166,0,0,1,2
1964254,1965608,1354,0,0,1,1
1964420,1964450,30,1,0,0,2
1964451,1965599,1148,0,0,1,2
1965600,1965850,250,1,0,0,2
1965609,1965842,233,1,0,0,1
1965626,1965809,183,0,1,0,2
1965628,1965816,188,0,1,0,1
1965843,1966005,162,0,0,1,1
1965851,1966004,153,0,0,1,2
1966005,1966114,109,1,0,0,2
1966006,1966151,145,1,0,0,1
1966115,1966185,70,0,0,1,2
1966152,1966186,34,0,0,1,1
1966186,1966223,37,1,0,0,2
1966187,1966222,35,1,0,0,1
1966223,1966408,185,0,0,1,1
1966224,1966399,175,0,0,1,2
1966400,1966430,30,1,0,0,2
1966409,1966430,21,1,0,0,1
1966431,1967838,1407,0,0,1,2
1966431,1967841,1410,0,0,1,1
1967839,1967915,76,1,0,0,2
1967842,1967933,91,1,0,0,1
1967916,1967963,47,0,0,1,2
1967934,1967965,31,0,0,1,1
1967964,1968025,61,1,0,0,2
1967966,1968018,52,1,0,0,1
1968019,1968093,74,0,0,1,1
1968026,1968094,68,0,0,1,2
1968094,1968132,38,1,0,0,1
1968095,1968131,36,1,0,0,2
1968132,1969138,1006,0,0,1,2
1968133,1969114,981,0,0,1,1
1969115,1969373,258,1,0,0,1
1969139,1969376,237,1,0,0,2
1969160,1969348,188,0,1,0,1
1969162,1969344,182,0,1,0,2
1969374,1969493,119,0,0,1,1
1969377,1969495,118,0,0,1,2
1969494,1969668,174,1,0,0,1
1969496,1969663,167,1,0,0,2
1969515,1969617,102,0,1,0,2
1969515,1969623,108,0,1,0,1
1969664,1969737,73,0,0,1,2
1969669,1969734,65,0,0,1,1
1969735,1969790,55,1,0,0,1
1969738,1969784,46,1,0,0,2
1969785,1971238,1453,0,0,1,2
1969791,1971240,1449,0,0,1,1
1971239,1971321,82,1,0,0,2
1971241,1971311,70,1,0,0,1
1971312,1971366,54,0,0,1,1
1971322,1971366,44,0,0,1,2
1971367,1971405,38,1,0,0,1
1971367,1971407,40,1,0,0,2
1971406,1971519,113,0,0,1,1
1971408,1971514,106,0,0,1,2
1971515,1971547,32,1,0,0,2
1971520,1971547,27,1,0,0,1
1971548,1972082,534,0,0,1,1
1971548,1972931,1383,0,0,1,2
1972083,1972087,4,1,0,0,1
1972088,1972931,843,0,0,1,1
1972932,1973040,108,1,0,0,1
1972932,1973041,109,1,0,0,2
1973041,1973098,57,0,0,1,1
1973042,1973093,51,0,0,1,2
1973094,1973120,26,1,0,0,2
1973099,1973123,24,1,0,0,1
1973121,1973248,127,0,0,1,2
1973124,1973249,125,0,0,1,1
1973249,1973280,31,1,0,0,2
1973250,1973274,24,1,0,0,1
1973275,1974632,1357,0,0,1,1
1973281,1974632,1351,0,0,1,2
1974633,1974678,45,1,0,0,1
1974633,1974684,51,1,0,0,2
1974679,1974837,158,0,0,1,1
1974685,1974831,146,0,0,1,2
1974832,1974863,31,1,0,0,2
1974838,1974851,13,1,0,0,1
1974852,1976007,1155,0,0,1,1
1974864,1975992,1128,0,0,1,2
1975993,1976222,229,1,0,0,2
1976008,1976218,210,1,0,0,1
1976021,1976182,161,0,1,0,2
1976025,1976194,169,0,1,0,1
1976219,1976306,87,0,0,1,1
1976223,1976304,81,0,0,1,2
1976305,1976389,84,1,0,0,2
1976307,1976373,66,1,0,0,1
1976374,1976476,102,0,0,1,1
1976390,1976476,86,0,0,1,2
1976477,1976506,29,1,0,0,1
1976477,1976508,31,1,0,0,2
1976507,1977958,1451,0,0,1,1
1976509,1977958,1449,0,0,1,2
1977959,1978032,73,1,0,0,1
1977959,1978033,74,1,0,0,2
1978033,1978105,72,0,0,1,1
1978034,1978105,71,0,0,1,2
1978106,1978144,38,1,0,0,2
1978106,1978145,39,1,0,0,1
1978145,1978313,168,0,0,1,2
1978146,1978308,162,0,0,1,1
1978309,1978330,21,1,0,0,1
1978314,1978328,14,1,0,0,2
1978329,1979650,1321,0,0,1,2
1978331,1979652,1321,0,0,1,1
1979651,1979704,53,1,0,0,2
1979653,1979707,54,1,0,0,1
1979705,1979820,115,0,0,1,2
1979708,1979818,110,0,0,1,1
1979819,1979849,30,1,0,0,1
1979821,1979844,23,1,0,0,2
1979845,1980884,1039,0,0,1,2
1979850,1980878,1028,0,0,1,1
1980879,1981094,215,1,0,0,1
1980885,1981090,205,1,0,0,2
1980915,1981056,141,0,1,0,1
1980916,1981050,134,0,1,0,2
1981091,1981247,156,0,0,1,2
1981095,1981248,153,0,0,1,1
1981248,1981342,94,1,0,0,2
1981249,1981340,91,1,0,0,1
1981341,1981424,83,0,0,1,1
1981343,1981421,78,0,0,1,2
1981422,1981460,38,1,0,0,2
1981425,1981460,35,1,0,0,1
1981461,1982906,1445,0,0,1,1
1981461,1982907,1446,0,0,1,2
1982907,1983169,262,1,0,0,1
1982908,1983167,259,1,0,0,2
1983168,1983246,78,0,0,1,2
1983170,1983248,78,0,0,1,1
1983247,1983284,37,1,0,0,2
1983249,1983286,37,1,0,0,1
1983285,1984462,1177,0,0,1,2
1983287,1984460,1173,0,0,1,1
1984461,1984558,97,1,0,0,1
1984463,1984559,96,1,0,0,2
1984559,1984649,90,0,0,1,1
1984560,1984650,90,0,0,1,2
1984650,1984834,184,1,0,0,1
1984651,1984751,100,1,0,0,2
1984752,1984778,26,0,0,1,2
1984779,1984832,53,1,0,0,2
1984833,1984874,41,0,0,1,2
1984835,1984876,41,0,0,1,1
1984875,1984917,42,1,0,0,2
1984877,1984916,39,1,0,0,1
1984917,1985120,203,0,0,1,1
1984918,1985118,200,0,0,1,2
1985119,1985124,5,1,0,0,2
1985121,1985144,23,1,0,0,1
1985125,1985900,775,0,0,1,2
1985145,1985894,749,0,0,1,1
1985895,1986131,236,1,0,0,1
1985901,1986139,238,1,0,0,2
1985922,1986104,182,0,1,0,2
1985927,1986106,179,0,1,0,1
1986132,1986220,88,0,0,1,1
1986140,1986231,91,0,0,1,2
1986221,1986394,173,1,0,0,1
1986232,1986394,162,1,0,0,2
1986250,1986364,114,0,1,0,2
1986250,1986372,122,0,1,0,1
1986395,1986506,111,0,0,1,2
1986395,1986508,113,0,0,1,1
1986507,1986591,84,1,0,0,2
1986509,1986595,86,1,0,0,1
1986592,1986653,61,0,0,1,2
1986596,1986654,58,0,0,1,1
1986654,1986691,37,1,0,0,2
1986655,1986680,25,1,0,0,1
1986681,1986793,112,0,0,1,1
1986692,1986784,92,0,0,1,2
1986785,1986815,30,1,0,0,2
1986794,1986814,20,1,0,0,1
1986815,1988307,1492,0,0,1,1
1986816,1988308,1492,0,0,1,2
1988308,1988370,62,1,0,0,1
1988309,1988387,78,1,0,0,2
1988371,1988449,78,0,0,1,1
1988388,1988449,61,0,0,1,2
1988450,1988473,23,1,0,0,2
1988450,1988485,35,1,0,0,1
1988474,1988617,143,0,0,1,2
1988486,1988616,130,0,0,1,1
1988617,1988626,9,1,0,0,1
1988618,1988640,22,1,0,0,2
1988627,1989546,919,0,0,1,1
1988641,1989531,890,0,0,1,2
1989532,1989729,197,1,0,0,2
1989547,1989722,175,1,0,0,1
1989570,1989696,126,0,1,0,2
1989572,1989701,129,0,1,0,1
1989723,1989993,270,0,0,1,1
1989730,1989993,263,0,0,1,2
1989994,1990077,83,1,0,0,1
1989994,1990078,84,1,0,0,2
1990078,1990141,63,0,0,1,1
1990079,1990142,63,0,0,1,2
1990142,1990179,37,1,0,0,1
1990143,1990185,42,1,0,0,2
1990180,1990361,181,0,0,1,1
1990186,1990367,181,0,0,1,2
1990362,1990380,18,1,0,0,1
1990368,1990372,4,1,0,0,2
1990373,1991612,1239,0,0,1,2
1990381,1991615,1234,0,0,1,1
1991613,1991683,70,1,0,0,2
1991616,1991669,53,1,0,0,1
1991670,1991875,205,0,0,1,1
1991684,1991876,192,0,0,1,2
1991876,1991940,64,1,0,0,1
1991877,1991952,75,1,0,0,2
1991941,1992018,77,0,0,1,1
1991953,1992021,68,0,0,1,2
1992019,1992043,24,1,0,0,1
1992022,1992054,32,1,0,0,2
1992044,1993161,1117,0,0,1,1
1992055,1993160,1105,0,0,1,2
1993161,1993382,221,1,0,0,2
1993162,1993364,202,1,0,0,1
1993202,1993323,121,0,1,0,1
1993205,1993318,113,0,1,0,2
1993365,1993475,110,0,0,1,1
1993383,1993475,92,0,0,1,2
1993476,1993545,69,1,0,0,1
1993476,1993552,76,1,0,0,2
1993546,1993699,153,0,0,1,1
1993553,1993702,149,0,0,1,2
1993700,1993734,34,1,0,0,1
1993703,1993726,23,1,0,0,2
1993727,1995111,1384,0,0,1,2
1993735,1995111,1376,0,0,1,1
1995112,1995170,58,1,0,0,1
1995112,1995175,63,1,0,0,2
1995171,1995305,134,0,0,1,1
1995176,1995305,129,0,0,1,2
1995306,1995324,18,1,0,0,1
1995306,1995333,27,1,0,0,2
1995325,1996758,1433,0,0,1,1
1995334,1996757,1423,0,0,1,2
1996758,1996854,96,1,0,0,2
1996759,1996853,94,1,0,0,1
1996854,1996918,64,0,0,1,1
1996855,1996916,61,0,0,1,2
1996917,1996952,35,1,0,0,2
1996919,1996969,50,1,0,0,1
1996953,1997144,191,0,0,1,2
1996970,1997138,168,0,0,1,1
1997139,1997169,30,1,0,0,1
1997145,1997169,24,1,0,0,2
1997170,1998493,1323,0,0,1,1
1997170,1998494,1324,0,0,1,2
1998494,1998591,97,1,0,0,1
1998495,1998590,95,1,0,0,2
1998591,1998636,45,0,0,1,2
1998592,1998635,43,0,0,1,1
1998636,1998677,41,1,0,0,1
1998637,1998677,40,1,0,0,2
1998678,1998828,150,0,0,1,1
1998678,1998828,150,0,0,1,2
1998829,1998846,17,1,0,0,2
1998829,1998849,20,1,0,0,1
1998847,2000139,1292,0,0,1,2
1998850,2000140,1290,0,0,1,1
2000140,2000232,92,1,0,0,2
2000141,2000229,88,1,0,0,1
2000230,2000283,53,0,0,1,1
2000233,2000284,51,0,0,1,2
2000284,2000324,40,1,0,0,1
2000285,2000327,42,1,0,0,2
2000325,2001256,931,0,0,1,1
2000328,2001266,938,0,0,1,2
2001257,2001564,307,1,0,0,1
2001267,2001566,299,1,0,0,2
2001286,2001509,223,0,1,0,1
2001290,2001479,189,0,1,0,2
2001565,2001704,139,0,0,1,1
2001567,2001703,136,0,0,1,2
2001704,2001778,74,1,0,0,2
2001705,2001775,70,1,0,0,1
2001776,2001838,62,0,0,1,1
2001779,2001838,59,0,0,1,2
2001839,2001877,38,1,0,0,2
2001839,2001878,39,1,0,0,1
2001878,2001978,100,0,0,1,2
2001879,2001979,100,0,0,1,1
2001979,2002010,31,1,0,0,2
2001980,2002009,29,1,0,0,1
2002010,2003405,1395,0,0,1,1
2002011,2003405,1394,0,0,1,2
2003406,2003495,89,1,0,0,1
2003406,2003500,94,1,0,0,2
2003496,2003534,38,0,0,1,1
2003501,2003534,33,0,0,1,2
2003535,2003584,49,1,0,0,2
2003535,2003585,50,1,0,0,1
2003585,2003643,58,0,0,1,2
2003586,2003643,57,0,0,1,1
2003644,2003685,41,1,0,0,2
2003644,2003698,54,1,0,0,1
2003686,2003875,189,0,0,1,2
2003699,2003869,170,0,0,1,1
2003870,2003889,19,1,0,0,1
2003876,2003895,19,1,0,0,2
2003890,2005195,1305,0,0,1,1
2003896,2005194,1298,0,0,1,2
2005195,2005301,106,1,0,0,2
2005196,2005298,102,1,0,0,1
2005299,2005458,159,0,0,1,1
2005302,2005457,155,0,0,1,2
2005458,2005490,32,1,0,0,2
2005459,2005488,29,1,0,0,1
2005489,2005772,283,0,0,1,1
2005491,2005773,282,0,0,1,2
2005773,2005795,22,1,0,0,1
2005774,2005784,10,1,0,0,2
2005785,2006402,617,0,0,1,2
2005796,2006418,622,0,0,1,1
2006403,2006586,183,1,0,0,2
2006419,2006580,161,1,0,0,1
2006431,2006549,118,0,1,0,2
2006434,2006558,124,0,1,0,1
2006581,2006840,259,0,0,1,1
2006587,2006839,252,0,0,1,2
2006840,2007008,168,1,0,0,2
2006841,2006929,88,1,0,0,1
2006930,2006952,22,0,0,1,1
2006953,2007013,60,1,0,0,1
2007009,2007095,86,0,0,1,2
2007014,2007096,82,0,0,1,1
2007096,2007125,29,1,0,0,2
2007097,2007126,29,1,0,0,1
2007126,2008642,1516,0,0,1,2
2007127,2008641,1514,0,0,1,1
2008642,2008773,131,1,0,0,1
2008643,2008759,116,1,0,0,2
2008760,2008822,62,0,0,1,2
2008774,2008823,49,0,0,1,1
2008823,2008861,38,1,0,0,2
2008824,2008858,34,1,0,0,1
2008859,2008929,70,0,0,1,1
2008862,2008929,67,0,0,1,2
2008930,2008960,30,1,0,0,1
2008930,2008966,36,1,0,0,2
2008961,2009269,308,0,0,1,1
2008967,2009266,299,0,0,1,2
2009267,2009295,28,1,0,0,2
2009270,2009294,24,1,0,0,1
2009295,2009913,618,0,0,1,1
2009296,2009914,618,0,0,1,2
2009914,2010082,168,1,0,0,1
2009915,2010102,187,1,0,0,2
2009932,2010054,122,0,1,0,2
2009933,2010062,129,0,1,0,1
2010083,2010296,213,0,0,1,1
2010103,2010293,190,0,0,1,2
2010294,2010375,81,1,0,0,2
2010297,2010371,74,1,0,0,1
2010372,2010443,71,0,0,1,1
2010376,2010437,61,0,0,1,2
2010438,2010467,29,1,0,0,2
2010444,2010467,23,1,0,0,1
2010468,2011958,1490,0,0,1,1
2010468,2011959,1491,0,0,1,2
2011959,2012019,60,1,0,0,1
2011960,2012020,60,1,0,0,2
2012020,2012099,79,0,0,1,1
2012021,2012100,79,0,0,1,2
2012100,2012140,40,1,0,0,1
2012101,2012141,40,1,0,0,2
2012141,2012273,132,0,0,1,1
2012142,2012275,133,0,0,1,2
2012274,2012306,32,1,0,0,1
2012276,2012297,21,1,0,0,2
2012298,2013630,1332,0,0,1,2
2012307,2013630,1323,0,0,1,1
2013631,2013689,58,1,0,0,2
2013631,2013709,78,1,0,0,1
2013690,2013787,97,0,0,1,2
2013710,2013785,75,0,0,1,1
2013786,2013826,40,1,0,0,1
2013788,2013822,34,1,0,0,2
2013823,2015350,1527,0,0,1,2
2013827,2015349,1522,0,0,1,1
2015350,2015464,114,1,0,0,1
2015351,2015465,114,1,0,0,2
2015465,2015553,88,0,0,1,1
2015466,2015551,85,0,0,1,2
2015552,2015585,33,1,0,0,2
2015554,2015574,20,1,0,0,1
2015575,2016630,1055,0,0,1,1
2015586,2016633,1047,0,0,1,2
2016631,2016807,176,1,0,0,1
2016634,2016824,190,1,0,0,2
2016647,2016783,136,0,1,0,1
2016649,2016775,126,0,1,0,2
2016808,2016975,167,0,0,1,1
2016825,2016974,149,0,0,1,2
2016975,2017058,83,1,0,0,2
2016976,2017045,69,1,0,0,1
2017046,2017124,78,0,0,1,1
2017059,2017123,64,0,0,1,2
2017124,2017169,45,1,0,0,2
2017125,2017168,43,1,0,0,1
2017169,2018147,978,0,0,1,1
2017170,2018143,973,0,0,1,2
2018144,2018236,92,1,0,0,2
2018148,2018222,74,1,0,0,1
2018223,2018602,379,0,0,1,1
2018237,2018602,365,0,0,1,2
2018603,2018677,74,1,0,0,1
2018603,2018686,83,1,0,0,2
2018678,2018818,140,0,0,1,1
2018687,2018815,128,0,0,1,2
2018816,2018848,32,1,0,0,2
2018819,2018849,30,1,0,0,1
2018849,2020154,1305,0,0,1,2
2018850,2020156,1306,0,0,1,1
2020155,2020241,86,1,0,0,2
2020157,2020240,83,1,0,0,1
2020241,2020337,96,0,0,1,1
2020242,2020336,94,0,0,1,2
2020337,2020370,33,1,0,0,2
2020338,2020370,32,1,0,0,1
2020371,2021756,1385,0,0,1,1
2020371,2021756,1385,0,0,1,2
2021757,2021829,72,1,0,0,1
2021757,2021832,75,1,0,0,2
2021830,2021917,87,0,0,1,1
2021833,2021916,83,0,0,1,2
2021917,2021955,38,1,0,0,2
2021918,2021952,34,1,0,0,1
2021953,2022159,206,0,0,1,1
2021956,2022155,199,0,0,1,2
2022156,2022172,16,1,0,0,2
2022160,2022179,19,1,0,0,1
2022173,2023348,1175,0,0,1,2
2022180,2023347,1167,0,0,1,1
2023348,2023408,60,1,0,0,1
2023349,2023422,73,1,0,0,2
2023409,2023501,92,0,0,1,1
2023423,2023501,78,0,0,1,2
2023502,2023535,33,1,0,0,2
2023502,2023536,34,1,0,0,1
2023536,2024042,506,0,0,1,2
2023537,2024047,510,0,0,1,1
2024043,2024064,21,1,0,0,2
2024048,2024058,10,1,0,0,1
2024059,2025043,984,0,0,1,1
2024065,2025041,976,0,0,1,2
2025042,2025109,67,1,0,0,2
2025044,2025105,61,1,0,0,1
2025106,2025175,69,0,0,1,1
2025110,2025177,67,0,0,1,2
2025176,2025199,23,1,0,0,1
2025178,2025210,32,1,0,0,2
2025200,2026252,1052,0,0,1,1
2025211,2026244,1033,0,0,1,2
2026245,2026515,270,1,0,0,2
2026253,2026512,259,1,0,0,1
2026281,2026490,209,0,1,0,1
2026283,2026486,203,0,1,0,2
2026513,2026623,110,0,0,1,1
2026516,2026622,106,0,0,1,2
2026623,2026709,86,1,0,0,2
2026624,2026704,80,1,0,0,1
2026705,2026757,52,0,0,1,1
2026710,2026757,47,0,0,1,2
2026758,2026794,36,1,0,0,2
2026758,2026809,51,1,0,0,1
2026795,2026976,181,0,0,1,2
2026810,2026979,169,0,0,1,1
2026977,2027008,31,1,0,0,2
2026980,2026996,16,1,0,0,1
2026997,2027195,198,0,0,1,1
2027009,2027195,186,0,0,1,2
2027196,2027217,21,1,0,0,2
2027196,2027221,25,1,0,0,1
2027218,2028620,1402,0,0,1,2
2027222,2027538,316,0,0,1,1
2027539,2027543,4,1,0,0,1
2027544,2028619,1075,0,0,1,1
2028620,2028691,71,1,0,0,1
2028621,2028709,88,1,0,0,2
2028692,2028836,144,0,0,1,1
2028710,2028829,119,0,0,1,2
2028830,2028852,22,1,0,0,2
2028837,2028850,13,1,0,0,1
2028851,2029240,389,0,0,1,1
2028853,2029249,396,0,0,1,2
2029241,2029261,20,1,0,0,1
2029250,2029254,4,1,0,0,2
2029255,2029877,622,0,0,1,2
2029262,2029863,601,0,0,1,1
2029864,2030106,242,1,0,0,1
2029878,2030101,223,1,0,0,2
2029900,2030076,176,0,1,0,1
2029901,2030068,167,0,1,0,2
2030102,2030278,176,0,0,1,2
2030107,2030280,173,0,0,1,1
2030279,2030352,73,1,0,0,2
2030281,2030353,72,1,0,0,1
2030353,2030409,56,0,0,1,2
2030354,2030410,56,0,0,1,1
2030410,2030445,35,1,0,0,2
2030411,2030446,35,1,0,0,1
2030446,2031030,584,0,0,1,2
2030447,2031028,581,0,0,1,1
2031029,2031047,18,1,0,0,1
2031031,2031050,19,1,0,0,2
2031048,2032024,976,0,0,1,1
2031051,2032025,974,0,0,1,2
2032025,2032108,83,1,0,0,1
2032026,2032111,85,1,0,0,2
2032109,2032177,68,0,0,1,1
2032112,2032178,66,0,0,1,2
2032178,2032218,40,1,0,0,1
2032179,2032218,39,1,0,0,2
2032219,2032712,493,0,0,1,1
2032219,2032715,496,0,0,1,2
2032713,2032741,28,1,0,0,1
2032716,2032731,15,1,0,0,2
2032732,2033431,699,0,0,1,2
2032742,2033428,686,0,0,1,1
2033429,2033626,197,1,0,0,1
2033432,2033646,214,1,0,0,2
2033448,2033609,161,0,1,0,1
2033450,2033604,154,0,1,0,2
2033627,2033736,109,0,0,1,1
2033647,2033735,88,0,0,1,2
2033736,2033822,86,1,0,0,2
2033737,2033823,86,1,0,0,1
2033823,2033897,74,0,0,1,2
2033824,2033897,73,0,0,1,1
2033898,2033924,26,1,0,0,1
2033898,2033924,26,1,0,0,2
2033925,2035305,1380,0,0,1,1
2033925,2035306,1381,0,0,1,2
2035306,2035394,88,1,0,0,1
2035307,2035390,83,1,0,0,2
2035391,2035461,70,0,0,1,2
2035395,2035460,65,0,0,1,1
2035461,2035504,43,1,0,0,1
2035462,2035520,58,1,0,0,2
2035505,2037154,1649,0,0,1,1
2035521,2035958,437,0,0,1,2
2035959,2035984,25,1,0,0,2
2035985,2037153,1168,0,0,1,2
2037154,2037234,80,1,0,0,2
2037155,2037234,79,1,0,0,1
2037235,2037369,134,0,0,1,2
2037235,2037371,136,0,0,1,1
2037370,2037405,35,1,0,0,2
2037372,2037406,34,1,0,0,1
2037406,2038767,1361,0,0,1,2
2037407,2038768,1361,0,0,1,1
2038768,2038838,70,1,0,0,2
2038769,2038853,84,1,0,0,1
2038839,2038898,59,0,0,1,2
2038854,2038897,43,0,0,1,1
2038898,2038933,35,1,0,0,1
2038899,2038934,35,1,0,0,2
2038934,2039117,183,0,0,1,1
2038935,2039123,188,0,0,1,2
2039118,2039135,17,1,0,0,1
2039124,2039143,19,1,0,0,2
2039136,2040125,989,0,0,1,1
2039144,2039302,158,0,0,1,2
2039303,2039315,12,1,0,0,2
2039316,2040112,796,0,0,1,2
2040113,2040329,216,1,0,0,2
2040126,2040335,209,1,0,0,1
2040146,2040295,149,0,1,0,2
2040147,2040299,152,0,1,0,1
2040330,2040432,102,0,0,1,2
2040336,2040431,95,0,0,1,1
2040432,2040515,83,1,0,0,1
2040433,2040526,93,1,0,0,2
2040516,2040626,110,0,0,1,1
2040527,2040626,99,0,0,1,2
2040627,2040662,35,1,0,0,2
2040627,2040663,36,1,0,0,1
2040663,2041679,1016,0,0,1,2
2040664,2041670,1006,0,0,1,1
2041671,2041820,149,1,0,0,1
2041680,2041836,156,1,0,0,2
2041693,2041799,106,0,1,0,1
2041698,2041804,106,0,1,0,2
2041821,2042073,252,0,0,1,1
2041837,2042074,237,0,0,1,2
2042074,2042140,66,1,0,0,1
2042075,2042145,70,1,0,0,2
2042141,2042279,138,0,0,1,1
2042146,2042281,135,0,0,1,2
2042280,2042303,23,1,0,0,1
2042282,2042296,14,1,0,0,2
2042297,2043984,1687,0,0,1,2
2042304,2043978,1674,0,0,1,1
2043979,2044194,215,1,0,0,1
2043985,2044194,209,1,0,0,2
2044008,2044152,144,0,1,0,2
2044009,2044164,155,0,1,0,1
2044195,2044643,448,0,0,1,2
2044195,2044645,450,0,0,1,1
2044644,2044699,55,1,0,0,2
2044646,2044697,51,1,0,0,1
2044698,2045566,868,0,0,1,1
2044700,2045557,857,0,0,1,2
2045558,2045752,194,1,0,0,2
2045567,2045748,181,1,0,0,1
2045582,2045716,134,0,1,0,1
2045583,2045708,125,0,1,0,2
2045749,2047746,1997,0,0,1,1
2045753,2047747,1994,0,0,1,2
2047747,2047947,200,1,0,0,1
2047748,2047948,200,1,0,0,2
2047771,2047906,135,0,1,0,2
2047773,2047914,141,0,1,0,1
2047948,2048407,459,0,0,1,1
2047949,2048408,459,0,0,1,2
2048408,2048490,82,1,0,0,1
2048409,2048497,88,1,0,0,2
2048491,2048590,99,0,0,1,1
2048498,2048590,92,0,0,1,2
2048591,2048620,29,1,0,0,1
2048591,2048622,31,1,0,0,2
2048621,2050564,1943,0,0,1,1
2048623,2050564,1941,0,0,1,2
2050565,2050618,53,1,0,0,2
2050565,2050619,54,1,0,0,1
2050619,2050786,167,0,0,1,2
2050620,2050781,161,0,0,1,1
2050782,2050813,31,1,0,0,1
2050787,2050811,24,1,0,0,2
2050812,2052619,1807,0,0,1,2
2050814,2052616,1802,0,0,1,1
2052617,2052862,245,1,0,0,1
2052620,2052856,236,1,0,0,2
2052643,2052840,197,0,1,0,1
2052646,2052820,174,0,1,0,2
2052857,2054401,1544,0,0,1,2
2052863,2054402,1539,0,0,1,1
2054402,2054576,174,1,0,0,2
2054403,2054578,175,1,0,0,1
2054418,2054550,132,0,1,0,1
2054419,2054540,121,0,1,0,2
2054577,2054687,110,0,0,1,2
2054579,2054686,107,0,0,1,1
2054687,2054757,70,1,0,0,1
2054688,2054759,71,1,0,0,2
2054758,2054890,132,0,0,1,1
2054760,2054888,128,0,0,1,2
2054889,2054917,28,1,0,0,2
2054891,2054907,16,1,0,0,1
2054908,2056426,1518,0,0,1,1
2054918,2056425,1507,0,0,1,2
2056426,2056493,67,1,0,0,2
2056427,2056482,55,1,0,0,1
2056483,2056607,124,0,0,1,1
2056494,2056606,112,0,0,1,2
2056607,2056629,22,1,0,0,2
2056608,2056626,18,1,0,0,1
2056627,2058532,1905,0,0,1,1
2056630,2058523,1893,0,0,1,2
2058524,2058724,200,1,0,0,2
2058533,2058716,183,1,0,0,1
2058546,2058688,142,0,1,0,2
2058548,2058698,150,0,1,0,1
2058717,2060356,1639,0,0,1,1
2058725,2060356,1631,0,0,1,2
2060357,2060435,78,1,0,0,2
2060357,2060469,112,1,0,0,1
2060436,2060763,327,0,0,1,2
2060470,2060766,296,0,0,1,1
2060764,2060782,18,1,0,0,2
2060767,2060796,29,1,0,0,1
2060783,2061863,1080,0,0,1,2
2060797,2061863,1066,0,0,1,1
2061864,2061932,68,1,0,0,2
2061864,2061953,89,1,0,0,1
2061933,2063518,1585,0,0,1,2
2061954,2063512,1558,0,0,1,1
2063513,2063687,174,1,0,0,1
2063519,2063673,154,1,0,0,2
2063543,2063638,95,0,1,0,1
2063544,2063635,91,0,1,0,2
2063674,2064420,746,0,0,1,2
2063688,2064422,734,0,0,1,1
2064421,2064493,72,1,0,0,2
2064423,2064502,79,1,0,0,1
2064494,2064769,275,0,0,1,2
2064503,2064771,268,0,0,1,1
2064770,2064940,170,1,0,0,2
2064772,2064948,176,1,0,0,1
2064791,2064912,121,0,1,0,2
2064793,2064921,128,0,1,0,1
2064941,2065143,202,0,0,1,2
2064949,2065144,195,0,0,1,1
2065144,2065198,54,1,0,0,2
2065145,2065200,55,1,0,0,1
2065199,2065398,199,0,0,1,2
2065201,2065401,200,0,0,1,1
2065399,2065476,77,1,0,0,2
2065402,2065479,77,1,0,0,1
2065477,2065566,89,0,0,1,2
2065480,2065566,86,0,0,1,1
2065567,2065599,32,1,0,0,2
2065567,2065600,33,1,0,0,1
2065600,2065740,140,0,0,1,2
2065601,2065740,139,0,0,1,1
2065741,2065756,15,1,0,0,1
2065741,2065769,28,1,0,0,2
2065757,2067023,1266,0,0,1,1
2065770,2067025,1255,0,0,1,2
2067024,2067080,56,1,0,0,1
2067026,2067095,69,1,0,0,2
2067081,2067224,143,0,0,1,1
2067096,2067224,128,0,0,1,2
2067225,2067257,32,1,0,0,2
2067225,2067258,33,1,0,0,1
2067258,2069093,1835,0,0,1,2
2067259,2069083,1824,0,0,1,1
2069084,2069299,215,1,0,0,1
2069094,2069293,199,1,0,0,2
2069123,2069254,131,0,1,0,2
2069124,2069256,132,0,1,0,1
2069294,2069323,29,0,0,1,2
2069300,2069324,24,0,0,1,1
2069324,2069571,247,1,0,0,2
2069325,2069569,244,1,0,0,1
2069349,2069539,190,0,1,0,2
2069352,2069547,195,0,1,0,1
2069570,2069652,82,0,0,1,1
2069572,2069655,83,0,0,1,2
2069653,2069816,163,1,0,0,1
2069656,2069828,172,1,0,0,2
2069676,2069786,110,0,1,0,2
2069677,2069792,115,0,1,0,1
2069817,2069947,130,0,0,1,1
2069829,2069948,119,0,0,1,2
2069948,2070013,65,1,0,0,1
2069949,2070027,78,1,0,0,2
2070014,2070816,802,0,0,1,1
2070028,2070820,792,0,0,1,2
2070817,2070917,100,1,0,0,1
2070821,2070919,98,1,0,0,2
2070918,2071017,99,0,0,1,1
2070920,2071016,96,0,0,1,2
2071017,2071053,36,1,0,0,2
2071018,2071052,34,1,0,0,1
2071053,2072673,1620,0,0,1,1
2071054,2072672,1618,0,0,1,2
2072673,2072746,73,1,0,0,2
2072674,2072730,56,1,0,0,1
2072731,2072798,67,0,0,1,1
2072747,2072798,51,0,0,1,2
2072799,2072835,36,1,0,0,1
2072799,2072835,36,1,0,0,2
2072836,2073082,246,0,0,1,2
2072836,2073088,252,0,0,1,1
2073083,2073113,30,1,0,0,2
2073089,2073103,14,1,0,0,1
2073104,2074714,1610,0,0,1,1
2073114,2074726,1612,0,0,1,2
2074715,2074995,280,1,0,0,1
2074727,2074985,258,1,0,0,2
2074742,2074966,224,0,1,0,1
2074744,2074954,210,0,1,0,2
2074986,2075118,132,0,0,1,2
2074996,2075130,134,0,0,1,1
2075119,2075318,199,1,0,0,2
2075131,2075321,190,1,0,0,1
2075150,2075288,138,0,1,0,2
2075152,2075295,143,0,1,0,1
2075319,2076701,1382,0,0,1,2
2075322,2076702,1380,0,0,1,1
2076702,2076791,89,1,0,0,2
2076703,2076779,76,1,0,0,1
2076780,2078338,1558,0,0,1,1
2076792,2078340,1548,0,0,1,2
2078339,2078387,48,1,0,0,1
2078341,2078391,50,1,0,0,2
2078388,2080372,1984,0,0,1,1
2078392,2080370,1978,0,0,1,2
2080371,2080693,322,1,0,0,2
2080373,2080692,319,1,0,0,1
2080418,2080659,241,0,1,0,2
2080421,2080668,247,0,1,0,1
2080693,2080803,110,0,0,1,1
2080694,2080809,115,0,0,1,2
2080804,2080993,189,1,0,0,1
2080810,2080993,183,1,0,0,2
2080831,2080959,128,0,1,0,2
2080832,2080966,134,0,1,0,1
2080994,2081166,172,0,0,1,2
2080994,2081168,174,0,0,1,1
2081167,2081232,65,1,0,0,2
2081169,2081219,50,1,0,0,1
2081220,2082246,1026,0,0,1,1
2081233,2082244,1011,0,0,1,2
2082245,2082324,79,1,0,0,2
2082247,2082324,77,1,0,0,1
2082325,2082490,165,0,0,1,1
2082325,2082491,166,0,0,1,2
2082491,2082523,32,1,0,0,1
2082492,2082518,26,1,0,0,2
2082519,2083795,1276,0,0,1,2
2082524,2083797,1273,0,0,1,1
2083796,2083867,71,1,0,0,2
2083798,2083849,51,1,0,0,1
2083850,2084245,395,0,0,1,1
2083868,2084245,377,0,0,1,2
2084246,2084277,31,1,0,0,1
2084246,2084279,33,1,0,0,2
2084278,2085851,1573,0,0,1,1
2084280,2085853,1573,0,0,1,2
2085852,2086080,228,1,0,0,1
2085854,2086100,246,1,0,0,2
2085878,2086050,172,0,1,0,2
2085881,2086058,177,0,1,0,1
2086081,2086227,146,0,0,1,1
2086101,2086222,121,0,0,1,2
2086223,2086438,215,1,0,0,2
2086228,2086434,206,1,0,0,1
2086244,2086400,156,0,1,0,2
2086249,2086409,160,0,1,0,1
2086435,2087220,785,0,0,1,1
2086439,2087219,780,0,0,1,2
2087220,2087268,48,1,0,0,2
2087221,2087269,48,1,0,0,1
2087269,2087443,174,0,0,1,2
2087270,2087443,173,0,0,1,1
2087444,2087522,78,1,0,0,1
2087444,2087528,84,1,0,0,2
2087523,2087629,106,0,0,1,1
2087529,2087628,99,0,0,1,2
2087629,2087661,32,1,0,0,2
2087630,2087668,38,1,0,0,1
2087662,2088977,1315,0,0,1,2
2087669,2088977,1308,0,0,1,1
2088978,2089043,65,1,0,0,1
2088978,2089043,65,1,0,0,2
2089044,2089603,559,0,0,1,2
2089044,2089610,566,0,0,1,1
2089604,2089634,30,1,0,0,2
2089611,2089622,11,1,0,0,1
2089623,2091021,1398,0,0,1,1
2089635,2091024,1389,0,0,1,2
2091022,2091283,261,1,0,0,1
2091025,2091268,243,1,0,0,2
2091039,2091251,212,0,1,0,1
2091042,2091231,189,0,1,0,2
2091269,2091420,151,0,0,1,2
2091284,2091415,131,0,0,1,1
2091416,2091627,211,1,0,0,1
2091421,2091638,217,1,0,0,2
2091438,2091593,155,0,1,0,2
2091438,2091604,166,0,1,0,1
2091628,2092635,1007,0,0,1,1
2091639,2092636,997,0,0,1,2
2092636,2092739,103,1,0,0,1
2092637,2092723,86,1,0,0,2
2092724,2092813,89,0,0,1,2
2092740,2092813,73,0,0,1,1
2092814,2092848,34,1,0,0,1
2092814,2092859,45,1,0,0,2
2092849,2093927,1078,0,0,1,1
2092860,2093926,1066,0,0,1,2
2093927,2094005,78,1,0,0,2
2093928,2094000,72,1,0,0,1
2094001,2094099,98,0,0,1,1
2094006,2094099,93,0,0,1,2
2094100,2094140,40,1,0,0,1
2094100,2094142,42,1,0,0,2
2094141,2095950,1809,0,0,1,1
2094143,2095938,1795,0,0,1,2
2095939,2096163,224,1,0,0,2
2095951,2096156,205,1,0,0,1
2095965,2096121,156,0,1,0,2
2095971,2096129,158,0,1,0,1
2096157,2096323,166,0,0,1,1
2096164,2096322,158,0,0,1,2
2096323,2096516,193,1,0,0,2
2096324,2096502,178,1,0,0,1
2096340,2096472,132,0,1,0,2
2096342,2096477,135,0,1,0,1
2096503,2097291,788,0,0,1,1
2096517,2097292,775,0,0,1,2
2097292,2097360,68,1,0,0,1
2097293,2097370,77,1,0,0,2
2097361,2097464,103,0,0,1,1
2097371,2097465,94,0,0,1,2
2097465,2097491,26,1,0,0,1
2097466,2097485,19,1,0,0,2
2097486,2098803,1317,0,0,1,2
2097492,2098803,1311,0,0,1,1
2098804,2098880,76,1,0,0,1
2098804,2098882,78,1,0,0,2
2098881,2098950,69,0,0,1,1
2098883,2098949,66,0,0,1,2
2098950,2098988,38,1,0,0,2
2098951,2098992,41,1,0,0,1
2098989,2100836,1847,0,0,1,2
2098993,2100832,1839,0,0,1,1
2100833,2101088,255,1,0,0,1
2100837,2101082,245,1,0,0,2
2100862,2101049,187,0,1,0,2
2100862,2101063,201,0,1,0,1
2101083,2101277,194,0,0,1,2
2101089,2101279,190,0,0,1,1
2101278,2101459,181,1,0,0,2
2101280,2101460,180,1,0,0,1
2101294,2101426,132,0,1,0,2
2101295,2101433,138,0,1,0,1
2101460,2102348,888,0,0,1,2
2101461,2102349,888,0,0,1,1
2102349,2102441,92,1,0,0,2
2102350,2102430,80,1,0,0,1
2102431,2102498,67,0,0,1,1
2102442,2102496,54,0,0,1,2
2102497,2102532,35,1,0,0,2
2102499,2102529,30,1,0,0,1
2102530,2102702,172,0,0,1,1
2102533,2102700,167,0,0,1,2
2102701,2102729,28,1,0,0,2
2102703,2102720,17,1,0,0,1
2102721,2103938,1217,0,0,1,1
2102730,2103936,1206,0,0,1,2
2103937,2103992,55,1,0,0,2
2103939,2103988,49,1,0,0,1
2103989,2104146,157,0,0,1,1
2103993,2104144,151,0,0,1,2
2104145,2104179,34,1,0,0,2
2104147,2104179,32,1,0,0,1
2104180,2105971,1791,0,0,1,2
2104180,2105982,1802,0,0,1,1
2105972,2106241,269,1,0,0,2
2105983,2106238,255,1,0,0,1
2106015,2106205,190,0,1,0,2
2106018,2106213,195,0,1,0,1
2106239,2106332,93,0,0,1,1
2106242,2106337,95,0,0,1,2
2106333,2106516,183,1,0,0,1
2106338,2106521,183,1,0,0,2
2106359,2106483,124,0,1,0,2
2106361,2106491,130,0,1,0,1
2106517,2107709,1192,0,0,1,1
2106522,2107706,1184,0,0,1,2
2107707,2107781,74,1,0,0,2
2107710,2107786,76,1,0,0,1
2107782,2107873,91,0,0,1,2
2107787,2107876,89,0,0,1,1
2107874,2107907,33,1,0,0,2
2107877,2107899,22,1,0,0,1
2107900,2109195,1295,0,0,1,1
2107908,2109194,1286,0,0,1,2
2109195,2109246,51,1,0,0,2
2109196,2109245,49,1,0,0,1
2109246,2111223,1977,0,0,1,1
2109247,2111220,1973,0,0,1,2
2111221,2111468,247,1,0,0,2
2111224,2111464,240,1,0,0,1
2111253,2111429,176,0,1,0,2
2111256,2111436,180,0,1,0,1
2111465,2111747,282,0,0,1,1
2111469,2111749,280,0,0,1,2
2111748,2111938,190,1,0,0,1
2111750,2111964,214,1,0,0,2
2111769,2111917,148,0,1,0,2
2111771,2111917,146,0,1,0,1
2111939,2112435,496,0,0,1,1
2111965,2112435,470,0,0,1,2
2112436,2112499,63,1,0,0,1
2112436,2112501,65,1,0,0,2
2112500,2112865,365,0,0,1,1
2112502,2112864,362,0,0,1,2
2112865,2112935,70,1,0,0,2
2112866,2112934,68,1,0,0,1
2112935,2113058,123,0,0,1,1
2112936,2113056,120,0,0,1,2
2113057,2113089,32,1,0,0,2
2113059,2113082,23,1,0,0,1
2113083,2114049,966,0,0,1,1
2113090,2114050,960,0,0,1,2
2114050,2114114,64,1,0,0,1
2114051,2114101,50,1,0,0,2
2114102,2116116,2014,0,0,1,2
2114115,2116121,2006,0,0,1,1
2116117,2116299,182,1,0,0,2
2116122,2116302,180,1,0,0,1
2116154,2116257,103,0,1,0,2
2116154,2116261,107,0,1,0,1
2116300,2116475,175,0,0,1,2
2116303,2116473,170,0,0,1,1
2116474,2116650,176,1,0,0,1
2116476,2116656,180,1,0,0,2
2116496,2116622,126,0,1,0,2
2116498,2116625,127,0,1,0,1
2116651,2117394,743,0,0,1,1
2116657,2117394,737,0,0,1,2
2117395,2117480,85,1,0,0,2
2117395,2117483,88,1,0,0,1
2117481,2117592,111,0,0,1,2
2117484,2117599,115,0,0,1,1
2117593,2117612,19,1,0,0,2
2117600,2117612,12,1,0,0,1
2117613,2118777,1164,0,0,1,2
2117613,2118778,1165,0,0,1,1
2118778,2118829,51,1,0,0,2
2118779,2118833,54,1,0,0,1
2118830,2120860,2030,0,0,1,2
2118834,2120854,2020,0,0,1,1
2120855,2121120,265,1,0,0,1
2120861,2121121,260,1,0,0,2
2120878,2121094,216,0,1,0,1
2120880,2121089,209,0,1,0,2
2121121,2122304,1183,0,0,1,1
2121122,2122303,1181,0,0,1,2
2122304,2122385,81,1,0,0,2
2122305,2122386,81,1,0,0,1
2122386,2122485,99,0,0,1,2
2122387,2122482,95,0,0,1,1
2122483,2122505,22,1,0,0,1
2122486,2122508,22,1,0,0,2
2122506,2122677,171,0,0,1,1
2122509,2122672,163,0,0,1,2
2122673,2122696,23,1,0,0,2
2122678,2122696,18,1,0,0,1
2122697,2123665,968,0,0,1,1
2122697,2123665,968,0,0,1,2
2123666,2123727,61,1,0,0,1
2123666,2123739,73,1,0,0,2
2123728,2123857,129,0,0,1,1
2123740,2123856,116,0,0,1,2
2123857,2123893,36,1,0,0,2
2123858,2123893,35,1,0,0,1
2123894,2124118,224,0,0,1,1
2123894,2124122,228,0,0,1,2
2124119,2124148,29,1,0,0,1
2124123,2124135,12,1,0,0,2
2124136,2125710,1574,0,0,1,2
2124149,2125715,1566,0,0,1,1
2125711,2125975,264,1,0,0,2
2125716,2125955,239,1,0,0,1
2125737,2125926,189,0,1,0,2
2125737,2125939,202,0,1,0,1
2125956,2127185,1229,0,0,1,1
2125976,2127184,1208,0,0,1,2
2127185,2127251,66,1,0,0,2
2127186,2127252,66,1,0,0,1
2127252,2127324,72,0,0,1,2
2127253,2127326,73,0,0,1,1
2127325,2127358,33,1,0,0,2
2127327,2127356,29,1,0,0,1
2127357,2129123,1766,0,0,1,1
2127359,2129119,1760,0,0,1,2
2129120,2129187,67,1,0,0,2
2129124,2129175,51,1,0,0,1
2129176,2129387,211,0,0,1,1
2129188,2129386,198,0,0,1,2
2129387,2129408,21,1,0,0,2
2129388,2129419,31,1,0,0,1
2129409,2131166,1757,0,0,1,2
2129420,2131169,1749,0,0,1,1
2131167,2131523,356,1,0,0,2
2131170,2131522,352,1,0,0,1
2131192,2131481,289,0,1,0,2
2131195,2131489,294,0,1,0,1
2131523,2131659,136,0,0,1,1
2131524,2131654,130,0,0,1,2
2131655,2131850,195,1,0,0,2
2131660,2131842,182,1,0,0,1
2131675,2131820,145,0,1,0,2
2131681,2131821,140,0,1,0,1
2131843,2132154,311,0,0,1,1
2131851,2132149,298,0,0,1,2
2132150,2132364,214,1,0,0,2
2132155,2132355,200,1,0,0,1
2132176,2132328,152,0,1,0,2
2132177,2132332,155,0,1,0,1
2132356,2133138,782,0,0,1,1
2132365,2133138,773,0,0,1,2
2133139,2133204,65,1,0,0,2
2133139,2133205,66,1,0,0,1
2133205,2133289,84,0,0,1,2
2133206,2133290,84,0,0,1,1
2133290,2133326,36,1,0,0,2
2133291,2133324,33,1,0,0,1
2133325,2134541,1216,0,0,1,1
2133327,2134541,1214,0,0,1,2
2134542,2134591,49,1,0,0,1
2134542,2134597,55,1,0,0,2
2134592,2136568,1976,0,0,1,1
2134598,2136577,1979,0,0,1,2
2136569,2136895,326,1,0,0,1
2136578,2136909,331,1,0,0,2
2136602,2136869,267,0,1,0,1
2136603,2136861,258,0,1,0,2
2136896,2136997,101,0,0,1,1
2136910,2136997,87,0,0,1,2
2136998,2137177,179,1,0,0,1
2136998,2137184,186,1,0,0,2
2137018,2137150,132,0,1,0,2
2137020,2137154,134,0,1,0,1
2137178,2138186,1008,0,0,1,1
2137185,2138186,1001,0,0,1,2
2138187,2138259,72,1,0,0,1
2138187,2138265,78,1,0,0,2
2138260,2138331,71,0,0,1,1
2138266,2138331,65,0,0,1,2
2138332,2138373,41,1,0,0,1
2138332,2138382,50,1,0,0,2
2138374,2138443,69,0,0,1,1
2138383,2138442,59,0,0,1,2
2138443,2138478,35,1,0,0,2
2138444,2138481,37,1,0,0,1
2138479,2139721,1242,0,0,1,2
2138482,2139720,1238,0,0,1,1
2139721,2139770,49,1,0,0,1
2139722,2139785,63,1,0,0,2
2139771,2139943,172,0,0,1,1
2139786,2139947,161,0,0,1,2
2139944,2139972,28,1,0,0,1
2139948,2139965,17,1,0,0,2
2139966,2140063,97,0,0,1,2
2139973,2140065,92,0,0,1,1
2140064,2140089,25,1,0,0,2
2140066,2140082,16,1,0,0,1
2140083,2141762,1679,0,0,1,1
2140090,2141767,1677,0,0,1,2
2141763,2142087,324,1,0,0,1
2141768,2142081,313,1,0,0,2
2141801,2142055,254,0,1,0,1
2141802,2142049,247,0,1,0,2
2142082,2142209,127,0,0,1,2
2142088,2142179,91,0,0,1,1
2142180,2142394,214,1,0,0,1
2142210,2142394,184,1,0,0,2
2142229,2142359,130,0,1,0,2
2142231,2142362,131,0,1,0,1
2142395,2142650,255,0,0,1,2
2142395,2142651,256,0,0,1,1
2142651,2142722,71,1,0,0,2
2142652,2142725,73,1,0,0,1
2142723,2143108,385,0,0,1,2
2142726,2143108,382,0,0,1,1
2143109,2143146,37,1,0,0,2
2143109,2143152,43,1,0,0,1
2143147,2143262,115,0,0,1,2
2143153,2143263,110,0,0,1,1
2143263,2143345,82,1,0,0,2
2143264,2143346,82,1,0,0,1
2143346,2143412,66,0,0,1,2
2143347,2143413,66,0,0,1,1
2143413,2143449,36,1,0,0,2
2143414,2143449,35,1,0,0,1
2143450,2143610,160,0,0,1,1
2143450,2143615,165,0,0,1,2
2143611,2143640,29,1,0,0,1
2143616,2143631,15,1,0,0,2
2143632,2144914,1282,0,0,1,2
2143641,2144914,1273,0,0,1,1
2144915,2144982,67,1,0,0,1
2144915,2144986,71,1,0,0,2
2144983,2145094,111,0,0,1,1
2144987,2145091,104,0,0,1,2
2145092,2145129,37,1,0,0,2
2145095,2145126,31,1,0,0,1
2145127,2146989,1862,0,0,1,1
2145130,2146989,1859,0,0,1,2
2146990,2147196,206,1,0,0,1
2146990,2147204,214,1,0,0,2
2147005,2147170,165,0,1,0,2
2147010,2147176,166,0,1,0,1
2147197,2148691,1494,0,0,1,1
2147205,2148690,1485,0,0,1,2
2148691,2148769,78,1,0,0,2
2148692,2148772,80,1,0,0,1
2148770,2148885,115,0,0,1,2
2148773,2148885,112,0,0,1,1
2148886,2148905,19,1,0,0,2
2148886,2148917,31,1,0,0,1
2148906,2149913,1007,0,0,1,2
2148918,2149914,996,0,0,1,1
2149914,2149981,67,1,0,0,2
2149915,2149969,54,1,0,0,1
2149970,2151963,1993,0,0,1,1
2149982,2151970,1988,0,0,1,2
2151964,2152226,262,1,0,0,1
2151971,2152249,278,1,0,0,2
2151993,2152194,201,0,1,0,2
2151996,2152203,207,0,1,0,1
2152227,2152393,166,0,0,1,1
2152250,2152387,137,0,0,1,2
2152388,2152581,193,1,0,0,2
2152394,2152562,168,1,0,0,1
2152409,2152537,128,0,1,0,2
2152412,2152542,130,0,1,0,1
2152563,2153315,752,0,0,1,1
2152582,2153315,733,0,0,1,2
2153316,2153363,47,1,0,0,2
2153316,2153394,78,1,0,0,1
2153364,2153480,116,0,0,1,2
2153395,2153478,83,0,0,1,1
2153479,2153517,38,1,0,0,1
2153481,2153517,36,1,0,0,2
2153518,2154860,1342,0,0,1,1
2153518,2154862,1344,0,0,1,2
2154861,2154915,54,1,0,0,1
2154863,2154942,79,1,0,0,2
2154916,2155073,157,0,0,1,1
2154943,2155065,122,0,0,1,2
2155066,2155096,30,1,0,0,2
2155074,2155091,17,1,0,0,1
2155092,2157004,1912,0,0,1,1
2155097,2157010,1913,0,0,1,2
2157005,2157210,205,1,0,0,1
2157011,2157209,198,1,0,0,2
2157025,2157182,157,0,1,0,1
2157029,2157168,139,0,1,0,2
2157210,2158457,1247,0,0,1,2
2157211,2158458,1247,0,0,1,1
2158458,2158509,51,1,0,0,2
2158459,2158512,53,1,0,0,1
2158510,2158756,246,0,0,1,2
2158513,2158750,237,0,0,1,1
2158751,2158766,15,1,0,0,1
2158757,2158774,17,1,0,0,2
2158767,2160246,1479,0,0,1,1
2158775,2160003,1228,0,0,1,2
2160004,2160008,4,1,0,0,2
2160009,2160246,237,0,0,1,2
2160247,2160292,45,1,0,0,1
2160247,2160318,71,1,0,0,2
2160293,2160363,70,0,0,1,1
2160319,2160364,45,0,0,1,2
2160364,2160417,53,1,0,0,1
2160365,2160401,36,1,0,0,2
2160402,2162267,1865,0,0,1,2
2160418,2162272,1854,0,0,1,1
2162268,2162717,449,1,0,0,2
2162273,2162707,434,1,0,0,1
2162300,2162489,189,0,1,0,1
2162301,2162482,181,0,1,0,2
2162545,2162675,130,0,1,0,2
2162547,2162681,134,0,1,0,1
2162708,2162861,153,0,0,1,1
2162718,2162859,141,0,0,1,2
2162860,2162911,51,1,0,0,2
2162862,2162909,47,1,0,0,1
2162910,2163717,807,0,0,1,1
2162912,2163716,804,0,0,1,2
2163717,2163770,53,1,0,0,2
2163718,2163761,43,1,0,0,1
2163762,2164122,360,0,0,1,1
2163771,2164123,352,0,0,1,2
2164123,2164198,75,1,0,0,1
2164124,2164201,77,1,0,0,2
2164199,2164288,89,0,0,1,1
2164202,2164285,83,0,0,1,2
2164286,2164320,34,1,0,0,2
2164289,2164318,29,1,0,0,1
2164319,2164514,195,0,0,1,1
2164321,2164516,195,0,0,1,2
2164515,2164530,15,1,0,0,1
2164517,2164528,11,1,0,0,2
2164529,2165810,1281,0,0,1,2
2164531,2165813,1282,0,0,1,1
2165811,2165883,72,1,0,0,2
2165814,2165889,75,1,0,0,1
2165884,2166036,152,0,0,1,2
2165890,2166037,147,0,0,1,1
2166037,2166074,37,1,0,0,2
2166038,2166073,35,1,0,0,1
2166074,2167873,1799,0,0,1,1
2166075,2167864,1789,0,0,1,2
2167865,2168040,175,1,0,0,2
2167874,2168025,151,1,0,0,1
2167892,2167995,103,0,1,0,2
2167898,2167997,99,0,1,0,1
2168026,2168364,338,0,0,1,1
2168041,2168364,323,0,0,1,2
2168365,2168414,49,1,0,0,2
2168365,2168418,53,1,0,0,1
2168415,2169294,879,0,0,1,2
2168419,2169296,877,0,0,1,1
2169295,2169372,77,1,0,0,2
2169297,2169375,78,1,0,0,1
2169373,2169589,216,0,0,1,2
2169376,2169590,214,0,0,1,1
2169590,2169672,82,1,0,0,2
2169591,2169663,72,1,0,0,1
2169664,2169761,97,0,0,1,1
2169673,2169761,88,0,0,1,2
2169762,2169797,35,1,0,0,1
2169762,2169797,35,1,0,0,2
2169798,2169933,135,0,0,1,2
2169798,2169934,136,0,0,1,1
2169934,2169953,19,1,0,0,2
2169935,2169963,28,1,0,0,1
2169954,2170935,981,0,0,1,2
2169964,2170934,970,0,0,1,1
2170935,2171014,79,1,0,0,1
2170936,2171015,79,1,0,0,2
2171015,2171150,135,0,0,1,1
2171016,2171151,135,0,0,1,2
2171151,2171186,35,1,0,0,1
2171152,2171184,32,1,0,0,2
2171185,2172945,1760,0,0,1,2
2171187,2172943,1756,0,0,1,1
2172944,2173187,243,1,0,0,1
2172946,2173205,259,1,0,0,2
2172963,2173153,190,0,1,0,1
2172968,2173163,195,0,1,0,2
2173188,2173279,91,0,0,1,1
2173206,2173290,84,0,0,1,2
2173280,2173495,215,1,0,0,1
2173291,2173467,176,1,0,0,2
2173311,2173437,126,0,1,0,2
2173315,2173452,137,0,1,0,1
2173468,2173649,181,0,0,1,2
2173496,2173650,154,0,0,1,1
2173650,2173702,52,1,0,0,2
2173651,2173701,50,1,0,0,1
2173702,2173912,210,0,0,1,1
2173703,2173911,208,0,0,1,2
2173912,2173975,63,1,0,0,2
2173913,2173975,62,1,0,0,1
2173976,2174171,195,0,0,1,1
2173976,2174171,195,0,0,1,2
2174172,2174243,71,1,0,0,1
2174172,2174245,73,1,0,0,2
2174244,2174316,72,0,0,1,1
2174246,2174315,69,0,0,1,2
2174316,2174354,38,1,0,0,2
2174317,2174354,37,1,0,0,1
2174355,2175743,1388,0,0,1,1
2174355,2175744,1389,0,0,1,2
2175744,2175781,37,1,0,0,1
2175745,2175816,71,1,0,0,2
2175782,2175893,111,0,0,1,1
2175817,2175889,72,0,0,1,2
2175890,2175925,35,1,0,0,2
2175894,2175922,28,1,0,0,1
2175923,2177784,1861,0,0,1,1
2175926,2176102,176,0,0,1,2
2176103,2176107,4,1,0,0,2
2176108,2177790,1682,0,0,1,2
2177785,2178021,236,1,0,0,1
2177791,2178019,228,1,0,0,2
2177807,2177992,185,0,1,0,1
2177808,2177981,173,0,1,0,2
2178020,2178092,72,0,0,1,2
2178022,2178098,76,0,0,1,1
2178093,2178310,217,1,0,0,2
2178099,2178295,196,1,0,0,1
2178114,2178264,150,0,1,0,2
2178117,2178272,155,0,1,0,1
2178296,2178611,315,0,0,1,1
2178311,2178611,300,0,0,1,2
2178612,2178663,51,1,0,0,1
2178612,2178663,51,1,0,0,2
2178664,2179266,602,0,0,1,2
2178664,2179267,603,0,0,1,1
2179267,2179342,75,1,0,0,2
2179268,2179336,68,1,0,0,1
2179337,2179412,75,0,0,1,1
2179343,2179417,74,0,0,1,2
2179413,2179452,39,1,0,0,1
2179418,2179454,36,1,0,0,2
2179453,2180683,1230,0,0,1,1
2179455,2180684,1229,0,0,1,2
2180684,2180737,53,1,0,0,1
2180685,2180756,71,1,0,0,2
2180738,2180857,119,0,0,1,1
2180757,2180858,101,0,0,1,2
2180858,2180894,36,1,0,0,1
2180859,2180894,35,1,0,0,2
2180895,2182732,1837,0,0,1,1
2180895,2182734,1839,0,0,1,2
2182733,2183069,336,1,0,0,1
2182735,2183080,345,1,0,0,2
2182768,2183037,269,0,1,0,2
2182768,2183043,275,0,1,0,1
2183070,2183157,87,0,0,1,1
2183081,2183165,84,0,0,1,2
2183158,2183344,186,1,0,0,1
2183166,2183350,184,1,0,0,2
2183188,2183317,129,0,1,0,2
2183191,2183320,129,0,1,0,1
2183345,2183804,459,0,0,1,1
2183351,2183806,455,0,0,1,2
2183805,2183832,27,1,0,0,1
2183807,2183901,94,1,0,0,2
2183833,2184234,401,0,0,1,1
2183902,2184233,331,0,0,1,2
2184234,2184295,61,1,0,0,2
2184235,2184304,69,1,0,0,1
2184296,2185639,1343,0,0,1,2
2184305,2185639,1334,0,0,1,1
2185640,2185690,50,1,0,0,1
2185640,2185694,54,1,0,0,2
2185691,2187680,1989,0,0,1,1
2185695,2187661,1966,0,0,1,2
2187662,2187861,199,1,0,0,2
2187681,2187877,196,1,0,0,1
2187695,2187810,115,0,1,0,2
2187699,2187813,114,0,1,0,1
2187862,2188001,139,0,0,1,2
2187878,2187999,121,0,0,1,1
2188000,2188088,88,1,0,0,1
2188002,2188084,82,1,0,0,2
2188085,2188424,339,0,0,1,2
2188089,2188426,337,0,0,1,1
2188425,2188515,90,1,0,0,2
2188427,2188492,65,1,0,0,1
2188493,2188748,255,0,0,1,1
2188516,2188747,231,0,0,1,2
2188748,2188795,47,1,0,0,2
2188749,2188794,45,1,0,0,1
2188795,2189236,441,0,0,1,1
2188796,2189235,439,0,0,1,2
2189236,2189279,43,1,0,0,2
2189237,2189281,44,1,0,0,1
2189280,2189365,85,0,0,1,2
2189282,2189364,82,0,0,1,1
2189365,2189391,26,1,0,0,1
2189366,2189389,23,1,0,0,2
2189390,2189549,159,0,0,1,2
2189392,2189550,158,0,0,1,1
2189550,2189574,24,1,0,0,2
2189551,2189568,17,1,0,0,1
2189569,2191326,1757,0,0,1,1
2189575,2189685,110,0,0,1,2
2189686,2189693,7,1,0,0,2
2189694,2189876,182,0,0,1,2
2189877,2189904,27,1,0,0,2
2189905,2190643,738,0,0,1,2
2190644,2190659,15,1,0,0,2
2190660,2191326,666,0,0,1,2
2191327,2191389,62,1,0,0,1
2191327,2191407,80,1,0,0,2
2191390,2191721,331,0,0,1,1
2191408,2191722,314,0,0,1,2
2191722,2191756,34,1,0,0,1
2191723,2191758,35,1,0,0,2
2191757,2193382,1625,0,0,1,1
2191759,2193382,1623,0,0,1,2
2193383,2193619,236,1,0,0,1
2193383,2193625,242,1,0,0,2
2193403,2193592,189,0,1,0,1
2193405,2193586,181,0,1,0,2
2193620,2193741,121,0,0,1,1
2193626,2193735,109,0,0,1,2
2193736,2193925,189,1,0,0,2
2193742,2193922,180,1,0,0,1
2193755,2193887,132,0,1,0,2
2193760,2193896,136,0,1,0,1
2193923,2194181,258,0,0,1,1
2193926,2194181,255,0,0,1,2
2194182,2194218,36,1,0,0,2
2194182,2194229,47,1,0,0,1
2194219,2194936,717,0,0,1,2
2194230,2194941,711,0,0,1,1
2194937,2194988,51,1,0,0,2
2194942,2194977,35,1,0,0,1
2194978,2195106,128,0,0,1,1
2194989,2195106,117,0,0,1,2
