start,end,duration,saccade,blink,fixation,eye
12429247,12429770,523,0,0,1,1
12429247,12429771,524,0,0,1,2
12429771,12429855,84,1,0,0,1
12429772,12429863,91,1,0,0,2
12429856,12430008,152,0,0,1,1
12429864,12430008,144,0,0,1,2
12430009,12430222,213,1,0,0,1
12430009,12430243,234,1,0,0,2
12430040,12430184,144,0,1,0,1
12430040,12430193,153,0,1,0,2
12430223,12430530,307,0,0,1,1
12430244,12430530,286,0,0,1,2
12430531,12430541,10,1,0,0,2
12430531,12430543,12,1,0,0,1
12430542,12430818,276,0,0,1,2
12430544,12430825,281,0,0,1,1
12430819,12431009,190,1,0,0,2
12430826,12431004,178,1,0,0,1
12430854,12430964,110,0,1,0,1
12430856,12430969,113,0,1,0,2
12431005,12431119,114,0,0,1,1
12431010,12431122,112,0,0,1,2
12431120,12431136,16,1,0,0,1
12431123,12431134,11,1,0,0,2
12431135,12431758,623,0,0,1,2
12431137,12431868,731,0,0,1,1
12431759,12431774,15,1,0,0,2
12431775,12431863,88,0,0,1,2
12431864,12432097,233,1,0,0,2
12431869,12432080,211,1,0,0,1
12431894,12432045,151,0,1,0,2
12431895,12432035,140,0,1,0,1
12432081,12432973,892,0,0,1,1
12432098,12432969,871,0,0,1,2
12432970,12433685,715,1,0,0,2
12432974,12433684,710,1,0,0,1
12433007,12433668,661,0,1,0,1
12433008,12433674,666,0,1,0,2
12433685,12433797,112,0,0,1,1
12433686,12433797,111,0,0,1,2
12433798,12433833,35,1,0,0,1
12433798,12433833,35,1,0,0,2
12433834,12434319,485,0,0,1,1
12433834,12434320,486,0,0,1,2
12434320,12435749,1429,1,0,0,1
12434321,12435761,1440,1,0,0,2
12434403,12435728,1325,0,1,0,1
12434436,12435738,1302,0,1,0,2
12435750,12435845,95,0,0,1,1
12435762,12435845,83,0,0,1,2
12435846,12435875,29,1,0,0,1
12435846,12435894,48,1,0,0,2
12435876,12436258,382,0,0,1,1
12435895,12436254,359,0,0,1,2
12436255,12436627,372,1,0,0,2
12436259,12436608,349,1,0,0,1
12436289,12436570,281,0,1,0,1
12436291,12436579,288,0,1,0,2
12436609,12437001,392,0,0,1,1
12436628,12436987,359,0,0,1,2
12436988,12437304,316,1,0,0,2
12437002,12437284,282,1,0,0,1
12437028,12437238,210,0,1,0,1
12437029,12437248,219,0,1,0,2
12437285,12437919,634,0,0,1,1
12437305,12437908,603,0,0,1,2
12437909,12438939,1030,1,0,0,2
12437920,12438930,1010,1,0,0,1
12437962,12438920,958,0,1,0,1
12437965,12438928,963,0,1,0,2
12438931,12439020,89,0,0,1,1
12438940,12439020,80,0,0,1,2
12439021,12439057,36,1,0,0,1
12439021,12439060,39,1,0,0,2
12439058,12439221,163,0,0,1,1
12439061,12439222,161,0,0,1,2
12439222,12439242,20,1,0,0,1
12439223,12439243,20,1,0,0,2
12439243,12439338,95,0,0,1,1
12439244,12439327,83,0,0,1,2
12439328,12439538,210,1,0,0,2
12439339,12439531,192,1,0,0,1
12439366,12439487,121,0,1,0,1
12439367,12439493,126,0,1,0,2
12439532,12440425,893,0,0,1,1
12439539,12440417,878,0,0,1,2
12440418,12440620,202,1,0,0,2
12440426,12440610,184,1,0,0,1
12440453,12440567,114,0,1,0,1
12440456,12440572,116,0,1,0,2
12440611,12441386,775,0,0,1,1
12440621,12440798,177,0,0,1,2
12440799,12440805,6,1,0,0,2
12440806,12441377,571,0,0,1,2
12441378,12441612,234,1,0,0,2
12441387,12441585,198,1,0,0,1
12441409,12441539,130,0,1,0,1
12441409,12441548,139,0,1,0,2
12441586,12441793,207,0,0,1,1
12441613,12441783,170,0,0,1,2
12441784,12442025,241,1,0,0,2
12441794,12442013,219,1,0,0,1
12441812,12441972,160,0,1,0,2
12441814,12441963,149,0,1,0,1
12442014,12442649,635,0,0,1,1
12442026,12442644,618,0,0,1,2
12442645,12442842,197,1,0,0,2
12442650,12442834,184,1,0,0,1
12442673,12442782,109,0,1,0,1
12442676,12442786,110,0,1,0,2
12442835,12442993,158,0,0,1,1
12442843,12442999,156,0,0,1,2
12442994,12443011,17,1,0,0,1
12443000,12443005,5,1,0,0,2
12443006,12443179,173,0,0,1,2
12443012,12443188,176,0,0,1,1
12443180,12443396,216,1,0,0,2
12443189,12443394,205,1,0,0,1
12443215,12443345,130,0,1,0,1
12443217,12443348,131,0,1,0,2
12443395,12443542,147,0,0,1,1
12443397,12443539,142,0,0,1,2
12443540,12443566,26,1,0,0,2
12443543,12443563,20,1,0,0,1
12443564,12443763,199,0,0,1,1
12443567,12443753,186,0,0,1,2
12443754,12443963,209,1,0,0,2
12443764,12443953,189,1,0,0,1
12443786,12443905,119,0,1,0,1
12443788,12443909,121,0,1,0,2
12443954,12444860,906,0,0,1,1
12443964,12444858,894,0,0,1,2
12444859,12444884,25,1,0,0,2
12444861,12444885,24,1,0,0,1
12444885,12445200,315,0,0,1,2
12444886,12445204,318,0,0,1,1
12445201,12445219,18,1,0,0,2
12445205,12445209,4,1,0,0,1
12445210,12445474,264,0,0,1,1
12445220,12445471,251,0,0,1,2
12445472,12445679,207,1,0,0,2
12445475,12445648,173,1,0,0,1
12445501,12445625,124,0,1,0,2
12445502,12445617,115,0,1,0,1
12445649,12447469,1820,0,0,1,1
12445680,12445920,240,0,0,1,2
12445921,12445932,11,1,0,0,2
12445933,12447468,1535,0,0,1,2
12447469,12447559,90,1,0,0,2
12447470,12447552,82,1,0,0,1
12447553,12447683,130,0,0,1,1
12447560,12447683,123,0,0,1,2
12447684,12447705,21,1,0,0,2
12447684,12447711,27,1,0,0,1
12447706,12447765,59,0,0,1,2
12447712,12447784,72,0,0,1,1
12447766,12448059,293,1,0,0,2
12447785,12447984,199,1,0,0,1
12447800,12447973,173,0,1,0,2
12447803,12447953,150,0,1,0,1
12447985,12448098,113,0,0,1,1
12448060,12448093,33,0,0,1,2
12448094,12448111,17,1,0,0,2
12448099,12448110,11,1,0,0,1
12448111,12449618,1507,0,0,1,1
12448112,12449617,1505,0,0,1,2
12449618,12449685,67,1,0,0,2
12449619,12449687,68,1,0,0,1
12449686,12449777,91,0,0,1,2
12449688,12449777,89,0,0,1,1
12449778,12449809,31,1,0,0,2
12449778,12449819,41,1,0,0,1
12449810,12450011,201,0,0,1,2
12449820,12450008,188,0,0,1,1
12450009,12450035,26,1,0,0,1
12450012,12450025,13,1,0,0,2
12450026,12451531,1505,0,0,1,2
12450036,12451533,1497,0,0,1,1
12451532,12452109,577,1,0,0,2
12451534,12451621,87,1,0,0,1
12451622,12451685,63,0,0,1,1
12451686,12451727,41,1,0,0,1
12451728,12451765,37,0,0,1,1
12451766,12452007,241,1,0,0,1
12451779,12452020,241,0,1,0,2
12451789,12451977,188,0,1,0,1
12452008,12452091,83,0,0,1,1
12452092,12452108,16,1,0,0,1
12452109,12453505,1396,0,0,1,1
12452110,12453504,1394,0,0,1,2
12453505,12453623,118,1,0,0,2
12453506,12453597,91,1,0,0,1
12453598,12453677,79,0,0,1,1
12453624,12453674,50,0,0,1,2
12453675,12453722,47,1,0,0,2
12453678,12453727,49,1,0,0,1
12453723,12453851,128,0,0,1,2
12453728,12453852,124,0,0,1,1
12453852,12453873,21,1,0,0,2
12453853,12453872,19,1,0,0,1
12453873,12454276,403,0,0,1,1
12453874,12454271,397,0,0,1,2
12454272,12454526,254,1,0,0,2
12454277,12454463,186,1,0,0,1
12454299,12454434,135,0,1,0,2
12454300,12454426,126,0,1,0,1
12454464,12455575,1111,0,0,1,1
12454527,12455574,1047,0,0,1,2
12455575,12455627,52,1,0,0,2
12455576,12455635,59,1,0,0,1
12455628,12455794,166,0,0,1,2
12455636,12455793,157,0,0,1,1
12455794,12455818,24,1,0,0,1
12455795,12455811,16,1,0,0,2
12455812,12457526,1714,0,0,1,2
12455819,12456928,1109,0,0,1,1
12456929,12456942,13,1,0,0,1
12456943,12457525,582,0,0,1,1
12457526,12457581,55,1,0,0,1
12457527,12457595,68,1,0,0,2
12457582,12457720,138,0,0,1,1
12457596,12457720,124,0,0,1,2
12457721,12457741,20,1,0,0,1
12457721,12457744,23,1,0,0,2
12457742,12459692,1950,0,0,1,1
12457745,12459692,1947,0,0,1,2
12459693,12459769,76,1,0,0,1
12459693,12459770,77,1,0,0,2
12459770,12459819,49,0,0,1,1
12459771,12459817,46,0,0,1,2
12459818,12460095,277,1,0,0,2
12459820,12460085,265,1,0,0,1
12459842,12460054,212,0,1,0,2
12459843,12460038,195,0,1,0,1
12460086,12461946,1860,0,0,1,1
12460096,12461947,1851,0,0,1,2
12461947,12462019,72,1,0,0,1
12461948,12462030,82,1,0,0,2
12462020,12462082,62,0,0,1,1
12462031,12462081,50,0,0,1,2
12462082,12462122,40,1,0,0,2
12462083,12462120,37,1,0,0,1
12462121,12462178,57,0,0,1,1
12462123,12462178,55,0,0,1,2
12462179,12462459,280,1,0,0,2
12462179,12462477,298,1,0,0,1
12462202,12462418,216,0,1,0,2
12462203,12462414,211,0,1,0,1
12462460,12462940,480,0,0,1,2
12462478,12464106,1628,0,0,1,1
12462941,12462952,11,1,0,0,2
12462953,12464105,1152,0,0,1,2
12464106,12464212,106,1,0,0,2
12464107,12464219,112,1,0,0,1
12464213,12464315,102,0,0,1,2
12464220,12464314,94,0,0,1,1
12464315,12464408,93,1,0,0,1
12464316,12464345,29,1,0,0,2
12464346,12466135,1789,0,0,1,2
12464409,12464476,67,0,0,1,1
12464477,12464491,14,1,0,0,1
12464492,12464589,97,0,0,1,1
12464590,12464732,142,1,0,0,1
12464733,12464780,47,0,0,1,1
12464781,12464930,149,1,0,0,1
12464931,12465007,76,0,0,1,1
12465008,12465021,13,1,0,0,1
12465022,12465128,106,0,0,1,1
12465129,12465396,267,1,0,0,1
12465397,12465488,91,0,0,1,1
12465489,12465889,400,1,0,0,1
12465890,12465941,51,0,0,1,1
12465942,12465954,12,1,0,0,1
12465955,12466049,94,0,0,1,1
12466050,12466247,197,1,0,0,1
12466136,12466416,280,1,0,0,2
12466248,12466383,135,0,0,1,1
12466384,12466429,45,1,0,0,1
12466417,12468257,1840,0,0,1,2
12466430,12468257,1827,0,0,1,1
12468258,12468360,102,1,0,0,2
12468258,12468369,111,1,0,0,1
12468361,12468469,108,0,0,1,2
12468370,12468467,97,0,0,1,1
12468468,12468495,27,1,0,0,1
12468470,12468506,36,1,0,0,2
12468496,12468938,442,0,0,1,1
12468507,12468938,431,0,0,1,2
12468939,12469187,248,1,0,0,2
12468939,12469196,257,1,0,0,1
12468959,12469166,207,0,1,0,2
12468963,12469139,176,0,1,0,1
12469188,12469302,114,0,0,1,2
12469197,12470246,1049,0,0,1,1
12469303,12469315,12,1,0,0,2
12469316,12470248,932,0,0,1,2
12470247,12470338,91,1,0,0,1
12470249,12470341,92,1,0,0,2
12470339,12470415,76,0,0,1,1
12470342,12470414,72,0,0,1,2
12470415,12470459,44,1,0,0,2
12470416,12470457,41,1,0,0,1
12470458,12470777,319,0,0,1,1
12470460,12470777,317,0,0,1,2
12470778,12470789,11,1,0,0,1
12470778,12470801,23,1,0,0,2
12470790,12472287,1497,0,0,1,1
12470802,12470973,171,0,0,1,2
12470974,12470992,18,1,0,0,2
12470993,12472286,1293,0,0,1,2
12472287,12472372,85,1,0,0,2
12472288,12472379,91,1,0,0,1
12472373,12474399,2026,0,0,1,2
12472380,12474400,2020,0,0,1,1
12474400,12474465,65,1,0,0,2
12474401,12474466,65,1,0,0,1
12474466,12474566,100,0,0,1,2
12474467,12474567,100,0,0,1,1
12474567,12474596,29,1,0,0,2
12474568,12474599,31,1,0,0,1
12474597,12476336,1739,0,0,1,2
12474600,12476371,1771,0,0,1,1
12476337,12476798,461,1,0,0,2
12476372,12476697,325,1,0,0,1
12476413,12476677,264,0,1,0,2
12476421,12476643,222,0,1,0,1
12476698,12476784,86,0,0,1,1
12476785,12476797,12,1,0,0,1
12476798,12477290,492,0,0,1,1
12476799,12477028,229,0,0,1,2
12477029,12477033,4,1,0,0,2
12477034,12477280,246,0,0,1,2
12477281,12477515,234,1,0,0,2
12477291,12477467,176,1,0,0,1
12477310,12477441,131,0,1,0,2
12477318,12477409,91,0,1,0,1
12477468,12477660,192,0,0,1,1
12477516,12478703,1187,0,0,1,2
12477661,12477668,7,1,0,0,1
12477669,12477918,249,0,0,1,1
12477919,12477942,23,1,0,0,1
12477943,12478700,757,0,0,1,1
12478701,12478729,28,1,0,0,1
12478704,12478717,13,1,0,0,2
12478718,12478776,58,0,0,1,2
12478730,12478788,58,0,0,1,1
12478777,12479052,275,1,0,0,2
12478789,12478937,148,1,0,0,1
12478815,12478829,14,0,1,0,2
12478872,12478883,11,0,1,0,2
12478877,12478928,51,0,1,0,1
12478911,12478967,56,0,1,0,2
12478938,12479013,75,0,0,1,1
12479014,12479045,31,1,0,0,1
12479046,12479431,385,0,0,1,1
12479053,12480860,1807,0,0,1,2
12479432,12479448,16,1,0,0,1
12479449,12480860,1411,0,0,1,1
12480861,12480912,51,1,0,0,1
12480861,12480914,53,1,0,0,2
12480913,12481257,344,0,0,1,1
12480915,12481262,347,0,0,1,2
12481258,12481657,399,1,0,0,1
12481263,12481654,391,1,0,0,2
12481279,12481614,335,0,1,0,2
12481281,12481646,365,0,1,0,1
12481655,12483032,1377,0,0,1,2
12481658,12483034,1376,0,0,1,1
12483033,12483181,148,1,0,0,2
12483035,12483167,132,1,0,0,1
12483110,12483114,4,0,1,0,2
12483168,12483230,62,0,0,1,1
12483182,12483229,47,0,0,1,2
12483230,12483252,22,1,0,0,2
12483231,12483311,80,1,0,0,1
12483253,12483506,253,0,0,1,2
12483312,12483434,122,0,0,1,1
12483435,12483466,31,1,0,0,1
12483467,12483707,240,0,0,1,1
12483507,12483515,8,1,0,0,2
12483516,12485037,1521,0,0,1,2
12483708,12483719,11,1,0,0,1
12483720,12483816,96,0,0,1,1
12483817,12483834,17,1,0,0,1
12483835,12483884,49,0,0,1,1
12483885,12483893,8,1,0,0,1
12483894,12484037,143,0,0,1,1
12484038,12484054,16,1,0,0,1
12484055,12484449,394,0,0,1,1
12484450,12484484,34,1,0,0,1
12484485,12484828,343,0,0,1,1
12484829,12484881,52,1,0,0,1
12484882,12485037,155,0,0,1,1
12485038,12485114,76,1,0,0,1
12485038,12485116,78,1,0,0,2
12485115,12485231,116,0,0,1,1
12485117,12485231,114,0,0,1,2
12485232,12485257,25,1,0,0,1
12485232,12485260,28,1,0,0,2
12485258,12485585,327,0,0,1,1
12485261,12485574,313,0,0,1,2
12485575,12485878,303,1,0,0,2
12485586,12485812,226,1,0,0,1
12485602,12485794,192,0,1,0,2
12485606,12485777,171,0,1,0,1
12485813,12485931,118,0,0,1,1
12485879,12485930,51,0,0,1,2
12485931,12485947,16,1,0,0,2
12485932,12485947,15,1,0,0,1
12485948,12487020,1072,0,0,1,1
12485948,12487020,1072,0,0,1,2
12487021,12487099,78,1,0,0,2
12487021,12487120,99,1,0,0,1
12487100,12487183,83,0,0,1,2
12487121,12487181,60,0,0,1,1
12487182,12487234,52,1,0,0,1
12487184,12487223,39,1,0,0,2
12487224,12487425,201,0,0,1,2
12487235,12487425,190,0,0,1,1
12487426,12487436,10,1,0,0,2
12487426,12487446,20,1,0,0,1
12487437,12489081,1644,0,0,1,2
12487447,12489039,1592,0,0,1,1
12489040,12489048,8,1,0,0,1
12489049,12489082,33,0,0,1,1
12489082,12489145,63,1,0,0,2
12489083,12489139,56,1,0,0,1
12489140,12489275,135,0,0,1,1
12489146,12489274,128,0,0,1,2
12489275,12489305,30,1,0,0,2
12489276,12489307,31,1,0,0,1
12489306,12491154,1848,0,0,1,2
12489308,12491155,1847,0,0,1,1
12491155,12491209,54,1,0,0,2
12491156,12491209,53,1,0,0,1
12491210,12491304,94,0,0,1,2
12491210,12491306,96,0,0,1,1
12491305,12491328,23,1,0,0,2
12491307,12491337,30,1,0,0,1
12491329,12491838,509,0,0,1,2
12491338,12491598,260,0,0,1,1
12491599,12491603,4,1,0,0,1
12491604,12491861,257,0,0,1,1
12491839,12492325,486,1,0,0,2
12491862,12492082,220,1,0,0,1
12491873,12492116,243,0,1,0,2
12491882,12492051,169,0,1,0,1
12492083,12492299,216,0,0,1,1
12492300,12492313,13,1,0,0,1
12492314,12493309,995,0,0,1,1
12492326,12492393,67,0,0,1,2
12492394,12492410,16,1,0,0,2
12492411,12493168,757,0,0,1,2
12493169,12493285,116,1,0,0,2
12493286,12493309,23,0,0,1,2
12493310,12493391,81,1,0,0,1
12493310,12493418,108,1,0,0,2
12493392,12493519,127,0,0,1,1
12493419,12493519,100,0,0,1,2
12493520,12493540,20,1,0,0,1
12493520,12493542,22,1,0,0,2
12493541,12495309,1768,0,0,1,1
12493543,12495286,1743,0,0,1,2
12495287,12495426,139,1,0,0,2
12495310,12495437,127,1,0,0,1
12495427,12495526,99,0,0,1,2
12495438,12495526,88,0,0,1,1
12495527,12495554,27,1,0,0,1
12495527,12495569,42,1,0,0,2
12495555,12496239,684,0,0,1,1
12495570,12496240,670,0,0,1,2
12496240,12496552,312,1,0,0,1
12496241,12496540,299,1,0,0,2
12496260,12496466,206,0,1,0,1
12496260,12496481,221,0,1,0,2
12496508,12496510,2,0,1,0,2
12496541,12496567,26,0,0,1,2
12496553,12496579,26,0,0,1,1
12496568,12496583,15,1,0,0,2
12496580,12496585,5,1,0,0,1
12496584,12497485,901,0,0,1,2
12496586,12497486,900,0,0,1,1
12497486,12497579,93,1,0,0,2
12497487,12497591,104,1,0,0,1
12497580,12497712,132,0,0,1,2
12497592,12497711,119,0,0,1,1
12497712,12497741,29,1,0,0,1
12497713,12497735,22,1,0,0,2
12497736,12497985,249,0,0,1,2
12497742,12499627,1885,0,0,1,1
12497986,12497990,4,1,0,0,2
12497991,12499627,1636,0,0,1,2
12499628,12499732,104,1,0,0,1
12499628,12499866,238,1,0,0,2
12499733,12499822,89,0,0,1,1
12499823,12499852,29,1,0,0,1
12499853,12501729,1876,0,0,1,1
12499867,12501729,1862,0,0,1,2
12501730,12501825,95,1,0,0,1
12501730,12503205,1475,1,0,0,2
12501826,12501899,73,0,0,1,1
12501900,12501943,43,1,0,0,1
12501907,12501969,62,0,1,0,2
12501944,12502126,182,0,0,1,1
12501993,12501998,5,0,1,0,2
12502019,12502038,19,0,1,0,2
12502127,12502527,400,1,0,0,1
12502132,12502133,1,0,1,0,2
12502162,12503143,981,0,1,0,2
12502169,12502499,330,0,1,0,1
12502528,12503787,1259,0,0,1,1
12503180,12503196,16,0,1,0,2
12503206,12503786,580,0,0,1,2
12503787,12503920,133,1,0,0,2
12503788,12503870,82,1,0,0,1
12503820,12503844,24,0,1,0,2
12503871,12503981,110,0,0,1,1
12503921,12503982,61,0,0,1,2
12503982,12504009,27,1,0,0,1
12503983,12504020,37,1,0,0,2
12504010,12505708,1698,0,0,1,1
12504021,12505710,1689,0,0,1,2
12505709,12505775,66,1,0,0,1
12505711,12505777,66,1,0,0,2
12505776,12505908,132,0,0,1,1
12505778,12505906,128,0,0,1,2
12505907,12505928,21,1,0,0,2
12505909,12505927,18,1,0,0,1
12505928,12506234,306,0,0,1,1
12505929,12506234,305,0,0,1,2
12506235,12506488,253,1,0,0,2
12506235,12506517,282,1,0,0,1
12506252,12506463,211,0,1,0,2
12506256,12506434,178,0,1,0,1
12506489,12507829,1340,0,0,1,2
12506518,12507829,1311,0,0,1,1
12507830,12507917,87,1,0,0,2
12507830,12507918,88,1,0,0,1
12507918,12508190,272,0,0,1,2
12507919,12509732,1813,0,0,1,1
12508191,12508205,14,1,0,0,2
12508206,12509732,1526,0,0,1,2
12509733,12509792,59,1,0,0,2
12509733,12509797,64,1,0,0,1
12509793,12509899,106,0,0,1,2
12509798,12509898,100,0,0,1,1
12509899,12509935,36,1,0,0,1
12509900,12509926,26,1,0,0,2
12509927,12511636,1709,0,0,1,2
12509936,12510330,394,0,0,1,1
12510331,12510345,14,1,0,0,1
12510346,12511636,1290,0,0,1,1
12511637,12511720,83,1,0,0,1
12511637,12511759,122,1,0,0,2
12511721,12511837,116,0,0,1,1
12511760,12511836,76,0,0,1,2
12511837,12512379,542,1,0,0,2
12511838,12511873,35,1,0,0,1
12511874,12511894,20,0,0,1,1
12511895,12512230,335,1,0,0,1
12511910,12512283,373,0,1,0,2
12511919,12512198,279,0,1,0,1
12512231,12513538,1307,0,0,1,1
12512380,12512557,177,0,0,1,2
12512558,12512574,16,1,0,0,2
12512575,12512642,67,0,0,1,2
12512643,12512875,232,1,0,0,2
12512876,12512919,43,0,0,1,2
12512920,12512943,23,1,0,0,2
12512944,12513019,75,0,0,1,2
12513020,12513085,65,1,0,0,2
12513086,12513539,453,0,0,1,2
12513539,12513622,83,1,0,0,1
12513540,12513624,84,1,0,0,2
12513623,12513733,110,0,0,1,1
12513625,12513732,107,0,0,1,2
12513733,12513770,37,1,0,0,2
12513734,12513759,25,1,0,0,1
12513760,12515498,1738,0,0,1,1
12513771,12515498,1727,0,0,1,2
12515499,12515579,80,1,0,0,1
12515499,12515581,82,1,0,0,2
12515580,12515714,134,0,0,1,1
12515582,12515715,133,0,0,1,2
12515715,12515734,19,1,0,0,1
12515716,12515735,19,1,0,0,2
12515735,12516731,996,0,0,1,1
12515736,12516720,984,0,0,1,2
12516721,12516932,211,1,0,0,2
12516732,12516908,176,1,0,0,1
12516750,12516894,144,0,1,0,2
12516753,12516876,123,0,1,0,1
12516909,12517372,463,0,0,1,1
12516933,12517372,439,0,0,1,2
12517373,12517473,100,1,0,0,1
12517373,12517659,286,1,0,0,2
12517458,12517647,189,0,1,0,2
12517474,12517535,61,0,0,1,1
12517536,12517626,90,1,0,0,1
12517557,12517595,38,0,1,0,1
12517627,12517697,70,0,0,1,1
12517660,12517692,32,0,0,1,2
12517693,12517734,41,1,0,0,2
12517698,12517712,14,1,0,0,1
12517713,12519406,1693,0,0,1,1
12517735,12517762,27,0,0,1,2
12517763,12517784,21,1,0,0,2
12517785,12519406,1621,0,0,1,2
12519407,12519538,131,1,0,0,2
12519407,12519550,143,1,0,0,1
12519539,12519648,109,0,0,1,2
12519551,12519648,97,0,0,1,1
12519649,12519697,48,1,0,0,2
12519649,12519699,50,1,0,0,1
12519698,12521204,1506,0,0,1,2
12519700,12521203,1503,0,0,1,1
12521204,12521263,59,1,0,0,1
12521205,12521255,50,1,0,0,2
12521256,12521417,161,0,0,1,2
12521264,12521424,160,0,0,1,1
12521418,12521669,251,1,0,0,2
12521425,12521636,211,1,0,0,1
12521447,12521604,157,0,1,0,2
12521449,12521593,144,0,1,0,1
12521637,12521736,99,0,0,1,1
12521670,12521726,56,0,0,1,2
12521727,12521750,23,1,0,0,2
12521737,12521750,13,1,0,0,1
12521751,12523219,1468,0,0,1,1
12521751,12523220,1469,0,0,1,2
12523220,12523351,131,1,0,0,1
12523221,12523619,398,1,0,0,2
12523352,12523482,130,0,0,1,1
12523483,12523503,20,1,0,0,1
12523504,12523872,368,0,0,1,1
12523620,12523870,250,0,0,1,2
12523871,12523920,49,1,0,0,2
12523873,12523894,21,1,0,0,1
12523895,12525131,1236,0,0,1,1
12523921,12525131,1210,0,0,1,2
12525132,12525225,93,1,0,0,1
12525132,12525259,127,1,0,0,2
12525226,12525345,119,0,0,1,1
12525260,12525344,84,0,0,1,2
12525345,12525380,35,1,0,0,2
12525346,12525376,30,1,0,0,1
12525377,12525601,224,0,0,1,1
12525381,12525585,204,0,0,1,2
12525586,12525869,283,1,0,0,2
12525602,12525788,186,1,0,0,1
12525616,12525775,159,0,1,0,2
12525620,12525757,137,0,1,0,1
12525789,12527064,1275,0,0,1,1
12525870,12527066,1196,0,0,1,2
12527065,12527152,87,1,0,0,1
12527067,12527148,81,1,0,0,2
12527149,12527275,126,0,0,1,2
12527153,12527276,123,0,0,1,1
12527276,12527315,39,1,0,0,2
12527277,12527301,24,1,0,0,1
12527302,12527424,122,0,0,1,1
12527316,12527421,105,0,0,1,2
12527422,12527690,268,1,0,0,2
12527425,12527691,266,1,0,0,1
12527448,12527638,190,0,1,0,2
12527454,12527626,172,0,1,0,1
12527691,12527796,105,0,0,1,2
12527692,12527797,105,0,0,1,1
12527797,12527809,12,1,0,0,2
12527798,12527808,10,1,0,0,1
12527809,12529058,1249,0,0,1,1
12527810,12529059,1249,0,0,1,2
12529059,12529150,91,1,0,0,1
12529060,12529287,227,1,0,0,2
12529151,12529217,66,0,0,1,1
12529218,12529246,28,1,0,0,1
12529247,12531109,1862,0,0,1,1
12529288,12531108,1820,0,0,1,2
12531109,12531178,69,1,0,0,2
12531110,12531177,67,1,0,0,1
12531178,12531325,147,0,0,1,1
12531179,12531325,146,0,0,1,2
12531326,12531337,11,1,0,0,2
12531326,12531338,12,1,0,0,1
12531338,12531483,145,0,0,1,2
12531339,12531492,153,0,0,1,1
12531484,12531800,316,1,0,0,2
12531493,12531756,263,1,0,0,1
12531507,12531737,230,0,1,0,2
12531510,12531713,203,0,1,0,1
12531757,12533175,1418,0,0,1,1
12531801,12531849,48,0,0,1,2
12531850,12531868,18,1,0,0,2
12531869,12533174,1305,0,0,1,2
12533175,12533332,157,1,0,0,2
12533176,12533271,95,1,0,0,1
12533272,12533373,101,0,0,1,1
12533333,12533375,42,0,0,1,2
12533374,12533479,105,1,0,0,1
12533376,12533418,42,1,0,0,2
12533419,12533964,545,0,0,1,2
12533480,12533515,35,0,0,1,1
12533516,12533661,145,1,0,0,1
12533662,12533694,32,0,0,1,1
12533695,12533737,42,1,0,0,1
12533738,12533826,88,0,0,1,1
12533827,12533858,31,1,0,0,1
12533859,12533923,64,0,0,1,1
12533924,12533949,25,1,0,0,1
12533950,12533995,45,0,0,1,1
12533965,12534436,471,1,0,0,2
12533996,12534309,313,1,0,0,1
12534022,12534305,283,0,1,0,2
12534041,12534082,41,0,1,0,1
12534155,12534274,119,0,1,0,1
12534310,12535033,723,0,0,1,1
12534437,12535031,594,0,0,1,2
12535032,12535084,52,1,0,0,2
12535034,12535085,51,1,0,0,1
12535085,12535266,181,0,0,1,2
12535086,12535267,181,0,0,1,1
12535267,12535277,10,1,0,0,2
12535268,12535287,19,1,0,0,1
12535278,12537052,1774,0,0,1,2
12535288,12537053,1765,0,0,1,1
12537053,12537124,71,1,0,0,2
12537054,12537117,63,1,0,0,1
12537118,12537279,161,0,0,1,1
12537125,12537278,153,0,0,1,2
12537279,12537297,18,1,0,0,2
12537280,12537296,16,1,0,0,1
12537297,12537799,502,0,0,1,1
12537298,12539026,1728,0,0,1,2
12537800,12537814,14,1,0,0,1
12537815,12539026,1211,0,0,1,1
12539027,12539126,99,1,0,0,1
12539027,12540099,1072,1,0,0,2
12539127,12539188,61,0,0,1,1
12539189,12539242,53,1,0,0,1
12539189,12539294,105,0,1,0,2
12539243,12539366,123,0,0,1,1
12539362,12539829,467,0,1,0,2
12539367,12539717,350,1,0,0,1
12539399,12539657,258,0,1,0,1
12539718,12540900,1182,0,0,1,1
12539874,12539922,48,0,1,0,2
12539955,12539972,17,0,1,0,2
12540009,12540010,1,0,1,0,2
12540100,12541111,1011,0,0,1,2
12540901,12540918,17,1,0,0,1
12540919,12541111,192,0,0,1,1
12541112,12541217,105,1,0,0,1
12541112,12541237,125,1,0,0,2
12541161,12541161,0,0,1,0,2
12541218,12541339,121,0,0,1,1
12541238,12541339,101,0,0,1,2
12541340,12541362,22,1,0,0,1
12541340,12541368,28,1,0,0,2
12541363,12541700,337,0,0,1,1
12541369,12541648,279,0,0,1,2
12541649,12541664,15,1,0,0,2
12541665,12541701,36,0,0,1,2
12541701,12541978,277,1,0,0,1
12541702,12541993,291,1,0,0,2
12541726,12541958,232,0,1,0,2
12541733,12541938,205,0,1,0,1
12541979,12542002,23,0,0,1,1
12541994,12543269,1275,0,0,1,2
12542003,12542020,17,1,0,0,1
12542021,12543269,1248,0,0,1,1
12543270,12543338,68,1,0,0,1
12543270,12543345,75,1,0,0,2
12543339,12543453,114,0,0,1,1
12543346,12543452,106,0,0,1,2
12543453,12543477,24,1,0,0,2
12543454,12543478,24,1,0,0,1
12543478,12543872,394,0,0,1,2
12543479,12544880,1401,0,0,1,1
12543873,12543888,15,1,0,0,2
12543889,12544830,941,0,0,1,2
12544831,12544836,5,1,0,0,2
12544837,12544873,36,0,0,1,2
12544874,12545136,262,1,0,0,2
12544881,12545089,208,1,0,0,1
12544904,12545062,158,0,1,0,2
12544909,12545043,134,0,1,0,1
12545090,12545597,507,0,0,1,1
12545137,12545594,457,0,0,1,2
12545595,12545656,61,1,0,0,2
12545598,12545662,64,1,0,0,1
12545657,12545931,274,0,0,1,2
12545663,12545931,268,0,0,1,1
12545932,12545975,43,1,0,0,2
12545932,12545988,56,1,0,0,1
12545976,12546054,78,0,0,1,2
12545989,12546067,78,0,0,1,1
12546055,12546303,248,1,0,0,2
12546068,12546251,183,1,0,0,1
12546079,12546242,163,0,1,0,2
12546083,12546216,133,0,1,0,1
12546252,12546578,326,0,0,1,1
12546304,12546470,166,0,0,1,2
12546471,12546490,19,1,0,0,2
12546491,12546576,85,0,0,1,2
12546577,12546633,56,1,0,0,2
12546579,12546632,53,1,0,0,1
12546633,12547069,436,0,0,1,1
12546634,12547062,428,0,0,1,2
12547063,12547397,334,1,0,0,2
12547070,12547363,293,1,0,0,1
12547082,12547357,275,0,1,0,2
12547088,12547142,54,0,1,0,1
12547192,12547338,146,0,1,0,1
12547364,12547576,212,0,0,1,1
12547398,12547577,179,0,0,1,2
12547577,12547664,87,1,0,0,1
12547578,12547666,88,1,0,0,2
12547665,12547967,302,0,0,1,1
12547667,12547966,299,0,0,1,2
12547967,12548200,233,1,0,0,2
12547968,12548160,192,1,0,0,1
12547992,12548143,151,0,1,0,2
12547993,12548119,126,0,1,0,1
12548161,12548598,437,0,0,1,1
12548201,12548598,397,0,0,1,2
12548599,12548656,57,1,0,0,1
12548599,12548656,57,1,0,0,2
12548657,12548859,202,0,0,1,2
12548657,12548962,305,0,0,1,1
12548860,12548892,32,1,0,0,2
12548893,12548933,40,0,0,1,2
12548934,12549005,71,1,0,0,2
12548963,12549014,51,1,0,0,1
12549006,12549896,890,0,0,1,2
12549015,12549895,880,0,0,1,1
12549896,12549972,76,1,0,0,1
12549897,12549970,73,1,0,0,2
12549971,12550090,119,0,0,1,2
12549973,12550089,116,0,0,1,1
12550090,12550125,35,1,0,0,1
12550091,12550123,32,1,0,0,2
12550124,12550937,813,0,0,1,2
12550126,12550937,811,0,0,1,1
12550938,12550959,21,1,0,0,2
12550938,12550962,24,1,0,0,1
12550960,12551335,375,0,0,1,2
12550963,12551343,380,0,0,1,1
12551336,12551692,356,1,0,0,2
12551344,12551628,284,1,0,0,1
12551361,12551568,207,0,1,0,1
12551361,12551600,239,0,1,0,2
12551629,12552264,635,0,0,1,1
12551693,12552258,565,0,0,1,2
12552259,12552281,22,1,0,0,2
12552265,12552275,10,1,0,0,1
12552276,12553433,1157,0,0,1,1
12552282,12553431,1149,0,0,1,2
12553432,12553548,116,1,0,0,2
12553434,12553497,63,1,0,0,1
12553498,12553842,344,0,0,1,1
12553549,12553823,274,0,0,1,2
12553824,12554204,380,1,0,0,2
12553843,12553928,85,1,0,0,1
12553854,12553891,37,0,1,0,2
12553929,12553950,21,0,0,1,1
12553951,12554137,186,1,0,0,1
12553971,12554132,161,0,1,0,2
12553974,12554109,135,0,1,0,1
12554138,12555752,1614,0,0,1,1
12554205,12555753,1548,0,0,1,2
12555753,12555867,114,1,0,0,1
12555754,12555865,111,1,0,0,2
12555866,12556187,321,0,0,1,2
12555868,12556188,320,0,0,1,1
12556188,12556646,458,1,0,0,2
12556189,12556288,99,1,0,0,1
12556289,12556313,24,0,0,1,1
12556314,12556535,221,1,0,0,1
12556323,12556531,208,0,1,0,2
12556329,12556494,165,0,1,0,1
12556536,12557030,494,0,0,1,1
12556647,12557031,384,0,0,1,2
12557031,12557130,99,1,0,0,1
12557032,12557184,152,1,0,0,2
12557131,12557351,220,0,0,1,1
12557185,12557352,167,0,0,1,2
12557352,12557372,20,1,0,0,1
12557353,12557362,9,1,0,0,2
12557363,12558741,1378,0,0,1,2
12557373,12557710,337,0,0,1,1
12557711,12557729,18,1,0,0,1
12557730,12558740,1010,0,0,1,1
12558741,12558791,50,1,0,0,1
12558742,12558794,52,1,0,0,2
12558792,12560820,2028,0,0,1,1
12558795,12560820,2025,0,0,1,2
12560821,12560857,36,1,0,0,1
12560821,12560866,45,1,0,0,2
12560858,12560973,115,0,0,1,1
12560867,12560953,86,0,0,1,2
12560954,12561355,401,1,0,0,2
12560974,12561218,244,1,0,0,1
12560997,12561209,212,0,1,0,2
12560999,12561182,183,0,1,0,1
12561219,12561467,248,0,0,1,1
12561231,12561233,2,0,1,0,2
12561356,12561467,111,0,0,1,2
12561468,12561517,49,1,0,0,1
12561468,12561517,49,1,0,0,2
12561518,12562248,730,0,0,1,1
12561518,12562249,731,0,0,1,2
12562249,12562334,85,1,0,0,1
12562250,12562328,78,1,0,0,2
12562329,12562440,111,0,0,1,2
12562335,12562440,105,0,0,1,1
12562441,12562467,26,1,0,0,1
12562441,12562476,35,1,0,0,2
12562468,12562644,176,0,0,1,1
12562477,12562640,163,0,0,1,2
12562641,12562657,16,1,0,0,2
12562645,12562656,11,1,0,0,1
12562657,12563460,803,0,0,1,1
12562658,12563460,802,0,0,1,2
12563461,12563509,48,1,0,0,2
12563461,12563511,50,1,0,0,1
12563510,12564041,531,0,0,1,2
12563512,12564040,528,0,0,1,1
12564041,12564071,30,1,0,0,1
12564042,12564063,21,1,0,0,2
12564064,12565585,1521,0,0,1,2
12564072,12565585,1513,0,0,1,1
12565586,12565636,50,1,0,0,2
12565586,12565638,52,1,0,0,1
12565637,12565805,168,0,0,1,2
12565639,12565816,177,0,0,1,1
12565806,12566297,491,1,0,0,2
12565817,12566215,398,1,0,0,1
12565832,12566281,449,0,1,0,2
12565842,12565932,90,0,1,0,1
12565965,12566170,205,0,1,0,1
12566216,12566708,492,0,0,1,1
12566298,12566707,409,0,0,1,2
12566708,12566752,44,1,0,0,2
12566709,12566739,30,1,0,0,1
12566740,12566887,147,0,0,1,1
12566753,12566884,131,0,0,1,2
12566885,12566902,17,1,0,0,2
12566888,12566902,14,1,0,0,1
12566903,12568280,1377,0,0,1,1
12566903,12568282,1379,0,0,1,2
12568281,12568336,55,1,0,0,1
12568283,12568334,51,1,0,0,2
12568335,12570406,2071,0,0,1,2
12568337,12570413,2076,0,0,1,1
12570407,12570868,461,1,0,0,2
12570414,12570781,367,1,0,0,1
12570433,12570806,373,0,1,0,2
12570442,12570736,294,0,1,0,1
12570782,12570889,107,0,0,1,1
12570869,12570889,20,0,0,1,2
12570890,12570916,26,1,0,0,1
12570890,12570928,38,1,0,0,2
12570917,12571218,301,0,0,1,1
12570929,12571191,262,0,0,1,2
12571192,12571562,370,1,0,0,2
12571219,12571492,273,1,0,0,1
12571234,12571454,220,0,1,0,2
12571244,12571440,196,0,1,0,1
12571493,12572109,616,0,0,1,1
12571563,12572108,545,0,0,1,2
12572109,12572331,222,1,0,0,2
12572110,12572207,97,1,0,0,1
12572208,12572300,92,0,0,1,1
12572301,12572326,25,1,0,0,1
12572327,12574038,1711,0,0,1,1
12572332,12575258,2926,0,0,1,2
12574039,12574068,29,1,0,0,1
12574069,12575257,1188,0,0,1,1
12575258,12575335,77,1,0,0,1
12575259,12575335,76,1,0,0,2
12575336,12575541,205,0,0,1,2
12575336,12576296,960,0,0,1,1
12575542,12575552,10,1,0,0,2
12575553,12577323,1770,0,0,1,2
12576297,12576309,12,1,0,0,1
12576310,12576958,648,0,0,1,1
12576959,12576967,8,1,0,0,1
12576968,12577335,367,0,0,1,1
12577324,12578122,798,1,0,0,2
12577336,12578060,724,1,0,0,1
12577357,12578071,714,0,1,0,2
12577361,12577630,269,0,1,0,1
12577687,12578051,364,0,1,0,1
12578061,12578352,291,0,0,1,1
12578123,12578348,225,0,0,1,2
12578349,12578780,431,1,0,0,2
12578353,12578401,48,1,0,0,1
12578402,12578438,36,0,0,1,1
12578439,12578717,278,1,0,0,1
12578452,12578714,262,0,1,0,2
12578461,12578680,219,0,1,0,1
12578718,12579128,410,0,0,1,1
12578781,12579127,346,0,0,1,2
12579128,12579324,196,1,0,0,2
12579129,12579241,112,1,0,0,1
12579156,12579173,17,0,1,0,2
12579242,12579371,129,0,0,1,1
12579325,12579367,42,0,0,1,2
12579368,12579385,17,1,0,0,2
12579372,12579507,135,1,0,0,1
12579386,12579807,421,0,0,1,2
12579508,12579670,162,0,0,1,1
12579671,12579718,47,1,0,0,1
12579719,12579808,89,0,0,1,1
12579808,12579887,79,1,0,0,2
12579809,12579868,59,1,0,0,1
12579869,12580064,195,0,0,1,1
12579888,12580067,179,0,0,1,2
12580065,12580084,19,1,0,0,1
12580068,12580116,48,1,0,0,2
12580085,12582006,1921,0,0,1,1
12580117,12581975,1858,0,0,1,2
12581976,12582494,518,1,0,0,2
12582007,12582040,33,1,0,0,1
12582014,12582015,1,0,1,0,2
12582041,12582105,64,0,0,1,1
12582106,12582361,255,1,0,0,1
12582121,12582363,242,0,1,0,2
12582128,12582330,202,0,1,0,1
12582362,12582946,584,0,0,1,1
12582393,12582394,1,0,1,0,2
12582495,12582943,448,0,0,1,2
12582944,12582987,43,1,0,0,2
12582947,12582985,38,1,0,0,1
12582986,12583215,229,0,0,1,1
12582988,12583215,227,0,0,1,2
12583216,12583272,56,1,0,0,1
12583216,12583282,66,1,0,0,2
12583273,12583731,458,0,0,1,1
12583283,12583450,167,0,0,1,2
12583451,12583467,16,1,0,0,2
12583468,12585221,1753,0,0,1,2
12583732,12583736,4,1,0,0,1
12583737,12585221,1484,0,0,1,1
12585222,12585280,58,1,0,0,1
12585222,12585282,60,1,0,0,2
12585281,12585502,221,0,0,1,1
12585283,12585497,214,0,0,1,2
12585498,12585522,24,1,0,0,2
12585503,12585513,10,1,0,0,1
12585514,12587274,1760,0,0,1,1
12585523,12587276,1753,0,0,1,2
12587275,12587529,254,1,0,0,1
12587277,12587826,549,1,0,0,2
12587297,12587528,231,0,1,0,2
12587299,12587502,203,0,1,0,1
12587530,12587553,23,0,0,1,1
12587554,12587766,212,1,0,0,1
12587564,12587764,200,0,1,0,2
12587574,12587738,164,0,1,0,1
12587767,12588651,884,0,0,1,1
12587827,12587962,135,0,0,1,2
12587963,12588002,39,1,0,0,2
12588003,12588448,445,0,0,1,2
12588449,12588586,137,1,0,0,2
12588587,12588632,45,0,0,1,2
12588633,12588724,91,1,0,0,2
12588652,12588672,20,1,0,0,1
12588673,12588873,200,0,0,1,1
12588725,12588870,145,0,0,1,2
12588871,12588912,41,1,0,0,2
12588874,12588915,41,1,0,0,1
12588913,12589031,118,0,0,1,2
12588916,12589043,127,0,0,1,1
12589032,12589406,374,1,0,0,2
12589044,12589318,274,1,0,0,1
12589060,12589318,258,0,1,0,2
12589068,12589291,223,0,1,0,1
12589319,12589481,162,0,0,1,1
12589407,12589480,73,0,0,1,2
12589481,12589556,75,1,0,0,2
12589482,12589730,248,1,0,0,1
12589557,12589692,135,0,0,1,2
12589693,12589720,27,1,0,0,2
12589721,12591021,1300,0,0,1,2
12589731,12589788,57,0,0,1,1
12589789,12589897,108,1,0,0,1
12589898,12589988,90,0,0,1,1
12589989,12590035,46,1,0,0,1
12590036,12590066,30,0,0,1,1
12590067,12590225,158,1,0,0,1
12590226,12590282,56,0,0,1,1
12590283,12590390,107,1,0,0,1
12590391,12590545,154,0,0,1,1
12590546,12590827,281,1,0,0,1
12590828,12590988,160,0,0,1,1
12590989,12591076,87,1,0,0,1
12591022,12591166,144,1,0,0,2
12591077,12591437,360,0,0,1,1
12591167,12591290,123,0,0,1,2
12591291,12591328,37,1,0,0,2
12591329,12591437,108,0,0,1,2
12591438,12591463,25,1,0,0,2
12591438,12591485,47,1,0,0,1
12591464,12593480,2016,0,0,1,2
12591486,12593496,2010,0,0,1,1
12593481,12594219,738,1,0,0,2
12593497,12594158,661,1,0,0,1
12593510,12594186,676,0,1,0,2
12593512,12593744,232,0,1,0,1
12593785,12594148,363,0,1,0,1
12594159,12594465,306,0,0,1,1
12594220,12594451,231,0,0,1,2
12594452,12594725,273,1,0,0,2
12594466,12594663,197,1,0,0,1
12594482,12594656,174,0,1,0,2
12594485,12594640,155,0,1,0,1
12594664,12595174,510,0,0,1,1
12594726,12595174,448,0,0,1,2
12595175,12595216,41,1,0,0,1
12595175,12595218,43,1,0,0,2
12595217,12595322,105,0,0,1,1
12595219,12595322,103,0,0,1,2
12595323,12595413,90,1,0,0,1
12595323,12595417,94,1,0,0,2
12595414,12595507,93,0,0,1,1
12595418,12595508,90,0,0,1,2
12595508,12595542,34,1,0,0,1
12595509,12595541,32,1,0,0,2
12595542,12596363,821,0,0,1,2
12595543,12596363,820,0,0,1,1
12596364,12596415,51,1,0,0,1
12596364,12596415,51,1,0,0,2
12596416,12597326,910,0,0,1,1
12596416,12597327,911,0,0,1,2
12597327,12597337,10,1,0,0,1
12597328,12597333,5,1,0,0,2
12597334,12598461,1127,0,0,1,2
12597338,12598463,1125,0,0,1,1
12598462,12598737,275,1,0,0,2
12598464,12598720,256,1,0,0,1
12598495,12598682,187,0,1,0,2
12598499,12598666,167,0,1,0,1
12598721,12598958,237,0,0,1,1
12598738,12598946,208,0,0,1,2
12598947,12599362,415,1,0,0,2
12598959,12598968,9,1,0,0,1
12598969,12598989,20,0,0,1,1
12598990,12599341,351,1,0,0,1
12599019,12599311,292,0,1,0,2
12599022,12599300,278,0,1,0,1
12599342,12599767,425,0,0,1,1
12599363,12599767,404,0,0,1,2
12599768,12599840,72,1,0,0,2
12599768,12599849,81,1,0,0,1
12599841,12600053,212,0,0,1,2
12599850,12600053,203,0,0,1,1
12600054,12600102,48,1,0,0,1
12600054,12600112,58,1,0,0,2
12600103,12600173,70,0,0,1,1
12600113,12600172,59,0,0,1,2
12600173,12600276,103,1,0,0,2
12600174,12600245,71,1,0,0,1
12600246,12600327,81,0,0,1,1
12600277,12600328,51,0,0,1,2
12600328,12600353,25,1,0,0,1
12600329,12600365,36,1,0,0,2
12600354,12601786,1432,0,0,1,1
12600366,12601786,1420,0,0,1,2
12601787,12601834,47,1,0,0,2
12601787,12601848,61,1,0,0,1
12601835,12602013,178,0,0,1,2
12601849,12602016,167,0,0,1,1
12602014,12602038,24,1,0,0,2
12602017,12602042,25,1,0,0,1
12602039,12603479,1440,0,0,1,2
12602043,12603513,1470,0,0,1,1
12603480,12603946,466,1,0,0,2
12603514,12603784,270,1,0,0,1
12603535,12603768,233,0,1,0,2
12603537,12603744,207,0,1,0,1
12603785,12604070,285,0,0,1,1
12603947,12604046,99,0,0,1,2
12604047,12604362,315,1,0,0,2
12604071,12604262,191,1,0,0,1
12604087,12604237,150,0,1,0,2
12604089,12604223,134,0,1,0,1
12604263,12605298,1035,0,0,1,1
12604363,12604901,538,0,0,1,2
12604902,12605130,228,1,0,0,2
12605131,12605298,167,0,0,1,2
12605299,12605354,55,1,0,0,1
12605299,12605364,65,1,0,0,2
12605355,12605512,157,0,0,1,1
12605365,12605492,127,0,0,1,2
12605493,12605783,290,1,0,0,2
12605513,12605687,174,1,0,0,1
12605527,12605651,124,0,1,0,2
12605530,12605637,107,0,1,0,1
12605688,12605758,70,0,0,1,1
12605759,12605782,23,1,0,0,1
12605783,12605960,177,0,0,1,1
12605784,12605963,179,0,0,1,2
12605961,12605974,13,1,0,0,1
12605964,12605974,10,1,0,0,2
12605975,12606891,916,0,0,1,2
12605975,12607123,1148,0,0,1,1
12606892,12606937,45,1,0,0,2
12606938,12607122,184,0,0,1,2
12607123,12607197,74,1,0,0,2
12607124,12607197,73,1,0,0,1
12607198,12607582,384,0,0,1,2
12607198,12607584,386,0,0,1,1
12607583,12607594,11,1,0,0,2
12607585,12607594,9,1,0,0,1
12607595,12607926,331,0,0,1,2
12607595,12607937,342,0,0,1,1
12607927,12608401,474,1,0,0,2
12607938,12608176,238,1,0,0,1
12607959,12608149,190,0,1,0,1
12607960,12608168,208,0,1,0,2
12608177,12609281,1104,0,0,1,1
12608402,12609189,787,0,0,1,2
12609190,12609212,22,1,0,0,2
12609213,12609266,53,0,0,1,2
12609267,12609329,62,1,0,0,2
12609282,12609292,10,1,0,0,1
12609293,12609416,123,0,0,1,1
12609330,12609391,61,0,0,1,2
12609392,12609696,304,1,0,0,2
12609417,12609624,207,1,0,0,1
12609437,12609617,180,0,1,0,2
12609440,12609588,148,0,1,0,1
12609625,12609761,136,0,0,1,1
12609697,12609738,41,0,0,1,2
12609739,12610152,413,1,0,0,2
12609762,12609995,233,1,0,0,1
12609778,12609990,212,0,1,0,2
12609782,12609960,178,0,1,0,1
12609996,12610444,448,0,0,1,1
12610153,12610443,290,0,0,1,2
12610444,12612678,2234,1,0,0,2
12610445,12610525,80,1,0,0,1
12610526,12610609,83,0,0,1,1
12610610,12610642,32,1,0,0,1
12610643,12610778,135,0,0,1,1
12610779,12610790,11,1,0,0,1
12610791,12610985,194,0,0,1,1
12610986,12611312,326,1,0,0,1
12611004,12611909,905,0,1,0,2
12611005,12611251,246,0,1,0,1
12611313,12613003,1690,0,0,1,1
12612679,12612775,96,0,0,1,2
12612776,12612821,45,1,0,0,2
12612822,12612995,173,0,0,1,2
12612996,12614547,1551,1,0,0,2
12613004,12613063,59,1,0,0,1
12613064,12613410,346,0,0,1,1
12613411,12613431,20,1,0,0,1
12613432,12613806,374,0,0,1,1
12613807,12614048,241,1,0,0,1
12613825,12614071,246,0,1,0,2
12613834,12614029,195,0,1,0,1
12614049,12615123,1074,0,0,1,1
12614548,12615096,548,0,0,1,2
12615097,12615976,879,1,0,0,2
12615124,12615389,265,1,0,0,1
12615143,12615408,265,0,1,0,2
12615150,12615357,207,0,1,0,1
12615390,12616372,982,0,0,1,1
12615977,12616368,391,0,0,1,2
12616369,12617836,1467,1,0,0,2
12616373,12616407,34,1,0,0,1
12616408,12616890,482,0,0,1,1
12616891,12616950,59,1,0,0,1
12616951,12617010,59,0,0,1,1
12617011,12617047,36,1,0,0,1
12617048,12617156,108,0,0,1,1
12617157,12617180,23,1,0,0,1
12617181,12617396,215,0,0,1,1
12617397,12617445,48,1,0,0,1
12617446,12617667,221,0,0,1,1
12617668,12617688,20,1,0,0,1
12617689,12618247,558,0,0,1,1
12617837,12618126,289,0,0,1,2
12618127,12618136,9,1,0,0,2
12618137,12618224,87,0,0,1,2
12618225,12618696,471,1,0,0,2
12618248,12618541,293,1,0,0,1
12618259,12618541,282,0,1,0,2
12618269,12618500,231,0,1,0,1
12618542,12619431,889,0,0,1,1
12618697,12619412,715,0,0,1,2
12619413,12620141,728,1,0,0,2
12619432,12619894,462,1,0,0,1
12619443,12619965,522,0,1,0,2
12619453,12619883,430,0,1,0,1
12619895,12620324,429,0,0,1,1
12620142,12620324,182,0,0,1,2
12620325,12620382,57,1,0,0,1
12620325,12620406,81,1,0,0,2
12620383,12620673,290,0,0,1,1
12620407,12620672,265,0,0,1,2
12620673,12620877,204,1,0,0,2
12620674,12620731,57,1,0,0,1
12620732,12620854,122,0,0,1,1
12620855,12620887,32,1,0,0,1
12620878,12621172,294,0,0,1,2
12620888,12621174,286,0,0,1,1
12621173,12621183,10,1,0,0,2
12621175,12621192,17,1,0,0,1
12621184,12622245,1061,0,0,1,2
12621193,12622268,1075,0,0,1,1
12622246,12622556,310,1,0,0,2
12622269,12622361,92,1,0,0,1
12622362,12622489,127,0,0,1,1
12622490,12622518,28,1,0,0,1
12622519,12624514,1995,0,0,1,1
12622557,12624418,1861,0,0,1,2
12624419,12624586,167,1,0,0,2
12624515,12624544,29,1,0,0,1
12624545,12624676,131,0,0,1,1
12624587,12624644,57,0,0,1,2
12624645,12625171,526,1,0,0,2
12624677,12624912,235,1,0,0,1
12624693,12624928,235,0,1,0,2
12624699,12624890,191,0,1,0,1
12624913,12625848,935,0,0,1,1
12625172,12625848,676,0,0,1,2
12625849,12625903,54,1,0,0,1
12625849,12626131,282,1,0,0,2
12625904,12625978,74,0,0,1,1
12625979,12626007,28,1,0,0,1
12625995,12626028,33,0,1,0,2
12626008,12626103,95,0,0,1,1
12626104,12626153,49,1,0,0,1
12626132,12626152,20,0,0,1,2
12626153,12626455,302,1,0,0,2
12626154,12627526,1372,0,0,1,1
12626456,12627524,1068,0,0,1,2
12627525,12627583,58,1,0,0,2
12627527,12627582,55,1,0,0,1
12627583,12627781,198,0,0,1,1
12627584,12627780,196,0,0,1,2
12627781,12627791,10,1,0,0,2
12627782,12627823,41,1,0,0,1
12627792,12628004,212,0,0,1,2
12627824,12628022,198,0,0,1,1
12628005,12628458,453,1,0,0,2
12628023,12628314,291,1,0,0,1
12628035,12628408,373,0,1,0,2
12628040,12628273,233,0,1,0,1
12628315,12629661,1346,0,0,1,1
12628459,12629646,1187,0,0,1,2
12629647,12631445,1798,1,0,0,2
12629662,12630122,460,1,0,0,1
12629678,12630276,598,0,1,0,2
12629682,12630112,430,0,1,0,1
12630123,12630281,158,0,0,1,1
12630282,12630336,54,1,0,0,1
12630337,12630614,277,0,0,1,1
12630615,12630962,347,1,0,0,1
12630627,12631038,411,0,1,0,2
12630638,12630930,292,0,1,0,1
12630963,12631085,122,0,0,1,1
12631086,12631138,52,1,0,0,1
12631139,12631351,212,0,0,1,1
12631352,12631363,11,1,0,0,1
12631364,12631957,593,0,0,1,1
12631446,12632974,1528,0,0,1,2
12631958,12631962,4,1,0,0,1
12631963,12632013,50,0,0,1,1
12632014,12632064,50,1,0,0,1
12632065,12632209,144,0,0,1,1
12632210,12632216,6,1,0,0,1
12632217,12632502,285,0,0,1,1
12632503,12632571,68,1,0,0,1
12632572,12632786,214,0,0,1,1
12632787,12632807,20,1,0,0,1
12632808,12632974,166,0,0,1,1
12632975,12633027,52,1,0,0,2
12632975,12633036,61,1,0,0,1
12633028,12633245,217,0,0,1,2
12633037,12633249,212,0,0,1,1
12633246,12633261,15,1,0,0,2
12633250,12633263,13,1,0,0,1
12633262,12635052,1790,0,0,1,2
12633264,12635074,1810,0,0,1,1
12635053,12635533,480,1,0,0,2
12635075,12635466,391,1,0,0,1
12635089,12635461,372,0,1,0,2
12635092,12635455,363,0,1,0,1
12635467,12636143,676,0,0,1,1
12635534,12636144,610,0,0,1,2
12636144,12636189,45,1,0,0,1
12636145,12636176,31,1,0,0,2
12636177,12637048,871,0,0,1,2
12636190,12637048,858,0,0,1,1
12637049,12637120,71,1,0,0,1
12637049,12637152,103,1,0,0,2
12637121,12637284,163,0,0,1,1
12637153,12637283,130,0,0,1,2
12637284,12637302,18,1,0,0,2
12637285,12637297,12,1,0,0,1
12637298,12638342,1044,0,0,1,1
12637303,12638341,1038,0,0,1,2
12638342,12638403,61,1,0,0,2
12638343,12638393,50,1,0,0,1
12638394,12638671,277,0,0,1,1
12638404,12638667,263,0,0,1,2
12638668,12638693,25,1,0,0,2
12638672,12638683,11,1,0,0,1
12638684,12640395,1711,0,0,1,1
12638694,12640382,1688,0,0,1,2
12640383,12640877,494,1,0,0,2
12640396,12640831,435,1,0,0,1
12640420,12640866,446,0,1,0,2
12640424,12640820,396,0,1,0,1
12640832,12641142,310,0,0,1,1
12640878,12641141,263,0,0,1,2
12641142,12641169,27,1,0,0,2
12641143,12641168,25,1,0,0,1
12641169,12641635,466,0,0,1,1
12641170,12641635,465,0,0,1,2
12641636,12641704,68,1,0,0,1
12641636,12641707,71,1,0,0,2
12641705,12641819,114,0,0,1,1
12641708,12641820,112,0,0,1,2
12641820,12641869,49,1,0,0,1
12641821,12641851,30,1,0,0,2
12641852,12642566,714,0,0,1,2
12641870,12642570,700,0,0,1,1
12642567,12642794,227,1,0,0,2
12642571,12642786,215,1,0,0,1
12642613,12642739,126,0,1,0,1
12642614,12642747,133,0,1,0,2
12642787,12644094,1307,0,0,1,1
12642795,12644094,1299,0,0,1,2
12644095,12644142,47,1,0,0,2
12644095,12644145,50,1,0,0,1
12644143,12644304,161,0,0,1,2
12644146,12644302,156,0,0,1,1
12644303,12644329,26,1,0,0,1
12644305,12644323,18,1,0,0,2
12644324,12646226,1902,0,0,1,2
12644330,12646226,1896,0,0,1,1
12646227,12646541,314,1,0,0,1
12646227,12646553,326,1,0,0,2
12646263,12646490,227,0,1,0,1
12646263,12646503,240,0,1,0,2
12646542,12646695,153,0,0,1,1
12646554,12646694,140,0,0,1,2
12646695,12646963,268,1,0,0,2
12646696,12646933,237,1,0,0,1
12646720,12646917,197,0,1,0,2
12646724,12646902,178,0,1,0,1
12646934,12647718,784,0,0,1,1
12646964,12647719,755,0,0,1,2
12647719,12647783,64,1,0,0,1
12647720,12647781,61,1,0,0,2
12647782,12647860,78,0,0,1,2
12647784,12647860,76,0,0,1,1
12647861,12647957,96,1,0,0,1
12647861,12648248,387,1,0,0,2
12647958,12648069,111,0,0,1,1
12648070,12648092,22,1,0,0,1
12648093,12648318,225,0,0,1,1
12648249,12648297,48,0,0,1,2
12648298,12648752,454,1,0,0,2
12648319,12648620,301,1,0,0,1
12648330,12648741,411,0,1,0,2
12648340,12648562,222,0,1,0,1
12648621,12648663,42,0,0,1,1
12648664,12648682,18,1,0,0,1
12648683,12649033,350,0,0,1,1
12648753,12649011,258,0,0,1,2
12649012,12649651,639,1,0,0,2
12649034,12649406,372,1,0,0,1
12649040,12649527,487,0,1,0,2
12649055,12649337,282,0,1,0,1
12649407,12650745,1338,0,0,1,1
12649652,12650745,1093,0,0,1,2
12650746,12650798,52,1,0,0,2
12650746,12650816,70,1,0,0,1
12650799,12652930,2131,0,0,1,2
12650817,12652942,2125,0,0,1,1
12652931,12653459,528,1,0,0,2
12652943,12653378,435,1,0,0,1
12652963,12653448,485,0,1,0,2
12652972,12653368,396,0,1,0,1
12653379,12654715,1336,0,0,1,1
12653460,12654715,1255,0,0,1,2
12654716,12654755,39,1,0,0,1
12654716,12654757,41,1,0,0,2
12654756,12654860,104,0,0,1,1
12654758,12654860,102,0,0,1,2
12654861,12654893,32,1,0,0,2
12654861,12654895,34,1,0,0,1
12654894,12656699,1805,0,0,1,2
12654896,12655227,331,0,0,1,1
12655228,12655241,13,1,0,0,1
12655242,12656699,1457,0,0,1,1
12656700,12656757,57,1,0,0,1
12656700,12656805,105,1,0,0,2
12656758,12656952,194,0,0,1,1
12656806,12656952,146,0,0,1,2
12656953,12656973,20,1,0,0,2
12656953,12657028,75,1,0,0,1
12656974,12658771,1797,0,0,1,2
12657029,12657114,85,0,0,1,1
12657115,12657149,34,1,0,0,1
12657150,12658270,1120,0,0,1,1
12658271,12658296,25,1,0,0,1
12658297,12658392,95,0,0,1,1
12658393,12658404,11,1,0,0,1
12658405,12658431,26,0,0,1,1
12658432,12658469,37,1,0,0,1
12658470,12658674,204,0,0,1,1
12658675,12659672,997,1,0,0,1
12658772,12659793,1021,1,0,0,2
12658807,12659782,975,0,1,0,2
12658813,12659308,495,0,1,0,1
12659337,12659565,228,0,1,0,1
12659673,12660078,405,0,0,1,1
12659794,12660078,284,0,0,1,2
12660079,12660109,30,1,0,0,1
12660079,12660119,40,1,0,0,2
12660110,12660491,381,0,0,1,1
12660120,12660447,327,0,0,1,2
12660448,12661101,653,1,0,0,2
12660492,12660729,237,1,0,0,1
12660500,12660739,239,0,1,0,2
12660514,12660692,178,0,1,0,1
12660730,12660829,99,0,0,1,1
12660830,12660887,57,1,0,0,1
12660888,12661051,163,0,0,1,1
12661052,12661063,11,1,0,0,1
12661064,12661858,794,0,0,1,1
12661102,12661853,751,0,0,1,2
12661854,12661889,35,1,0,0,2
12661859,12661890,31,1,0,0,1
12661890,12662490,600,0,0,1,2
12661891,12662493,602,0,0,1,1
12662491,12662547,56,1,0,0,2
12662494,12662554,60,1,0,0,1
12662548,12663120,572,0,0,1,2
12662555,12664834,2279,0,0,1,1
12663121,12663141,20,1,0,0,2
12663142,12664822,1680,0,0,1,2
12664823,12665455,632,1,0,0,2
12664835,12665358,523,1,0,0,1
12664848,12665444,596,0,1,0,2
12664853,12665348,495,0,1,0,1
12665359,12665892,533,0,0,1,1
12665456,12665894,438,0,0,1,2
12665893,12665934,41,1,0,0,1
12665895,12665921,26,1,0,0,2
12665922,12666315,393,0,0,1,2
12665935,12666315,380,0,0,1,1
12666316,12666391,75,1,0,0,1
12666316,12666443,127,1,0,0,2
12666392,12666487,95,0,0,1,1
12666444,12666487,43,0,0,1,2
12666488,12666515,27,1,0,0,1
12666488,12666515,27,1,0,0,2
12666516,12666696,180,0,0,1,2
12666516,12667884,1368,0,0,1,1
12666697,12666711,14,1,0,0,2
12666712,12667471,759,0,0,1,2
12667472,12667503,31,1,0,0,2
12667504,12667589,85,0,0,1,2
12667590,12667648,58,1,0,0,2
12667649,12667708,59,0,0,1,2
12667709,12667958,249,1,0,0,2
12667885,12667950,65,1,0,0,1
12667951,12668080,129,0,0,1,1
12667959,12668079,120,0,0,1,2
12668080,12668106,26,1,0,0,2
12668081,12668124,43,1,0,0,1
12668107,12669754,1647,0,0,1,2
12668125,12669748,1623,0,0,1,1
12669749,12669769,20,1,0,0,1
12669755,12669770,15,1,0,0,2
12669770,12669974,204,0,0,1,1
12669771,12669963,192,0,0,1,2
12669964,12670256,292,1,0,0,2
12669975,12670204,229,1,0,0,1
12670001,12670194,193,0,1,0,2
12670003,12670181,178,0,1,0,1
12670205,12670416,211,0,0,1,1
12670257,12670404,147,0,0,1,2
12670405,12670748,343,1,0,0,2
12670417,12670688,271,1,0,0,1
12670442,12670683,241,0,1,0,2
12670448,12670660,212,0,1,0,1
12670689,12671019,330,0,0,1,1
12670749,12671020,271,0,0,1,2
12671020,12671046,26,1,0,0,1
12671021,12671072,51,1,0,0,2
12671047,12671331,284,0,0,1,1
12671073,12671332,259,0,0,1,2
12671332,12671405,73,1,0,0,1
12671333,12671399,66,1,0,0,2
12671400,12671495,95,0,0,1,2
12671406,12671495,89,0,0,1,1
12671496,12671524,28,1,0,0,1
12671496,12671524,28,1,0,0,2
12671525,12672739,1214,0,0,1,1
12671525,12672740,1215,0,0,1,2
12672740,12672786,46,1,0,0,1
12672741,12672786,45,1,0,0,2
12672787,12672963,176,0,0,1,1
12672787,12672963,176,0,0,1,2
12672964,12672984,20,1,0,0,1
12672964,12672984,20,1,0,0,2
12672985,12674749,1764,0,0,1,2
12672985,12674753,1768,0,0,1,1
12674750,12675128,378,1,0,0,2
12674754,12675089,335,1,0,0,1
12674776,12675060,284,0,1,0,2
12674782,12675043,261,0,1,0,1
12675090,12675182,92,0,0,1,1
12675129,12675168,39,0,0,1,2
12675169,12675480,311,1,0,0,2
12675183,12675438,255,1,0,0,1
12675199,12675403,204,0,1,0,2
12675207,12675383,176,0,1,0,1
12675439,12675901,462,0,0,1,1
12675481,12675900,419,0,0,1,2
12675901,12675929,28,1,0,0,2
12675902,12675927,25,1,0,0,1
12675928,12676074,146,0,0,1,1
12675930,12676074,144,0,0,1,2
12676075,12676146,71,1,0,0,1
12676075,12676247,172,1,0,0,2
12676147,12676396,249,0,0,1,1
12676248,12676397,149,0,0,1,2
12676397,12676405,8,1,0,0,1
12676398,12676412,14,1,0,0,2
12676406,12677772,1366,0,0,1,1
12676413,12677773,1360,0,0,1,2
12677773,12677844,71,1,0,0,1
12677774,12677842,68,1,0,0,2
12677843,12678526,683,0,0,1,2
12677845,12678526,681,0,0,1,1
12678527,12678547,20,1,0,0,2
12678527,12678561,34,1,0,0,1
12678548,12679500,952,0,0,1,2
12678562,12679500,938,0,0,1,1
12679501,12679523,22,1,0,0,1
12679501,12679524,23,1,0,0,2
12679524,12679834,310,0,0,1,1
12679525,12679827,302,0,0,1,2
12679828,12680312,484,1,0,0,2
12679835,12680276,441,1,0,0,1
12679854,12680301,447,0,1,0,2
12679861,12680257,396,0,1,0,1
12680277,12680651,374,0,0,1,1
12680313,12680637,324,0,0,1,2
12680638,12681079,441,1,0,0,2
12680652,12680949,297,1,0,0,1
12680672,12680941,269,0,1,0,2
12680678,12680903,225,0,1,0,1
12680950,12681033,83,0,0,1,1
12681034,12681090,56,1,0,0,1
12681080,12681484,404,0,0,1,2
12681091,12681484,393,0,0,1,1
12681485,12681550,65,1,0,0,1
12681485,12681664,179,1,0,0,2
12681551,12681723,172,0,0,1,1
12681665,12681689,24,0,0,1,2
12681690,12681763,73,1,0,0,2
12681724,12681735,11,1,0,0,1
12681736,12683332,1596,0,0,1,1
12681764,12681960,196,0,0,1,2
12681961,12682016,55,1,0,0,2
12682017,12682249,232,0,0,1,2
12682250,12682305,55,1,0,0,2
12682306,12682381,75,0,0,1,2
12682382,12682391,9,1,0,0,2
12682392,12682429,37,0,0,1,2
12682430,12682574,144,1,0,0,2
12682575,12682756,181,0,0,1,2
12682757,12682905,148,1,0,0,2
12682906,12683174,268,0,0,1,2
12683175,12683193,18,1,0,0,2
12683194,12683226,32,0,0,1,2
12683227,12683232,5,1,0,0,2
12683233,12683331,98,0,0,1,2
12683332,12683386,54,1,0,0,2
12683333,12683379,46,1,0,0,1
12683380,12683781,401,0,0,1,1
12683387,12683777,390,0,0,1,2
12683778,12683808,30,1,0,0,2
12683782,12683801,19,1,0,0,1
12683802,12685757,1955,0,0,1,1
12683809,12685751,1942,0,0,1,2
12685752,12686160,408,1,0,0,2
12685758,12686091,333,1,0,0,1
12685773,12686146,373,0,1,0,2
12685780,12686052,272,0,1,0,1
12686092,12686560,468,0,0,1,1
12686161,12686561,400,0,0,1,2
12686561,12686612,51,1,0,0,1
12686562,12686618,56,1,0,0,2
12686613,12686800,187,0,0,1,1
12686619,12686801,182,0,0,1,2
12686801,12686879,78,1,0,0,1
12686802,12686873,71,1,0,0,2
12686874,12687038,164,0,0,1,2
12686880,12687387,507,0,0,1,1
12687039,12687048,9,1,0,0,2
12687049,12687383,334,0,0,1,2
12687384,12687409,25,1,0,0,2
12687388,12687410,22,1,0,0,1
12687410,12688699,1289,0,0,1,2
12687411,12688699,1288,0,0,1,1
12688700,12688765,65,1,0,0,2
12688700,12688775,75,1,0,0,1
12688766,12688917,151,0,0,1,2
12688776,12688917,141,0,0,1,1
12688918,12688939,21,1,0,0,1
12688918,12688941,23,1,0,0,2
12688940,12689161,221,0,0,1,1
12688942,12689162,220,0,0,1,2
12689162,12689173,11,1,0,0,1
12689163,12689173,10,1,0,0,2
12689174,12690883,1709,0,0,1,2
12689174,12690884,1710,0,0,1,1
12690884,12690901,17,1,0,0,2
12690885,12690921,36,1,0,0,1
12690902,12691060,158,0,0,1,2
12690922,12691076,154,0,0,1,1
12691061,12691547,486,1,0,0,2
12691077,12691491,414,1,0,0,1
12691110,12691482,372,0,1,0,2
12691117,12691480,363,0,1,0,1
12691492,12691762,270,0,0,1,1
12691548,12691762,214,0,0,1,2
12691763,12691797,34,1,0,0,1
12691763,12691809,46,1,0,0,2
12691798,12691885,87,0,0,1,1
12691810,12691868,58,0,0,1,2
12691869,12692339,470,1,0,0,2
12691886,12692283,397,1,0,0,1
12691901,12692273,372,0,1,0,2
12691909,12692273,364,0,1,0,1
12692284,12692662,378,0,0,1,1
12692340,12692420,80,0,0,1,2
12692421,12692457,36,1,0,0,2
12692458,12692581,123,0,0,1,2
12692582,12692593,11,1,0,0,2
12692594,12692661,67,0,0,1,2
12692662,12692777,115,1,0,0,2
12692663,12692747,84,1,0,0,1
12692748,12692837,89,0,0,1,1
12692778,12692837,59,0,0,1,2
12692838,12692872,34,1,0,0,1
12692838,12692875,37,1,0,0,2
12692873,12694373,1500,0,0,1,1
12692876,12694373,1497,0,0,1,2
12694374,12694420,46,1,0,0,2
12694374,12694438,64,1,0,0,1
12694421,12694715,294,0,0,1,2
12694439,12694711,272,0,0,1,1
12694712,12694733,21,1,0,0,1
12694716,12694721,5,1,0,0,2
12694722,12696452,1730,0,0,1,2
12694734,12696461,1727,0,0,1,1
12696453,12697335,882,1,0,0,2
12696462,12697257,795,1,0,0,1
12696480,12697055,575,0,1,0,2
12696482,12696675,193,0,1,0,1
12696697,12696823,126,0,1,0,1
12696901,12697038,137,0,1,0,1
12697098,12697257,159,0,1,0,2
12697101,12697237,136,0,1,0,1
12697258,12697539,281,0,0,1,1
12697336,12697538,202,0,0,1,2
12697539,12697609,70,1,0,0,2
12697540,12697606,66,1,0,0,1
12697607,12698031,424,0,0,1,1
12697610,12698031,421,0,0,1,2
12698032,12698097,65,1,0,0,1
12698032,12698125,93,1,0,0,2
12698098,12698194,96,0,0,1,1
12698126,12698194,68,0,0,1,2
12698195,12698232,37,1,0,0,1
12698195,12698236,41,1,0,0,2
12698233,12698841,608,0,0,1,1
12698237,12699723,1486,0,0,1,2
12698842,12698849,7,1,0,0,1
12698850,12699724,874,0,0,1,1
12699724,12699778,54,1,0,0,2
12699725,12699811,86,1,0,0,1
12699779,12700116,337,0,0,1,2
12699812,12700111,299,0,0,1,1
12700112,12700139,27,1,0,0,1
12700117,12700138,21,1,0,0,2
12700139,12700466,327,0,0,1,2
12700140,12700472,332,0,0,1,1
12700467,12700473,6,1,0,0,2
12700473,12700488,15,1,0,0,1
12700474,12701765,1291,0,0,1,2
12700489,12700980,491,0,0,1,1
12700981,12701023,42,1,0,0,1
12701024,12701715,691,0,0,1,1
12701716,12701720,4,1,0,0,1
12701721,12701785,64,0,0,1,1
12701766,12702882,1116,1,0,0,2
12701786,12702776,990,1,0,0,1
12701796,12702796,1000,0,1,0,2
12701808,12702766,958,0,1,0,1
12702777,12703032,255,0,0,1,1
12702883,12703031,148,0,0,1,2
12703032,12703083,51,1,0,0,2
12703033,12703084,51,1,0,0,1
12703084,12703185,101,0,0,1,2
12703085,12703186,101,0,0,1,1
12703186,12703252,66,1,0,0,2
12703187,12703240,53,1,0,0,1
12703241,12703549,308,0,0,1,1
12703253,12703302,49,0,0,1,2
12703303,12703478,175,1,0,0,2
12703479,12703523,44,0,0,1,2
12703524,12703626,102,1,0,0,2
12703550,12703609,59,1,0,0,1
12703610,12703783,173,0,0,1,1
12703627,12703787,160,0,0,1,2
12703784,12703801,17,1,0,0,1
12703788,12703818,30,1,0,0,2
12703802,12703893,91,0,0,1,1
12703819,12703886,67,0,0,1,2
12703887,12704666,779,1,0,0,2
12703894,12704623,729,1,0,0,1
12703914,12704618,704,0,1,0,2
12703918,12704612,694,0,1,0,1
12704624,12704694,70,0,0,1,1
12704667,12704692,25,0,0,1,2
12704693,12704728,35,1,0,0,2
12704695,12704730,35,1,0,0,1
12704729,12705033,304,0,0,1,2
12704731,12705034,303,0,0,1,1
12705034,12705079,45,1,0,0,2
12705035,12705066,31,1,0,0,1
12705067,12705239,172,0,0,1,1
12705080,12705232,152,0,0,1,2
12705233,12705523,290,1,0,0,2
12705240,12705498,258,1,0,0,1
12705261,12705468,207,0,1,0,2
12705265,12705454,189,0,1,0,1
12705499,12705738,239,0,0,1,1
12705524,12705738,214,0,0,1,2
12705739,12705770,31,1,0,0,1
12705739,12705771,32,1,0,0,2
12705771,12705999,228,0,0,1,1
12705772,12705998,226,0,0,1,2
12705999,12706023,24,1,0,0,2
12706000,12706031,31,1,0,0,1
12706024,12706166,142,0,0,1,2
12706032,12706174,142,0,0,1,1
12706167,12706670,503,1,0,0,2
12706175,12706580,405,1,0,0,1
12706199,12706571,372,0,1,0,2
12706205,12706569,364,0,1,0,1
12706581,12706619,38,0,0,1,1
12706620,12706666,46,1,0,0,1
12706667,12706920,253,0,0,1,1
12706671,12706920,249,0,0,1,2
12971187,12971221,34,0,0,1,2
12971187,12971233,46,0,0,1,1
12971222,12971540,318,1,0,0,2
12971234,12971486,252,1,0,0,1
12971317,12971446,129,0,1,0,1
12971317,12971464,147,0,1,0,2
12971487,12971918,431,0,0,1,1
12971541,12971919,378,0,0,1,2
12971919,12971937,18,1,0,0,1
12971920,12971938,18,1,0,0,2
12971938,12972435,497,0,0,1,1
12971939,12972434,495,0,0,1,2
12972435,12972508,73,1,0,0,2
12972436,12972506,70,1,0,0,1
12972507,12972619,112,0,0,1,1
12972509,12972620,111,0,0,1,2
12972620,12972645,25,1,0,0,1
12972621,12972647,26,1,0,0,2
12972646,12972755,109,0,0,1,1
12972648,12972751,103,0,0,1,2
12972752,12973063,311,1,0,0,2
12972756,12973070,314,1,0,0,1
12972781,12973021,240,0,1,0,2
12972783,12973001,218,0,1,0,1
12973064,12973251,187,0,0,1,2
12973071,12973248,177,0,0,1,1
12973249,12974018,769,1,0,0,1
12973252,12974086,834,1,0,0,2
12973278,12974020,742,0,1,0,2
12973299,12973992,693,0,1,0,1
12974019,12974050,31,0,0,1,1
12974051,12974087,36,1,0,0,1
12974087,12974226,139,0,0,1,2
12974088,12974225,137,0,0,1,1
12974226,12974242,16,1,0,0,1
12974227,12974252,25,1,0,0,2
12974243,12976472,2229,0,0,1,1
12974253,12974617,364,0,0,1,2
12974618,12974636,18,1,0,0,2
12974637,12976472,1835,0,0,1,2
12976473,12976573,100,1,0,0,1
12976473,12976573,100,1,0,0,2
12976574,12976655,81,0,0,1,1
12976574,12976657,83,0,0,1,2
12976656,12976694,38,1,0,0,1
12976658,12976681,23,1,0,0,2
12976682,12977919,1237,0,0,1,2
12976695,12977022,327,0,0,1,1
12977023,12977037,14,1,0,0,1
12977038,12977925,887,0,0,1,1
12977920,12977960,40,1,0,0,2
12977926,12977959,33,1,0,0,1
12977960,12978335,375,0,0,1,1
12977961,12978338,377,0,0,1,2
12978336,12978394,58,1,0,0,1
12978339,12978407,68,1,0,0,2
12978395,12978446,51,0,0,1,1
12978408,12978439,31,0,0,1,2
12978440,12978756,316,1,0,0,2
12978447,12978715,268,1,0,0,1
12978458,12978700,242,0,1,0,2
12978463,12978676,213,0,1,0,1
12978716,12978777,61,0,0,1,1
12978757,12980126,1369,0,0,1,2
12978778,12978787,9,1,0,0,1
12978788,12980129,1341,0,0,1,1
12980127,12980181,54,1,0,0,2
12980130,12980184,54,1,0,0,1
12980182,12980349,167,0,0,1,2
12980185,12980348,163,0,0,1,1
12980349,12980371,22,1,0,0,1
12980350,12980360,10,1,0,0,2
12980361,12981951,1590,0,0,1,2
12980372,12981951,1579,0,0,1,1
12981952,12982041,89,1,0,0,1
12981952,12982072,120,1,0,0,2
12982032,12982062,30,0,1,0,2
12982042,12982135,93,0,0,1,1
12982073,12982137,64,0,0,1,2
12982136,12982163,27,1,0,0,1
12982138,12982173,35,1,0,0,2
12982164,12983300,1136,0,0,1,1
12982174,12982338,164,0,0,1,2
12982339,12982343,4,1,0,0,2
12982344,12983299,955,0,0,1,2
12983300,12983429,129,1,0,0,2
12983301,12983407,106,1,0,0,1
12983408,12983800,392,0,0,1,1
12983430,12983801,371,0,0,1,2
12983801,12983908,107,1,0,0,1
12983802,12983883,81,1,0,0,2
12983884,12983977,93,0,0,1,2
12983909,12983976,67,0,0,1,1
12983977,12984019,42,1,0,0,1
12983978,12984022,44,1,0,0,2
12984020,12984241,221,0,0,1,1
12984023,12984236,213,0,0,1,2
12984237,12984257,20,1,0,0,2
12984242,12984256,14,1,0,0,1
12984257,12984371,114,0,0,1,1
12984258,12984366,108,0,0,1,2
12984367,12984615,248,1,0,0,2
12984372,12984617,245,1,0,0,1
12984391,12984577,186,0,1,0,2
12984396,12984553,157,0,1,0,1
12984616,12985637,1021,0,0,1,2
12984618,12985637,1019,0,0,1,1
12985638,12985746,108,1,0,0,2
12985638,12985747,109,1,0,0,1
12985747,12985820,73,0,0,1,2
12985748,12985820,72,0,0,1,1
12985821,12985849,28,1,0,0,2
12985821,12985860,39,1,0,0,1
12985850,12986010,160,0,0,1,2
12985861,12986010,149,0,0,1,1
12986011,12986022,11,1,0,0,2
12986011,12986023,12,1,0,0,1
12986023,12986819,796,0,0,1,2
12986024,12986828,804,0,0,1,1
12986820,12987092,272,1,0,0,2
12986829,12987027,198,1,0,0,1
12986843,12987025,182,0,1,0,2
12986848,12986994,146,0,1,0,1
12987028,12987376,348,0,0,1,1
12987093,12987377,284,0,0,1,2
12987377,12987470,93,1,0,0,1
12987378,12987654,276,1,0,0,2
12987428,12987625,197,0,1,0,2
12987471,12987557,86,0,0,1,1
12987558,12987593,35,1,0,0,1
12987594,12987697,103,0,0,1,1
12987655,12987698,43,0,0,1,2
12987698,12987717,19,1,0,0,1
12987699,12987717,18,1,0,0,2
12987718,12988719,1001,0,0,1,1
12987718,12988720,1002,0,0,1,2
12988720,12988822,102,1,0,0,1
12988721,12988825,104,1,0,0,2
12988773,12988773,0,0,1,0,2
12988823,12989184,361,0,0,1,1
12988826,12989082,256,0,0,1,2
12989083,12989087,4,1,0,0,2
12989088,12989184,96,0,0,1,2
12989185,12989245,60,1,0,0,1
12989185,12989257,72,1,0,0,2
12989246,12989727,481,0,0,1,1
12989258,12989724,466,0,0,1,2
12989725,12990005,280,1,0,0,2
12989728,12990001,273,1,0,0,1
12989746,12989991,245,0,1,0,2
12989749,12989929,180,0,1,0,1
12990002,12990954,952,0,0,1,1
12990006,12990954,948,0,0,1,2
12990955,12991046,91,1,0,0,1
12990955,12991059,104,1,0,0,2
12991047,12991136,89,0,0,1,1
12991060,12991136,76,0,0,1,2
12991137,12991176,39,1,0,0,1
12991137,12991177,40,1,0,0,2
12991177,12991328,151,0,0,1,1
12991178,12991328,150,0,0,1,2
12991329,12991340,11,1,0,0,2
12991329,12991342,13,1,0,0,1
12991341,12992753,1412,0,0,1,2
12991343,12992753,1410,0,0,1,1
12992754,12992822,68,1,0,0,1
12992754,12992823,69,1,0,0,2
12992823,12992905,82,0,0,1,1
12992824,12992905,81,0,0,1,2
12992906,12992931,25,1,0,0,1
12992906,12992932,26,1,0,0,2
12992932,12993033,101,0,0,1,1
12992933,12993032,99,0,0,1,2
12993033,12993055,22,1,0,0,2
12993034,12993054,20,1,0,0,1
12993055,12993276,221,0,0,1,1
12993056,12993261,205,0,0,1,2
12993262,12993547,285,1,0,0,2
12993277,12993507,230,1,0,0,1
12993292,12993500,208,0,1,0,2
12993298,12993468,170,0,1,0,1
12993508,12994474,966,0,0,1,1
12993548,12994473,925,0,0,1,2
12994474,12994576,102,1,0,0,2
12994475,12994575,100,1,0,0,1
12994576,12994651,75,0,0,1,1
12994577,12994650,73,0,0,1,2
12994651,12994694,43,1,0,0,2
12994652,12994690,38,1,0,0,1
12994691,12994770,79,0,0,1,1
12994695,12994770,75,0,0,1,2
12994771,12994801,30,1,0,0,1
12994771,12994803,32,1,0,0,2
12994802,12994938,136,0,0,1,1
12994804,12994937,133,0,0,1,2
12994938,12994968,30,1,0,0,2
12994939,12994953,14,1,0,0,1
12994954,12995738,784,0,0,1,1
12994969,12995732,763,0,0,1,2
12995733,12995763,30,1,0,0,2
12995739,12995752,13,1,0,0,1
12995753,12996186,433,0,0,1,1
12995764,12996186,422,0,0,1,2
12996187,12996293,106,1,0,0,2
12996187,12996295,108,1,0,0,1
12996294,12996383,89,0,0,1,2
12996296,12996382,86,0,0,1,1
12996383,12996418,35,1,0,0,1
12996384,12996416,32,1,0,0,2
12996417,12997876,1459,0,0,1,2
12996419,12997875,1456,0,0,1,1
12997876,12997941,65,1,0,0,1
12997877,12997941,64,1,0,0,2
12997942,12998058,116,0,0,1,2
12997942,12998059,117,0,0,1,1
12998059,12998081,22,1,0,0,2
12998060,12998081,21,1,0,0,1
12998082,12998526,444,0,0,1,2
12998082,12998643,561,0,0,1,1
12998527,12998555,28,1,0,0,2
12998556,12998615,59,0,0,1,2
12998616,12998937,321,1,0,0,2
12998644,12998857,213,1,0,0,1
12998653,12998857,204,0,1,0,2
12998661,12998818,157,0,1,0,1
12998858,12999586,728,0,0,1,1
12998938,12999126,188,0,0,1,2
12999127,12999284,157,1,0,0,2
12999285,12999362,77,0,0,1,2
12999363,12999370,7,1,0,0,2
12999371,12999452,81,0,0,1,2
12999453,12999508,55,1,0,0,2
12999509,12999570,61,0,0,1,2
12999571,12999696,125,1,0,0,2
12999587,12999698,111,1,0,0,1
12999697,12999802,105,0,0,1,2
12999699,12999801,102,0,0,1,1
12999802,12999838,36,1,0,0,1
12999803,12999836,33,1,0,0,2
12999837,13001238,1401,0,0,1,2
12999839,13001238,1399,0,0,1,1
13001239,13001378,139,1,0,0,1
13001239,13001380,141,1,0,0,2
13001379,13001445,66,0,0,1,1
13001381,13001444,63,0,0,1,2
13001445,13001486,41,1,0,0,2
13001446,13001501,55,1,0,0,1
13001487,13001559,72,0,0,1,2
13001502,13001561,59,0,0,1,1
13001560,13001583,23,1,0,0,2
13001562,13001584,22,1,0,0,1
13001584,13002948,1364,0,0,1,2
13001585,13002948,1363,0,0,1,1
13002949,13003010,61,1,0,0,1
13002949,13003018,69,1,0,0,2
13003011,13003526,515,0,0,1,1
13003019,13003512,493,0,0,1,2
13003513,13003950,437,1,0,0,2
13003527,13003830,303,1,0,0,1
13003533,13003906,373,0,1,0,2
13003547,13003786,239,0,1,0,1
13003831,13004735,904,0,0,1,1
13003951,13004736,785,0,0,1,2
13004736,13004800,64,1,0,0,1
13004737,13004875,138,1,0,0,2
13004801,13004914,113,0,0,1,1
13004876,13004915,39,0,0,1,2
13004915,13004934,19,1,0,0,1
13004916,13004946,30,1,0,0,2
13004935,13006561,1626,0,0,1,1
13004947,13006560,1613,0,0,1,2
13006561,13006717,156,1,0,0,2
13006562,13006836,274,1,0,0,1
13006594,13006607,13,0,1,0,2
13006718,13006784,66,0,0,1,2
13006785,13006832,47,1,0,0,2
13006833,13007847,1014,0,0,1,2
13006837,13007052,215,0,0,1,1
13007053,13007065,12,1,0,0,1
13007066,13007137,71,0,0,1,1
13007138,13007142,4,1,0,0,1
13007143,13007847,704,0,0,1,1
13007848,13007931,83,1,0,0,2
13007848,13007939,91,1,0,0,1
13007932,13008264,332,0,0,1,2
13007940,13008263,323,0,0,1,1
13008264,13008350,86,1,0,0,1
13008265,13008429,164,1,0,0,2
13008333,13008406,73,0,1,0,2
13008351,13008538,187,0,0,1,1
13008430,13008503,73,0,0,1,2
13008504,13008597,93,1,0,0,2
13008539,13008554,15,1,0,0,1
13008555,13009429,874,0,0,1,1
13008598,13008741,143,0,0,1,2
13008742,13008770,28,1,0,0,2
13008771,13009415,644,0,0,1,2
13009416,13009570,154,1,0,0,2
13009430,13009481,51,1,0,0,1
13009482,13009978,496,0,0,1,1
13009571,13009979,408,0,0,1,2
13009979,13010054,75,1,0,0,1
13009980,13010085,105,1,0,0,2
13010031,13010034,3,0,1,0,2
13010055,13010161,106,0,0,1,1
13010086,13010159,73,0,0,1,2
13010160,13010192,32,1,0,0,2
13010162,13010182,20,1,0,0,1
13010183,13010548,365,0,0,1,1
13010193,13010541,348,0,0,1,2
13010542,13010691,149,1,0,0,2
13010549,13010669,120,1,0,0,1
13010587,13010658,71,0,1,0,2
13010670,13011240,570,0,0,1,1
13010692,13010722,30,0,0,1,2
13010723,13010738,15,1,0,0,2
13010739,13010921,182,0,0,1,2
13010922,13010935,13,1,0,0,2
13010936,13011240,304,0,0,1,2
13011241,13011296,55,1,0,0,2
13011241,13011297,56,1,0,0,1
13011297,13011610,313,0,0,1,2
13011298,13011610,312,0,0,1,1
13011611,13011664,53,1,0,0,1
13011611,13011671,60,1,0,0,2
13011665,13011773,108,0,0,1,1
13011672,13011773,101,0,0,1,2
13011774,13012159,385,1,0,0,1
13011774,13012169,395,1,0,0,2
13011822,13012105,283,0,1,0,2
13011826,13012063,237,0,1,0,1
13012142,13012150,8,0,1,0,2
13012160,13013341,1181,0,0,1,1
13012170,13013342,1172,0,0,1,2
13013342,13013397,55,1,0,0,1
13013343,13013397,54,1,0,0,2
13013398,13013523,125,0,0,1,1
13013398,13013524,126,0,0,1,2
13013524,13013543,19,1,0,0,1
13013525,13013544,19,1,0,0,2
13013544,13015096,1552,0,0,1,1
13013545,13015095,1550,0,0,1,2
13015096,13015215,119,1,0,0,2
13015097,13015180,83,1,0,0,1
13015181,13015267,86,0,0,1,1
13015216,13015267,51,0,0,1,2
13015268,13015297,29,1,0,0,1
13015268,13015301,33,1,0,0,2
13015298,13015496,198,0,0,1,1
13015302,13016670,1368,0,0,1,2
13015497,13015509,12,1,0,0,1
13015510,13016670,1160,0,0,1,1
13016671,13016721,50,1,0,0,2
13016671,13016725,54,1,0,0,1
13016722,13016830,108,0,0,1,2
13016726,13016830,104,0,0,1,1
13016831,13016849,18,1,0,0,2
13016831,13016855,24,1,0,0,1
13016850,13018492,1642,0,0,1,2
13016856,13018491,1635,0,0,1,1
13018492,13018627,135,1,0,0,1
13018493,13018622,129,1,0,0,2
13018623,13018725,102,0,0,1,2
13018628,13018723,95,0,0,1,1
13018724,13018749,25,1,0,0,1
13018726,13018757,31,1,0,0,2
13018750,13019213,463,0,0,1,1
13018758,13019214,456,0,0,1,2
13019214,13019230,16,1,0,0,1
13019215,13019231,16,1,0,0,2
13019231,13020105,874,0,0,1,1
13019232,13020105,873,0,0,1,2
13020106,13020153,47,1,0,0,1
13020106,13020153,47,1,0,0,2
13020154,13020266,112,0,0,1,1
13020154,13020267,113,0,0,1,2
13020267,13020297,30,1,0,0,1
13020268,13020289,21,1,0,0,2
13020290,13020489,199,0,0,1,2
13020298,13020497,199,0,0,1,1
13020490,13020718,228,1,0,0,2
13020498,13020714,216,1,0,0,1
13020527,13020669,142,0,1,0,2
13020531,13020642,111,0,1,0,1
13020715,13021682,967,0,0,1,1
13020719,13021685,966,0,0,1,2
13021683,13021735,52,1,0,0,1
13021686,13021734,48,1,0,0,2
13021735,13021890,155,0,0,1,2
13021736,13023366,1630,0,0,1,1
13021891,13021904,13,1,0,0,2
13021905,13023366,1461,0,0,1,2
13023367,13023443,76,1,0,0,1
13023367,13023445,78,1,0,0,2
13023444,13023680,236,0,0,1,1
13023446,13023663,217,0,0,1,2
13023664,13023962,298,1,0,0,2
13023681,13023936,255,1,0,0,1
13023708,13023912,204,0,1,0,2
13023711,13023888,177,0,1,0,1
13023937,13025052,1115,0,0,1,1
13023963,13025052,1089,0,0,1,2
13025053,13025127,74,1,0,0,2
13025053,13025136,83,1,0,0,1
13025128,13025223,95,0,0,1,2
13025137,13025222,85,0,0,1,1
13025223,13025266,43,1,0,0,1
13025224,13025255,31,1,0,0,2
13025256,13026706,1450,0,0,1,2
13025267,13026706,1439,0,0,1,1
13026707,13026804,97,1,0,0,2
13026707,13026805,98,1,0,0,1
13026805,13026908,103,0,0,1,2
13026806,13026907,101,0,0,1,1
13026908,13026944,36,1,0,0,1
13026909,13026947,38,1,0,0,2
13026945,13028359,1414,0,0,1,1
13026948,13028360,1412,0,0,1,2
13028360,13028458,98,1,0,0,1
13028361,13028451,90,1,0,0,2
13028452,13028565,113,0,0,1,2
13028459,13028565,106,0,0,1,1
13028566,13028600,34,1,0,0,2
13028566,13028601,35,1,0,0,1
13028601,13028833,232,0,0,1,2
13028602,13028836,234,0,0,1,1
13028834,13028844,10,1,0,0,2
13028837,13028845,8,1,0,0,1
13028845,13030067,1222,0,0,1,2
13028846,13030067,1221,0,0,1,1
13030068,13030152,84,1,0,0,1
13030068,13030179,111,1,0,0,2
13030153,13030276,123,0,0,1,1
13030180,13030276,96,0,0,1,2
13030277,13030300,23,1,0,0,1
13030277,13030301,24,1,0,0,2
13030301,13031767,1466,0,0,1,1
13030302,13031738,1436,0,0,1,2
13031739,13032113,374,1,0,0,2
13031768,13032023,255,1,0,0,1
13031787,13032009,222,0,1,0,2
13031791,13031963,172,0,1,0,1
13032024,13032074,50,0,0,1,1
13032075,13032109,34,1,0,0,1
13032110,13033507,1397,0,0,1,1
13032114,13033507,1393,0,0,1,2
13033508,13033616,108,1,0,0,1
13033508,13034111,603,1,0,0,2
13033617,13033721,104,0,0,1,1
13033722,13033769,47,1,0,0,1
13033765,13034100,335,0,1,0,2
13033770,13035267,1497,0,0,1,1
13034112,13035267,1155,0,0,1,2
13035268,13035400,132,1,0,0,1
13035268,13035763,495,1,0,0,2
13035377,13035425,48,0,1,0,2
13035401,13035500,99,0,0,1,1
13035501,13035545,44,1,0,0,1
13035517,13035605,88,0,1,0,2
13035546,13036974,1428,0,0,1,1
13035735,13035754,19,0,1,0,2
13035764,13036976,1212,0,0,1,2
13036975,13037055,80,1,0,0,1
13036977,13037241,264,1,0,0,2
13037034,13037038,4,0,1,0,2
13037056,13037142,86,0,0,1,1
13037143,13037172,29,1,0,0,1
13037173,13037351,178,0,0,1,1
13037242,13037439,197,0,0,1,2
13037352,13037362,10,1,0,0,1
13037363,13038751,1388,0,0,1,1
13037440,13037566,126,1,0,0,2
13037567,13038750,1183,0,0,1,2
13038751,13038915,164,1,0,0,2
13038752,13038871,119,1,0,0,1
13038784,13038791,7,0,1,0,2
13038872,13039003,131,0,0,1,1
13038916,13039004,88,0,0,1,2
13039004,13039025,21,1,0,0,1
13039005,13039031,26,1,0,0,2
13039026,13040018,992,0,0,1,1
13039032,13039193,161,0,0,1,2
13039194,13039218,24,1,0,0,2
13039219,13040003,784,0,0,1,2
13040004,13040296,292,1,0,0,2
13040019,13040195,176,1,0,0,1
13040031,13040197,166,0,1,0,2
13040037,13040169,132,0,1,0,1
13040196,13040409,213,0,0,1,1
13040297,13040409,112,0,0,1,2
13040410,13040482,72,1,0,0,1
13040410,13040484,74,1,0,0,2
13040483,13040540,57,0,0,1,1
13040485,13040530,45,0,0,1,2
13040531,13040784,253,1,0,0,2
13040541,13040762,221,1,0,0,1
13040554,13040731,177,0,1,0,2
13040558,13040717,159,0,1,0,1
13040763,13040858,95,0,0,1,1
13040785,13040858,73,0,0,1,2
13040859,13040882,23,1,0,0,1
13040859,13040892,33,1,0,0,2
13040883,13040932,49,0,0,1,1
13040893,13040921,28,0,0,1,2
13040922,13041179,257,1,0,0,2
13040933,13041150,217,1,0,0,1
13040947,13041130,183,0,1,0,2
13040950,13041123,173,0,1,0,1
13041151,13041380,229,0,0,1,1
13041180,13041387,207,0,0,1,2
13041381,13041392,11,1,0,0,1
13041388,13041392,4,1,0,0,2
13041393,13041765,372,0,0,1,2
13041393,13041779,386,0,0,1,1
13041766,13042313,547,1,0,0,2
13041780,13041916,136,1,0,0,1
13041809,13041882,73,0,1,0,2
13041818,13041865,47,0,1,0,1
13041917,13041950,33,0,0,1,1
13041951,13042182,231,1,0,0,1
13041969,13042169,200,0,1,0,2
13041973,13042143,170,0,1,0,1
13042183,13042388,205,0,0,1,1
13042314,13042388,74,0,0,1,2
13042389,13042464,75,1,0,0,1
13042389,13042681,292,1,0,0,2
13042438,13042634,196,0,1,0,2
13042465,13042560,95,0,0,1,1
13042561,13042598,37,1,0,0,1
13042599,13042843,244,0,0,1,1
13042682,13042830,148,0,0,1,2
13042831,13043456,625,1,0,0,2
13042844,13043113,269,1,0,0,1
13042849,13043412,563,0,1,0,2
13042867,13043075,208,0,1,0,1
13043114,13043170,56,0,0,1,1
13043171,13043183,12,1,0,0,1
13043184,13043567,383,0,0,1,1
13043457,13044117,660,0,0,1,2
13043568,13043600,32,1,0,0,1
13043601,13043828,227,0,0,1,1
13043829,13043853,24,1,0,0,1
13043854,13044116,262,0,0,1,1
13044117,13044184,67,1,0,0,1
13044118,13044188,70,1,0,0,2
13044185,13044347,162,0,0,1,1
13044189,13044342,153,0,0,1,2
13044343,13044361,18,1,0,0,2
13044348,13044356,8,1,0,0,1
13044357,13045525,1168,0,0,1,1
13044362,13045517,1155,0,0,1,2
13045518,13045796,278,1,0,0,2
13045526,13045780,254,1,0,0,1
13045534,13045758,224,0,1,0,2
13045541,13045733,192,0,1,0,1
13045781,13045926,145,0,0,1,1
13045797,13045927,130,0,0,1,2
13045927,13045990,63,1,0,0,1
13045928,13045990,62,1,0,0,2
13045991,13046117,126,0,0,1,2
13045991,13046121,130,0,0,1,1
13046118,13046140,22,1,0,0,2
13046122,13046138,16,1,0,0,1
13046139,13047751,1612,0,0,1,1
13046141,13047752,1611,0,0,1,2
13047752,13047845,93,1,0,0,1
13047753,13047836,83,1,0,0,2
13047837,13047875,38,0,0,1,2
13047846,13047873,27,0,0,1,1
13047874,13048190,316,1,0,0,1
13047876,13048179,303,1,0,0,2
13047898,13048153,255,0,1,0,2
13047901,13048137,236,0,1,0,1
13048180,13048263,83,0,0,1,2
13048191,13048264,73,0,0,1,1
13048264,13048283,19,1,0,0,2
13048265,13048283,18,1,0,0,1
13048284,13049286,1002,0,0,1,1
13048284,13049287,1003,0,0,1,2
13049287,13049308,21,1,0,0,1
13049288,13049307,19,1,0,0,2
13049308,13049711,403,0,0,1,2
13049309,13049712,403,0,0,1,1
13049712,13049796,84,1,0,0,2
13049713,13049805,92,1,0,0,1
13049797,13049904,107,0,0,1,2
13049806,13049903,97,0,0,1,1
13049904,13049933,29,1,0,0,1
13049905,13049925,20,1,0,0,2
13049926,13050614,688,0,0,1,2
13049934,13050638,704,0,0,1,1
13050615,13051263,648,1,0,0,2
13050639,13050722,83,1,0,0,1
13050723,13050824,101,0,0,1,1
13050825,13050977,152,1,0,0,1
13050841,13050971,130,0,1,0,2
13050854,13050943,89,0,1,0,1
13050978,13051006,28,0,0,1,1
13051007,13051177,170,1,0,0,1
13051020,13051171,151,0,1,0,2
13051028,13051154,126,0,1,0,1
13051178,13051368,190,0,0,1,1
13051264,13051368,104,0,0,1,2
13051369,13051453,84,1,0,0,1
13051369,13051682,313,1,0,0,2
13051454,13053160,1706,0,0,1,1
13051683,13052143,460,0,0,1,2
13052144,13052164,20,1,0,0,2
13052165,13053160,995,0,0,1,2
13053161,13053274,113,1,0,0,1
13053161,13053275,114,1,0,0,2
13053275,13053336,61,0,0,1,1
13053276,13053315,39,0,0,1,2
13053316,13053409,93,1,0,0,2
13053337,13053440,103,1,0,0,1
13053410,13053677,267,0,0,1,2
13053441,13054254,813,0,0,1,1
13053678,13053682,4,1,0,0,2
13053683,13054990,1307,0,0,1,2
13054255,13054278,23,1,0,0,1
13054279,13054990,711,0,0,1,1
13054991,13055086,95,1,0,0,1
13054991,13055342,351,1,0,0,2
13055060,13055210,150,0,1,0,2
13055087,13055215,128,0,0,1,1
13055216,13055233,17,1,0,0,1
13055234,13055253,19,0,1,0,2
13055234,13055656,422,0,0,1,1
13055294,13055295,1,0,1,0,2
13055343,13055432,89,0,0,1,2
13055433,13055603,170,1,0,0,2
13055480,13055570,90,0,1,0,2
13055604,13056341,737,0,0,1,2
13055657,13055671,14,1,0,0,1
13055672,13055990,318,0,0,1,1
13055991,13056578,587,1,0,0,1
13056342,13056929,587,1,0,0,2
13056364,13056574,210,0,1,0,2
13056370,13056553,183,0,1,0,1
13056579,13056652,73,0,0,1,1
13056653,13056878,225,1,0,0,1
13056662,13056874,212,0,1,0,2
13056672,13056842,170,0,1,0,1
13056879,13056964,85,0,0,1,1
13056930,13056965,35,0,0,1,2
13056965,13057004,39,1,0,0,1
13056966,13056990,24,1,0,0,2
13056991,13058517,1526,0,0,1,2
13057005,13058517,1512,0,0,1,1
13058518,13058604,86,1,0,0,2
13058518,13058609,91,1,0,0,1
13058605,13058713,108,0,0,1,2
13058610,13058713,103,0,0,1,1
13058714,13058737,23,1,0,0,1
13058714,13058739,25,1,0,0,2
13058738,13059062,324,0,0,1,1
13058740,13059062,322,0,0,1,2
13059063,13059072,9,1,0,0,1
13059063,13059082,19,1,0,0,2
13059073,13060331,1258,0,0,1,1
13059083,13060331,1248,0,0,1,2
13060332,13060401,69,1,0,0,1
13060332,13060402,70,1,0,0,2
13060402,13060478,76,0,0,1,1
13060403,13060473,70,0,0,1,2
13060474,13061069,595,1,0,0,2
13060479,13060757,278,1,0,0,1
13060501,13060741,240,0,1,0,2
13060505,13060716,211,0,1,0,1
13060758,13060809,51,0,0,1,1
13060810,13061065,255,1,0,0,1
13060827,13061036,209,0,1,0,2
13060831,13061030,199,0,1,0,1
13061066,13061229,163,0,0,1,1
13061070,13061227,157,0,0,1,2
13061228,13061248,20,1,0,0,2
13061230,13061246,16,1,0,0,1
13061247,13061411,164,0,0,1,1
13061249,13061410,161,0,0,1,2
13061411,13061608,197,1,0,0,2
13061412,13061599,187,1,0,0,1
13061438,13061568,130,0,1,0,2
13061439,13061544,105,0,1,0,1
13061600,13062962,1362,0,0,1,1
13061609,13062962,1353,0,0,1,2
13062963,13063022,59,1,0,0,2
13062963,13063024,61,1,0,0,1
13063023,13066806,3783,0,0,1,2
13063025,13066800,3775,0,0,1,1
13066801,13066822,21,1,0,0,1
13066807,13066820,13,1,0,0,2
13066821,13067068,247,0,0,1,2
13066823,13067089,266,0,0,1,1
13067069,13067182,113,1,0,0,2
13067090,13067177,87,1,0,0,1
13067178,13067294,116,0,0,1,1
13067183,13067279,96,0,0,1,2
13067280,13067482,202,1,0,0,2
13067295,13067453,158,1,0,0,1
13067311,13067437,126,0,1,0,2
13067315,13067423,108,0,1,0,1
13067454,13067802,348,0,0,1,1
13067483,13067803,320,0,0,1,2
13067803,13067872,69,1,0,0,1
13067804,13067875,71,1,0,0,2
13067873,13068112,239,0,0,1,1
13067876,13068111,235,0,0,1,2
13068112,13068143,31,1,0,0,2
13068113,13068132,19,1,0,0,1
13068133,13069835,1702,0,0,1,1
13068144,13068723,579,0,0,1,2
13068724,13068734,10,1,0,0,2
13068735,13069834,1099,0,0,1,2
13069835,13070199,364,1,0,0,2
13069836,13070161,325,1,0,0,1
13069876,13070127,251,0,1,0,1
13069877,13070152,275,0,1,0,2
13070162,13070269,107,0,0,1,1
13070200,13070256,56,0,0,1,2
13070257,13070487,230,1,0,0,2
13070270,13070457,187,1,0,0,1
13070283,13070440,157,0,1,0,2
13070286,13070428,142,0,1,0,1
13070458,13071067,609,0,0,1,1
13070488,13071068,580,0,0,1,2
13071068,13071139,71,1,0,0,1
13071069,13071139,70,1,0,0,2
13071140,13071252,112,0,0,1,1
13071140,13071253,113,0,0,1,2
13071253,13071277,24,1,0,0,1
13071254,13071285,31,1,0,0,2
13071278,13072316,1038,0,0,1,1
13071286,13072315,1029,0,0,1,2
13072316,13072565,249,1,0,0,2
13072317,13072551,234,1,0,0,1
13072341,13072522,181,0,1,0,2
13072342,13072491,149,0,1,0,1
13072552,13073847,1295,0,0,1,1
13072566,13073848,1282,0,0,1,2
13073848,13073910,62,1,0,0,1
13073849,13073900,51,1,0,0,2
13073901,13075715,1814,0,0,1,2
13073911,13075714,1803,0,0,1,1
13075715,13075736,21,1,0,0,1
13075716,13075738,22,1,0,0,2
13075737,13075967,230,0,0,1,1
13075739,13075965,226,0,0,1,2
13075966,13076769,803,1,0,0,2
13075968,13076231,263,1,0,0,1
13075992,13076200,208,0,1,0,2
13075994,13076180,186,0,1,0,1
13076232,13076264,32,0,0,1,1
13076265,13076497,232,1,0,0,1
13076287,13076478,191,0,1,0,2
13076292,13076460,168,0,1,0,1
13076498,13076532,34,0,0,1,1
13076533,13076762,229,1,0,0,1
13076547,13076731,184,0,1,0,2
13076552,13076714,162,0,1,0,1
13076763,13077251,488,0,0,1,1
13076770,13077249,479,0,0,1,2
13077250,13077274,24,1,0,0,2
13077252,13077274,22,1,0,0,1
13077275,13077368,93,0,0,1,2
13077275,13077376,101,0,0,1,1
13077369,13077763,394,1,0,0,2
13077377,13077703,326,1,0,0,1
13077397,13077684,287,0,1,0,2
13077399,13077661,262,0,1,0,1
13077704,13077860,156,0,0,1,1
13077764,13077861,97,0,0,1,2
13077861,13077953,92,1,0,0,1
13077862,13078230,368,1,0,0,2
13077954,13078026,72,0,0,1,1
13078027,13078072,45,1,0,0,1
13078073,13078256,183,0,0,1,1
13078231,13078256,25,0,0,1,2
13078257,13078266,9,1,0,0,1
13078257,13078269,12,1,0,0,2
13078267,13079413,1146,0,0,1,1
13078270,13079413,1143,0,0,1,2
13079414,13079485,71,1,0,0,1
13079414,13079489,75,1,0,0,2
13079486,13079610,124,0,0,1,1
13079490,13079610,120,0,0,1,2
13079611,13079633,22,1,0,0,1
13079611,13079642,31,1,0,0,2
13079634,13081734,2100,0,0,1,1
13079643,13081733,2090,0,0,1,2
13081734,13082244,510,1,0,0,2
13081735,13082244,509,1,0,0,1
13081755,13082214,459,0,1,0,2
13081756,13081981,225,0,1,0,1
13082027,13082193,166,0,1,0,1
13082245,13082557,312,0,0,1,1
13082245,13082557,312,0,0,1,2
13082558,13082599,41,1,0,0,2
13082558,13082609,51,1,0,0,1
13082600,13082733,133,0,0,1,2
13082610,13082734,124,0,0,1,1
13082734,13082816,82,1,0,0,2
13082735,13082797,62,1,0,0,1
13082798,13083008,210,0,0,1,1
13082817,13082977,160,0,0,1,2
13082978,13083084,106,1,0,0,2
13083009,13083090,81,1,0,0,1
13083085,13083187,102,0,0,1,2
13083091,13083188,97,0,0,1,1
13083188,13083227,39,1,0,0,2
13083189,13083220,31,1,0,0,1
13083221,13083417,196,0,0,1,1
13083228,13083422,194,0,0,1,2
13083418,13083436,18,1,0,0,1
13083423,13083436,13,1,0,0,2
13083437,13084858,1421,0,0,1,1
13083437,13084858,1421,0,0,1,2
13084859,13084909,50,1,0,0,2
13084859,13084919,60,1,0,0,1
13084910,13087140,2230,0,0,1,2
13084920,13085410,490,0,0,1,1
13085411,13085420,9,1,0,0,1
13085421,13087167,1746,0,0,1,1
13087141,13087772,631,1,0,0,2
13087168,13087745,577,1,0,0,1
13087190,13087478,288,0,1,0,2
13087199,13087450,251,0,1,0,1
13087513,13087698,185,0,1,0,2
13087524,13087680,156,0,1,0,1
13087746,13088154,408,0,0,1,1
13087773,13088155,382,0,0,1,2
13088155,13088253,98,1,0,0,1
13088156,13088239,83,1,0,0,2
13088240,13088513,273,0,0,1,2
13088254,13088513,259,0,0,1,1
13088514,13088597,83,1,0,0,2
13088514,13088598,84,1,0,0,1
13088598,13088684,86,0,0,1,2
13088599,13088684,85,0,0,1,1
13088685,13088746,61,1,0,0,1
13088685,13088748,63,1,0,0,2
13088747,13088901,154,0,0,1,1
13088749,13088901,152,0,0,1,2
13088902,13089003,101,1,0,0,1
13088902,13089003,101,1,0,0,2
13089004,13089219,215,0,0,1,2
13089004,13089221,217,0,0,1,1
13089220,13089309,89,1,0,0,2
13089222,13089302,80,1,0,0,1
13089294,13089295,1,0,1,0,2
13089303,13089448,145,0,0,1,1
13089310,13089448,138,0,0,1,2
13089449,13089544,95,1,0,0,2
13089449,13089550,101,1,0,0,1
13089545,13089691,146,0,0,1,2
13089551,13089691,140,0,0,1,1
13089692,13089742,50,1,0,0,1
13089692,13089753,61,1,0,0,2
13089743,13089893,150,0,0,1,1
13089754,13089888,134,0,0,1,2
13089889,13089961,72,1,0,0,2
13089894,13089906,12,1,0,0,1
13089907,13091606,1699,0,0,1,1
13089962,13090969,1007,0,0,1,2
13090970,13090993,23,1,0,0,2
13090994,13091121,127,0,0,1,2
13091122,13091136,14,1,0,0,2
13091137,13091239,102,0,0,1,2
13091240,13091353,113,1,0,0,2
13091354,13091442,88,0,0,1,2
13091443,13091448,5,1,0,0,2
13091449,13091570,121,0,0,1,2
13091571,13091668,97,1,0,0,2
13091607,13091661,54,1,0,0,1
13091662,13091847,185,0,0,1,1
13091669,13091849,180,0,0,1,2
13091848,13091869,21,1,0,0,1
13091850,13091879,29,1,0,0,2
13091870,13093848,1978,0,0,1,1
13091880,13093848,1968,0,0,1,2
13093849,13093909,60,1,0,0,2
13093849,13093920,71,1,0,0,1
13093910,13093979,69,0,0,1,2
13093921,13093991,70,0,0,1,1
13093980,13094559,579,1,0,0,2
13093992,13094546,554,1,0,0,1
13094015,13094507,492,0,1,0,2
13094020,13094180,160,0,1,0,1
13094250,13094484,234,0,1,0,1
13094547,13094647,100,0,0,1,1
13094560,13094646,86,0,0,1,2
13094647,13094721,74,1,0,0,2
13094648,13094710,62,1,0,0,1
13094711,13094830,119,0,0,1,1
13094722,13094829,107,0,0,1,2
13094830,13094914,84,1,0,0,2
13094831,13094898,67,1,0,0,1
13094899,13095005,106,0,0,1,1
13094915,13095005,90,0,0,1,2
13095006,13095063,57,1,0,0,2
13095006,13095070,64,1,0,0,1
13095064,13095312,248,0,0,1,2
13095071,13095312,241,0,0,1,1
13095313,13095380,67,1,0,0,1
13095313,13095407,94,1,0,0,2
13095381,13095608,227,0,0,1,1
13095408,13095610,202,0,0,1,2
13095609,13095662,53,1,0,0,1
13095611,13095673,62,1,0,0,2
13095663,13095832,169,0,0,1,1
13095674,13095828,154,0,0,1,2
13095829,13095856,27,1,0,0,2
13095833,13095848,15,1,0,0,1
13095849,13097351,1502,0,0,1,1
13095857,13097351,1494,0,0,1,2
13097352,13097415,63,1,0,0,1
13097352,13097415,63,1,0,0,2
13097416,13097572,156,0,0,1,2
13097416,13097576,160,0,0,1,1
13097573,13097592,19,1,0,0,2
13097577,13097592,15,1,0,0,1
13097593,13099486,1893,0,0,1,2
13097593,13099489,1896,0,0,1,1
13099487,13100100,613,1,0,0,2
13099490,13100057,567,1,0,0,1
13099526,13100089,563,0,1,0,2
13099529,13099808,279,0,1,0,1
13099857,13100021,164,0,1,0,1
13100058,13100988,930,0,0,1,1
13100101,13100987,886,0,0,1,2
13100988,13101057,69,1,0,0,2
13100989,13101057,68,1,0,0,1
13101058,13101171,113,0,0,1,1
13101058,13101173,115,0,0,1,2
13101172,13101196,24,1,0,0,1
13101174,13101192,18,1,0,0,2
13101193,13101602,409,0,0,1,2
13101197,13101595,398,0,0,1,1
13101596,13101619,23,1,0,0,1
13101603,13101637,34,1,0,0,2
13101620,13103019,1399,0,0,1,1
13101638,13102046,408,0,0,1,2
13102047,13102107,60,1,0,0,2
13102108,13102493,385,0,0,1,2
13102494,13102555,61,1,0,0,2
13102556,13102585,29,0,0,1,2
13102586,13102601,15,1,0,0,2
13102602,13103020,418,0,0,1,2
13103020,13103094,74,1,0,0,1
13103021,13103093,72,1,0,0,2
13103094,13103755,661,0,0,1,2
13103095,13103755,660,0,0,1,1
13103756,13103776,20,1,0,0,1
13103756,13103779,23,1,0,0,2
13103777,13104320,543,0,0,1,1
13103780,13104316,536,0,0,1,2
13104317,13104330,13,1,0,0,2
13104321,13104326,5,1,0,0,1
13104327,13105083,756,0,0,1,1
13104331,13105079,748,0,0,1,2
13105080,13105817,737,1,0,0,2
13105084,13105770,686,1,0,0,1
13105105,13105782,677,0,1,0,2
13105109,13105253,144,0,1,0,1
13105282,13105492,210,0,1,0,1
13105537,13105724,187,0,1,0,1
13105771,13106317,546,0,0,1,1
13105818,13106317,499,0,0,1,2
13106318,13106558,240,1,0,0,1
13106318,13106785,467,1,0,0,2
13106379,13106548,169,0,1,0,1
13106384,13106677,293,0,1,0,2
13106559,13106609,50,0,0,1,1
13106610,13106711,101,1,0,0,1
13106712,13106895,183,0,0,1,1
13106786,13106895,109,0,0,1,2
13106896,13106970,74,1,0,0,1
13106896,13106979,83,1,0,0,2
13106971,13107023,52,0,0,1,1
13106980,13107022,42,0,0,1,2
13107023,13107073,50,1,0,0,2
13107024,13107073,49,1,0,0,1
13107074,13107176,102,0,0,1,2
13107074,13107177,103,0,0,1,1
13107177,13107204,27,1,0,0,2
13107178,13107204,26,1,0,0,1
13107205,13108938,1733,0,0,1,1
13107205,13108938,1733,0,0,1,2
13108939,13109000,61,1,0,0,2
13108939,13109002,63,1,0,0,1
13109001,13109144,143,0,0,1,2
13109003,13109141,138,0,0,1,1
13109142,13109169,27,1,0,0,1
13109145,13109167,22,1,0,0,2
13109168,13111338,2170,0,0,1,2
13109170,13111342,2172,0,0,1,1
13111339,13111888,549,1,0,0,2
13111343,13111820,477,1,0,0,1
13111374,13111859,485,0,1,0,2
13111379,13111809,430,0,1,0,1
13111821,13112939,1118,0,0,1,1
13111889,13112940,1051,0,0,1,2
13112940,13112972,32,1,0,0,1
13112941,13112987,46,1,0,0,2
13112973,13113112,139,0,0,1,1
13112988,13113113,125,0,0,1,2
13113113,13113133,20,1,0,0,1
13113114,13113132,18,1,0,0,2
13113133,13114448,1315,0,0,1,2
13113134,13114515,1381,0,0,1,1
13114449,13114588,139,1,0,0,2
13114516,13114567,51,1,0,0,1
13114568,13114807,239,0,0,1,1
13114589,13114805,216,0,0,1,2
13114806,13114837,31,1,0,0,2
13114808,13114828,20,1,0,0,1
13114829,13115979,1150,0,0,1,1
13114838,13115979,1141,0,0,1,2
13115980,13115994,14,1,0,0,2
13115980,13115996,16,1,0,0,1
13115995,13116972,977,0,0,1,2
13115997,13116976,979,0,0,1,1
13116973,13116989,16,1,0,0,2
13116977,13116990,13,1,0,0,1
13116990,13117048,58,0,0,1,2
13116991,13117053,62,0,0,1,1
13117049,13117576,527,1,0,0,2
13117054,13117536,482,1,0,0,1
13117083,13117532,449,0,1,0,2
13117086,13117282,196,0,1,0,1
13117323,13117486,163,0,1,0,1
13117537,13118232,695,0,0,1,1
13117577,13118232,655,0,0,1,2
13118233,13118279,46,1,0,0,1
13118233,13118289,56,1,0,0,2
13118280,13119287,1007,0,0,1,1
13118290,13119286,996,0,0,1,2
13119287,13119341,54,1,0,0,2
13119288,13119343,55,1,0,0,1
13119342,13119572,230,0,0,1,2
13119344,13119570,226,0,0,1,1
13119571,13119635,64,1,0,0,1
13119573,13119635,62,1,0,0,2
13119636,13120145,509,0,0,1,1
13119636,13120145,509,0,0,1,2
13120146,13120214,68,1,0,0,2
13120146,13120247,101,1,0,0,1
13120215,13120331,116,0,0,1,2
13120248,13120332,84,0,0,1,1
13120332,13120364,32,1,0,0,2
13120333,13120360,27,1,0,0,1
13120361,13122179,1818,0,0,1,1
13120365,13122177,1812,0,0,1,2
13122178,13122671,493,1,0,0,2
13122180,13122646,466,1,0,0,1
13122213,13122660,447,0,1,0,2
13122222,13122618,396,0,1,0,1
13122647,13124039,1392,0,0,1,1
13122672,13124039,1367,0,0,1,2
13124040,13124096,56,1,0,0,2
13124040,13124108,68,1,0,0,1
13124097,13124218,121,0,0,1,2
13124109,13124219,110,0,0,1,1
13124219,13124236,17,1,0,0,2
13124220,13124239,19,1,0,0,1
13124237,13124426,189,0,0,1,2
13124240,13124428,188,0,0,1,1
13124427,13124961,534,1,0,0,2
13124429,13124950,521,1,0,0,1
13124454,13124938,484,0,1,0,2
13124457,13124920,463,0,1,0,1
13124951,13125043,92,0,0,1,1
13124962,13125047,85,0,0,1,2
13125044,13125062,18,1,0,0,1
13125048,13125061,13,1,0,0,2
13125062,13126235,1173,0,0,1,2
13125063,13126235,1172,0,0,1,1
13126236,13126283,47,1,0,0,2
13126236,13126284,48,1,0,0,1
13126284,13126408,124,0,0,1,2
13126285,13126406,121,0,0,1,1
13126407,13126426,19,1,0,0,1
13126409,13126424,15,1,0,0,2
13126425,13128492,2067,0,0,1,2
13126427,13128503,2076,0,0,1,1
13128493,13129279,786,1,0,0,2
13128504,13129240,736,1,0,0,1
13128522,13129265,743,0,1,0,2
13128532,13129227,695,0,1,0,1
13129241,13129774,533,0,0,1,1
13129280,13129774,494,0,0,1,2
13129775,13129827,52,1,0,0,1
13129775,13129830,55,1,0,0,2
13129828,13129978,150,0,0,1,1
13129831,13129979,148,0,0,1,2
13129979,13129995,16,1,0,0,1
13129980,13129997,17,1,0,0,2
13129996,13131677,1681,0,0,1,1
13129998,13131677,1679,0,0,1,2
13131678,13131731,53,1,0,0,1
13131678,13131740,62,1,0,0,2
13131732,13131884,152,0,0,1,1
13131741,13131885,144,0,0,1,2
13131885,13131911,26,1,0,0,1
13131886,13131902,16,1,0,0,2
13131903,13133736,1833,0,0,1,2
13131912,13133739,1827,0,0,1,1
13133737,13134536,799,1,0,0,2
13133740,13134467,727,1,0,0,1
13133759,13134502,743,0,1,0,2
13133762,13134456,694,0,1,0,1
13134468,13134672,204,0,0,1,1
13134537,13134652,115,0,0,1,2
13134653,13135073,420,1,0,0,2
13134673,13134989,316,1,0,0,1
13134694,13134981,287,0,1,0,2
13134697,13134957,260,0,1,0,1
13134990,13135632,642,0,0,1,1
13135074,13135633,559,0,0,1,2
13135633,13135706,73,1,0,0,1
13135634,13135709,75,1,0,0,2
13135707,13135867,160,0,0,1,1
13135710,13135860,150,0,0,1,2
13135861,13135882,21,1,0,0,2
13135868,13135876,8,1,0,0,1
13135877,13137365,1488,0,0,1,1
13135883,13137365,1482,0,0,1,2
13137366,13137429,63,1,0,0,1
13137366,13137435,69,1,0,0,2
13137430,13137536,106,0,0,1,1
13137436,13137537,101,0,0,1,2
13137537,13137572,35,1,0,0,1
13137538,13137564,26,1,0,0,2
13137565,13139413,1848,0,0,1,2
13137573,13139429,1856,0,0,1,1
13139414,13140329,915,1,0,0,2
13139430,13140262,832,1,0,0,1
13139454,13140280,826,0,1,0,2
13139459,13139746,287,0,1,0,1
13139789,13140252,463,0,1,0,1
13140263,13141043,780,0,0,1,1
13140330,13141044,714,0,0,1,2
13141044,13141131,87,1,0,0,1
13141045,13141120,75,1,0,0,2
13141121,13141198,77,0,0,1,2
13141132,13141205,73,0,0,1,1
13141199,13141285,86,1,0,0,2
13141206,13141241,35,1,0,0,1
13141242,13141384,142,0,0,1,1
13141286,13141306,20,0,0,1,2
13141307,13141329,22,1,0,0,2
13141330,13141363,33,0,0,1,2
13141364,13141571,207,1,0,0,2
13141385,13141395,10,1,0,0,1
13141396,13142644,1248,0,0,1,1
13141572,13142644,1072,0,0,1,2
13142645,13142699,54,1,0,0,1
13142645,13142704,59,1,0,0,2
13142700,13143024,324,0,0,1,1
13142705,13142926,221,0,0,1,2
13142927,13143112,185,1,0,0,2
13143009,13143049,40,0,1,0,2
13143025,13143053,28,1,0,0,1
13143054,13143316,262,0,0,1,1
13143113,13143165,52,0,0,1,2
13143166,13143175,9,1,0,0,2
13143176,13143291,115,0,0,1,2
13143292,13143859,567,1,0,0,2
13143317,13143677,360,1,0,0,1
13143318,13143767,449,0,1,0,2
13143341,13143632,291,0,1,0,1
13143678,13145438,1760,0,0,1,1
13143860,13145425,1565,0,0,1,2
13145426,13146016,590,1,0,0,2
13145439,13145743,304,1,0,0,1
13145446,13145933,487,0,1,0,2
13145455,13145700,245,0,1,0,1
13145744,13146336,592,0,0,1,1
13146017,13146335,318,0,0,1,2
13146336,13146482,146,1,0,0,2
13146337,13146443,106,1,0,0,1
13146444,13146550,106,0,0,1,1
13146483,13146550,67,0,0,1,2
13146551,13146580,29,1,0,0,2
13146551,13146581,30,1,0,0,1
13146581,13147836,1255,0,0,1,2
13146582,13147837,1255,0,0,1,1
13147837,13147894,57,1,0,0,2
13147838,13147893,55,1,0,0,1
13147894,13148165,271,0,0,1,1
13147895,13148167,272,0,0,1,2
13148166,13148189,23,1,0,0,1
13148168,13148178,10,1,0,0,2
13148179,13149875,1696,0,0,1,2
13148190,13149892,1702,0,0,1,1
13149876,13150525,649,1,0,0,2
13149893,13150443,550,1,0,0,1
13149910,13150473,563,0,1,0,2
13149916,13150156,240,0,1,0,1
13150192,13150409,217,0,1,0,1
13150444,13151251,807,0,0,1,1
13150526,13151251,725,0,0,1,2
13151252,13151318,66,1,0,0,1
13151252,13151323,71,1,0,0,2
13151319,13151482,163,0,0,1,1
13151324,13152089,765,0,0,1,2
13151483,13151497,14,1,0,0,1
13151498,13153385,1887,0,0,1,1
13152090,13152094,4,1,0,0,2
13152095,13152314,219,0,0,1,2
13152315,13152474,159,1,0,0,2
13152475,13152530,55,0,0,1,2
13152531,13152591,60,1,0,0,2
13152592,13153316,724,0,0,1,2
13153317,13153332,15,1,0,0,2
13153333,13153385,52,0,0,1,2
13153386,13153437,51,1,0,0,1
13153386,13153448,62,1,0,0,2
13153438,13155562,2124,0,0,1,1
13153449,13155555,2106,0,0,1,2
13155556,13156251,695,1,0,0,2
13155563,13156189,626,1,0,0,1
13155583,13156215,632,0,1,0,2
13155587,13156149,562,0,1,0,1
13156190,13156578,388,0,0,1,1
13156252,13156401,149,0,0,1,2
13156402,13156424,22,1,0,0,2
13156425,13156580,155,0,0,1,2
13156579,13156606,27,1,0,0,1
13156581,13156620,39,1,0,0,2
13156607,13156967,360,0,0,1,1
13156621,13156971,350,0,0,1,2
13156968,13157020,52,1,0,0,1
13156972,13157020,48,1,0,0,2
13157021,13157287,266,0,0,1,2
13157021,13157288,267,0,0,1,1
13157288,13157348,60,1,0,0,2
13157289,13157315,26,1,0,0,1
13157316,13158866,1550,0,0,1,1
13157349,13158867,1518,0,0,1,2
13158867,13158916,49,1,0,0,1
13158868,13158919,51,1,0,0,2
13158917,13161010,2093,0,0,1,1
13158920,13159656,736,0,0,1,2
13159657,13159668,11,1,0,0,2
13159669,13161002,1333,0,0,1,2
13161003,13161679,676,1,0,0,2
13161011,13161644,633,1,0,0,1
13161030,13161624,594,0,1,0,2
13161034,13161630,596,0,1,0,1
13161645,13162472,827,0,0,1,1
13161680,13162471,791,0,0,1,2
13162472,13162590,118,1,0,0,2
13162473,13162801,328,1,0,0,1
13162591,13162688,97,0,0,1,2
13162689,13162712,23,1,0,0,2
13162713,13164509,1796,0,0,1,2
13162802,13162865,63,0,0,1,1
13162866,13162874,8,1,0,0,1
13162875,13163301,426,0,0,1,1
13163302,13163306,4,1,0,0,1
13163307,13164507,1200,0,0,1,1
13164508,13164582,74,1,0,0,1
13164510,13164581,71,1,0,0,2
13164582,13164753,171,0,0,1,2
13164583,13164751,168,0,0,1,1
13164752,13164767,15,1,0,0,1
13164754,13164768,14,1,0,0,2
13164768,13165914,1146,0,0,1,1
13164769,13165918,1149,0,0,1,2
13165915,13165934,19,1,0,0,1
13165919,13165934,15,1,0,0,2
13165935,13166832,897,0,0,1,2
13165935,13166849,914,0,0,1,1
13166833,13167450,617,1,0,0,2
13166850,13167381,531,1,0,0,1
13166864,13167386,522,0,1,0,2
13166871,13167368,497,0,1,0,1
13167382,13168412,1030,0,0,1,1
13167451,13168412,961,0,0,1,2
13168413,13168483,70,1,0,0,2
13168413,13168484,71,1,0,0,1
13168484,13168592,108,0,0,1,2
13168485,13168592,107,0,0,1,1
13168593,13168611,18,1,0,0,2
13168593,13168619,26,1,0,0,1
13168612,13170587,1975,0,0,1,2
13168620,13169481,861,0,0,1,1
13169482,13169568,86,1,0,0,1
13169569,13169850,281,0,0,1,1
13169851,13169855,4,1,0,0,1
13169856,13170035,179,0,0,1,1
13170036,13170047,11,1,0,0,1
13170048,13170585,537,0,0,1,1
13170586,13170638,52,1,0,0,1
13170588,13170639,51,1,0,0,2
13170639,13170757,118,0,0,1,1
13170640,13170757,117,0,0,1,2
13170758,13170785,27,1,0,0,2
13170758,13170787,29,1,0,0,1
13170786,13172624,1838,0,0,1,2
13170788,13172634,1846,0,0,1,1
13172625,13173212,587,1,0,0,2
13172635,13173153,518,1,0,0,1
13172653,13172875,222,0,1,0,2
13172655,13172856,201,0,1,0,1
13172905,13173144,239,0,1,0,2
13172919,13173118,199,0,1,0,1
13173154,13173438,284,0,0,1,1
13173213,13173422,209,0,0,1,2
13173423,13173731,308,1,0,0,2
13173439,13173655,216,1,0,0,1
13173455,13173641,186,0,1,0,2
13173461,13173627,166,0,1,0,1
13173656,13174705,1049,0,0,1,1
13173732,13174697,965,0,0,1,2
13174698,13174799,101,1,0,0,2
13174706,13174797,91,1,0,0,1
13174798,13174907,109,0,0,1,1
13174800,13174907,107,0,0,1,2
13174908,13174926,18,1,0,0,2
13174908,13174927,19,1,0,0,1
13174927,13176352,1425,0,0,1,2
13174928,13176352,1424,0,0,1,1
13176353,13176404,51,1,0,0,1
13176353,13176412,59,1,0,0,2
13176405,13177213,808,0,0,1,1
13176413,13177208,795,0,0,1,2
13177209,13177224,15,1,0,0,2
13177214,13177222,8,1,0,0,1
13177223,13178454,1231,0,0,1,1
13177225,13178450,1225,0,0,1,2
13178451,13179048,597,1,0,0,2
13178455,13179009,554,1,0,0,1
13178475,13179038,563,0,1,0,2
13178478,13178697,219,0,1,0,1
13178744,13178961,217,0,1,0,1
13179010,13179879,869,0,0,1,1
13179049,13179341,292,0,0,1,2
13179342,13179367,25,1,0,0,2
13179368,13179877,509,0,0,1,2
13179878,13179951,73,1,0,0,2
13179880,13179952,72,1,0,0,1
13179952,13180048,96,0,0,1,2
13179953,13180047,94,0,0,1,1
13180048,13180076,28,1,0,0,1
13180049,13180067,18,1,0,0,2
13180068,13182070,2002,0,0,1,2
13180077,13182069,1992,0,0,1,1
13182070,13182121,51,1,0,0,1
13182071,13182135,64,1,0,0,2
13182122,13182277,155,0,0,1,1
13182136,13182272,136,0,0,1,2
13182273,13182299,26,1,0,0,2
13182278,13182295,17,1,0,0,1
13182296,13183775,1479,0,0,1,1
13182300,13183781,1481,0,0,1,2
13183776,13183795,19,1,0,0,1
13183782,13183799,17,1,0,0,2
13183796,13184117,321,0,0,1,1
13183800,13184108,308,0,0,1,2
13184109,13184644,535,1,0,0,2
13184118,13184613,495,1,0,0,1
13184136,13184619,483,0,1,0,2
13184140,13184603,463,0,1,0,1
13184614,13184681,67,0,0,1,1
13184645,13184669,24,0,0,1,2
13184670,13184988,318,1,0,0,2
13184682,13184937,255,1,0,0,1
13184697,13184907,210,0,1,0,2
13184703,13184885,182,0,1,0,1
13184938,13186163,1225,0,0,1,1
13184989,13186162,1173,0,0,1,2
13186163,13186524,361,1,0,0,2
13186164,13186235,71,1,0,0,1
13186236,13186316,80,0,0,1,1
13186266,13186267,1,0,1,0,2
13186317,13186349,32,1,0,0,1
13186322,13186326,4,0,1,0,2
13186350,13186464,114,0,0,1,1
13186370,13186371,1,0,1,0,2
13186465,13186494,29,1,0,0,1
13186495,13188516,2021,0,0,1,1
13186525,13188515,1990,0,0,1,2
13188516,13188572,56,1,0,0,2
13188517,13188579,62,1,0,0,1
13188573,13188866,293,0,0,1,2
13188580,13188868,288,0,0,1,1
13188867,13188882,15,1,0,0,2
13188869,13188890,21,1,0,0,1
13188883,13190552,1669,0,0,1,2
13188891,13190574,1683,0,0,1,1
13190553,13191404,851,1,0,0,2
13190575,13191342,767,1,0,0,1
13190586,13191366,780,0,1,0,2
13190599,13191326,727,0,1,0,1
13191343,13191387,44,0,0,1,1
13191388,13191392,4,1,0,0,1
13191393,13191774,381,0,0,1,1
13191405,13191525,120,0,0,1,2
13191526,13191627,101,1,0,0,2
13191628,13191682,54,0,0,1,2
13191683,13191699,16,1,0,0,2
13191700,13191760,60,0,0,1,2
13191761,13192073,312,1,0,0,2
13191775,13192012,237,1,0,0,1
13191785,13192014,229,0,1,0,2
13191791,13191980,189,0,1,0,1
13192013,13192576,563,0,0,1,1
13192074,13192273,199,0,0,1,2
13192274,13192309,35,1,0,0,2
13192310,13192543,233,0,0,1,2
13192544,13192646,102,1,0,0,2
13192577,13192647,70,1,0,0,1
13192647,13192749,102,0,0,1,2
13192648,13192749,101,0,0,1,1
13192750,13192777,27,1,0,0,1
13192750,13192789,39,1,0,0,2
13192778,13194880,2102,0,0,1,1
13192790,13192969,179,0,0,1,2
13192970,13192981,11,1,0,0,2
13192982,13193231,249,0,0,1,2
13193232,13193236,4,1,0,0,2
13193237,13194879,1642,0,0,1,2
13194880,13194941,61,1,0,0,2
13194881,13194944,63,1,0,0,1
13194942,13195147,205,0,0,1,2
13194945,13195146,201,0,0,1,1
13195147,13195182,35,1,0,0,1
13195148,13195175,27,1,0,0,2
13195176,13196175,999,0,0,1,2
13195183,13196935,1752,0,0,1,1
13196176,13196181,5,1,0,0,2
13196182,13196933,751,0,0,1,2
13196934,13197679,745,1,0,0,2
13196936,13197635,699,1,0,0,1
13196958,13197625,667,0,1,0,2
13196962,13197623,661,0,1,0,1
13197636,13197931,295,0,0,1,1
13197680,13197924,244,0,0,1,2
13197925,13198235,310,1,0,0,2
13197932,13198182,250,1,0,0,1
13197949,13198155,206,0,1,0,2
13197954,13198135,181,0,1,0,1
13198183,13198816,633,0,0,1,1
13198236,13198815,579,0,0,1,2
13198816,13198924,108,1,0,0,2
13198817,13198898,81,1,0,0,1
13198899,13198989,90,0,0,1,1
13198925,13198989,64,0,0,1,2
13198990,13199019,29,1,0,0,1
13198990,13199019,29,1,0,0,2
13199020,13200606,1586,0,0,1,2
13199020,13200607,1587,0,0,1,1
13200607,13200669,62,1,0,0,2
13200608,13200667,59,1,0,0,1
13200668,13202740,2072,0,0,1,1
13200670,13200950,280,0,0,1,2
13200951,13200962,11,1,0,0,2
13200963,13202726,1763,0,0,1,2
13202727,13203485,758,1,0,0,2
13202741,13203432,691,1,0,0,1
13202750,13203456,706,0,1,0,2
13202761,13203422,661,0,1,0,1
13203433,13204180,747,0,0,1,1
13203486,13204180,694,0,0,1,2
13204181,13204261,80,1,0,0,2
13204181,13204262,81,1,0,0,1
13204262,13204373,111,0,0,1,2
13204263,13204375,112,0,0,1,1
13204374,13204407,33,1,0,0,2
13204376,13204395,19,1,0,0,1
13204396,13204691,295,0,0,1,1
13204408,13204697,289,0,0,1,2
13204692,13204701,9,1,0,0,1
13204698,13204702,4,1,0,0,2
13204702,13205962,1260,0,0,1,1
13204703,13205961,1258,0,0,1,2
13205962,13206033,71,1,0,0,2
13205963,13206026,63,1,0,0,1
13206027,13206737,710,0,0,1,1
13206034,13206733,699,0,0,1,2
13206734,13206767,33,1,0,0,2
13206738,13206772,34,1,0,0,1
13206768,13208009,1241,0,0,1,2
13206773,13208018,1245,0,0,1,1
13208010,13208684,674,1,0,0,2
13208019,13208587,568,1,0,0,1
13208042,13208600,558,0,1,0,2
13208049,13208578,529,0,1,0,1
13208588,13209428,840,0,0,1,1
13208685,13209428,743,0,0,1,2
13209429,13209511,82,1,0,0,1
13209429,13209511,82,1,0,0,2
13209512,13209615,103,0,0,1,2
13209512,13209616,104,0,0,1,1
13209616,13209639,23,1,0,0,2
13209617,13209640,23,1,0,0,1
13209640,13210970,1330,0,0,1,2
13209641,13210971,1330,0,0,1,1
13210971,13211069,98,1,0,0,2
13210972,13211033,61,1,0,0,1
13211034,13211185,151,0,0,1,1
13211070,13211096,26,0,0,1,2
13211097,13211246,149,1,0,0,2
13211186,13211215,29,1,0,0,1
13211216,13213018,1802,0,0,1,1
13211247,13213024,1777,0,0,1,2
13213019,13213890,871,1,0,0,1
13213025,13213927,902,1,0,0,2
13213048,13213916,868,0,1,0,2
13213055,13213865,810,0,1,0,1
13213891,13214154,263,0,0,1,1
13213928,13214155,227,0,0,1,2
13214155,13214224,69,1,0,0,1
13214156,13214262,106,1,0,0,2
13214225,13214304,79,0,0,1,1
13214263,13214305,42,0,0,1,2
13214305,13214367,62,1,0,0,1
13214306,13214389,83,1,0,0,2
13214368,13214484,116,0,0,1,1
13214390,13214485,95,0,0,1,2
13214485,13214504,19,1,0,0,1
13214486,13214532,46,1,0,0,2
13214505,13215885,1380,0,0,1,1
13214533,13215887,1354,0,0,1,2
13215886,13215937,51,1,0,0,1
13215888,13215948,60,1,0,0,2
13215938,13218223,2285,0,0,1,1
13215949,13218206,2257,0,0,1,2
13218207,13218876,669,1,0,0,2
13218224,13218769,545,1,0,0,1
13218253,13218772,519,0,1,0,2
13218263,13218758,495,0,1,0,1
13218770,13219304,534,0,0,1,1
13218877,13219307,430,0,0,1,2
13219305,13219348,43,1,0,0,1
13219308,13219507,199,1,0,0,2
13219349,13219591,242,0,0,1,1
13219508,13219590,82,0,0,1,2
13219591,13219640,49,1,0,0,2
13219592,13219639,47,1,0,0,1
13219640,13219689,49,0,0,1,1
13219641,13219680,39,0,0,1,2
13219681,13220181,500,1,0,0,2
13219690,13220156,466,1,0,0,1
13219709,13220156,447,0,1,0,2
13219716,13220146,430,0,1,0,1
13220157,13220231,74,0,0,1,1
13220182,13220230,48,0,0,1,2
13220231,13220265,34,1,0,0,2
13220232,13220265,33,1,0,0,1
13220266,13220695,429,0,0,1,1
13220266,13220695,429,0,0,1,2
13220696,13220734,38,1,0,0,1
13220696,13220745,49,1,0,0,2
13220735,13220865,130,0,0,1,1
13220746,13220858,112,0,0,1,2
13220859,13221282,423,1,0,0,2
13220866,13221268,402,1,0,0,1
13220890,13221261,371,0,1,0,2
13220894,13221257,363,0,1,0,1
13221269,13221417,148,0,0,1,1
13221283,13221417,134,0,0,1,2
13221418,13221439,21,1,0,0,1
13221418,13221440,22,1,0,0,2
13221440,13221858,418,0,0,1,1
13221441,13221859,418,0,0,1,2
13221859,13221904,45,1,0,0,1
13221860,13221904,44,1,0,0,2
13221905,13222157,252,0,0,1,1
13221905,13222157,252,0,0,1,2
13222158,13222182,24,1,0,0,2
13222158,13222183,25,1,0,0,1
13222183,13222408,225,0,0,1,2
13222184,13222424,240,0,0,1,1
13222409,13245635,23226,1,0,0,2
13222425,13248601,26176,1,0,0,1
13222465,13245568,23103,0,1,0,2
13222468,13248562,26094,0,1,0,1
13245636,13245914,278,0,0,1,2
13245915,13248687,2772,1,0,0,2
13245954,13248613,2659,0,1,0,2
13248602,13248660,58,0,0,1,1
13248661,13248687,26,1,0,0,1
13248688,13248782,94,0,0,1,2
13248688,13248825,137,0,0,1,1
13248783,13249269,486,1,0,0,2
13248826,13249186,360,1,0,0,1
13248862,13249235,373,0,1,0,2
13248863,13249150,287,0,1,0,1
13249187,13249431,244,0,0,1,1
13249270,13249413,143,0,0,1,2
13249414,13251440,2026,1,0,0,2
13249432,13250853,1421,1,0,0,1
13249451,13250856,1405,0,1,0,2
13249455,13250842,1387,0,1,0,1
13250854,13250933,79,0,0,1,1
13250934,13251405,471,1,0,0,1
13250953,13251398,445,0,1,0,2
13250956,13251386,430,0,1,0,1
13251406,13251495,89,0,0,1,1
13251441,13251494,53,0,0,1,2
13251495,13251517,22,1,0,0,2
13251496,13251518,22,1,0,0,1
13251518,13251606,88,0,0,1,2
13251519,13251612,93,0,0,1,1
13251607,13252079,472,1,0,0,2
13251613,13252050,437,1,0,0,1
13251638,13252034,396,0,1,0,1
13251639,13252048,409,0,1,0,2
13252051,13252137,86,0,0,1,1
13252080,13252139,59,0,0,1,2
13252138,13252156,18,1,0,0,1
13252140,13252163,23,1,0,0,2
13252157,13252397,240,0,0,1,1
13252164,13252383,219,0,0,1,2
13252384,13252885,501,1,0,0,2
13252398,13252865,467,1,0,0,1
13252428,13252825,397,0,1,0,1
13252429,13252837,408,0,1,0,2
13252866,13253033,167,0,0,1,1
13252886,13252917,31,0,0,1,2
13252918,13252939,21,1,0,0,2
13252940,13253033,93,0,0,1,2
13253034,13253070,36,1,0,0,1
13253034,13253097,63,1,0,0,2
13253071,13253402,331,0,0,1,1
13253098,13253364,266,0,0,1,2
13253365,13253829,464,1,0,0,2
13253403,13253643,240,1,0,0,1
13253433,13253622,189,0,1,0,1
13253435,13253618,183,0,1,0,2
13253644,13253684,40,0,0,1,1
13253685,13253731,46,1,0,0,1
13253732,13253997,265,0,0,1,1
13253830,13253997,167,0,0,1,2
13304811,13304878,67,0,1,0,1
13304811,13304895,84,0,1,0,2
13304811,13304895,84,1,0,0,1
13304811,13304946,135,1,0,0,2
13304896,13305104,208,0,0,1,1
13304947,13305104,157,0,0,1,2
13305105,13305184,79,1,0,0,2
13305105,13305185,80,1,0,0,1
13305185,13305296,111,0,0,1,2
13305186,13305290,104,0,0,1,1
13305291,13305319,28,1,0,0,1
13305297,13305308,11,1,0,0,2
13305309,13306092,783,0,0,1,2
13305320,13306088,768,0,0,1,1
13306089,13306122,33,1,0,0,1
13306093,13306104,11,1,0,0,2
13306105,13307603,1498,0,0,1,2
13306123,13307602,1479,0,0,1,1
13307603,13307665,62,1,0,0,1
13307604,13307922,318,1,0,0,2
13307666,13307762,96,0,0,1,1
13307763,13307805,42,1,0,0,1
13307806,13307908,102,0,0,1,1
13307909,13307932,23,1,0,0,1
13307923,13309354,1431,0,0,1,2
13307933,13309399,1466,0,0,1,1
13309355,13309376,21,1,0,0,2
13309377,13309399,22,0,0,1,2
13309400,13310281,881,1,0,0,1
13309400,13310475,1075,1,0,0,2
13309458,13310465,1007,0,1,0,2
13309476,13310271,795,0,1,0,1
13310282,13310994,712,0,0,1,1
13310476,13310992,516,0,0,1,2
13310993,13311133,140,1,0,0,2
13310995,13311062,67,1,0,0,1
13311063,13311486,423,0,0,1,1
13311134,13311488,354,0,0,1,2
13311487,13311576,89,1,0,0,1
13311489,13311573,84,1,0,0,2
13311574,13311672,98,0,0,1,2
13311577,13311672,95,0,0,1,1
13311673,13311706,33,1,0,0,2
13311673,13311715,42,1,0,0,1
13311707,13312206,499,0,0,1,2
13311716,13312210,494,0,0,1,1
13312207,13312491,284,1,0,0,2
13312211,13312481,270,1,0,0,1
13312241,13312442,201,0,1,0,2
13312243,13312429,186,0,1,0,1
13312482,13312774,292,0,0,1,1
13312492,13312774,282,0,0,1,2
13312775,13312833,58,1,0,0,1
13312775,13312833,58,1,0,0,2
13312834,13313200,366,0,0,1,2
13312834,13313201,367,0,0,1,1
13313201,13313288,87,1,0,0,2
13313202,13313288,86,1,0,0,1
13313289,13313384,95,0,0,1,2
13313289,13313385,96,0,0,1,1
13313385,13313410,25,1,0,0,2
13313386,13313427,41,1,0,0,1
13313411,13314258,847,0,0,1,2
13313428,13314267,839,0,0,1,1
13314259,13315038,779,1,0,0,2
13314268,13314589,321,1,0,0,1
13314284,13314579,295,0,1,0,1
13314288,13314594,306,0,1,0,2
13314590,13314663,73,0,0,1,1
13314664,13314751,87,1,0,0,1
13314752,13314934,182,0,0,1,1
13314935,13314996,61,1,0,0,1
13314997,13315146,149,0,0,1,1
13315039,13315142,103,0,0,1,2
13315143,13315157,14,1,0,0,2
13315147,13315159,12,1,0,0,1
13315158,13315314,156,0,0,1,2
13315160,13315425,265,0,0,1,1
13315315,13315322,7,1,0,0,2
13315323,13315411,88,0,0,1,2
13315412,13315537,125,1,0,0,2
13315426,13315433,7,1,0,0,1
13315434,13316178,744,0,0,1,1
13315538,13315682,144,0,0,1,2
13315683,13315754,71,1,0,0,2
13315755,13316064,309,0,0,1,2
13316065,13316576,511,1,0,0,2
13316179,13316454,275,1,0,0,1
13316194,13316456,262,0,1,0,2
13316199,13316434,235,0,1,0,1
13316455,13316822,367,0,0,1,1
13316577,13316821,244,0,0,1,2
13316822,13316959,137,1,0,0,2
13316823,13316922,99,1,0,0,1
13316923,13317013,90,0,0,1,1
13316960,13317011,51,0,0,1,2
13317012,13317046,34,1,0,0,2
13317014,13317055,41,1,0,0,1
13317047,13317245,198,0,0,1,2
13317056,13317238,182,0,0,1,1
13317239,13317256,17,1,0,0,1
13317246,13317256,10,1,0,0,2
13317257,13318636,1379,0,0,1,2
13317257,13318638,1381,0,0,1,1
13318637,13318733,96,1,0,0,2
13318639,13318732,93,1,0,0,1
13318733,13318853,120,0,0,1,1
13318734,13318851,117,0,0,1,2
13318852,13318882,30,1,0,0,2
13318854,13318875,21,1,0,0,1
13318876,13320422,1546,0,0,1,1
13318883,13320422,1539,0,0,1,2
13320423,13320484,61,1,0,0,2
13320423,13320499,76,1,0,0,1
13320485,13320623,138,0,0,1,2
13320500,13320622,122,0,0,1,1
13320623,13320656,33,1,0,0,1
13320624,13320649,25,1,0,0,2
13320650,13320947,297,0,0,1,2
13320657,13320943,286,0,0,1,1
13320944,13320970,26,1,0,0,1
13320948,13320963,15,1,0,0,2
13320964,13321219,255,0,0,1,2
13320971,13321220,249,0,0,1,1
13321220,13321434,214,1,0,0,2
13321221,13321450,229,1,0,0,1
13321251,13321389,138,0,1,0,2
13321252,13321376,124,0,1,0,1
13321435,13322093,658,0,0,1,2
13321451,13322093,642,0,0,1,1
13322094,13322183,89,1,0,0,1
13322094,13322185,91,1,0,0,2
13322184,13322292,108,0,0,1,1
13322186,13322292,106,0,0,1,2
13322293,13322316,23,1,0,0,1
13322293,13322324,31,1,0,0,2
13322317,13323877,1560,0,0,1,1
13322325,13323877,1552,0,0,1,2
13323878,13323927,49,1,0,0,2
13323878,13323928,50,1,0,0,1
13323928,13324124,196,0,0,1,2
13323929,13324891,962,0,0,1,1
13324125,13324133,8,1,0,0,2
13324134,13324896,762,0,0,1,2
13324892,13324914,22,1,0,0,1
13324897,13324914,17,1,0,0,2
13324915,13325419,504,0,0,1,2
13324915,13325423,508,0,0,1,1
13325420,13325696,276,1,0,0,2
13325424,13325648,224,1,0,0,1
13325450,13325600,150,0,1,0,1
13325451,13325619,168,0,1,0,2
13325649,13326082,433,0,0,1,1
13325697,13326082,385,0,0,1,2
13326083,13326184,101,1,0,0,1
13326083,13326878,795,1,0,0,2
13326152,13326867,715,0,1,0,2
13326185,13326245,60,0,0,1,1
13326256,13326381,125,0,1,0,1
13326391,13326391,0,1,0,0,1
13326392,13326424,32,0,0,1,1
13326425,13326436,11,1,0,0,1
13326437,13327375,938,0,0,1,1
13326879,13327376,497,0,0,1,2
13327376,13327452,76,1,0,0,1
13327377,13327536,159,1,0,0,2
13327453,13327829,376,0,0,1,1
13327537,13327827,290,0,0,1,2
13327828,13327877,49,1,0,0,2
13327830,13327875,45,1,0,0,1
13327876,13328038,162,0,0,1,1
13327878,13329484,1606,0,0,1,2
13328039,13328063,24,1,0,0,1
13328064,13329484,1420,0,0,1,1
13329485,13329562,77,1,0,0,1
13329485,13329576,91,1,0,0,2
13329563,13329652,89,0,0,1,1
13329577,13329657,80,0,0,1,2
13329653,13329685,32,1,0,0,1
13329658,13329677,19,1,0,0,2
13329678,13331354,1676,0,0,1,2
13329686,13329876,190,0,0,1,1
13329877,13329889,12,1,0,0,1
13329890,13331352,1462,0,0,1,1
13331353,13331505,152,1,0,0,1
13331355,13331499,144,1,0,0,2
13331500,13331595,95,0,0,1,2
13331506,13331594,88,0,0,1,1
13331595,13331633,38,1,0,0,1
13331596,13331634,38,1,0,0,2
13331634,13332615,981,0,0,1,1
13331635,13332614,979,0,0,1,2
13332615,13332896,281,1,0,0,2
13332616,13332855,239,1,0,0,1
13332646,13332833,187,0,1,0,2
13332647,13332806,159,0,1,0,1
13332856,13332888,32,0,0,1,1
13332889,13332893,4,1,0,0,1
13332894,13333158,264,0,0,1,1
13332897,13332951,54,0,0,1,2
13332952,13332957,5,1,0,0,2
13332958,13333158,200,0,0,1,2
13333159,13333212,53,1,0,0,1
13333159,13333213,54,1,0,0,2
13333213,13333390,177,0,0,1,1
13333214,13333391,177,0,0,1,2
13333391,13333402,11,1,0,0,1
13333392,13333410,18,1,0,0,2
13333403,13334799,1396,0,0,1,1
13333411,13334798,1387,0,0,1,2
13334799,13335344,545,1,0,0,2
13334800,13334947,147,1,0,0,1
13334859,13335105,246,0,1,0,2
13334876,13334937,61,0,1,0,1
13334948,13335055,107,0,0,1,1
13335056,13335083,27,1,0,0,1
13335084,13336114,1030,0,0,1,1
13335345,13336114,769,0,0,1,2
13336115,13336192,77,1,0,0,1
13336115,13336377,262,1,0,0,2
13336193,13336589,396,0,0,1,1
13336378,13336578,200,0,0,1,2
13336579,13336697,118,1,0,0,2
13336590,13336764,174,1,0,0,1
13336698,13336792,94,0,0,1,2
13336765,13336791,26,0,0,1,1
13336792,13336856,64,1,0,0,1
13336793,13336836,43,1,0,0,2
13336837,13337126,289,0,0,1,2
13336857,13337126,269,0,0,1,1
13337127,13337723,596,1,0,0,2
13337127,13337728,601,1,0,0,1
13337165,13337271,106,0,1,0,2
13337168,13337262,94,0,1,0,1
13337391,13337643,252,0,1,0,2
13337400,13337611,211,0,1,0,1
13337724,13338294,570,0,0,1,2
13337729,13338293,564,0,0,1,1
13338294,13338391,97,1,0,0,1
13338295,13338460,165,1,0,0,2
13338392,13338490,98,0,0,1,1
13338461,13338491,30,0,0,1,2
13338491,13338532,41,1,0,0,1
13338492,13338565,73,1,0,0,2
13338533,13339996,1463,0,0,1,1
13338566,13338796,230,0,0,1,2
13338797,13338819,22,1,0,0,2
13338820,13339995,1175,0,0,1,2
13339996,13340046,50,1,0,0,2
13339997,13340037,40,1,0,0,1
13340038,13340126,88,0,0,1,1
13340047,13340125,78,0,0,1,2
13340126,13340153,27,1,0,0,2
13340127,13340168,41,1,0,0,1
13340154,13340261,107,0,0,1,2
13340169,13340260,91,0,0,1,1
13340261,13340303,42,1,0,0,1
13340262,13340296,34,1,0,0,2
13340297,13341684,1387,0,0,1,2
13340304,13340856,552,0,0,1,1
13340857,13340877,20,1,0,0,1
13340878,13341711,833,0,0,1,1
13341685,13342746,1061,1,0,0,2
13341712,13342326,614,1,0,0,1
13341730,13342735,1005,0,1,0,2
13341732,13342315,583,0,1,0,1
13342327,13343247,920,0,0,1,1
13342747,13343247,500,0,0,1,2
13343248,13343312,64,1,0,0,1
13343248,13343396,148,1,0,0,2
13343313,13343707,394,0,0,1,1
13343397,13343707,310,0,0,1,2
13343708,13343826,118,1,0,0,1
13343708,13343827,119,1,0,0,2
13343827,13343903,76,0,0,1,1
13343828,13343903,75,0,0,1,2
13343904,13343945,41,1,0,0,2
13343904,13343952,48,1,0,0,1
13343946,13345577,1631,0,0,1,2
13343953,13345578,1625,0,0,1,1
13345578,13346130,552,1,0,0,2
13345579,13346130,551,1,0,0,1
13345649,13346095,446,0,1,0,2
13345656,13346094,438,0,1,0,1
13346131,13347578,1447,0,0,1,2
13346131,13347579,1448,0,0,1,1
13347579,13347633,54,1,0,0,2
13347580,13347633,53,1,0,0,1
13347634,13347702,68,0,0,1,1
13347634,13347703,69,0,0,1,2
13347703,13347711,8,1,0,0,1
13347704,13347709,5,1,0,0,2
13347710,13347736,26,0,0,1,2
13347712,13347745,33,0,0,1,1
13347737,13347769,32,1,0,0,2
13347746,13347760,14,1,0,0,1
13347761,13347931,170,0,0,1,1
13347770,13347929,159,0,0,1,2
13347930,13347941,11,1,0,0,2
13347932,13347941,9,1,0,0,1
13347942,13349484,1542,0,0,1,1
13347942,13349484,1542,0,0,1,2
13349485,13349540,55,1,0,0,1
13349485,13349546,61,1,0,0,2
13349541,13350607,1066,0,0,1,1
13349547,13350610,1063,0,0,1,2
13350608,13350955,347,1,0,0,1
13350611,13350979,368,1,0,0,2
13350634,13350969,335,0,1,0,2
13350652,13350913,261,0,1,0,1
13350956,13351328,372,0,0,1,1
13350980,13351328,348,0,0,1,2
13351329,13351467,138,1,0,0,2
13351329,13351468,139,1,0,0,1
13351468,13351536,68,0,0,1,2
13351469,13351536,67,0,0,1,1
13351537,13351570,33,1,0,0,2
13351537,13351589,52,1,0,0,1
13351571,13353081,1510,0,0,1,2
13351590,13353081,1491,0,0,1,1
13353082,13353667,585,1,0,0,1
13353082,13354015,933,1,0,0,2
13353154,13353865,711,0,1,0,2
13353185,13353656,471,0,1,0,1
13353668,13353735,67,0,0,1,1
13353736,13353743,7,1,0,0,1
13353744,13354827,1083,0,0,1,1
13354016,13354825,809,0,0,1,2
13354826,13355154,328,1,0,0,2
13354828,13355143,315,1,0,0,1
13354852,13355129,277,0,1,0,2
13354857,13355106,249,0,1,0,1
13355144,13355179,35,0,0,1,1
13355155,13355177,22,0,0,1,2
13355178,13355202,24,1,0,0,2
13355180,13355200,20,1,0,0,1
13355201,13356891,1690,0,0,1,1
13355203,13356893,1690,0,0,1,2
13356892,13356942,50,1,0,0,1
13356894,13356953,59,1,0,0,2
13356943,13357072,129,0,0,1,1
13356954,13357068,114,0,0,1,2
13357069,13357095,26,1,0,0,2
13357073,13357104,31,1,0,0,1
13357096,13357465,369,0,0,1,2
13357105,13358700,1595,0,0,1,1
13357466,13357485,19,1,0,0,2
13357486,13358698,1212,0,0,1,2
13358699,13359013,314,1,0,0,2
13358701,13358815,114,1,0,0,1
13358761,13358790,29,0,1,0,2
13358816,13358922,106,0,0,1,1
13358923,13358984,61,1,0,0,1
13358985,13359177,192,0,0,1,1
13359014,13359174,160,0,0,1,2
13359175,13359185,10,1,0,0,2
13359178,13359202,24,1,0,0,1
13359186,13360592,1406,0,0,1,2
13359203,13359755,552,0,0,1,1
13359756,13359760,4,1,0,0,1
13359761,13360595,834,0,0,1,1
13360593,13360896,303,1,0,0,2
13360596,13360894,298,1,0,0,1
13360629,13360849,220,0,1,0,2
13360631,13360836,205,0,1,0,1
13360895,13360997,102,0,0,1,1
13360897,13360999,102,0,0,1,2
13360998,13361046,48,1,0,0,1
13361000,13361032,32,1,0,0,2
13361033,13361202,169,0,0,1,2
13361047,13361199,152,0,0,1,1
13361200,13361228,28,1,0,0,1
13361203,13361227,24,1,0,0,2
13361228,13362467,1239,0,0,1,2
13361229,13362464,1235,0,0,1,1
13362465,13362534,69,1,0,0,1
13362468,13362546,78,1,0,0,2
13362535,13362655,120,0,0,1,1
13362547,13362655,108,0,0,1,2
13362656,13362677,21,1,0,0,1
13362656,13362689,33,1,0,0,2
13362678,13363886,1208,0,0,1,1
13362690,13363884,1194,0,0,1,2
13363885,13364495,610,1,0,0,2
13363887,13364147,260,1,0,0,1
13363915,13364121,206,0,1,0,1
13363915,13364133,218,0,1,0,2
13364148,13364203,55,0,0,1,1
13364204,13364545,341,1,0,0,1
13364211,13364464,253,0,1,0,2
13364217,13364437,220,0,1,0,1
13364496,13364518,22,0,0,1,2
13364519,13364556,37,1,0,0,2
13364546,13365694,1148,0,0,1,1
13364557,13365694,1137,0,0,1,2
13365695,13365777,82,1,0,0,2
13365695,13365779,84,1,0,0,1
13365778,13366129,351,0,0,1,2
13365780,13366130,350,0,0,1,1
13366130,13366223,93,1,0,0,2
13366131,13366217,86,1,0,0,1
13366218,13366327,109,0,0,1,1
13366224,13366328,104,0,0,1,2
13366328,13366363,35,1,0,0,1
13366329,13366363,34,1,0,0,2
13366364,13366675,311,0,0,1,2
13366364,13367934,1570,0,0,1,1
13366676,13366684,8,1,0,0,2
13366685,13367935,1250,0,0,1,2
13367935,13367996,61,1,0,0,1
13367936,13367999,63,1,0,0,2
13367997,13368121,124,0,0,1,1
13368000,13368124,124,0,0,1,2
13368122,13368149,27,1,0,0,1
13368125,13368146,21,1,0,0,2
13368147,13369736,1589,0,0,1,2
13368150,13368566,416,0,0,1,1
13368567,13368591,24,1,0,0,1
13368592,13369735,1143,0,0,1,1
13369736,13369881,145,1,0,0,1
13369737,13370158,421,1,0,0,2
13369809,13369946,137,0,1,0,2
13369882,13369910,28,0,0,1,1
13369911,13369975,64,1,0,0,1
13369976,13371580,1604,0,0,1,1
13370159,13370263,104,0,0,1,2
13370264,13370324,60,1,0,0,2
13370325,13371580,1255,0,0,1,2
13371581,13371649,68,1,0,0,1
13371581,13371689,108,1,0,0,2
13371650,13371780,130,0,0,1,1
13371690,13371780,90,0,0,1,2
13371781,13371807,26,1,0,0,1
13371781,13371808,27,1,0,0,2
13371808,13373349,1541,0,0,1,1
13371809,13373349,1540,0,0,1,2
13373350,13374195,845,1,0,0,1
13373350,13374459,1109,1,0,0,2
13373404,13374448,1044,0,1,0,2
13373405,13374186,781,0,1,0,1
13374196,13374721,525,0,0,1,1
13374460,13374720,260,0,0,1,2
13374721,13374874,153,1,0,0,2
13374722,13374796,74,1,0,0,1
13374744,13374778,34,0,1,0,2
13374797,13375272,475,0,0,1,1
13374875,13374900,25,0,0,1,2
13374901,13375028,127,1,0,0,2
13375029,13375069,40,0,0,1,2
13375070,13375138,68,1,0,0,2
13375139,13375270,131,0,0,1,2
13375271,13375449,178,1,0,0,2
13375273,13375403,130,1,0,0,1
13375404,13375481,77,0,0,1,1
13375450,13375482,32,0,0,1,2
13375482,13375520,38,1,0,0,1
13375483,13375523,40,1,0,0,2
13375521,13375713,192,0,0,1,1
13375524,13376986,1462,0,0,1,2
13375714,13375726,12,1,0,0,1
13375727,13376988,1261,0,0,1,1
13376987,13377414,427,1,0,0,2
13376989,13377066,77,1,0,0,1
13377067,13377175,108,0,0,1,1
13377176,13377200,24,1,0,0,1
13377201,13378798,1597,0,0,1,1
13377415,13377939,524,0,0,1,2
13377940,13378032,92,1,0,0,2
13378033,13378798,765,0,0,1,2
13378799,13378890,91,1,0,0,1
13378799,13378893,94,1,0,0,2
13378891,13378982,91,0,0,1,1
13378894,13378983,89,0,0,1,2
13378983,13379034,51,1,0,0,1
13378984,13379025,41,1,0,0,2
13379026,13379212,186,0,0,1,2
13379035,13380590,1555,0,0,1,1
13379213,13379224,11,1,0,0,2
13379225,13380584,1359,0,0,1,2
13380585,13381624,1039,1,0,0,2
13380591,13380833,242,1,0,0,1
13380623,13380825,202,0,1,0,2
13380624,13380805,181,0,1,0,1
13380834,13380925,91,0,0,1,1
13380926,13380947,21,1,0,0,1
13380948,13382417,1469,0,0,1,1
13381625,13382418,793,0,0,1,2
13382418,13382517,99,1,0,0,1
13382419,13382957,538,1,0,0,2
13382487,13382919,432,0,1,0,2
13382501,13382507,6,0,1,0,1
13382518,13382560,42,0,0,1,1
13382561,13382738,177,1,0,0,1
13382575,13382680,105,0,1,0,1
13382739,13382855,116,0,0,1,1
13382856,13382861,5,1,0,0,1
13382862,13383809,947,0,0,1,1
13382958,13383006,48,0,0,1,2
13383007,13383107,100,1,0,0,2
13383108,13383811,703,0,0,1,2
13383810,13383862,52,1,0,0,1
13383812,13383904,92,1,0,0,2
13383863,13384257,394,0,0,1,1
13383905,13384256,351,0,0,1,2
13384257,13384319,62,1,0,0,2
13384258,13384311,53,1,0,0,1
13384312,13384456,144,0,0,1,1
13384320,13384455,135,0,0,1,2
13384456,13384474,18,1,0,0,2
13384457,13384480,23,1,0,0,1
13384475,13386137,1662,0,0,1,2
13384481,13386137,1656,0,0,1,1
13386138,13386235,97,1,0,0,1
13386138,13386240,102,1,0,0,2
13386236,13386357,121,0,0,1,1
13386241,13386262,21,0,0,1,2
13386263,13386295,32,1,0,0,2
13386296,13386357,61,0,0,1,2
13386358,13386393,35,1,0,0,2
13386358,13386394,36,1,0,0,1
13386394,13387931,1537,0,0,1,2
13386395,13387931,1536,0,0,1,1
13387932,13388406,474,1,0,0,1
13387932,13389055,1123,1,0,0,2
13387990,13389045,1055,0,1,0,2
13387998,13388395,397,0,1,0,1
13388407,13388490,83,0,0,1,1
13388491,13388513,22,1,0,0,1
13388514,13388543,29,0,0,1,1
13388554,13388555,1,0,1,0,1
13388564,13388564,0,1,0,0,1
13388565,13388667,102,0,0,1,1
13388678,13388740,62,0,1,0,1
13388749,13388749,0,1,0,0,1
13388750,13389826,1076,0,0,1,1
13389056,13389827,771,0,0,1,2
13389827,13389925,98,1,0,0,1
13389828,13390015,187,1,0,0,2
13389926,13391524,1598,0,0,1,1
13390016,13391524,1508,0,0,1,2
13391525,13391584,59,1,0,0,2
13391525,13391589,64,1,0,0,1
13391585,13391726,141,0,0,1,2
13391590,13391727,137,0,0,1,1
13391727,13391738,11,1,0,0,2
13391728,13391740,12,1,0,0,1
13391739,13393353,1614,0,0,1,2
13391741,13393354,1613,0,0,1,1
13393354,13393610,256,1,0,0,2
13393355,13393452,97,1,0,0,1
13393453,13393539,86,0,0,1,1
13393540,13393592,52,1,0,0,1
13393593,13394303,710,0,0,1,1
13393611,13395179,1568,0,0,1,2
13394304,13394310,6,1,0,0,1
13394311,13395177,866,0,0,1,1
13395178,13395277,99,1,0,0,1
13395180,13395277,97,1,0,0,2
13395278,13395366,88,0,0,1,1
13395278,13395366,88,0,0,1,2
13395367,13395418,51,1,0,0,2
13395367,13395430,63,1,0,0,1
13395419,13395454,35,0,0,1,2
13395431,13395460,29,0,0,1,1
13395455,13395728,273,1,0,0,2
13395461,13395709,248,1,0,0,1
13395486,13395679,193,0,1,0,2
13395490,13395667,177,0,1,0,1
13395710,13395991,281,0,0,1,1
13395729,13397860,2131,0,0,1,2
13395992,13396008,16,1,0,0,1
13396009,13397861,1852,0,0,1,1
13397861,13397927,66,1,0,0,2
13397862,13397933,71,1,0,0,1
13397928,13398004,76,0,0,1,2
13397934,13398012,78,0,0,1,1
13398005,13398345,340,1,0,0,2
13398013,13398307,294,1,0,0,1
13398032,13398292,260,0,1,0,2
13398037,13398273,236,0,1,0,1
13398308,13401793,3485,0,0,1,1
13398346,13401792,3446,0,0,1,2
13401793,13401891,98,1,0,0,2
13401794,13401873,79,1,0,0,1
13401874,13401960,86,0,0,1,1
13401892,13401932,40,0,0,1,2
13401933,13401995,62,1,0,0,2
13401961,13401984,23,1,0,0,1
13401985,13402087,102,0,0,1,1
13401996,13402084,88,0,0,1,2
13402085,13402118,33,1,0,0,2
13402088,13402108,20,1,0,0,1
13402109,13403305,1196,0,0,1,1
13402119,13403302,1183,0,0,1,2
13403303,13403376,73,1,0,0,2
13403306,13403382,76,1,0,0,1
13403377,13403506,129,0,0,1,2
13403383,13403507,124,0,0,1,1
13403507,13403536,29,1,0,0,2
13403508,13403547,39,1,0,0,1
13403537,13405624,2087,0,0,1,2
13403548,13405622,2074,0,0,1,1
13405623,13406192,569,1,0,0,1
13405625,13406212,587,1,0,0,2
13405648,13406169,521,0,1,0,2
13405651,13406181,530,0,1,0,1
13406193,13406620,427,0,0,1,1
13406213,13406620,407,0,0,1,2
13406621,13406680,59,1,0,0,2
13406621,13406683,62,1,0,0,1
13406681,13406785,104,0,0,1,2
13406684,13406785,101,0,0,1,1
13406786,13406816,30,1,0,0,2
13406786,13406817,31,1,0,0,1
13406817,13407541,724,0,0,1,2
13406818,13407536,718,0,0,1,1
13407537,13407553,16,1,0,0,1
13407542,13407547,5,1,0,0,2
13407548,13408884,1336,0,0,1,2
13407554,13408885,1331,0,0,1,1
13408885,13408959,74,1,0,0,2
13408886,13408948,62,1,0,0,1
13408949,13410612,1663,0,0,1,1
13408960,13410607,1647,0,0,1,2
13410608,13411274,666,1,0,0,2
13410613,13411238,625,1,0,0,1
13410632,13411263,631,0,1,0,2
13410633,13411227,594,0,1,0,1
13411239,13412515,1276,0,0,1,1
13411275,13412514,1239,0,0,1,2
13412515,13412681,166,1,0,0,2
13412516,13412617,101,1,0,0,1
13412618,13412711,93,0,0,1,1
13412682,13412710,28,0,0,1,2
13412711,13412738,27,1,0,0,2
13412712,13412737,25,1,0,0,1
13412738,13414118,1380,0,0,1,1
13412739,13412971,232,0,0,1,2
13412972,13412985,13,1,0,0,2
13412986,13414117,1131,0,0,1,2
13414118,13414181,63,1,0,0,2
13414119,13414190,71,1,0,0,1
13414182,13414342,160,0,0,1,2
13414191,13414341,150,0,0,1,1
13414342,13414359,17,1,0,0,1
13414343,13414367,24,1,0,0,2
13414360,13414738,378,0,0,1,1
13414368,13414741,373,0,0,1,2
13414739,13414762,23,1,0,0,1
13414742,13414763,21,1,0,0,2
13414763,13416337,1574,0,0,1,1
13414764,13416295,1531,0,0,1,2
13416296,13416710,414,1,0,0,2
13416338,13416670,332,1,0,0,1
13416369,13416635,266,0,1,0,2
13416370,13416629,259,0,1,0,1
13416671,13417493,822,0,0,1,1
13416711,13417493,782,0,0,1,2
13417494,13417563,69,1,0,0,1
13417494,13417755,261,1,0,0,2
13417564,13417724,160,0,0,1,1
13417725,13417757,32,1,0,0,1
13417756,13418272,516,0,0,1,2
13417758,13418243,485,0,0,1,1
13418244,13418285,41,1,0,0,1
13418273,13418277,4,1,0,0,2
13418278,13419655,1377,0,0,1,2
13418286,13419655,1369,0,0,1,1
13419656,13419731,75,1,0,0,1
13419656,13419770,114,1,0,0,2
13419732,13419889,157,0,0,1,1
13419771,13419889,118,0,0,1,2
13419890,13419909,19,1,0,0,2
13419890,13419943,53,1,0,0,1
13419910,13421717,1807,0,0,1,2
13419944,13421534,1590,0,0,1,1
13421535,13421562,27,1,0,0,1
13421563,13421728,165,0,0,1,1
13421718,13422428,710,1,0,0,2
13421729,13422266,537,1,0,0,1
13421761,13422256,495,0,1,0,1
13421767,13422286,519,0,1,0,2
13422267,13422907,640,0,0,1,1
13422429,13422907,478,0,0,1,2
13422908,13422960,52,1,0,0,2
13422908,13422961,53,1,0,0,1
13422961,13423137,176,0,0,1,2
13422962,13423137,175,0,0,1,1
13423138,13423199,61,1,0,0,1
13423138,13423221,83,1,0,0,2
13423200,13423468,268,0,0,1,1
13423222,13423470,248,0,0,1,2
13423469,13423546,77,1,0,0,1
13423471,13423549,78,1,0,0,2
13423547,13423731,184,0,0,1,1
13423550,13423731,181,0,0,1,2
13423732,13423809,77,1,0,0,2
13423732,13423822,90,1,0,0,1
13423810,13423912,102,0,0,1,2
13423823,13423913,90,0,0,1,1
13423913,13423952,39,1,0,0,2
13423914,13423946,32,1,0,0,1
13423947,13424124,177,0,0,1,1
13423953,13424129,176,0,0,1,2
13424125,13424149,24,1,0,0,1
13424130,13424139,9,1,0,0,2
13424140,13425285,1145,0,0,1,2
13424150,13425285,1135,0,0,1,1
13425286,13425357,71,1,0,0,1
13425286,13425367,81,1,0,0,2
13425358,13427304,1946,0,0,1,1
13425368,13427299,1931,0,0,1,2
13427300,13427617,317,1,0,0,2
13427305,13427622,317,1,0,0,1
13427329,13427590,261,0,1,0,2
13427331,13427569,238,0,1,0,1
13427618,13427648,30,0,0,1,2
13427623,13428606,983,0,0,1,1
13427649,13427692,43,1,0,0,2
13427693,13428606,913,0,0,1,2
13428607,13428664,57,1,0,0,1
13428607,13428674,67,1,0,0,2
13428665,13428961,296,0,0,1,1
13428675,13428960,285,0,0,1,2
13428961,13429094,133,1,0,0,2
13428962,13429045,83,1,0,0,1
13429046,13429168,122,0,0,1,1
13429095,13429168,73,0,0,1,2
13429169,13429201,32,1,0,0,1
13429169,13429202,33,1,0,0,2
13429202,13429466,264,0,0,1,1
13429203,13430999,1796,0,0,1,2
13429467,13429477,10,1,0,0,1
13429478,13431000,1522,0,0,1,1
13431000,13431068,68,1,0,0,2
13431001,13431070,69,1,0,0,1
13431069,13431199,130,0,0,1,2
13431071,13431200,129,0,0,1,1
13431200,13431229,29,1,0,0,2
13431201,13431239,38,1,0,0,1
13431230,13431526,296,0,0,1,2
13431240,13431543,303,0,0,1,1
13431527,13431876,349,1,0,0,2
13431544,13431789,245,1,0,0,1
13431559,13431763,204,0,1,0,2
13431561,13431763,202,0,1,0,1
13431790,13433098,1308,0,0,1,1
13431877,13433084,1207,0,0,1,2
13433085,13434140,1055,1,0,0,2
13433099,13433668,569,1,0,0,1
13433120,13433348,228,0,1,0,2
13433121,13433351,230,0,1,0,1
13433397,13433652,255,0,1,0,2
13433398,13433649,251,0,1,0,1
13433669,13433730,61,0,0,1,1
13433731,13434038,307,1,0,0,1
13433751,13433991,240,0,1,0,2
13433756,13433984,228,0,1,0,1
13434039,13434247,208,0,0,1,1
13434141,13434245,104,0,0,1,2
13434246,13434299,53,1,0,0,2
13434248,13434299,51,1,0,0,1
13434300,13434927,627,0,0,1,1
13434300,13434927,627,0,0,1,2
13434928,13435007,79,1,0,0,1
13434928,13435041,113,1,0,0,2
13435008,13435111,103,0,0,1,1
13435042,13435110,68,0,0,1,2
13435111,13435138,27,1,0,0,2
13435112,13435139,27,1,0,0,1
13435139,13436968,1829,0,0,1,2
13435140,13436969,1829,0,0,1,1
13436969,13437026,57,1,0,0,2
13436970,13437027,57,1,0,0,1
13437027,13437153,126,0,0,1,2
13437028,13437154,126,0,0,1,1
13437154,13437176,22,1,0,0,2
13437155,13437176,21,1,0,0,1
13437177,13437373,196,0,0,1,1
13437177,13439127,1950,0,0,1,2
13437374,13437394,20,1,0,0,1
13437395,13439139,1744,0,0,1,1
13439128,13439768,640,1,0,0,2
13439140,13439705,565,1,0,0,1
13439178,13439434,256,0,1,0,1
13439186,13439674,488,0,1,0,2
13439468,13439662,194,0,1,0,1
13439706,13441028,1322,0,0,1,1
13439769,13441028,1259,0,0,1,2
13441029,13441091,62,1,0,0,2
13441029,13441092,63,1,0,0,1
13441092,13441213,121,0,0,1,2
13441093,13441216,123,0,0,1,1
13441214,13441359,145,1,0,0,2
13441217,13441241,24,1,0,0,1
13441242,13441911,669,0,0,1,1
13441360,13441472,112,0,0,1,2
13441473,13441489,16,1,0,0,2
13441490,13442678,1188,0,0,1,2
13441912,13441928,16,1,0,0,1
13441929,13442679,750,0,0,1,1
13442679,13442914,235,1,0,0,2
13442680,13442745,65,1,0,0,1
13442746,13442999,253,0,0,1,1
13442915,13443448,533,0,0,1,2
13443000,13443011,11,1,0,0,1
13443012,13443441,429,0,0,1,1
13443442,13443463,21,1,0,0,1
13443449,13443453,4,1,0,0,2
13443454,13444714,1260,0,0,1,2
13443464,13444722,1258,0,0,1,1
13444715,13445386,671,1,0,0,2
13444723,13445261,538,1,0,0,1
13444745,13445228,483,0,1,0,2
13444753,13445250,497,0,1,0,1
13445262,13445423,161,0,0,1,1
13445387,13445422,35,0,0,1,2
13445423,13445527,104,1,0,0,2
13445424,13445477,53,1,0,0,1
13445478,13446463,985,0,0,1,1
13445528,13446463,935,0,0,1,2
13446464,13446535,71,1,0,0,1
13446464,13446612,148,1,0,0,2
13446536,13446703,167,0,0,1,1
13446613,13446705,92,0,0,1,2
13446704,13446728,24,1,0,0,1
13446706,13446717,11,1,0,0,2
13446718,13448176,1458,0,0,1,2
13446729,13447854,1125,0,0,1,1
13447855,13447859,4,1,0,0,1
13447860,13448177,317,0,0,1,1
13448177,13448288,111,1,0,0,2
13448178,13448246,68,1,0,0,1
13448247,13448439,192,0,0,1,1
13448289,13448438,149,0,0,1,2
13448439,13448458,19,1,0,0,2
13448440,13448457,17,1,0,0,1
13448458,13450242,1784,0,0,1,1
13448459,13450191,1732,0,0,1,2
13450192,13450835,643,1,0,0,2
13450243,13450640,397,1,0,0,1
13450360,13450604,244,0,1,0,1
13450363,13450610,247,0,1,0,2
13450641,13451286,645,0,0,1,1
13450836,13451286,450,0,0,1,2
13451287,13451370,83,1,0,0,1
13451287,13451371,84,1,0,0,2
13451371,13452067,696,0,0,1,1
13451372,13452066,694,0,0,1,2
13452067,13452121,54,1,0,0,2
13452068,13452129,61,1,0,0,1
13452122,13452581,459,0,0,1,2
13452130,13453493,1363,0,0,1,1
13452582,13452740,158,1,0,0,2
13452741,13452968,227,0,0,1,2
13452969,13452990,21,1,0,0,2
13452991,13453014,23,0,0,1,2
13453015,13453282,267,1,0,0,2
13453283,13453382,99,0,0,1,2
13453383,13453428,45,1,0,0,2
13453429,13453492,63,0,0,1,2
13453493,13453603,110,1,0,0,2
13453494,13453573,79,1,0,0,1
13453574,13453723,149,0,0,1,1
13453604,13453723,119,0,0,1,2
13453724,13453735,11,1,0,0,1
13453724,13453737,13,1,0,0,2
13453736,13455645,1909,0,0,1,1
13453738,13455644,1906,0,0,1,2
13455645,13456282,637,1,0,0,2
13455646,13456168,522,1,0,0,1
13455722,13456169,447,0,1,0,2
13455753,13456149,396,0,1,0,1
13456169,13456998,829,0,0,1,1
13456283,13456998,715,0,0,1,2
13456999,13457065,66,1,0,0,2
13456999,13457068,69,1,0,0,1
13457066,13457187,121,0,0,1,2
13457069,13457185,116,0,0,1,1
13457186,13457219,33,1,0,0,1
13457188,13457202,14,1,0,0,2
13457203,13458304,1101,0,0,1,2
13457220,13457489,269,0,0,1,1
13457490,13457515,25,1,0,0,1
13457516,13458303,787,0,0,1,1
13458304,13458378,74,1,0,0,1
13458305,13458364,59,1,0,0,2
13458365,13458525,160,0,0,1,2
13458379,13458522,143,0,0,1,1
13458523,13458540,17,1,0,0,1
13458526,13458544,18,1,0,0,2
13458541,13459615,1074,0,0,1,1
13458545,13460431,1886,0,0,1,2
13459616,13459643,27,1,0,0,1
13459644,13460440,796,0,0,1,1
13460432,13461189,757,1,0,0,2
13460441,13460622,181,1,0,0,1
13460463,13460564,101,0,1,0,1
13460472,13460532,60,0,1,0,2
13460623,13460778,155,0,0,1,1
13460779,13461092,313,1,0,0,1
13460881,13461086,205,0,1,0,2
13460886,13461076,190,0,1,0,1
13461093,13461597,504,0,0,1,1
13461190,13461468,278,0,0,1,2
13461469,13461537,68,1,0,0,2
13461538,13461595,57,0,0,1,2
13461596,13461769,173,1,0,0,2
13461598,13461668,70,1,0,0,1
13461669,13461804,135,0,0,1,1
13461770,13461803,33,0,0,1,2
13461804,13461824,20,1,0,0,2
13461805,13461835,30,1,0,0,1
13461825,13462298,473,0,0,1,2
13461836,13462298,462,0,0,1,1
13462299,13462303,4,1,0,0,2
13462299,13462324,25,1,0,0,1
13462304,13462986,682,0,0,1,2
13462325,13462985,660,0,0,1,1
13462986,13463049,63,1,0,0,1
13462987,13463305,318,1,0,0,2
13463049,13463296,247,0,1,0,2
13463050,13463191,141,0,0,1,1
13463192,13463210,18,1,0,0,1
13463211,13465301,2090,0,0,1,1
13463306,13465311,2005,0,0,1,2
13465302,13465625,323,1,0,0,1
13465312,13465670,358,1,0,0,2
13465343,13465609,266,0,1,0,1
13465347,13465597,250,0,1,0,2
13465626,13466294,668,0,0,1,1
13465671,13466292,621,0,0,1,2
13466293,13466454,161,1,0,0,2
13466295,13466382,87,1,0,0,1
13466383,13466500,117,0,0,1,1
13466455,13466498,43,0,0,1,2
13466499,13466521,22,1,0,0,2
13466501,13466522,21,1,0,0,1
13466522,13467948,1426,0,0,1,2
13466523,13467949,1426,0,0,1,1
13467949,13468014,65,1,0,0,2
13467950,13468013,63,1,0,0,1
13468014,13468108,94,0,0,1,1
13468015,13468107,92,0,0,1,2
13468108,13468142,34,1,0,0,2
13468109,13468140,31,1,0,0,1
13468141,13470486,2345,0,0,1,1
13468143,13468509,366,0,0,1,2
13468510,13468520,10,1,0,0,2
13468521,13470481,1960,0,0,1,2
13470482,13470855,373,1,0,0,2
13470487,13470731,244,1,0,0,1
13470509,13470693,184,0,1,0,1
13470509,13470699,190,0,1,0,2
13470732,13471475,743,0,0,1,1
13470856,13471316,460,0,0,1,2
13471317,13471379,62,1,0,0,2
13471380,13471474,94,0,0,1,2
13471475,13471758,283,1,0,0,2
13471476,13471535,59,1,0,0,1
13471536,13471660,124,0,0,1,1
13471661,13471691,30,1,0,0,1
13471692,13472939,1247,0,0,1,1
13471759,13472938,1179,0,0,1,2
13472939,13473128,189,1,0,0,2
13472940,13473023,83,1,0,0,1
13473024,13473151,127,0,0,1,1
13473129,13473157,28,0,0,1,2
13473152,13473216,64,1,0,0,1
13473158,13473179,21,1,0,0,2
13473180,13474238,1058,0,0,1,2
13473217,13474684,1467,0,0,1,1
13474239,13474289,50,1,0,0,2
13474290,13474318,28,0,0,1,2
13474319,13474374,55,1,0,0,2
13474375,13474669,294,0,0,1,2
13474670,13475071,401,1,0,0,2
13474685,13474938,253,1,0,0,1
13474703,13474935,232,0,1,0,2
13474705,13474928,223,0,1,0,1
13474939,13475166,227,0,0,1,1
13475072,13475148,76,0,0,1,2
13475149,13475579,430,1,0,0,2
13475167,13475472,305,1,0,0,1
13475182,13475450,268,0,1,0,2
13475185,13475451,266,0,1,0,1
13475473,13476221,748,0,0,1,1
13475580,13476221,641,0,0,1,2
13476222,13476293,71,1,0,0,1
13476222,13476339,117,1,0,0,2
13476294,13476389,95,0,0,1,1
13476340,13476390,50,0,0,1,2
13476390,13476413,23,1,0,0,1
13476391,13476421,30,1,0,0,2
13476414,13477747,1333,0,0,1,1
13476422,13476609,187,0,0,1,2
13476610,13476615,5,1,0,0,2
13476616,13477102,486,0,0,1,2
13477103,13477169,66,1,0,0,2
13477170,13477196,26,0,0,1,2
13477197,13477281,84,1,0,0,2
13477282,13477394,112,0,0,1,2
13477395,13477510,115,1,0,0,2
13477511,13477657,146,0,0,1,2
13477658,13477662,4,1,0,0,2
13477663,13477748,85,0,0,1,2
13477748,13477806,58,1,0,0,1
13477749,13477807,58,1,0,0,2
13477807,13480141,2334,0,0,1,1
13477808,13480139,2331,0,0,1,2
13480140,13480713,573,1,0,0,2
13480142,13480639,497,1,0,0,1
13480164,13480646,482,0,1,0,2
13480165,13480628,463,0,1,0,1
13480640,13481220,580,0,0,1,1
13480714,13481220,506,0,0,1,2
13481221,13481306,85,1,0,0,1
13481221,13481345,124,1,0,0,2
13481307,13481407,100,0,0,1,1
13481346,13481406,60,0,0,1,2
13481407,13481437,30,1,0,0,2
13481408,13481429,21,1,0,0,1
13481430,13481688,258,0,0,1,1
13481438,13482905,1467,0,0,1,2
13481689,13481693,4,1,0,0,1
13481694,13482905,1211,0,0,1,1
13482906,13482964,58,1,0,0,1
13482906,13482969,63,1,0,0,2
13482965,13483102,137,0,0,1,1
13482970,13483103,133,0,0,1,2
13483103,13483126,23,1,0,0,1
13483104,13483127,23,1,0,0,2
13483127,13483573,446,0,0,1,1
13483128,13485096,1968,0,0,1,2
13483574,13483582,8,1,0,0,1
13483583,13485105,1522,0,0,1,1
13485097,13485915,818,1,0,0,2
13485106,13485513,407,1,0,0,1
13485139,13485502,363,0,1,0,1
13485139,13485510,371,0,1,0,2
13485514,13485594,80,0,0,1,1
13485595,13485849,254,1,0,0,1
13485618,13485811,193,0,1,0,2
13485621,13485797,176,0,1,0,1
13485850,13486641,791,0,0,1,1
13485916,13486641,725,0,0,1,2
13486642,13486752,110,1,0,0,1
13486642,13486892,250,1,0,0,2
13486717,13486795,78,0,1,0,2
13486753,13486818,65,0,0,1,1
13486819,13486865,46,1,0,0,1
13486828,13486846,18,0,1,0,2
13486866,13486925,59,0,0,1,1
13486868,13486875,7,0,1,0,2
13486893,13488964,2071,0,0,1,2
13486926,13486932,6,1,0,0,1
13486933,13486996,63,0,0,1,1
13486997,13487007,10,1,0,0,1
13487008,13488964,1956,0,0,1,1
13488965,13489026,61,1,0,0,2
13488965,13489036,71,1,0,0,1
13489027,13489128,101,0,0,1,2
13489037,13489128,91,0,0,1,1
13489129,13489157,28,1,0,0,2
13489129,13489161,32,1,0,0,1
13489158,13490483,1325,0,0,1,2
13489162,13491069,1907,0,0,1,1
13490484,13490488,4,1,0,0,2
13490489,13491065,576,0,0,1,2
13491066,13491587,521,1,0,0,2
13491070,13491542,472,1,0,0,1
13491094,13491577,483,0,1,0,2
13491095,13491525,430,0,1,0,1
13491543,13493042,1499,0,0,1,1
13491588,13493041,1453,0,0,1,2
13493042,13493138,96,1,0,0,2
13493043,13493124,81,1,0,0,1
13493125,13493263,138,0,0,1,1
13493139,13493258,119,0,0,1,2
13493259,13493288,29,1,0,0,2
13493264,13493290,26,1,0,0,1
13493289,13493527,238,0,0,1,2
13493291,13493527,236,0,0,1,1
13493528,13493532,4,1,0,0,2
13493528,13493541,13,1,0,0,1
13493533,13494751,1218,0,0,1,2
13493542,13494752,1210,0,0,1,1
13494752,13494801,49,1,0,0,2
13494753,13494801,48,1,0,0,1
13494802,13495867,1065,0,0,1,2
13494802,13495913,1111,0,0,1,1
13495868,13496222,354,1,0,0,2
13495914,13496182,268,1,0,0,1
13495931,13496173,242,0,1,0,2
13495933,13496154,221,0,1,0,1
13496183,13496854,671,0,0,1,1
13496223,13496292,69,0,0,1,2
13496293,13496304,11,1,0,0,2
13496305,13496537,232,0,0,1,2
13496538,13496550,12,1,0,0,2
13496551,13496847,296,0,0,1,2
13496848,13497422,574,1,0,0,2
13496855,13497101,246,1,0,0,1
13496884,13497048,164,0,1,0,1
13496886,13497058,172,0,1,0,2
13497102,13497126,24,0,0,1,1
13497127,13497368,241,1,0,0,1
13497147,13497318,171,0,1,0,2
13497149,13497303,154,0,1,0,1
13497369,13498584,1215,0,0,1,1
13497423,13498584,1161,0,0,1,2
13498585,13498640,55,1,0,0,1
13498585,13498651,66,1,0,0,2
13498641,13498781,140,0,0,1,1
13498652,13498780,128,0,0,1,2
13498781,13498800,19,1,0,0,2
13498782,13498799,17,1,0,0,1
13498800,13500019,1219,0,0,1,1
13498801,13500019,1218,0,0,1,2
13500020,13500069,49,1,0,0,1
13500020,13500072,52,1,0,0,2
13500070,13502084,2014,0,0,1,1
13500073,13502076,2003,0,0,1,2
13502077,13502378,301,1,0,0,2
13502085,13502358,273,1,0,0,1
13502122,13502292,170,0,1,0,1
13502123,13502307,184,0,1,0,2
13502359,13502406,47,0,0,1,1
13502379,13502413,34,0,0,1,2
13502407,13502629,222,1,0,0,1
13502414,13502670,256,1,0,0,2
13502439,13502591,152,0,1,0,2
13502441,13502578,137,0,1,0,1
13502630,13503454,824,0,0,1,1
13502671,13502787,116,0,0,1,2
13502788,13502797,9,1,0,0,2
13502798,13503455,657,0,0,1,2
13503455,13503531,76,1,0,0,1
13503456,13503535,79,1,0,0,2
13503532,13504813,1281,0,0,1,1
13503536,13503705,169,0,0,1,2
13503706,13503715,9,1,0,0,2
13503716,13504814,1098,0,0,1,2
13504814,13504878,64,1,0,0,1
13504815,13504877,62,1,0,0,2
13504878,13505056,178,0,0,1,2
13504879,13505065,186,0,0,1,1
13505057,13505075,18,1,0,0,2
13505066,13505078,12,1,0,0,1
13505076,13505250,174,0,0,1,2
13505079,13505254,175,0,0,1,1
13505251,13505511,260,1,0,0,2
13505255,13505480,225,1,0,0,1
13505279,13505441,162,0,1,0,2
13505280,13505430,150,0,1,0,1
13505481,13505663,182,0,0,1,1
13505512,13505661,149,0,0,1,2
13505662,13505672,10,1,0,0,2
13505664,13505676,12,1,0,0,1
13505673,13506864,1191,0,0,1,2
13505677,13506864,1187,0,0,1,1
13506865,13507108,243,1,0,0,1
13506865,13507160,295,1,0,0,2
13506897,13507070,173,0,1,0,1
13506898,13507084,186,0,1,0,2
13507109,13508434,1325,0,0,1,1
13507161,13508426,1265,0,0,1,2
13508427,13512786,4359,1,0,0,2
13508435,13508837,402,1,0,0,1
13508462,13508826,364,0,1,0,1
13508462,13509024,562,0,1,0,2
13508838,13508955,117,0,0,1,1
13508956,13508967,11,1,0,0,1
13508968,13510395,1427,0,0,1,1
13510396,13510444,48,1,0,0,1
13510445,13511608,1163,0,0,1,1
13511609,13511629,20,1,0,0,1
13511630,13511877,247,0,0,1,1
13511878,13512446,568,1,0,0,1
13511900,13512457,557,0,1,0,2
13511906,13512435,529,0,1,0,1
13512447,13512672,225,0,0,1,1
13512673,13512769,96,1,0,0,1
13512770,13512944,174,0,0,1,1
13512787,13512945,158,0,0,1,2
13512945,13512987,42,1,0,0,1
13512946,13512987,41,1,0,0,2
13512988,13513081,93,0,0,1,1
13512988,13513081,93,0,0,1,2
13513082,13513138,56,1,0,0,1
13513082,13513280,198,1,0,0,2
13513139,13513788,649,0,0,1,1
13513281,13513357,76,0,0,1,2
13513358,13513640,282,1,0,0,2
13513641,13513790,149,0,0,1,2
13513789,13513893,104,1,0,0,1
13513791,13513864,73,1,0,0,2
13513865,13514196,331,0,0,1,2
13513894,13514194,300,0,0,1,1
13514195,13514276,81,1,0,0,1
13514197,13514291,94,1,0,0,2
13514277,13514355,78,0,0,1,1
13514292,13514356,64,0,0,1,2
13514356,13514475,119,1,0,0,1
13514357,13514629,272,1,0,0,2
13514476,13514537,61,0,0,1,1
13514538,13514575,37,1,0,0,1
13514576,13514724,148,0,0,1,1
13514630,13514662,32,0,0,1,2
13514663,13514750,87,1,0,0,2
13514725,13514739,14,1,0,0,1
13514740,13516268,1528,0,0,1,1
13514751,13516268,1517,0,0,1,2
13516269,13516339,70,1,0,0,2
13516269,13516340,71,1,0,0,1
13516340,13518454,2114,0,0,1,2
13516341,13518453,2112,0,0,1,1
13518454,13519150,696,1,0,0,1
13518455,13519195,740,1,0,0,2
13518476,13519136,660,0,1,0,1
13518480,13519184,704,0,1,0,2
13519151,13519697,546,0,0,1,1
13519196,13519698,502,0,0,1,2
13519698,13519753,55,1,0,0,1
13519699,13519752,53,1,0,0,2
13519753,13520001,248,0,0,1,2
13519754,13520000,246,0,0,1,1
13520001,13520073,72,1,0,0,1
13520002,13520078,76,1,0,0,2
13520074,13520206,132,0,0,1,1
13520079,13520204,125,0,0,1,2
13520205,13520234,29,1,0,0,2
13520207,13520227,20,1,0,0,1
13520228,13521310,1082,0,0,1,1
13520235,13521310,1075,0,0,1,2
13521311,13521364,53,1,0,0,1
13521311,13521370,59,1,0,0,2
13521365,13521944,579,0,0,1,1
13521371,13521940,569,0,0,1,2
13521941,13521967,26,1,0,0,2
13521945,13521957,12,1,0,0,1
13521958,13523311,1353,0,0,1,1
13521968,13523311,1343,0,0,1,2
13523312,13523808,496,1,0,0,1
13523312,13523826,514,1,0,0,2
13523333,13523816,483,0,1,0,2
13523336,13523798,462,0,1,0,1
13523809,13523988,179,0,0,1,1
13523827,13523988,161,0,0,1,2
13523989,13524039,50,1,0,0,1
13523989,13524042,53,1,0,0,2
13524040,13524767,727,0,0,1,1
13524043,13524765,722,0,0,1,2
13524766,13524840,74,1,0,0,2
13524768,13524854,86,1,0,0,1
13524841,13524979,138,0,0,1,2
13524855,13524974,119,0,0,1,1
13524975,13525002,27,1,0,0,1
13524980,13524990,10,1,0,0,2
13524991,13527043,2052,0,0,1,2
13525003,13525262,259,0,0,1,1
13525263,13525280,17,1,0,0,1
13525281,13527044,1763,0,0,1,1
13527044,13527103,59,1,0,0,2
13527045,13527103,58,1,0,0,1
13527104,13527237,133,0,0,1,1
13527104,13527238,134,0,0,1,2
13527238,13527261,23,1,0,0,1
13527239,13527261,22,1,0,0,2
13527262,13527737,475,0,0,1,1
13527262,13529071,1809,0,0,1,2
13527738,13527753,15,1,0,0,1
13527754,13529083,1329,0,0,1,1
13529072,13529847,775,1,0,0,2
13529084,13529711,627,1,0,0,1
13529104,13529736,632,0,1,0,2
13529105,13529700,595,0,1,0,1
13529712,13531089,1377,0,0,1,1
13529848,13531089,1241,0,0,1,2
13531090,13531159,69,1,0,0,1
13531090,13531161,71,1,0,0,2
13531160,13531297,137,0,0,1,1
13531162,13531293,131,0,0,1,2
13531294,13531311,17,1,0,0,2
13531298,13531311,13,1,0,0,1
13531312,13532820,1508,0,0,1,2
13531312,13532821,1509,0,0,1,1
13532821,13532885,64,1,0,0,2
13532822,13532885,63,1,0,0,1
13532886,13533046,160,0,0,1,1
13532886,13534883,1997,0,0,1,2
13533047,13533062,15,1,0,0,1
13533063,13534898,1835,0,0,1,1
13534884,13535424,540,1,0,0,2
13534899,13535300,401,1,0,0,1
13534918,13535328,410,0,1,0,2
13534924,13535288,364,0,1,0,1
13535301,13536644,1343,0,0,1,1
13535425,13536643,1218,0,0,1,2
13536644,13536907,263,1,0,0,2
13536645,13536736,91,1,0,0,1
13536737,13536878,141,0,0,1,1
13536879,13536911,32,1,0,0,1
13536908,13537136,228,0,0,1,2
13536912,13537131,219,0,0,1,1
13537132,13537145,13,1,0,0,1
13537137,13537157,20,1,0,0,2
13537146,13537999,853,0,0,1,1
13537158,13537998,840,0,0,1,2
13537999,13538342,343,1,0,0,2
13538000,13538056,56,1,0,0,1
13538057,13538237,180,0,0,1,1
13538238,13538249,11,1,0,0,1
13538250,13540034,1784,0,0,1,1
13538343,13540028,1685,0,0,1,2
13540029,13540683,654,1,0,0,2
13540035,13540544,509,1,0,0,1
13540057,13540519,462,0,1,0,1
13540058,13540579,521,0,1,0,2
13540545,13541297,752,0,0,1,1
13540684,13541297,613,0,0,1,2
13541298,13541339,41,1,0,0,2
13541298,13541342,44,1,0,0,1
13541340,13541508,168,0,0,1,2
13541343,13541505,162,0,0,1,1
13541506,13541529,23,1,0,0,1
13541509,13541520,11,1,0,0,2
13541521,13542792,1271,0,0,1,2
13541530,13542792,1262,0,0,1,1
13542793,13542855,62,1,0,0,1
13542793,13543080,287,1,0,0,2
13542856,13543036,180,0,0,1,1
13543037,13543059,22,1,0,0,1
13543060,13543470,410,0,0,1,1
13543081,13543471,390,0,0,1,2
13543471,13543484,13,1,0,0,1
13543472,13543483,11,1,0,0,2
13543484,13544827,1343,0,0,1,2
13543485,13543687,202,0,0,1,1
13543688,13543704,16,1,0,0,1
13543705,13544829,1124,0,0,1,1
13544828,13545924,1096,1,0,0,2
13544830,13545750,920,1,0,0,1
13544854,13545705,851,0,1,0,2
13544857,13545683,826,0,1,0,1
13545751,13546215,464,0,0,1,1
13545925,13546213,288,0,0,1,2
13546214,13546279,65,1,0,0,2
13546216,13546285,69,1,0,0,1
13546280,13546412,132,0,0,1,2
13546286,13546421,135,0,0,1,1
13546413,13546448,35,1,0,0,2
13546422,13546449,27,1,0,0,1
13546449,13546538,89,0,0,1,2
13546450,13546548,98,0,0,1,1
13546539,13546918,379,1,0,0,2
13546549,13546867,318,1,0,0,1
13546566,13546901,335,0,1,0,2
13546571,13546845,274,0,1,0,1
13546868,13546959,91,0,0,1,1
13546919,13546959,40,0,0,1,2
13546960,13546984,24,1,0,0,1
13546960,13547011,51,1,0,0,2
13546985,13547300,315,0,0,1,1
13547012,13547300,288,0,0,1,2
13547301,13547327,26,1,0,0,2
13547301,13547329,28,1,0,0,1
13547328,13547556,228,0,0,1,2
13547330,13547564,234,0,0,1,1
13547557,13547890,333,1,0,0,2
13547565,13547823,258,1,0,0,1
13547589,13547808,219,0,1,0,2
13547590,13547789,199,0,1,0,1
13547824,13547946,122,0,0,1,1
13547891,13547946,55,0,0,1,2
13594703,13594970,267,0,0,1,1
13594705,13594736,31,0,0,1,2
13594737,13594889,152,1,0,0,2
13594890,13594972,82,0,0,1,2
13594971,13595282,311,1,0,0,1
13594973,13595749,776,1,0,0,2
13595031,13595739,708,0,1,0,2
13595039,13595273,234,0,1,0,1
13595283,13597139,1856,0,0,1,1
13595750,13596205,455,0,0,1,2
13596206,13596215,9,1,0,0,2
13596216,13597140,924,0,0,1,2
13597140,13597157,17,1,0,0,1
13597141,13597164,23,1,0,0,2
13597158,13597988,830,0,0,1,1
13597165,13597982,817,0,0,1,2
13597983,13598004,21,1,0,0,2
13597989,13597994,5,1,0,0,1
13597995,13598778,783,0,0,1,1
13598005,13599203,1198,0,0,1,2
13598779,13598783,4,1,0,0,1
13598784,13598954,170,0,0,1,1
13598955,13598968,13,1,0,0,1
13598969,13599193,224,0,0,1,1
13599194,13599223,29,1,0,0,1
13599204,13599864,660,1,0,0,2
13599223,13599331,108,0,1,0,2
13599224,13599245,21,0,0,1,1
13599246,13599702,456,1,0,0,1
13599290,13599318,28,0,1,0,1
13599395,13599730,335,0,1,0,2
13599405,13599675,270,0,1,0,1
13599703,13599754,51,0,0,1,1
13599755,13599759,4,1,0,0,1
13599760,13601152,1392,0,0,1,1
13599865,13601154,1289,0,0,1,2
13601153,13601239,86,1,0,0,1
13601155,13601260,105,1,0,0,2
13601240,13601316,76,0,0,1,1
13601261,13601318,57,0,0,1,2
13601317,13601350,33,1,0,0,1
13601319,13601362,43,1,0,0,2
13601351,13602996,1645,0,0,1,1
13601363,13602997,1634,0,0,1,2
13602997,13603082,85,1,0,0,1
13602998,13603075,77,1,0,0,2
13603076,13603170,94,0,0,1,2
13603083,13603169,86,0,0,1,1
13603170,13603202,32,1,0,0,1
13603171,13603192,21,1,0,0,2
13603193,13603571,378,0,0,1,2
13603203,13603574,371,0,0,1,1
13603572,13604115,543,1,0,0,2
13603575,13604133,558,1,0,0,1
13603614,13603768,154,0,1,0,2
13603616,13603753,137,0,1,0,1
13603856,13604076,220,0,1,0,2
13603865,13604054,189,0,1,0,1
13604116,13604711,595,0,0,1,2
13604134,13604712,578,0,0,1,1
13604712,13605480,768,1,0,0,2
13604713,13605178,465,1,0,0,1
13604773,13605469,696,0,1,0,2
13604780,13605169,389,0,1,0,1
13605179,13606364,1185,0,0,1,1
13605481,13606363,882,0,0,1,2
13606364,13606663,299,1,0,0,2
13606365,13606465,100,1,0,0,1
13606395,13606451,56,0,1,0,2
13606466,13606570,104,0,0,1,1
13606571,13606597,26,1,0,0,1
13606598,13607111,513,0,0,1,1
13606664,13607108,444,0,0,1,2
13607109,13607133,24,1,0,0,2
13607112,13607133,21,1,0,0,1
13607134,13607658,524,0,0,1,1
13607134,13607660,526,0,0,1,2
13607659,13607683,24,1,0,0,1
13607661,13607684,23,1,0,0,2
13607684,13608108,424,0,0,1,1
13607685,13608109,424,0,0,1,2
13608109,13608181,72,1,0,0,1
13608110,13608184,74,1,0,0,2
13608182,13608308,126,0,0,1,1
13608185,13608304,119,0,0,1,2
13608305,13608321,16,1,0,0,2
13608309,13608315,6,1,0,0,1
13608316,13608595,279,0,0,1,1
13608322,13608589,267,0,0,1,2
13608590,13609226,636,1,0,0,2
13608596,13608880,284,1,0,0,1
13608626,13608870,244,0,1,0,2
13608629,13608842,213,0,1,0,1
13608881,13608919,38,0,0,1,1
13608920,13609206,286,1,0,0,1
13608940,13609215,275,0,1,0,2
13608951,13609187,236,0,1,0,1
13609207,13609227,20,0,0,1,1
13609227,13609309,82,0,0,1,2
13609228,13609234,6,1,0,0,1
13609235,13609815,580,0,0,1,1
13609310,13609396,86,1,0,0,2
13609397,13609814,417,0,0,1,2
13609815,13610052,237,1,0,0,2
13609816,13609912,96,1,0,0,1
13609913,13609999,86,0,0,1,1
13610000,13610044,44,1,0,0,1
13610045,13610256,211,0,0,1,1
13610053,13610265,212,0,0,1,2
13610257,13610282,25,1,0,0,1
13610266,13610270,4,1,0,0,2
13610271,13611663,1392,0,0,1,2
13610283,13611663,1380,0,0,1,1
13611664,13611710,46,1,0,0,2
13611664,13611712,48,1,0,0,1
13611711,13611848,137,0,0,1,2
13611713,13611858,145,0,0,1,1
13611849,13611871,22,1,0,0,2
13611859,13611883,24,1,0,0,1
13611872,13613484,1612,0,0,1,2
13611884,13612788,904,0,0,1,1
13612789,13612802,13,1,0,0,1
13612803,13613485,682,0,0,1,1
13613485,13613617,132,1,0,0,2
13613486,13613616,130,1,0,0,1
13613617,13613679,62,0,0,1,1
13613618,13613679,61,0,0,1,2
13613680,13613726,46,1,0,0,2
13613680,13613742,62,1,0,0,1
13613727,13613880,153,0,0,1,2
13613743,13613878,135,0,0,1,1
13613879,13613909,30,1,0,0,1
13613881,13613907,26,1,0,0,2
13613908,13614566,658,0,0,1,2
13613910,13614571,661,0,0,1,1
13614567,13614839,272,1,0,0,2
13614572,13614825,253,1,0,0,1
13614604,13614792,188,0,1,0,2
13614611,13614771,160,0,1,0,1
13614826,13615326,500,0,0,1,1
13614840,13615326,486,0,0,1,2
13615327,13615422,95,1,0,0,1
13615327,13615487,160,1,0,0,2
13615423,13615510,87,0,0,1,1
13615488,13615509,21,0,0,1,2
13615510,13615602,92,1,0,0,2
13615511,13615545,34,1,0,0,1
13615546,13615731,185,0,0,1,1
13615603,13615734,131,0,0,1,2
13615732,13615757,25,1,0,0,1
13615735,13615746,11,1,0,0,2
13615747,13617047,1300,0,0,1,2
13615758,13616215,457,0,0,1,1
13616216,13616225,9,1,0,0,1
13616226,13617047,821,0,0,1,1
13617048,13617133,85,1,0,0,1
13617048,13617136,88,1,0,0,2
13617134,13617264,130,0,0,1,1
13617137,13617265,128,0,0,1,2
13617265,13617282,17,1,0,0,1
13617266,13617284,18,1,0,0,2
13617283,13617565,282,0,0,1,1
13617285,13617544,259,0,0,1,2
13617545,13618018,473,1,0,0,2
13617566,13617944,378,1,0,0,1
13617600,13617663,63,0,1,0,1
13617600,13617684,84,0,1,0,2
13617745,13617953,208,0,1,0,2
13617751,13617930,179,0,1,0,1
13617945,13618750,805,0,0,1,1
13618019,13618142,123,0,0,1,2
13618143,13618203,60,1,0,0,2
13618204,13618750,546,0,0,1,2
13618751,13618821,70,1,0,0,1
13618751,13619296,545,1,0,0,2
13618822,13618937,115,0,0,1,1
13618938,13618966,28,1,0,0,1
13618967,13619153,186,0,0,1,1
13619154,13619164,10,1,0,0,1
13619165,13620426,1261,0,0,1,1
13619297,13620424,1127,0,0,1,2
13620425,13620485,60,1,0,0,2
13620427,13620482,55,1,0,0,1
13620483,13620657,174,0,0,1,1
13620486,13620655,169,0,0,1,2
13620656,13620668,12,1,0,0,2
13620658,13620670,12,1,0,0,1
13620669,13621527,858,0,0,1,2
13620671,13621553,882,0,0,1,1
13621528,13622415,887,1,0,0,2
13621554,13622319,765,1,0,0,1
13621574,13622235,661,0,1,0,1
13621574,13622317,743,0,1,0,2
13622320,13622455,135,0,0,1,1
13622416,13622453,37,0,0,1,2
13622454,13622478,24,1,0,0,2
13622456,13622483,27,1,0,0,1
13622479,13623871,1392,0,0,1,2
13622484,13623871,1387,0,0,1,1
13623872,13623967,95,1,0,0,1
13623872,13624237,365,1,0,0,2
13623968,13624034,66,0,0,1,1
13624035,13624078,43,1,0,0,1
13624079,13624177,98,0,0,1,1
13624178,13624195,17,1,0,0,1
13624196,13624970,774,0,0,1,1
13624238,13624484,246,0,0,1,2
13624485,13624500,15,1,0,0,2
13624501,13624968,467,0,0,1,2
13624969,13625802,833,1,0,0,2
13624971,13625318,347,1,0,0,1
13625003,13625376,373,0,1,0,2
13625009,13625305,296,0,1,0,1
13625319,13625651,332,0,0,1,1
13625652,13625770,118,1,0,0,1
13625771,13625861,90,0,0,1,1
13625803,13625861,58,0,0,1,2
13625862,13625921,59,1,0,0,2
13625862,13625922,60,1,0,0,1
13625922,13626079,157,0,0,1,2
13625923,13626074,151,0,0,1,1
13626075,13626091,16,1,0,0,1
13626080,13626092,12,1,0,0,2
13626092,13627348,1256,0,0,1,1
13626093,13627338,1245,0,0,1,2
13627339,13627653,314,1,0,0,2
13627349,13627663,314,1,0,0,1
13627442,13627644,202,0,1,0,2
13627654,13627707,53,0,0,1,2
13627664,13628599,935,0,0,1,1
13627708,13627871,163,1,0,0,2
13627872,13628600,728,0,0,1,2
13628600,13628685,85,1,0,0,1
13628601,13628681,80,1,0,0,2
13628682,13629073,391,0,0,1,2
13628686,13629089,403,0,0,1,1
13629074,13629331,257,1,0,0,2
13629090,13629338,248,1,0,0,1
13629112,13629290,178,0,1,0,1
13629112,13629306,194,0,1,0,2
13629332,13629381,49,0,0,1,2
13629339,13629398,59,0,0,1,1
13629382,13629432,50,1,0,0,2
13629399,13629423,24,1,0,0,1
13629424,13630970,1546,0,0,1,1
13629433,13630969,1536,0,0,1,2
13630970,13631088,118,1,0,0,2
13630971,13631064,93,1,0,0,1
13631065,13631152,87,0,0,1,1
13631089,13631152,63,0,0,1,2
13631153,13631179,26,1,0,0,2
13631153,13631193,40,1,0,0,1
13631180,13632941,1761,0,0,1,2
13631194,13631355,161,0,0,1,1
13631356,13631378,22,1,0,0,1
13631379,13631721,342,0,0,1,1
13631722,13631741,19,1,0,0,1
13631742,13632940,1198,0,0,1,1
13632941,13633024,83,1,0,0,1
13632942,13633017,75,1,0,0,2
13633018,13633141,123,0,0,1,2
13633025,13633137,112,0,0,1,1
13633138,13633169,31,1,0,0,1
13633142,13633170,28,1,0,0,2
13633170,13634818,1648,0,0,1,1
13633171,13634818,1647,0,0,1,2
13634819,13635118,299,1,0,0,1
13634819,13635239,420,1,0,0,2
13634907,13635089,182,0,1,0,2
13634910,13635084,174,0,1,0,1
13635119,13635218,99,0,0,1,1
13635219,13635237,18,1,0,0,1
13635238,13636294,1056,0,0,1,1
13635240,13635409,169,0,0,1,2
13635410,13635423,13,1,0,0,2
13635424,13636273,849,0,0,1,2
13636274,13636520,246,1,0,0,2
13636295,13636464,169,1,0,0,1
13636326,13636416,90,0,1,0,1
13636326,13636421,95,0,1,0,2
13636465,13636849,384,0,0,1,1
13636521,13636850,329,0,0,1,2
13636850,13637321,471,1,0,0,1
13636851,13638109,1258,1,0,0,2
13636938,13636948,10,0,1,0,2
13636946,13637311,365,0,1,0,1
13636976,13637000,24,0,1,0,2
13637249,13638099,850,0,1,0,2
13637322,13637448,126,0,0,1,1
13637459,13637462,3,0,1,0,1
13637472,13637522,50,1,0,0,1
13637484,13637513,29,0,1,0,1
13637523,13638720,1197,0,0,1,1
13638110,13638218,108,0,0,1,2
13638219,13638224,5,1,0,0,2
13638225,13638719,494,0,0,1,2
13638720,13639093,373,1,0,0,2
13638721,13639072,351,1,0,0,1
13638739,13639034,295,0,1,0,2
13638748,13639018,270,0,1,0,1
13639073,13639129,56,0,0,1,1
13639094,13639123,29,0,0,1,2
13639124,13639161,37,1,0,0,2
13639130,13639143,13,1,0,0,1
13639144,13640755,1611,0,0,1,1
13639162,13640755,1593,0,0,1,2
13640756,13641254,498,1,0,0,1
13640756,13642357,1601,1,0,0,2
13640793,13642346,1553,0,1,0,2
13640818,13641236,418,0,1,0,1
13641255,13642605,1350,0,0,1,1
13642358,13642576,218,0,0,1,2
13642587,13642984,397,0,1,0,2
13642606,13643091,485,1,0,0,1
13642648,13643080,432,0,1,0,1
13642994,13643274,280,1,0,0,2
13643092,13644476,1384,0,0,1,1
13643275,13643454,179,0,0,1,2
13643455,13643920,465,1,0,0,2
13643921,13643979,58,0,0,1,2
13643980,13645354,1374,1,0,0,2
13644477,13645047,570,1,0,0,1
13644494,13644519,25,0,1,0,1
13644516,13645074,558,0,1,0,2
13644541,13645036,495,0,1,0,1
13645048,13646262,1214,0,0,1,1
13645355,13646262,907,0,0,1,2
13646263,13646338,75,1,0,0,1
13646263,13646406,143,1,0,0,2
13646339,13646451,112,0,0,1,1
13646407,13646451,44,0,0,1,2
13646452,13646473,21,1,0,0,1
13646452,13646484,32,1,0,0,2
13646474,13647277,803,0,0,1,1
13646485,13646807,322,0,0,1,2
13646808,13646907,99,1,0,0,2
13646908,13647001,93,0,0,1,2
13647002,13647110,108,1,0,0,2
13647111,13647148,37,0,0,1,2
13647149,13647164,15,1,0,0,2
13647165,13647280,115,0,0,1,2
13647278,13647294,16,1,0,0,1
13647281,13647301,20,1,0,0,2
13647295,13648015,720,0,0,1,1
13647302,13647485,183,0,0,1,2
13647486,13647527,41,1,0,0,2
13647528,13647619,91,0,0,1,2
13647620,13647726,106,1,0,0,2
13647727,13647776,49,0,0,1,2
13647777,13647867,90,1,0,0,2
13647868,13648014,146,0,0,1,2
13648015,13649618,1603,1,0,0,2
13648016,13648487,471,1,0,0,1
13648062,13649270,1208,0,1,0,2
13648081,13648476,395,0,1,0,1
13648488,13649301,813,0,0,1,1
13649311,13649312,1,0,1,0,2
13649312,13649312,0,0,1,0,1
13649321,13649321,0,1,0,0,1
13649322,13649915,593,0,0,1,1
13649335,13649337,2,0,1,0,2
13649371,13649608,237,0,1,0,2
13649619,13649649,30,0,0,1,2
13649660,13649730,70,0,1,0,2
13649739,13649739,0,1,0,0,2
13649740,13649784,44,0,0,1,2
13649795,13649821,26,0,1,0,2
13649830,13649830,0,1,0,0,2
13649831,13649877,46,0,0,1,2
13649888,13649970,82,0,1,0,2
13649916,13650026,110,1,0,0,1
13649980,13650022,42,1,0,0,2
13650023,13650111,88,0,0,1,2
13650027,13650111,84,0,0,1,1
13650112,13650161,49,1,0,0,1
13650112,13650170,58,1,0,0,2
13650162,13650344,182,0,0,1,1
13650171,13650341,170,0,0,1,2
13650342,13650368,26,1,0,0,2
13650345,13650359,14,1,0,0,1
13650360,13651771,1411,0,0,1,1
13650369,13650778,409,0,0,1,2
13650779,13650795,16,1,0,0,2
13650796,13651770,974,0,0,1,2
13651771,13652619,848,1,0,0,2
13651772,13652019,247,1,0,0,1
13651800,13651999,199,0,1,0,2
13651802,13651996,194,0,1,0,1
13652020,13652080,60,0,0,1,1
13652081,13652111,30,1,0,0,1
13652112,13652377,265,0,0,1,1
13652378,13652395,17,1,0,0,1
13652396,13653697,1301,0,0,1,1
13652620,13653692,1072,0,0,1,2
13653693,13653810,117,1,0,0,2
13653698,13653818,120,1,0,0,1
13653811,13653908,97,0,0,1,2
13653819,13653906,87,0,0,1,1
13653907,13653949,42,1,0,0,1
13653909,13653950,41,1,0,0,2
13653950,13654215,265,0,0,1,1
13653951,13655602,1651,0,0,1,2
13654216,13654227,11,1,0,0,1
13654228,13655597,1369,0,0,1,1
13655598,13656057,459,1,0,0,1
13655603,13656060,457,1,0,0,2
13655639,13656049,410,0,1,0,2
13655641,13656005,364,0,1,0,1
13656058,13656492,434,0,0,1,1
13656061,13656285,224,0,0,1,2
13656286,13656300,14,1,0,0,2
13656301,13656965,664,0,0,1,2
13656493,13656497,4,1,0,0,1
13656498,13656964,466,0,0,1,1
13656965,13656975,10,1,0,0,1
13656966,13656977,11,1,0,0,2
13656976,13657646,670,0,0,1,1
13656978,13657651,673,0,0,1,2
13657647,13657918,271,1,0,0,1
13657652,13657859,207,1,0,0,2
13657672,13657674,2,0,1,0,2
13657703,13657750,47,0,1,0,1
13657716,13657834,118,0,1,0,2
13657860,13658036,176,0,0,1,2
13657919,13659506,1587,0,0,1,1
13658037,13658086,49,1,0,0,2
13658087,13659499,1412,0,0,1,2
13659500,13661737,2237,1,0,0,2
13659507,13661295,1788,1,0,0,1
13659534,13661578,2044,0,1,0,2
13659542,13661284,1742,0,1,0,1
13661296,13661432,136,0,0,1,1
13661433,13661633,200,1,0,0,1
13661445,13661508,63,0,1,0,1
13661634,13661667,33,0,0,1,1
13661668,13661736,68,1,0,0,1
13661737,13661864,127,0,0,1,1
13661738,13661868,130,0,0,1,2
13661865,13661893,28,1,0,0,1
13661869,13661883,14,1,0,0,2
13661884,13662317,433,0,0,1,2
13661894,13663141,1247,0,0,1,1
13662318,13663244,926,1,0,0,2
13663142,13663242,100,1,0,0,1
13663243,13663452,209,0,0,1,1
13663245,13663452,207,0,0,1,2
13663453,13664235,782,1,0,0,1
13663453,13664629,1176,1,0,0,2
13663516,13664311,795,0,1,0,2
13663524,13664225,701,0,1,0,1
13664236,13664855,619,0,0,1,1
13664342,13664386,44,0,1,0,2
13664630,13664832,202,0,0,1,2
13664833,13667443,2610,1,0,0,2
13664856,13665182,326,1,0,0,1
13664865,13665238,373,0,1,0,2
13664889,13665149,260,0,1,0,1
13665172,13665173,1,0,1,0,1
13665183,13665401,218,0,0,1,1
13665402,13665474,72,1,0,0,1
13665475,13665577,102,0,0,1,1
13665578,13665617,39,1,0,0,1
13665618,13666040,422,0,0,1,1
13666041,13666063,22,1,0,0,1
13666064,13667331,1267,0,0,1,1
13667332,13667425,93,1,0,0,1
13667426,13667584,158,0,0,1,1
13667444,13667583,139,0,0,1,2
13667584,13667603,19,1,0,0,2
13667585,13667612,27,1,0,0,1
13667604,13669139,1535,0,0,1,2
13667613,13669139,1526,0,0,1,1
13669140,13669192,52,1,0,0,2
13669140,13669203,63,1,0,0,1
13669193,13669306,113,0,0,1,2
13669204,13669306,102,0,0,1,1
13669307,13669343,36,1,0,0,1
13669307,13669967,660,1,0,0,2
13669344,13669437,93,0,0,1,1
13669438,13669663,225,1,0,0,1
13669456,13669629,173,0,1,0,2
13669459,13669615,156,0,1,0,1
13669664,13671034,1370,0,0,1,1
13669968,13670589,621,0,0,1,2
13670590,13670599,9,1,0,0,2
13670600,13671035,435,0,0,1,2
13671035,13671098,63,1,0,0,1
13671036,13671102,66,1,0,0,2
13671099,13671237,138,0,0,1,1
13671103,13671232,129,0,0,1,2
13671233,13671254,21,1,0,0,2
13671238,13671247,9,1,0,0,1
13671248,13671503,255,0,0,1,1
13671255,13671508,253,0,0,1,2
13671504,13671515,11,1,0,0,1
13671509,13671513,4,1,0,0,2
13671514,13672902,1388,0,0,1,2
13671516,13672914,1398,0,0,1,1
13672903,13673178,275,1,0,0,2
13672915,13673155,240,1,0,0,1
13672946,13673127,181,0,1,0,2
13672950,13673119,169,0,1,0,1
13673156,13673244,88,0,0,1,1
13673179,13673245,66,0,0,1,2
13673245,13673289,44,1,0,0,1
13673246,13673295,49,1,0,0,2
13673290,13673437,147,0,0,1,1
13673296,13673431,135,0,0,1,2
13673432,13673452,20,1,0,0,2
13673438,13673451,13,1,0,0,1
13673452,13674369,917,0,0,1,1
13673453,13673769,316,0,0,1,2
13673770,13673779,9,1,0,0,2
13673780,13674365,585,0,0,1,2
13674366,13674565,199,1,0,0,2
13674370,13674563,193,1,0,0,1
13674407,13674504,97,0,1,0,2
13674410,13674495,85,0,1,0,1
13674564,13674609,45,0,0,1,1
13674566,13674868,302,0,0,1,2
13674610,13674614,4,1,0,0,1
13674615,13674874,259,0,0,1,1
13674869,13679003,4134,1,0,0,2
13674875,13675089,214,1,0,0,1
13674899,13675065,166,0,1,0,2
13674902,13675051,149,0,1,0,1
13675090,13675213,123,0,0,1,1
13675214,13675245,31,1,0,0,1
13675246,13675589,343,0,0,1,1
13675590,13675614,24,1,0,0,1
13675615,13676737,1122,0,0,1,1
13676738,13677218,480,1,0,0,1
13676767,13677207,440,0,1,0,1
13676768,13677860,1092,0,1,0,2
13677219,13677319,100,0,0,1,1
13677320,13677374,54,1,0,0,1
13677375,13678865,1490,0,0,1,1
13678866,13679022,156,1,0,0,1
13678883,13678943,60,0,1,0,2
13678902,13678938,36,0,1,0,1
13679004,13679129,125,0,0,1,2
13679023,13679129,106,0,0,1,1
13679130,13679166,36,1,0,0,2
13679130,13679218,88,1,0,0,1
13679167,13679361,194,0,0,1,2
13679219,13679358,139,0,0,1,1
13679359,13679384,25,1,0,0,1
13679362,13679369,7,1,0,0,2
13679370,13679954,584,0,0,1,2
13679385,13679755,370,0,0,1,1
13679756,13679771,15,1,0,0,1
13679772,13679954,182,0,0,1,1
13679955,13680177,222,1,0,0,1
13679955,13680195,240,1,0,0,2
13679984,13680136,152,0,1,0,2
13679987,13680131,144,0,1,0,1
13680178,13680757,579,0,0,1,1
13680196,13680757,561,0,0,1,2
13680758,13680877,119,1,0,0,1
13680758,13680906,148,1,0,0,2
13680864,13680868,4,0,1,0,1
13680878,13680985,107,0,0,1,1
13680907,13680985,78,0,0,1,2
13680986,13681014,28,1,0,0,2
13680986,13681034,48,1,0,0,1
13681015,13681287,272,0,0,1,2
13681035,13681301,266,0,0,1,1
13681288,13681333,45,1,0,0,2
13681302,13681390,88,1,0,0,1
13681334,13681905,571,0,0,1,2
13681391,13681418,27,0,0,1,1
13681419,13681437,18,1,0,0,1
13681438,13681894,456,0,0,1,1
13681895,13682418,523,1,0,0,1
13681906,13682423,517,1,0,0,2
13681961,13681962,1,0,1,0,2
13681970,13682082,112,0,1,0,1
13681992,13682004,12,0,1,0,2
13682041,13682066,25,0,1,0,2
13682123,13682362,239,0,1,0,1
13682123,13682398,275,0,1,0,2
13682419,13682568,149,0,0,1,1
13682424,13682540,116,0,0,1,2
13682541,13682643,102,1,0,0,2
13682569,13682637,68,1,0,0,1
13682638,13682736,98,0,0,1,1
13682644,13682738,94,0,0,1,2
13682737,13682767,30,1,0,0,1
13682739,13682790,51,1,0,0,2
13682768,13684357,1589,0,0,1,1
13682791,13682817,26,0,0,1,2
13682818,13683112,294,1,0,0,2
13683113,13684359,1246,0,0,1,2
13684358,13684482,124,1,0,0,1
13684360,13684461,101,1,0,0,2
13684462,13684562,100,0,0,1,2
13684483,13684561,78,0,0,1,1
13684562,13684601,39,1,0,0,1
13684563,13684592,29,1,0,0,2
13684593,13685227,634,0,0,1,2
13684602,13685222,620,0,0,1,1
13685223,13685446,223,1,0,0,1
13685228,13685453,225,1,0,0,2
13685265,13685402,137,0,1,0,2
13685266,13685394,128,0,1,0,1
13685447,13686181,734,0,0,1,1
13685454,13686182,728,0,0,1,2
13686182,13686352,170,1,0,0,1
13686183,13687108,925,1,0,0,2
13686257,13686379,122,0,1,0,2
13686288,13686332,44,0,1,0,1
13686353,13686403,50,0,0,1,1
13686404,13686429,25,1,0,0,1
13686430,13686497,67,0,0,1,1
13686498,13686519,21,1,0,0,1
13686520,13686577,57,0,0,1,1
13686578,13686586,8,1,0,0,1
13686587,13688114,1527,0,0,1,1
13687109,13688056,947,0,0,1,2
13688057,13688773,716,1,0,0,2
13688115,13688208,93,1,0,0,1
13688132,13688139,7,0,1,0,1
13688133,13688160,27,0,1,0,2
13688166,13688170,4,0,1,0,1
13688209,13688309,100,0,0,1,1
13688310,13688335,25,1,0,0,1
13688336,13688462,126,0,0,1,1
13688463,13688703,240,1,0,0,1
13688478,13688705,227,0,1,0,2
13688481,13688677,196,0,1,0,1
13688704,13689347,643,0,0,1,1
13688774,13688852,78,0,0,1,2
13688853,13688857,4,1,0,0,2
13688858,13688906,48,0,0,1,2
13688907,13688912,5,1,0,0,2
13688913,13689570,657,0,0,1,2
13689348,13689361,13,1,0,0,1
13689362,13689579,217,0,0,1,1
13689571,13689901,330,1,0,0,2
13689580,13689815,235,1,0,0,1
13689595,13689820,225,0,1,0,2
13689597,13689786,189,0,1,0,1
13689816,13691398,1582,0,0,1,1
13689902,13691397,1495,0,0,1,2
13691398,13691475,77,1,0,0,2
13691399,13691472,73,1,0,0,1
13691473,13694582,3109,0,0,1,1
13691476,13694579,3103,0,0,1,2
13694580,13695439,859,1,0,0,2
13694583,13694865,282,1,0,0,1
13694613,13694835,222,0,1,0,1
13694614,13694871,257,0,1,0,2
13694866,13695073,207,0,0,1,1
13695074,13695342,268,1,0,0,1
13695097,13695347,250,0,1,0,2
13695099,13695311,212,0,1,0,1
13695343,13695528,185,0,0,1,1
13695440,13695480,40,0,0,1,2
13695481,13695621,140,1,0,0,2
13695529,13695614,85,1,0,0,1
13695615,13695708,93,0,0,1,1
13695622,13695709,87,0,0,1,2
13695709,13695746,37,1,0,0,1
13695710,13695745,35,1,0,0,2
13695746,13697148,1402,0,0,1,2
13695747,13697148,1401,0,0,1,1
13697149,13697207,58,1,0,0,2
13697149,13697208,59,1,0,0,1
13697208,13699243,2035,0,0,1,2
13697209,13699252,2043,0,0,1,1
13699244,13699871,627,1,0,0,2
13699253,13699792,539,1,0,0,1
13699274,13699770,496,0,1,0,1
13699274,13699832,558,0,1,0,2
13699793,13700659,866,0,0,1,1
13699872,13699917,45,0,0,1,2
13699918,13699970,52,1,0,0,2
13699971,13700658,687,0,0,1,2
13700659,13700686,27,1,0,0,2
13700660,13700684,24,1,0,0,1
13700685,13700930,245,0,0,1,1
13700687,13700930,243,0,0,1,2
13700931,13700956,25,1,0,0,1
13700931,13700956,25,1,0,0,2
13700957,13701114,157,0,0,1,1
13700957,13701118,161,0,0,1,2
13701115,13701130,15,1,0,0,1
13701119,13701130,11,1,0,0,2
13701131,13701429,298,0,0,1,2
13701131,13702551,1420,0,0,1,1
13701430,13701514,84,1,0,0,2
13701515,13701744,229,0,0,1,2
13701745,13701762,17,1,0,0,2
13701763,13701874,111,0,0,1,2
13701875,13701889,14,1,0,0,2
13701890,13702479,589,0,0,1,2
13702480,13702497,17,1,0,0,2
13702498,13702552,54,0,0,1,2
13702552,13702627,75,1,0,0,1
13702553,13702625,72,1,0,0,2
13702626,13702736,110,0,0,1,2
13702628,13702736,108,0,0,1,1
13702737,13702776,39,1,0,0,1
13702737,13702777,40,1,0,0,2
13702777,13704627,1850,0,0,1,1
13702778,13704630,1852,0,0,1,2
13704628,13705209,581,1,0,0,1
13704631,13705273,642,1,0,0,2
13704655,13705256,601,0,1,0,2
13704657,13704952,295,0,1,0,1
13704984,13705186,202,0,1,0,1
13705210,13706460,1250,0,0,1,1
13705274,13705971,697,0,0,1,2
13705972,13705979,7,1,0,0,2
13705980,13706460,480,0,0,1,2
13706461,13706538,77,1,0,0,1
13706461,13706808,347,1,0,0,2
13706528,13706706,178,0,1,0,2
13706539,13706644,105,0,0,1,1
13706645,13706672,27,1,0,0,1
13706673,13708463,1790,0,0,1,1
13706809,13708464,1655,0,0,1,2
13708464,13708531,67,1,0,0,1
13708465,13708548,83,1,0,0,2
13708532,13708706,174,0,0,1,1
13708549,13708706,157,0,0,1,2
13708707,13708727,20,1,0,0,1
13708707,13708728,21,1,0,0,2
13708728,13709153,425,0,0,1,1
13708729,13709153,424,0,0,1,2
13709154,13709171,17,1,0,0,1
13709154,13709173,19,1,0,0,2
13709172,13710530,1358,0,0,1,1
13709174,13710525,1351,0,0,1,2
13710526,13710937,411,1,0,0,2
13710531,13710900,369,1,0,0,1
13710554,13710927,373,0,1,0,2
13710559,13710889,330,0,1,0,1
13710901,13712512,1611,0,0,1,1
13710938,13712512,1574,0,0,1,2
13712513,13712570,57,1,0,0,1
13712513,13712697,184,1,0,0,2
13712571,13714348,1777,0,0,1,1
13712698,13712741,43,0,0,1,2
13712742,13712821,79,1,0,0,2
13712822,13714350,1528,0,0,1,2
13714349,13714409,60,1,0,0,1
13714351,13714408,57,1,0,0,2
13714409,13714688,279,0,0,1,2
13714410,13714689,279,0,0,1,1
13714689,13714702,13,1,0,0,2
13714690,13714699,9,1,0,0,1
13714700,13715238,538,0,0,1,1
13714703,13715239,536,0,0,1,2
13715239,13715254,15,1,0,0,1
13715240,13715260,20,1,0,0,2
13715255,13716420,1165,0,0,1,1
13715261,13716419,1158,0,0,1,2
13716420,13717065,645,1,0,0,2
13716421,13717021,600,1,0,0,1
13716446,13717040,594,0,1,0,2
13716448,13717010,562,0,1,0,1
13717022,13718389,1367,0,0,1,1
13717066,13718389,1323,0,0,1,2
13718390,13718453,63,1,0,0,2
13718390,13718454,64,1,0,0,1
13718454,13718626,172,0,0,1,2
13718455,13718618,163,0,0,1,1
13718619,13718629,10,1,0,0,1
13718627,13718631,4,1,0,0,2
13718630,13720094,1464,0,0,1,1
13718632,13720093,1461,0,0,1,2
13720094,13720218,124,1,0,0,2
13720095,13720166,71,1,0,0,1
13720167,13722298,2131,0,0,1,1
13720219,13722297,2078,0,0,1,2
13722298,13722961,663,1,0,0,2
13722299,13722926,627,1,0,0,1
13722321,13722951,630,0,1,0,2
13722323,13722917,594,0,1,0,1
13722927,13723885,958,0,0,1,1
13722962,13723886,924,0,0,1,2
13723886,13723957,71,1,0,0,1
13723887,13723989,102,1,0,0,2
13723958,13725428,1470,0,0,1,1
13723990,13724485,495,0,0,1,2
13724486,13724502,16,1,0,0,2
13724503,13725256,753,0,0,1,2
13725257,13725402,145,1,0,0,2
13725403,13725430,27,0,0,1,2
13725429,13725493,64,1,0,0,1
13725431,13725473,42,1,0,0,2
13725474,13725720,246,0,0,1,2
13725494,13727457,1963,0,0,1,1
13725721,13725731,10,1,0,0,2
13725732,13727451,1719,0,0,1,2
13727452,13727995,543,1,0,0,2
13727458,13727943,485,1,0,0,1
13727487,13727917,430,0,1,0,1
13727489,13727935,446,0,1,0,2
13727944,13728889,945,0,0,1,1
13727996,13728889,893,0,0,1,2
13728890,13728941,51,1,0,0,1
13728890,13728962,72,1,0,0,2
13728942,13729125,183,0,0,1,1
13728963,13729085,122,0,0,1,2
13729086,13729139,53,1,0,0,2
13729126,13729130,4,1,0,0,1
13729131,13730630,1499,0,0,1,1
13729140,13729198,58,0,0,1,2
13729199,13729282,83,1,0,0,2
13729283,13729332,49,0,0,1,2
13729333,13729412,79,1,0,0,2
13729413,13729470,57,0,0,1,2
13729471,13729526,55,1,0,0,2
13729527,13729620,93,0,0,1,2
13729621,13729694,73,1,0,0,2
13729695,13729726,31,0,0,1,2
13729727,13729756,29,1,0,0,2
13729757,13729787,30,0,0,1,2
13729788,13729908,120,1,0,0,2
13729909,13729967,58,0,0,1,2
13729968,13729997,29,1,0,0,2
13729998,13730047,49,0,0,1,2
13730048,13730110,62,1,0,0,2
13730111,13730158,47,0,0,1,2
13730159,13730176,17,1,0,0,2
13730177,13730221,44,0,0,1,2
13730222,13730336,114,1,0,0,2
13730337,13730357,20,0,0,1,2
13730358,13730516,158,1,0,0,2
13730517,13730629,112,0,0,1,2
13730630,13730690,60,1,0,0,2
13730631,13730692,61,1,0,0,1
13730691,13732914,2223,0,0,1,2
13730693,13732915,2222,0,0,1,1
13732915,13733356,441,1,0,0,2
13732916,13733244,328,1,0,0,1
13732942,13733222,280,0,1,0,1
13732942,13733277,335,0,1,0,2
13733245,13734563,1318,0,0,1,1
13733357,13734281,924,0,0,1,2
13734282,13734286,4,1,0,0,2
13734287,13734337,50,0,0,1,2
13734338,13734343,5,1,0,0,2
13734344,13734563,219,0,0,1,2
13734564,13734644,80,1,0,0,2
13734564,13734668,104,1,0,0,1
13734645,13734776,131,0,0,1,2
13734669,13734777,108,0,0,1,1
13734777,13734806,29,1,0,0,2
13734778,13734799,21,1,0,0,1
13734800,13736174,1374,0,0,1,1
13734807,13736174,1367,0,0,1,2
13736175,13736240,65,1,0,0,1
13736175,13736243,68,1,0,0,2
13736241,13736424,183,0,0,1,1
13736244,13736423,179,0,0,1,2
13736424,13736457,33,1,0,0,2
13736425,13736460,35,1,0,0,1
13736458,13738271,1813,0,0,1,2
13736461,13738270,1809,0,0,1,1
13738271,13738699,428,1,0,0,1
13738272,13738730,458,1,0,0,2
13738309,13738719,410,0,1,0,2
13738312,13738675,363,0,1,0,1
13738700,13738810,110,0,0,1,1
13738731,13738810,79,0,0,1,2
13738811,13738876,65,1,0,0,2
13738811,13738877,66,1,0,0,1
13738877,13739737,860,0,0,1,2
13738878,13739738,860,0,0,1,1
13739738,13739831,93,1,0,0,2
13739739,13739831,92,1,0,0,1
13739832,13740008,176,0,0,1,1
13739832,13740831,999,0,0,1,2
13740009,13740034,25,1,0,0,1
13740035,13740469,434,0,0,1,1
13740470,13740493,23,1,0,0,1
13740494,13740858,364,0,0,1,1
13740832,13741245,413,1,0,0,2
13740859,13741171,312,1,0,0,1
13740886,13741143,257,0,1,0,1
13740890,13741149,259,0,1,0,2
13741172,13741810,638,0,0,1,1
13741246,13741810,564,0,0,1,2
13741811,13741883,72,1,0,0,1
13741811,13741908,97,1,0,0,2
13741884,13741944,60,0,0,1,1
13741909,13741944,35,0,0,1,2
13741945,13742013,68,1,0,0,1
13741945,13742084,139,1,0,0,2
13742014,13742136,122,0,0,1,1
13742085,13742137,52,0,0,1,2
13742137,13742166,29,1,0,0,1
13742138,13742170,32,1,0,0,2
13742167,13742368,201,0,0,1,1
13742171,13742363,192,0,0,1,2
13742364,13742377,13,1,0,0,2
13742369,13742377,8,1,0,0,1
13742378,13743279,901,0,0,1,1
13742378,13744054,1676,0,0,1,2
13743280,13743858,578,1,0,0,1
13743859,13743899,40,0,0,1,1
13743900,13744535,635,1,0,0,1
13744055,13744583,528,1,0,0,2
13744087,13744273,186,0,1,0,1
13744087,13744278,191,0,1,0,2
13744343,13744518,175,0,1,0,2
13744344,13744512,168,0,1,0,1
13744536,13745270,734,0,0,1,1
13744584,13745270,686,0,0,1,2
13745271,13745325,54,1,0,0,1
13745271,13745328,57,1,0,0,2
13745326,13745872,546,0,0,1,1
13745329,13745872,543,0,0,1,2
13745873,13745943,70,1,0,0,2
13745873,13745953,80,1,0,0,1
13745944,13746108,164,0,0,1,2
13745954,13746109,155,0,0,1,1
13746109,13746127,18,1,0,0,2
13746110,13746167,57,1,0,0,1
13746128,13747542,1414,0,0,1,2
13746168,13746698,530,0,0,1,1
13746699,13746718,19,1,0,0,1
13746719,13746881,162,0,0,1,1
13746882,13746957,75,1,0,0,1
13746958,13747544,586,0,0,1,1
13747543,13747709,166,1,0,0,2
13747545,13747643,98,1,0,0,1
13747644,13747763,119,0,0,1,1
13747710,13747763,53,0,0,1,2
13747764,13747787,23,1,0,0,1
13747764,13747787,23,1,0,0,2
13747788,13748055,267,0,0,1,1
13747788,13748058,270,0,0,1,2
13748056,13748088,32,1,0,0,1
13748059,13748081,22,1,0,0,2
13748082,13749769,1687,0,0,1,2
13748089,13748500,411,0,0,1,1
13748501,13748505,4,1,0,0,1
13748506,13749788,1282,0,0,1,1
13749770,13750551,781,1,0,0,2
13749789,13750431,642,1,0,0,1
13749826,13750420,594,0,1,0,1
13749828,13750458,630,0,1,0,2
13750432,13751254,822,0,0,1,1
13750552,13750605,53,0,0,1,2
13750606,13750652,46,1,0,0,2
13750653,13751255,602,0,0,1,2
13751255,13751336,81,1,0,0,1
13751256,13751360,104,1,0,0,2
13751337,13751493,156,0,0,1,1
13751361,13751493,132,0,0,1,2
13751494,13751514,20,1,0,0,2
13751494,13751523,29,1,0,0,1
13751515,13753290,1775,0,0,1,2
13751524,13753290,1766,0,0,1,1
13753291,13753349,58,1,0,0,1
13753291,13753352,61,1,0,0,2
13753350,13753481,131,0,0,1,1
13753353,13753480,127,0,0,1,2
13753481,13753514,33,1,0,0,2
13753482,13753515,33,1,0,0,1
13753515,13755693,2178,0,0,1,2
13753516,13755705,2189,0,0,1,1
13755694,13756154,460,1,0,0,2
13755706,13756143,437,1,0,0,1
13755731,13756139,408,0,1,0,2
13755732,13756129,397,0,1,0,1
13756144,13757020,876,0,0,1,1
13756155,13756213,58,0,0,1,2
13756214,13756231,17,1,0,0,2
13756232,13757015,783,0,0,1,2
13757016,13757775,759,1,0,0,2
13757021,13757248,227,1,0,0,1
13757089,13757283,194,0,1,0,2
13757102,13757239,137,0,1,0,1
13757249,13757379,130,0,0,1,1
13757380,13757413,33,1,0,0,1
13757414,13757673,259,0,0,1,1
13757674,13757689,15,1,0,0,1
13757690,13758781,1091,0,0,1,1
13757776,13758782,1006,0,0,1,2
13758782,13758833,51,1,0,0,1
13758783,13759025,242,1,0,0,2
13758834,13758985,151,0,0,1,1
13758986,13759015,29,1,0,0,1
13759016,13760328,1312,0,0,1,1
13759026,13760337,1311,0,0,1,2
13760329,13760380,51,1,0,0,1
13760338,13760352,14,1,0,0,2
13760353,13761072,719,0,0,1,2
13760381,13761087,706,0,0,1,1
13761073,13762624,1551,1,0,0,2
13761088,13761718,630,1,0,0,1
13761110,13761740,630,0,1,0,2
13761112,13761706,594,0,1,0,1
13761719,13762358,639,0,0,1,1
13762359,13762464,105,1,0,0,1
13762431,13762440,9,0,1,0,2
13762465,13762465,0,0,1,0,2
13762465,13762605,140,0,0,1,1
13762606,13762621,15,1,0,0,1
13762622,13764253,1631,0,0,1,1
13762625,13762879,254,0,0,1,2
13762880,13762884,4,1,0,0,2
13762885,13764252,1367,0,0,1,2
13764253,13764299,46,1,0,0,2
13764254,13764296,42,1,0,0,1
13764297,13764399,102,0,0,1,1
13764300,13764398,98,0,0,1,2
13764399,13764426,27,1,0,0,2
13764400,13764425,25,1,0,0,1
13764426,13766385,1959,0,0,1,1
13764427,13766383,1956,0,0,1,2
13766384,13767090,706,1,0,0,2
13766386,13767056,670,1,0,0,1
13766411,13767080,669,0,1,0,2
13766418,13767046,628,0,1,0,1
13767057,13767630,573,0,0,1,1
13767091,13767631,540,0,0,1,2
13767631,13767658,27,1,0,0,1
13767632,13767669,37,1,0,0,2
13767659,13769426,1767,0,0,1,1
13767670,13769427,1757,0,0,1,2
13769427,13769484,57,1,0,0,1
13769428,13769482,54,1,0,0,2
13769483,13769578,95,0,0,1,2
13769485,13769578,93,0,0,1,1
13769579,13769599,20,1,0,0,1
13769579,13769600,21,1,0,0,2
13769600,13769801,201,0,0,1,1
13769601,13771725,2124,0,0,1,2
13769802,13769815,13,1,0,0,1
13769816,13771728,1912,0,0,1,1
13771726,13772136,410,1,0,0,2
13771729,13772088,359,1,0,0,1
13771752,13772125,373,0,1,0,2
13771763,13772055,292,0,1,0,1
13772089,13773271,1182,0,0,1,1
13772137,13773272,1135,0,0,1,2
13773272,13773422,150,1,0,0,1
13773273,13773418,145,1,0,0,2
13773419,13773501,82,0,0,1,2
13773423,13773460,37,0,0,1,1
13773461,13773557,96,1,0,0,1
13773502,13773545,43,1,0,0,2
13773546,13773676,130,0,0,1,2
13773558,13773675,117,0,0,1,1
13773676,13773708,32,1,0,0,1
13773677,13773704,27,1,0,0,2
13773705,13775149,1444,0,0,1,2
13773709,13774092,383,0,0,1,1
13774093,13774152,59,1,0,0,1
13774153,13775149,996,0,0,1,1
13775150,13775206,56,1,0,0,2
13775150,13775234,84,1,0,0,1
13775207,13775333,126,0,0,1,2
13775235,13775332,97,0,0,1,1
13775333,13775366,33,1,0,0,1
13775334,13775367,33,1,0,0,2
13775367,13775628,261,0,0,1,1
13775368,13776124,756,0,0,1,2
13775629,13775658,29,1,0,0,1
13775659,13776039,380,0,0,1,1
13776040,13776105,65,1,0,0,1
13776106,13776140,34,0,0,1,1
13776125,13776459,334,1,0,0,2
13776141,13776404,263,1,0,0,1
13776168,13776352,184,0,1,0,2
13776169,13776347,178,0,1,0,1
13776405,13777244,839,0,0,1,1
13776460,13777230,770,0,0,1,2
13777231,13777259,28,1,0,0,2
13777245,13777259,14,1,0,0,1
13777260,13777375,115,0,0,1,2
13777260,13777399,139,0,0,1,1
13777376,13777763,387,1,0,0,2
13777400,13777665,265,1,0,0,1
13777424,13777650,226,0,1,0,2
13777425,13777643,218,0,1,0,1
13777666,13777808,142,0,0,1,1
13777764,13777808,44,0,0,1,2
13777809,13777842,33,1,0,0,1
13777809,13777843,34,1,0,0,2
13777843,13778831,988,0,0,1,1
13777844,13778830,986,0,0,1,2
13778831,13779911,1080,1,0,0,2
13778832,13778934,102,1,0,0,1
13778912,13779901,989,0,1,0,2
13778935,13779026,91,0,0,1,1
13779027,13779068,41,1,0,0,1
13779069,13779196,127,0,0,1,1
13779197,13779215,18,1,0,0,1
13779216,13780541,1325,0,0,1,1
13779912,13780541,629,0,0,1,2
13780542,13780610,68,1,0,0,1
13780542,13780674,132,1,0,0,2
13780611,13780801,190,0,0,1,1
13780675,13780799,124,0,0,1,2
13780800,13780814,14,1,0,0,2
13780802,13780814,12,1,0,0,1
13780815,13781870,1055,0,0,1,2
13780815,13782632,1817,0,0,1,1
13781871,13781912,41,1,0,0,2
13781913,13782620,707,0,0,1,2
13782621,13783151,530,1,0,0,2
13782633,13783068,435,1,0,0,1
13782659,13783068,409,0,1,0,2
13782661,13783058,397,0,1,0,1
13783069,13783760,691,0,0,1,1
13783152,13783434,282,0,0,1,2
13783435,13783534,99,1,0,0,2
13783535,13783629,94,0,0,1,2
13783630,13783688,58,1,0,0,2
13783689,13783759,70,0,0,1,2
13783760,13783835,75,1,0,0,2
13783761,13783821,60,1,0,0,1
13783822,13783919,97,0,0,1,1
13783836,13783917,81,0,0,1,2
13783918,13784034,116,1,0,0,2
13783920,13784010,90,1,0,0,1
13784011,13784105,94,0,0,1,1
13784035,13784105,70,0,0,1,2
13784106,13784134,28,1,0,0,1
13784106,13784140,34,1,0,0,2
13784135,13784329,194,0,0,1,1
13784141,13784329,188,0,0,1,2
13784330,13784355,25,1,0,0,2
13784330,13784361,31,1,0,0,1
13784356,13784558,202,0,0,1,2
13784362,13784563,201,0,0,1,1
13784559,13784786,227,1,0,0,2
13784564,13784786,222,1,0,0,1
13784595,13784724,129,0,1,0,1
13784597,13784734,137,0,1,0,2
13784787,13784836,49,0,0,1,2
13784787,13784918,131,0,0,1,1
13784837,13784862,25,1,0,0,2
13784863,13784916,53,0,0,1,2
13784917,13784932,15,1,0,0,2
13784919,13784931,12,1,0,0,1
13784932,13786203,1271,0,0,1,1
13784933,13786201,1268,0,0,1,2
13786202,13786314,112,1,0,0,2
13786204,13786304,100,1,0,0,1
13786305,13786418,113,0,0,1,1
13786315,13786417,102,0,0,1,2
13786418,13786442,24,1,0,0,2
13786419,13786439,20,1,0,0,1
13786440,13787575,1135,0,0,1,1
13786443,13787837,1394,0,0,1,2
13787576,13787580,4,1,0,0,1
13787581,13787838,257,0,0,1,1
13787838,13788122,284,1,0,0,2
13787839,13788089,250,1,0,0,1
13787869,13788029,160,0,1,0,1
13787869,13788044,175,0,1,0,2
13788090,13788277,187,0,0,1,1
13788123,13788270,147,0,0,1,2
13788271,13788582,311,1,0,0,2
13788278,13788560,282,1,0,0,1
13788304,13788522,218,0,1,0,2
13788307,13788498,191,0,1,0,1
13788561,13789970,1409,0,0,1,1
13788583,13788633,50,0,0,1,2
13788634,13788672,38,1,0,0,2
13788673,13789970,1297,0,0,1,2
13789971,13790044,73,1,0,0,2
13789971,13790045,74,1,0,0,1
13790045,13790212,167,0,0,1,2
13790046,13790213,167,0,0,1,1
13790213,13790289,76,1,0,0,2
13790214,13790287,73,1,0,0,1
13790288,13790382,94,0,0,1,1
13790290,13790344,54,0,0,1,2
13790345,13790407,62,1,0,0,2
13790383,13790421,38,1,0,0,1
13790408,13790540,132,0,0,1,2
13790422,13790539,117,0,0,1,1
13790540,13790558,18,1,0,0,1
13790541,13790560,19,1,0,0,2
13790559,13791450,891,0,0,1,1
13790561,13790703,142,0,0,1,2
13790704,13790708,4,1,0,0,2
13790709,13791451,742,0,0,1,2
13791451,13791505,54,1,0,0,1
13791452,13791514,62,1,0,0,2
13791506,13793478,1972,0,0,1,1
13791515,13793478,1963,0,0,1,2
13793479,13793835,356,1,0,0,1
13793479,13793850,371,1,0,0,2
13793506,13793796,290,0,1,0,1
13793506,13793841,335,0,1,0,2
13793836,13794805,969,0,0,1,1
13793851,13793878,27,0,0,1,2
13793879,13793975,96,1,0,0,2
13793976,13794804,828,0,0,1,2
13794805,13795212,407,1,0,0,2
13794806,13794909,103,1,0,0,1
13794910,13795055,145,0,0,1,1
13795056,13795061,5,1,0,0,1
13795062,13795391,329,0,0,1,1
13795213,13796296,1083,0,0,1,2
13795392,13795452,60,1,0,0,1
13795453,13795609,156,0,0,1,1
13795610,13795950,340,1,0,0,1
13795951,13795999,48,0,0,1,1
13796000,13796057,57,1,0,0,1
13796058,13796178,120,0,0,1,1
13796179,13796348,169,1,0,0,1
13796297,13796357,60,1,0,0,2
13796349,13796490,141,0,0,1,1
13796358,13796413,55,0,0,1,2
13796414,13796430,16,1,0,0,2
13796431,13796490,59,0,0,1,2
13796491,13796519,28,1,0,0,1
13796491,13796521,30,1,0,0,2
13796520,13797700,1180,0,0,1,1
13796522,13797694,1172,0,0,1,2
13797695,13797929,234,1,0,0,2
13797701,13797933,232,1,0,0,1
13797723,13797870,147,0,1,0,1
13797724,13797874,150,0,1,0,2
13797930,13797968,38,0,0,1,2
13797934,13799426,1492,0,0,1,1
13797969,13797991,22,1,0,0,2
13797992,13799411,1419,0,0,1,2
13799412,13799864,452,1,0,0,2
13799427,13799740,313,1,0,0,1
13799453,13799644,191,0,1,0,1
13799453,13799662,209,0,1,0,2
13799714,13799751,37,0,1,0,2
13799741,13799848,107,0,0,1,1
13799849,13799866,17,1,0,0,1
13799865,13799933,68,0,0,1,2
13799867,13800948,1081,0,0,1,1
13799934,13800099,165,1,0,0,2
13800100,13800143,43,0,0,1,2
13800144,13800422,278,1,0,0,2
13800423,13800948,525,0,0,1,2
13800949,13801015,66,1,0,0,1
13800949,13801015,66,1,0,0,2
13801016,13801463,447,0,0,1,2
13801016,13804406,3390,0,0,1,1
13801464,13801468,4,1,0,0,2
13801469,13804406,2937,0,0,1,2
13804407,13804460,53,1,0,0,2
13804407,13804463,56,1,0,0,1
13804461,13804781,320,0,0,1,2
13804464,13804606,142,0,0,1,1
13804607,13804615,8,1,0,0,1
13804616,13804787,171,0,0,1,1
13804782,13805044,262,1,0,0,2
13804788,13805035,247,1,0,0,1
13804817,13804994,177,0,1,0,2
13804818,13804977,159,0,1,0,1
13805036,13805750,714,0,0,1,1
13805045,13805750,705,0,0,1,2
13805751,13805802,51,1,0,0,2
13805751,13805813,62,1,0,0,1
13805803,13807976,2173,0,0,1,2
13805814,13807972,2158,0,0,1,1
13807973,13808243,270,1,0,0,1
13807977,13808236,259,1,0,0,2
13808016,13808190,174,0,1,0,2
13808017,13808184,167,0,1,0,1
13808237,13808264,27,0,0,1,2
13808244,13808265,21,0,0,1,1
13808265,13808551,286,1,0,0,2
13808266,13808536,270,1,0,0,1
13808295,13808498,203,0,1,0,2
13808296,13808479,183,0,1,0,1
13808537,13809273,736,0,0,1,1
13808552,13809273,721,0,0,1,2
13809274,13809327,53,1,0,0,2
13809274,13809339,65,1,0,0,1
13809328,13809446,118,0,0,1,2
13809340,13809446,106,0,0,1,1
13809447,13809475,28,1,0,0,1
13809447,13809476,29,1,0,0,2
13809476,13811251,1775,0,0,1,1
13809477,13811251,1774,0,0,1,2
13811252,13811314,62,1,0,0,2
13811252,13811316,64,1,0,0,1
13811315,13811712,397,0,0,1,2
13811317,13813303,1986,0,0,1,1
13811713,13811722,9,1,0,0,2
13811723,13813301,1578,0,0,1,2
13813302,13813702,400,1,0,0,2
13813304,13813669,365,1,0,0,1
13813339,13813674,335,0,1,0,2
13813345,13813608,263,0,1,0,1
13813670,13814937,1267,0,0,1,1
13813703,13814937,1234,0,0,1,2
13814938,13815028,90,1,0,0,2
13814938,13815031,93,1,0,0,1
13815029,13815302,273,0,0,1,2
13815032,13815301,269,0,0,1,1
13815302,13815405,103,1,0,0,1
13815303,13815387,84,1,0,0,2
13815388,13815452,64,0,0,1,2
13815406,13815452,46,0,0,1,1
13815453,13815493,40,1,0,0,2
13815453,13815499,46,1,0,0,1
13815494,13815636,142,0,0,1,2
13815500,13815632,132,0,0,1,1
13815633,13815661,28,1,0,0,1
13815637,13815647,10,1,0,0,2
13815648,13816964,1316,0,0,1,2
13815662,13816964,1302,0,0,1,1
13816965,13817037,72,1,0,0,1
13816965,13817038,73,1,0,0,2
13817038,13817181,143,0,0,1,1
13817039,13817182,143,0,0,1,2
13817182,13817204,22,1,0,0,1
13817183,13817204,21,1,0,0,2
13817205,13818632,1427,0,0,1,2
13817205,13819209,2004,0,0,1,1
13818633,13818637,4,1,0,0,2
13818638,13819207,569,0,0,1,2
13819208,13819837,629,1,0,0,2
13819210,13819773,563,1,0,0,1
13819239,13819758,519,0,1,0,2
13819242,13819738,496,0,1,0,1
13819774,13820793,1019,0,0,1,1
13819838,13820792,954,0,0,1,2
13820793,13820885,92,1,0,0,2
13820794,13820867,73,1,0,0,1
13820868,13821588,720,0,0,1,1
13820886,13821589,703,0,0,1,2
13821589,13821605,16,1,0,0,1
13821590,13821614,24,1,0,0,2
13821606,13822315,709,0,0,1,1
13821615,13822316,701,0,0,1,2
13822316,13822390,74,1,0,0,1
13822317,13822414,97,1,0,0,2
13822391,13822528,137,0,0,1,1
13822415,13822502,87,0,0,1,2
13822503,13822560,57,1,0,0,2
13822529,13822569,40,1,0,0,1
13822561,13823373,812,0,0,1,2
13822570,13824394,1824,0,0,1,1
13823374,13823476,102,1,0,0,2
13823477,13823538,61,0,0,1,2
13823539,13823688,149,1,0,0,2
13823689,13823709,20,0,0,1,2
13823710,13823827,117,1,0,0,2
13823828,13823908,80,0,0,1,2
13823909,13824017,108,1,0,0,2
13824018,13824349,331,0,0,1,2
13824350,13824749,399,1,0,0,2
13824395,13824704,309,1,0,0,1
13824421,13824673,252,0,1,0,1
13824427,13824680,253,0,1,0,2
13824705,13824739,34,0,0,1,1
13824740,13824753,13,1,0,0,1
13824750,13824809,59,0,0,1,2
13824754,13824865,111,0,0,1,1
13824810,13824910,100,1,0,0,2
13824866,13824901,35,1,0,0,1
13824902,13826002,1100,0,0,1,1
13824911,13826001,1090,0,0,1,2
13826002,13826613,611,1,0,0,2
13826003,13826370,367,1,0,0,1
13826061,13826434,373,0,1,0,2
13826063,13826228,165,0,1,0,1
13826341,13826360,19,0,1,0,1
13826371,13826512,141,0,0,1,1
13826513,13826524,11,1,0,0,1
13826525,13827469,944,0,0,1,1
13826614,13827469,855,0,0,1,2
13827470,13827523,53,1,0,0,1
13827470,13827526,56,1,0,0,2
13827524,13827757,233,0,0,1,1
13827527,13827755,228,0,0,1,2
13827756,13827775,19,1,0,0,2
13827758,13827775,17,1,0,0,1
13827776,13827987,211,0,0,1,1
13827776,13828900,1124,0,0,1,2
13827988,13827999,11,1,0,0,1
13828000,13829643,1643,0,0,1,1
13828901,13828905,4,1,0,0,2
13828906,13829636,730,0,0,1,2
13829637,13830347,710,1,0,0,2
13829644,13830314,670,1,0,0,1
13829671,13830310,639,0,1,0,2
13829678,13829946,268,0,1,0,1
13829967,13829967,0,0,1,0,1
13829991,13830257,266,0,1,0,1
13830315,13830744,429,0,0,1,1
13830348,13830462,114,0,0,1,2
13830463,13830524,61,1,0,0,2
13830525,13830643,118,0,0,1,2
13830644,13830694,50,1,0,0,2
13830695,13830744,49,0,0,1,2
13830745,13830832,87,1,0,0,1
13830745,13830846,101,1,0,0,2
13830833,13830926,93,0,0,1,1
13830847,13830926,79,0,0,1,2
13830927,13830950,23,1,0,0,1
13830927,13830957,30,1,0,0,2
13830951,13832671,1720,0,0,1,1
13830958,13832672,1714,0,0,1,2
13832672,13832720,48,1,0,0,1
13832673,13832791,118,1,0,0,2
13832721,13832884,163,0,0,1,1
13832792,13834744,1952,0,0,1,2
13832885,13832911,26,1,0,0,1
13832912,13834753,1841,0,0,1,1
13834745,13835414,669,1,0,0,2
13834754,13835390,636,1,0,0,1
13834774,13835369,595,0,1,0,2
13834783,13835379,596,0,1,0,1
13835391,13836455,1064,0,0,1,1
13835415,13835451,36,0,0,1,2
13835452,13835478,26,1,0,0,2
13835479,13836456,977,0,0,1,2
13836456,13836520,64,1,0,0,1
13836457,13836522,65,1,0,0,2
13836521,13836659,138,0,0,1,1
13836523,13836656,133,0,0,1,2
13836657,13836674,17,1,0,0,2
13836660,13836672,12,1,0,0,1
13836673,13837906,1233,0,0,1,1
13836675,13837907,1232,0,0,1,2
13837907,13837980,73,1,0,0,1
13837908,13838211,303,1,0,0,2
13837981,13838154,173,0,0,1,1
13838155,13838174,19,1,0,0,1
13838175,13839975,1800,0,0,1,1
13838212,13839977,1765,0,0,1,2
13839976,13840433,457,1,0,0,1
13839978,13840488,510,1,0,0,2
13840043,13840453,410,0,1,0,2
13840060,13840423,363,0,1,0,1
13840434,13841373,939,0,0,1,1
13840489,13841375,886,0,0,1,2
13841374,13841431,57,1,0,0,1
13841376,13841424,48,1,0,0,2
13841425,13841615,190,0,0,1,2
13841432,13841613,181,0,0,1,1
13841614,13841672,58,1,0,0,1
13841616,13841674,58,1,0,0,2
13841673,13841918,245,0,0,1,1
13841675,13841746,71,0,0,1,2
13841747,13841866,119,1,0,0,2
13841867,13841915,48,0,0,1,2
13841916,13842712,796,1,0,0,2
13841919,13841948,29,1,0,0,1
13841949,13841992,43,0,0,1,1
13841993,13842651,658,1,0,0,1
13842013,13842641,628,0,1,0,1
13842013,13842643,630,0,1,0,2
13842652,13842890,238,0,0,1,1
13842713,13842738,25,0,0,1,2
13842739,13842751,12,1,0,0,2
13842752,13842877,125,0,0,1,2
13842878,13856641,13763,1,0,0,2
13842891,13856815,13924,1,0,0,1
13842899,13856624,13725,0,1,0,2
13842904,13856805,13901,0,1,0,1
13856642,13856896,254,0,0,1,2
13856816,13856867,51,0,0,1,1
13856868,13857181,313,1,0,0,1
13856897,13857195,298,1,0,0,2
13856926,13857135,209,0,1,0,1
13856929,13857132,203,0,1,0,2
13857182,13857241,59,0,0,1,1
13857196,13857240,44,0,0,1,2
13857241,13857264,23,1,0,0,2
13857242,13857262,20,1,0,0,1
13857263,13857411,148,0,0,1,1
13857265,13857400,135,0,0,1,2
13857401,13857668,267,1,0,0,2
13857412,13857639,227,1,0,0,1
13857447,13857591,144,0,1,0,1
13857448,13857585,137,0,1,0,2
13857640,13857931,291,0,0,1,1
13857669,13857881,212,0,0,1,2
13857882,13857902,20,1,0,0,2
13857903,13857935,32,0,0,1,2
13857932,13857945,13,1,0,0,1
13857936,13857999,63,1,0,0,2
13857946,13858087,141,0,0,1,1
13858000,13858058,58,0,0,1,2
13858059,13858437,378,1,0,0,2
13858088,13858324,236,1,0,0,1
13858118,13858297,179,0,1,0,1
13858124,13858300,176,0,1,0,2
13858325,13858831,506,0,0,1,1
13858438,13858806,368,0,0,1,2
13858807,13859105,298,1,0,0,2
13858832,13859083,251,1,0,0,1
13858859,13859043,184,0,1,0,1
13858861,13859053,192,0,1,0,2
13859084,13859380,296,0,0,1,1
13859106,13859188,82,0,0,1,2
13859189,13859313,124,1,0,0,2
13859314,13859380,66,0,0,1,2
13923376,13924089,713,0,0,1,1
13923451,13924090,639,0,0,1,2
13924090,13924211,121,1,0,0,1
13924091,13924209,118,1,0,0,2
13924210,13924337,127,0,0,1,2
13924212,13924338,126,0,0,1,1
13924338,13924366,28,1,0,0,2
13924339,13924374,35,1,0,0,1
13924367,13924665,298,0,0,1,2
13924375,13924663,288,0,0,1,1
13924664,13924697,33,1,0,0,1
13924666,13924688,22,1,0,0,2
13924689,13925993,1304,0,0,1,2
13924698,13925992,1294,0,0,1,1
13925993,13926068,75,1,0,0,1
13925994,13926066,72,1,0,0,2
13926067,13926129,62,0,0,1,2
13926069,13926124,55,0,0,1,1
13926125,13926377,252,1,0,0,1
13926130,13926376,246,1,0,0,2
13926150,13926336,186,0,1,0,1
13926151,13926349,198,0,1,0,2
13926377,13926455,78,0,0,1,2
13926378,13926460,82,0,0,1,1
13926456,13926480,24,1,0,0,2
13926461,13926471,10,1,0,0,1
13926472,13927902,1430,0,0,1,1
13926481,13927901,1420,0,0,1,2
13927902,13928321,419,1,0,0,2
13927903,13927989,86,1,0,0,1
13927971,13928306,335,0,1,0,2
13927990,13928065,75,0,0,1,1
13928066,13928173,107,1,0,0,1
13928174,13928213,39,0,0,1,1
13928214,13928248,34,1,0,0,1
13928249,13929807,1558,0,0,1,1
13928322,13929812,1490,0,0,1,2
13929808,13930037,229,1,0,0,1
13929813,13930025,212,1,0,0,2
13929840,13929984,144,0,1,0,1
13929840,13929987,147,0,1,0,2
13930026,13930126,100,0,0,1,2
13930038,13930126,88,0,0,1,1
13930127,13930158,31,1,0,0,2
13930127,13930169,42,1,0,0,1
13930159,13931895,1736,0,0,1,2
13930170,13931889,1719,0,0,1,1
13931890,13932106,216,1,0,0,1
13931896,13932139,243,1,0,0,2
13931933,13932071,138,0,1,0,1
13931935,13932078,143,0,1,0,2
13932107,13932195,88,0,0,1,1
13932140,13932195,55,0,0,1,2
13932196,13932218,22,1,0,0,1
13932196,13932220,24,1,0,0,2
13932219,13933845,1626,0,0,1,1
13932221,13933846,1625,0,0,1,2
13933846,13934785,939,1,0,0,1
13933847,13935343,1496,1,0,0,2
13933947,13934774,827,0,1,0,1
13933949,13935334,1385,0,1,0,2
13934786,13935293,507,0,0,1,1
13935294,13935329,35,1,0,0,1
13935330,13935608,278,0,0,1,1
13935344,13935438,94,0,0,1,2
13935439,13935445,6,1,0,0,2
13935446,13935606,160,0,0,1,2
13935607,13935938,331,1,0,0,2
13935609,13935919,310,1,0,0,1
13935638,13935880,242,0,1,0,2
13935644,13935866,222,0,1,0,1
13935920,13936026,106,0,0,1,1
13935939,13936027,88,0,0,1,2
13936027,13936109,82,1,0,0,1
13936028,13936106,78,1,0,0,2
13936107,13936192,85,0,0,1,2
13936110,13936192,82,0,0,1,1
13936193,13936225,32,1,0,0,2
13936193,13936233,40,1,0,0,1
13936226,13937742,1516,0,0,1,2
13936234,13937742,1508,0,0,1,1
13937743,13937801,58,1,0,0,2
13937743,13937810,67,1,0,0,1
13937802,13938275,473,0,0,1,2
13937811,13938108,297,0,0,1,1
13938109,13938130,21,1,0,0,1
13938131,13938286,155,0,0,1,1
13938276,13938565,289,1,0,0,2
13938287,13938565,278,1,0,0,1
13938313,13938506,193,0,1,0,2
13938316,13938502,186,0,1,0,1
13938566,13938616,50,0,0,1,1
13938566,13938624,58,0,0,1,2
13938617,13938646,29,1,0,0,1
13938625,13938635,10,1,0,0,2
13938636,13939506,870,0,0,1,2
13938647,13939505,858,0,0,1,1
13939506,13939579,73,1,0,0,1
13939507,13939615,108,1,0,0,2
13939580,13939687,107,0,0,1,1
13939616,13939662,46,0,0,1,2
13939663,13939826,163,1,0,0,2
13939688,13939716,28,1,0,0,1
13939717,13940976,1259,0,0,1,1
13939827,13939994,167,0,0,1,2
13939995,13940168,173,1,0,0,2
13940169,13940955,786,0,0,1,2
13940956,13941619,663,1,0,0,2
13940977,13941315,338,1,0,0,1
13940996,13941279,283,0,1,0,2
13940997,13941282,285,0,1,0,1
13941316,13941473,157,0,0,1,1
13941474,13941610,136,1,0,0,1
13941511,13941530,19,0,1,0,2
13941611,13941701,90,0,0,1,1
13941620,13941702,82,0,0,1,2
13941702,13941752,50,1,0,0,1
13941703,13941731,28,1,0,0,2
13941732,13941975,243,0,0,1,2
13941753,13943252,1499,0,0,1,1
13941976,13941986,10,1,0,0,2
13941987,13943253,1266,0,0,1,2
13943253,13944119,866,1,0,0,1
13943254,13944660,1406,1,0,0,2
13943339,13944106,767,0,1,0,1
13943343,13944649,1306,0,1,0,2
13944120,13945072,952,0,0,1,1
13944661,13945068,407,0,0,1,2
13945073,13945391,318,1,0,0,1
13945079,13945414,335,0,1,0,2
13945094,13945357,263,0,1,0,1
13945392,13945454,62,0,0,1,1
13945424,13945425,1,1,0,0,2
13945426,13945450,24,0,0,1,2
13945451,13945475,24,1,0,0,2
13945455,13945486,31,1,0,0,1
13945476,13946928,1452,0,0,1,2
13945487,13946791,1304,0,0,1,1
13946792,13946815,23,1,0,0,1
13946816,13946928,112,0,0,1,1
13946929,13947009,80,1,0,0,1
13946929,13947300,371,1,0,0,2
13947010,13947091,81,0,0,1,1
13947092,13947308,216,1,0,0,1
13947110,13947244,134,0,1,0,1
13947110,13947254,144,0,1,0,2
13947301,13947390,89,0,0,1,2
13947309,13947388,79,0,0,1,1
13947389,13947414,25,1,0,0,1
13947391,13947415,24,1,0,0,2
13947415,13947591,176,0,0,1,1
13947416,13949132,1716,0,0,1,2
13947592,13947612,20,1,0,0,1
13947613,13949132,1519,0,0,1,1
13949133,13949204,71,1,0,0,1
13949133,13949205,72,1,0,0,2
13949205,13949294,89,0,0,1,1
13949206,13949295,89,0,0,1,2
13949295,13949320,25,1,0,0,1
13949296,13949318,22,1,0,0,2
13949319,13949595,276,0,0,1,2
13949321,13949585,264,0,0,1,1
13949586,13949611,25,1,0,0,1
13949596,13949600,4,1,0,0,2
13949601,13950553,952,0,0,1,2
13949612,13949998,386,0,0,1,1
13949999,13950009,10,1,0,0,1
13950010,13951046,1036,0,0,1,1
13950554,13950571,17,1,0,0,2
13950572,13951046,474,0,0,1,2
13951047,13951104,57,1,0,0,2
13951047,13951106,59,1,0,0,1
13951105,13951208,103,0,0,1,2
13951107,13951207,100,0,0,1,1
13951208,13951231,23,1,0,0,1
13951209,13951231,22,1,0,0,2
13951232,13951407,175,0,0,1,2
13951232,13952820,1588,0,0,1,1
13951408,13951417,9,1,0,0,2
13951418,13952818,1400,0,0,1,2
13952819,13952893,74,1,0,0,2
13952821,13952881,60,1,0,0,1
13952882,13953008,126,0,0,1,1
13952894,13953009,115,0,0,1,2
13953009,13953029,20,1,0,0,1
13953010,13953030,20,1,0,0,2
13953030,13953756,726,0,0,1,1
13953031,13953751,720,0,0,1,2
13953752,13953955,203,1,0,0,2
13953757,13953936,179,1,0,0,1
13953784,13953885,101,0,1,0,1
13953786,13953899,113,0,1,0,2
13953937,13954124,187,0,0,1,1
13953956,13954115,159,0,0,1,2
13954116,13954399,283,1,0,0,2
13954125,13954397,272,1,0,0,1
13954149,13954342,193,0,1,0,2
13954151,13954325,174,0,1,0,1
13954398,13954836,438,0,0,1,1
13954400,13954837,437,0,0,1,2
13954837,13955279,442,1,0,0,1
13954838,13955963,1125,1,0,0,2
13954897,13955952,1055,0,1,0,2
13954905,13955268,363,0,1,0,1
13955280,13955403,123,0,0,1,1
13955414,13955484,70,0,1,0,1
13955494,13955506,12,1,0,0,1
13955507,13955639,132,0,0,1,1
13955640,13955645,5,1,0,0,1
13955646,13956706,1060,0,0,1,1
13955964,13956707,743,0,0,1,2
13956707,13956787,80,1,0,0,1
13956708,13956920,212,1,0,0,2
13956788,13956897,109,0,0,1,1
13956898,13956929,31,1,0,0,1
13956921,13957289,368,0,0,1,2
13956930,13958526,1596,0,0,1,1
13957290,13957414,124,1,0,0,2
13957415,13957619,204,0,0,1,2
13957620,13957678,58,1,0,0,2
13957679,13957945,266,0,0,1,2
13957946,13957956,10,1,0,0,2
13957957,13958056,99,0,0,1,2
13958057,13958139,82,1,0,0,2
13958140,13958185,45,0,0,1,2
13958186,13958190,4,1,0,0,2
13958191,13958525,334,0,0,1,2
13958526,13959775,1249,1,0,0,2
13958527,13959183,656,1,0,0,1
13958563,13959764,1201,0,1,0,2
13958578,13959172,594,0,1,0,1
13959184,13959668,484,0,0,1,1
13959679,13959683,4,0,1,0,1
13959692,13959692,0,1,0,0,1
13959693,13959994,301,0,0,1,1
13959776,13959979,203,0,0,1,2
13959990,13960096,106,0,1,0,2
13959995,13960052,57,1,0,0,1
13960018,13960029,11,0,1,0,1
13960053,13960192,139,0,0,1,1
13960105,13960105,0,1,0,0,2
13960106,13960190,84,0,0,1,2
13960191,13960533,342,1,0,0,2
13960193,13960479,286,1,0,0,1
13960207,13960485,278,0,1,0,2
13960225,13960447,222,0,1,0,1
13960480,13960581,101,0,0,1,1
13960534,13960582,48,0,0,1,2
13960582,13960662,80,1,0,0,1
13960583,13960673,90,1,0,0,2
13960630,13960660,30,0,1,0,2
13960663,13960770,107,0,0,1,1
13960674,13960772,98,0,0,1,2
13960771,13960814,43,1,0,0,1
13960773,13960797,24,1,0,0,2
13960798,13962423,1625,0,0,1,2
13960815,13962423,1608,0,0,1,1
13962424,13962475,51,1,0,0,2
13962424,13962478,54,1,0,0,1
13962476,13962614,138,0,0,1,2
13962479,13962608,129,0,0,1,1
13962609,13962627,18,1,0,0,1
13962615,13962627,12,1,0,0,2
13962628,13964189,1561,0,0,1,1
13962628,13964191,1563,0,0,1,2
13964190,13964258,68,1,0,0,1
13964192,13964246,54,1,0,0,2
13964247,13964336,89,0,0,1,2
13964259,13964304,45,0,0,1,1
13964305,13964656,351,1,0,0,1
13964337,13964625,288,1,0,0,2
13964360,13964609,249,0,1,0,2
13964365,13964589,224,0,1,0,1
13964626,13964716,90,0,0,1,2
13964657,13966065,1408,0,0,1,1
13964717,13964728,11,1,0,0,2
13964729,13966064,1335,0,0,1,2
13966065,13966154,89,1,0,0,2
13966066,13966148,82,1,0,0,1
13966149,13966243,94,0,0,1,1
13966155,13966244,89,0,0,1,2
13966244,13966281,37,1,0,0,1
13966245,13966284,39,1,0,0,2
13966282,13966448,166,0,0,1,1
13966285,13967829,1544,0,0,1,2
13966449,13966465,16,1,0,0,1
13966466,13967827,1361,0,0,1,1
13967828,13967885,57,1,0,0,1
13967830,13967895,65,1,0,0,2
13967886,13968044,158,0,0,1,1
13967896,13968045,149,0,0,1,2
13968045,13968065,20,1,0,0,1
13968046,13968077,31,1,0,0,2
13968066,13969042,976,0,0,1,1
13968078,13969040,962,0,0,1,2
13969041,13969555,514,1,0,0,2
13969043,13969558,515,1,0,0,1
13969075,13969229,154,0,1,0,2
13969076,13969203,127,0,1,0,1
13969312,13969515,203,0,1,0,2
13969316,13969491,175,0,1,0,1
13969556,13969694,138,0,0,1,2
13969559,13969695,136,0,0,1,1
13969695,13969769,74,1,0,0,2
13969696,13969757,61,1,0,0,1
13969758,13969876,118,0,0,1,1
13969770,13969874,104,0,0,1,2
13969875,13969898,23,1,0,0,2
13969877,13969895,18,1,0,0,1
13969896,13971487,1591,0,0,1,1
13969899,13971487,1588,0,0,1,2
13971488,13971542,54,1,0,0,1
13971488,13971551,63,1,0,0,2
13971543,13971628,85,0,0,1,1
13971552,13971632,80,0,0,1,2
13971629,13971653,24,1,0,0,1
13971633,13971678,45,1,0,0,2
13971654,13971760,106,0,0,1,1
13971679,13971755,76,0,0,1,2
13971756,13971789,33,1,0,0,2
13971761,13971788,27,1,0,0,1
13971789,13972938,1149,0,0,1,1
13971790,13971863,73,0,0,1,2
13971864,13971881,17,1,0,0,2
13971882,13972619,737,0,0,1,2
13972620,13972653,33,1,0,0,2
13972654,13972816,162,0,0,1,2
13972817,13974038,1221,1,0,0,2
13972939,13972977,38,1,0,0,1
13972978,13973371,393,0,0,1,1
13973372,13973736,364,1,0,0,1
13973388,13974027,639,0,1,0,2
13973391,13973680,289,0,1,0,1
13973737,13973918,181,0,0,1,1
13973919,13973929,10,1,0,0,1
13973930,13974693,763,0,0,1,1
13974039,13975426,1387,0,0,1,2
13974694,13974718,24,1,0,0,1
13974719,13975425,706,0,0,1,1
13975426,13975535,109,1,0,0,1
13975427,13975590,163,1,0,0,2
13975536,13975656,120,0,0,1,1
13975591,13975668,77,0,0,1,2
13975657,13975673,16,1,0,0,1
13975669,13975684,15,1,0,0,2
13975674,13975852,178,0,0,1,1
13975685,13975838,153,0,0,1,2
13975839,13975879,40,1,0,0,2
13975853,13975862,9,1,0,0,1
13975863,13977373,1510,0,0,1,1
13975880,13975927,47,0,0,1,2
13975928,13975984,56,1,0,0,2
13975985,13976155,170,0,0,1,2
13976156,13976195,39,1,0,0,2
13976196,13976216,20,0,0,1,2
13976217,13976470,253,1,0,0,2
13976471,13976491,20,0,0,1,2
13976492,13976561,69,1,0,0,2
13976562,13976741,179,0,0,1,2
13976742,13976944,202,1,0,0,2
13976945,13977020,75,0,0,1,2
13977021,13977144,123,1,0,0,2
13977145,13977205,60,0,0,1,2
13977206,13977300,94,1,0,0,2
13977301,13977374,73,0,0,1,2
13977374,13979137,1763,1,0,0,1
13977375,13979100,1725,1,0,0,2
13977418,13979082,1664,0,1,0,2
13977428,13979126,1698,0,1,0,1
13979101,13979201,100,0,0,1,2
13979138,13979203,65,0,0,1,1
13979202,13981194,1992,1,0,0,2
13979204,13979519,315,1,0,0,1
13979223,13979508,285,0,1,0,1
13979235,13981160,1925,0,1,0,2
13979520,13980568,1048,0,0,1,1
13980569,13980696,127,1,0,0,1
13980593,13980675,82,0,1,0,1
13980697,13981086,389,0,0,1,1
13981087,13981291,204,1,0,0,1
13981195,13981259,64,0,0,1,2
13981260,13981291,31,1,0,0,2
13981292,13982274,982,0,0,1,1
13981292,13982274,982,0,0,1,2
13982275,13982644,369,1,0,0,1
13982275,13982661,386,1,0,0,2
13982316,13982651,335,0,1,0,2
13982327,13982601,274,0,1,0,1
13982645,13982816,171,0,0,1,1
13982662,13982816,154,0,0,1,2
13982817,13982873,56,1,0,0,1
13982817,13983051,234,1,0,0,2
13982854,13983024,170,0,1,0,2
13982874,13982979,105,0,0,1,1
13982980,13983001,21,1,0,0,1
13983002,13983310,308,0,0,1,1
13983052,13984613,1561,0,0,1,2
13983311,13983325,14,1,0,0,1
13983326,13984613,1287,0,0,1,1
13984614,13984731,117,1,0,0,1
13984614,13984733,119,1,0,0,2
13984732,13984822,90,0,0,1,1
13984734,13984822,88,0,0,1,2
13984823,13984846,23,1,0,0,2
13984823,13984847,24,1,0,0,1
13984847,13985076,229,0,0,1,2
13984848,13985076,228,0,0,1,1
13985077,13985087,10,1,0,0,1
13985077,13985090,13,1,0,0,2
13985088,13985866,778,0,0,1,1
13985091,13985216,125,0,0,1,2
13985217,13985232,15,1,0,0,2
13985233,13985872,639,0,0,1,2
13985867,13986049,182,1,0,0,1
13985873,13986028,155,1,0,0,2
13985900,13985975,75,0,1,0,1
13985901,13985984,83,0,1,0,2
13986029,13986546,517,0,0,1,2
13986050,13986553,503,0,0,1,1
13986547,13986559,12,1,0,0,2
13986554,13986558,4,1,0,0,1
13986559,13986693,134,0,0,1,1
13986560,13986693,133,0,0,1,2
13986694,13986805,111,1,0,0,2
13986694,13986806,112,1,0,0,1
13986806,13986942,136,0,0,1,2
13986807,13986942,135,0,0,1,1
13986943,13986967,24,1,0,0,1
13986943,13986967,24,1,0,0,2
13986968,13988337,1369,0,0,1,1
13986968,13988337,1369,0,0,1,2
13988338,13988406,68,1,0,0,1
13988338,13988418,80,1,0,0,2
13988407,13988545,138,0,0,1,1
13988419,13988544,125,0,0,1,2
13988545,13988563,18,1,0,0,2
13988546,13988588,42,1,0,0,1
13988564,13988764,200,0,0,1,2
13988589,13988771,182,0,0,1,1
13988765,13988994,229,1,0,0,2
13988772,13989002,230,1,0,0,1
13988796,13988931,135,0,1,0,1
13988798,13988936,138,0,1,0,2
13988995,13989692,697,0,0,1,2
13989003,13989696,693,0,0,1,1
13989693,13989774,81,1,0,0,2
13989697,13989764,67,1,0,0,1
13989765,13990072,307,0,0,1,1
13989775,13990070,295,0,0,1,2
13990071,13990399,328,1,0,0,2
13990073,13990362,289,1,0,0,1
13990143,13990388,245,0,1,0,2
13990152,13990178,26,0,1,0,1
13990363,13990387,24,0,0,1,1
13990388,13990396,8,1,0,0,1
13990397,13991434,1037,0,0,1,1
13990400,13991432,1032,0,0,1,2
13991433,13991501,68,1,0,0,2
13991435,13991513,78,1,0,0,1
13991502,13991922,420,0,0,1,2
13991514,13991921,407,0,0,1,1
13991922,13992018,96,1,0,0,1
13991923,13992017,94,1,0,0,2
13992018,13992132,114,0,0,1,2
13992019,13992128,109,0,0,1,1
13992129,13992166,37,1,0,0,1
13992133,13992167,34,1,0,0,2
13992167,13993679,1512,0,0,1,1
13992168,13993678,1510,0,0,1,2
13993679,13994030,351,1,0,0,2
13993680,13994027,347,1,0,0,1
13993700,13993941,241,0,1,0,1
13993701,13993973,272,0,1,0,2
13994028,13995536,1508,0,0,1,1
13994031,13994764,733,0,0,1,2
13994765,13994780,15,1,0,0,2
13994781,13995535,754,0,0,1,2
13995536,13995732,196,1,0,0,2
13995537,13995603,66,1,0,0,1
13995604,13995700,96,0,0,1,1
13995701,13995730,29,1,0,0,1
13995731,13996479,748,0,0,1,1
13995733,13995790,57,0,0,1,2
13995791,13995833,42,1,0,0,2
13995834,13997271,1437,0,0,1,2
13996480,13996484,4,1,0,0,1
13996485,13997270,785,0,0,1,1
13997271,13997335,64,1,0,0,1
13997272,13997338,66,1,0,0,2
13997336,13997501,165,0,0,1,1
13997339,13997488,149,0,0,1,2
13997489,13997517,28,1,0,0,2
13997502,13997506,4,1,0,0,1
13997507,13999048,1541,0,0,1,1
13997518,13999047,1529,0,0,1,2
13999048,13999140,92,1,0,0,2
13999049,13999133,84,1,0,0,1
13999134,13999230,96,0,0,1,1
13999141,13999228,87,0,0,1,2
13999229,13999253,24,1,0,0,2
13999231,13999253,22,1,0,0,1
13999254,13999398,144,0,0,1,1
13999254,13999401,147,0,0,1,2
13999399,13999429,30,1,0,0,1
13999402,13999427,25,1,0,0,2
13999428,14000860,1432,0,0,1,2
13999430,14000871,1441,0,0,1,1
14000861,14002075,1214,1,0,0,2
14000872,14002015,1143,1,0,0,1
14000890,14002004,1114,0,1,0,1
14000892,14002064,1172,0,1,0,2
14002016,14002645,629,0,0,1,1
14002076,14002309,233,0,0,1,2
14002310,14002326,16,1,0,0,2
14002327,14002642,315,0,0,1,2
14002643,14002865,222,1,0,0,2
14002646,14002729,83,1,0,0,1
14002730,14002824,94,0,0,1,1
14002825,14002859,34,1,0,0,1
14002860,14003062,202,0,0,1,1
14002866,14003416,550,0,0,1,2
14003063,14003072,9,1,0,0,1
14003073,14004355,1282,0,0,1,1
14003417,14003423,6,1,0,0,2
14003424,14004348,924,0,0,1,2
14004349,14004596,247,1,0,0,2
14004356,14004566,210,1,0,0,1
14004372,14004545,173,0,1,0,1
14004374,14004549,175,0,1,0,2
14004567,14004669,102,0,0,1,1
14004597,14004669,72,0,0,1,2
14004670,14004688,18,1,0,0,1
14004670,14004702,32,1,0,0,2
14004689,14005140,451,0,0,1,1
14004703,14005139,436,0,0,1,2
14005140,14005162,22,1,0,0,2
14005141,14005162,21,1,0,0,1
14005163,14006200,1037,0,0,1,1
14005163,14006200,1037,0,0,1,2
14006201,14006278,77,1,0,0,1
14006201,14006295,94,1,0,0,2
14006279,14006390,111,0,0,1,1
14006296,14006389,93,0,0,1,2
14006390,14006408,18,1,0,0,2
14006391,14006413,22,1,0,0,1
14006409,14008004,1595,0,0,1,2
14006414,14006586,172,0,0,1,1
14006587,14006598,11,1,0,0,1
14006599,14008015,1416,0,0,1,1
14008005,14008364,359,1,0,0,2
14008016,14008402,386,1,0,0,1
14008053,14008319,266,0,1,0,1
14008060,14008338,278,0,1,0,2
14008365,14008452,87,0,0,1,2
14008403,14008459,56,0,0,1,1
14008453,14008472,19,1,0,0,2
14008460,14008471,11,1,0,0,1
14008472,14009887,1415,0,0,1,1
14008473,14008677,204,0,0,1,2
14008678,14008689,11,1,0,0,2
14008690,14009888,1198,0,0,1,2
14009888,14009993,105,1,0,0,1
14009889,14010059,170,1,0,0,2
14009994,14010105,111,0,0,1,1
14010060,14010108,48,0,0,1,2
14010106,14010147,41,1,0,0,1
14010109,14010164,55,1,0,0,2
14010148,14010378,230,0,0,1,1
14010165,14010569,404,0,0,1,2
14010379,14010417,38,1,0,0,1
14010418,14011626,1208,0,0,1,1
14010570,14010584,14,1,0,0,2
14010585,14010641,56,0,0,1,2
14010642,14010657,15,1,0,0,2
14010658,14010785,127,0,0,1,2
14010786,14010947,161,1,0,0,2
14010948,14010987,39,0,0,1,2
14010988,14011037,49,1,0,0,2
14011038,14011128,90,0,0,1,2
14011129,14011181,52,1,0,0,2
14011182,14011259,77,0,0,1,2
14011260,14011334,74,1,0,0,2
14011335,14011393,58,0,0,1,2
14011394,14011468,74,1,0,0,2
14011469,14011625,156,0,0,1,2
14011626,14011720,94,1,0,0,2
14011627,14011722,95,1,0,0,1
14011721,14011888,167,0,0,1,2
14011723,14011887,164,0,0,1,1
14011888,14011903,15,1,0,0,1
14011889,14011897,8,1,0,0,2
14011898,14012966,1068,0,0,1,2
14011904,14013458,1554,0,0,1,1
14012967,14012983,16,1,0,0,2
14012984,14013026,42,0,0,1,2
14013027,14013152,125,1,0,0,2
14013153,14013293,140,0,0,1,2
14013294,14013310,16,1,0,0,2
14013311,14013362,51,0,0,1,2
14013363,14013437,74,1,0,0,2
14013438,14013460,22,0,0,1,2
14013459,14013986,527,1,0,0,1
14013461,14014807,1346,1,0,0,2
14013514,14013976,462,0,1,0,1
14013520,14014798,1278,0,1,0,2
14013987,14015184,1197,0,0,1,1
14014808,14015164,356,0,0,1,2
14015175,14015662,487,0,1,0,2
14015185,14015743,558,1,0,0,1
14015212,14015628,416,0,1,0,1
14015672,14015674,2,1,0,0,2
14015675,14015715,40,0,0,1,2
14015716,14015742,26,1,0,0,2
14015743,14015915,172,0,0,1,2
14015744,14015911,167,0,0,1,1
14015912,14015943,31,1,0,0,1
14015916,14015926,10,1,0,0,2
14015927,14017505,1578,0,0,1,2
14015944,14017502,1558,0,0,1,1
14017503,14017597,94,1,0,0,1
14017506,14017582,76,1,0,0,2
14017583,14017766,183,0,0,1,2
14017598,14017769,171,0,0,1,1
14017767,14017800,33,1,0,0,2
14017770,14017787,17,1,0,0,1
14017788,14019567,1779,0,0,1,1
14017801,14017983,182,0,0,1,2
14017984,14018061,77,1,0,0,2
14018062,14018220,158,0,0,1,2
14018221,14018249,28,1,0,0,2
14018250,14018581,331,0,0,1,2
14018582,14018611,29,1,0,0,2
14018612,14018659,47,0,0,1,2
14018660,14018712,52,1,0,0,2
14018713,14018752,39,0,0,1,2
14018753,14018796,43,1,0,0,2
14018797,14019556,759,0,0,1,2
14019557,14019832,275,1,0,0,2
14019568,14019790,222,1,0,0,1
14019583,14019765,182,0,1,0,1
14019584,14019776,192,0,1,0,2
14019791,14020764,973,0,0,1,1
14019833,14020462,629,0,0,1,2
14020463,14020526,63,1,0,0,2
14020527,14020615,88,0,0,1,2
14020616,14020629,13,1,0,0,2
14020630,14020763,133,0,0,1,2
14020764,14020839,75,1,0,0,2
14020765,14020836,71,1,0,0,1
14020837,14020926,89,0,0,1,1
14020840,14020892,52,0,0,1,2
14020903,14021000,97,0,1,0,2
14020927,14020981,54,1,0,0,1
14020982,14021167,185,0,0,1,1
14021009,14021009,0,1,0,0,2
14021010,14022180,1170,0,0,1,2
14021168,14021174,6,1,0,0,1
14021175,14022180,1005,0,0,1,1
14022181,14022240,59,1,0,0,1
14022181,14022290,109,1,0,0,2
14022241,14022456,215,0,0,1,1
14022291,14022455,164,0,0,1,2
14022456,14022474,18,1,0,0,2
14022457,14022485,28,1,0,0,1
14022475,14022628,153,0,0,1,2
14022486,14024303,1817,0,0,1,1
14022629,14022759,130,1,0,0,2
14022760,14023023,263,0,0,1,2
14023024,14023113,89,1,0,0,2
14023114,14023195,81,0,0,1,2
14023196,14023226,30,1,0,0,2
14023227,14023555,328,0,0,1,2
14023556,14023973,417,1,0,0,2
14023974,14023995,21,0,0,1,2
14023996,14024073,77,1,0,0,2
14024074,14024147,73,0,0,1,2
14024148,14024217,69,1,0,0,2
14024218,14024281,63,0,0,1,2
14024282,14024658,376,1,0,0,2
14024304,14024608,304,1,0,0,1
14024329,14024580,251,0,1,0,1
14024329,14024581,252,0,1,0,2
14024609,14025560,951,0,0,1,1
14024659,14025559,900,0,0,1,2
14025560,14025655,95,1,0,0,2
14025561,14025645,84,1,0,0,1
14025646,14025768,122,0,0,1,1
14025656,14025767,111,0,0,1,2
14025768,14025785,17,1,0,0,2
14025769,14025795,26,1,0,0,1
14025786,14027702,1916,0,0,1,2
14025796,14027702,1906,0,0,1,1
14027703,14027743,40,1,0,0,1
14027703,14027755,52,1,0,0,2
14027744,14027940,196,0,0,1,1
14027756,14027938,182,0,0,1,2
14027939,14027948,9,1,0,0,2
14027941,14027946,5,1,0,0,1
14027947,14028445,498,0,0,1,1
14027949,14028438,489,0,0,1,2
14028439,14028744,305,1,0,0,2
14028446,14028692,246,1,0,0,1
14028464,14028663,199,0,1,0,1
14028465,14028666,201,0,1,0,2
14028693,14029720,1027,0,0,1,1
14028745,14029700,955,0,0,1,2
14029701,14030007,306,1,0,0,2
14029721,14029963,242,1,0,0,1
14029743,14029942,199,0,1,0,2
14029746,14029940,194,0,1,0,1
14029964,14031717,1753,0,0,1,1
14030008,14031719,1711,0,0,1,2
14031718,14031810,92,1,0,0,1
14031720,14031808,88,1,0,0,2
14031809,14031897,88,0,0,1,2
14031811,14031901,90,0,0,1,1
14031898,14031927,29,1,0,0,2
14031902,14031923,21,1,0,0,1
14031924,14032141,217,0,0,1,1
14031928,14033388,1460,0,0,1,2
14032142,14032152,10,1,0,0,1
14032153,14033389,1236,0,0,1,1
14033389,14033694,305,1,0,0,2
14033390,14033657,267,1,0,0,1
14033459,14033627,168,0,1,0,1
14033461,14033636,175,0,1,0,2
14033658,14033756,98,0,0,1,1
14033695,14033756,61,0,0,1,2
14033757,14033778,21,1,0,0,1
14033757,14033781,24,1,0,0,2
14033779,14033940,161,0,0,1,1
14033782,14033943,161,0,0,1,2
14033941,14033972,31,1,0,0,1
14033944,14033972,28,1,0,0,2
14033973,14035380,1407,0,0,1,1
14033973,14035382,1409,0,0,1,2
14035381,14035776,395,1,0,0,1
14035383,14035799,416,1,0,0,2
14035415,14035746,331,0,1,0,1
14035415,14035788,373,0,1,0,2
14035777,14035898,121,0,0,1,1
14035800,14035896,96,0,0,1,2
14035897,14035942,45,1,0,0,2
14035899,14035930,31,1,0,0,1
14035931,14036224,293,0,0,1,1
14035943,14036222,279,0,0,1,2
14036223,14036392,169,1,0,0,2
14036225,14036397,172,1,0,0,1
14036247,14036336,89,0,1,0,1
14036249,14036347,98,0,1,0,2
14036393,14037030,637,0,0,1,2
14036398,14037031,633,0,0,1,1
14037031,14037127,96,1,0,0,2
14037032,14037114,82,1,0,0,1
14037115,14037278,163,0,0,1,1
14037128,14037274,146,0,0,1,2
14037275,14037294,19,1,0,0,2
14037279,14037304,25,1,0,0,1
14037295,14037489,194,0,0,1,2
14037305,14038937,1632,0,0,1,1
14037490,14037506,16,1,0,0,2
14037507,14038938,1431,0,0,1,2
14038938,14039016,78,1,0,0,1
14038939,14039009,70,1,0,0,2
14039010,14039168,158,0,0,1,2
14039017,14039169,152,0,0,1,1
14039169,14039197,28,1,0,0,2
14039170,14039188,18,1,0,0,1
14039189,14040973,1784,0,0,1,1
14039198,14040958,1760,0,0,1,2
14040959,14041320,361,1,0,0,2
14040974,14041292,318,1,0,0,1
14040998,14041249,251,0,1,0,1
14040998,14041272,274,0,1,0,2
14041293,14041585,292,0,0,1,1
14041321,14041573,252,0,0,1,2
14041574,14041875,301,1,0,0,2
14041586,14041818,232,1,0,0,1
14041599,14041800,201,0,1,0,2
14041601,14041803,202,0,1,0,1
14041819,14042718,899,0,0,1,1
14041876,14042720,844,0,0,1,2
14042719,14043268,549,1,0,0,1
14042721,14043943,1222,1,0,0,2
14042755,14043351,596,0,1,0,2
14042762,14043257,495,0,1,0,1
14043269,14044142,873,0,0,1,1
14043944,14043989,45,0,0,1,2
14043990,14044728,738,1,0,0,2
14044143,14044193,50,1,0,0,1
14044174,14044178,4,0,1,0,1
14044194,14044236,42,0,0,1,1
14044200,14044718,518,0,1,0,2
14044247,14044399,152,0,1,0,1
14044409,14044409,0,1,0,0,1
14044410,14044431,21,0,0,1,1
14044442,14044456,14,0,1,0,1
14044466,14044611,145,1,0,0,1
14044478,14044519,41,0,1,0,1
14044563,14044578,15,0,1,0,1
14044602,14044602,0,0,1,0,1
14044612,14046161,1549,0,0,1,1
14044729,14046164,1435,0,0,1,2
14046162,14046570,408,1,0,0,1
14046165,14046539,374,1,0,0,2
14046194,14046529,335,0,1,0,2
14046197,14046561,364,0,1,0,1
14046540,14047579,1039,0,0,1,2
14046571,14047578,1007,0,0,1,1
14047579,14047707,128,1,0,0,1
14047580,14047678,98,1,0,0,2
14047611,14047643,32,0,1,0,2
14047679,14047787,108,0,0,1,2
14047708,14047787,79,0,0,1,1
14047788,14047812,24,1,0,0,1
14047788,14047822,34,1,0,0,2
14047813,14049449,1636,0,0,1,1
14047823,14048037,214,0,0,1,2
14048038,14048042,4,1,0,0,2
14048043,14049448,1405,0,0,1,2
14049449,14049518,69,1,0,0,2
14049450,14049520,70,1,0,0,1
14049519,14049669,150,0,0,1,2
14049521,14049668,147,0,0,1,1
14049669,14049689,20,1,0,0,1
14049670,14049696,26,1,0,0,2
14049690,14051534,1844,0,0,1,1
14049697,14051536,1839,0,0,1,2
14051535,14051777,242,1,0,0,1
14051537,14051826,289,1,0,0,2
14051562,14051763,201,0,1,0,1
14051566,14051779,213,0,1,0,2
14051778,14051800,22,0,0,1,1
14051801,14051816,15,1,0,0,1
14051817,14053412,1595,0,0,1,1
14051827,14053411,1584,0,0,1,2
14053412,14053813,401,1,0,0,2
14053413,14053712,299,1,0,0,1
14053480,14053744,264,0,1,0,2
14053495,14053701,206,0,1,0,1
14053713,14054743,1030,0,0,1,1
14053814,14053991,177,0,0,1,2
14053992,14054119,127,1,0,0,2
14054120,14054278,158,0,0,1,2
14054279,14054380,101,1,0,0,2
14054381,14054442,61,0,0,1,2
14054443,14054485,42,1,0,0,2
14054486,14054740,254,0,0,1,2
14054741,14054794,53,1,0,0,2
14054744,14054793,49,1,0,0,1
14054794,14054983,189,0,0,1,1
14054795,14054994,199,0,0,1,2
14054984,14055009,25,1,0,0,1
14054995,14055009,14,1,0,0,2
14055010,14056725,1715,0,0,1,2
14055010,14056730,1720,0,0,1,1
14056726,14057516,790,1,0,0,2
14056731,14057464,733,1,0,0,1
14056758,14057463,705,0,1,0,2
14056759,14057453,694,0,1,0,1
14057465,14058063,598,0,0,1,1
14057517,14058063,546,0,0,1,2
14058064,14058161,97,1,0,0,1
14058064,14058161,97,1,0,0,2
14058162,14058264,102,0,0,1,2
14058162,14058267,105,0,0,1,1
14058265,14058295,30,1,0,0,2
14058268,14058292,24,1,0,0,1
14058293,14058445,152,0,0,1,1
14058296,14058442,146,0,0,1,2
14058443,14058508,65,1,0,0,2
14058446,14058460,14,1,0,0,1
14058461,14059700,1239,0,0,1,1
14058509,14059702,1193,0,0,1,2
14059701,14059779,78,1,0,0,1
14059703,14059778,75,1,0,0,2
14059779,14060700,921,0,0,1,2
14059780,14061751,1971,0,0,1,1
14060701,14060731,30,1,0,0,2
14060732,14061044,312,0,0,1,2
14061045,14061061,16,1,0,0,2
14061062,14061758,696,0,0,1,2
14061752,14062008,256,1,0,0,1
14061759,14062057,298,1,0,0,2
14061775,14061980,205,0,1,0,1
14061776,14061997,221,0,1,0,2
14062009,14063286,1277,0,0,1,1
14062058,14063286,1228,0,0,1,2
14063287,14063531,244,1,0,0,1
14063287,14063575,288,1,0,0,2
14063341,14063565,224,0,1,0,2
14063357,14063404,47,0,1,0,1
14063532,14064909,1377,0,0,1,1
14063576,14064908,1332,0,0,1,2
14064909,14064986,77,1,0,0,2
14064910,14064978,68,1,0,0,1
14064979,14065161,182,0,0,1,1
14064987,14065034,47,0,0,1,2
14065035,14065043,8,1,0,0,2
14065044,14065169,125,0,0,1,2
14065162,14065178,16,1,0,0,1
14065170,14065221,51,1,0,0,2
14065179,14065325,146,0,0,1,1
14065222,14065254,32,0,0,1,2
14065255,14065281,26,1,0,0,2
14065282,14065314,32,0,0,1,2
14065315,14065683,368,1,0,0,2
14065326,14065627,301,1,0,0,1
14065347,14065599,252,0,1,0,1
14065347,14065631,284,0,1,0,2
14065628,14067065,1437,0,0,1,1
14065684,14065730,46,0,0,1,2
14065731,14065755,24,1,0,0,2
14065756,14065984,228,0,0,1,2
14065985,14065994,9,1,0,0,2
14065995,14067065,1070,0,0,1,2
14067066,14067365,299,1,0,0,1
14067066,14067383,317,1,0,0,2
14067087,14067361,274,0,1,0,2
14067095,14067345,250,0,1,0,1
14067366,14068500,1134,0,0,1,1
14067384,14068502,1118,0,0,1,2
14068501,14068553,52,1,0,0,1
14068503,14068558,55,1,0,0,2
14068554,14068687,133,0,0,1,1
14068559,14068692,133,0,0,1,2
14068688,14068726,38,1,0,0,1
14068693,14068724,31,1,0,0,2
14068725,14069885,1160,0,0,1,2
14068727,14069884,1157,0,0,1,1
14069885,14069956,71,1,0,0,1
14069886,14069959,73,1,0,0,2
14069957,14070139,182,0,0,1,1
14069960,14070453,493,0,0,1,2
14070140,14070144,4,1,0,0,1
14070145,14071964,1819,0,0,1,1
14070454,14070561,107,1,0,0,2
14070562,14071940,1378,0,0,1,2
14071941,14072412,471,1,0,0,2
14071965,14072361,396,1,0,0,1
14071986,14072350,364,0,1,0,1
14071989,14072398,409,0,1,0,2
14072362,14072467,105,0,0,1,1
14072413,14072463,50,0,0,1,2
14072464,14072745,281,1,0,0,2
14072468,14072696,228,1,0,0,1
14072486,14072686,200,0,1,0,2
14072487,14072670,183,0,1,0,1
14072697,14073265,568,0,0,1,1
14072746,14072864,118,0,0,1,2
14072865,14072879,14,1,0,0,2
14072880,14072911,31,0,0,1,2
14072912,14072928,16,1,0,0,2
14072929,14072970,41,0,0,1,2
14072971,14073091,120,1,0,0,2
14073092,14073265,173,0,0,1,2
14073266,14073315,49,1,0,0,2
14073266,14073316,50,1,0,0,1
14073316,14073479,163,0,0,1,2
14073317,14074943,1626,0,0,1,1
14073480,14073518,38,1,0,0,2
14073519,14073569,50,0,0,1,2
14073570,14073703,133,1,0,0,2
14073704,14074944,1240,0,0,1,2
14074944,14074995,51,1,0,0,1
14074945,14074999,54,1,0,0,2
14074996,14077083,2087,0,0,1,1
14075000,14075547,547,0,0,1,2
14075548,14075558,10,1,0,0,2
14075559,14077093,1534,0,0,1,2
14077084,14077588,504,1,0,0,1
14077094,14077613,519,1,0,0,2
14077115,14077578,463,0,1,0,1
14077119,14077602,483,0,1,0,2
14077589,14078499,910,0,0,1,1
14077614,14078500,886,0,0,1,2
14078500,14078560,60,1,0,0,1
14078501,14078557,56,1,0,0,2
14078558,14078681,123,0,0,1,2
14078561,14078679,118,0,0,1,1
14078680,14078697,17,1,0,0,1
14078682,14078698,16,1,0,0,2
14078698,14080472,1774,0,0,1,1
14078699,14080471,1772,0,0,1,2
14080472,14080533,61,1,0,0,2
14080473,14080532,59,1,0,0,1
14080533,14080675,142,0,0,1,1
14080534,14080671,137,0,0,1,2
14080672,14080693,21,1,0,0,2
14080676,14080697,21,1,0,0,1
14080694,14081505,811,0,0,1,2
14080698,14082592,1894,0,0,1,1
14081506,14081535,29,1,0,0,2
14081536,14081613,77,0,0,1,2
14081614,14081640,26,1,0,0,2
14081641,14082581,940,0,0,1,2
14082582,14082901,319,1,0,0,2
14082593,14082879,286,1,0,0,1
14082613,14082849,236,0,1,0,1
14082617,14082874,257,0,1,0,2
14082880,14084235,1355,0,0,1,1
14082902,14083646,744,0,0,1,2
14083647,14083663,16,1,0,0,2
14083664,14083988,324,0,0,1,2
14083989,14084004,15,1,0,0,2
14084005,14084133,128,0,0,1,2
14084134,14084178,44,1,0,0,2
14084179,14084235,56,0,0,1,2
14084236,14084296,60,1,0,0,2
14084236,14084311,75,1,0,0,1
14084297,14084412,115,0,0,1,2
14084312,14084411,99,0,0,1,1
14084412,14084440,28,1,0,0,1
14084413,14084448,35,1,0,0,2
14084441,14086090,1649,0,0,1,1
14084449,14086089,1640,0,0,1,2
14086090,14086153,63,1,0,0,2
14086091,14086144,53,1,0,0,1
14086145,14086326,181,0,0,1,1
14086154,14086328,174,0,0,1,2
14086327,14086342,15,1,0,0,1
14086329,14086339,10,1,0,0,2
14086340,14088178,1838,0,0,1,2
14086343,14088175,1832,0,0,1,1
14088176,14088860,684,1,0,0,1
14088179,14088848,669,1,0,0,2
14088206,14088837,631,0,1,0,2
14088207,14088823,616,0,1,0,1
14088849,14089792,943,0,0,1,2
14088861,14089793,932,0,0,1,1
14089793,14089845,52,1,0,0,2
14089794,14089845,51,1,0,0,1
14089846,14089972,126,0,0,1,2
14089846,14089974,128,0,0,1,1
14089973,14089988,15,1,0,0,2
14089975,14089991,16,1,0,0,1
14089989,14091584,1595,0,0,1,2
14089992,14091582,1590,0,0,1,1
14091583,14091640,57,1,0,0,1
14091585,14091642,57,1,0,0,2
14091641,14091768,127,0,0,1,1
14091643,14091767,124,0,0,1,2
14091768,14091784,16,1,0,0,2
14091769,14091803,34,1,0,0,1
14091785,14093764,1979,0,0,1,2
14091804,14093762,1958,0,0,1,1
14093763,14094260,497,1,0,0,1
14093765,14094282,517,1,0,0,2
14093786,14094249,463,0,1,0,1
14093788,14094271,483,0,1,0,2
14094261,14095341,1080,0,0,1,1
14094283,14095339,1056,0,0,1,2
14095340,14095407,67,1,0,0,2
14095342,14095407,65,1,0,0,1
14095408,14095515,107,0,0,1,2
14095408,14095516,108,0,0,1,1
14095516,14095559,43,1,0,0,2
14095517,14095543,26,1,0,0,1
14095544,14096739,1195,0,0,1,1
14095560,14095909,349,0,0,1,2
14095910,14095994,84,1,0,0,2
14095995,14096104,109,0,0,1,2
14096105,14096655,550,1,0,0,2
14096656,14096738,82,0,0,1,2
14096739,14096825,86,1,0,0,2
14096740,14096812,72,1,0,0,1
14096813,14098804,1991,0,0,1,1
14096826,14098806,1980,0,0,1,2
14098805,14099364,559,1,0,0,1
14098807,14099373,566,1,0,0,2
14098843,14099338,495,0,1,0,1
14098843,14099362,519,0,1,0,2
14099365,14100085,720,0,0,1,1
14099374,14100084,710,0,0,1,2
14100085,14100116,31,1,0,0,2
14100086,14100128,42,1,0,0,1
14100117,14101732,1615,0,0,1,2
14100129,14101731,1602,0,0,1,1
14101732,14101810,78,1,0,0,1
14101733,14101815,82,1,0,0,2
14101811,14103756,1945,0,0,1,1
14101816,14101853,37,0,0,1,2
14101854,14101876,22,1,0,0,2
14101877,14102181,304,0,0,1,2
14102182,14102249,67,1,0,0,2
14102250,14102602,352,0,0,1,2
14102603,14102740,137,1,0,0,2
14102741,14102870,129,0,0,1,2
14102871,14102914,43,1,0,0,2
14102915,14103166,251,0,0,1,2
14103167,14103224,57,1,0,0,2
14103225,14103284,59,0,0,1,2
14103285,14103646,361,1,0,0,2
14103647,14103723,76,0,0,1,2
14103724,14104186,462,1,0,0,2
14103757,14104083,326,1,0,0,1
14103776,14104051,275,0,1,0,1
14103777,14104064,287,0,1,0,2
14104084,14104113,29,0,0,1,1
14104114,14104129,15,1,0,0,1
14104130,14105429,1299,0,0,1,1
14104187,14104364,177,0,0,1,2
14104365,14104408,43,1,0,0,2
14104409,14104464,55,0,0,1,2
14104465,14105266,801,1,0,0,2
14105267,14105430,163,0,0,1,2
14105430,14105679,249,1,0,0,1
14105431,14106170,739,1,0,0,2
14105483,14106160,677,0,1,0,2
14105487,14105669,182,0,1,0,1
14105680,14105870,190,0,0,1,1
14105871,14105881,10,1,0,0,1
14105882,14106749,867,0,0,1,1
14106171,14106749,578,0,0,1,2
14106750,14106823,73,1,0,0,1
14106750,14106859,109,1,0,0,2
14106802,14106849,47,0,1,0,2
14106824,14106993,169,0,0,1,1
14106860,14106995,135,0,0,1,2
14106994,14107017,23,1,0,0,1
14106996,14107027,31,1,0,0,2
14107018,14108781,1763,0,0,1,1
14107028,14108791,1763,0,0,1,2
14108782,14109368,586,1,0,0,1
14108792,14109414,622,1,0,0,2
14108810,14109404,594,0,1,0,2
14108820,14109348,528,0,1,0,1
14109369,14110038,669,0,0,1,1
14109415,14110036,621,0,0,1,2
14110037,14110139,102,1,0,0,2
14110039,14110102,63,1,0,0,1
14110103,14110294,191,0,0,1,1
14110140,14110302,162,0,0,1,2
14110295,14110315,20,1,0,0,1
14110303,14110307,4,1,0,0,2
14110308,14110664,356,0,0,1,2
14110316,14110660,344,0,0,1,1
14110661,14110681,20,1,0,0,1
14110665,14110709,44,1,0,0,2
14110682,14111948,1266,0,0,1,1
14110710,14110841,131,0,0,1,2
14110842,14110877,35,1,0,0,2
14110878,14110954,76,0,0,1,2
14110955,14110959,4,1,0,0,2
14110960,14111948,988,0,0,1,2
14111949,14112002,53,1,0,0,1
14111949,14112002,53,1,0,0,2
14112003,14112967,964,0,0,1,1
14112003,14112974,971,0,0,1,2
14112968,14112990,22,1,0,0,1
14112975,14112979,4,1,0,0,2
14112980,14114052,1072,0,0,1,2
14112991,14114046,1055,0,0,1,1
14114047,14114381,334,1,0,0,1
14114053,14114407,354,1,0,0,2
14114082,14114358,276,0,1,0,1
14114084,14114361,277,0,1,0,2
14114382,14115758,1376,0,0,1,1
14114408,14115754,1346,0,0,1,2
14115755,14116029,274,1,0,0,2
14115759,14116056,297,1,0,0,1
14115821,14116018,197,0,1,0,2
14115840,14115844,4,0,1,0,1
14116030,14116147,117,0,0,1,2
14116057,14116145,88,0,0,1,1
14116146,14116155,9,1,0,0,1
14116148,14116152,4,1,0,0,2
14116153,14117774,1621,0,0,1,2
14116156,14117773,1617,0,0,1,1
14117774,14117828,54,1,0,0,1
14117775,14117847,72,1,0,0,2
14117829,14117985,156,0,0,1,1
14117848,14117986,138,0,0,1,2
14117986,14117997,11,1,0,0,1
14117987,14117997,10,1,0,0,2
14117998,14119753,1755,0,0,1,1
14117998,14119756,1758,0,0,1,2
14119754,14120133,379,1,0,0,1
14119757,14120170,413,1,0,0,2
14119786,14120159,373,0,1,0,2
14119789,14120119,330,0,1,0,1
14120134,14121396,1262,0,0,1,1
14120171,14121394,1223,0,0,1,2
14121395,14121528,133,1,0,0,2
14121397,14121507,110,1,0,0,1
14121508,14121596,88,0,0,1,1
14121529,14121594,65,0,0,1,2
14121595,14121633,38,1,0,0,2
14121597,14121641,44,1,0,0,1
14121634,14123101,1467,0,0,1,2
14121642,14121850,208,0,0,1,1
14121851,14121866,15,1,0,0,1
14121867,14123101,1234,0,0,1,1
14123102,14123147,45,1,0,0,1
14123102,14123149,47,1,0,0,2
14123148,14123312,164,0,0,1,1
14123150,14123310,160,0,0,1,2
14123311,14123329,18,1,0,0,2
14123313,14123330,17,1,0,0,1
14123330,14125134,1804,0,0,1,2
14123331,14123545,214,0,0,1,1
14123546,14123565,19,1,0,0,1
14123566,14125151,1585,0,0,1,1
14125135,14125570,435,1,0,0,2
14125152,14125468,316,1,0,0,1
14125169,14125452,283,0,1,0,2
14125172,14125432,260,0,1,0,1
14125469,14125512,43,0,0,1,1
14125513,14125517,4,1,0,0,1
14125518,14126826,1308,0,0,1,1
14125571,14126826,1255,0,0,1,2
14126827,14126888,61,1,0,0,1
14126827,14126898,71,1,0,0,2
14126889,14127008,119,0,0,1,1
14126899,14127009,110,0,0,1,2
14127009,14127037,28,1,0,0,1
14127010,14127040,30,1,0,0,2
14127038,14127625,587,0,0,1,1
14127041,14127637,596,0,0,1,2
14127626,14127657,31,1,0,0,1
14127638,14127642,4,1,0,0,2
14127643,14128754,1111,0,0,1,2
14127658,14128755,1097,0,0,1,1
14128755,14128833,78,1,0,0,2
14128756,14128820,64,1,0,0,1
14128821,14128941,120,0,0,1,1
14128834,14128941,107,0,0,1,2
14128942,14128972,30,1,0,0,1
14128942,14128974,32,1,0,0,2
14128973,14129634,661,0,0,1,1
14128975,14130976,2001,0,0,1,2
14129635,14129639,4,1,0,0,1
14129640,14130980,1340,0,0,1,1
14130977,14131299,322,1,0,0,2
14130981,14131278,297,1,0,0,1
14131017,14131259,242,0,1,0,2
14131018,14131247,229,0,1,0,1
14131279,14131338,59,0,0,1,1
14131300,14131328,28,0,0,1,2
14131329,14131549,220,1,0,0,2
14131339,14131536,197,1,0,0,1
14131353,14131504,151,0,1,0,2
14131357,14131490,133,0,1,0,1
14131537,14132787,1250,0,0,1,1
14131550,14132786,1236,0,0,1,2
14132787,14133109,322,1,0,0,2
14132788,14132845,57,1,0,0,1
14132846,14132960,114,0,0,1,1
14132961,14132982,21,1,0,0,1
14132983,14134296,1313,0,0,1,1
14133110,14133144,34,0,0,1,2
14133145,14133169,24,1,0,0,2
14133170,14133367,197,0,0,1,2
14133368,14133436,68,1,0,0,2
14133437,14133491,54,0,0,1,2
14133492,14133838,346,1,0,0,2
14133839,14133883,44,0,0,1,2
14133884,14133958,74,1,0,0,2
14133959,14133994,35,0,0,1,2
14133995,14134105,110,1,0,0,2
14134106,14134296,190,0,0,1,2
14134297,14134351,54,1,0,0,1
14134297,14134379,82,1,0,0,2
14134352,14134566,214,0,0,1,1
14134380,14134490,110,0,0,1,2
14134491,14134540,49,1,0,0,2
14134541,14134570,29,0,0,1,2
14134567,14134582,15,1,0,0,1
14134571,14134613,42,1,0,0,2
14134583,14136214,1631,0,0,1,1
14134614,14135644,1030,0,0,1,2
14135645,14135738,93,1,0,0,2
14135739,14135862,123,0,0,1,2
14135863,14135978,115,1,0,0,2
14135979,14136203,224,0,0,1,2
14136204,14136577,373,1,0,0,2
14136215,14136545,330,1,0,0,1
14136252,14136542,290,0,1,0,2
14136260,14136518,258,0,1,0,1
14136546,14136625,79,0,0,1,1
14136578,14136626,48,0,0,1,2
14136626,14136652,26,1,0,0,1
14136627,14136663,36,1,0,0,2
14136653,14136952,299,0,0,1,1
14136664,14136713,49,0,0,1,2
14136714,14136756,42,1,0,0,2
14136757,14136810,53,0,0,1,2
14136811,14137239,428,1,0,0,2
14136953,14137173,220,1,0,0,1
14136972,14137134,162,0,1,0,1
14136972,14137148,176,0,1,0,2
14137174,14137576,402,0,0,1,1
14137240,14137386,146,0,0,1,2
14137387,14137678,291,1,0,0,2
14137577,14137647,70,1,0,0,1
14137648,14137760,112,0,0,1,1
14137679,14137759,80,0,0,1,2
14137760,14137796,36,1,0,0,2
14137761,14137789,28,1,0,0,1
14137790,14139445,1655,0,0,1,1
14137797,14139445,1648,0,0,1,2
14139446,14139497,51,1,0,0,1
14139446,14139500,54,1,0,0,2
14139498,14139871,373,0,0,1,1
14139501,14139884,383,0,0,1,2
14139872,14140276,404,1,0,0,1
14139885,14140294,409,1,0,0,2
14139911,14140284,373,0,1,0,2
14139919,14140258,339,0,1,0,1
14140277,14141611,1334,0,0,1,1
14140295,14141613,1318,0,0,1,2
14141612,14142005,393,1,0,0,1
14141614,14141981,367,1,0,0,2
14141636,14141971,335,0,1,0,2
14141645,14141976,331,0,1,0,1
14141982,14143413,1431,0,0,1,2
14142006,14143415,1409,0,0,1,1
14143414,14143507,93,1,0,0,2
14143416,14143503,87,1,0,0,1
14143504,14143601,97,0,0,1,1
14143508,14143599,91,0,0,1,2
14143600,14143631,31,1,0,0,2
14143602,14143631,29,1,0,0,1
14143632,14143669,37,0,0,1,2
14143632,14143671,39,0,0,1,1
14143670,14143933,263,1,0,0,2
14143672,14143917,245,1,0,0,1
14143695,14143892,197,0,1,0,2
14143698,14143881,183,0,1,0,1
14143918,14144015,97,0,0,1,1
14143934,14144014,80,0,0,1,2
14144015,14144037,22,1,0,0,2
14144016,14144037,21,1,0,0,1
14144038,14145503,1465,0,0,1,1
14144038,14145504,1466,0,0,1,2
14145504,14145571,67,1,0,0,1
14145505,14145574,69,1,0,0,2
14145572,14145657,85,0,0,1,1
14145575,14145657,82,0,0,1,2
14145658,14145682,24,1,0,0,2
14145658,14145690,32,1,0,0,1
14145683,14146401,718,0,0,1,2
14145691,14147544,1853,0,0,1,1
14146402,14146589,187,1,0,0,2
14146590,14146628,38,0,0,1,2
14146629,14146812,183,1,0,0,2
14146813,14147548,735,0,0,1,2
14147545,14148143,598,1,0,0,1
14147549,14148175,626,1,0,0,2
14147568,14148130,562,0,1,0,1
14147570,14148164,594,0,1,0,2
14148144,14149453,1309,0,0,1,1
14148176,14149450,1274,0,0,1,2
14149451,14149500,49,1,0,0,2
14149454,14149522,68,1,0,0,1
14149501,14149596,95,0,0,1,2
14149523,14149630,107,0,0,1,1
14149597,14149727,130,1,0,0,2
14149631,14149653,22,1,0,0,1
14149654,14151275,1621,0,0,1,1
14149728,14149864,136,0,0,1,2
14149865,14149878,13,1,0,0,2
14149879,14151273,1394,0,0,1,2
14151274,14151332,58,1,0,0,2
14151276,14151325,49,1,0,0,1
14151326,14151471,145,0,0,1,1
14151333,14151470,137,0,0,1,2
14151471,14151494,23,1,0,0,2
14151472,14151493,21,1,0,0,1
14151494,14153392,1898,0,0,1,1
14151495,14153392,1897,0,0,1,2
14153393,14153960,567,1,0,0,1
14153393,14153976,583,1,0,0,2
14153420,14153949,529,0,1,0,1
14153421,14153941,520,0,1,0,2
14153961,14155245,1284,0,0,1,1
14153977,14155244,1267,0,0,1,2
14155245,14155571,326,1,0,0,2
14155246,14155369,123,1,0,0,1
14155329,14155562,233,0,1,0,2
14155370,14155404,34,0,0,1,1
14155405,14155485,80,1,0,0,1
14155486,14155522,36,0,0,1,1
14155523,14155564,41,1,0,0,1
14155565,14157249,1684,0,0,1,1
14155572,14157245,1673,0,0,1,2
14157246,14157326,80,1,0,0,2
14157250,14157326,76,1,0,0,1
14157327,14157463,136,0,0,1,1
14157327,14157463,136,0,0,1,2
14157464,14157485,21,1,0,0,2
14157464,14157493,29,1,0,0,1
14157486,14159337,1851,0,0,1,2
14157494,14159325,1831,0,0,1,1
14159326,14160173,847,1,0,0,1
14159338,14160207,869,1,0,0,2
14159370,14160111,741,0,1,0,2
14159373,14160067,694,0,1,0,1
14160174,14161047,873,0,0,1,1
14160208,14160245,37,0,0,1,2
14160246,14160255,9,1,0,0,2
14160256,14160285,29,0,0,1,2
14160286,14160317,31,1,0,0,2
14160318,14160673,355,0,0,1,2
14160674,14160712,38,1,0,0,2
14160713,14160798,85,0,0,1,2
14160799,14160831,32,1,0,0,2
14160832,14161044,212,0,0,1,2
14161045,14161135,90,1,0,0,2
14161048,14161101,53,1,0,0,1
14161102,14161229,127,0,0,1,1
14161136,14161223,87,0,0,1,2
14161224,14161235,11,1,0,0,2
14161230,14161241,11,1,0,0,1
14161236,14162167,931,0,0,1,2
14161242,14162486,1244,0,0,1,1
14162168,14162177,9,1,0,0,2
14162178,14162535,357,0,0,1,2
14162487,14162491,4,1,0,0,1
14162492,14162590,98,0,0,1,1
14162536,14162551,15,1,0,0,2
14162552,14162588,36,0,0,1,2
14162589,14162673,84,1,0,0,2
14162591,14162665,74,1,0,0,1
14162666,14162813,147,0,0,1,1
14162674,14162816,142,0,0,1,2
14162814,14162833,19,1,0,0,1
14162817,14162833,16,1,0,0,2
14162834,14164679,1845,0,0,1,2
14162834,14164695,1861,0,0,1,1
14164680,14165415,735,1,0,0,2
14164696,14165360,664,1,0,0,1
14164720,14165350,630,0,1,0,2
14164722,14165350,628,0,1,0,1
14165361,14166136,775,0,0,1,1
14165416,14165467,51,0,0,1,2
14165468,14165587,119,1,0,0,2
14165588,14165733,145,0,0,1,2
14165734,14165847,113,1,0,0,2
14165848,14165873,25,0,0,1,2
14165874,14166032,158,1,0,0,2
14166033,14166136,103,0,0,1,2
