start,end,duration,saccade,blink,fixation,eye
1529697,1529877,180,0,0,1,2
1529697,1529882,185,0,0,1,1
1529878,1529922,44,1,0,0,2
1529883,1529921,38,1,0,0,1
1529922,1530067,145,0,0,1,1
1529923,1530066,143,0,0,1,2
1530067,1530126,59,1,0,0,2
1530068,1530137,69,1,0,0,1
1530127,1530264,137,0,0,1,2
1530138,1530263,125,0,0,1,1
1530264,1530295,31,1,0,0,1
1530265,1530294,29,1,0,0,2
1530295,1530737,442,0,0,1,2
1530296,1530741,445,0,0,1,1
1530738,1530765,27,1,0,0,2
1530742,1530766,24,1,0,0,1
1530766,1531445,679,0,0,1,2
1530767,1531446,679,0,0,1,1
1531446,1531480,34,1,0,0,2
1531447,1531490,43,1,0,0,1
1531481,1534461,2980,0,0,1,2
1531491,1534459,2968,0,0,1,1
1534460,1534490,30,1,0,0,1
1534462,1534489,27,1,0,0,2
1534490,1536740,2250,0,0,1,2
1534491,1536740,2249,0,0,1,1
1536741,1536836,95,1,0,0,1
1536741,1536836,95,1,0,0,2
1536837,1536917,80,0,0,1,1
1536837,1536920,83,0,0,1,2
1536918,1536966,48,1,0,0,1
1536921,1536956,35,1,0,0,2
1536957,1540110,3153,0,0,1,2
1536967,1540110,3143,0,0,1,1
1540111,1540205,94,1,0,0,2
1540111,1540209,98,1,0,0,1
1540206,1540488,282,0,0,1,2
1540210,1540488,278,0,0,1,1
1540489,1540544,55,1,0,0,2
1540489,1540553,64,1,0,0,1
1540545,1540629,84,0,0,1,2
1540554,1540628,74,0,0,1,1
1540629,1540661,32,1,0,0,1
1540630,1540661,31,1,0,0,2
1540662,1541595,933,0,0,1,1
1540662,1541596,934,0,0,1,2
1541596,1541630,34,1,0,0,1
1541597,1541630,33,1,0,0,2
1541631,1541727,96,0,0,1,1
1541631,1541729,98,0,0,1,2
1541728,1541759,31,1,0,0,1
1541730,1541763,33,1,0,0,2
1541760,1541947,187,0,0,1,1
1541764,1541953,189,0,0,1,2
1541948,1541975,27,1,0,0,1
1541954,1541988,34,1,0,0,2
1541976,1542749,773,0,0,1,1
1541989,1542745,756,0,0,1,2
1542746,1542817,71,1,0,0,2
1542750,1542814,64,1,0,0,1
1542815,1543074,259,0,0,1,1
1542818,1543074,256,0,0,1,2
1543075,1543131,56,1,0,0,1
1543075,1543131,56,1,0,0,2
1543132,1543204,72,0,0,1,1
1543132,1543205,73,0,0,1,2
1543205,1543286,81,1,0,0,1
1543206,1543278,72,1,0,0,2
1543279,1543369,90,0,0,1,2
1543287,1543369,82,0,0,1,1
1543370,1543395,25,1,0,0,1
1543370,1543406,36,1,0,0,2
1543396,1543974,578,0,0,1,1
1543407,1543972,565,0,0,1,2
1543973,1544008,35,1,0,0,2
1543975,1544016,41,1,0,0,1
1544009,1544155,146,0,0,1,2
1544017,1544154,137,0,0,1,1
1544155,1544189,34,1,0,0,1
1544156,1544173,17,1,0,0,2
1544174,1544684,510,0,0,1,2
1544190,1544682,492,0,0,1,1
1544683,1544732,49,1,0,0,1
1544685,1544716,31,1,0,0,2
1544717,1544913,196,0,0,1,2
1544733,1544914,181,0,0,1,1
1544914,1544944,30,1,0,0,2
1544915,1544961,46,1,0,0,1
1544945,1545813,868,0,0,1,2
1544962,1545813,851,0,0,1,1
1545814,1545871,57,1,0,0,1
1545814,1545876,62,1,0,0,2
1545872,1545965,93,0,0,1,1
1545877,1545965,88,0,0,1,2
1545966,1545991,25,1,0,0,2
1545966,1545998,32,1,0,0,1
1545992,1546215,223,0,0,1,2
1545999,1546214,215,0,0,1,1
1546215,1546244,29,1,0,0,1
1546216,1546243,27,1,0,0,2
1546244,1546370,126,0,0,1,2
1546245,1546369,124,0,0,1,1
1546370,1546396,26,1,0,0,1
1546371,1546396,25,1,0,0,2
1546397,1546660,263,0,0,1,2
1546397,1546663,266,0,0,1,1
1546661,1546685,24,1,0,0,2
1546664,1546684,20,1,0,0,1
1546685,1548320,1635,0,0,1,1
1546686,1548320,1634,0,0,1,2
1548321,1548380,59,1,0,0,2
1548321,1548386,65,1,0,0,1
1548381,1548595,214,0,0,1,2
1548387,1548593,206,0,0,1,1
1548594,1548623,29,1,0,0,1
1548596,1548625,29,1,0,0,2
1548624,1548731,107,0,0,1,1
1548626,1548731,105,0,0,1,2
1548732,1548752,20,1,0,0,1
1548732,1548757,25,1,0,0,2
1548753,1550726,1973,0,0,1,1
1548758,1550726,1968,0,0,1,2
1550727,1550799,72,1,0,0,1
1550727,1550807,80,1,0,0,2
1550800,1551138,338,0,0,1,1
1550808,1551137,329,0,0,1,2
1551138,1551220,82,1,0,0,2
1551139,1551214,75,1,0,0,1
1551215,1551303,88,0,0,1,1
1551221,1551307,86,0,0,1,2
1551304,1551319,15,1,0,0,1
1551308,1551320,12,1,0,0,2
1551320,1551522,202,0,0,1,1
1551321,1551524,203,0,0,1,2
1551523,1551551,28,1,0,0,1
1551525,1551577,52,1,0,0,2
1551552,1552016,464,0,0,1,1
1551578,1552016,438,0,0,1,2
1552017,1552048,31,1,0,0,1
1552017,1552049,32,1,0,0,2
1552049,1553974,1925,0,0,1,1
1552050,1552437,387,0,0,1,2
1552438,1552444,6,1,0,0,2
1552445,1553159,714,0,0,1,2
1553160,1553174,14,1,0,0,2
1553175,1553265,90,0,0,1,2
1553266,1553280,14,1,0,0,2
1553281,1553975,694,0,0,1,2
1553975,1554048,73,1,0,0,1
1553976,1554050,74,1,0,0,2
1554049,1554350,301,0,0,1,1
1554051,1554350,299,0,0,1,2
1554351,1554417,66,1,0,0,1
1554351,1554424,73,1,0,0,2
1554418,1554498,80,0,0,1,1
1554425,1554498,73,0,0,1,2
1554499,1554542,43,1,0,0,1
1554499,1554544,45,1,0,0,2
1554543,1554605,62,0,0,1,1
1554545,1555829,1284,0,0,1,2
1554606,1554623,17,1,0,0,1
1554624,1555828,1204,0,0,1,1
1555829,1555862,33,1,0,0,1
1555830,1555861,31,1,0,0,2
1555862,1557707,1845,0,0,1,2
1555863,1557709,1846,0,0,1,1
1557708,1557777,69,1,0,0,2
1557710,1557787,77,1,0,0,1
1557778,1557876,98,0,0,1,2
1557788,1557875,87,0,0,1,1
1557876,1557950,74,1,0,0,1
1557877,1557963,86,1,0,0,2
1557951,1558068,117,0,0,1,1
1557964,1558070,106,0,0,1,2
1558069,1558091,22,1,0,0,1
1558071,1558092,21,1,0,0,2
1558092,1559131,1039,0,0,1,1
1558093,1559134,1041,0,0,1,2
1559132,1559158,26,1,0,0,1
1559135,1559150,15,1,0,0,2
1559151,1559776,625,0,0,1,2
1559159,1559777,618,0,0,1,1
1559777,1559839,62,1,0,0,2
1559778,1559838,60,1,0,0,1
1559839,1560088,249,0,0,1,1
1559840,1560087,247,0,0,1,2
1560088,1560154,66,1,0,0,2
1560089,1560165,76,1,0,0,1
1560155,1560387,232,0,0,1,2
1560166,1560386,220,0,0,1,1
1560387,1560426,39,1,0,0,1
1560388,1560418,30,1,0,0,2
1560419,1560959,540,0,0,1,2
1560427,1560960,533,0,0,1,1
1560960,1560992,32,1,0,0,2
1560961,1560992,31,1,0,0,1
1560993,1561457,464,0,0,1,2
1560993,1561767,774,0,0,1,1
1561458,1561471,13,1,0,0,2
1561472,1561765,293,0,0,1,2
1561766,1561799,33,1,0,0,2
1561768,1561799,31,1,0,0,1
1561800,1561946,146,0,0,1,2
1561800,1561949,149,0,0,1,1
1561947,1561976,29,1,0,0,2
1561950,1561977,27,1,0,0,1
1561977,1562692,715,0,0,1,2
1561978,1562696,718,0,0,1,1
1562693,1562763,70,1,0,0,2
1562697,1562753,56,1,0,0,1
1562754,1563112,358,0,0,1,1
1562764,1563113,349,0,0,1,2
1563113,1563175,62,1,0,0,1
1563114,1563167,53,1,0,0,2
1563168,1563255,87,0,0,1,2
1563176,1563255,79,0,0,1,1
1563256,1563286,30,1,0,0,2
1563256,1563287,31,1,0,0,1
1563287,1563533,246,0,0,1,2
1563288,1563532,244,0,0,1,1
1563533,1563565,32,1,0,0,1
1563534,1563564,30,1,0,0,2
1563565,1564086,521,0,0,1,2
1563566,1564087,521,0,0,1,1
1564087,1564118,31,1,0,0,2
1564088,1564118,30,1,0,0,1
1564119,1565923,1804,0,0,1,1
1564119,1565923,1804,0,0,1,2
1565924,1566007,83,1,0,0,2
1565924,1566008,84,1,0,0,1
1566008,1566084,76,0,0,1,2
1566009,1566085,76,0,0,1,1
1566085,1566136,51,1,0,0,2
1566086,1566135,49,1,0,0,1
1566136,1566486,350,0,0,1,1
1566137,1566489,352,0,0,1,2
1566487,1566520,33,1,0,0,1
1566490,1566517,27,1,0,0,2
1566518,1567719,1201,0,0,1,2
1566521,1567719,1198,0,0,1,1
1567720,1567788,68,1,0,0,1
1567720,1567793,73,1,0,0,2
1567789,1568076,287,0,0,1,1
1567794,1568078,284,0,0,1,2
1568077,1568130,53,1,0,0,1
1568079,1568130,51,1,0,0,2
1568131,1568185,54,0,0,1,1
1568131,1568187,56,0,0,1,2
1568186,1568251,65,1,0,0,1
1568188,1568259,71,1,0,0,2
1568252,1568362,110,0,0,1,1
1568260,1568364,104,0,0,1,2
1568363,1568385,22,1,0,0,1
1568365,1568392,27,1,0,0,2
1568386,1569553,1167,0,0,1,1
1568393,1569274,881,0,0,1,2
1569275,1569293,18,1,0,0,2
1569294,1569555,261,0,0,1,2
1569554,1569630,76,1,0,0,1
1569556,1569621,65,1,0,0,2
1569622,1569949,327,0,0,1,2
1569631,1569950,319,0,0,1,1
1569950,1570014,64,1,0,0,2
1569951,1570026,75,1,0,0,1
1570015,1570135,120,0,0,1,2
1570027,1570134,107,0,0,1,1
1570135,1570165,30,1,0,0,1
1570136,1570165,29,1,0,0,2
1570166,1571146,980,0,0,1,2
1570166,1571149,983,0,0,1,1
1571147,1571171,24,1,0,0,2
1571150,1571169,19,1,0,0,1
1571170,1571765,595,0,0,1,1
1571172,1571766,594,0,0,1,2
1571766,1571830,64,1,0,0,1
1571767,1571844,77,1,0,0,2
1571831,1572158,327,0,0,1,1
1571845,1572160,315,0,0,1,2
1572159,1572228,69,1,0,0,1
1572161,1572228,67,1,0,0,2
1572229,1572378,149,0,0,1,2
1572229,1572379,150,0,0,1,1
1572379,1572399,20,1,0,0,2
1572380,1572396,16,1,0,0,1
1572397,1572656,259,0,0,1,1
1572400,1572650,250,0,0,1,2
1572651,1572690,39,1,0,0,2
1572657,1572674,17,1,0,0,1
1572675,1574067,1392,0,0,1,1
1572691,1574067,1376,0,0,1,2
1574068,1574114,46,1,0,0,1
1574068,1574123,55,1,0,0,2
1574115,1574177,62,0,0,1,1
1574124,1574175,51,0,0,1,2
1574176,1574235,59,1,0,0,2
1574178,1574235,57,1,0,0,1
1574236,1574385,149,0,0,1,1
1574236,1574385,149,0,0,1,2
1574386,1574438,52,1,0,0,1
1574386,1574439,53,1,0,0,2
1574439,1574614,175,0,0,1,1
1574440,1574615,175,0,0,1,2
1574615,1574645,30,1,0,0,1
1574616,1574644,28,1,0,0,2
1574645,1574948,303,0,0,1,2
1574646,1574946,300,0,0,1,1
1574947,1574978,31,1,0,0,1
1574949,1574975,26,1,0,0,2
1574976,1575817,841,0,0,1,2
1574979,1575816,837,0,0,1,1
1575817,1575849,32,1,0,0,1
1575818,1575852,34,1,0,0,2
1575850,1576567,717,0,0,1,1
1575853,1576566,713,0,0,1,2
1576567,1576633,66,1,0,0,2
1576568,1576641,73,1,0,0,1
1576634,1576842,208,0,0,1,2
1576642,1576842,200,0,0,1,1
1576843,1576870,27,1,0,0,2
1576843,1576879,36,1,0,0,1
1576871,1577156,285,0,0,1,2
1576880,1577151,271,0,0,1,1
1577152,1577179,27,1,0,0,1
1577157,1577178,21,1,0,0,2
1577179,1578330,1151,0,0,1,2
1577180,1578331,1151,0,0,1,1
1578331,1578407,76,1,0,0,2
1578332,1578404,72,1,0,0,1
1578405,1578748,343,0,0,1,1
1578408,1578751,343,0,0,1,2
1578749,1578822,73,1,0,0,1
1578752,1578822,70,1,0,0,2
1578823,1578954,131,0,0,1,1
1578823,1578954,131,0,0,1,2
1578955,1578981,26,1,0,0,1
1578955,1578981,26,1,0,0,2
1578982,1579429,447,0,0,1,1
1578982,1579429,447,0,0,1,2
1579430,1579461,31,1,0,0,1
1579430,1579487,57,1,0,0,2
1579462,1580200,738,0,0,1,1
1579488,1580201,713,0,0,1,2
1580201,1580266,65,1,0,0,1
1580202,1580273,71,1,0,0,2
1580267,1580619,352,0,0,1,1
1580274,1580620,346,0,0,1,2
1580620,1580702,82,1,0,0,1
1580621,1580682,61,1,0,0,2
1580683,1580798,115,0,0,1,2
1580703,1580799,96,0,0,1,1
1580799,1580832,33,1,0,0,2
1580800,1580849,49,1,0,0,1
1580833,1581553,720,0,0,1,2
1580850,1580976,126,0,0,1,1
1580977,1581000,23,1,0,0,1
1581001,1581553,552,0,0,1,1
1581554,1581587,33,1,0,0,2
1581554,1581619,65,1,0,0,1
1581588,1582195,607,0,0,1,2
1581620,1581792,172,0,0,1,1
1581793,1581807,14,1,0,0,1
1581808,1581833,25,0,0,1,1
1581834,1581896,62,1,0,0,1
1581897,1581961,64,0,0,1,1
1581962,1582021,59,1,0,0,1
1582022,1582198,176,0,0,1,1
1582196,1582266,70,1,0,0,2
1582199,1582265,66,1,0,0,1
1582266,1582547,281,0,0,1,1
1582267,1582549,282,0,0,1,2
1582548,1582596,48,1,0,0,1
1582550,1582613,63,1,0,0,2
1582597,1582728,131,0,0,1,1
1582614,1582728,114,0,0,1,2
1582729,1582758,29,1,0,0,2
1582729,1582761,32,1,0,0,1
1582759,1583596,837,0,0,1,2
1582762,1583596,834,0,0,1,1
1583597,1583626,29,1,0,0,1
1583597,1583627,30,1,0,0,2
1583627,1584726,1099,0,0,1,1
1583628,1584726,1098,0,0,1,2
1584727,1584802,75,1,0,0,1
1584727,1584812,85,1,0,0,2
1584803,1584875,72,0,0,1,1
1584813,1584875,62,0,0,1,2
1584876,1584913,37,1,0,0,1
1584876,1584942,66,1,0,0,2
1584914,1585122,208,0,0,1,1
1584943,1585072,129,0,0,1,2
1585073,1585170,97,1,0,0,2
1585123,1585153,30,1,0,0,1
1585154,1585324,170,0,0,1,1
1585171,1585330,159,0,0,1,2
1585325,1585354,29,1,0,0,1
1585331,1585354,23,1,0,0,2
1585355,1585720,365,0,0,1,2
1585355,1585749,394,0,0,1,1
1585721,1585812,91,1,0,0,2
1585750,1585782,32,1,0,0,1
1585783,1586148,365,0,0,1,1
1585813,1586081,268,0,0,1,2
1586082,1586208,126,1,0,0,2
1586149,1586206,57,1,0,0,1
1586207,1586342,135,0,0,1,1
1586209,1586343,134,0,0,1,2
1586343,1586392,49,1,0,0,1
1586344,1586398,54,1,0,0,2
1586393,1586581,188,0,0,1,1
1586399,1586582,183,0,0,1,2
1586582,1586667,85,1,0,0,1
1586583,1586663,80,1,0,0,2
1586664,1586786,122,0,0,1,2
1586668,1586787,119,0,0,1,1
1586787,1586811,24,1,0,0,2
1586788,1586812,24,1,0,0,1
1586812,1588100,1288,0,0,1,2
1586813,1588098,1285,0,0,1,1
1588099,1588174,75,1,0,0,1
1588101,1588176,75,1,0,0,2
1588175,1588399,224,0,0,1,1
1588177,1588401,224,0,0,1,2
1588400,1588469,69,1,0,0,1
1588402,1588469,67,1,0,0,2
1588470,1588560,90,0,0,1,2
1588470,1588566,96,0,0,1,1
1588561,1588591,30,1,0,0,2
1588567,1588590,23,1,0,0,1
1588591,1590240,1649,0,0,1,1
1588592,1590240,1648,0,0,1,2
1590241,1590287,46,1,0,0,1
1590241,1590288,47,1,0,0,2
1590288,1590440,152,0,0,1,1
1590289,1590440,151,0,0,1,2
1590441,1590508,67,1,0,0,1
1590441,1590509,68,1,0,0,2
1590509,1590640,131,0,0,1,1
1590510,1590637,127,0,0,1,2
1590638,1590654,16,1,0,0,2
1590641,1590656,15,1,0,0,1
1590655,1592430,1775,0,0,1,2
1590657,1592430,1773,0,0,1,1
1592431,1592493,62,1,0,0,2
1592431,1592497,66,1,0,0,1
1592494,1592552,58,0,0,1,2
1592498,1592551,53,0,0,1,1
1592552,1592617,65,1,0,0,1
1592553,1592604,51,1,0,0,2
1592605,1592714,109,0,0,1,2
1592618,1592714,96,0,0,1,1
1592715,1592747,32,1,0,0,2
1592715,1592749,34,1,0,0,1
1592748,1594235,1487,0,0,1,2
1592750,1594235,1485,0,0,1,1
1594236,1594296,60,1,0,0,1
1594236,1594305,69,1,0,0,2
1594297,1594365,68,0,0,1,1
1594306,1594365,59,0,0,1,2
1594366,1594419,53,1,0,0,2
1594366,1594421,55,1,0,0,1
1594420,1594637,217,0,0,1,2
1594422,1594621,199,0,0,1,1
1594622,1594708,86,1,0,0,1
1594638,1594698,60,1,0,0,2
1594699,1594781,82,0,0,1,2
1594709,1594780,71,0,0,1,1
1594781,1594824,43,1,0,0,1
1594782,1594816,34,1,0,0,2
1594817,1595017,200,0,0,1,2
1594825,1595017,192,0,0,1,1
1595018,1595047,29,1,0,0,2
1595018,1595048,30,1,0,0,1
1595048,1595745,697,0,0,1,2
1595049,1595743,694,0,0,1,1
1595744,1595777,33,1,0,0,1
1595746,1595775,29,1,0,0,2
1595776,1596385,609,0,0,1,2
1595778,1596385,607,0,0,1,1
1596386,1596435,49,1,0,0,2
1596386,1596436,50,1,0,0,1
1596436,1596555,119,0,0,1,2
1596437,1596554,117,0,0,1,1
1596555,1596595,40,1,0,0,1
1596556,1596603,47,1,0,0,2
1596596,1596790,194,0,0,1,1
1596604,1596790,186,0,0,1,2
1596791,1596831,40,1,0,0,1
1596791,1597343,552,1,0,0,2
1596832,1596932,100,0,0,1,1
1596933,1596974,41,1,0,0,1
1596975,1597169,194,0,0,1,1
1597170,1597198,28,1,0,0,1
1597199,1597435,236,0,0,1,1
1597344,1597412,68,0,0,1,2
1597413,1597531,118,1,0,0,2
1597436,1597466,30,1,0,0,1
1597467,1597794,327,0,0,1,1
1597532,1597566,34,0,0,1,2
1597567,1597665,98,1,0,0,2
1597666,1597704,38,0,0,1,2
1597705,1597824,119,1,0,0,2
1597795,1597823,28,1,0,0,1
1597824,1598616,792,0,0,1,1
1597825,1598179,354,0,0,1,2
1598180,1598428,248,1,0,0,2
1598429,1598460,31,0,0,1,2
1598461,1598569,108,1,0,0,2
1598570,1598616,46,0,0,1,2
1598617,1598677,60,1,0,0,1
1598617,1598679,62,1,0,0,2
1598678,1598894,216,0,0,1,1
1598680,1598893,213,0,0,1,2
1598894,1598926,32,1,0,0,2
1598895,1598929,34,1,0,0,1
1598927,1599127,200,0,0,1,2
1598930,1599127,197,0,0,1,1
1599128,1599189,61,1,0,0,2
1599128,1599190,62,1,0,0,1
1599190,1599254,64,0,0,1,2
1599191,1599253,62,0,0,1,1
1599254,1599582,328,1,0,0,1
1599255,1599555,300,1,0,0,2
1599274,1599528,254,0,1,0,1
1599281,1599507,226,0,1,0,2
1599556,1599855,299,0,0,1,2
1599583,1599854,271,0,0,1,1
1599855,1599873,18,1,0,0,1
1599856,1599873,17,1,0,0,2
1599874,1600141,267,0,0,1,2
1599874,1600142,268,0,0,1,1
1600142,1600172,30,1,0,0,2
1600143,1600171,28,1,0,0,1
1600172,1600872,700,0,0,1,1
1600173,1600456,283,0,0,1,2
1600457,1600497,40,1,0,0,2
1600498,1600811,313,0,0,1,2
1600812,1600939,127,1,0,0,2
1600873,1600939,66,1,0,0,1
1600940,1601238,298,0,0,1,1
1600940,1601239,299,0,0,1,2
1601239,1601320,81,1,0,0,1
1601240,1601331,91,1,0,0,2
1601321,1601377,56,0,0,1,1
1601332,1601378,46,0,0,1,2
1601378,1601429,51,1,0,0,1
1601379,1601431,52,1,0,0,2
1601430,1601538,108,0,0,1,1
1601432,1601541,109,0,0,1,2
1601539,1601579,40,1,0,0,1
1601542,1601570,28,1,0,0,2
1601571,1601690,119,0,0,1,2
1601580,1601691,111,0,0,1,1
1601691,1601712,21,1,0,0,2
1601692,1601716,24,1,0,0,1
1601713,1603007,1294,0,0,1,2
1601717,1603008,1291,0,0,1,1
1603008,1603102,94,1,0,0,2
1603009,1603103,94,1,0,0,1
1603103,1603443,340,0,0,1,2
1603104,1603442,338,0,0,1,1
1603443,1603504,61,1,0,0,1
1603444,1603505,61,1,0,0,2
1603505,1603610,105,0,0,1,1
1603506,1603611,105,0,0,1,2
1603611,1603641,30,1,0,0,1
1603612,1603640,28,1,0,0,2
1603641,1604518,877,0,0,1,2
1603642,1604520,878,0,0,1,1
1604519,1604564,45,1,0,0,2
1604521,1604564,43,1,0,0,1
1604565,1604666,101,0,0,1,1
1604565,1604668,103,0,0,1,2
1604667,1604687,20,1,0,0,1
1604669,1604697,28,1,0,0,2
1604688,1605378,690,0,0,1,1
1604698,1605378,680,0,0,1,2
1605379,1605431,52,1,0,0,2
1605379,1605435,56,1,0,0,1
1605432,1605705,273,0,0,1,2
1605436,1605705,269,0,0,1,1
1605706,1605775,69,1,0,0,1
1605706,1605787,81,1,0,0,2
1605776,1605973,197,0,0,1,1
1605788,1605973,185,0,0,1,2
1605974,1606005,31,1,0,0,1
1605974,1606005,31,1,0,0,2
1606006,1607166,1160,0,0,1,1
1606006,1607168,1162,0,0,1,2
1607167,1607245,78,1,0,0,1
1607169,1607243,74,1,0,0,2
1607244,1607562,318,0,0,1,2
1607246,1607563,317,0,0,1,1
1607563,1607626,63,1,0,0,2
1607564,1607632,68,1,0,0,1
1607627,1607723,96,0,0,1,2
1607633,1607722,89,0,0,1,1
1607723,1607752,29,1,0,0,1
1607724,1607747,23,1,0,0,2
1607748,1609263,1515,0,0,1,2
1607753,1608111,358,0,0,1,1
1608112,1608128,16,1,0,0,1
1608129,1609261,1132,0,0,1,1
1609262,1609331,69,1,0,0,1
1609264,1609331,67,1,0,0,2
1609332,1609684,352,0,0,1,1
1609332,1609686,354,0,0,1,2
1609685,1609853,168,1,0,0,1
1609687,1609840,153,1,0,0,2
1609841,1609933,92,0,0,1,2
1609854,1609931,77,0,0,1,1
1609932,1609957,25,1,0,0,1
1609934,1609960,26,1,0,0,2
1609958,1610331,373,0,0,1,1
1609961,1610332,371,0,0,1,2
1610332,1610364,32,1,0,0,1
1610333,1610406,73,1,0,0,2
1610365,1611713,1348,0,0,1,1
1610407,1611713,1306,0,0,1,2
1611714,1611783,69,1,0,0,1
1611714,1611793,79,1,0,0,2
1611784,1611859,75,0,0,1,1
1611794,1611859,65,0,0,1,2
1611860,1611904,44,1,0,0,2
1611860,1611912,52,1,0,0,1
1611905,1612185,280,0,0,1,2
1611913,1612185,272,0,0,1,1
1612186,1612261,75,1,0,0,1
1612186,1612262,76,1,0,0,2
1612262,1612359,97,0,0,1,1
1612263,1612359,96,0,0,1,2
1612360,1612388,28,1,0,0,1
1612360,1612391,31,1,0,0,2
1612389,1612798,409,0,0,1,1
1612392,1612792,400,0,0,1,2
1612793,1612822,29,1,0,0,2
1612799,1612823,24,1,0,0,1
1612823,1613387,564,0,0,1,2
1612824,1613388,564,0,0,1,1
1613388,1613422,34,1,0,0,2
1613389,1613423,34,1,0,0,1
1613423,1613523,100,0,0,1,2
1613424,1613525,101,0,0,1,1
1613524,1613555,31,1,0,0,2
1613526,1613552,26,1,0,0,1
1613553,1614092,539,0,0,1,1
1613556,1614093,537,0,0,1,2
1614093,1614215,122,1,0,0,1
1614094,1614210,116,1,0,0,2
1614211,1614569,358,0,0,1,2
1614216,1614568,352,0,0,1,1
1614569,1614635,66,1,0,0,1
1614570,1614634,64,1,0,0,2
1614635,1614721,86,0,0,1,2
1614636,1614722,86,0,0,1,1
1614722,1614754,32,1,0,0,2
1614723,1614751,28,1,0,0,1
1614752,1615092,340,0,0,1,1
1614755,1615091,336,0,0,1,2
1615092,1615125,33,1,0,0,2
1615093,1615128,35,1,0,0,1
1615126,1615657,531,0,0,1,2
1615129,1615656,527,0,0,1,1
1615657,1615688,31,1,0,0,1
1615658,1615688,30,1,0,0,2
1615689,1616297,608,0,0,1,2
1615689,1616298,609,0,0,1,1
1616298,1616371,73,1,0,0,2
1616299,1616366,67,1,0,0,1
1616367,1616710,343,0,0,1,1
1616372,1616710,338,0,0,1,2
1616711,1616803,92,1,0,0,2
1616711,1616820,109,1,0,0,1
1616804,1616867,63,0,0,1,2
1616821,1616867,46,0,0,1,1
1616868,1616909,41,1,0,0,1
1616868,1616909,41,1,0,0,2
1616910,1617032,122,0,0,1,2
1616910,1617730,820,0,0,1,1
1617033,1617037,4,1,0,0,2
1617038,1617730,692,0,0,1,2
1617731,1617765,34,1,0,0,1
1617731,1617791,60,1,0,0,2
1617766,1618053,287,0,0,1,1
1617792,1618054,262,0,0,1,2
1618054,1618136,82,1,0,0,1
1618055,1618140,85,1,0,0,2
1618137,1618223,86,0,0,1,1
1618141,1618223,82,0,0,1,2
1618224,1618285,61,1,0,0,1
1618224,1618285,61,1,0,0,2
1618286,1618513,227,0,0,1,1
1618286,1618514,228,0,0,1,2
1618514,1618584,70,1,0,0,1
1618515,1618582,67,1,0,0,2
1618583,1618657,74,0,0,1,2
1618585,1618658,73,0,0,1,1
1618658,1618715,57,1,0,0,2
1618659,1618716,57,1,0,0,1
1618716,1618926,210,0,0,1,2
1618717,1618926,209,0,0,1,1
1618927,1618956,29,1,0,0,2
1618927,1618958,31,1,0,0,1
1618957,1619093,136,0,0,1,2
1618959,1619091,132,0,0,1,1
1619092,1619122,30,1,0,0,1
1619094,1619124,30,1,0,0,2
1619123,1619296,173,0,0,1,1
1619125,1619296,171,0,0,1,2
1619297,1619326,29,1,0,0,1
1619297,1619332,35,1,0,0,2
1619327,1619589,262,0,0,1,1
1619333,1619591,258,0,0,1,2
1619590,1619615,25,1,0,0,1
1619592,1619614,22,1,0,0,2
1619615,1619911,296,0,0,1,2
1619616,1619911,295,0,0,1,1
1619912,1619938,26,1,0,0,2
1619912,1619941,29,1,0,0,1
1619939,1620441,502,0,0,1,2
1619942,1620441,499,0,0,1,1
1620442,1620515,73,1,0,0,2
1620442,1620522,80,1,0,0,1
1620516,1620853,337,0,0,1,2
1620523,1620854,331,0,0,1,1
1620854,1620951,97,1,0,0,2
1620855,1620953,98,1,0,0,1
1620952,1621023,71,0,0,1,2
1620954,1621022,68,0,0,1,1
1621023,1621076,53,1,0,0,1
1621024,1621059,35,1,0,0,2
1621060,1621173,113,0,0,1,2
1621077,1621174,97,0,0,1,1
1621174,1621200,26,1,0,0,2
1621175,1621200,25,1,0,0,1
1621201,1622183,982,0,0,1,2
1621201,1623371,2170,0,0,1,1
1622184,1622201,17,1,0,0,2
1622202,1622353,151,0,0,1,2
1622354,1622471,117,1,0,0,2
1622472,1622500,28,0,0,1,2
1622501,1622528,27,1,0,0,2
1622529,1622600,71,0,0,1,2
1622601,1622605,4,1,0,0,2
1622606,1622656,50,0,0,1,2
1622657,1622706,49,1,0,0,2
1622707,1623373,666,0,0,1,2
1623372,1623482,110,1,0,0,1
1623374,1623479,105,1,0,0,2
1623480,1623568,88,0,0,1,2
1623483,1623569,86,0,0,1,1
1623569,1623608,39,1,0,0,2
1623570,1623603,33,1,0,0,1
1623604,1623859,255,0,0,1,1
1623609,1623860,251,0,0,1,2
1623860,1623892,32,1,0,0,1
1623861,1623891,30,1,0,0,2
1623892,1624222,330,0,0,1,2
1623893,1624217,324,0,0,1,1
1624218,1624255,37,1,0,0,1
1624223,1624249,26,1,0,0,2
1624250,1624435,185,0,0,1,2
1624256,1624435,179,0,0,1,1
1624436,1624466,30,1,0,0,1
1624436,1624466,30,1,0,0,2
1624467,1625399,932,0,0,1,1
1624467,1625399,932,0,0,1,2
1625400,1625454,54,1,0,0,1
1625400,1625463,63,1,0,0,2
1625455,1625630,175,0,0,1,1
1625464,1625630,166,0,0,1,2
1625631,1625651,20,1,0,0,2
1625631,1625655,24,1,0,0,1
1625652,1626030,378,0,0,1,2
1625656,1626029,373,0,0,1,1
1626030,1626058,28,1,0,0,1
1626031,1626059,28,1,0,0,2
1626059,1626351,292,0,0,1,1
1626060,1626352,292,0,0,1,2
1626352,1626384,32,1,0,0,1
1626353,1626383,30,1,0,0,2
1626384,1627487,1103,0,0,1,2
1626385,1627487,1102,0,0,1,1
1627488,1627527,39,1,0,0,1
1627488,1627541,53,1,0,0,2
1627528,1627756,228,0,0,1,1
1627542,1627758,216,0,0,1,2
1627757,1627777,20,1,0,0,1
1627759,1627777,18,1,0,0,2
1627778,1629575,1797,0,0,1,1
1627778,1629577,1799,0,0,1,2
1629576,1629644,68,1,0,0,1
1629578,1629650,72,1,0,0,2
1629645,1629744,99,0,0,1,1
1629651,1629745,94,0,0,1,2
1629745,1629772,27,1,0,0,1
1629746,1629774,28,1,0,0,2
1629773,1630946,1173,0,0,1,1
1629775,1630944,1169,0,0,1,2
1630945,1631023,78,1,0,0,2
1630947,1631034,87,1,0,0,1
1631024,1631386,362,0,0,1,2
1631035,1631385,350,0,0,1,1
1631386,1631465,79,1,0,0,1
1631387,1631459,72,1,0,0,2
1631460,1631602,142,0,0,1,2
1631466,1631603,137,0,0,1,1
1631603,1631634,31,1,0,0,2
1631604,1631634,30,1,0,0,1
1631635,1632307,672,0,0,1,2
1631635,1632308,673,0,0,1,1
1632308,1632342,34,1,0,0,2
1632309,1632343,34,1,0,0,1
1632343,1632489,146,0,0,1,2
1632344,1632491,147,0,0,1,1
1632490,1632520,30,1,0,0,2
1632492,1632519,27,1,0,0,1
1632520,1632982,462,0,0,1,1
1632521,1632983,462,0,0,1,2
1632983,1633061,78,1,0,0,1
1632984,1633054,70,1,0,0,2
1633055,1633188,133,0,0,1,2
1633062,1633186,124,0,0,1,1
1633187,1633262,75,1,0,0,1
1633189,1633262,73,1,0,0,2
1633263,1633419,156,0,0,1,1
1633263,1633419,156,0,0,1,2
1633420,1633482,62,1,0,0,2
1633420,1633484,64,1,0,0,1
1633483,1633528,45,0,0,1,2
1633485,1633528,43,0,0,1,1
1633529,1633588,59,1,0,0,2
1633529,1633589,60,1,0,0,1
1633589,1634375,786,0,0,1,2
1633590,1634374,784,0,0,1,1
1634375,1634417,42,1,0,0,1
1634376,1634410,34,1,0,0,2
1634411,1635258,847,0,0,1,2
1634418,1635258,840,0,0,1,1
1635259,1635333,74,1,0,0,1
1635259,1635344,85,1,0,0,2
1635334,1635518,184,0,0,1,1
1635345,1635520,175,0,0,1,2
1635519,1635585,66,1,0,0,1
1635521,1635594,73,1,0,0,2
1635586,1635661,75,0,0,1,1
1635595,1635661,66,0,0,1,2
1635662,1635697,35,1,0,0,2
1635662,1635706,44,1,0,0,1
1635698,1636939,1241,0,0,1,2
1635707,1636939,1232,0,0,1,1
1636940,1637019,79,1,0,0,1
1636940,1637019,79,1,0,0,2
1637020,1637311,291,0,0,1,2
1637020,1637312,292,0,0,1,1
1637312,1637363,51,1,0,0,2
1637313,1637363,50,1,0,0,1
1637364,1637407,43,0,0,1,1
1637364,1637409,45,0,0,1,2
1637408,1637456,48,1,0,0,1
1637410,1637456,46,1,0,0,2
1637457,1637854,397,0,0,1,1
1637457,1637854,397,0,0,1,2
1637855,1637886,31,1,0,0,1
1637855,1637887,32,1,0,0,2
1637887,1638014,127,0,0,1,1
1637888,1638013,125,0,0,1,2
1638014,1638043,29,1,0,0,2
1638015,1638040,25,1,0,0,1
1638041,1638838,797,0,0,1,1
1638044,1638835,791,0,0,1,2
1638836,1638995,159,1,0,0,2
1638839,1638930,91,1,0,0,1
1638931,1639050,119,0,0,1,1
1638996,1639052,56,0,0,1,2
1639051,1639139,88,1,0,0,1
1639053,1639140,87,1,0,0,2
1639140,1639296,156,0,0,1,1
1639141,1639296,155,0,0,1,2
1639297,1639377,80,1,0,0,2
1639297,1639382,85,1,0,0,1
1639378,1639496,118,0,0,1,2
1639383,1639495,112,0,0,1,1
1639496,1639524,28,1,0,0,1
1639497,1639525,28,1,0,0,2
1639525,1639836,311,0,0,1,1
1639526,1639835,309,0,0,1,2
1639836,1639867,31,1,0,0,2
1639837,1639863,26,1,0,0,1
1639864,1640695,831,0,0,1,1
1639868,1640695,827,0,0,1,2
1640696,1640775,79,1,0,0,2
1640696,1640778,82,1,0,0,1
1640776,1641095,319,0,0,1,2
1640779,1641095,316,0,0,1,1
1641096,1641139,43,1,0,0,2
1641096,1641148,52,1,0,0,1
1641140,1641384,244,0,0,1,2
1641149,1641382,233,0,0,1,1
1641383,1641414,31,1,0,0,1
1641385,1641414,29,1,0,0,2
1641415,1641687,272,0,0,1,2
1641415,1641688,273,0,0,1,1
1641688,1641723,35,1,0,0,2
1641689,1641721,32,1,0,0,1
1641722,1642573,851,0,0,1,1
1641724,1642574,850,0,0,1,2
1642574,1642622,48,1,0,0,1
1642575,1642631,56,1,0,0,2
1642623,1643043,420,0,0,1,1
1642632,1643042,410,0,0,1,2
1643043,1643142,99,1,0,0,2
1643044,1643125,81,1,0,0,1
1643126,1643211,85,0,0,1,1
1643143,1643211,68,0,0,1,2
1643212,1643252,40,1,0,0,2
1643212,1643255,43,1,0,0,1
1643253,1644473,1220,0,0,1,2
1643256,1644474,1218,0,0,1,1
1644474,1644570,96,1,0,0,2
1644475,1644574,99,1,0,0,1
1644571,1645007,436,0,0,1,2
1644575,1645007,432,0,0,1,1
1645008,1645062,54,1,0,0,2
1645008,1645067,59,1,0,0,1
1645063,1645383,320,0,0,1,2
1645068,1645381,313,0,0,1,1
1645382,1645431,49,1,0,0,1
1645384,1645432,48,1,0,0,2
1645432,1645592,160,0,0,1,1
1645433,1645591,158,0,0,1,2
1645592,1645678,86,1,0,0,2
1645593,1645699,106,1,0,0,1
1645679,1646231,552,0,0,1,2
1645700,1646231,531,0,0,1,1
1646232,1646301,69,1,0,0,2
1646232,1646304,72,1,0,0,1
1646302,1646505,203,0,0,1,2
1646305,1646505,200,0,0,1,1
1646506,1646850,344,1,0,0,2
1646506,1654722,8216,1,0,0,1
1646602,1646845,243,0,1,0,1
1646851,1646894,43,0,0,1,2
1646895,1654696,7801,1,0,0,2
1646909,1654687,7778,0,1,0,2
1646951,1654713,7762,0,1,0,1
1654697,1655717,1020,0,0,1,2
1654723,1654800,77,0,0,1,1
1654801,1654805,4,1,0,0,1
1654806,1655718,912,0,0,1,1
1655718,1655763,45,1,0,0,2
1655719,1655764,45,1,0,0,1
1655764,1655892,128,0,0,1,2
1655765,1655891,126,0,0,1,1
1655892,1655942,50,1,0,0,1
1655893,1655933,40,1,0,0,2
1655934,1656209,275,0,0,1,2
1655943,1656211,268,0,0,1,1
1656210,1656255,45,1,0,0,2
1656212,1656264,52,1,0,0,1
1656256,1656619,363,0,0,1,2
1656265,1656621,356,0,0,1,1
1656620,1656671,51,1,0,0,2
1656622,1656676,54,1,0,0,1
1656672,1657072,400,0,0,1,2
1656677,1657071,394,0,0,1,1
1657072,1657111,39,1,0,0,1
1657073,1657121,48,1,0,0,2
1657112,1657300,188,0,0,1,1
1657122,1657298,176,0,0,1,2
1657299,1657337,38,1,0,0,2
1657301,1657340,39,1,0,0,1
1657338,1657643,305,0,0,1,2
1657341,1657642,301,0,0,1,1
1657643,1657746,103,1,0,0,1
1657644,1657745,101,1,0,0,2
1657746,1657772,26,0,0,1,2
1657747,1657774,27,0,0,1,1
1657773,1658532,759,1,0,0,2
1657775,1658569,794,1,0,0,1
1657840,1658545,705,0,1,0,1
1657854,1658521,667,0,1,0,2
1658533,1658761,228,0,0,1,2
1658570,1658678,108,0,0,1,1
1658679,1658697,18,1,0,0,1
1658698,1658763,65,0,0,1,1
1658762,1658831,69,1,0,0,2
1658764,1658829,65,1,0,0,1
1658830,1658924,94,0,0,1,1
1658832,1658924,92,0,0,1,2
1658925,1658957,32,1,0,0,1
1658925,1658957,32,1,0,0,2
1658958,1659311,353,0,0,1,1
1658958,1659313,355,0,0,1,2
1659312,1659342,30,1,0,0,1
1659314,1659341,27,1,0,0,2
1659342,1659719,377,0,0,1,2
1659343,1659719,376,0,0,1,1
1659720,1659747,27,1,0,0,2
1659720,1659748,28,1,0,0,1
1659748,1660188,440,0,0,1,2
1659749,1660188,439,0,0,1,1
1660189,1660218,29,1,0,0,2
1660189,1660219,30,1,0,0,1
1660219,1660434,215,0,0,1,2
1660220,1660435,215,0,0,1,1
1660435,1660464,29,1,0,0,2
1660436,1660461,25,1,0,0,1
1660462,1660910,448,0,0,1,1
1660465,1660911,446,0,0,1,2
1660911,1660941,30,1,0,0,1
1660912,1660934,22,1,0,0,2
1660935,1661238,303,0,0,1,2
1660942,1661235,293,0,0,1,1
1661236,1661495,259,1,0,0,1
1661239,1661504,265,1,0,0,2
1661257,1661457,200,0,1,0,1
1661262,1661421,159,0,1,0,2
1661496,1661580,84,0,0,1,1
1661505,1661581,76,0,0,1,2
1661581,1661608,27,1,0,0,1
1661582,1661599,17,1,0,0,2
1661600,1662972,1372,0,0,1,2
1661609,1662972,1363,0,0,1,1
1662973,1663004,31,1,0,0,1
1662973,1663005,32,1,0,0,2
1663005,1663111,106,0,0,1,1
1663006,1663112,106,0,0,1,2
1663112,1663154,42,1,0,0,1
1663113,1663158,45,1,0,0,2
1663155,1663566,411,0,0,1,1
1663159,1663567,408,0,0,1,2
1663567,1663598,31,1,0,0,1
1663568,1663599,31,1,0,0,2
1663599,1665162,1563,0,0,1,1
1663600,1665161,1561,0,0,1,2
1665162,1665246,84,1,0,0,2
1665163,1665247,84,1,0,0,1
1665247,1665661,414,0,0,1,2
1665248,1665657,409,0,0,1,1
1665658,1665732,74,1,0,0,1
1665662,1665738,76,1,0,0,2
1665733,1666518,785,0,0,1,1
1665739,1666519,780,0,0,1,2
1666519,1666585,66,1,0,0,1
1666520,1666590,70,1,0,0,2
1666586,1666647,61,0,0,1,1
1666591,1666647,56,0,0,1,2
1666648,1666673,25,1,0,0,2
1666648,1666676,28,1,0,0,1
1666674,1666921,247,0,0,1,2
1666677,1666919,242,0,0,1,1
1666920,1666939,19,1,0,0,1
1666922,1666933,11,1,0,0,2
1666934,1668423,1489,0,0,1,2
1666940,1668423,1483,0,0,1,1
1668424,1668455,31,1,0,0,1
1668424,1668462,38,1,0,0,2
1668456,1668952,496,0,0,1,1
1668463,1668952,489,0,0,1,2
1668953,1669050,97,1,0,0,2
1668953,1669105,152,1,0,0,1
1669051,1669147,96,0,0,1,2
1669106,1669148,42,0,0,1,1
1669148,1669214,66,1,0,0,2
1669149,1669236,87,1,0,0,1
1669215,1669339,124,0,0,1,2
1669237,1669340,103,0,0,1,1
1669340,1669374,34,1,0,0,2
1669341,1669371,30,1,0,0,1
1669372,1669558,186,0,0,1,1
1669375,1669563,188,0,0,1,2
1669559,1669930,371,1,0,0,1
1669564,1669875,311,1,0,0,2
1669587,1669808,221,0,1,0,2
1669587,1669866,279,0,1,0,1
1669876,1669970,94,0,0,1,2
1669931,1669978,47,0,0,1,1
1669971,1670004,33,1,0,0,2
1669979,1670038,59,1,0,0,1
1670005,1670330,325,0,0,1,2
1670039,1671584,1545,0,0,1,1
1670331,1670335,4,1,0,0,2
1670336,1671579,1243,0,0,1,2
1671580,1671628,48,1,0,0,2
1671585,1671606,21,1,0,0,1
1671607,1672260,653,0,0,1,1
1671629,1672260,631,0,0,1,2
1672261,1672317,56,1,0,0,1
1672261,1672320,59,1,0,0,2
1672318,1672474,156,0,0,1,1
1672321,1672475,154,0,0,1,2
1672475,1672506,31,1,0,0,1
1672476,1672506,30,1,0,0,2
1672507,1674208,1701,0,0,1,1
1672507,1674209,1702,0,0,1,2
1674209,1674235,26,1,0,0,1
1674210,1674227,17,1,0,0,2
1674228,1675549,1321,0,0,1,2
1674236,1675548,1312,0,0,1,1
1675549,1675596,47,1,0,0,1
1675550,1675597,47,1,0,0,2
1675597,1675722,125,0,0,1,1
1675598,1675716,118,0,0,1,2
1675717,1675732,15,1,0,0,2
1675723,1675738,15,1,0,0,1
1675733,1676121,388,0,0,1,2
1675739,1677484,1745,0,0,1,1
1676122,1676132,10,1,0,0,2
1676133,1677486,1353,0,0,1,2
1677485,1677526,41,1,0,0,1
1677487,1677527,40,1,0,0,2
1677527,1677772,245,0,0,1,1
1677528,1677770,242,0,0,1,2
1677771,1677802,31,1,0,0,2
1677773,1677800,27,1,0,0,1
1677801,1678264,463,0,0,1,1
1677803,1678266,463,0,0,1,2
1678265,1678541,276,1,0,0,1
1678267,1678529,262,1,0,0,2
1678287,1678482,195,0,1,0,2
1678291,1678500,209,0,1,0,1
1678530,1678710,180,0,0,1,2
1678542,1678710,168,0,0,1,1
1678711,1678738,27,1,0,0,1
1678711,1678741,30,1,0,0,2
1678739,1680860,2121,0,0,1,1
1678742,1680860,2118,0,0,1,2
1680861,1680921,60,1,0,0,2
1680861,1680926,65,1,0,0,1
1680922,1681014,92,0,0,1,2
1680927,1681014,87,0,0,1,1
1681015,1681053,38,1,0,0,2
1681015,1681056,41,1,0,0,1
1681054,1681474,420,0,0,1,2
1681057,1681473,416,0,0,1,1
1681474,1681504,30,1,0,0,1
1681475,1681504,29,1,0,0,2
1681505,1681907,402,0,0,1,1
1681505,1681912,407,0,0,1,2
1681908,1681925,17,1,0,0,1
1681913,1681929,16,1,0,0,2
1681926,1683018,1092,0,0,1,1
1681930,1683019,1089,0,0,1,2
1683019,1683075,56,1,0,0,1
1683020,1683116,96,1,0,0,2
1683076,1683509,433,0,0,1,1
1683117,1683509,392,0,0,1,2
1683510,1683534,24,1,0,0,1
1683510,1683534,24,1,0,0,2
1683535,1683800,265,0,0,1,1
1683535,1683800,265,0,0,1,2
1683801,1683830,29,1,0,0,1
1683801,1683831,30,1,0,0,2
1683831,1685175,1344,0,0,1,1
1683832,1684548,716,0,0,1,2
1684549,1684574,25,1,0,0,2
1684575,1684756,181,0,0,1,2
1684757,1684800,43,1,0,0,2
1684801,1685074,273,0,0,1,2
1685075,1685215,140,1,0,0,2
1685176,1685213,37,1,0,0,1
1685214,1686794,1580,0,0,1,1
1685216,1686794,1578,0,0,1,2
1686795,1686862,67,1,0,0,2
1686795,1686872,77,1,0,0,1
1686863,1686979,116,0,0,1,2
1686873,1686976,103,0,0,1,1
1686977,1687002,25,1,0,0,1
1686980,1687003,23,1,0,0,2
1687003,1688511,1508,0,0,1,1
1687004,1688506,1502,0,0,1,2
1688507,1688521,14,1,0,0,2
1688512,1688516,4,1,0,0,1
1688517,1688931,414,0,0,1,1
1688522,1688931,409,0,0,1,2
1688932,1688989,57,1,0,0,1
1688932,1689010,78,1,0,0,2
1688990,1689093,103,0,0,1,1
1689011,1689094,83,0,0,1,2
1689094,1689129,35,1,0,0,1
1689095,1689129,34,1,0,0,2
1689130,1689614,484,0,0,1,2
1689130,1689620,490,0,0,1,1
1689615,1689642,27,1,0,0,2
1689621,1689641,20,1,0,0,1
1689642,1692487,2845,0,0,1,1
1689643,1692488,2845,0,0,1,2
1692488,1692547,59,1,0,0,1
1692489,1692562,73,1,0,0,2
1692548,1692920,372,0,0,1,1
1692563,1692920,357,0,0,1,2
1692921,1692952,31,1,0,0,1
1692921,1692952,31,1,0,0,2
1692953,1693164,211,0,0,1,1
1692953,1693166,213,0,0,1,2
1693165,1693193,28,1,0,0,1
1693167,1693192,25,1,0,0,2
1693193,1693860,667,0,0,1,2
1693194,1693859,665,0,0,1,1
1693860,1693892,32,1,0,0,1
1693861,1693893,32,1,0,0,2
1693893,1694365,472,0,0,1,1
1693894,1694365,471,0,0,1,2
1694366,1694425,59,1,0,0,2
1694366,1694427,61,1,0,0,1
1694426,1694649,223,0,0,1,2
1694428,1694649,221,0,0,1,1
1694650,1694679,29,1,0,0,2
1694650,1694681,31,1,0,0,1
1694680,1695300,620,0,0,1,2
1694682,1695302,620,0,0,1,1
1695301,1695337,36,1,0,0,2
1695303,1695344,41,1,0,0,1
1695338,1695882,544,0,0,1,2
1695345,1695884,539,0,0,1,1
1695883,1696090,207,1,0,0,2
1695885,1696134,249,1,0,0,1
1695914,1696046,132,0,1,0,2
1695915,1696073,158,0,1,0,1
1696091,1696277,186,0,0,1,2
1696135,1696262,127,0,0,1,1
1696263,1696512,249,1,0,0,1
1696278,1696440,162,1,0,0,2
1696301,1696435,134,0,1,0,1
1696305,1696400,95,0,1,0,2
1696441,1696597,156,0,0,1,2
1696513,1696598,85,0,0,1,1
1696598,1696650,52,1,0,0,2
1696599,1696651,52,1,0,0,1
1696651,1696869,218,0,0,1,2
1696652,1696868,216,0,0,1,1
1696869,1696915,46,1,0,0,1
1696870,1696913,43,1,0,0,2
1696914,1698045,1131,0,0,1,2
1696916,1698044,1128,0,0,1,1
1698045,1698116,71,1,0,0,1
1698046,1698129,83,1,0,0,2
1698117,1698237,120,0,0,1,1
1698130,1698238,108,0,0,1,2
1698238,1698258,20,1,0,0,1
1698239,1698271,32,1,0,0,2
1698259,1699156,897,0,0,1,1
1698272,1699154,882,0,0,1,2
1699155,1699191,36,1,0,0,2
1699157,1699189,32,1,0,0,1
1699190,1699916,726,0,0,1,1
1699192,1699919,727,0,0,1,2
1699917,1699960,43,1,0,0,1
1699920,1699961,41,1,0,0,2
1699961,1700318,357,0,0,1,1
1699962,1700319,357,0,0,1,2
1700319,1700347,28,1,0,0,1
1700320,1700351,31,1,0,0,2
1700348,1702086,1738,0,0,1,1
1700352,1702086,1734,0,0,1,2
1702087,1702143,56,1,0,0,2
1702087,1702144,57,1,0,0,1
1702144,1702396,252,0,0,1,2
1702145,1702395,250,0,0,1,1
1702396,1702459,63,1,0,0,1
1702397,1702461,64,1,0,0,2
1702460,1703452,992,0,0,1,1
1702462,1703452,990,0,0,1,2
1703453,1703512,59,1,0,0,2
1703453,1703518,65,1,0,0,1
1703513,1703768,255,0,0,1,2
1703519,1703768,249,0,0,1,1
1703769,1703820,51,1,0,0,2
1703769,1703821,52,1,0,0,1
1703821,1703934,113,0,0,1,2
1703822,1703937,115,0,0,1,1
1703935,1703956,21,1,0,0,2
1703938,1703956,18,1,0,0,1
1703957,1704145,188,0,0,1,2
1703957,1704147,190,0,0,1,1
1704146,1704176,30,1,0,0,2
1704148,1704177,29,1,0,0,1
1704177,1705787,1610,0,0,1,2
1704178,1705787,1609,0,0,1,1
1705788,1705828,40,1,0,0,1
1705788,1705831,43,1,0,0,2
1705829,1708065,2236,0,0,1,1
1705832,1708064,2232,0,0,1,2
1708065,1708097,32,1,0,0,2
1708066,1708106,40,1,0,0,1
1708098,1708957,859,0,0,1,2
1708107,1708958,851,0,0,1,1
1708958,1709011,53,1,0,0,2
1708959,1709009,50,1,0,0,1
1709010,1709719,709,0,0,1,1
1709012,1709716,704,0,0,1,2
1709717,1709758,41,1,0,0,2
1709720,1709760,40,1,0,0,1
1709759,1709904,145,0,0,1,2
1709761,1709902,141,0,0,1,1
1709903,1709934,31,1,0,0,1
1709905,1709933,28,1,0,0,2
1709934,1710936,1002,0,0,1,2
1709935,1710936,1001,0,0,1,1
1710937,1710967,30,1,0,0,1
1710937,1710968,31,1,0,0,2
1710968,1711268,300,0,0,1,1
1710969,1711268,299,0,0,1,2
1711269,1711324,55,1,0,0,2
1711269,1711326,57,1,0,0,1
1711325,1711421,96,0,0,1,2
1711327,1711420,93,0,0,1,1
1711421,1711453,32,1,0,0,1
1711422,1711457,35,1,0,0,2
1711454,1712261,807,0,0,1,1
1711458,1711655,197,0,0,1,2
1711656,1711665,9,1,0,0,2
1711666,1712323,657,0,0,1,2
1712262,1712622,360,1,0,0,1
1712324,1712536,212,1,0,0,2
1712348,1712506,158,0,1,0,1
1712352,1712466,114,0,1,0,2
1712537,1712671,134,0,0,1,2
1712623,1712654,31,0,0,1,1
1712655,1712982,327,1,0,0,1
1712672,1712896,224,1,0,0,2
1712693,1712877,184,0,1,0,1
1712695,1712840,145,0,1,0,2
1712897,1713716,819,0,0,1,2
1712902,1712908,6,0,1,0,1
1712983,1713717,734,0,0,1,1
1713717,1713766,49,1,0,0,2
1713718,1713779,61,1,0,0,1
1713767,1713944,177,0,0,1,2
1713780,1713945,165,0,0,1,1
1713945,1713983,38,1,0,0,2
1713946,1713984,38,1,0,0,1
1713984,1714871,887,0,0,1,2
1713985,1714874,889,0,0,1,1
1714872,1714940,68,1,0,0,2
1714875,1714941,66,1,0,0,1
1714941,1715125,184,0,0,1,2
1714942,1715124,182,0,0,1,1
1715125,1715158,33,1,0,0,1
1715126,1715157,31,1,0,0,2
1715158,1715309,151,0,0,1,2
1715159,1715307,148,0,0,1,1
1715308,1715336,28,1,0,0,1
1715310,1715336,26,1,0,0,2
1715337,1715888,551,0,0,1,2
1715337,1715891,554,0,0,1,1
1715889,1715894,5,1,0,0,2
1715892,1715896,4,1,0,0,1
1715895,1716251,356,0,0,1,2
1715897,1716251,354,0,0,1,1
1716252,1716299,47,1,0,0,1
1716252,1716309,57,1,0,0,2
1716300,1716427,127,0,0,1,1
1716310,1716430,120,0,0,1,2
1716428,1716457,29,1,0,0,1
1716431,1716450,19,1,0,0,2
1716451,1718347,1896,0,0,1,2
1716458,1718345,1887,0,0,1,1
1718346,1718401,55,1,0,0,1
1718348,1718410,62,1,0,0,2
1718402,1719883,1481,0,0,1,1
1718411,1719884,1473,0,0,1,2
1719884,1719972,88,1,0,0,1
1719885,1719990,105,1,0,0,2
1719973,1720068,95,0,0,1,1
1719991,1720069,78,0,0,1,2
1720069,1720100,31,1,0,0,1
1720070,1720100,30,1,0,0,2
1720101,1721336,1235,0,0,1,2
1720101,1721337,1236,0,0,1,1
1721337,1721446,109,1,0,0,2
1721338,1721381,43,1,0,0,1
1721382,1721997,615,0,0,1,1
1721447,1721623,176,0,0,1,2
1721624,1721670,46,1,0,0,2
1721671,1721823,152,0,0,1,2
1721824,1721828,4,1,0,0,2
1721829,1721996,167,0,0,1,2
1721997,1722144,147,1,0,0,2
1721998,1722030,32,1,0,0,1
1722031,1722600,569,0,0,1,1
1722145,1722599,454,0,0,1,2
1722600,1722640,40,1,0,0,2
1722601,1722637,36,1,0,0,1
1722638,1723285,647,0,0,1,1
1722641,1722852,211,0,0,1,2
1722853,1722875,22,1,0,0,2
1722876,1723286,410,0,0,1,2
1723286,1723341,55,1,0,0,1
1723287,1723344,57,1,0,0,2
1723342,1723455,113,0,0,1,1
1723345,1723455,110,0,0,1,2
1723456,1723494,38,1,0,0,1
1723456,1723495,39,1,0,0,2
1723495,1724779,1284,0,0,1,1
1723496,1724778,1282,0,0,1,2
1724779,1724896,117,1,0,0,2
1724780,1724899,119,1,0,0,1
1724897,1724996,99,0,0,1,2
1724900,1724997,97,0,0,1,1
1724997,1725028,31,1,0,0,2
1724998,1725029,31,1,0,0,1
1725029,1725278,249,0,0,1,2
1725030,1725274,244,0,0,1,1
1725275,1725302,27,1,0,0,1
1725279,1725303,24,1,0,0,2
1725303,1726160,857,0,0,1,1
1725304,1726160,856,0,0,1,2
1726161,1726188,27,1,0,0,2
1726161,1726189,28,1,0,0,1
1726189,1726653,464,0,0,1,2
1726190,1726653,463,0,0,1,1
1726654,1726699,45,1,0,0,2
1726654,1726717,63,1,0,0,1
1726700,1726809,109,0,0,1,2
1726718,1726812,94,0,0,1,1
1726810,1726831,21,1,0,0,2
1726813,1726836,23,1,0,0,1
1726832,1726896,64,0,0,1,2
1726837,1727167,330,0,0,1,1
1726897,1726961,64,1,0,0,2
1726962,1727167,205,0,0,1,2
1727168,1727200,32,1,0,0,1
1727168,1727211,43,1,0,0,2
1727201,1727890,689,0,0,1,1
1727212,1727661,449,0,0,1,2
1727662,1727771,109,1,0,0,2
1727772,1727888,116,0,0,1,2
1727889,1728002,113,1,0,0,2
1727891,1727926,35,1,0,0,1
1727927,1728164,237,0,0,1,1
1728003,1728165,162,0,0,1,2
1728165,1728210,45,1,0,0,1
1728166,1728222,56,1,0,0,2
1728211,1728370,159,0,0,1,1
1728223,1728368,145,0,0,1,2
1728369,1728402,33,1,0,0,2
1728371,1728400,29,1,0,0,1
1728401,1728758,357,0,0,1,1
1728403,1728758,355,0,0,1,2
1728759,1728838,79,1,0,0,2
1728759,1728845,86,1,0,0,1
1728839,1729395,556,0,0,1,2
1728846,1729395,549,0,0,1,1
1729396,1729427,31,1,0,0,1
1729396,1729431,35,1,0,0,2
1729428,1730325,897,0,0,1,1
1729432,1730323,891,0,0,1,2
1730324,1730362,38,1,0,0,2
1730326,1730363,37,1,0,0,1
1730363,1730522,159,0,0,1,2
1730364,1730522,158,0,0,1,1
1730523,1730549,26,1,0,0,2
1730523,1730550,27,1,0,0,1
1730550,1730783,233,0,0,1,2
1730551,1730780,229,0,0,1,1
1730781,1730813,32,1,0,0,1
1730784,1730813,29,1,0,0,2
1730814,1731703,889,0,0,1,2
1730814,1731711,897,0,0,1,1
1731704,1731734,30,1,0,0,2
1731712,1731733,21,1,0,0,1
1731734,1732610,876,0,0,1,1
1731735,1732612,877,0,0,1,2
1732611,1732716,105,1,0,0,1
1732613,1732716,103,1,0,0,2
1732717,1732776,59,0,0,1,2
1732717,1733268,551,0,0,1,1
1732777,1732792,15,1,0,0,2
1732793,1733268,475,0,0,1,2
1733269,1733300,31,1,0,0,1
1733269,1733303,34,1,0,0,2
1733301,1734616,1315,0,0,1,1
1733304,1734615,1311,0,0,1,2
1734616,1734661,45,1,0,0,2
1734617,1734659,42,1,0,0,1
1734660,1734880,220,0,0,1,1
1734662,1734881,219,0,0,1,2
1734881,1734929,48,1,0,0,1
1734882,1734944,62,1,0,0,2
1734930,1735095,165,0,0,1,1
1734945,1735094,149,0,0,1,2
1735095,1735129,34,1,0,0,2
1735096,1735127,31,1,0,0,1
1735128,1735329,201,0,0,1,1
1735130,1735330,200,0,0,1,2
1735330,1735359,29,1,0,0,1
1735331,1735360,29,1,0,0,2
1735360,1736641,1281,0,0,1,1
1735361,1736641,1280,0,0,1,2
1736642,1736749,107,1,0,0,2
1736642,1736750,108,1,0,0,1
1736750,1736878,128,0,0,1,2
1736751,1736837,86,0,0,1,1
1736838,1736915,77,1,0,0,1
1736879,1736897,18,1,0,0,2
1736898,1737257,359,0,0,1,2
1736916,1737254,338,0,0,1,1
1737255,1737298,43,1,0,0,1
1737258,1737289,31,1,0,0,2
1737290,1738303,1013,0,0,1,2
1737299,1738302,1003,0,0,1,1
1738303,1738360,57,1,0,0,1
1738304,1738360,56,1,0,0,2
1738361,1740528,2167,0,0,1,1
1738361,1740528,2167,0,0,1,2
1740529,1740588,59,1,0,0,1
1740529,1740588,59,1,0,0,2
1740589,1740831,242,0,0,1,1
1740589,1740832,243,0,0,1,2
1740832,1740866,34,1,0,0,1
1740833,1740871,38,1,0,0,2
1740867,1742025,1158,0,0,1,1
1740872,1742024,1152,0,0,1,2
1742025,1742085,60,1,0,0,2
1742026,1742087,61,1,0,0,1
1742086,1742196,110,0,0,1,2
1742088,1742194,106,0,0,1,1
1742195,1742227,32,1,0,0,1
1742197,1742228,31,1,0,0,2
1742228,1742883,655,0,0,1,1
1742229,1742883,654,0,0,1,2
1742884,1742915,31,1,0,0,2
1742884,1742918,34,1,0,0,1
1742916,1743856,940,0,0,1,2
1742919,1743061,142,0,0,1,1
1743062,1743153,91,1,0,0,1
1743154,1743321,167,0,0,1,1
1743322,1743346,24,1,0,0,1
1743347,1743855,508,0,0,1,1
1743856,1743914,58,1,0,0,1
1743857,1743912,55,1,0,0,2
1743913,1744062,149,0,0,1,2
1743915,1744063,148,0,0,1,1
1744063,1744097,34,1,0,0,2
1744064,1744095,31,1,0,0,1
1744096,1744285,189,0,0,1,1
1744098,1744286,188,0,0,1,2
1744286,1744318,32,1,0,0,1
1744287,1744319,32,1,0,0,2
1744319,1745957,1638,0,0,1,1
1744320,1745958,1638,0,0,1,2
1745958,1746006,48,1,0,0,1
1745959,1746007,48,1,0,0,2
1746007,1746172,165,0,0,1,1
1746008,1746171,163,0,0,1,2
1746172,1746205,33,1,0,0,2
1746173,1746206,33,1,0,0,1
1746206,1747809,1603,0,0,1,2
1746207,1747808,1601,0,0,1,1
1747809,1747882,73,1,0,0,1
1747810,1747887,77,1,0,0,2
1747883,1747989,106,0,0,1,1
1747888,1747990,102,0,0,1,2
1747990,1748037,47,1,0,0,1
1747991,1748020,29,1,0,0,2
1748021,1748416,395,0,0,1,2
1748038,1748416,378,0,0,1,1
1748417,1748449,32,1,0,0,1
1748417,1748451,34,1,0,0,2
1748450,1748552,102,0,0,1,1
1748452,1748553,101,0,0,1,2
1748553,1748573,20,1,0,0,1
1748554,1748580,26,1,0,0,2
1748574,1749599,1025,0,0,1,1
1748581,1749602,1021,0,0,1,2
1749600,1749647,47,1,0,0,1
1749603,1749648,45,1,0,0,2
1749648,1750175,527,0,0,1,1
1749649,1750174,525,0,0,1,2
1750175,1750210,35,1,0,0,2
1750176,1750210,34,1,0,0,1
1750211,1751279,1068,0,0,1,1
1750211,1751280,1069,0,0,1,2
1751280,1751308,28,1,0,0,1
1751281,1751316,35,1,0,0,2
1751309,1751422,113,0,0,1,1
1751317,1751426,109,0,0,1,2
1751423,1751460,37,1,0,0,1
1751427,1751462,35,1,0,0,2
1751461,1751717,256,0,0,1,1
1751463,1751717,254,0,0,1,2
1751718,1751774,56,1,0,0,2
1751718,1751775,57,1,0,0,1
1751775,1752002,227,0,0,1,2
1751776,1752004,228,0,0,1,1
1752003,1752058,55,1,0,0,2
1752005,1752050,45,1,0,0,1
1752051,1752269,218,0,0,1,1
1752059,1752267,208,0,0,1,2
1752268,1752311,43,1,0,0,2
1752270,1752312,42,1,0,0,1
1752312,1753483,1171,0,0,1,2
1752313,1753484,1171,0,0,1,1
1753484,1753547,63,1,0,0,2
1753485,1753548,63,1,0,0,1
1753548,1754248,700,0,0,1,2
1753549,1753851,302,0,0,1,1
1753852,1753884,32,1,0,0,1
1753885,1754246,361,0,0,1,1
1754247,1754277,30,1,0,0,1
1754249,1754276,27,1,0,0,2
1754277,1754943,666,0,0,1,2
1754278,1754853,575,0,0,1,1
1754854,1754862,8,1,0,0,1
1754863,1754943,80,0,0,1,1
1754944,1755003,59,1,0,0,1
1754944,1755011,67,1,0,0,2
1755004,1755496,492,0,0,1,1
1755012,1755497,485,0,0,1,2
1755497,1755522,25,1,0,0,1
1755498,1755533,35,1,0,0,2
1755523,1756862,1339,0,0,1,1
1755534,1756864,1330,0,0,1,2
1756863,1756889,26,1,0,0,1
1756865,1757200,335,1,0,0,2
1756890,1756910,20,0,0,1,1
1756911,1757204,293,1,0,0,1
1756954,1757130,176,0,1,0,2
1756962,1757153,191,0,1,0,1
1757201,1758525,1324,0,0,1,2
1757205,1758523,1318,0,0,1,1
1758524,1758603,79,1,0,0,1
1758526,1758598,72,1,0,0,2
1758599,1758721,122,0,0,1,2
1758604,1758721,117,0,0,1,1
1758722,1758753,31,1,0,0,2
1758722,1758754,32,1,0,0,1
1758754,1758921,167,0,0,1,2
1758755,1758917,162,0,0,1,1
1758918,1758945,27,1,0,0,1
1758922,1758939,17,1,0,0,2
1758940,1760143,1203,0,0,1,2
1758946,1760143,1197,0,0,1,1
1760144,1760177,33,1,0,0,1
1760144,1760212,68,1,0,0,2
1760178,1760419,241,0,0,1,1
1760213,1760388,175,0,0,1,2
1760389,1760433,44,1,0,0,2
1760420,1760425,5,1,0,0,1
1760426,1762243,1817,0,0,1,1
1760434,1760576,142,0,0,1,2
1760577,1760657,80,1,0,0,2
1760658,1760711,53,0,0,1,2
1760712,1760886,174,1,0,0,2
1760887,1761654,767,0,0,1,2
1761655,1761730,75,1,0,0,2
1761731,1761764,33,0,0,1,2
1761765,1761858,93,1,0,0,2
1761859,1761911,52,0,0,1,2
1761912,1761975,63,1,0,0,2
1761976,1762244,268,0,0,1,2
1762244,1762305,61,1,0,0,1
1762245,1762308,63,1,0,0,2
1762306,1764150,1844,0,0,1,1
1762309,1764151,1842,0,0,1,2
1764151,1764206,55,1,0,0,1
1764152,1764217,65,1,0,0,2
1764207,1764480,273,0,0,1,1
1764218,1764479,261,0,0,1,2
1764480,1764520,40,1,0,0,2
1764481,1764520,39,1,0,0,1
1764521,1764878,357,0,0,1,1
1764521,1764878,357,0,0,1,2
1764879,1764911,32,1,0,0,1
1764879,1764913,34,1,0,0,2
1764912,1765683,771,0,0,1,1
1764914,1765682,768,0,0,1,2
1765683,1765717,34,1,0,0,2
1765684,1765707,23,1,0,0,1
1765708,1766571,863,0,0,1,1
1765718,1766571,853,0,0,1,2
1766572,1766613,41,1,0,0,2
1766572,1766614,42,1,0,0,1
1766614,1767446,832,0,0,1,2
1766615,1767445,830,0,0,1,1
1767446,1767477,31,1,0,0,1
1767447,1767481,34,1,0,0,2
1767478,1768684,1206,0,0,1,1
1767482,1768684,1202,0,0,1,2
1768685,1768733,48,1,0,0,2
1768685,1768743,58,1,0,0,1
1768734,1769331,597,0,0,1,2
1768744,1769330,586,0,0,1,1
1769331,1769371,40,1,0,0,1
1769332,1769367,35,1,0,0,2
1769368,1770618,1250,0,0,1,2
1769372,1770618,1246,0,0,1,1
1770619,1770649,30,1,0,0,1
1770619,1770651,32,1,0,0,2
1770650,1770838,188,0,0,1,1
1770652,1770839,187,0,0,1,2
1770839,1770869,30,1,0,0,1
1770840,1770869,29,1,0,0,2
1770870,1771245,375,0,0,1,2
1770870,1771246,376,0,0,1,1
1771246,1771278,32,1,0,0,2
1771247,1771278,31,1,0,0,1
1771279,1771467,188,0,0,1,1
1771279,1771467,188,0,0,1,2
1771468,1771493,25,1,0,0,1
1771468,1771494,26,1,0,0,2
1771494,1771697,203,0,0,1,1
1771495,1771695,200,0,0,1,2
1771696,1771726,30,1,0,0,2
1771698,1771718,20,1,0,0,1
1771719,1771870,151,0,0,1,1
1771727,1771872,145,0,0,1,2
1771871,1771901,30,1,0,0,1
1771873,1771904,31,1,0,0,2
1771902,1772376,474,0,0,1,1
1771905,1772378,473,0,0,1,2
1772377,1772430,53,1,0,0,1
1772379,1772432,53,1,0,0,2
1772431,1772643,212,0,0,1,1
1772433,1772645,212,0,0,1,2
1772644,1772675,31,1,0,0,1
1772646,1772680,34,1,0,0,2
1772676,1773078,402,0,0,1,1
1772681,1773077,396,0,0,1,2
1773078,1773116,38,1,0,0,2
1773079,1773114,35,1,0,0,1
1773115,1773693,578,0,0,1,1
1773117,1773693,576,0,0,1,2
1773694,1773729,35,1,0,0,1
1773694,1773730,36,1,0,0,2
1773730,1774439,709,0,0,1,1
1773731,1774439,708,0,0,1,2
1774440,1774489,49,1,0,0,1
1774440,1774492,52,1,0,0,2
1774490,1774642,152,0,0,1,1
1774493,1774643,150,0,0,1,2
1774643,1774672,29,1,0,0,1
1774644,1774672,28,1,0,0,2
1774673,1774911,238,0,0,1,2
1774673,1774912,239,0,0,1,1
1774912,1774931,19,1,0,0,2
1774913,1774935,22,1,0,0,1
1774932,1775238,306,0,0,1,2
1774936,1775237,301,0,0,1,1
1775238,1775259,21,1,0,0,1
1775239,1775262,23,1,0,0,2
1775260,1776266,1006,0,0,1,1
1775263,1776266,1003,0,0,1,2
1776267,1776300,33,1,0,0,1
1776267,1776300,33,1,0,0,2
1776301,1777585,1284,0,0,1,2
1776301,1777586,1285,0,0,1,1
1777586,1777651,65,1,0,0,2
1777587,1777650,63,1,0,0,1
1777651,1777762,111,0,0,1,1
1777652,1777762,110,0,0,1,2
1777763,1777788,25,1,0,0,1
1777763,1777798,35,1,0,0,2
1777789,1778242,453,0,0,1,1
1777799,1778243,444,0,0,1,2
1778243,1778276,33,1,0,0,1
1778244,1778278,34,1,0,0,2
1778277,1779651,1374,0,0,1,1
1778279,1778485,206,0,0,1,2
1778486,1778614,128,1,0,0,2
1778615,1778668,53,0,0,1,2
1778669,1778689,20,1,0,0,2
1778690,1778802,112,0,0,1,2
1778803,1778836,33,1,0,0,2
1778837,1779374,537,0,0,1,2
1779375,1779726,351,1,0,0,2
1779652,1779727,75,1,0,0,1
1779727,1780131,404,0,0,1,2
1779728,1780132,404,0,0,1,1
1780132,1780197,65,1,0,0,2
1780133,1780198,65,1,0,0,1
1780198,1780525,327,0,0,1,2
1780199,1780525,326,0,0,1,1
1780526,1780582,56,1,0,0,1
1780526,1780582,56,1,0,0,2
1780583,1780820,237,0,0,1,1
1780583,1780821,238,0,0,1,2
1780821,1780854,33,1,0,0,1
1780822,1780846,24,1,0,0,2
1780847,1781117,270,0,0,1,2
1780855,1782405,1550,0,0,1,1
1781118,1781131,13,1,0,0,2
1781132,1781892,760,0,0,1,2
1781893,1781910,17,1,0,0,2
1781911,1782406,495,0,0,1,2
1782406,1782475,69,1,0,0,1
1782407,1782468,61,1,0,0,2
1782469,1782673,204,0,0,1,2
1782476,1782674,198,0,0,1,1
1782674,1782713,39,1,0,0,2
1782675,1782710,35,1,0,0,1
1782711,1783568,857,0,0,1,1
1782714,1783567,853,0,0,1,2
1783568,1783621,53,1,0,0,2
1783569,1783618,49,1,0,0,1
1783619,1784442,823,0,0,1,1
1783622,1783963,341,0,0,1,2
1783964,1783980,16,1,0,0,2
1783981,1784384,403,0,0,1,2
1784385,1784399,14,1,0,0,2
1784400,1784441,41,0,0,1,2
1784442,1784505,63,1,0,0,2
1784443,1784507,64,1,0,0,1
1784506,1784626,120,0,0,1,2
1784508,1784625,117,0,0,1,1
1784626,1784665,39,1,0,0,1
1784627,1784665,38,1,0,0,2
1784666,1784827,161,0,0,1,2
1784666,1784828,162,0,0,1,1
1784828,1784864,36,1,0,0,2
1784829,1784862,33,1,0,0,1
1784863,1785097,234,0,0,1,1
1784865,1785096,231,0,0,1,2
1785097,1785132,35,1,0,0,2
1785098,1785132,34,1,0,0,1
1785133,1786120,987,0,0,1,1
1785133,1786122,989,0,0,1,2
1786121,1786208,87,1,0,0,1
1786123,1786194,71,1,0,0,2
1786195,1786441,246,0,0,1,2
1786209,1786442,233,0,0,1,1
1786442,1786474,32,1,0,0,2
1786443,1786472,29,1,0,0,1
1786473,1788013,1540,0,0,1,1
1786475,1786771,296,0,0,1,2
1786772,1786787,15,1,0,0,2
1786788,1788014,1226,0,0,1,2
1788014,1788080,66,1,0,0,1
1788015,1788080,65,1,0,0,2
1788081,1790119,2038,0,0,1,1
1788081,1790120,2039,0,0,1,2
1790120,1790186,66,1,0,0,1
1790121,1790180,59,1,0,0,2
1790181,1790339,158,0,0,1,2
1790187,1790339,152,0,0,1,1
1790340,1790376,36,1,0,0,2
1790340,1790378,38,1,0,0,1
1790377,1790707,330,0,0,1,2
1790379,1790707,328,0,0,1,1
1790708,1790740,32,1,0,0,1
1790708,1790741,33,1,0,0,2
1790741,1790949,208,0,0,1,1
1790742,1790949,207,0,0,1,2
1790950,1790981,31,1,0,0,1
1790950,1790984,34,1,0,0,2
1790982,1791248,266,0,0,1,1
1790985,1791248,263,0,0,1,2
1791249,1791283,34,1,0,0,1
1791249,1791284,35,1,0,0,2
1791284,1792049,765,0,0,1,1
1791285,1792050,765,0,0,1,2
1792050,1792089,39,1,0,0,1
1792051,1792088,37,1,0,0,2
1792089,1792467,378,0,0,1,2
1792090,1792466,376,0,0,1,1
1792467,1792517,50,1,0,0,1
1792468,1792519,51,1,0,0,2
1792518,1792652,134,0,0,1,1
1792520,1792651,131,0,0,1,2
1792652,1792677,25,1,0,0,2
1792653,1792676,23,1,0,0,1
1792677,1794307,1630,0,0,1,1
1792678,1794307,1629,0,0,1,2
1794308,1794338,30,1,0,0,2
1794308,1794339,31,1,0,0,1
1794339,1794589,250,0,0,1,2
1794340,1794588,248,0,0,1,1
1794589,1794635,46,1,0,0,1
1794590,1794636,46,1,0,0,2
1794636,1796743,2107,0,0,1,1
1794637,1796743,2106,0,0,1,2
1796744,1796807,63,1,0,0,1
1796744,1796809,65,1,0,0,2
1796808,1797135,327,0,0,1,1
1796810,1797135,325,0,0,1,2
1797136,1797168,32,1,0,0,1
1797136,1797170,34,1,0,0,2
1797169,1797495,326,0,0,1,1
1797171,1797493,322,0,0,1,2
1797494,1797524,30,1,0,0,2
1797496,1797528,32,1,0,0,1
1797525,1798204,679,0,0,1,2
1797529,1798203,674,0,0,1,1
1798204,1798275,71,1,0,0,1
1798205,1798284,79,1,0,0,2
1798276,1798406,130,0,0,1,1
1798285,1798406,121,0,0,1,2
1798407,1798432,25,1,0,0,1
1798407,1798432,25,1,0,0,2
1798433,1798617,184,0,0,1,1
1798433,1798618,185,0,0,1,2
1798618,1798650,32,1,0,0,1
1798619,1798654,35,1,0,0,2
1798651,1798818,167,0,0,1,1
1798655,1798814,159,0,0,1,2
1798815,1798842,27,1,0,0,2
1798819,1798831,12,1,0,0,1
1798832,1799369,537,0,0,1,1
1798843,1799364,521,0,0,1,2
1799365,1799395,30,1,0,0,2
1799370,1799393,23,1,0,0,1
1799394,1800280,886,0,0,1,1
1799396,1800280,884,0,0,1,2
1800281,1800332,51,1,0,0,1
1800281,1800332,51,1,0,0,2
1800333,1800558,225,0,0,1,1
1800333,1800559,226,0,0,1,2
1800559,1800576,17,1,0,0,1
1800560,1800573,13,1,0,0,2
1800574,1802449,1875,0,0,1,2
1800577,1802449,1872,0,0,1,1
1802450,1802515,65,1,0,0,1
1802450,1802516,66,1,0,0,2
1802516,1802930,414,0,0,1,1
1802517,1802932,415,0,0,1,2
1802931,1802965,34,1,0,0,1
1802933,1802963,30,1,0,0,2
1802964,1804391,1427,0,0,1,2
1802966,1804391,1425,0,0,1,1
1804392,1804460,68,1,0,0,2
1804392,1804461,69,1,0,0,1
1804461,1804555,94,0,0,1,2
1804462,1804554,92,0,0,1,1
1804555,1804588,33,1,0,0,1
1804556,1804586,30,1,0,0,2
1804587,1804912,325,0,0,1,2
1804589,1804913,324,0,0,1,1
1804913,1804934,21,1,0,0,2
1804914,1804931,17,1,0,0,1
1804932,1805140,208,0,0,1,1
1804935,1805140,205,0,0,1,2
1805141,1805174,33,1,0,0,1
1805141,1805177,36,1,0,0,2
1805175,1806767,1592,0,0,1,1
1805178,1806769,1591,0,0,1,2
1806768,1806827,59,1,0,0,1
1806770,1806825,55,1,0,0,2
1806826,1806965,139,0,0,1,2
1806828,1806966,138,0,0,1,1
1806966,1806985,19,1,0,0,2
1806967,1806982,15,1,0,0,1
1806983,1807141,158,0,0,1,1
1806986,1807141,155,0,0,1,2
1807142,1807173,31,1,0,0,1
1807142,1807176,34,1,0,0,2
1807174,1807462,288,0,0,1,1
1807177,1807460,283,0,0,1,2
1807461,1807491,30,1,0,0,2
1807463,1807494,31,1,0,0,1
1807492,1808207,715,0,0,1,2
1807495,1808210,715,0,0,1,1
1808208,1808243,35,1,0,0,2
1808211,1808269,58,1,0,0,1
1808244,1808447,203,0,0,1,2
1808270,1808451,181,0,0,1,1
1808448,1808478,30,1,0,0,2
1808452,1808528,76,1,0,0,1
1808479,1809108,629,0,0,1,2
1808529,1809108,579,0,0,1,1
1809109,1809209,100,1,0,0,1
1809109,1809215,106,1,0,0,2
1809210,1809267,57,0,0,1,1
1809216,1809268,52,0,0,1,2
1809268,1809318,50,1,0,0,1
1809269,1809305,36,1,0,0,2
1809306,1809476,170,0,0,1,2
1809319,1809478,159,0,0,1,1
1809477,1809510,33,1,0,0,2
1809479,1809502,23,1,0,0,1
1809503,1809874,371,0,0,1,1
1809511,1809875,364,0,0,1,2
1809875,1809904,29,1,0,0,1
1809876,1809905,29,1,0,0,2
1809905,1810874,969,0,0,1,1
1809906,1810875,969,0,0,1,2
1810875,1810957,82,1,0,0,1
1810876,1810968,92,1,0,0,2
1810958,1811239,281,0,0,1,1
1810969,1811236,267,0,0,1,2
1811237,1811269,32,1,0,0,2
1811240,1811267,27,1,0,0,1
1811268,1812736,1468,0,0,1,1
1811270,1812180,910,0,0,1,2
1812181,1812215,34,1,0,0,2
1812216,1812499,283,0,0,1,2
1812500,1812523,23,1,0,0,2
1812524,1812737,213,0,0,1,2
1812737,1812783,46,1,0,0,1
1812738,1812781,43,1,0,0,2
1812782,1812897,115,0,0,1,2
1812784,1812898,114,0,0,1,1
1812898,1812924,26,1,0,0,2
1812899,1812927,28,1,0,0,1
1812925,1813389,464,0,0,1,2
1812928,1813390,462,0,0,1,1
1813390,1813421,31,1,0,0,2
1813391,1813418,27,1,0,0,1
1813419,1814932,1513,0,0,1,1
1813422,1814931,1509,0,0,1,2
1814932,1814989,57,1,0,0,2
1814933,1814989,56,1,0,0,1
1814990,1815235,245,0,0,1,2
1814990,1815236,246,0,0,1,1
1815236,1815300,64,1,0,0,2
1815237,1815300,63,1,0,0,1
1815301,1815734,433,0,0,1,1
1815301,1815734,433,0,0,1,2
1815735,1815780,45,1,0,0,1
1815735,1815781,46,1,0,0,2
1815781,1816378,597,0,0,1,1
1815782,1816378,596,0,0,1,2
1816379,1816446,67,1,0,0,1
1816379,1816461,82,1,0,0,2
1816447,1816534,87,0,0,1,1
1816462,1816533,71,0,0,1,2
1816534,1816569,35,1,0,0,2
1816535,1816568,33,1,0,0,1
1816569,1816715,146,0,0,1,1
1816570,1816718,148,0,0,1,2
1816716,1816734,18,1,0,0,1
1816719,1816730,11,1,0,0,2
1816731,1817303,572,0,0,1,2
1816735,1817593,858,0,0,1,1
1817304,1817320,16,1,0,0,2
1817321,1817490,169,0,0,1,2
1817491,1817536,45,1,0,0,2
1817537,1817592,55,0,0,1,2
1817593,1817650,57,1,0,0,2
1817594,1817643,49,1,0,0,1
1817644,1818197,553,0,0,1,1
1817651,1818138,487,0,0,1,2
1818139,1818170,31,1,0,0,2
1818171,1818192,21,0,0,1,2
1818193,1818227,34,1,0,0,2
1818198,1818226,28,1,0,0,1
1818227,1819084,857,0,0,1,1
1818228,1818834,606,0,0,1,2
1818835,1818854,19,1,0,0,2
1818855,1819083,228,0,0,1,2
1819084,1819145,61,1,0,0,2
1819085,1819148,63,1,0,0,1
1819146,1819560,414,0,0,1,2
1819149,1819558,409,0,0,1,1
1819559,1819583,24,1,0,0,1
1819561,1819583,22,1,0,0,2
1819584,1820075,491,0,0,1,1
1819584,1820075,491,0,0,1,2
1820076,1820106,30,1,0,0,1
1820076,1820108,32,1,0,0,2
1820107,1821252,1145,0,0,1,1
1820109,1821252,1143,0,0,1,2
1821253,1821327,74,1,0,0,1
1821253,1821336,83,1,0,0,2
1821328,1821890,562,0,0,1,1
1821337,1821891,554,0,0,1,2
1821891,1821934,43,1,0,0,1
1821892,1821926,34,1,0,0,2
1821927,1822780,853,0,0,1,2
1821935,1822778,843,0,0,1,1
1822779,1822818,39,1,0,0,1
1822781,1822824,43,1,0,0,2
1822819,1823143,324,0,0,1,1
1822825,1823144,319,0,0,1,2
1823144,1823162,18,1,0,0,1
1823145,1823174,29,1,0,0,2
1823163,1823365,202,0,0,1,1
1823175,1823359,184,0,0,1,2
1823360,1823406,46,1,0,0,2
1823366,1823406,40,1,0,0,1
1823407,1823570,163,0,0,1,1
1823407,1823571,164,0,0,1,2
1823571,1823608,37,1,0,0,1
1823572,1823599,27,1,0,0,2
1823600,1823943,343,0,0,1,2
1823609,1823943,334,0,0,1,1
1823944,1823982,38,1,0,0,2
1823944,1823983,39,1,0,0,1
1823983,1824134,151,0,0,1,2
1823984,1824133,149,0,0,1,1
1824134,1824160,26,1,0,0,1
1824135,1824167,32,1,0,0,2
1824161,1824427,266,0,0,1,1
1824168,1824452,284,0,0,1,2
1824428,1824432,4,1,0,0,1
1824433,1824453,20,0,0,1,1
1824453,1826871,2418,1,0,0,2
1824454,1826837,2383,1,0,0,1
1824524,1826861,2337,0,1,0,2
1824528,1826827,2299,0,1,0,1
1826838,1826882,44,0,0,1,1
1826872,1826947,75,0,0,1,2
1826883,1826908,25,1,0,0,1
1826909,1826952,43,0,0,1,1
1826948,1826970,22,1,0,0,2
1826953,1826970,17,1,0,0,1
1826971,1826997,26,0,0,1,1
1826971,1827055,84,0,0,1,2
1826998,1827444,446,1,0,0,1
1827056,1827403,347,1,0,0,2
1827123,1827376,253,0,1,0,1
1827148,1827348,200,0,1,0,2
1827404,1827630,226,0,0,1,2
1827445,1827630,185,0,0,1,1
1827631,1827670,39,1,0,0,1
1827631,1827672,41,1,0,0,2
1827671,1827955,284,0,0,1,1
1827673,1827956,283,0,0,1,2
1827956,1827991,35,1,0,0,1
1827957,1827990,33,1,0,0,2
1827991,1828125,134,0,0,1,2
1827992,1828123,131,0,0,1,1
1828124,1828171,47,1,0,0,1
1828126,1828180,54,1,0,0,2
1828172,1828445,273,0,0,1,1
1828181,1828445,264,0,0,1,2
1870318,1870561,243,0,0,1,1
1870318,1870561,243,0,0,1,2
1870562,1870630,68,1,0,0,1
1870562,1870632,70,1,0,0,2
1870631,1870683,52,0,0,1,1
1870633,1870684,51,0,0,1,2
1870684,1870743,59,1,0,0,1
1870685,1870740,55,1,0,0,2
1870741,1870892,151,0,0,1,2
1870744,1870890,146,0,0,1,1
1870891,1870920,29,1,0,0,1
1870893,1870919,26,1,0,0,2
1870920,1871092,172,0,0,1,2
1870921,1872819,1898,0,0,1,1
1871093,1871110,17,1,0,0,2
1871111,1872820,1709,0,0,1,2
1872820,1872881,61,1,0,0,1
1872821,1872891,70,1,0,0,2
1872882,1872966,84,0,0,1,1
1872892,1872966,74,0,0,1,2
1872967,1872996,29,1,0,0,1
1872967,1872997,30,1,0,0,2
1872997,1873202,205,0,0,1,1
1872998,1873202,204,0,0,1,2
1873203,1873233,30,1,0,0,1
1873203,1873233,30,1,0,0,2
1873234,1874800,1566,0,0,1,1
1873234,1874801,1567,0,0,1,2
1874801,1874825,24,1,0,0,1
1874802,1874846,44,1,0,0,2
1874826,1874991,165,0,0,1,1
1874847,1874992,145,0,0,1,2
1874992,1875050,58,1,0,0,1
1874993,1875051,58,1,0,0,2
1875051,1875245,194,0,0,1,1
1875052,1875246,194,0,0,1,2
1875246,1875337,91,1,0,0,1
1875247,1875333,86,1,0,0,2
1875334,1875423,89,0,0,1,2
1875338,1875423,85,0,0,1,1
1875424,1875460,36,1,0,0,1
1875424,1875465,41,1,0,0,2
1875461,1876070,609,0,0,1,1
1875466,1876069,603,0,0,1,2
1876070,1876102,32,1,0,0,2
1876071,1876103,32,1,0,0,1
1876103,1877150,1047,0,0,1,2
1876104,1877150,1046,0,0,1,1
1877151,1877224,73,1,0,0,1
1877151,1877238,87,1,0,0,2
1877225,1877331,106,0,0,1,1
1877239,1877331,92,0,0,1,2
1877332,1877400,68,1,0,0,1
1877332,1877405,73,1,0,0,2
1877401,1877493,92,0,0,1,1
1877406,1877493,87,0,0,1,2
1877494,1877544,50,1,0,0,1
1877494,1877545,51,1,0,0,2
1877545,1877641,96,0,0,1,1
1877546,1877642,96,0,0,1,2
1877642,1877690,48,1,0,0,1
1877643,1877695,52,1,0,0,2
1877691,1877840,149,0,0,1,1
1877696,1877836,140,0,0,1,2
1877837,1877860,23,1,0,0,2
1877841,1877861,20,1,0,0,1
1877861,1878216,355,0,0,1,2
1877862,1878218,356,0,0,1,1
1878217,1878246,29,1,0,0,2
1878219,1878244,25,1,0,0,1
1878245,1878607,362,0,0,1,1
1878247,1878603,356,0,0,1,2
1878604,1878634,30,1,0,0,2
1878608,1878633,25,1,0,0,1
1878634,1879476,842,0,0,1,1
1878635,1879476,841,0,0,1,2
1879477,1879531,54,1,0,0,1
1879477,1879531,54,1,0,0,2
1879532,1879805,273,0,0,1,1
1879532,1879805,273,0,0,1,2
1879806,1879867,61,1,0,0,1
1879806,1879868,62,1,0,0,2
1879868,1879963,95,0,0,1,1
1879869,1879964,95,0,0,1,2
1879964,1879995,31,1,0,0,1
1879965,1879990,25,1,0,0,2
1879991,1880188,197,0,0,1,2
1879996,1880188,192,0,0,1,1
1880189,1880215,26,1,0,0,1
1880189,1880216,27,1,0,0,2
1880216,1880391,175,0,0,1,1
1880217,1880631,414,0,0,1,2
1880392,1880400,8,1,0,0,1
1880401,1880629,228,0,0,1,1
1880630,1880698,68,1,0,0,1
1880632,1880665,33,1,0,0,2
1880666,1881392,726,0,0,1,2
1880699,1881393,694,0,0,1,1
1881393,1881476,83,1,0,0,2
1881394,1881477,83,1,0,0,1
1881477,1881691,214,0,0,1,2
1881478,1881690,212,0,0,1,1
1881691,1881759,68,1,0,0,1
1881692,1881762,70,1,0,0,2
1881760,1881845,85,0,0,1,1
1881763,1881845,82,0,0,1,2
1881846,1881883,37,1,0,0,2
1881846,1881884,38,1,0,0,1
1881884,1883601,1717,0,0,1,2
1881885,1883600,1715,0,0,1,1
1883601,1883657,56,1,0,0,1
1883602,1883666,64,1,0,0,2
1883658,1883817,159,0,0,1,1
1883667,1883816,149,0,0,1,2
1883817,1883880,63,1,0,0,2
1883818,1883880,62,1,0,0,1
1883881,1883985,104,0,0,1,1
1883881,1883987,106,0,0,1,2
1883986,1884060,74,1,0,0,1
1883988,1884045,57,1,0,0,2
1884046,1884149,103,0,0,1,2
1884061,1884150,89,0,0,1,1
1884150,1884209,59,1,0,0,2
1884151,1884180,29,1,0,0,1
1884181,1884452,271,0,0,1,1
1884210,1884453,243,0,0,1,2
1884453,1884490,37,1,0,0,1
1884454,1884481,27,1,0,0,2
1884482,1885763,1281,0,0,1,2
1884491,1885762,1271,0,0,1,1
1885763,1885829,66,1,0,0,1
1885764,1885829,65,1,0,0,2
1885830,1885911,81,0,0,1,2
1885830,1885912,82,0,0,1,1
1885912,1885966,54,1,0,0,2
1885913,1885967,54,1,0,0,1
1885967,1886249,282,0,0,1,2
1885968,1886250,282,0,0,1,1
1886250,1886331,81,1,0,0,2
1886251,1886319,68,1,0,0,1
1886320,1886471,151,0,0,1,1
1886332,1886469,137,0,0,1,2
1886470,1886495,25,1,0,0,2
1886472,1886489,17,1,0,0,1
1886490,1888814,2324,0,0,1,1
1886496,1888815,2319,0,0,1,2
1888815,1888924,109,1,0,0,1
1888816,1888926,110,1,0,0,2
1888925,1889006,81,0,0,1,1
1888927,1889006,79,0,0,1,2
1889007,1889060,53,1,0,0,1
1889007,1889062,55,1,0,0,2
1889061,1890441,1380,0,0,1,1
1889063,1890441,1378,0,0,1,2
1890442,1890505,63,1,0,0,1
1890442,1890522,80,1,0,0,2
1890506,1890856,350,0,0,1,1
1890523,1890857,334,0,0,1,2
1890857,1890921,64,1,0,0,1
1890858,1890940,82,1,0,0,2
1890922,1891014,92,0,0,1,1
1890941,1891020,79,0,0,1,2
1891015,1891039,24,1,0,0,1
1891021,1891041,20,1,0,0,2
1891040,1891560,520,0,0,1,1
1891042,1891566,524,0,0,1,2
1891561,1891584,23,1,0,0,1
1891567,1891589,22,1,0,0,2
1891585,1892582,997,0,0,1,1
1891590,1891831,241,0,0,1,2
1891832,1891854,22,1,0,0,2
1891855,1892296,441,0,0,1,2
1892297,1892316,19,1,0,0,2
1892317,1892583,266,0,0,1,2
1892583,1892661,78,1,0,0,1
1892584,1892659,75,1,0,0,2
1892660,1892825,165,0,0,1,2
1892662,1892822,160,0,0,1,1
1892823,1892907,84,1,0,0,1
1892826,1892902,76,1,0,0,2
1892903,1893013,110,0,0,1,2
1892908,1893011,103,0,0,1,1
1893012,1893050,38,1,0,0,1
1893014,1893052,38,1,0,0,2
1893051,1894315,1264,0,0,1,1
1893053,1894315,1262,0,0,1,2
1894316,1894403,87,1,0,0,2
1894316,1894409,93,1,0,0,1
1894404,1894716,312,0,0,1,2
1894410,1894716,306,0,0,1,1
1894717,1894756,39,1,0,0,1
1894717,1894761,44,1,0,0,2
1894757,1894872,115,0,0,1,1
1894762,1894872,110,0,0,1,2
1894873,1894904,31,1,0,0,1
1894873,1894904,31,1,0,0,2
1894905,1897238,2333,0,0,1,1
1894905,1897239,2334,0,0,1,2
1897239,1897327,88,1,0,0,1
1897240,1897342,102,1,0,0,2
1897328,1899666,2338,0,0,1,1
1897343,1899667,2324,0,0,1,2
1899667,1899764,97,1,0,0,1
1899668,1899767,99,1,0,0,2
1899765,1899848,83,0,0,1,1
1899768,1899848,80,0,0,1,2
1899849,1899880,31,1,0,0,1
1899849,1899902,53,1,0,0,2
1899881,1901867,1986,0,0,1,1
1899903,1901867,1964,0,0,1,2
1901868,1901924,56,1,0,0,1
1901868,1901943,75,1,0,0,2
1901925,1903877,1952,0,0,1,1
1901944,1902648,704,0,0,1,2
1902649,1902972,323,1,0,0,2
1902973,1903111,138,0,0,1,2
1903112,1903180,68,1,0,0,2
1903181,1903242,61,0,0,1,2
1903243,1903314,71,1,0,0,2
1903315,1903394,79,0,0,1,2
1903395,1903468,73,1,0,0,2
1903469,1903877,408,0,0,1,2
1903878,1903962,84,1,0,0,2
1903878,1903967,89,1,0,0,1
1903963,1904016,53,0,0,1,2
1903968,1904017,49,0,0,1,1
1904017,1904052,35,1,0,0,2
1904018,1904056,38,1,0,0,1
1904053,1904161,108,0,0,1,2
1904057,1904160,103,0,0,1,1
1904161,1904190,29,1,0,0,1
1904162,1904184,22,1,0,0,2
1904185,1904457,272,0,0,1,2
1904191,1904457,266,0,0,1,1
1904458,1904488,30,1,0,0,1
1904458,1904488,30,1,0,0,2
1904489,1904587,98,0,0,1,1
1904489,1904588,99,0,0,1,2
1904588,1904616,28,1,0,0,1
1904589,1904620,31,1,0,0,2
1904617,1904853,236,0,0,1,1
1904621,1904852,231,0,0,1,2
1904853,1904883,30,1,0,0,2
1904854,1904889,35,1,0,0,1
1904884,1905029,145,0,0,1,2
1904890,1905024,134,0,0,1,1
1905025,1905044,19,1,0,0,1
1905030,1905046,16,1,0,0,2
1905045,1905711,666,0,0,1,1
1905047,1905709,662,0,0,1,2
1905710,1905770,60,1,0,0,2
1905712,1905769,57,1,0,0,1
1905770,1906066,296,0,0,1,1
1905771,1906067,296,0,0,1,2
1906067,1906158,91,1,0,0,1
1906068,1906160,92,1,0,0,2
1906159,1906314,155,0,0,1,1
1906161,1906316,155,0,0,1,2
1906315,1906347,32,1,0,0,1
1906317,1906350,33,1,0,0,2
1906348,1906525,177,0,0,1,1
1906351,1906523,172,0,0,1,2
1906524,1906550,26,1,0,0,2
1906526,1906539,13,1,0,0,1
1906540,1907024,484,0,0,1,1
1906551,1907026,475,0,0,1,2
1907025,1907065,40,1,0,0,1
1907027,1907065,38,1,0,0,2
1907066,1907323,257,0,0,1,1
1907066,1907323,257,0,0,1,2
1907324,1907354,30,1,0,0,1
1907324,1907355,31,1,0,0,2
1907355,1907642,287,0,0,1,1
1907356,1907641,285,0,0,1,2
1907642,1907701,59,1,0,0,2
1907643,1907702,59,1,0,0,1
1907702,1907879,177,0,0,1,2
1907703,1907878,175,0,0,1,1
1907879,1907928,49,1,0,0,1
1907880,1907926,46,1,0,0,2
1907927,1908098,171,0,0,1,2
1907929,1908099,170,0,0,1,1
1908099,1908158,59,1,0,0,2
1908100,1908160,60,1,0,0,1
1908159,1908249,90,0,0,1,2
1908161,1908249,88,0,0,1,1
1908250,1908279,29,1,0,0,1
1908250,1908283,33,1,0,0,2
1908280,1909052,772,0,0,1,1
1908284,1909053,769,0,0,1,2
1909053,1909077,24,1,0,0,1
1909054,1909077,23,1,0,0,2
1909078,1909267,189,0,0,1,2
1909078,1909269,191,0,0,1,1
1909268,1909299,31,1,0,0,2
1909270,1909299,29,1,0,0,1
1909300,1910216,916,0,0,1,1
1909300,1910217,917,0,0,1,2
1910217,1910253,36,1,0,0,1
1910218,1910257,39,1,0,0,2
1910254,1910492,238,0,0,1,1
1910258,1910492,234,0,0,1,2
1910493,1910567,74,1,0,0,2
1910493,1910624,131,1,0,0,1
1910568,1910656,88,0,0,1,2
1910625,1910656,31,0,0,1,1
1910657,1910690,33,1,0,0,1
1910657,1910693,36,1,0,0,2
1910691,1911159,468,0,0,1,1
1910694,1911159,465,0,0,1,2
1911160,1911207,47,1,0,0,1
1911160,1911210,50,1,0,0,2
1911208,1911339,131,0,0,1,1
1911211,1911338,127,0,0,1,2
1911339,1911371,32,1,0,0,2
1911340,1911368,28,1,0,0,1
1911369,1911617,248,0,0,1,1
1911372,1911618,246,0,0,1,2
1911618,1911651,33,1,0,0,1
1911619,1911654,35,1,0,0,2
1911652,1912373,721,0,0,1,1
1911655,1912374,719,0,0,1,2
1912374,1912444,70,1,0,0,1
1912375,1912539,164,1,0,0,2
1912445,1912672,227,0,0,1,1
1912540,1912668,128,0,0,1,2
1912669,1912730,61,1,0,0,2
1912673,1912729,56,1,0,0,1
1912730,1912843,113,0,0,1,1
1912731,1912843,112,0,0,1,2
1912844,1912924,80,1,0,0,2
1912844,1912926,82,1,0,0,1
1912925,1913047,122,0,0,1,2
1912927,1913046,119,0,0,1,1
1913047,1913066,19,1,0,0,1
1913048,1913070,22,1,0,0,2
1913067,1914596,1529,0,0,1,1
1913071,1914598,1527,0,0,1,2
1914597,1914655,58,1,0,0,1
1914599,1914658,59,1,0,0,2
1914656,1914847,191,0,0,1,1
1914659,1914847,188,0,0,1,2
1914848,1914901,53,1,0,0,1
1914848,1914902,54,1,0,0,2
1914902,1914986,84,0,0,1,1
1914903,1914987,84,0,0,1,2
1914987,1915021,34,1,0,0,1
1914988,1915083,95,1,0,0,2
1915022,1916802,1780,0,0,1,1
1915084,1916802,1718,0,0,1,2
1916803,1916851,48,1,0,0,1
1916803,1916854,51,1,0,0,2
1916852,1917188,336,0,0,1,1
1916855,1917190,335,0,0,1,2
1917189,1917282,93,1,0,0,1
1917191,1917308,117,1,0,0,2
1917283,1917383,100,0,0,1,1
1917309,1917382,73,0,0,1,2
1917383,1917421,38,1,0,0,2
1917384,1917425,41,1,0,0,1
1917422,1918994,1572,0,0,1,2
1917426,1918996,1570,0,0,1,1
1918995,1919071,76,1,0,0,2
1918997,1919068,71,1,0,0,1
1919069,1919367,298,0,0,1,1
1919072,1919369,297,0,0,1,2
1919368,1919431,63,1,0,0,1
1919370,1919435,65,1,0,0,2
1919432,1919547,115,0,0,1,1
1919436,1919546,110,0,0,1,2
1919547,1919579,32,1,0,0,2
1919548,1919579,31,1,0,0,1
1919580,1920933,1353,0,0,1,2
1919580,1920934,1354,0,0,1,1
1920934,1920998,64,1,0,0,2
1920935,1920995,60,1,0,0,1
1920996,1921326,330,0,0,1,1
1920999,1921326,327,0,0,1,2
1921327,1921410,83,1,0,0,2
1921327,1921411,84,1,0,0,1
1921411,1921483,72,0,0,1,2
1921412,1921482,70,0,0,1,1
1921483,1921534,51,1,0,0,1
1921484,1921527,43,1,0,0,2
1921528,1923455,1927,0,0,1,2
1921535,1923455,1920,0,0,1,1
1923456,1923538,82,1,0,0,1
1923456,1923538,82,1,0,0,2
1923539,1923651,112,0,0,1,1
1923539,1923651,112,0,0,1,2
1923652,1923686,34,1,0,0,2
1923652,1923687,35,1,0,0,1
1923687,1925667,1980,0,0,1,2
1923688,1925666,1978,0,0,1,1
1925667,1925742,75,1,0,0,1
1925668,1925743,75,1,0,0,2
1925743,1925884,141,0,0,1,1
1925744,1925886,142,0,0,1,2
1925885,1925921,36,1,0,0,1
1925887,1925926,39,1,0,0,2
1925922,1927782,1860,0,0,1,1
1925927,1927782,1855,0,0,1,2
1927783,1927841,58,1,0,0,1
1927783,1927850,67,1,0,0,2
1927842,1928025,183,0,0,1,1
1927851,1928024,173,0,0,1,2
1928025,1928058,33,1,0,0,2
1928026,1928048,22,1,0,0,1
1928049,1928483,434,0,0,1,1
1928059,1928481,422,0,0,1,2
1928482,1928516,34,1,0,0,2
1928484,1928514,30,1,0,0,1
1928515,1929848,1333,0,0,1,1
1928517,1929848,1331,0,0,1,2
1929849,1929902,53,1,0,0,1
1929849,1929905,56,1,0,0,2
1929903,1930108,205,0,0,1,1
1929906,1930107,201,0,0,1,2
1930108,1930232,124,1,0,0,2
1930109,1930218,109,1,0,0,1
1930219,1930314,95,0,0,1,1
1930233,1930315,82,0,0,1,2
1930315,1930363,48,1,0,0,1
1930316,1930352,36,1,0,0,2
1930353,1930562,209,0,0,1,2
1930364,1930566,202,0,0,1,1
1930563,1930589,26,1,0,0,2
1930567,1930587,20,1,0,0,1
1930588,1931024,436,0,0,1,1
1930590,1930757,167,0,0,1,2
1930758,1930770,12,1,0,0,2
1930771,1931025,254,0,0,1,2
1931025,1931056,31,1,0,0,1
1931026,1931061,35,1,0,0,2
1931057,1931190,133,0,0,1,1
1931062,1931190,128,0,0,1,2
1931191,1931222,31,1,0,0,1
1931191,1931228,37,1,0,0,2
1931223,1931699,476,0,0,1,1
1931229,1931700,471,0,0,1,2
1931700,1931757,57,1,0,0,1
1931701,1931768,67,1,0,0,2
1931758,1931956,198,0,0,1,1
1931769,1931956,187,0,0,1,2
1931957,1932028,71,1,0,0,2
1931957,1932040,83,1,0,0,1
1932029,1932131,102,0,0,1,2
1932041,1932133,92,0,0,1,1
1932132,1932197,65,1,0,0,2
1932134,1932192,58,1,0,0,1
1932193,1932366,173,0,0,1,1
1932198,1932365,167,0,0,1,2
1932366,1932431,65,1,0,0,2
1932367,1932437,70,1,0,0,1
1932432,1932515,83,0,0,1,2
1932438,1932516,78,0,0,1,1
1932516,1932554,38,1,0,0,2
1932517,1932565,48,1,0,0,1
1932555,1933948,1393,0,0,1,2
1932566,1933946,1380,0,0,1,1
1933947,1934019,72,1,0,0,1
1933949,1934018,69,1,0,0,2
1934019,1934127,108,0,0,1,2
1934020,1934127,107,0,0,1,1
1934128,1934188,60,1,0,0,1
1934128,1934198,70,1,0,0,2
1934189,1934483,294,0,0,1,1
1934199,1934484,285,0,0,1,2
1934484,1934546,62,1,0,0,1
1934485,1934565,80,1,0,0,2
1934547,1934733,186,0,0,1,1
1934566,1934736,170,0,0,1,2
1934734,1934759,25,1,0,0,1
1934737,1934773,36,1,0,0,2
1934760,1936261,1501,0,0,1,1
1934774,1935022,248,0,0,1,2
1935023,1935060,37,1,0,0,2
1935061,1936260,1199,0,0,1,2
1936261,1936352,91,1,0,0,2
1936262,1936358,96,1,0,0,1
1936353,1936695,342,0,0,1,2
1936359,1936695,336,0,0,1,1
1936696,1936763,67,1,0,0,2
1936696,1936772,76,1,0,0,1
1936764,1936859,95,0,0,1,2
1936773,1936859,86,0,0,1,1
1936860,1936888,28,1,0,0,2
1936860,1936889,29,1,0,0,1
1936889,1937192,303,0,0,1,2
1936890,1937191,301,0,0,1,1
1937192,1937222,30,1,0,0,1
1937193,1937222,29,1,0,0,2
1937223,1937551,328,0,0,1,1
1937223,1937551,328,0,0,1,2
1937552,1937585,33,1,0,0,1
1937552,1937585,33,1,0,0,2
1937586,1937817,231,0,0,1,2
1937586,1937818,232,0,0,1,1
1937818,1937847,29,1,0,0,2
1937819,1937847,28,1,0,0,1
1937848,1938712,864,0,0,1,1
1937848,1938714,866,0,0,1,2
1938713,1938771,58,1,0,0,1
1938715,1938770,55,1,0,0,2
1938771,1938978,207,0,0,1,2
1938772,1938977,205,0,0,1,1
1938978,1939034,56,1,0,0,1
1938979,1939025,46,1,0,0,2
1939026,1939195,169,0,0,1,2
1939035,1939196,161,0,0,1,1
1939196,1939277,81,1,0,0,2
1939197,1939302,105,1,0,0,1
1939278,1939372,94,0,0,1,2
1939303,1939372,69,0,0,1,1
1939373,1939409,36,1,0,0,1
1939373,1939419,46,1,0,0,2
1939410,1939653,243,0,0,1,1
1939420,1939654,234,0,0,1,2
1939654,1939687,33,1,0,0,1
1939655,1939688,33,1,0,0,2
1939688,1939891,203,0,0,1,1
1939689,1939890,201,0,0,1,2
1939891,1939903,12,1,0,0,2
1939892,1939897,5,1,0,0,1
1939898,1940925,1027,0,0,1,1
1939904,1940926,1022,0,0,1,2
1940926,1941012,86,1,0,0,1
1940927,1941021,94,1,0,0,2
1941013,1941061,48,0,0,1,1
1941022,1941061,39,0,0,1,2
1941062,1941138,76,1,0,0,1
1941062,1941139,77,1,0,0,2
1941139,1941382,243,0,0,1,1
1941140,1941382,242,0,0,1,2
1941383,1941451,68,1,0,0,2
1941383,1941461,78,1,0,0,1
1941452,1941532,80,0,0,1,2
1941462,1941533,71,0,0,1,1
1941533,1941567,34,1,0,0,2
1941534,1941570,36,1,0,0,1
1941568,1941793,225,0,0,1,2
1941571,1941793,222,0,0,1,1
1941794,1941826,32,1,0,0,2
1941794,1941828,34,1,0,0,1
1941827,1941929,102,0,0,1,2
1941829,1941930,101,0,0,1,1
1941930,1941961,31,1,0,0,2
1941931,1941959,28,1,0,0,1
1941960,1942913,953,0,0,1,1
1941962,1942913,951,0,0,1,2
1942914,1942984,70,1,0,0,1
1942914,1942995,81,1,0,0,2
1942985,1943255,270,0,0,1,1
1942996,1943256,260,0,0,1,2
1943256,1943307,51,1,0,0,1
1943257,1943306,49,1,0,0,2
1943307,1943396,89,0,0,1,2
1943308,1943396,88,0,0,1,1
1943397,1943430,33,1,0,0,2
1943397,1943435,38,1,0,0,1
1943431,1944947,1516,0,0,1,2
1943436,1944948,1512,0,0,1,1
1944948,1945000,52,1,0,0,2
1944949,1944998,49,1,0,0,1
1944999,1945224,225,0,0,1,1
1945001,1945224,223,0,0,1,2
1945225,1945287,62,1,0,0,1
1945225,1945307,82,1,0,0,2
1945288,1945385,97,0,0,1,1
1945308,1945382,74,0,0,1,2
1945383,1945415,32,1,0,0,2
1945386,1945414,28,1,0,0,1
1945415,1945690,275,0,0,1,1
1945416,1945653,237,0,0,1,2
1945654,1945709,55,1,0,0,2
1945691,1945707,16,1,0,0,1
1945708,1947215,1507,0,0,1,1
1945710,1945754,44,0,0,1,2
1945755,1945759,4,1,0,0,2
1945760,1947216,1456,0,0,1,2
1947216,1947285,69,1,0,0,1
1947217,1947285,68,1,0,0,2
1947286,1947542,256,0,0,1,1
1947286,1947542,256,0,0,1,2
1947543,1947638,95,1,0,0,1
1947543,1947647,104,1,0,0,2
1947639,1947686,47,0,0,1,1
1947648,1947685,37,0,0,1,2
1947686,1947748,62,1,0,0,2
1947687,1947748,61,1,0,0,1
1947749,1947934,185,0,0,1,1
1947749,1947934,185,0,0,1,2
1947935,1947965,30,1,0,0,1
1947935,1947969,34,1,0,0,2
1947966,1948638,672,0,0,1,1
1947970,1948637,667,0,0,1,2
1948638,1948673,35,1,0,0,2
1948639,1948674,35,1,0,0,1
1948674,1949413,739,0,0,1,2
1948675,1949414,739,0,0,1,1
1949414,1949471,57,1,0,0,2
1949415,1949464,49,1,0,0,1
1949465,1949704,239,0,0,1,1
1949472,1949704,232,0,0,1,2
1949705,1949766,61,1,0,0,1
1949705,1949772,67,1,0,0,2
1949767,1949852,85,0,0,1,1
1949773,1949851,78,0,0,1,2
1949852,1949913,61,1,0,0,2
1949853,1949891,38,1,0,0,1
1949892,1951658,1766,0,0,1,1
1949914,1951658,1744,0,0,1,2
1951659,1951774,115,1,0,0,1
1951659,1951784,125,1,0,0,2
1951775,1951892,117,0,0,1,1
1951785,1951893,108,0,0,1,2
1951893,1951919,26,1,0,0,1
1951894,1951933,39,1,0,0,2
1951920,1952122,202,0,0,1,1
1951934,1952123,189,0,0,1,2
1952123,1952141,18,1,0,0,1
1952124,1952160,36,1,0,0,2
1952142,1953301,1159,0,0,1,1
1952161,1953299,1138,0,0,1,2
1953300,1953356,56,1,0,0,2
1953302,1953361,59,1,0,0,1
1953357,1953596,239,0,0,1,2
1953362,1953595,233,0,0,1,1
1953596,1953675,79,1,0,0,1
1953597,1953685,88,1,0,0,2
1953676,1953769,93,0,0,1,1
1953686,1953771,85,0,0,1,2
1953770,1953798,28,1,0,0,1
1953772,1953797,25,1,0,0,2
1953798,1955441,1643,0,0,1,2
1953799,1955441,1642,0,0,1,1
1955442,1955521,79,1,0,0,2
1955442,1955533,91,1,0,0,1
1955522,1955594,72,0,0,1,2
1955534,1955593,59,0,0,1,1
1955594,1955656,62,1,0,0,1
1955595,1955658,63,1,0,0,2
1955657,1955930,273,0,0,1,1
1955659,1955930,271,0,0,1,2
1955931,1955961,30,1,0,0,1
1955931,1955962,31,1,0,0,2
1955962,1956987,1025,0,0,1,1
1955963,1956987,1024,0,0,1,2
1956988,1957054,66,1,0,0,1
1956988,1957062,74,1,0,0,2
1957055,1957344,289,0,0,1,1
1957063,1957345,282,0,0,1,2
1957345,1957377,32,1,0,0,1
1957346,1957380,34,1,0,0,2
1957378,1957505,127,0,0,1,1
1957381,1957497,116,0,0,1,2
1957498,1957521,23,1,0,0,2
1957506,1957519,13,1,0,0,1
1957520,1959074,1554,0,0,1,1
1957522,1959074,1552,0,0,1,2
1959075,1959108,33,1,0,0,2
1959075,1959125,50,1,0,0,1
1959109,1959323,214,0,0,1,2
1959126,1959323,197,0,0,1,1
1959324,1959357,33,1,0,0,1
1959324,1959361,37,1,0,0,2
1959358,1959890,532,0,0,1,1
1959362,1959894,532,0,0,1,2
1959891,1959913,22,1,0,0,1
1959895,1959914,19,1,0,0,2
1959914,1960875,961,0,0,1,1
1959915,1960874,959,0,0,1,2
1960875,1960942,67,1,0,0,2
1960876,1960939,63,1,0,0,1
1960940,1961025,85,0,0,1,1
1960943,1961026,83,0,0,1,2
1961026,1961081,55,1,0,0,1
1961027,1961064,37,1,0,0,2
1961065,1962069,1004,0,0,1,2
1961082,1962767,1685,0,0,1,1
1962070,1962101,31,1,0,0,2
1962102,1962174,72,0,0,1,2
1962175,1962190,15,1,0,0,2
1962191,1962767,576,0,0,1,2
1962768,1962855,87,1,0,0,2
1962768,1962875,107,1,0,0,1
1962856,1962951,95,0,0,1,2
1962876,1962956,80,0,0,1,1
1962952,1962991,39,1,0,0,2
1962957,1962994,37,1,0,0,1
1962992,1963203,211,0,0,1,2
1962995,1963200,205,0,0,1,1
1963201,1963232,31,1,0,0,1
1963204,1963232,28,1,0,0,2
1963233,1964534,1301,0,0,1,2
1963233,1964535,1302,0,0,1,1
1964535,1964633,98,1,0,0,2
1964536,1964627,91,1,0,0,1
1964628,1964713,85,0,0,1,1
1964634,1964715,81,0,0,1,2
1964714,1964748,34,1,0,0,1
1964716,1964777,61,1,0,0,2
1964749,1965023,274,0,0,1,1
1964778,1965022,244,0,0,1,2
1965023,1965056,33,1,0,0,2
1965024,1965051,27,1,0,0,1
1965052,1965544,492,0,0,1,1
1965057,1965546,489,0,0,1,2
1965545,1965562,17,1,0,0,1
1965547,1965564,17,1,0,0,2
1965563,1966232,669,0,0,1,1
1965565,1966231,666,0,0,1,2
1966232,1966309,77,1,0,0,2
1966233,1966311,78,1,0,0,1
1966310,1966485,175,0,0,1,2
1966312,1966485,173,0,0,1,1
1966486,1966578,92,1,0,0,1
1966486,1966590,104,1,0,0,2
1966579,1966655,76,0,0,1,1
1966591,1966654,63,0,0,1,2
1966655,1966704,49,1,0,0,2
1966656,1966700,44,1,0,0,1
1966701,1966929,228,0,0,1,1
1966705,1966930,225,0,0,1,2
1966930,1966962,32,1,0,0,1
1966931,1966970,39,1,0,0,2
1966963,1967266,303,0,0,1,1
1966971,1967267,296,0,0,1,2
1967267,1967298,31,1,0,0,1
1967268,1967309,41,1,0,0,2
1967299,1968330,1031,0,0,1,1
1967310,1968332,1022,0,0,1,2
1968331,1968409,78,1,0,0,1
1968333,1968428,95,1,0,0,2
1968410,1968492,82,0,0,1,1
1968429,1968494,65,0,0,1,2
1968493,1968545,52,1,0,0,1
1968495,1968543,48,1,0,0,2
1968544,1968692,148,0,0,1,2
1968546,1968697,151,0,0,1,1
1968693,1968720,27,1,0,0,2
1968698,1968703,5,1,0,0,1
1968704,1969694,990,0,0,1,1
1968721,1969045,324,0,0,1,2
1969046,1969056,10,1,0,0,2
1969057,1969188,131,0,0,1,2
1969189,1969204,15,1,0,0,2
1969205,1969355,150,0,0,1,2
1969356,1969490,134,1,0,0,2
1969491,1969614,123,0,0,1,2
1969615,1969670,55,1,0,0,2
1969671,1969694,23,0,0,1,2
1969695,1969748,53,1,0,0,1
1969695,1969759,64,1,0,0,2
1969749,1970040,291,0,0,1,1
1969760,1970042,282,0,0,1,2
1970041,1970123,82,1,0,0,1
1970043,1970123,80,1,0,0,2
1970124,1970230,106,0,0,1,1
1970124,1970231,107,0,0,1,2
1970231,1970257,26,1,0,0,1
1970232,1970264,32,1,0,0,2
1970258,1971313,1055,0,0,1,1
1970265,1971312,1047,0,0,1,2
1971313,1971359,46,1,0,0,2
1971314,1971377,63,1,0,0,1
1971360,1971738,378,0,0,1,2
1971378,1971738,360,0,0,1,1
1971739,1971784,45,1,0,0,1
1971739,1971785,46,1,0,0,2
1971785,1973493,1708,0,0,1,1
1971786,1971905,119,0,0,1,2
1971906,1971916,10,1,0,0,2
1971917,1972374,457,0,0,1,2
1972375,1972483,108,1,0,0,2
1972484,1972558,74,0,0,1,2
1972559,1972574,15,1,0,0,2
1972575,1972628,53,0,0,1,2
1972629,1972633,4,1,0,0,2
1972634,1972742,108,0,0,1,2
1972743,1972818,75,1,0,0,2
1972819,1972848,29,0,0,1,2
1972849,1972865,16,1,0,0,2
1972866,1973114,248,0,0,1,2
1973115,1973128,13,1,0,0,2
1973129,1973357,228,0,0,1,2
1973358,1973426,68,1,0,0,2
1973427,1973493,66,0,0,1,2
1973494,1973571,77,1,0,0,2
1973494,1973572,78,1,0,0,1
1973572,1973719,147,0,0,1,2
1973573,1973718,145,0,0,1,1
1973719,1973785,66,1,0,0,1
1973720,1973790,70,1,0,0,2
1973786,1974104,318,0,0,1,1
1973791,1974104,313,0,0,1,2
1974105,1974137,32,1,0,0,1
1974105,1974138,33,1,0,0,2
1974138,1974287,149,0,0,1,1
1974139,1974287,148,0,0,1,2
1974288,1974318,30,1,0,0,1
1974288,1974318,30,1,0,0,2
1974319,1974528,209,0,0,1,2
1974319,1974535,216,0,0,1,1
1974529,1974559,30,1,0,0,2
1974536,1974557,21,1,0,0,1
1974558,1974855,297,0,0,1,1
1974560,1974855,295,0,0,1,2
1974856,1974885,29,1,0,0,1
1974856,1974888,32,1,0,0,2
1974886,1975062,176,0,0,1,1
1974889,1975063,174,0,0,1,2
1975063,1975082,19,1,0,0,1
1975064,1975092,28,1,0,0,2
1975083,1975968,885,0,0,1,1
1975093,1975967,874,0,0,1,2
1975968,1976029,61,1,0,0,2
1975969,1976044,75,1,0,0,1
1976030,1976209,179,0,0,1,2
1976045,1976205,160,0,0,1,1
1976206,1976222,16,1,0,0,1
1976210,1976222,12,1,0,0,2
1976223,1978057,1834,0,0,1,1
1976223,1978057,1834,0,0,1,2
1978058,1978103,45,1,0,0,1
1978058,1978103,45,1,0,0,2
1978104,1978955,851,0,0,1,1
1978104,1978955,851,0,0,1,2
1978956,1979003,47,1,0,0,1
1978956,1979003,47,1,0,0,2
1979004,1979474,470,0,0,1,1
1979004,1979474,470,0,0,1,2
1979475,1979510,35,1,0,0,2
1979475,1979514,39,1,0,0,1
1979511,1979759,248,0,0,1,2
1979515,1979752,237,0,0,1,1
1979753,1979772,19,1,0,0,1
1979760,1979776,16,1,0,0,2
1979773,1980584,811,0,0,1,1
1979777,1980583,806,0,0,1,2
1980584,1980622,38,1,0,0,2
1980585,1980620,35,1,0,0,1
1980621,1980944,323,0,0,1,1
1980623,1980963,340,0,0,1,2
1980945,1981177,232,1,0,0,1
1980964,1981102,138,1,0,0,2
1980973,1981075,102,0,1,0,1
1981103,1981301,198,0,0,1,2
1981178,1981296,118,0,0,1,1
1981297,1981654,357,1,0,0,1
1981302,1981541,239,1,0,0,2
1981325,1981538,213,0,1,0,1
1981332,1981446,114,0,1,0,2
1981542,1981579,37,0,0,1,2
1981580,1981614,34,1,0,0,2
1981615,1981946,331,0,0,1,2
1981655,1981937,282,0,0,1,1
1981938,1982421,483,1,0,0,1
1981947,1982246,299,1,0,0,2
1981976,1982253,277,0,1,0,1
1981988,1982169,181,0,1,0,2
1982247,1982288,41,0,0,1,2
1982274,1982328,54,0,1,0,1
1982289,1982317,28,1,0,0,2
1982318,1982920,602,0,0,1,2
1982422,1982460,38,0,0,1,1
1982461,1982506,45,1,0,0,1
1982507,1982920,413,0,0,1,1
1982921,1982952,31,1,0,0,1
1982921,1982955,34,1,0,0,2
1982953,1983075,122,0,0,1,1
1982956,1983076,120,0,0,1,2
1983076,1983105,29,1,0,0,1
1983077,1983108,31,1,0,0,2
1983106,1983432,326,0,0,1,1
1983109,1983430,321,0,0,1,2
1983431,1983733,302,1,0,0,2
1983433,1983774,341,1,0,0,1
1983479,1983736,257,0,1,0,1
1983483,1983689,206,0,1,0,2
1983734,1983843,109,0,0,1,2
1983775,1983833,58,0,0,1,1
1983834,1984075,241,1,0,0,1
1983844,1984033,189,1,0,0,2
1983856,1984034,178,0,1,0,1
1983869,1983981,112,0,1,0,2
1984034,1984385,351,0,0,1,2
1984076,1984384,308,0,0,1,1
1984385,1984423,38,1,0,0,1
1984386,1984431,45,1,0,0,2
1984424,1984718,294,0,0,1,1
1984432,1984718,286,0,0,1,2
1984719,1984764,45,1,0,0,2
1984719,1984765,46,1,0,0,1
1984765,1985071,306,0,0,1,2
1984766,1985070,304,0,0,1,1
1985071,1985116,45,1,0,0,1
1985072,1985124,52,1,0,0,2
1985117,1985233,116,0,0,1,1
1985125,1985234,109,0,0,1,2
1985234,1985292,58,1,0,0,1
1985235,1985305,70,1,0,0,2
1985293,1986268,975,0,0,1,1
1985306,1986265,959,0,0,1,2
1986266,1986298,32,1,0,0,2
1986269,1986304,35,1,0,0,1
1986299,1986580,281,0,0,1,2
1986305,1986577,272,0,0,1,1
1986578,1986614,36,1,0,0,1
1986581,1986601,20,1,0,0,2
1986602,1986975,373,0,0,1,2
1986615,1986975,360,0,0,1,1
1986976,1987039,63,1,0,0,1
1986976,1987040,64,1,0,0,2
1987040,1987224,184,0,0,1,1
1987041,1987224,183,0,0,1,2
1987225,1987248,23,1,0,0,1
1987225,1987248,23,1,0,0,2
1987249,1987529,280,0,0,1,2
1987249,1987531,282,0,0,1,1
1987530,1987565,35,1,0,0,2
1987532,1987562,30,1,0,0,1
1987563,1989877,2314,0,0,1,1
1987566,1989877,2311,0,0,1,2
1989878,1989923,45,1,0,0,1
1989878,1989928,50,1,0,0,2
1989924,1990258,334,0,0,1,1
1989929,1990260,331,0,0,1,2
1990259,1990280,21,1,0,0,1
1990261,1990280,19,1,0,0,2
1990281,1991052,771,0,0,1,1
1990281,1991052,771,0,0,1,2
1991053,1991122,69,1,0,0,1
1991053,1991122,69,1,0,0,2
1991123,1991221,98,0,0,1,1
1991123,1991221,98,0,0,1,2
1991222,1991249,27,1,0,0,2
1991222,1991252,30,1,0,0,1
1991250,1991489,239,0,0,1,2
1991253,1993100,1847,0,0,1,1
1991490,1991508,18,1,0,0,2
1991509,1993101,1592,0,0,1,2
1993101,1993148,47,1,0,0,1
1993102,1993150,48,1,0,0,2
1993149,1993496,347,0,0,1,1
1993151,1993494,343,0,0,1,2
1993495,1993534,39,1,0,0,2
1993497,1993527,30,1,0,0,1
1993528,1995169,1641,0,0,1,1
1993535,1995170,1635,0,0,1,2
1995170,1995257,87,1,0,0,1
1995171,1995264,93,1,0,0,2
1995258,1997138,1880,0,0,1,1
1995265,1997139,1874,0,0,1,2
1997139,1997200,61,1,0,0,1
1997140,1997209,69,1,0,0,2
1997201,1997425,224,0,0,1,1
1997210,1997424,214,0,0,1,2
1997425,1997456,31,1,0,0,2
1997426,1997446,20,1,0,0,1
1997447,1998422,975,0,0,1,1
1997457,1998136,679,0,0,1,2
1998137,1998141,4,1,0,0,2
1998142,1998421,279,0,0,1,2
1998422,1998474,52,1,0,0,2
1998423,1998475,52,1,0,0,1
1998475,2000494,2019,0,0,1,2
1998476,2000494,2018,0,0,1,1
2000495,2000600,105,1,0,0,1
2000495,2000603,108,1,0,0,2
2000601,2000692,91,0,0,1,1
2000604,2000692,88,0,0,1,2
2000693,2000735,42,1,0,0,1
2000693,2000735,42,1,0,0,2
2000736,2000863,127,0,0,1,1
2000736,2000863,127,0,0,1,2
2000864,2000904,40,1,0,0,1
2000864,2000905,41,1,0,0,2
2000905,2001256,351,0,0,1,1
2000906,2001260,354,0,0,1,2
2001257,2001565,308,1,0,0,1
2001261,2001548,287,1,0,0,2
2001291,2001529,238,0,1,0,1
2001300,2001460,160,0,1,0,2
2001549,2001796,247,0,0,1,2
2001566,2001796,230,0,0,1,1
2001797,2001833,36,1,0,0,1
2001797,2001833,36,1,0,0,2
2001834,2002830,996,0,0,1,2
2001834,2002831,997,0,0,1,1
2002831,2002856,25,1,0,0,2
2002832,2002856,24,1,0,0,1
2002857,2003204,347,0,0,1,1
2002857,2003205,348,0,0,1,2
2003205,2003235,30,1,0,0,1
2003206,2003236,30,1,0,0,2
2003236,2003675,439,0,0,1,1
2003237,2003674,437,0,0,1,2
2003675,2003725,50,1,0,0,2
2003676,2003724,48,1,0,0,1
2003725,2006642,2917,0,0,1,1
2003726,2006643,2917,0,0,1,2
2006643,2006684,41,1,0,0,1
2006644,2006685,41,1,0,0,2
2006685,2007883,1198,0,0,1,1
2006686,2007883,1197,0,0,1,2
2007884,2007992,108,1,0,0,2
2007884,2007997,113,1,0,0,1
2007993,2008080,87,0,0,1,2
2007998,2008078,80,0,0,1,1
2008079,2008118,39,1,0,0,1
2008081,2008117,36,1,0,0,2
2008118,2008457,339,0,0,1,2
2008119,2008458,339,0,0,1,1
2008458,2008486,28,1,0,0,2
2008459,2008483,24,1,0,0,1
2008484,2009765,1281,0,0,1,1
2008487,2009764,1277,0,0,1,2
2009765,2009804,39,1,0,0,2
2009766,2009804,38,1,0,0,1
2009805,2009957,152,0,0,1,1
2009805,2009960,155,0,0,1,2
2009958,2009980,22,1,0,0,1
2009961,2009989,28,1,0,0,2
2009981,2010450,469,0,0,1,1
2009990,2010451,461,0,0,1,2
2010451,2010484,33,1,0,0,1
2010452,2010483,31,1,0,0,2
2010484,2010688,204,0,0,1,2
2010485,2010687,202,0,0,1,1
2010688,2010717,29,1,0,0,1
2010689,2010719,30,1,0,0,2
2010718,2011135,417,0,0,1,1
2010720,2011136,416,0,0,1,2
2011136,2011166,30,1,0,0,1
2011137,2011168,31,1,0,0,2
2011167,2011901,734,0,0,1,1
2011169,2011901,732,0,0,1,2
2011902,2012013,111,1,0,0,1
2011902,2012013,111,1,0,0,2
2012014,2013816,1802,0,0,1,2
2012014,2013817,1803,0,0,1,1
2013817,2013971,154,1,0,0,2
2013818,2013894,76,1,0,0,1
2013895,2013994,99,0,0,1,1
2013972,2013995,23,0,0,1,2
2013995,2014035,40,1,0,0,1
2013996,2014027,31,1,0,0,2
2014028,2014067,39,0,0,1,2
2014036,2014654,618,0,0,1,1
2014068,2014079,11,1,0,0,2
2014080,2014653,573,0,0,1,2
2014654,2014672,18,1,0,0,2
2014655,2014672,17,1,0,0,1
2014673,2014859,186,0,0,1,1
2014673,2014864,191,0,0,1,2
2014860,2014874,14,1,0,0,1
2014865,2014890,25,1,0,0,2
2014875,2015252,377,0,0,1,1
2014891,2015252,361,0,0,1,2
2015253,2015273,20,1,0,0,1
2015253,2015273,20,1,0,0,2
2015274,2015322,48,0,0,1,2
2015274,2015905,631,0,0,1,1
2015323,2015352,29,1,0,0,2
2015353,2015907,554,0,0,1,2
2015906,2015954,48,1,0,0,1
2015908,2015974,66,1,0,0,2
2015955,2016112,157,0,0,1,1
2015975,2016111,136,0,0,1,2
2016112,2016144,32,1,0,0,2
2016113,2016134,21,1,0,0,1
2016135,2016400,265,0,0,1,1
2016145,2016402,257,0,0,1,2
2016401,2016461,60,1,0,0,1
2016403,2016469,66,1,0,0,2
2016462,2018316,1854,0,0,1,1
2016470,2018315,1845,0,0,1,2
2018316,2018370,54,1,0,0,2
2018317,2018357,40,1,0,0,1
2018358,2019867,1509,0,0,1,1
2018371,2019867,1496,0,0,1,2
2019868,2019931,63,1,0,0,2
2019868,2019939,71,1,0,0,1
2019932,2020028,96,0,0,1,2
2019940,2020025,85,0,0,1,1
2020026,2020086,60,1,0,0,1
2020029,2020059,30,1,0,0,2
2020060,2020507,447,0,0,1,2
2020087,2021447,1360,0,0,1,1
2020508,2020521,13,1,0,0,2
2020522,2021446,924,0,0,1,2
2021447,2021505,58,1,0,0,2
2021448,2021506,58,1,0,0,1
2021506,2021658,152,0,0,1,2
2021507,2021662,155,0,0,1,1
2021659,2021686,27,1,0,0,2
2021663,2021697,34,1,0,0,1
2021687,2023902,2215,0,0,1,2
2021698,2023902,2204,0,0,1,1
2023903,2023955,52,1,0,0,1
2023903,2023958,55,1,0,0,2
2023956,2024841,885,0,0,1,1
2023959,2024842,883,0,0,1,2
2024842,2024879,37,1,0,0,1
2024843,2024880,37,1,0,0,2
2024880,2025137,257,0,0,1,1
2024881,2025139,258,0,0,1,2
2025138,2025170,32,1,0,0,1
2025140,2025171,31,1,0,0,2
2025171,2025352,181,0,0,1,1
2025172,2025351,179,0,0,1,2
2025352,2025383,31,1,0,0,2
2025353,2025384,31,1,0,0,1
2025384,2025966,582,0,0,1,2
2025385,2025970,585,0,0,1,1
2025967,2025977,10,1,0,0,2
2025971,2025975,4,1,0,0,1
2025976,2026447,471,0,0,1,1
2025978,2026446,468,0,0,1,2
2026447,2026507,60,1,0,0,2
2026448,2026529,81,1,0,0,1
2026508,2026680,172,0,0,1,2
2026530,2026680,150,0,0,1,1
2026681,2026706,25,1,0,0,1
2026681,2026720,39,1,0,0,2
2026707,2028567,1860,0,0,1,1
2026721,2028567,1846,0,0,1,2
2028568,2028630,62,1,0,0,2
2028568,2028633,65,1,0,0,1
2028631,2030187,1556,0,0,1,2
2028634,2030187,1553,0,0,1,1
2030188,2030266,78,1,0,0,1
2030188,2030270,82,1,0,0,2
2030267,2030374,107,0,0,1,1
2030271,2030375,104,0,0,1,2
2030375,2030406,31,1,0,0,1
2030376,2030407,31,1,0,0,2
2030407,2031026,619,0,0,1,1
2030408,2031026,618,0,0,1,2
2031027,2031055,28,1,0,0,1
2031027,2031063,36,1,0,0,2
2031056,2031562,506,0,0,1,1
2031064,2031561,497,0,0,1,2
2031562,2031624,62,1,0,0,2
2031563,2031632,69,1,0,0,1
2031625,2031827,202,0,0,1,2
2031633,2031826,193,0,0,1,1
2031827,2031859,32,1,0,0,1
2031828,2031860,32,1,0,0,2
2031860,2034877,3017,0,0,1,1
2031861,2034879,3018,0,0,1,2
2034878,2034938,60,1,0,0,1
2034880,2034947,67,1,0,0,2
2034939,2035053,114,0,0,1,1
2034948,2035055,107,0,0,1,2
2035054,2035088,34,1,0,0,1
2035056,2035090,34,1,0,0,2
2035089,2035517,428,0,0,1,1
2035091,2035516,425,0,0,1,2
2035517,2035563,46,1,0,0,2
2035518,2035561,43,1,0,0,1
2035562,2035671,109,0,0,1,1
2035564,2035673,109,0,0,1,2
2035672,2035691,19,1,0,0,1
2035674,2035702,28,1,0,0,2
2035692,2036123,431,0,0,1,1
2035703,2036124,421,0,0,1,2
2036124,2036156,32,1,0,0,1
2036125,2036156,31,1,0,0,2
2036157,2036424,267,0,0,1,1
2036157,2036427,270,0,0,1,2
2036425,2036483,58,1,0,0,1
2036428,2036483,55,1,0,0,2
2036484,2036750,266,0,0,1,2
2036484,2036752,268,0,0,1,1
2036751,2036773,22,1,0,0,2
2036753,2036772,19,1,0,0,1
2036773,2038791,2018,0,0,1,1
2036774,2038790,2016,0,0,1,2
2038791,2038863,72,1,0,0,2
2038792,2038849,57,1,0,0,1
2038850,2039282,432,0,0,1,1
2038864,2039281,417,0,0,1,2
2039282,2039339,57,1,0,0,2
2039283,2039328,45,1,0,0,1
2039329,2039805,476,0,0,1,1
2039340,2039805,465,0,0,1,2
2039806,2039877,71,1,0,0,2
2039806,2039878,72,1,0,0,1
2039878,2040005,127,0,0,1,2
2039879,2040005,126,0,0,1,1
2040006,2040032,26,1,0,0,2
2040006,2040034,28,1,0,0,1
2040033,2040347,314,0,0,1,2
2040035,2040349,314,0,0,1,1
2040348,2040367,19,1,0,0,2
2040350,2040367,17,1,0,0,1
2040368,2040633,265,0,0,1,2
2040368,2040634,266,0,0,1,1
2040634,2040665,31,1,0,0,2
2040635,2040665,30,1,0,0,1
2040666,2041382,716,0,0,1,2
2040666,2041384,718,0,0,1,1
2041383,2041403,20,1,0,0,2
2041385,2041402,17,1,0,0,1
2041403,2041586,183,0,0,1,1
2041404,2041585,181,0,0,1,2
2041586,2041640,54,1,0,0,2
2041587,2041627,40,1,0,0,1
2041628,2045184,3556,0,0,1,1
2041641,2045182,3541,0,0,1,2
2045183,2045307,124,1,0,0,2
2045185,2045257,72,1,0,0,1
2045258,2045574,316,0,0,1,1
2045308,2045571,263,0,0,1,2
2045572,2045606,34,1,0,0,2
2045575,2045610,35,1,0,0,1
2045607,2046849,1242,0,0,1,2
2045611,2046851,1240,0,0,1,1
2046850,2046901,51,1,0,0,2
2046852,2046901,49,1,0,0,1
2046902,2047016,114,0,0,1,1
2046902,2047019,117,0,0,1,2
2047017,2047046,29,1,0,0,1
2047020,2047047,27,1,0,0,2
2047047,2047333,286,0,0,1,1
2047048,2047338,290,0,0,1,2
2047334,2047361,27,1,0,0,1
2047339,2047361,22,1,0,0,2
2047362,2047611,249,0,0,1,1
2047362,2047611,249,0,0,1,2
2047612,2047643,31,1,0,0,1
2047612,2047676,64,1,0,0,2
2047644,2049132,1488,0,0,1,1
2047677,2047902,225,0,0,1,2
2047903,2047963,60,1,0,0,2
2047964,2048025,61,0,0,1,2
2048026,2048068,42,1,0,0,2
2048069,2048335,266,0,0,1,2
2048336,2048357,21,1,0,0,2
2048358,2048484,126,0,0,1,2
2048485,2048576,91,1,0,0,2
2048577,2048618,41,0,0,1,2
2048619,2048626,7,1,0,0,2
2048627,2048671,44,0,0,1,2
2048672,2048712,40,1,0,0,2
2048713,2048867,154,0,0,1,2
2048868,2048933,65,1,0,0,2
2048934,2049133,199,0,0,1,2
2049133,2049175,42,1,0,0,1
2049134,2049181,47,1,0,0,2
2049176,2050697,1521,0,0,1,1
2049182,2050486,1304,0,0,1,2
2050487,2050566,79,1,0,0,2
2050567,2050697,130,0,0,1,2
2050698,2050764,66,1,0,0,2
2050698,2050778,80,1,0,0,1
2050765,2050865,100,0,0,1,2
2050779,2050865,86,0,0,1,1
2050866,2050892,26,1,0,0,1
2050866,2050894,28,1,0,0,2
2050893,2051177,284,0,0,1,1
2050895,2051177,282,0,0,1,2
2051178,2051211,33,1,0,0,1
2051178,2051219,41,1,0,0,2
2051212,2051774,562,0,0,1,1
2051220,2051776,556,0,0,1,2
2051775,2051808,33,1,0,0,1
2051777,2051813,36,1,0,0,2
2051809,2052066,257,0,0,1,1
2051814,2052065,251,0,0,1,2
2052066,2052113,47,1,0,0,2
2052067,2052120,53,1,0,0,1
2052114,2052244,130,0,0,1,2
2052121,2052243,122,0,0,1,1
2052244,2052272,28,1,0,0,1
2052245,2052275,30,1,0,0,2
2052273,2055568,3295,0,0,1,1
2052276,2055569,3293,0,0,1,2
2055569,2055641,72,1,0,0,1
2055570,2055625,55,1,0,0,2
2055626,2056187,561,0,0,1,2
2055642,2056186,544,0,0,1,1
2056187,2056220,33,1,0,0,1
2056188,2056220,32,1,0,0,2
2056221,2057014,793,0,0,1,1
2056221,2057015,794,0,0,1,2
2057015,2057080,65,1,0,0,1
2057016,2057091,75,1,0,0,2
2057081,2057376,295,0,0,1,1
2057092,2057377,285,0,0,1,2
2057377,2057408,31,1,0,0,1
2057378,2057405,27,1,0,0,2
2057406,2060454,3048,0,0,1,2
2057409,2060454,3045,0,0,1,1
2060455,2060534,79,1,0,0,1
2060455,2060557,102,1,0,0,2
2060535,2060656,121,0,0,1,1
2060558,2060657,99,0,0,1,2
2060657,2060698,41,1,0,0,1
2060658,2060716,58,1,0,0,2
2060699,2061794,1095,0,0,1,1
2060717,2061794,1077,0,0,1,2
2061795,2061860,65,1,0,0,1
2061795,2061870,75,1,0,0,2
2061861,2065128,3267,0,0,1,1
2061871,2065130,3259,0,0,1,2
2065129,2065298,169,1,0,0,1
2065131,2065232,101,1,0,0,2
2065233,2065333,100,0,0,1,2
2065299,2065333,34,0,0,1,1
2065334,2065372,38,1,0,0,1
2065334,2065377,43,1,0,0,2
2065373,2066920,1547,0,0,1,1
2065378,2066921,1543,0,0,1,2
2066921,2067033,112,1,0,0,1
2066922,2066975,53,1,0,0,2
2066976,2067390,414,0,0,1,2
2067034,2070864,3830,0,0,1,1
2067391,2067411,20,1,0,0,2
2067412,2070865,3453,0,0,1,2
2070865,2071052,187,1,0,0,1
2070866,2070912,46,1,0,0,2
2070913,2072537,1624,0,0,1,2
2071053,2072537,1484,0,0,1,1
2072538,2072594,56,1,0,0,1
2072538,2072601,63,1,0,0,2
2072595,2072709,114,0,0,1,1
2072602,2073396,794,0,0,1,2
2072710,2072732,22,1,0,0,1
2072733,2074411,1678,0,0,1,1
2073397,2073403,6,1,0,0,2
2073404,2073467,63,0,0,1,2
2073468,2073491,23,1,0,0,2
2073492,2073872,380,0,0,1,2
2073873,2073882,9,1,0,0,2
2073883,2076143,2260,0,0,1,2
2074412,2074436,24,1,0,0,1
2074437,2076144,1707,0,0,1,1
2076144,2076247,103,1,0,0,2
2076145,2076244,99,1,0,0,1
2076245,2076363,118,0,0,1,1
2076248,2076362,114,0,0,1,2
2076363,2076437,74,1,0,0,2
2076364,2076395,31,1,0,0,1
2076396,2077862,1466,0,0,1,1
2076438,2077861,1423,0,0,1,2
2077862,2077918,56,1,0,0,2
2077863,2077915,52,1,0,0,1
2077916,2081546,3630,0,0,1,1
2077919,2081546,3627,0,0,1,2
2081547,2081633,86,1,0,0,2
2081547,2081649,102,1,0,0,1
2081634,2081739,105,0,0,1,2
2081650,2081689,39,0,0,1,1
2081690,2081707,17,1,0,0,1
2081708,2081737,29,0,0,1,1
2081738,2081774,36,1,0,0,1
2081740,2081778,38,1,0,0,2
2081775,2081818,43,0,0,1,1
2081779,2082777,998,0,0,1,2
2081819,2081833,14,1,0,0,1
2081834,2082195,361,0,0,1,1
2082196,2082207,11,1,0,0,1
2082208,2082777,569,0,0,1,1
2082778,2082821,43,1,0,0,1
2082778,2082842,64,1,0,0,2
2082822,2086011,3189,0,0,1,1
2082843,2086011,3168,0,0,1,2
2086012,2086058,46,1,0,0,2
2086012,2086068,56,1,0,0,1
2086059,2087402,1343,0,0,1,2
2086069,2087403,1334,0,0,1,1
2087403,2087468,65,1,0,0,2
2087404,2087465,61,1,0,0,1
2087466,2091057,3591,0,0,1,1
2087469,2091057,3588,0,0,1,2
2091058,2091112,54,1,0,0,1
2091058,2091119,61,1,0,0,2
2091113,2091295,182,0,0,1,1
2091120,2091293,173,0,0,1,2
2091294,2091329,35,1,0,0,2
2091296,2091329,33,1,0,0,1
2091330,2091471,141,0,0,1,1
2091330,2091471,141,0,0,1,2
2091472,2091499,27,1,0,0,1
2091472,2091500,28,1,0,0,2
2091500,2092212,712,0,0,1,1
2091501,2092212,711,0,0,1,2
2092213,2092268,55,1,0,0,2
2092213,2092269,56,1,0,0,1
2092269,2095470,3201,0,0,1,2
2092270,2095528,3258,0,0,1,1
2095471,2095615,144,1,0,0,2
2095529,2095630,101,1,0,0,1
2095616,2096153,537,0,0,1,2
2095631,2096139,508,0,0,1,1
2096140,2096202,62,1,0,0,1
2096154,2096202,48,1,0,0,2
2096203,2096611,408,0,0,1,2
2096203,2097484,1281,0,0,1,1
2096612,2096637,25,1,0,0,2
2096638,2097484,846,0,0,1,2
2097485,2097515,30,1,0,0,1
2097485,2097516,31,1,0,0,2
2097516,2098416,900,0,0,1,1
2097517,2098417,900,0,0,1,2
2098417,2098492,75,1,0,0,1
2098418,2098475,57,1,0,0,2
2098476,2098748,272,0,0,1,2
2098493,2098747,254,0,0,1,1
2098748,2098813,65,1,0,0,1
2098749,2098783,34,1,0,0,2
2098784,2099442,658,0,0,1,2
2098814,2099442,628,0,0,1,1
2099443,2099475,32,1,0,0,2
2099443,2099479,36,1,0,0,1
2099476,2099648,172,0,0,1,2
2099480,2099644,164,0,0,1,1
2099645,2099682,37,1,0,0,1
2099649,2099684,35,1,0,0,2
2099683,2099978,295,0,0,1,1
2099685,2099974,289,0,0,1,2
2099975,2100000,25,1,0,0,2
2099979,2099990,11,1,0,0,1
2099991,2100515,524,0,0,1,1
2100001,2100517,516,0,0,1,2
2100516,2100637,121,1,0,0,1
2100518,2100590,72,1,0,0,2
2100591,2100612,21,0,0,1,2
2100613,2100636,23,1,0,0,2
2100637,2100845,208,0,0,1,2
2100638,2100843,205,0,0,1,1
2100844,2100879,35,1,0,0,1
2100846,2100880,34,1,0,0,2
2100880,2101059,179,0,0,1,1
2100881,2101062,181,0,0,1,2
2101060,2101393,333,1,0,0,1
2101063,2101379,316,1,0,0,2
2101099,2101342,243,0,1,0,1
2101115,2101280,165,0,1,0,2
2101380,2101863,483,0,0,1,2
2101394,2101858,464,0,0,1,1
2101859,2102169,310,1,0,0,1
2101864,2102162,298,1,0,0,2
2101883,2102107,224,0,1,0,1
2101894,2102054,160,0,1,0,2
2102163,2102457,294,0,0,1,2
2102170,2102456,286,0,0,1,1
2102457,2102531,74,1,0,0,1
2102458,2102548,90,1,0,0,2
2102532,2103160,628,0,0,1,1
2102549,2102596,47,0,0,1,2
2102597,2102831,234,1,0,0,2
2102832,2102894,62,0,0,1,2
2102895,2103039,144,1,0,0,2
2103040,2103079,39,0,0,1,2
2103080,2103210,130,1,0,0,2
2103161,2103289,128,1,0,0,1
2103211,2103373,162,0,0,1,2
2103290,2103408,118,0,0,1,1
2103374,2103733,359,1,0,0,2
2103409,2103423,14,1,0,0,1
2103424,2103528,104,0,0,1,1
2103529,2103577,48,1,0,0,1
2103578,2103836,258,0,0,1,1
2103734,2103778,44,0,0,1,2
2103779,2103895,116,1,0,0,2
2103837,2103885,48,1,0,0,1
2103886,2104043,157,0,0,1,1
2103896,2104043,147,0,0,1,2
2104044,2104076,32,1,0,0,2
2104044,2104079,35,1,0,0,1
2104077,2104456,379,0,0,1,2
2104080,2104456,376,0,0,1,1
2104457,2104488,31,1,0,0,1
2104457,2104489,32,1,0,0,2
2104489,2104939,450,0,0,1,1
2104490,2104941,451,0,0,1,2
2104940,2104978,38,1,0,0,1
2104942,2104975,33,1,0,0,2
2104976,2105977,1001,0,0,1,2
2104979,2105976,997,0,0,1,1
2105977,2106006,29,1,0,0,1
2105978,2106007,29,1,0,0,2
2106007,2107523,1516,0,0,1,1
2106008,2107523,1515,0,0,1,2
2107524,2107541,17,1,0,0,1
2107524,2107544,20,1,0,0,2
2107542,2107757,215,0,0,1,1
2107545,2107751,206,0,0,1,2
2107752,2107783,31,1,0,0,2
2107758,2107781,23,1,0,0,1
2107782,2108917,1135,0,0,1,1
2107784,2108918,1134,0,0,1,2
2108918,2108960,42,1,0,0,1
2108919,2108960,41,1,0,0,2
2108961,2109888,927,0,0,1,1
2108961,2109890,929,0,0,1,2
2109889,2109922,33,1,0,0,1
2109891,2109925,34,1,0,0,2
2109923,2111060,1137,0,0,1,1
2109926,2111061,1135,0,0,1,2
2111061,2111102,41,1,0,0,1
2111062,2111099,37,1,0,0,2
2111100,2111155,55,0,0,1,2
2111103,2111154,51,0,0,1,1
2111155,2111193,38,1,0,0,1
2111156,2111186,30,1,0,0,2
2111187,2111509,322,0,0,1,2
2111194,2111508,314,0,0,1,1
2111509,2111555,46,1,0,0,1
2111510,2111556,46,1,0,0,2
2111556,2111961,405,0,0,1,1
2111557,2111961,404,0,0,1,2
2111962,2111984,22,1,0,0,2
2111962,2111985,23,1,0,0,1
2111985,2112492,507,0,0,1,2
2111986,2112491,505,0,0,1,1
2112492,2112557,65,1,0,0,1
2112493,2112561,68,1,0,0,2
2112558,2112731,173,0,0,1,1
2112562,2112731,169,0,0,1,2
2112732,2112764,32,1,0,0,1
2112732,2112764,32,1,0,0,2
2112765,2112879,114,0,0,1,2
2112765,2112883,118,0,0,1,1
2112880,2112912,32,1,0,0,2
2112884,2112910,26,1,0,0,1
2112911,2113065,154,0,0,1,1
2112913,2113064,151,0,0,1,2
2113065,2113095,30,1,0,0,2
2113066,2113094,28,1,0,0,1
2113095,2113337,242,0,0,1,1
2113096,2113334,238,0,0,1,2
2113335,2113356,21,1,0,0,2
2113338,2113354,16,1,0,0,1
2113355,2113878,523,0,0,1,1
2113357,2113878,521,0,0,1,2
2113879,2113925,46,1,0,0,2
2113879,2113960,81,1,0,0,1
2113926,2114140,214,0,0,1,2
2113961,2114140,179,0,0,1,1
2114141,2114188,47,1,0,0,2
2114141,2114193,52,1,0,0,1
2114189,2114725,536,0,0,1,2
2114194,2114725,531,0,0,1,1
2114726,2114760,34,1,0,0,2
2114726,2114764,38,1,0,0,1
2114761,2115989,1228,0,0,1,2
2114765,2115584,819,0,0,1,1
2115585,2115606,21,1,0,0,1
2115607,2115987,380,0,0,1,1
2115988,2116067,79,1,0,0,1
2115990,2116063,73,1,0,0,2
2116064,2116343,279,0,0,1,2
2116068,2116342,274,0,0,1,1
2116343,2116375,32,1,0,0,1
2116344,2116382,38,1,0,0,2
2116376,2117217,841,0,0,1,1
2116383,2117217,834,0,0,1,2
2117218,2117280,62,1,0,0,1
2117218,2117284,66,1,0,0,2
2117281,2117378,97,0,0,1,1
2117285,2117379,94,0,0,1,2
2117379,2117411,32,1,0,0,1
2117380,2117412,32,1,0,0,2
2117412,2118834,1422,0,0,1,1
2117413,2118834,1421,0,0,1,2
2118835,2118878,43,1,0,0,2
2118835,2118880,45,1,0,0,1
2118879,2119086,207,0,0,1,2
2118881,2119087,206,0,0,1,1
2119087,2119123,36,1,0,0,2
2119088,2119123,35,1,0,0,1
2119124,2120981,1857,0,0,1,1
2119124,2120981,1857,0,0,1,2
2120982,2121016,34,1,0,0,1
2120982,2121019,37,1,0,0,2
2121017,2122598,1581,0,0,1,1
2121020,2122598,1578,0,0,1,2
2122599,2122645,46,1,0,0,1
2122599,2122650,51,1,0,0,2
2122646,2122746,100,0,0,1,1
2122651,2122747,96,0,0,1,2
2122747,2122790,43,1,0,0,1
2122748,2122775,27,1,0,0,2
2122776,2123079,303,0,0,1,2
2122791,2123080,289,0,0,1,1
2123080,2123110,30,1,0,0,2
2123081,2123103,22,1,0,0,1
2123104,2123254,150,0,0,1,1
2123111,2123255,144,0,0,1,2
2123255,2123277,22,1,0,0,1
2123256,2123278,22,1,0,0,2
2123278,2123359,81,0,0,1,1
2123279,2123361,82,0,0,1,2
2123360,2123395,35,1,0,0,1
2123362,2123401,39,1,0,0,2
2123396,2123635,239,0,0,1,1
2123402,2123635,233,0,0,1,2
2123636,2123683,47,1,0,0,1
2123636,2123683,47,1,0,0,2
2123684,2123968,284,0,0,1,2
2123684,2123971,287,0,0,1,1
2123969,2123999,30,1,0,0,2
2123972,2123999,27,1,0,0,1
2124000,2124134,134,0,0,1,1
2124000,2124138,138,0,0,1,2
2124135,2133235,9100,1,0,0,1
2124139,2133241,9102,1,0,0,2
2124227,2133208,8981,0,1,0,1
2124243,2133198,8955,0,1,0,2
2133236,2133275,39,0,0,1,1
2133242,2133289,47,0,0,1,2
2133276,2133978,702,1,0,0,1
2133290,2133938,648,1,0,0,2
2133381,2133399,18,0,1,0,1
2133556,2133967,411,0,1,0,1
2133648,2133869,221,0,1,0,2
2133939,2134090,151,0,0,1,2
2133979,2134044,65,0,0,1,1
2134045,2134061,16,1,0,0,1
2134062,2134089,27,0,0,1,1
2134090,2134115,25,1,0,0,1
2134091,2134125,34,1,0,0,2
2134116,2134307,191,0,0,1,1
2134126,2134309,183,0,0,1,2
2134308,2134341,33,1,0,0,1
2134310,2134343,33,1,0,0,2
2134342,2134458,116,0,0,1,1
2134344,2134458,114,0,0,1,2
2174867,2175127,260,0,0,1,1
2174867,2175127,260,0,0,1,2
2175128,2175170,42,1,0,0,2
2175128,2175173,45,1,0,0,1
2175171,2175295,124,0,0,1,2
2175174,2175297,123,0,0,1,1
2175296,2175327,31,1,0,0,2
2175298,2175328,30,1,0,0,1
2175328,2177507,2179,0,0,1,2
2175329,2177508,2179,0,0,1,1
2177508,2177572,64,1,0,0,2
2177509,2177584,75,1,0,0,1
2177573,2177656,83,0,0,1,2
2177585,2177656,71,0,0,1,1
2177657,2177693,36,1,0,0,2
2177657,2177697,40,1,0,0,1
2177694,2177852,158,0,0,1,2
2177698,2177850,152,0,0,1,1
2177851,2177883,32,1,0,0,1
2177853,2177879,26,1,0,0,2
2177880,2178036,156,0,0,1,2
2177884,2178040,156,0,0,1,1
2178037,2178054,17,1,0,0,2
2178041,2178053,12,1,0,0,1
2178054,2178813,759,0,0,1,1
2178055,2178812,757,0,0,1,2
2178813,2178920,107,1,0,0,2
2178814,2178907,93,1,0,0,1
2178908,2179325,417,0,0,1,1
2178921,2179325,404,0,0,1,2
2179326,2179432,106,1,0,0,2
2179326,2179433,107,1,0,0,1
2179433,2179499,66,0,0,1,2
2179434,2179498,64,0,0,1,1
2179499,2179542,43,1,0,0,1
2179500,2179537,37,1,0,0,2
2179538,2180193,655,0,0,1,2
2179543,2180193,650,0,0,1,1
2180194,2180224,30,1,0,0,2
2180194,2180226,32,1,0,0,1
2180225,2180326,101,0,0,1,2
2180227,2180327,100,0,0,1,1
2180327,2180359,32,1,0,0,2
2180328,2180357,29,1,0,0,1
2180358,2180598,240,0,0,1,1
2180360,2180594,234,0,0,1,2
2180595,2180634,39,1,0,0,2
2180599,2180631,32,1,0,0,1
2180632,2181531,899,0,0,1,1
2180635,2181531,896,0,0,1,2
2181532,2181598,66,1,0,0,2
2181532,2181604,72,1,0,0,1
2181599,2181653,54,0,0,1,2
2181605,2181677,72,0,0,1,1
2181654,2181718,64,1,0,0,2
2181678,2181705,27,1,0,0,1
2181706,2182078,372,0,0,1,1
2181719,2182077,358,0,0,1,2
2182078,2182111,33,1,0,0,2
2182079,2182108,29,1,0,0,1
2182109,2182292,183,0,0,1,1
2182112,2182295,183,0,0,1,2
2182293,2182320,27,1,0,0,1
2182296,2182376,80,1,0,0,2
2182321,2182667,346,0,0,1,1
2182377,2182665,288,0,0,1,2
2182666,2182699,33,1,0,0,2
2182668,2182701,33,1,0,0,1
2182700,2182845,145,0,0,1,2
2182702,2183127,425,0,0,1,1
2182846,2182857,11,1,0,0,2
2182858,2183128,270,0,0,1,2
2183128,2183197,69,1,0,0,1
2183129,2183180,51,1,0,0,2
2183181,2183452,271,0,0,1,2
2183198,2183451,253,0,0,1,1
2183452,2183515,63,1,0,0,1
2183453,2183522,69,1,0,0,2
2183516,2183612,96,0,0,1,1
2183523,2183612,89,0,0,1,2
2183613,2183640,27,1,0,0,1
2183613,2183643,30,1,0,0,2
2183641,2184294,653,0,0,1,1
2183644,2184295,651,0,0,1,2
2184295,2184329,34,1,0,0,1
2184296,2184330,34,1,0,0,2
2184330,2184926,596,0,0,1,1
2184331,2184926,595,0,0,1,2
2184927,2185010,83,1,0,0,1
2184927,2185011,84,1,0,0,2
2185011,2185246,235,0,0,1,1
2185012,2185244,232,0,0,1,2
2185245,2185284,39,1,0,0,2
2185247,2185282,35,1,0,0,1
2185283,2185448,165,0,0,1,1
2185285,2185448,163,0,0,1,2
2185449,2185522,73,1,0,0,2
2185449,2185535,86,1,0,0,1
2185523,2185645,122,0,0,1,2
2185536,2185645,109,0,0,1,1
2185646,2185680,34,1,0,0,2
2185646,2185693,47,1,0,0,1
2185681,2186776,1095,0,0,1,2
2185694,2186774,1080,0,0,1,1
2186775,2186856,81,1,0,0,1
2186777,2186876,99,1,0,0,2
2186857,2187136,279,0,0,1,1
2186877,2187137,260,0,0,1,2
2187137,2187191,54,1,0,0,1
2187138,2187198,60,1,0,0,2
2187192,2187281,89,0,0,1,1
2187199,2187282,83,0,0,1,2
2187282,2187305,23,1,0,0,1
2187283,2187312,29,1,0,0,2
2187306,2188558,1252,0,0,1,1
2187313,2188557,1244,0,0,1,2
2188558,2188626,68,1,0,0,2
2188559,2188630,71,1,0,0,1
2188627,2188930,303,0,0,1,2
2188631,2188929,298,0,0,1,1
2188930,2188986,56,1,0,0,1
2188931,2188987,56,1,0,0,2
2188987,2189083,96,0,0,1,1
2188988,2189086,98,0,0,1,2
2189084,2189111,27,1,0,0,1
2189087,2189107,20,1,0,0,2
2189108,2189508,400,0,0,1,2
2189112,2189503,391,0,0,1,1
2189504,2189534,30,1,0,0,1
2189509,2189534,25,1,0,0,2
2189535,2189759,224,0,0,1,1
2189535,2189773,238,0,0,1,2
2189760,2189769,9,1,0,0,1
2189770,2189916,146,0,0,1,1
2189774,2189778,4,1,0,0,2
2189779,2189915,136,0,0,1,2
2189916,2189935,19,1,0,0,2
2189917,2189937,20,1,0,0,1
2189936,2190214,278,0,0,1,2
2189938,2190215,277,0,0,1,1
2190215,2190248,33,1,0,0,2
2190216,2190257,41,1,0,0,1
2190249,2190410,161,0,0,1,2
2190258,2190410,152,0,0,1,1
2190411,2190440,29,1,0,0,2
2190411,2190453,42,1,0,0,1
2190441,2190726,285,0,0,1,2
2190454,2190725,271,0,0,1,1
2190726,2190792,66,1,0,0,1
2190727,2190814,87,1,0,0,2
2190793,2190966,173,0,0,1,1
2190815,2190967,152,0,0,1,2
2190967,2190998,31,1,0,0,1
2190968,2190999,31,1,0,0,2
2190999,2191256,257,0,0,1,1
2191000,2191253,253,0,0,1,2
2191254,2191282,28,1,0,0,2
2191257,2191278,21,1,0,0,1
2191279,2191844,565,0,0,1,1
2191283,2191647,364,0,0,1,2
2191648,2191738,90,1,0,0,2
2191739,2191821,82,0,0,1,2
2191822,2191955,133,1,0,0,2
2191845,2191906,61,1,0,0,1
2191907,2192083,176,0,0,1,1
2191956,2192084,128,0,0,1,2
2192084,2192143,59,1,0,0,1
2192085,2192153,68,1,0,0,2
2192144,2192305,161,0,0,1,1
2192154,2192270,116,0,0,1,2
2192271,2192362,91,1,0,0,2
2192306,2192352,46,1,0,0,1
2192353,2192489,136,0,0,1,1
2192363,2192489,126,0,0,1,2
2192490,2192518,28,1,0,0,1
2192490,2192532,42,1,0,0,2
2192519,2193379,860,0,0,1,1
2192533,2193378,845,0,0,1,2
2193379,2193457,78,1,0,0,2
2193380,2193458,78,1,0,0,1
2193458,2193611,153,0,0,1,2
2193459,2193704,245,0,0,1,1
2193612,2193639,27,1,0,0,2
2193640,2193699,59,0,0,1,2
2193700,2193890,190,1,0,0,2
2193705,2193800,95,1,0,0,1
2193801,2193824,23,0,0,1,1
2193825,2193882,57,1,0,0,1
2193883,2193958,75,0,0,1,1
2193891,2193958,67,0,0,1,2
2193959,2194004,45,1,0,0,1
2193959,2194015,56,1,0,0,2
2194005,2194320,315,0,0,1,1
2194016,2194320,304,0,0,1,2
2194321,2194354,33,1,0,0,2
2194321,2194355,34,1,0,0,1
2194355,2194567,212,0,0,1,2
2194356,2194568,212,0,0,1,1
2194568,2194600,32,1,0,0,2
2194569,2194599,30,1,0,0,1
2194600,2195134,534,0,0,1,1
2194601,2195134,533,0,0,1,2
2195135,2195202,67,1,0,0,1
2195135,2195205,70,1,0,0,2
2195203,2195489,286,0,0,1,1
2195206,2195488,282,0,0,1,2
2195489,2195588,99,1,0,0,2
2195490,2195556,66,1,0,0,1
2195557,2195673,116,0,0,1,1
2195589,2195674,85,0,0,1,2
2195674,2195706,32,1,0,0,1
2195675,2195736,61,1,0,0,2
2195707,2196795,1088,0,0,1,1
2195737,2195768,31,0,0,1,2
2195769,2195818,49,1,0,0,2
2195819,2196386,567,0,0,1,2
2196387,2196396,9,1,0,0,2
2196397,2196793,396,0,0,1,2
2196794,2196858,64,1,0,0,2
2196796,2196860,64,1,0,0,1
2196859,2197089,230,0,0,1,2
2196861,2197089,228,0,0,1,1
2197090,2197159,69,1,0,0,1
2197090,2197252,162,1,0,0,2
2197160,2197188,28,0,0,1,1
2197189,2197252,63,1,0,0,1
2197253,2197328,75,0,0,1,1
2197253,2197328,75,0,0,1,2
2197329,2197379,50,1,0,0,1
2197329,2197382,53,1,0,0,2
2197380,2197551,171,0,0,1,1
2197383,2197557,174,0,0,1,2
2197552,2197579,27,1,0,0,1
2197558,2197580,22,1,0,0,2
2197580,2198866,1286,0,0,1,1
2197581,2198865,1284,0,0,1,2
2198866,2198917,51,1,0,0,2
2198867,2198911,44,1,0,0,1
2198912,2199069,157,0,0,1,1
2198918,2199069,151,0,0,1,2
2199070,2199143,73,1,0,0,2
2199070,2199151,81,1,0,0,1
2199144,2199254,110,0,0,1,2
2199152,2199253,101,0,0,1,1
2199254,2199281,27,1,0,0,1
2199255,2199277,22,1,0,0,2
2199278,2199538,260,0,0,1,2
2199282,2199536,254,0,0,1,1
2199537,2199569,32,1,0,0,1
2199539,2199569,30,1,0,0,2
2199570,2200402,832,0,0,1,2
2199570,2200403,833,0,0,1,1
2200403,2200434,31,1,0,0,2
2200404,2200435,31,1,0,0,1
2200435,2200573,138,0,0,1,2
2200436,2200572,136,0,0,1,1
2200573,2200655,82,1,0,0,1
2200574,2200661,87,1,0,0,2
2200656,2201042,386,0,0,1,1
2200662,2201043,381,0,0,1,2
2201043,2201114,71,1,0,0,1
2201044,2201119,75,1,0,0,2
2201115,2201220,105,0,0,1,1
2201120,2201220,100,0,0,1,2
2201221,2201253,32,1,0,0,1
2201221,2201254,33,1,0,0,2
2201254,2202398,1144,0,0,1,1
2201255,2202398,1143,0,0,1,2
2202399,2202465,66,1,0,0,2
2202399,2202466,67,1,0,0,1
2202466,2202764,298,0,0,1,2
2202467,2202765,298,0,0,1,1
2202765,2202859,94,1,0,0,2
2202766,2202827,61,1,0,0,1
2202828,2202925,97,0,0,1,1
2202860,2202924,64,0,0,1,2
2202925,2202967,42,1,0,0,2
2202926,2202962,36,1,0,0,1
2202963,2204618,1655,0,0,1,1
2202968,2204618,1650,0,0,1,2
2204619,2204683,64,1,0,0,1
2204619,2204686,67,1,0,0,2
2204684,2205224,540,0,0,1,1
2204687,2205221,534,0,0,1,2
2205222,2205246,24,1,0,0,2
2205225,2205250,25,1,0,0,1
2205247,2206316,1069,0,0,1,2
2205251,2206316,1065,0,0,1,1
2206317,2206398,81,1,0,0,1
2206317,2206404,87,1,0,0,2
2206399,2206483,84,0,0,1,1
2206405,2206482,77,0,0,1,2
2206483,2206532,49,1,0,0,2
2206484,2206524,40,1,0,0,1
2206525,2207004,479,0,0,1,1
2206533,2207001,468,0,0,1,2
2207002,2207029,27,1,0,0,2
2207005,2207029,24,1,0,0,1
2207030,2208201,1171,0,0,1,1
2207030,2208202,1172,0,0,1,2
2208202,2208298,96,1,0,0,1
2208203,2208288,85,1,0,0,2
2208289,2208362,73,0,0,1,2
2208299,2208360,61,0,0,1,1
2208361,2208401,40,1,0,0,1
2208363,2208418,55,1,0,0,2
2208402,2208580,178,0,0,1,1
2208419,2208581,162,0,0,1,2
2208581,2208613,32,1,0,0,1
2208582,2208616,34,1,0,0,2
2208614,2209645,1031,0,0,1,1
2208617,2209645,1028,0,0,1,2
2209646,2209717,71,1,0,0,2
2209646,2209741,95,1,0,0,1
2209718,2209808,90,0,0,1,2
2209742,2209922,180,0,0,1,1
2209809,2209874,65,1,0,0,2
2209875,2209923,48,0,0,1,2
2209923,2210078,155,1,0,0,1
2209924,2210065,141,1,0,0,2
2210066,2210173,107,0,0,1,2
2210079,2210174,95,0,0,1,1
2210174,2210201,27,1,0,0,2
2210175,2210218,43,1,0,0,1
2210202,2210690,488,0,0,1,2
2210219,2210691,472,0,0,1,1
2210691,2210722,31,1,0,0,2
2210692,2210724,32,1,0,0,1
2210723,2211887,1164,0,0,1,2
2210725,2211729,1004,0,0,1,1
2211730,2211742,12,1,0,0,1
2211743,2211887,144,0,0,1,1
2211888,2212010,122,1,0,0,2
2211888,2212132,244,1,0,0,1
2212011,2212081,70,0,0,1,2
2212082,2212145,63,1,0,0,2
2212133,2212458,325,0,0,1,1
2212146,2212455,309,0,0,1,2
2212456,2212491,35,1,0,0,2
2212459,2212490,31,1,0,0,1
2212491,2213195,704,0,0,1,1
2212492,2212704,212,0,0,1,2
2212705,2212726,21,1,0,0,2
2212727,2213190,463,0,0,1,2
2213191,2213264,73,1,0,0,2
2213196,2213276,80,1,0,0,1
2213265,2213540,275,0,0,1,2
2213277,2213540,263,0,0,1,1
2213541,2213602,61,1,0,0,2
2213541,2213603,62,1,0,0,1
2213603,2213871,268,0,0,1,2
2213604,2213872,268,0,0,1,1
2213872,2213951,79,1,0,0,2
2213873,2213953,80,1,0,0,1
2213952,2214200,248,0,0,1,2
2213954,2214199,245,0,0,1,1
2214200,2214230,30,1,0,0,1
2214201,2214230,29,1,0,0,2
2214231,2214727,496,0,0,1,1
2214231,2214727,496,0,0,1,2
2214728,2214767,39,1,0,0,1
2214728,2214769,41,1,0,0,2
2214768,2214871,103,0,0,1,1
2214770,2214873,103,0,0,1,2
2214872,2214894,22,1,0,0,1
2214874,2214903,29,1,0,0,2
2214895,2215049,154,0,0,1,1
2214904,2215051,147,0,0,1,2
2215050,2215078,28,1,0,0,1
2215052,2215078,26,1,0,0,2
2215079,2215271,192,0,0,1,2
2215079,2215272,193,0,0,1,1
2215272,2215304,32,1,0,0,2
2215273,2215305,32,1,0,0,1
2215305,2215458,153,0,0,1,2
2215306,2215458,152,0,0,1,1
2215459,2215681,222,1,0,0,1
2215459,2215682,223,1,0,0,2
2215682,2215830,148,0,0,1,1
2215683,2215831,148,0,0,1,2
2215831,2215926,95,1,0,0,1
2215832,2215915,83,1,0,0,2
2215916,2215962,46,0,0,1,2
2215927,2215960,33,0,0,1,1
2215961,2216019,58,1,0,0,1
2215963,2216021,58,1,0,0,2
2216020,2216688,668,0,0,1,1
2216022,2216689,667,0,0,1,2
2216689,2216719,30,1,0,0,1
2216690,2216715,25,1,0,0,2
2216716,2217718,1002,0,0,1,2
2216720,2217719,999,0,0,1,1
2217719,2217796,77,1,0,0,2
2217720,2217793,73,1,0,0,1
2217794,2217897,103,0,0,1,1
2217797,2217897,100,0,0,1,2
2217898,2217925,27,1,0,0,1
2217898,2217927,29,1,0,0,2
2217926,2218108,182,0,0,1,1
2217928,2218108,180,0,0,1,2
2218109,2218139,30,1,0,0,1
2218109,2218139,30,1,0,0,2
2218140,2218732,592,0,0,1,1
2218140,2218732,592,0,0,1,2
2218733,2218757,24,1,0,0,1
2218733,2218765,32,1,0,0,2
2218758,2219108,350,0,0,1,1
2218766,2219109,343,0,0,1,2
2219109,2219143,34,1,0,0,1
2219110,2219147,37,1,0,0,2
2219144,2219377,233,0,0,1,1
2219148,2219376,228,0,0,1,2
2219377,2219414,37,1,0,0,2
2219378,2219413,35,1,0,0,1
2219414,2219493,79,0,0,1,1
2219415,2219494,79,0,0,1,2
2219494,2219566,72,1,0,0,1
2219495,2219568,73,1,0,0,2
2219567,2219664,97,0,0,1,1
2219569,2219665,96,0,0,1,2
2219665,2219685,20,1,0,0,1
2219666,2219688,22,1,0,0,2
2219686,2219984,298,0,0,1,1
2219689,2219984,295,0,0,1,2
2219985,2220014,29,1,0,0,1
2219985,2220016,31,1,0,0,2
2220015,2220333,318,0,0,1,1
2220017,2220334,317,0,0,1,2
2220334,2220354,20,1,0,0,1
2220335,2220354,19,1,0,0,2
2220355,2221118,763,0,0,1,1
2220355,2221119,764,0,0,1,2
2221119,2221164,45,1,0,0,1
2221120,2221164,44,1,0,0,2
2221165,2221497,332,0,0,1,2
2221165,2221501,336,0,0,1,1
2221498,2221683,185,1,0,0,2
2221502,2221567,65,1,0,0,1
2221568,2221646,78,0,0,1,1
2221647,2221683,36,1,0,0,1
2221684,2222155,471,0,0,1,2
2221684,2222157,473,0,0,1,1
2222156,2222186,30,1,0,0,2
2222158,2222187,29,1,0,0,1
2222187,2222293,106,0,0,1,2
2222188,2222293,105,0,0,1,1
2222294,2222317,23,1,0,0,1
2222294,2222323,29,1,0,0,2
2222318,2223035,717,0,0,1,1
2222324,2223036,712,0,0,1,2
2223036,2223115,79,1,0,0,1
2223037,2223114,77,1,0,0,2
2223115,2223401,286,0,0,1,2
2223116,2223401,285,0,0,1,1
2223402,2223458,56,1,0,0,1
2223402,2223462,60,1,0,0,2
2223459,2223557,98,0,0,1,1
2223463,2223557,94,0,0,1,2
2223558,2223593,35,1,0,0,2
2223558,2223604,46,1,0,0,1
2223594,2223786,192,0,0,1,2
2223605,2223786,181,0,0,1,1
2223787,2223817,30,1,0,0,2
2223787,2223834,47,1,0,0,1
2223818,2224024,206,0,0,1,2
2223835,2224025,190,0,0,1,1
2224025,2224055,30,1,0,0,2
2224026,2224053,27,1,0,0,1
2224054,2224251,197,0,0,1,1
2224056,2224253,197,0,0,1,2
2224252,2224271,19,1,0,0,1
2224254,2224272,18,1,0,0,2
2224272,2224519,247,0,0,1,1
2224273,2224522,249,0,0,1,2
2224520,2224565,45,1,0,0,1
2224523,2224552,29,1,0,0,2
2224553,2225343,790,0,0,1,2
2224566,2225342,776,0,0,1,1
2225343,2225408,65,1,0,0,1
2225344,2225406,62,1,0,0,2
2225407,2225599,192,0,0,1,2
2225409,2225599,190,0,0,1,1
2225600,2225641,41,1,0,0,1
2225600,2225642,42,1,0,0,2
2225642,2226546,904,0,0,1,1
2225643,2226543,900,0,0,1,2
2226544,2226571,27,1,0,0,2
2226547,2226575,28,1,0,0,1
2226572,2227587,1015,0,0,1,2
2226576,2227586,1010,0,0,1,1
2227587,2227656,69,1,0,0,1
2227588,2227662,74,1,0,0,2
2227657,2227690,33,0,0,1,1
2227663,2227691,28,0,0,1,2
2227691,2227770,79,1,0,0,1
2227692,2227769,77,1,0,0,2
2227770,2227840,70,0,0,1,2
2227771,2227821,50,0,0,1,1
2227822,2227911,89,1,0,0,1
2227841,2227871,30,1,0,0,2
2227872,2229839,1967,0,0,1,2
2227912,2228587,675,0,0,1,1
2228588,2228600,12,1,0,0,1
2228601,2229295,694,0,0,1,1
2229296,2229396,100,1,0,0,1
2229397,2229840,443,0,0,1,1
2229840,2229936,96,1,0,0,2
2229841,2229933,92,1,0,0,1
2229934,2230054,120,0,0,1,1
2229937,2230050,113,0,0,1,2
2230051,2230078,27,1,0,0,2
2230055,2230072,17,1,0,0,1
2230073,2230314,241,0,0,1,1
2230079,2230313,234,0,0,1,2
2230314,2230336,22,1,0,0,2
2230315,2230333,18,1,0,0,1
2230334,2230446,112,0,0,1,1
2230337,2230446,109,0,0,1,2
2230447,2230468,21,1,0,0,1
2230447,2230479,32,1,0,0,2
2230469,2230766,297,0,0,1,1
2230480,2230765,285,0,0,1,2
2230766,2230794,28,1,0,0,2
2230767,2230786,19,1,0,0,1
2230787,2231539,752,0,0,1,1
2230795,2231539,744,0,0,1,2
2231540,2231739,199,1,0,0,1
2231540,2231740,200,1,0,0,2
2231740,2231992,252,0,0,1,1
2231741,2231990,249,0,0,1,2
2231991,2232062,71,1,0,0,2
2231993,2232068,75,1,0,0,1
2232063,2232160,97,0,0,1,2
2232069,2232160,91,0,0,1,1
2232161,2232188,27,1,0,0,2
2232161,2232190,29,1,0,0,1
2232189,2232716,527,0,0,1,2
2232191,2232715,524,0,0,1,1
2232716,2232746,30,1,0,0,1
2232717,2232746,29,1,0,0,2
2232747,2233240,493,0,0,1,2
2232747,2234142,1395,0,0,1,1
2233241,2233255,14,1,0,0,2
2233256,2234143,887,0,0,1,2
2234143,2234236,93,1,0,0,1
2234144,2234218,74,1,0,0,2
2234219,2234303,84,0,0,1,2
2234237,2234302,65,0,0,1,1
2234303,2234357,54,1,0,0,1
2234304,2234347,43,1,0,0,2
2234348,2234497,149,0,0,1,2
2234358,2234503,145,0,0,1,1
2234498,2234528,30,1,0,0,2
2234504,2234530,26,1,0,0,1
2234529,2235105,576,0,0,1,2
2234531,2234725,194,0,0,1,1
2234726,2234745,19,1,0,0,1
2234746,2235106,360,0,0,1,1
2235106,2235137,31,1,0,0,2
2235107,2235126,19,1,0,0,1
2235127,2235279,152,0,0,1,1
2235138,2235862,724,0,0,1,2
2235280,2235301,21,1,0,0,1
2235302,2235861,559,0,0,1,1
2235862,2235918,56,1,0,0,1
2235863,2235918,55,1,0,0,2
2235919,2236036,117,0,0,1,2
2235919,2236039,120,0,0,1,1
2236037,2236094,57,1,0,0,2
2236040,2236093,53,1,0,0,1
2236094,2236258,164,0,0,1,1
2236095,2236258,163,0,0,1,2
2236259,2236338,79,1,0,0,1
2236259,2236342,83,1,0,0,2
2236339,2236425,86,0,0,1,1
2236343,2236425,82,0,0,1,2
2236426,2236456,30,1,0,0,1
2236426,2236461,35,1,0,0,2
2236457,2236955,498,0,0,1,1
2236462,2236955,493,0,0,1,2
2236956,2236987,31,1,0,0,1
2236956,2236991,35,1,0,0,2
2236988,2237308,320,0,0,1,1
2236992,2237304,312,0,0,1,2
2237305,2237333,28,1,0,0,2
2237309,2237320,11,1,0,0,1
2237321,2237735,414,0,0,1,1
2237334,2237735,401,0,0,1,2
2237736,2237931,195,1,0,0,2
2237736,2237932,196,1,0,0,1
2237932,2238231,299,0,0,1,2
2237933,2238229,296,0,0,1,1
2238230,2238284,54,1,0,0,1
2238232,2238286,54,1,0,0,2
2238285,2238411,126,0,0,1,1
2238287,2238415,128,0,0,1,2
2238412,2238433,21,1,0,0,1
2238416,2238423,7,1,0,0,2
2238424,2239516,1092,0,0,1,2
2238434,2239631,1197,0,0,1,1
2239517,2239584,67,1,0,0,2
2239585,2239631,46,0,0,1,2
2239632,2239718,86,1,0,0,1
2239632,2239718,86,1,0,0,2
2239719,2240020,301,0,0,1,1
2239719,2240020,301,0,0,1,2
2240021,2240058,37,1,0,0,1
2240021,2240061,40,1,0,0,2
2240059,2240223,164,0,0,1,1
2240062,2240224,162,0,0,1,2
2240224,2240258,34,1,0,0,1
2240225,2240253,28,1,0,0,2
2240254,2241181,927,0,0,1,2
2240259,2240523,264,0,0,1,1
2240524,2240530,6,1,0,0,1
2240531,2241180,649,0,0,1,1
2241181,2241236,55,1,0,0,1
2241182,2241233,51,1,0,0,2
2241234,2241578,344,0,0,1,2
2241237,2241578,341,0,0,1,1
2241579,2241667,88,1,0,0,2
2241579,2241676,97,1,0,0,1
2241668,2241708,40,0,0,1,2
2241677,2241705,28,0,0,1,1
2241706,2241759,53,1,0,0,1
2241709,2241763,54,1,0,0,2
2241760,2241867,107,0,0,1,1
2241764,2241868,104,0,0,1,2
2241868,2241896,28,1,0,0,1
2241869,2241890,21,1,0,0,2
2241891,2242469,578,0,0,1,2
2241897,2242468,571,0,0,1,1
2242469,2242501,32,1,0,0,1
2242470,2242505,35,1,0,0,2
2242502,2242602,100,0,0,1,1
2242506,2242602,96,0,0,1,2
2242603,2242633,30,1,0,0,1
2242603,2242636,33,1,0,0,2
2242634,2243344,710,0,0,1,1
2242637,2243344,707,0,0,1,2
2243345,2243412,67,1,0,0,1
2243345,2243415,70,1,0,0,2
2243413,2243482,69,0,0,1,1
2243416,2243480,64,0,0,1,2
2243481,2243575,94,1,0,0,2
2243483,2243568,85,1,0,0,1
2243569,2243757,188,0,0,1,1
2243576,2243757,181,0,0,1,2
2243758,2243840,82,1,0,0,2
2243758,2243846,88,1,0,0,1
2243841,2243928,87,0,0,1,2
2243847,2243929,82,0,0,1,1
2243929,2243969,40,1,0,0,2
2243930,2243969,39,1,0,0,1
2243970,2244193,223,0,0,1,2
2243970,2244195,225,0,0,1,1
2244194,2244227,33,1,0,0,2
2244196,2244224,28,1,0,0,1
2244225,2244455,230,0,0,1,1
2244228,2244453,225,0,0,1,2
2244454,2244496,42,1,0,0,2
2244456,2244489,33,1,0,0,1
2244490,2245410,920,0,0,1,1
2244497,2245409,912,0,0,1,2
2245410,2245529,119,1,0,0,2
2245411,2245529,118,1,0,0,1
2245530,2245844,314,0,0,1,2
2245530,2245845,315,0,0,1,1
2245845,2245892,47,1,0,0,2
2245846,2245894,48,1,0,0,1
2245893,2245976,83,0,0,1,2
2245895,2245978,83,0,0,1,1
2245977,2246023,46,1,0,0,2
2245979,2246021,42,1,0,0,1
2246022,2246308,286,0,0,1,1
2246024,2246307,283,0,0,1,2
2246308,2246337,29,1,0,0,2
2246309,2246334,25,1,0,0,1
2246335,2246848,513,0,0,1,1
2246338,2246849,511,0,0,1,2
2246849,2246876,27,1,0,0,1
2246850,2246877,27,1,0,0,2
2246877,2247844,967,0,0,1,1
2246878,2247842,964,0,0,1,2
2247843,2247892,49,1,0,0,2
2247845,2247890,45,1,0,0,1
2247891,2247989,98,0,0,1,1
2247893,2247984,91,0,0,1,2
2247985,2248029,44,1,0,0,2
2247990,2248016,26,1,0,0,1
2248017,2248401,384,0,0,1,1
2248030,2248336,306,0,0,1,2
2248337,2248445,108,1,0,0,2
2248402,2248430,28,1,0,0,1
2248431,2248741,310,0,0,1,1
2248446,2248744,298,0,0,1,2
2248742,2248773,31,1,0,0,1
2248745,2248807,62,1,0,0,2
2248774,2249911,1137,0,0,1,1
2248808,2249910,1102,0,0,1,2
2249911,2250019,108,1,0,0,2
2249912,2250005,93,1,0,0,1
2250006,2250136,130,0,0,1,1
2250020,2250135,115,0,0,1,2
2250136,2250159,23,1,0,0,2
2250137,2250160,23,1,0,0,1
2250160,2250351,191,0,0,1,2
2250161,2250353,192,0,0,1,1
2250352,2250371,19,1,0,0,2
2250354,2250370,16,1,0,0,1
2250371,2250659,288,0,0,1,1
2250372,2250659,287,0,0,1,2
2250660,2250689,29,1,0,0,1
2250660,2250700,40,1,0,0,2
2250690,2251744,1054,0,0,1,1
2250701,2251744,1043,0,0,1,2
2251745,2251840,95,1,0,0,1
2251745,2251845,100,1,0,0,2
2251841,2252070,229,0,0,1,1
2251846,2252071,225,0,0,1,2
2252071,2252128,57,1,0,0,1
2252072,2252128,56,1,0,0,2
2252129,2252207,78,0,0,1,1
2252129,2252209,80,0,0,1,2
2252208,2252248,40,1,0,0,1
2252210,2252243,33,1,0,0,2
2252244,2252428,184,0,0,1,2
2252249,2252425,176,0,0,1,1
2252426,2252455,29,1,0,0,1
2252429,2252457,28,1,0,0,2
2252456,2253140,684,0,0,1,1
2252458,2253140,682,0,0,1,2
2253141,2253173,32,1,0,0,1
2253141,2253174,33,1,0,0,2
2253174,2254005,831,0,0,1,1
2253175,2254006,831,0,0,1,2
2254006,2254064,58,1,0,0,1
2254007,2254067,60,1,0,0,2
2254065,2254188,123,0,0,1,1
2254068,2254189,121,0,0,1,2
2254189,2254253,64,1,0,0,1
2254190,2254252,62,1,0,0,2
2254253,2254342,89,0,0,1,2
2254254,2254342,88,0,0,1,1
2254343,2254368,25,1,0,0,1
2254343,2254369,26,1,0,0,2
2254369,2254551,182,0,0,1,1
2254370,2254551,181,0,0,1,2
2254552,2254582,30,1,0,0,1
2254552,2254582,30,1,0,0,2
2254583,2254727,144,0,0,1,1
2254583,2254728,145,0,0,1,2
2254728,2254756,28,1,0,0,1
2254729,2254758,29,1,0,0,2
2254757,2256019,1262,0,0,1,1
2254759,2255189,430,0,0,1,2
2255190,2255198,8,1,0,0,2
2255199,2256020,821,0,0,1,2
2256020,2256065,45,1,0,0,1
2256021,2256065,44,1,0,0,2
2256066,2256224,158,0,0,1,1
2256066,2256224,158,0,0,1,2
2256225,2256294,69,1,0,0,1
2256225,2256310,85,1,0,0,2
2256295,2256394,99,0,0,1,1
2256311,2256394,83,0,0,1,2
2256395,2256423,28,1,0,0,2
2256395,2256424,29,1,0,0,1
2256424,2256852,428,0,0,1,2
2256425,2256854,429,0,0,1,1
2256853,2256883,30,1,0,0,2
2256855,2256878,23,1,0,0,1
2256879,2257974,1095,0,0,1,1
2256884,2257973,1089,0,0,1,2
2257974,2258031,57,1,0,0,2
2257975,2258027,52,1,0,0,1
2258028,2258316,288,0,0,1,1
2258032,2258315,283,0,0,1,2
2258316,2258383,67,1,0,0,2
2258317,2258383,66,1,0,0,1
2258384,2258455,71,0,0,1,2
2258384,2258456,72,0,0,1,1
2258456,2258496,40,1,0,0,2
2258457,2258502,45,1,0,0,1
2258497,2258702,205,0,0,1,2
2258503,2258701,198,0,0,1,1
2258702,2258721,19,1,0,0,1
2258703,2258727,24,1,0,0,2
2258722,2259844,1122,0,0,1,1
2258728,2259844,1116,0,0,1,2
2259845,2259877,32,1,0,0,2
2259845,2259885,40,1,0,0,1
2259878,2260377,499,0,0,1,2
2259886,2260376,490,0,0,1,1
2260377,2260453,76,1,0,0,1
2260378,2260463,85,1,0,0,2
2260454,2260535,81,0,0,1,1
2260464,2260536,72,0,0,1,2
2260536,2260571,35,1,0,0,1
2260537,2260577,40,1,0,0,2
2260572,2261948,1376,0,0,1,1
2260578,2261948,1370,0,0,1,2
2261949,2262032,83,1,0,0,2
2261949,2262037,88,1,0,0,1
2262033,2262306,273,0,0,1,2
2262038,2262307,269,0,0,1,1
2262307,2262374,67,1,0,0,2
2262308,2262367,59,1,0,0,1
2262368,2262456,88,0,0,1,1
2262375,2262454,79,0,0,1,2
2262455,2262488,33,1,0,0,2
2262457,2262489,32,1,0,0,1
2262489,2262689,200,0,0,1,2
2262490,2262695,205,0,0,1,1
2262690,2262718,28,1,0,0,2
2262696,2262718,22,1,0,0,1
2262719,2264232,1513,0,0,1,1
2262719,2264234,1515,0,0,1,2
2264233,2264297,64,1,0,0,1
2264235,2264308,73,1,0,0,2
2264298,2264381,83,0,0,1,1
2264309,2264381,72,0,0,1,2
2264382,2264427,45,1,0,0,2
2264382,2264428,46,1,0,0,1
2264428,2264536,108,0,0,1,2
2264429,2264536,107,0,0,1,1
2264537,2264564,27,1,0,0,1
2264537,2264568,31,1,0,0,2
2264565,2264782,217,0,0,1,1
2264569,2264782,213,0,0,1,2
2264783,2264787,4,1,0,0,1
2264783,2264795,12,1,0,0,2
2264788,2266108,1320,0,0,1,1
2264796,2266107,1311,0,0,1,2
2266108,2266186,78,1,0,0,2
2266109,2266187,78,1,0,0,1
2266187,2266258,71,0,0,1,2
2266188,2266258,70,0,0,1,1
2266259,2266302,43,1,0,0,2
2266259,2266325,66,1,0,0,1
2266303,2267054,751,0,0,1,2
2266326,2267053,727,0,0,1,1
2267054,2267089,35,1,0,0,1
2267055,2267099,44,1,0,0,2
2267090,2267291,201,0,0,1,1
2267100,2267292,192,0,0,1,2
2267292,2267317,25,1,0,0,1
2267293,2267315,22,1,0,0,2
2267316,2268170,854,0,0,1,2
2267318,2268170,852,0,0,1,1
2268171,2268272,101,1,0,0,2
2268171,2268274,103,1,0,0,1
2268273,2268396,123,0,0,1,2
2268275,2268331,56,0,0,1,1
2268332,2268348,16,1,0,0,1
2268349,2268396,47,0,0,1,1
2268397,2268425,28,1,0,0,2
2268397,2268429,32,1,0,0,1
2268426,2268704,278,0,0,1,2
2268430,2268706,276,0,0,1,1
2268705,2268732,27,1,0,0,2
2268707,2268741,34,1,0,0,1
2268733,2269526,793,0,0,1,2
2268742,2269526,784,0,0,1,1
2269527,2269607,80,1,0,0,2
2269527,2269609,82,1,0,0,1
2269608,2270046,438,0,0,1,2
2269610,2270046,436,0,0,1,1
2270047,2270105,58,1,0,0,2
2270047,2270107,60,1,0,0,1
2270106,2270209,103,0,0,1,2
2270108,2270208,100,0,0,1,1
2270209,2270234,25,1,0,0,1
2270210,2270236,26,1,0,0,2
2270235,2270431,196,0,0,1,1
2270237,2270432,195,0,0,1,2
2270432,2270454,22,1,0,0,1
2270433,2270449,16,1,0,0,2
2270450,2271835,1385,0,0,1,2
2270455,2271829,1374,0,0,1,1
2271830,2271859,29,1,0,0,1
2271836,2271858,22,1,0,0,2
2271859,2272120,261,0,0,1,2
2271860,2272119,259,0,0,1,1
2272120,2272174,54,1,0,0,1
2272121,2272175,54,1,0,0,2
2272175,2272259,84,0,0,1,1
2272176,2272259,83,0,0,1,2
2272260,2272284,24,1,0,0,2
2272260,2272286,26,1,0,0,1
2272285,2275574,3289,0,0,1,2
2272287,2275574,3287,0,0,1,1
2275575,2275624,49,1,0,0,1
2275575,2275649,74,1,0,0,2
2275625,2275770,145,0,0,1,1
2275650,2275766,116,0,0,1,2
2275767,2275784,17,1,0,0,2
2275771,2275781,10,1,0,0,1
2275782,2276578,796,0,0,1,1
2275785,2276014,229,0,0,1,2
2276015,2276026,11,1,0,0,2
2276027,2276576,549,0,0,1,2
2276577,2276600,23,1,0,0,2
2276579,2276598,19,1,0,0,1
2276599,2276720,121,0,0,1,1
2276601,2276720,119,0,0,1,2
2276721,2276772,51,1,0,0,1
2276721,2276793,72,1,0,0,2
2276773,2277001,228,0,0,1,1
2276794,2277003,209,0,0,1,2
2277002,2277032,30,1,0,0,1
2277004,2277036,32,1,0,0,2
2277033,2279046,2013,0,0,1,1
2277037,2279046,2009,0,0,1,2
2279047,2279095,48,1,0,0,2
2279047,2279097,50,1,0,0,1
2279096,2280038,942,0,0,1,2
2279098,2280038,940,0,0,1,1
2280039,2280119,80,1,0,0,2
2280039,2280123,84,1,0,0,1
2280120,2280207,87,0,0,1,2
2280124,2280207,83,0,0,1,1
2280208,2280240,32,1,0,0,1
2280208,2280242,34,1,0,0,2
2280241,2280545,304,0,0,1,1
2280243,2280540,297,0,0,1,2
2280541,2280568,27,1,0,0,2
2280546,2280560,14,1,0,0,1
2280561,2281158,597,0,0,1,1
2280569,2281156,587,0,0,1,2
2281157,2281228,71,1,0,0,2
2281159,2281231,72,1,0,0,1
2281229,2281949,720,0,0,1,2
2281232,2281947,715,0,0,1,1
2281948,2282008,60,1,0,0,1
2281950,2282013,63,1,0,0,2
2282009,2282099,90,0,0,1,1
2282014,2282099,85,0,0,1,2
2282100,2282149,49,1,0,0,1
2282100,2282150,50,1,0,0,2
2282150,2282282,132,0,0,1,1
2282151,2282820,669,0,0,1,2
2282283,2282295,12,1,0,0,1
2282296,2282832,536,0,0,1,1
2282821,2282849,28,1,0,0,2
2282833,2282851,18,1,0,0,1
2282850,2284662,1812,0,0,1,2
2282852,2284663,1811,0,0,1,1
2284663,2284721,58,1,0,0,2
2284664,2284723,59,1,0,0,1
2284722,2284776,54,0,0,1,2
2284724,2284778,54,0,0,1,1
2284777,2284834,57,1,0,0,2
2284779,2284824,45,1,0,0,1
2284825,2286160,1335,0,0,1,1
2284835,2286159,1324,0,0,1,2
2286160,2286215,55,1,0,0,2
2286161,2286234,73,1,0,0,1
2286216,2286429,213,0,0,1,2
2286235,2286428,193,0,0,1,1
2286429,2286463,34,1,0,0,1
2286430,2286462,32,1,0,0,2
2286463,2286853,390,0,0,1,2
2286464,2286854,390,0,0,1,1
2286854,2286875,21,1,0,0,2
2286855,2286881,26,1,0,0,1
2286876,2287097,221,0,0,1,2
2286882,2287097,215,0,0,1,1
2287098,2287128,30,1,0,0,1
2287098,2287128,30,1,0,0,2
2287129,2288181,1052,0,0,1,2
2287129,2288182,1053,0,0,1,1
2288182,2288255,73,1,0,0,2
2288183,2288239,56,1,0,0,1
2288240,2288510,270,0,0,1,1
2288256,2288512,256,0,0,1,2
2288511,2288536,25,1,0,0,1
2288513,2288536,23,1,0,0,2
2288537,2288986,449,0,0,1,1
2288537,2288988,451,0,0,1,2
2288987,2289011,24,1,0,0,1
2288989,2289013,24,1,0,0,2
2289012,2290784,1772,0,0,1,1
2289014,2290784,1770,0,0,1,2
2290785,2290843,58,1,0,0,1
2290785,2290844,59,1,0,0,2
2290844,2292143,1299,0,0,1,1
2290845,2292142,1297,0,0,1,2
2292143,2292245,102,1,0,0,2
2292144,2292241,97,1,0,0,1
2292242,2292377,135,0,0,1,1
2292246,2292359,113,0,0,1,2
2292360,2292428,68,1,0,0,2
2292378,2292410,32,1,0,0,1
2292411,2292571,160,0,0,1,1
2292429,2292575,146,0,0,1,2
2292572,2292598,26,1,0,0,1
2292576,2292592,16,1,0,0,2
2292593,2293061,468,0,0,1,2
2292599,2293061,462,0,0,1,1
2293062,2293092,30,1,0,0,1
2293062,2293092,30,1,0,0,2
2293093,2293352,259,0,0,1,1
2293093,2293357,264,0,0,1,2
2293353,2293381,28,1,0,0,1
2293358,2293382,24,1,0,0,2
2293382,2293527,145,0,0,1,1
2293383,2293527,144,0,0,1,2
2293528,2293576,48,1,0,0,1
2293528,2293583,55,1,0,0,2
2293577,2293741,164,0,0,1,1
2293584,2293740,156,0,0,1,2
2293741,2293868,127,1,0,0,2
2293742,2293774,32,1,0,0,1
2293775,2294174,399,0,0,1,1
2293869,2293904,35,0,0,1,2
2293905,2293922,17,1,0,0,2
2293923,2293970,47,0,0,1,2
2293971,2294047,76,1,0,0,2
2294048,2294173,125,0,0,1,2
2294174,2294209,35,1,0,0,2
2294175,2294209,34,1,0,0,1
2294210,2294640,430,0,0,1,1
2294210,2294641,431,0,0,1,2
2294641,2294694,53,1,0,0,1
2294642,2294676,34,1,0,0,2
2294677,2295544,867,0,0,1,2
2294695,2295597,902,0,0,1,1
2295545,2295573,28,1,0,0,2
2295574,2295596,22,0,0,1,2
2295597,2295641,44,1,0,0,2
2295598,2295643,45,1,0,0,1
2295642,2295823,181,0,0,1,2
2295644,2295821,177,0,0,1,1
2295822,2295862,40,1,0,0,1
2295824,2295865,41,1,0,0,2
2295863,2296781,918,0,0,1,1
2295866,2296783,917,0,0,1,2
2296782,2296849,67,1,0,0,1
2296784,2296858,74,1,0,0,2
2296850,2296984,134,0,0,1,1
2296859,2296986,127,0,0,1,2
2296985,2297007,22,1,0,0,1
2296987,2297017,30,1,0,0,2
2297008,2297121,113,0,0,1,1
2297018,2297123,105,0,0,1,2
2297122,2297159,37,1,0,0,1
2297124,2297153,29,1,0,0,2
2297154,2297446,292,0,0,1,2
2297160,2298662,1502,0,0,1,1
2297447,2297468,21,1,0,0,2
2297469,2298661,1192,0,0,1,2
2298662,2298728,66,1,0,0,2
2298663,2298719,56,1,0,0,1
2298720,2298831,111,0,0,1,1
2298729,2298831,102,0,0,1,2
2298832,2298863,31,1,0,0,1
2298832,2298866,34,1,0,0,2
2298864,2299045,181,0,0,1,1
2298867,2299046,179,0,0,1,2
2299046,2299081,35,1,0,0,1
2299047,2299079,32,1,0,0,2
2299080,2300786,1706,0,0,1,2
2299082,2300785,1703,0,0,1,1
2300786,2300849,63,1,0,0,1
2300787,2300849,62,1,0,0,2
2300850,2301178,328,0,0,1,2
2300850,2301180,330,0,0,1,1
2301179,2301228,49,1,0,0,2
2301181,2301228,47,1,0,0,1
2301229,2302450,1221,0,0,1,1
2301229,2302453,1224,0,0,1,2
2302451,2302527,76,1,0,0,1
2302454,2302503,49,1,0,0,2
2302504,2302699,195,0,0,1,2
2302528,2302696,168,0,0,1,1
2302697,2302769,72,1,0,0,1
2302700,2302734,34,1,0,0,2
2302735,2302922,187,0,0,1,2
2302770,2302853,83,0,0,1,1
2302854,2302858,4,1,0,0,1
2302859,2302925,66,0,0,1,1
2302923,2302963,40,1,0,0,2
2302926,2302955,29,1,0,0,1
2302956,2303564,608,0,0,1,1
2302964,2304377,1413,0,0,1,2
2303565,2303573,8,1,0,0,1
2303574,2304377,803,0,0,1,1
2304378,2304439,61,1,0,0,1
2304378,2304443,65,1,0,0,2
2304440,2304544,104,0,0,1,1
2304444,2304544,100,0,0,1,2
2304545,2304581,36,1,0,0,2
2304545,2304590,45,1,0,0,1
2304582,2305224,642,0,0,1,2
2304591,2305225,634,0,0,1,1
2305225,2305257,32,1,0,0,2
2305226,2305256,30,1,0,0,1
2305257,2307520,2263,0,0,1,1
2305258,2307519,2261,0,0,1,2
2307520,2307576,56,1,0,0,2
2307521,2307585,64,1,0,0,1
2307577,2308240,663,0,0,1,2
2307586,2308240,654,0,0,1,1
2308241,2308291,50,1,0,0,2
2308241,2308302,61,1,0,0,1
2308292,2308398,106,0,0,1,2
2308303,2308398,95,0,0,1,1
2308399,2308422,23,1,0,0,2
2308399,2308429,30,1,0,0,1
2308423,2308903,480,0,0,1,2
2308430,2308909,479,0,0,1,1
2308904,2308935,31,1,0,0,2
2308910,2308935,25,1,0,0,1
2308936,2310343,1407,0,0,1,2
2308936,2310345,1409,0,0,1,1
2310344,2310403,59,1,0,0,2
2310346,2310411,65,1,0,0,1
2310404,2313725,3321,0,0,1,2
2310412,2313726,3314,0,0,1,1
2313726,2313786,60,1,0,0,2
2313727,2313785,58,1,0,0,1
2313786,2314318,532,0,0,1,1
2313787,2314319,532,0,0,1,2
2314319,2314385,66,1,0,0,1
2314320,2314388,68,1,0,0,2
2314386,2315604,1218,0,0,1,1
2314389,2314643,254,0,0,1,2
2314644,2314648,4,1,0,0,2
2314649,2315605,956,0,0,1,2
2315605,2315657,52,1,0,0,1
2315606,2315656,50,1,0,0,2
2315657,2318062,2405,0,0,1,2
2315658,2318063,2405,0,0,1,1
2318063,2318141,78,1,0,0,2
2318064,2318122,58,1,0,0,1
2318123,2319202,1079,0,0,1,1
2318142,2319204,1062,0,0,1,2
2319203,2319266,63,1,0,0,1
2319205,2319278,73,1,0,0,2
2319267,2320678,1411,0,0,1,1
2319279,2319401,122,0,0,1,2
2319402,2319418,16,1,0,0,2
2319419,2319526,107,0,0,1,2
2319527,2319531,4,1,0,0,2
2319532,2320075,543,0,0,1,2
2320076,2320166,90,1,0,0,2
2320167,2320276,109,0,0,1,2
2320277,2320343,66,1,0,0,2
2320344,2320404,60,0,0,1,2
2320405,2320409,4,1,0,0,2
2320410,2320678,268,0,0,1,2
2320679,2320729,50,1,0,0,1
2320679,2320752,73,1,0,0,2
2320730,2323301,2571,0,0,1,1
2320753,2322360,1607,0,0,1,2
2322361,2322406,45,1,0,0,2
2322407,2322548,141,0,0,1,2
2322549,2322553,4,1,0,0,2
2322554,2323302,748,0,0,1,2
2323302,2323369,67,1,0,0,1
2323303,2323372,69,1,0,0,2
2323370,2324267,897,0,0,1,1
2323373,2324267,894,0,0,1,2
2324268,2324342,74,1,0,0,2
2324268,2324345,77,1,0,0,1
2324343,2324446,103,0,0,1,2
2324346,2324445,99,0,0,1,1
2324446,2324477,31,1,0,0,1
2324447,2324499,52,1,0,0,2
2324478,2325228,750,0,0,1,1
2324500,2325228,728,0,0,1,2
2325229,2325265,36,1,0,0,1
2325229,2325291,62,1,0,0,2
2325266,2325781,515,0,0,1,1
2325292,2325781,489,0,0,1,2
2325782,2325844,62,1,0,0,2
2325782,2325851,69,1,0,0,1
2325845,2328571,2726,0,0,1,2
2325852,2328570,2718,0,0,1,1
2328571,2328663,92,1,0,0,1
2328572,2328671,99,1,0,0,2
2328664,2328912,248,0,0,1,1
2328672,2328913,241,0,0,1,2
2328913,2328958,45,1,0,0,1
2328914,2328954,40,1,0,0,2
2328955,2329091,136,0,0,1,2
2328959,2329092,133,0,0,1,1
2329092,2329149,57,1,0,0,2
2329093,2329150,57,1,0,0,1
2329150,2329259,109,0,0,1,2
2329151,2329260,109,0,0,1,1
2329260,2329294,34,1,0,0,2
2329261,2329285,24,1,0,0,1
2329286,2329345,59,0,0,1,1
2329295,2329364,69,0,0,1,2
2329346,2329665,319,1,0,0,1
2329365,2329620,255,1,0,0,2
2329378,2329615,237,0,1,0,1
2329402,2329555,153,0,1,0,2
2329621,2330113,492,0,0,1,2
2329666,2330112,446,0,0,1,1
2330113,2330144,31,1,0,0,1
2330114,2330146,32,1,0,0,2
2330145,2330324,179,0,0,1,1
2330147,2330325,178,0,0,1,2
2330325,2330339,14,1,0,0,1
2330326,2330349,23,1,0,0,2
2330340,2330512,172,0,0,1,1
2330350,2330512,162,0,0,1,2
2330513,2330556,43,1,0,0,2
2330513,2330558,45,1,0,0,1
2330557,2331169,612,0,0,1,2
2330559,2331169,610,0,0,1,1
2331170,2331201,31,1,0,0,1
2331170,2331202,32,1,0,0,2
2331202,2333876,2674,0,0,1,1
2331203,2333877,2674,0,0,1,2
2333877,2333944,67,1,0,0,1
2333878,2333941,63,1,0,0,2
2333942,2334048,106,0,0,1,2
2333945,2334047,102,0,0,1,1
2334048,2334081,33,1,0,0,1
2334049,2334084,35,1,0,0,2
2334082,2334369,287,0,0,1,1
2334085,2334370,285,0,0,1,2
2334370,2334397,27,1,0,0,1
2334371,2334397,26,1,0,0,2
2334398,2334982,584,0,0,1,1
2334398,2334982,584,0,0,1,2
2334983,2334994,11,1,0,0,1
2334983,2334998,15,1,0,0,2
2334995,2335692,697,0,0,1,1
2334999,2335692,693,0,0,1,2
2335693,2335753,60,1,0,0,1
2335693,2335762,69,1,0,0,2
2335754,2336180,426,0,0,1,1
2335763,2336181,418,0,0,1,2
2336181,2336216,35,1,0,0,1
2336182,2336219,37,1,0,0,2
2336217,2337533,1316,0,0,1,1
2336220,2337533,1313,0,0,1,2
2337534,2337558,24,1,0,0,1
2337534,2337565,31,1,0,0,2
2337559,2337767,208,0,0,1,1
2337566,2337768,202,0,0,1,2
2337768,2337802,34,1,0,0,1
2337769,2337804,35,1,0,0,2
2337803,2339463,1660,0,0,1,1
2337805,2339462,1657,0,0,1,2
2339463,2339590,127,1,0,0,2
2339464,2339590,126,1,0,0,1
2339591,2339695,104,0,0,1,2
2339591,2339696,105,0,0,1,1
2339696,2339733,37,1,0,0,2
2339697,2339747,50,1,0,0,1
2339734,2340178,444,0,0,1,2
2339748,2340174,426,0,0,1,1
2340175,2340202,27,1,0,0,1
2340179,2340202,23,1,0,0,2
2340203,2340610,407,0,0,1,2
2340203,2340613,410,0,0,1,1
2340611,2340655,44,1,0,0,2
2340614,2340664,50,1,0,0,1
2340656,2341111,455,0,0,1,2
2340665,2341111,446,0,0,1,1
2341112,2341132,20,1,0,0,1
2341112,2341138,26,1,0,0,2
2341133,2341612,479,0,0,1,1
2341139,2341615,476,0,0,1,2
2341613,2341647,34,1,0,0,1
2341616,2341644,28,1,0,0,2
2341645,2342674,1029,0,0,1,2
2341648,2342673,1025,0,0,1,1
2342674,2342735,61,1,0,0,1
2342675,2342736,61,1,0,0,2
2342736,2342916,180,0,0,1,1
2342737,2342957,220,0,0,1,2
2342917,2342933,16,1,0,0,1
2342934,2342957,23,0,0,1,1
2342958,2342998,40,1,0,0,2
2342958,2343011,53,1,0,0,1
2342999,2343119,120,0,0,1,2
2343012,2343123,111,0,0,1,1
2343120,2343160,40,1,0,0,2
2343124,2343146,22,1,0,0,1
2343147,2343943,796,0,0,1,1
2343161,2343942,781,0,0,1,2
2343943,2344014,71,1,0,0,2
2343944,2344220,276,1,0,0,1
2344015,2344122,107,0,0,1,2
2344123,2344156,33,1,0,0,2
2344157,2344301,144,0,0,1,2
2344221,2344311,90,0,0,1,1
2344302,2344318,16,1,0,0,2
2344312,2344316,4,1,0,0,1
2344317,2344544,227,0,0,1,1
2344319,2345030,711,0,0,1,2
2344545,2344560,15,1,0,0,1
2344561,2345031,470,0,0,1,1
2345031,2345052,21,1,0,0,2
2345032,2345081,49,1,0,0,1
2345053,2345837,784,0,0,1,2
2345082,2345529,447,0,0,1,1
2345530,2345901,371,1,0,0,1
2345838,2345906,68,1,0,0,2
2345902,2346235,333,0,0,1,1
2345907,2346236,329,0,0,1,2
2346236,2346290,54,1,0,0,1
2346237,2346289,52,1,0,0,2
2346290,2349894,3604,0,0,1,2
2346291,2349894,3603,0,0,1,1
2349895,2349949,54,1,0,0,2
2349895,2349952,57,1,0,0,1
2349950,2351212,1262,0,0,1,2
2349953,2351214,1261,0,0,1,1
2351213,2351227,14,1,0,0,2
2351215,2351221,6,1,0,0,1
2351222,2351772,550,0,0,1,1
2351228,2351772,544,0,0,1,2
2351773,2351818,45,1,0,0,2
2351773,2351833,60,1,0,0,1
2351819,2354150,2331,0,0,1,2
2351834,2354151,2317,0,0,1,1
2354151,2354211,60,1,0,0,2
2354152,2354212,60,1,0,0,1
2354212,2355818,1606,0,0,1,2
2354213,2355818,1605,0,0,1,1
2355819,2355853,34,1,0,0,1
2355819,2355853,34,1,0,0,2
2355854,2357123,1269,0,0,1,1
2355854,2357123,1269,0,0,1,2
2357124,2357174,50,1,0,0,1
2357124,2357176,52,1,0,0,2
2357175,2357283,108,0,0,1,1
2357177,2357285,108,0,0,1,2
2357284,2357309,25,1,0,0,1
2357286,2357316,30,1,0,0,2
2357310,2357728,418,0,0,1,1
2357317,2357731,414,0,0,1,2
2357729,2357755,26,1,0,0,1
2357732,2357762,30,1,0,0,2
2357756,2358305,549,0,0,1,1
2357763,2358116,353,0,0,1,2
2358117,2358144,27,1,0,0,2
2358145,2358305,160,0,0,1,2
2358306,2358337,31,1,0,0,1
2358306,2358337,31,1,0,0,2
2358338,2358830,492,0,0,1,2
2358338,2358832,494,0,0,1,1
2358831,2358868,37,1,0,0,2
2358833,2358867,34,1,0,0,1
2358868,2359611,743,0,0,1,1
2358869,2359611,742,0,0,1,2
2359612,2359991,379,1,0,0,2
2359612,2360001,389,1,0,0,1
2359726,2359923,197,0,1,0,1
2359736,2359888,152,0,1,0,2
2359992,2360827,835,0,0,1,2
2360002,2360827,825,0,0,1,1
2360828,2360900,72,1,0,0,1
2360828,2360909,81,1,0,0,2
2360901,2361014,113,0,0,1,1
2360910,2361014,104,0,0,1,2
2361015,2361055,40,1,0,0,1
2361015,2361057,42,1,0,0,2
2361056,2361665,609,0,0,1,1
2361058,2361666,608,0,0,1,2
2361666,2361700,34,1,0,0,1
2361667,2361713,46,1,0,0,2
2361701,2362117,416,0,0,1,1
2361714,2362118,404,0,0,1,2
2362118,2362166,48,1,0,0,1
2362119,2362198,79,1,0,0,2
2362167,2362411,244,0,0,1,1
2362199,2362411,212,0,0,1,2
2362412,2362444,32,1,0,0,1
2362412,2362445,33,1,0,0,2
2362445,2363096,651,0,0,1,1
2362446,2363095,649,0,0,1,2
2363096,2363141,45,1,0,0,2
2363097,2363132,35,1,0,0,1
2363133,2363599,466,0,0,1,1
2363142,2363597,455,0,0,1,2
2363598,2363637,39,1,0,0,2
2363600,2363637,37,1,0,0,1
2363638,2364271,633,0,0,1,1
2363638,2364271,633,0,0,1,2
2364272,2364338,66,1,0,0,1
2364272,2364341,69,1,0,0,2
2364339,2364587,248,0,0,1,1
2364342,2364586,244,0,0,1,2
2364587,2364647,60,1,0,0,2
2364588,2364637,49,1,0,0,1
2364638,2364907,269,0,0,1,1
2364648,2364907,259,0,0,1,2
2364908,2364937,29,1,0,0,2
2364908,2364957,49,1,0,0,1
2364938,2365171,233,0,0,1,2
2364958,2365171,213,0,0,1,1
2365172,2365211,39,1,0,0,1
2365172,2365220,48,1,0,0,2
2365212,2365660,448,0,0,1,1
2365221,2365662,441,0,0,1,2
2365661,2365726,65,1,0,0,1
2365663,2365769,106,1,0,0,2
2365727,2365818,91,0,0,1,1
2365770,2365816,46,0,0,1,2
2365817,2365866,49,1,0,0,2
2365819,2365852,33,1,0,0,1
2365853,2365998,145,0,0,1,1
2365867,2365995,128,0,0,1,2
2365996,2366012,16,1,0,0,2
2365999,2366010,11,1,0,0,1
2366011,2366959,948,0,0,1,1
2366013,2366958,945,0,0,1,2
2366959,2366998,39,1,0,0,2
2366960,2366997,37,1,0,0,1
2366998,2367194,196,0,0,1,1
2366999,2367082,83,0,0,1,2
2367083,2367115,32,1,0,0,2
2367116,2367194,78,0,0,1,2
2367195,2367234,39,1,0,0,1
2367195,2367246,51,1,0,0,2
2367235,2367701,466,0,0,1,1
2367247,2367702,455,0,0,1,2
2367702,2367737,35,1,0,0,1
2367703,2367745,42,1,0,0,2
2367738,2368040,302,0,0,1,1
2367746,2367972,226,0,0,1,2
2367973,2368097,124,1,0,0,2
2368041,2368073,32,1,0,0,1
2368074,2369126,1052,0,0,1,1
2368098,2368812,714,0,0,1,2
2368813,2368826,13,1,0,0,2
2368827,2369125,298,0,0,1,2
2369126,2369193,67,1,0,0,2
2369127,2369212,85,1,0,0,1
2369194,2369586,392,0,0,1,2
2369213,2369586,373,0,0,1,1
2369587,2369621,34,1,0,0,2
2369587,2369636,49,1,0,0,1
2369622,2370309,687,0,0,1,2
2369637,2370308,671,0,0,1,1
2370309,2370341,32,1,0,0,1
2370310,2370348,38,1,0,0,2
2370342,2370443,101,0,0,1,1
2370349,2370444,95,0,0,1,2
2370444,2370503,59,1,0,0,1
2370445,2370517,72,1,0,0,2
2370504,2370606,102,0,0,1,1
2370518,2370607,89,0,0,1,2
2370607,2370633,26,1,0,0,1
2370608,2370646,38,1,0,0,2
2370634,2371544,910,0,0,1,1
2370647,2371544,897,0,0,1,2
2371545,2371615,70,1,0,0,1
2371545,2371616,71,1,0,0,2
2371616,2371782,166,0,0,1,1
2371617,2371782,165,0,0,1,2
2371783,2371818,35,1,0,0,1
2371783,2371818,35,1,0,0,2
2371819,2372168,349,0,0,1,1
2371819,2372169,350,0,0,1,2
2372169,2372202,33,1,0,0,1
2372170,2372202,32,1,0,0,2
2372203,2373672,1469,0,0,1,1
2372203,2373672,1469,0,0,1,2
2373673,2373732,59,1,0,0,2
2373673,2373733,60,1,0,0,1
2373733,2373961,228,0,0,1,2
2373734,2373961,227,0,0,1,1
2373962,2374021,59,1,0,0,1
2373962,2374026,64,1,0,0,2
2374022,2374448,426,0,0,1,1
2374027,2374449,422,0,0,1,2
2374449,2374526,77,1,0,0,1
2374450,2374529,79,1,0,0,2
2374527,2374839,312,0,0,1,1
2374530,2374841,311,0,0,1,2
2374840,2374910,70,1,0,0,1
2374842,2374920,78,1,0,0,2
2374911,2375024,113,0,0,1,1
2374921,2375024,103,0,0,1,2
2375025,2375056,31,1,0,0,1
2375025,2375056,31,1,0,0,2
2375057,2375427,370,0,0,1,1
2375057,2375474,417,0,0,1,2
2375428,2375432,4,1,0,0,1
2375433,2375474,41,0,0,1,1
2375475,2375505,30,1,0,0,1
2375475,2375511,36,1,0,0,2
2375506,2375840,334,0,0,1,1
2375512,2375712,200,0,0,1,2
2375713,2375731,18,1,0,0,2
2375732,2375755,23,0,0,1,2
2375756,2375777,21,1,0,0,2
2375778,2375838,60,0,0,1,2
2375839,2375892,53,1,0,0,2
2375841,2375846,5,1,0,0,1
2375847,2377351,1504,0,0,1,1
2375893,2375933,40,0,0,1,2
2375934,2375960,26,1,0,0,2
2375961,2376004,43,0,0,1,2
2376005,2376020,15,1,0,0,2
2376021,2376065,44,0,0,1,2
2376066,2376412,346,1,0,0,2
2376413,2376586,173,0,0,1,2
2376587,2376619,32,1,0,0,2
2376620,2376776,156,0,0,1,2
2376777,2376814,37,1,0,0,2
2376815,2377058,243,0,0,1,2
2377059,2377067,8,1,0,0,2
2377068,2377190,122,0,0,1,2
2377191,2377255,64,1,0,0,2
2377256,2377301,45,0,0,1,2
2377302,2377407,105,1,0,0,2
2377352,2377397,45,1,0,0,1
2377398,2377592,194,0,0,1,1
2377408,2377592,184,0,0,1,2
2377593,2377620,27,1,0,0,1
2377593,2377623,30,1,0,0,2
2377621,2379504,1883,0,0,1,1
2377624,2378114,490,0,0,1,2
2378115,2378174,59,1,0,0,2
2378175,2378618,443,0,0,1,2
2378619,2378754,135,1,0,0,2
2378755,2379062,307,0,0,1,2
2379063,2379084,21,1,0,0,2
2379085,2379501,416,0,0,1,2
2379502,2379605,103,1,0,0,2
2379505,2379605,100,1,0,0,1
2379606,2379639,33,0,0,1,1
2379606,2379766,160,0,0,1,2
2379640,2379647,7,1,0,0,1
2379648,2379766,118,0,0,1,1
2379767,2379792,25,1,0,0,2
2379767,2379794,27,1,0,0,1
2379793,2380191,398,0,0,1,2
2379795,2380191,396,0,0,1,1
2380192,2380225,33,1,0,0,2
2380192,2380228,36,1,0,0,1
2380226,2381530,1304,0,0,1,2
2380229,2381530,1301,0,0,1,1
2381531,2381586,55,1,0,0,1
2381531,2381617,86,1,0,0,2
2381587,2381686,99,0,0,1,1
2381618,2381686,68,0,0,1,2
2381687,2381719,32,1,0,0,1
2381687,2381720,33,1,0,0,2
2381720,2381905,185,0,0,1,1
2381721,2381900,179,0,0,1,2
2381901,2381946,45,1,0,0,2
2381906,2381935,29,1,0,0,1
2381936,2382102,166,0,0,1,1
2381947,2382070,123,0,0,1,2
2382071,2382189,118,1,0,0,2
2382103,2382116,13,1,0,0,1
2382117,2382561,444,0,0,1,1
2382190,2382329,139,0,0,1,2
2382330,2382395,65,1,0,0,2
2382396,2382433,37,0,0,1,2
2382434,2382890,456,1,0,0,2
2382562,2382625,63,1,0,0,1
2382626,2382822,196,0,0,1,1
2382823,2382887,64,1,0,0,1
2382888,2383752,864,0,0,1,1
2382891,2383753,862,0,0,1,2
2383753,2383789,36,1,0,0,1
2383754,2383784,30,1,0,0,2
2383785,2384798,1013,0,0,1,2
2383790,2384797,1007,0,0,1,1
2384798,2384853,55,1,0,0,1
2384799,2384865,66,1,0,0,2
2384854,2385089,235,0,0,1,1
2384866,2385089,223,0,0,1,2
2385090,2385127,37,1,0,0,2
2385090,2385139,49,1,0,0,1
2385128,2385456,328,0,0,1,2
2385140,2385456,316,0,0,1,1
2385457,2385488,31,1,0,0,1
2385457,2385494,37,1,0,0,2
2385489,2386073,584,0,0,1,1
2385495,2386075,580,0,0,1,2
2386074,2386137,63,1,0,0,1
2386076,2386136,60,1,0,0,2
2386137,2386246,109,0,0,1,2
2386138,2386243,105,0,0,1,1
2386244,2386278,34,1,0,0,1
2386247,2386285,38,1,0,0,2
2386279,2386462,183,0,0,1,1
2386286,2386463,177,0,0,1,2
2386463,2386553,90,1,0,0,1
2386464,2386496,32,1,0,0,2
2386497,2387008,511,0,0,1,2
2386554,2386765,211,0,0,1,1
2386766,2386821,55,1,0,0,1
2386822,2386994,172,0,0,1,1
2386995,2387021,26,1,0,0,1
2387009,2387020,11,1,0,0,2
2387021,2387656,635,0,0,1,2
2387022,2387656,634,0,0,1,1
2387657,2387711,54,1,0,0,1
2387657,2387712,55,1,0,0,2
2387712,2389758,2046,0,0,1,1
2387713,2389758,2045,0,0,1,2
2389759,2389798,39,1,0,0,2
2389759,2389799,40,1,0,0,1
2389799,2389971,172,0,0,1,2
2389800,2389970,170,0,0,1,1
2389971,2390003,32,1,0,0,1
2389972,2390004,32,1,0,0,2
2390004,2391490,1486,0,0,1,1
2390005,2391489,1484,0,0,1,2
2391490,2391553,63,1,0,0,2
2391491,2391564,73,1,0,0,1
2391554,2392728,1174,0,0,1,2
2391565,2392164,599,0,0,1,1
2392165,2392189,24,1,0,0,1
2392190,2392728,538,0,0,1,1
2392729,2392760,31,1,0,0,1
2392729,2392760,31,1,0,0,2
2392761,2393411,650,0,0,1,1
2392761,2393412,651,0,0,1,2
2393412,2393464,52,1,0,0,1
2393413,2393472,59,1,0,0,2
2393465,2395823,2358,0,0,1,1
2393473,2394453,980,0,0,1,2
2394454,2394458,4,1,0,0,2
2394459,2394510,51,0,0,1,2
2394511,2394515,4,1,0,0,2
2394516,2394639,123,0,0,1,2
2394640,2394657,17,1,0,0,2
2394658,2394958,300,0,0,1,2
2394959,2394984,25,1,0,0,2
2394985,2395114,129,0,0,1,2
2395115,2395119,4,1,0,0,2
2395120,2395408,288,0,0,1,2
2395409,2395465,56,1,0,0,2
2395466,2395823,357,0,0,1,2
2395824,2395868,44,1,0,0,1
2395824,2395883,59,1,0,0,2
2395869,2396450,581,0,0,1,1
2395884,2396449,565,0,0,1,2
2396450,2396495,45,1,0,0,2
2396451,2396504,53,1,0,0,1
2396496,2397250,754,0,0,1,2
2396505,2397250,745,0,0,1,1
2397251,2397321,70,1,0,0,1
2397251,2397325,74,1,0,0,2
2397322,2398768,1446,0,0,1,1
2397326,2398381,1055,0,0,1,2
2398382,2398421,39,1,0,0,2
2398422,2398611,189,0,0,1,2
2398612,2398616,4,1,0,0,2
2398617,2398767,150,0,0,1,2
2398768,2398834,66,1,0,0,2
2398769,2398834,65,1,0,0,1
2398835,2398941,106,0,0,1,1
2398835,2398943,108,0,0,1,2
2398942,2398979,37,1,0,0,1
2398944,2398982,38,1,0,0,2
2398980,2401023,2043,0,0,1,1
2398983,2401022,2039,0,0,1,2
2401023,2401069,46,1,0,0,2
2401024,2401076,52,1,0,0,1
2401070,2402626,1556,0,0,1,2
2401077,2402627,1550,0,0,1,1
2402627,2402694,67,1,0,0,2
2402628,2402702,74,1,0,0,1
2402695,2402805,110,0,0,1,2
2402703,2402804,101,0,0,1,1
2402805,2402840,35,1,0,0,1
2402806,2402838,32,1,0,0,2
2402839,2403666,827,0,0,1,2
2402841,2403665,824,0,0,1,1
2403666,2403724,58,1,0,0,1
2403667,2403735,68,1,0,0,2
2403725,2403895,170,0,0,1,1
2403736,2403897,161,0,0,1,2
2403896,2403928,32,1,0,0,1
2403898,2403928,30,1,0,0,2
2403929,2406247,2318,0,0,1,1
2403929,2406247,2318,0,0,1,2
2406248,2406286,38,1,0,0,1
2406248,2406290,42,1,0,0,2
2406287,2407047,760,0,0,1,1
2406291,2407046,755,0,0,1,2
2407047,2407140,93,1,0,0,2
2407048,2407122,74,1,0,0,1
2407123,2407223,100,0,0,1,1
2407141,2407224,83,0,0,1,2
2407224,2407259,35,1,0,0,1
2407225,2407261,36,1,0,0,2
2407260,2407908,648,0,0,1,1
2407262,2407903,641,0,0,1,2
2407904,2407934,30,1,0,0,2
2407909,2407931,22,1,0,0,1
2407932,2408096,164,0,0,1,1
2407935,2408096,161,0,0,1,2
2408097,2408157,60,1,0,0,1
2408097,2408170,73,1,0,0,2
2408158,2408260,102,0,0,1,1
2408171,2408262,91,0,0,1,2
2408261,2408294,33,1,0,0,1
2408263,2408288,25,1,0,0,2
2408289,2408830,541,0,0,1,2
2408295,2408830,535,0,0,1,1
2408831,2408862,31,1,0,0,1
2408831,2408865,34,1,0,0,2
2408863,2410738,1875,0,0,1,1
2408866,2410012,1146,0,0,1,2
2410013,2410033,20,1,0,0,2
2410034,2410737,703,0,0,1,2
2410738,2410814,76,1,0,0,2
2410739,2410815,76,1,0,0,1
2410815,2411456,641,0,0,1,2
2410816,2411454,638,0,0,1,1
2411455,2411520,65,1,0,0,1
2411457,2411524,67,1,0,0,2
2411521,2411622,101,0,0,1,1
2411525,2411624,99,0,0,1,2
2411623,2411645,22,1,0,0,1
2411625,2411659,34,1,0,0,2
2411646,2411850,204,0,0,1,1
2411660,2411850,190,0,0,1,2
2411851,2411882,31,1,0,0,1
2411851,2411885,34,1,0,0,2
2411883,2412998,1115,0,0,1,1
2411886,2412997,1111,0,0,1,2
2412998,2413049,51,1,0,0,2
2412999,2413052,53,1,0,0,1
2413050,2416230,3180,0,0,1,2
2413053,2416232,3179,0,0,1,1
2416231,2416305,74,1,0,0,2
2416233,2416300,67,1,0,0,1
2416301,2416691,390,0,0,1,1
2416306,2416690,384,0,0,1,2
2416691,2416742,51,1,0,0,2
2416692,2416743,51,1,0,0,1
2416743,2416854,111,0,0,1,2
2416744,2416854,110,0,0,1,1
2416855,2416886,31,1,0,0,2
2416855,2416894,39,1,0,0,1
2416887,2417010,123,0,0,1,2
2416895,2417011,116,0,0,1,1
2417011,2417043,32,1,0,0,2
2417012,2417042,30,1,0,0,1
2417043,2417133,90,0,0,1,1
2417044,2417133,89,0,0,1,2
2417134,2417187,53,1,0,0,2
2417134,2417191,57,1,0,0,1
2417188,2417399,211,0,0,1,2
2417192,2417393,201,0,0,1,1
2417394,2428487,11093,1,0,0,1
2417400,2417774,374,1,0,0,2
2417572,2417701,129,0,1,0,1
2417775,2417853,78,0,0,1,2
2417854,2428170,10316,1,0,0,2
2417925,2428152,10227,0,1,0,2
2417939,2428205,10266,0,1,0,1
2428171,2428215,44,0,0,1,2
2428216,2428268,52,1,0,0,2
2428269,2428291,22,0,0,1,2
2428292,2428430,138,1,0,0,2
2428335,2428352,17,0,1,0,1
2428431,2428517,86,0,0,1,2
2428488,2428775,287,0,0,1,1
2428518,2428531,13,1,0,0,2
2428532,2428774,242,0,0,1,2
2428775,2428803,28,1,0,0,2
2428776,2428826,50,1,0,0,1
2428804,2429252,448,0,0,1,2
2428827,2429252,425,0,0,1,1
2429253,2429280,27,1,0,0,1
2429253,2429288,35,1,0,0,2
2429281,2429577,296,0,0,1,1
2429289,2429577,288,0,0,1,2
2471472,2471895,423,0,0,1,1
2471472,2471895,423,0,0,1,2
2471896,2471965,69,1,0,0,1
2471896,2471976,80,1,0,0,2
2471966,2472074,108,0,0,1,1
2471977,2472067,90,0,0,1,2
2472068,2472155,87,1,0,0,2
2472075,2472111,36,1,0,0,1
2472112,2472428,316,0,0,1,1
2472156,2472421,265,0,0,1,2
2472422,2472443,21,1,0,0,2
2472429,2472433,4,1,0,0,1
2472434,2472708,274,0,0,1,1
2472444,2472477,33,0,0,1,2
2472478,2472482,4,1,0,0,2
2472483,2472705,222,0,0,1,2
2472706,2472731,25,1,0,0,2
2472709,2472733,24,1,0,0,1
2472732,2473349,617,0,0,1,2
2472734,2474006,1272,0,0,1,1
2473350,2473374,24,1,0,0,2
2473375,2474007,632,0,0,1,2
2474007,2474118,111,1,0,0,1
2474008,2474122,114,1,0,0,2
2474119,2474182,63,0,0,1,1
2474123,2474182,59,0,0,1,2
2474183,2474231,48,1,0,0,1
2474183,2474231,48,1,0,0,2
2474232,2474414,182,0,0,1,2
2474232,2474419,187,0,0,1,1
2474415,2474439,24,1,0,0,2
2474420,2474438,18,1,0,0,1
2474439,2475956,1517,0,0,1,1
2474440,2475954,1514,0,0,1,2
2475955,2476044,89,1,0,0,2
2475957,2476044,87,1,0,0,1
2476045,2476136,91,0,0,1,1
2476045,2476137,92,0,0,1,2
2476137,2476175,38,1,0,0,1
2476138,2476179,41,1,0,0,2
2476176,2477224,1048,0,0,1,1
2476180,2477224,1044,0,0,1,2
2477225,2477296,71,1,0,0,2
2477225,2477299,74,1,0,0,1
2477297,2477568,271,0,0,1,2
2477300,2477567,267,0,0,1,1
2477568,2477613,45,1,0,0,1
2477569,2477619,50,1,0,0,2
2477614,2477735,121,0,0,1,1
2477620,2477736,116,0,0,1,2
2477736,2477756,20,1,0,0,1
2477737,2477766,29,1,0,0,2
2477757,2478022,265,0,0,1,1
2477767,2478023,256,0,0,1,2
2478023,2478050,27,1,0,0,1
2478024,2478052,28,1,0,0,2
2478051,2479254,1203,0,0,1,1
2478053,2479255,1202,0,0,1,2
2479255,2479302,47,1,0,0,1
2479256,2479304,48,1,0,0,2
2479303,2479458,155,0,0,1,1
2479305,2479456,151,0,0,1,2
2479457,2479542,85,1,0,0,2
2479459,2479487,28,1,0,0,1
2479488,2479726,238,0,0,1,1
2479543,2479727,184,0,0,1,2
2479727,2479757,30,1,0,0,1
2479728,2479757,29,1,0,0,2
2479758,2480206,448,0,0,1,2
2479758,2480713,955,0,0,1,1
2480207,2480784,577,1,0,0,2
2480714,2480774,60,1,0,0,1
2480775,2480990,215,0,0,1,1
2480785,2480991,206,0,0,1,2
2480991,2481075,84,1,0,0,1
2480992,2481084,92,1,0,0,2
2481076,2481169,93,0,0,1,1
2481085,2481169,84,0,0,1,2
2481170,2481197,27,1,0,0,1
2481170,2481208,38,1,0,0,2
2481198,2481497,299,0,0,1,1
2481209,2481496,287,0,0,1,2
2481497,2481514,17,1,0,0,2
2481498,2481507,9,1,0,0,1
2481508,2482292,784,0,0,1,1
2481515,2482294,779,0,0,1,2
2482293,2482358,65,1,0,0,1
2482295,2482358,63,1,0,0,2
2482359,2482597,238,0,0,1,1
2482359,2482597,238,0,0,1,2
2482598,2482680,82,1,0,0,1
2482598,2482681,83,1,0,0,2
2482681,2482749,68,0,0,1,1
2482682,2482748,66,0,0,1,2
2482749,2482798,49,1,0,0,2
2482750,2482785,35,1,0,0,1
2482786,2482923,137,0,0,1,1
2482799,2483915,1116,0,0,1,2
2482924,2482936,12,1,0,0,1
2482937,2483916,979,0,0,1,1
2483916,2484013,97,1,0,0,2
2483917,2484012,95,1,0,0,1
2484013,2484340,327,0,0,1,1
2484014,2484340,326,0,0,1,2
2484341,2484411,70,1,0,0,2
2484341,2484423,82,1,0,0,1
2484412,2484517,105,0,0,1,2
2484424,2484516,92,0,0,1,1
2484517,2484542,25,1,0,0,1
2484518,2484558,40,1,0,0,2
2484543,2485620,1077,0,0,1,1
2484559,2485621,1062,0,0,1,2
2485621,2485702,81,1,0,0,1
2485622,2485713,91,1,0,0,2
2485703,2485898,195,0,0,1,1
2485714,2485954,240,0,0,1,2
2485899,2485919,20,1,0,0,1
2485920,2486006,86,0,0,1,1
2485955,2486082,127,1,0,0,2
2486007,2486082,75,1,0,0,1
2486083,2486166,83,0,0,1,1
2486083,2486167,84,0,0,1,2
2486167,2486210,43,1,0,0,1
2486168,2486210,42,1,0,0,2
2486211,2486397,186,0,0,1,2
2486211,2486400,189,0,0,1,1
2486398,2486426,28,1,0,0,2
2486401,2486463,62,1,0,0,1
2486427,2487365,938,0,0,1,2
2486464,2487365,901,0,0,1,1
2487366,2487422,56,1,0,0,1
2487366,2487425,59,1,0,0,2
2487423,2487639,216,0,0,1,1
2487426,2487640,214,0,0,1,2
2487640,2487743,103,1,0,0,1
2487641,2487739,98,1,0,0,2
2487740,2487844,104,0,0,1,2
2487744,2487844,100,0,0,1,1
2487845,2487878,33,1,0,0,2
2487845,2487884,39,1,0,0,1
2487879,2488864,985,0,0,1,2
2487885,2488864,979,0,0,1,1
2488865,2488939,74,1,0,0,1
2488865,2488948,83,1,0,0,2
2488940,2489211,271,0,0,1,1
2488949,2489212,263,0,0,1,2
2489212,2489285,73,1,0,0,1
2489213,2489295,82,1,0,0,2
2489286,2490387,1101,0,0,1,1
2489296,2490388,1092,0,0,1,2
2490388,2490461,73,1,0,0,1
2490389,2490459,70,1,0,0,2
2490460,2490796,336,0,0,1,2
2490462,2490796,334,0,0,1,1
2490797,2490865,68,1,0,0,1
2490797,2490898,101,1,0,0,2
2490866,2490995,129,0,0,1,1
2490899,2490994,95,0,0,1,2
2490995,2491026,31,1,0,0,2
2490996,2491025,29,1,0,0,1
2491026,2491971,945,0,0,1,1
2491027,2491162,135,0,0,1,2
2491163,2491177,14,1,0,0,2
2491178,2491970,792,0,0,1,2
2491971,2492061,90,1,0,0,2
2491972,2492053,81,1,0,0,1
2492054,2492234,180,0,0,1,1
2492062,2492234,172,0,0,1,2
2492235,2492278,43,1,0,0,2
2492235,2492310,75,1,0,0,1
2492279,2492392,113,0,0,1,2
2492311,2492394,83,0,0,1,1
2492393,2492417,24,1,0,0,2
2492395,2492414,19,1,0,0,1
2492415,2492682,267,0,0,1,1
2492418,2492676,258,0,0,1,2
2492677,2492710,33,1,0,0,2
2492683,2492703,20,1,0,0,1
2492704,2492817,113,0,0,1,1
2492711,2492813,102,0,0,1,2
2492814,2492844,30,1,0,0,2
2492818,2492843,25,1,0,0,1
2492844,2493407,563,0,0,1,1
2492845,2493407,562,0,0,1,2
2493408,2493450,42,1,0,0,1
2493408,2493451,43,1,0,0,2
2493451,2493589,138,0,0,1,1
2493452,2493587,135,0,0,1,2
2493588,2493645,57,1,0,0,2
2493590,2493633,43,1,0,0,1
2493634,2493733,99,0,0,1,1
2493646,2493736,90,0,0,1,2
2493734,2493762,28,1,0,0,1
2493737,2493760,23,1,0,0,2
2493761,2494089,328,0,0,1,2
2493763,2494087,324,0,0,1,1
2494088,2494103,15,1,0,0,1
2494090,2494105,15,1,0,0,2
2494104,2494477,373,0,0,1,1
2494106,2494470,364,0,0,1,2
2494471,2494487,16,1,0,0,2
2494478,2494493,15,1,0,0,1
2494488,2495098,610,0,0,1,2
2494494,2495098,604,0,0,1,1
2495099,2495154,55,1,0,0,1
2495099,2495164,65,1,0,0,2
2495155,2495271,116,0,0,1,1
2495165,2495270,105,0,0,1,2
2495271,2495336,65,1,0,0,2
2495272,2495361,89,1,0,0,1
2495337,2495425,88,0,0,1,2
2495362,2495425,63,0,0,1,1
2495426,2495463,37,1,0,0,2
2495426,2495469,43,1,0,0,1
2495464,2495634,170,0,0,1,2
2495470,2495634,164,0,0,1,1
2495635,2495663,28,1,0,0,2
2495635,2495684,49,1,0,0,1
2495664,2495987,323,0,0,1,2
2495685,2495978,293,0,0,1,1
2495979,2496010,31,1,0,0,1
2495988,2496010,22,1,0,0,2
2496011,2497149,1138,0,0,1,1
2496011,2497150,1139,0,0,1,2
2497150,2497205,55,1,0,0,1
2497151,2497228,77,1,0,0,2
2497206,2497313,107,0,0,1,1
2497229,2497315,86,0,0,1,2
2497314,2497365,51,1,0,0,1
2497316,2497342,26,1,0,0,2
2497343,2497653,310,0,0,1,2
2497366,2497505,139,0,0,1,1
2497506,2497520,14,1,0,0,1
2497521,2497620,99,0,0,1,1
2497621,2497716,95,1,0,0,1
2497654,2497669,15,1,0,0,2
2497670,2498834,1164,0,0,1,2
2497717,2498835,1118,0,0,1,1
2498835,2498885,50,1,0,0,2
2498836,2498887,51,1,0,0,1
2498886,2498967,81,0,0,1,2
2498888,2498969,81,0,0,1,1
2498968,2499023,55,1,0,0,2
2498970,2499029,59,1,0,0,1
2499024,2499126,102,0,0,1,2
2499030,2499125,95,0,0,1,1
2499126,2499162,36,1,0,0,1
2499127,2499163,36,1,0,0,2
2499163,2499412,249,0,0,1,1
2499164,2499525,361,0,0,1,2
2499413,2499483,70,1,0,0,1
2499484,2499531,47,0,0,1,1
2499526,2499542,16,1,0,0,2
2499532,2499557,25,1,0,0,1
2499543,2500096,553,0,0,1,2
2499558,2500096,538,0,0,1,1
2500097,2500137,40,1,0,0,1
2500097,2500148,51,1,0,0,2
2500138,2500216,78,0,0,1,1
2500149,2500216,67,0,0,1,2
2500217,2500263,46,1,0,0,1
2500217,2500264,47,1,0,0,2
2500264,2500370,106,0,0,1,1
2500265,2500371,106,0,0,1,2
2500371,2500390,19,1,0,0,1
2500372,2500391,19,1,0,0,2
2500391,2500666,275,0,0,1,1
2500392,2500665,273,0,0,1,2
2500666,2500693,27,1,0,0,2
2500667,2500688,21,1,0,0,1
2500689,2501064,375,0,0,1,1
2500694,2501063,369,0,0,1,2
2501064,2501092,28,1,0,0,2
2501065,2501092,27,1,0,0,1
2501093,2501579,486,0,0,1,1
2501093,2501580,487,0,0,1,2
2501580,2501638,58,1,0,0,1
2501581,2501638,57,1,0,0,2
2501639,2501936,297,0,0,1,1
2501639,2501937,298,0,0,1,2
2501937,2501990,53,1,0,0,1
2501938,2501989,51,1,0,0,2
2501990,2502158,168,0,0,1,2
2501991,2502163,172,0,0,1,1
2502159,2502185,26,1,0,0,2
2502164,2502205,41,1,0,0,1
2502186,2502654,468,0,0,1,2
2502206,2502652,446,0,0,1,1
2502653,2502683,30,1,0,0,1
2502655,2502686,31,1,0,0,2
2502684,2502989,305,0,0,1,1
2502687,2502990,303,0,0,1,2
2502990,2503019,29,1,0,0,1
2502991,2503021,30,1,0,0,2
2503020,2503909,889,0,0,1,1
2503022,2503904,882,0,0,1,2
2503905,2503984,79,1,0,0,2
2503910,2504007,97,1,0,0,1
2503985,2504110,125,0,0,1,2
2504008,2504114,106,0,0,1,1
2504111,2504143,32,1,0,0,2
2504115,2504133,18,1,0,0,1
2504134,2505257,1123,0,0,1,1
2504144,2504330,186,0,0,1,2
2504331,2504357,26,1,0,0,2
2504358,2504708,350,0,0,1,2
2504709,2504748,39,1,0,0,2
2504749,2505256,507,0,0,1,2
2505257,2505362,105,1,0,0,2
2505258,2505355,97,1,0,0,1
2505356,2505588,232,0,0,1,1
2505363,2505588,225,0,0,1,2
2505589,2505653,64,1,0,0,2
2505589,2505655,66,1,0,0,1
2505654,2505748,94,0,0,1,2
2505656,2505749,93,0,0,1,1
2505749,2505777,28,1,0,0,2
2505750,2505800,50,1,0,0,1
2505778,2506005,227,0,0,1,2
2505801,2506007,206,0,0,1,1
2506006,2506029,23,1,0,0,2
2506008,2506039,31,1,0,0,1
2506030,2506245,215,0,0,1,2
2506040,2506250,210,0,0,1,1
2506246,2506274,28,1,0,0,2
2506251,2506273,22,1,0,0,1
2506274,2507167,893,0,0,1,1
2506275,2507168,893,0,0,1,2
2507168,2507245,77,1,0,0,1
2507169,2507222,53,1,0,0,2
2507223,2507357,134,0,0,1,2
2507246,2507356,110,0,0,1,1
2507357,2507472,115,1,0,0,1
2507358,2507441,83,1,0,0,2
2507442,2507833,391,0,0,1,2
2507473,2507836,363,0,0,1,1
2507834,2507863,29,1,0,0,2
2507837,2507865,28,1,0,0,1
2507864,2508849,985,0,0,1,2
2507866,2508165,299,0,0,1,1
2508166,2508179,13,1,0,0,1
2508180,2508224,44,0,0,1,1
2508225,2508231,6,1,0,0,1
2508232,2508849,617,0,0,1,1
2508850,2508922,72,1,0,0,1
2508850,2508924,74,1,0,0,2
2508923,2509084,161,0,0,1,1
2508925,2509080,155,0,0,1,2
2509081,2509151,70,1,0,0,2
2509085,2509150,65,1,0,0,1
2509151,2509415,264,0,0,1,1
2509152,2509399,247,0,0,1,2
2509400,2509429,29,1,0,0,2
2509416,2509421,5,1,0,0,1
2509422,2509937,515,0,0,1,1
2509430,2509638,208,0,0,1,2
2509639,2509655,16,1,0,0,2
2509656,2509935,279,0,0,1,2
2509936,2509957,21,1,0,0,2
2509938,2509951,13,1,0,0,1
2509952,2510480,528,0,0,1,1
2509958,2510787,829,0,0,1,2
2510481,2510541,60,1,0,0,1
2510542,2510582,40,0,0,1,1
2510583,2510587,4,1,0,0,1
2510588,2510724,136,0,0,1,1
2510725,2510766,41,1,0,0,1
2510767,2510789,22,0,0,1,1
2510788,2510876,88,1,0,0,2
2510790,2510863,73,1,0,0,1
2510864,2510914,50,0,0,1,1
2510877,2510970,93,0,0,1,2
2510915,2511006,91,1,0,0,1
2510971,2511003,32,1,0,0,2
2511004,2511201,197,0,0,1,2
2511007,2511198,191,0,0,1,1
2511199,2511212,13,1,0,0,1
2511202,2511208,6,1,0,0,2
2511209,2511981,772,0,0,1,2
2511213,2511974,761,0,0,1,1
2511975,2512049,74,1,0,0,1
2511982,2512049,67,1,0,0,2
2512050,2512213,163,0,0,1,1
2512050,2512214,164,0,0,1,2
2512214,2512314,100,1,0,0,1
2512215,2512254,39,1,0,0,2
2512255,2512357,102,0,0,1,2
2512315,2512355,40,0,0,1,1
2512356,2512412,56,1,0,0,1
2512358,2512415,57,1,0,0,2
2512413,2512508,95,0,0,1,1
2512416,2512508,92,0,0,1,2
2512509,2512535,26,1,0,0,1
2512509,2512536,27,1,0,0,2
2512536,2512819,283,0,0,1,1
2512537,2512818,281,0,0,1,2
2512819,2512838,19,1,0,0,2
2512820,2512848,28,1,0,0,1
2512839,2513181,342,0,0,1,2
2512849,2513181,332,0,0,1,1
2513182,2513211,29,1,0,0,1
2513182,2513217,35,1,0,0,2
2513212,2513429,217,0,0,1,1
2513218,2513431,213,0,0,1,2
2513430,2513450,20,1,0,0,1
2513432,2513451,19,1,0,0,2
2513451,2513575,124,0,0,1,1
2513452,2513577,125,0,0,1,2
2513576,2513606,30,1,0,0,1
2513578,2513599,21,1,0,0,2
2513600,2514146,546,0,0,1,2
2513607,2514145,538,0,0,1,1
2514146,2514199,53,1,0,0,1
2514147,2514216,69,1,0,0,2
2514200,2514269,69,0,0,1,1
2514217,2514268,51,0,0,1,2
2514269,2514310,41,1,0,0,2
2514270,2514299,29,1,0,0,1
2514300,2514525,225,0,0,1,1
2514311,2514519,208,0,0,1,2
2514520,2514552,32,1,0,0,2
2514526,2514553,27,1,0,0,1
2514553,2514815,262,0,0,1,2
2514554,2514814,260,0,0,1,1
2514815,2514834,19,1,0,0,1
2514816,2514835,19,1,0,0,2
2514835,2515133,298,0,0,1,1
2514836,2515128,292,0,0,1,2
2515129,2515155,26,1,0,0,2
2515134,2515146,12,1,0,0,1
2515147,2515535,388,0,0,1,1
2515156,2515529,373,0,0,1,2
2515530,2515613,83,1,0,0,2
2515536,2515610,74,1,0,0,1
2515611,2515894,283,0,0,1,1
2515614,2515894,280,0,0,1,2
2515895,2515952,57,1,0,0,1
2515895,2515962,67,1,0,0,2
2515953,2516088,135,0,0,1,1
2515963,2516087,124,0,0,1,2
2516088,2516121,33,1,0,0,2
2516089,2516119,30,1,0,0,1
2516120,2516343,223,0,0,1,1
2516122,2516344,222,0,0,1,2
2516344,2516388,44,1,0,0,1
2516345,2516377,32,1,0,0,2
2516378,2516548,170,0,0,1,2
2516389,2516545,156,0,0,1,1
2516546,2516573,27,1,0,0,1
2516549,2516576,27,1,0,0,2
2516574,2517430,856,0,0,1,1
2516577,2517429,852,0,0,1,2
2517430,2517501,71,1,0,0,2
2517431,2517585,154,1,0,0,1
2517502,2517538,36,0,0,1,2
2517539,2517605,66,1,0,0,2
2517586,2517840,254,0,0,1,1
2517606,2517841,235,0,0,1,2
2517841,2517944,103,1,0,0,1
2517842,2517946,104,1,0,0,2
2517945,2518039,94,0,0,1,1
2517947,2518042,95,0,0,1,2
2518040,2518059,19,1,0,0,1
2518043,2518065,22,1,0,0,2
2518060,2518282,222,0,0,1,1
2518066,2518279,213,0,0,1,2
2518280,2518311,31,1,0,0,2
2518283,2518311,28,1,0,0,1
2518312,2518480,168,0,0,1,2
2518312,2518485,173,0,0,1,1
2518481,2518504,23,1,0,0,2
2518486,2518518,32,1,0,0,1
2518505,2519066,561,0,0,1,2
2518519,2519066,547,0,0,1,1
2519067,2519133,66,1,0,0,1
2519067,2519316,249,1,0,0,2
2519134,2519198,64,0,0,1,1
2519199,2519314,115,1,0,0,1
2519315,2519525,210,0,0,1,1
2519317,2519524,207,0,0,1,2
2519525,2519591,66,1,0,0,2
2519526,2519591,65,1,0,0,1
2519592,2519682,90,0,0,1,1
2519592,2519682,90,0,0,1,2
2519683,2519723,40,1,0,0,2
2519683,2519724,41,1,0,0,1
2519724,2519909,185,0,0,1,2
2519725,2519908,183,0,0,1,1
2519909,2519932,23,1,0,0,1
2519910,2519941,31,1,0,0,2
2519933,2520144,211,0,0,1,1
2519942,2520143,201,0,0,1,2
2520144,2520177,33,1,0,0,2
2520145,2520176,31,1,0,0,1
2520177,2520987,810,0,0,1,1
2520178,2520986,808,0,0,1,2
2520987,2521083,96,1,0,0,2
2520988,2521081,93,1,0,0,1
2521082,2521192,110,0,0,1,1
2521084,2521194,110,0,0,1,2
2521193,2521236,43,1,0,0,1
2521195,2521245,50,1,0,0,2
2521237,2521339,102,0,0,1,1
2521246,2521339,93,0,0,1,2
2521340,2521400,60,1,0,0,1
2521340,2521402,62,1,0,0,2
2521401,2521494,93,0,0,1,1
2521403,2521494,91,0,0,1,2
2521495,2521526,31,1,0,0,1
2521495,2521534,39,1,0,0,2
2521527,2521730,203,0,0,1,1
2521535,2521731,196,0,0,1,2
2521731,2521760,29,1,0,0,1
2521732,2521762,30,1,0,0,2
2521761,2521878,117,0,0,1,1
2521763,2521881,118,0,0,1,2
2521879,2521909,30,1,0,0,1
2521882,2521908,26,1,0,0,2
2521909,2522725,816,0,0,1,2
2521910,2522725,815,0,0,1,1
2522726,2522817,91,1,0,0,1
2522726,2522826,100,1,0,0,2
2522818,2523213,395,0,0,1,1
2522827,2523215,388,0,0,1,2
2523214,2523295,81,1,0,0,1
2523216,2523312,96,1,0,0,2
2523296,2523513,217,0,0,1,1
2523313,2523514,201,0,0,1,2
2523514,2523547,33,1,0,0,1
2523515,2523579,64,1,0,0,2
2523548,2523657,109,0,0,1,1
2523580,2523606,26,0,0,1,2
2523607,2523620,13,1,0,0,2
2523621,2523657,36,0,0,1,2
2523658,2523688,30,1,0,0,1
2523658,2523693,35,1,0,0,2
2523689,2523928,239,0,0,1,1
2523694,2523927,233,0,0,1,2
2523928,2523975,47,1,0,0,2
2523929,2523944,15,1,0,0,1
2523945,2524960,1015,0,0,1,1
2523976,2524393,417,0,0,1,2
2524394,2524419,25,1,0,0,2
2524420,2524954,534,0,0,1,2
2524955,2525032,77,1,0,0,2
2524961,2525019,58,1,0,0,1
2525020,2525141,121,0,0,1,1
2525033,2525138,105,0,0,1,2
2525139,2525187,48,1,0,0,2
2525142,2525168,26,1,0,0,1
2525169,2526057,888,0,0,1,1
2525188,2526058,870,0,0,1,2
2526058,2526192,134,1,0,0,1
2526059,2526177,118,1,0,0,2
2526178,2526365,187,0,0,1,2
2526193,2526364,171,0,0,1,1
2526365,2526414,49,1,0,0,1
2526366,2526413,47,1,0,0,2
2526414,2526961,547,0,0,1,2
2526415,2526960,545,0,0,1,1
2526961,2526995,34,1,0,0,1
2526962,2526990,28,1,0,0,2
2526991,2527691,700,0,0,1,2
2526996,2527693,697,0,0,1,1
2527692,2527739,47,1,0,0,2
2527694,2527755,61,1,0,0,1
2527740,2528097,357,0,0,1,2
2527756,2528097,341,0,0,1,1
2528098,2528158,60,1,0,0,2
2528098,2528165,67,1,0,0,1
2528159,2528240,81,0,0,1,2
2528166,2528241,75,0,0,1,1
2528241,2528276,35,1,0,0,2
2528242,2528275,33,1,0,0,1
2528276,2528586,310,0,0,1,1
2528277,2528584,307,0,0,1,2
2528585,2528615,30,1,0,0,2
2528587,2528614,27,1,0,0,1
2528615,2529208,593,0,0,1,1
2528616,2529381,765,0,0,1,2
2529209,2529213,4,1,0,0,1
2529214,2529381,167,0,0,1,1
2529382,2529440,58,1,0,0,1
2529382,2529451,69,1,0,0,2
2529441,2529805,364,0,0,1,1
2529452,2529806,354,0,0,1,2
2529806,2529870,64,1,0,0,1
2529807,2529871,64,1,0,0,2
2529871,2529964,93,0,0,1,1
2529872,2529963,91,0,0,1,2
2529964,2529993,29,1,0,0,2
2529965,2529994,29,1,0,0,1
2529994,2530448,454,0,0,1,2
2529995,2530457,462,0,0,1,1
2530449,2530480,31,1,0,0,2
2530458,2530476,18,1,0,0,1
2530477,2530675,198,0,0,1,1
2530481,2530672,191,0,0,1,2
2530673,2530702,29,1,0,0,2
2530676,2530701,25,1,0,0,1
2530702,2531055,353,0,0,1,1
2530703,2531207,504,0,0,1,2
2531056,2531072,16,1,0,0,1
2531073,2531205,132,0,0,1,1
2531206,2531300,94,1,0,0,1
2531208,2531239,31,1,0,0,2
2531240,2531894,654,0,0,1,2
2531301,2531893,592,0,0,1,1
2531894,2531997,103,1,0,0,1
2531895,2531997,102,1,0,0,2
2531998,2532314,316,0,0,1,1
2531998,2532314,316,0,0,1,2
2532315,2532364,49,1,0,0,1
2532315,2532373,58,1,0,0,2
2532365,2532463,98,0,0,1,1
2532374,2532465,91,0,0,1,2
2532464,2532490,26,1,0,0,1
2532466,2532490,24,1,0,0,2
2532491,2532942,451,0,0,1,2
2532491,2532943,452,0,0,1,1
2532943,2532971,28,1,0,0,2
2532944,2532971,27,1,0,0,1
2532972,2534208,1236,0,0,1,2
2532972,2534209,1237,0,0,1,1
2534209,2534274,65,1,0,0,2
2534210,2534272,62,1,0,0,1
2534273,2534500,227,0,0,1,1
2534275,2534497,222,0,0,1,2
2534498,2534531,33,1,0,0,2
2534501,2534530,29,1,0,0,1
2534531,2534758,227,0,0,1,1
2534532,2534758,226,0,0,1,2
2534759,2534789,30,1,0,0,1
2534759,2534791,32,1,0,0,2
2534790,2535863,1073,0,0,1,1
2534792,2535864,1072,0,0,1,2
2535864,2535925,61,1,0,0,1
2535865,2535935,70,1,0,0,2
2535926,2536030,104,0,0,1,1
2535936,2536031,95,0,0,1,2
2536031,2536066,35,1,0,0,1
2536032,2536068,36,1,0,0,2
2536067,2536401,334,0,0,1,1
2536069,2536401,332,0,0,1,2
2536402,2536431,29,1,0,0,1
2536402,2536433,31,1,0,0,2
2536432,2537626,1194,0,0,1,1
2536434,2537627,1193,0,0,1,2
2537627,2537720,93,1,0,0,1
2537628,2537723,95,1,0,0,2
2537721,2537818,97,0,0,1,1
2537724,2537818,94,0,0,1,2
2537819,2537847,28,1,0,0,1
2537819,2537857,38,1,0,0,2
2537848,2538207,359,0,0,1,1
2537858,2538208,350,0,0,1,2
2538208,2538236,28,1,0,0,1
2538209,2538237,28,1,0,0,2
2538237,2538379,142,0,0,1,1
2538238,2538376,138,0,0,1,2
2538377,2538406,29,1,0,0,2
2538380,2538403,23,1,0,0,1
2538404,2539139,735,0,0,1,1
2538407,2539139,732,0,0,1,2
2539140,2539208,68,1,0,0,1
2539140,2539215,75,1,0,0,2
2539209,2539328,119,0,0,1,1
2539216,2539328,112,0,0,1,2
2539329,2539414,85,1,0,0,2
2539329,2539417,88,1,0,0,1
2539415,2539450,35,0,0,1,2
2539418,2539451,33,0,0,1,1
2539451,2539536,85,1,0,0,2
2539452,2539544,92,1,0,0,1
2539537,2539656,119,0,0,1,2
2539545,2539655,110,0,0,1,1
2539656,2539688,32,1,0,0,1
2539657,2539680,23,1,0,0,2
2539681,2540731,1050,0,0,1,2
2539689,2539951,262,0,0,1,1
2539952,2540008,56,1,0,0,1
2540009,2540047,38,0,0,1,1
2540048,2540087,39,1,0,0,1
2540088,2540731,643,0,0,1,1
2540732,2540793,61,1,0,0,1
2540732,2540805,73,1,0,0,2
2540794,2541063,269,0,0,1,1
2540806,2541063,257,0,0,1,2
2541064,2541142,78,1,0,0,1
2541064,2541145,81,1,0,0,2
2541143,2541211,68,0,0,1,1
2541146,2541211,65,0,0,1,2
2541212,2541261,49,1,0,0,1
2541212,2541265,53,1,0,0,2
2541262,2541513,251,0,0,1,1
2541266,2541512,246,0,0,1,2
2541513,2541547,34,1,0,0,2
2541514,2541545,31,1,0,0,1
2541546,2542393,847,0,0,1,1
2541548,2542392,844,0,0,1,2
2542393,2542459,66,1,0,0,2
2542394,2542459,65,1,0,0,1
2542460,2542608,148,0,0,1,1
2542460,2542608,148,0,0,1,2
2542609,2542653,44,1,0,0,1
2542609,2542654,45,1,0,0,2
2542654,2542818,164,0,0,1,1
2542655,2542818,163,0,0,1,2
2542819,2542921,102,1,0,0,1
2542819,2542923,104,1,0,0,2
2542922,2543441,519,0,0,1,1
2542924,2543440,516,0,0,1,2
2543441,2543475,34,1,0,0,2
2543442,2543472,30,1,0,0,1
2543473,2543589,116,0,0,1,1
2543476,2543590,114,0,0,1,2
2543590,2543611,21,1,0,0,1
2543591,2543621,30,1,0,0,2
2543612,2544164,552,0,0,1,1
2543622,2544162,540,0,0,1,2
2544163,2544237,74,1,0,0,2
2544165,2544236,71,1,0,0,1
2544237,2544412,175,0,0,1,1
2544238,2544412,174,0,0,1,2
2544413,2544478,65,1,0,0,1
2544413,2544489,76,1,0,0,2
2544479,2544567,88,0,0,1,1
2544490,2544567,77,0,0,1,2
2544568,2544605,37,1,0,0,1
2544568,2544609,41,1,0,0,2
2544606,2544850,244,0,0,1,1
2544610,2544845,235,0,0,1,2
2544846,2544866,20,1,0,0,2
2544851,2544862,11,1,0,0,1
2544863,2545337,474,0,0,1,1
2544867,2545337,470,0,0,1,2
2545338,2545364,26,1,0,0,1
2545338,2545367,29,1,0,0,2
2545365,2545848,483,0,0,1,1
2545368,2545848,480,0,0,1,2
2545849,2545892,43,1,0,0,1
2545849,2545892,43,1,0,0,2
2545893,2546081,188,0,0,1,2
2545893,2546082,189,0,0,1,1
2546082,2546157,75,1,0,0,2
2546083,2546161,78,1,0,0,1
2546158,2546231,73,0,0,1,2
2546162,2546232,70,0,0,1,1
2546232,2546283,51,1,0,0,2
2546233,2546293,60,1,0,0,1
2546284,2546478,194,0,0,1,2
2546294,2546477,183,0,0,1,1
2546478,2546510,32,1,0,0,1
2546479,2546510,31,1,0,0,2
2546511,2546757,246,0,0,1,1
2546511,2546757,246,0,0,1,2
2546758,2546787,29,1,0,0,1
2546758,2546788,30,1,0,0,2
2546788,2547860,1072,0,0,1,1
2546789,2547858,1069,0,0,1,2
2547859,2547980,121,1,0,0,2
2547861,2547963,102,1,0,0,1
2547964,2548082,118,0,0,1,1
2547981,2548082,101,0,0,1,2
2548083,2548105,22,1,0,0,1
2548083,2548115,32,1,0,0,2
2548106,2549226,1120,0,0,1,1
2548116,2548714,598,0,0,1,2
2548715,2548823,108,1,0,0,2
2548824,2548900,76,0,0,1,2
2548901,2548927,26,1,0,0,2
2548928,2548950,22,0,0,1,2
2548951,2549077,126,1,0,0,2
2549078,2549109,31,0,0,1,2
2549110,2549126,16,1,0,0,2
2549127,2549203,76,0,0,1,2
2549204,2549301,97,1,0,0,2
2549227,2549298,71,1,0,0,1
2549299,2549416,117,0,0,1,1
2549302,2549416,114,0,0,1,2
2549417,2549491,74,1,0,0,2
2549417,2549494,77,1,0,0,1
2549492,2549577,85,0,0,1,2
2549495,2549577,82,0,0,1,1
2549578,2549610,32,1,0,0,1
2549578,2549614,36,1,0,0,2
2549611,2550235,624,0,0,1,1
2549615,2550238,623,0,0,1,2
2550236,2550269,33,1,0,0,1
2550239,2550268,29,1,0,0,2
2550269,2550805,536,0,0,1,2
2550270,2550805,535,0,0,1,1
2550806,2550860,54,1,0,0,1
2550806,2550864,58,1,0,0,2
2550861,2551077,216,0,0,1,1
2550865,2551078,213,0,0,1,2
2551078,2551137,59,1,0,0,1
2551079,2551146,67,1,0,0,2
2551138,2551256,118,0,0,1,1
2551147,2551256,109,0,0,1,2
2551257,2551288,31,1,0,0,1
2551257,2551290,33,1,0,0,2
2551289,2551399,110,0,0,1,1
2551291,2551398,107,0,0,1,2
2551399,2551428,29,1,0,0,2
2551400,2551419,19,1,0,0,1
2551420,2551637,217,0,0,1,1
2551429,2551637,208,0,0,1,2
2551638,2551666,28,1,0,0,2
2551638,2551668,30,1,0,0,1
2551667,2552637,970,0,0,1,2
2551669,2552638,969,0,0,1,1
2552638,2552726,88,1,0,0,2
2552639,2552712,73,1,0,0,1
2552713,2552803,90,0,0,1,1
2552727,2552803,76,0,0,1,2
2552804,2552842,38,1,0,0,1
2552804,2552846,42,1,0,0,2
2552843,2553047,204,0,0,1,1
2552847,2553040,193,0,0,1,2
2553041,2553058,17,1,0,0,2
2553048,2553052,4,1,0,0,1
2553053,2553794,741,0,0,1,1
2553059,2553796,737,0,0,1,2
2553795,2553866,71,1,0,0,1
2553797,2554006,209,1,0,0,2
2553867,2553945,78,0,0,1,1
2553946,2554002,56,1,0,0,1
2554003,2554260,257,0,0,1,1
2554007,2554036,29,0,0,1,2
2554037,2554163,126,1,0,0,2
2554164,2554259,95,0,0,1,2
2554260,2554342,82,1,0,0,2
2554261,2554339,78,1,0,0,1
2554340,2554417,77,0,0,1,1
2554343,2554419,76,0,0,1,2
2554418,2554456,38,1,0,0,1
2554420,2554461,41,1,0,0,2
2554457,2555245,788,0,0,1,1
2554462,2555237,775,0,0,1,2
2555238,2555265,27,1,0,0,2
2555246,2555265,19,1,0,0,1
2555266,2556321,1055,0,0,1,1
2555266,2556321,1055,0,0,1,2
2556322,2556383,61,1,0,0,1
2556322,2556385,63,1,0,0,2
2556384,2556486,102,0,0,1,1
2556386,2556486,100,0,0,1,2
2556487,2556516,29,1,0,0,2
2556487,2556521,34,1,0,0,1
2556517,2556816,299,0,0,1,2
2556522,2556817,295,0,0,1,1
2556817,2556845,28,1,0,0,2
2556818,2556845,27,1,0,0,1
2556846,2557974,1128,0,0,1,2
2556846,2557975,1129,0,0,1,1
2557975,2558007,32,1,0,0,2
2557976,2558007,31,1,0,0,1
2558008,2558498,490,0,0,1,1
2558008,2558498,490,0,0,1,2
2558499,2558580,81,1,0,0,1
2558499,2558651,152,1,0,0,2
2558581,2558753,172,0,0,1,1
2558652,2558753,101,0,0,1,2
2558754,2558799,45,1,0,0,1
2558754,2558809,55,1,0,0,2
2558800,2558970,170,0,0,1,1
2558810,2558961,151,0,0,1,2
2558962,2559012,50,1,0,0,2
2558971,2558998,27,1,0,0,1
2558999,2560552,1553,0,0,1,1
2559013,2559080,67,0,0,1,2
2559081,2559090,9,1,0,0,2
2559091,2559157,66,0,0,1,2
2559158,2559514,356,1,0,0,2
2559515,2559580,65,0,0,1,2
2559581,2559650,69,1,0,0,2
2559651,2559749,98,0,0,1,2
2559750,2559781,31,1,0,0,2
2559782,2560338,556,0,0,1,2
2560339,2560355,16,1,0,0,2
2560356,2560552,196,0,0,1,2
2560553,2560633,80,1,0,0,1
2560553,2560638,85,1,0,0,2
2560634,2560829,195,0,0,1,1
2560639,2560829,190,0,0,1,2
2560830,2560864,34,1,0,0,2
2560830,2560867,37,1,0,0,1
2560865,2561161,296,0,0,1,2
2560868,2561159,291,0,0,1,1
2561160,2561196,36,1,0,0,1
2561162,2561199,37,1,0,0,2
2561197,2562163,966,0,0,1,1
2561200,2562162,962,0,0,1,2
2562163,2562231,68,1,0,0,2
2562164,2562231,67,1,0,0,1
2562232,2562345,113,0,0,1,2
2562232,2562347,115,0,0,1,1
2562346,2562378,32,1,0,0,2
2562348,2562376,28,1,0,0,1
2562377,2562631,254,0,0,1,1
2562379,2562630,251,0,0,1,2
2562631,2562664,33,1,0,0,2
2562632,2562663,31,1,0,0,1
2562664,2562843,179,0,0,1,1
2562665,2562843,178,0,0,1,2
2562844,2562872,28,1,0,0,1
2562844,2562874,30,1,0,0,2
2562873,2563275,402,0,0,1,1
2562875,2563274,399,0,0,1,2
2563275,2563307,32,1,0,0,2
2563276,2563307,31,1,0,0,1
2563308,2564135,827,0,0,1,2
2563308,2564136,828,0,0,1,1
2564136,2564194,58,1,0,0,2
2564137,2564196,59,1,0,0,1
2564195,2564693,498,0,0,1,2
2564197,2564694,497,0,0,1,1
2564694,2564728,34,1,0,0,2
2564695,2564728,33,1,0,0,1
2564729,2566272,1543,0,0,1,1
2564729,2566272,1543,0,0,1,2
2566273,2566301,28,1,0,0,1
2566273,2566312,39,1,0,0,2
2566302,2566509,207,0,0,1,1
2566313,2566508,195,0,0,1,2
2566509,2566541,32,1,0,0,2
2566510,2566541,31,1,0,0,1
2566542,2566829,287,0,0,1,1
2566542,2566829,287,0,0,1,2
2566830,2566853,23,1,0,0,2
2566830,2566862,32,1,0,0,1
2566854,2567376,522,0,0,1,2
2566863,2567375,512,0,0,1,1
2567376,2567420,44,1,0,0,1
2567377,2567414,37,1,0,0,2
2567415,2567923,508,0,0,1,2
2567421,2567923,502,0,0,1,1
2567924,2567954,30,1,0,0,1
2567924,2567954,30,1,0,0,2
2567955,2568826,871,0,0,1,1
2567955,2568826,871,0,0,1,2
2568827,2568861,34,1,0,0,1
2568827,2568862,35,1,0,0,2
2568862,2569183,321,0,0,1,1
2568863,2569182,319,0,0,1,2
2569183,2569248,65,1,0,0,2
2569184,2569249,65,1,0,0,1
2569249,2569384,135,0,0,1,2
2569250,2569382,132,0,0,1,1
2569383,2569403,20,1,0,0,1
2569385,2569406,21,1,0,0,2
2569404,2569590,186,0,0,1,1
2569407,2569592,185,0,0,1,2
2569591,2569623,32,1,0,0,1
2569593,2569622,29,1,0,0,2
2569623,2571452,1829,0,0,1,2
2569624,2571451,1827,0,0,1,1
2571452,2571505,53,1,0,0,1
2571453,2571504,51,1,0,0,2
2571505,2571714,209,0,0,1,2
2571506,2571714,208,0,0,1,1
2571715,2571788,73,1,0,0,2
2571715,2571789,74,1,0,0,1
2571789,2572182,393,0,0,1,2
2571790,2572181,391,0,0,1,1
2572182,2572250,68,1,0,0,1
2572183,2572262,79,1,0,0,2
2572251,2572781,530,0,0,1,1
2572263,2572783,520,0,0,1,2
2572782,2572842,60,1,0,0,1
2572784,2572845,61,1,0,0,2
2572843,2573007,164,0,0,1,1
2572846,2573011,165,0,0,1,2
2573008,2573038,30,1,0,0,1
2573012,2573042,30,1,0,0,2
2573039,2573234,195,0,0,1,1
2573043,2573234,191,0,0,1,2
2573235,2573268,33,1,0,0,1
2573235,2573268,33,1,0,0,2
2573269,2573478,209,0,0,1,1
2573269,2573480,211,0,0,1,2
2573479,2573509,30,1,0,0,1
2573481,2573512,31,1,0,0,2
2573510,2573878,368,0,0,1,1
2573513,2573879,366,0,0,1,2
2573879,2573909,30,1,0,0,1
2573880,2573932,52,1,0,0,2
2573910,2574249,339,0,0,1,1
2573933,2574249,316,0,0,1,2
2574250,2574320,70,1,0,0,2
2574250,2574329,79,1,0,0,1
2574321,2574428,107,0,0,1,2
2574330,2574427,97,0,0,1,1
2574428,2574460,32,1,0,0,1
2574429,2574461,32,1,0,0,2
2574461,2576208,1747,0,0,1,1
2574462,2576213,1751,0,0,1,2
2576209,2576238,29,1,0,0,1
2576214,2576238,24,1,0,0,2
2576239,2577924,1685,0,0,1,1
2576239,2577924,1685,0,0,1,2
2577925,2578027,102,1,0,0,1
2577925,2578082,157,1,0,0,2
2578028,2578384,356,0,0,1,1
2578083,2578387,304,0,0,1,2
2578385,2578409,24,1,0,0,1
2578388,2578396,8,1,0,0,2
2578397,2578595,198,0,0,1,2
2578410,2578600,190,0,0,1,1
2578596,2578612,16,1,0,0,2
2578601,2578614,13,1,0,0,1
2578613,2579563,950,0,0,1,2
2578615,2579563,948,0,0,1,1
2579564,2579586,22,1,0,0,1
2579564,2579596,32,1,0,0,2
2579587,2579805,218,0,0,1,1
2579597,2579803,206,0,0,1,2
2579804,2579870,66,1,0,0,2
2579806,2579871,65,1,0,0,1
2579871,2579957,86,0,0,1,2
2579872,2579958,86,0,0,1,1
2579958,2579996,38,1,0,0,2
2579959,2579997,38,1,0,0,1
2579997,2581122,1125,0,0,1,2
2579998,2581123,1125,0,0,1,1
2581123,2581159,36,1,0,0,2
2581124,2581154,30,1,0,0,1
2581155,2581966,811,0,0,1,1
2581160,2581967,807,0,0,1,2
2581967,2582029,62,1,0,0,1
2581968,2582000,32,1,0,0,2
2582001,2582908,907,0,0,1,2
2582030,2582907,877,0,0,1,1
2582908,2582971,63,1,0,0,1
2582909,2582982,73,1,0,0,2
2582972,2583543,571,0,0,1,1
2582983,2583545,562,0,0,1,2
2583544,2583597,53,1,0,0,1
2583546,2583596,50,1,0,0,2
2583597,2583778,181,0,0,1,2
2583598,2583777,179,0,0,1,1
2583778,2583850,72,1,0,0,1
2583779,2583857,78,1,0,0,2
2583851,2584051,200,0,0,1,1
2583858,2584050,192,0,0,1,2
2584051,2584105,54,1,0,0,2
2584052,2584103,51,1,0,0,1
2584104,2584302,198,0,0,1,1
2584106,2584303,197,0,0,1,2
2584303,2584334,31,1,0,0,1
2584304,2584337,33,1,0,0,2
2584335,2584561,226,0,0,1,1
2584338,2584558,220,0,0,1,2
2584559,2584590,31,1,0,0,2
2584562,2584591,29,1,0,0,1
2584591,2585473,882,0,0,1,2
2584592,2585471,879,0,0,1,1
2585472,2585532,60,1,0,0,1
2585474,2585543,69,1,0,0,2
2585533,2586141,608,0,0,1,1
2585544,2586140,596,0,0,1,2
2586141,2586179,38,1,0,0,2
2586142,2586179,37,1,0,0,1
2586180,2587736,1556,0,0,1,1
2586180,2587736,1556,0,0,1,2
2587737,2587803,66,1,0,0,1
2587737,2587803,66,1,0,0,2
2587804,2589146,1342,0,0,1,2
2587804,2589147,1343,0,0,1,1
2589147,2589210,63,1,0,0,2
2589148,2589216,68,1,0,0,1
2589211,2589441,230,0,0,1,2
2589217,2589442,225,0,0,1,1
2589442,2589473,31,1,0,0,2
2589443,2589482,39,1,0,0,1
2589474,2589643,169,0,0,1,2
2589483,2589642,159,0,0,1,1
2589643,2589670,27,1,0,0,1
2589644,2589670,26,1,0,0,2
2589671,2590987,1316,0,0,1,1
2589671,2590988,1317,0,0,1,2
2590988,2591045,57,1,0,0,1
2590989,2591058,69,1,0,0,2
2591046,2591148,102,0,0,1,1
2591059,2591147,88,0,0,1,2
2591148,2591181,33,1,0,0,2
2591149,2591180,31,1,0,0,1
2591181,2591613,432,0,0,1,1
2591182,2591613,431,0,0,1,2
2591614,2591647,33,1,0,0,1
2591614,2591647,33,1,0,0,2
2591648,2591795,147,0,0,1,1
2591648,2591795,147,0,0,1,2
2591796,2591822,26,1,0,0,1
2591796,2591823,27,1,0,0,2
2591823,2595012,3189,0,0,1,1
2591824,2595012,3188,0,0,1,2
2595013,2595072,59,1,0,0,1
2595013,2595074,61,1,0,0,2
2595073,2595175,102,0,0,1,1
2595075,2595176,101,0,0,1,2
2595176,2595210,34,1,0,0,1
2595177,2595210,33,1,0,0,2
2595211,2595419,208,0,0,1,1
2595211,2595419,208,0,0,1,2
2595420,2595449,29,1,0,0,2
2595420,2595450,30,1,0,0,1
2595450,2596098,648,0,0,1,2
2595451,2596099,648,0,0,1,1
2596099,2596166,67,1,0,0,2
2596100,2596160,60,1,0,0,1
2596161,2596755,594,0,0,1,1
2596167,2596754,587,0,0,1,2
2596755,2596770,15,1,0,0,2
2596756,2596764,8,1,0,0,1
2596765,2599423,2658,0,0,1,1
2596771,2599423,2652,0,0,1,2
2599424,2599501,77,1,0,0,1
2599424,2599511,87,1,0,0,2
2599502,2599614,112,0,0,1,1
2599512,2599614,102,0,0,1,2
2599615,2599646,31,1,0,0,1
2599615,2599647,32,1,0,0,2
2599647,2600872,1225,0,0,1,1
2599648,2600873,1225,0,0,1,2
2600873,2600939,66,1,0,0,1
2600874,2600920,46,1,0,0,2
2600921,2604579,3658,0,0,1,2
2600940,2604580,3640,0,0,1,1
2604580,2604677,97,1,0,0,2
2604581,2604669,88,1,0,0,1
2604670,2604783,113,0,0,1,1
2604678,2604784,106,0,0,1,2
2604784,2604807,23,1,0,0,1
2604785,2604816,31,1,0,0,2
2604808,2605162,354,0,0,1,1
2604817,2605162,345,0,0,1,2
2605163,2605191,28,1,0,0,1
2605163,2605194,31,1,0,0,2
2605192,2606057,865,0,0,1,1
2605195,2606056,861,0,0,1,2
2606057,2606106,49,1,0,0,2
2606058,2606112,54,1,0,0,1
2606107,2609617,3510,0,0,1,2
2606113,2609618,3505,0,0,1,1
2609618,2609679,61,1,0,0,2
2609619,2609672,53,1,0,0,1
2609673,2609800,127,0,0,1,1
2609680,2609800,120,0,0,1,2
2609801,2609864,63,1,0,0,2
2609801,2609870,69,1,0,0,1
2609865,2610002,137,0,0,1,2
2609871,2610007,136,0,0,1,1
2610003,2610024,21,1,0,0,2
2610008,2610023,15,1,0,0,1
2610024,2611183,1159,0,0,1,1
2610025,2611182,1157,0,0,1,2
2611183,2611249,66,1,0,0,2
2611184,2611248,64,1,0,0,1
2611249,2611346,97,0,0,1,1
2611250,2611345,95,0,0,1,2
2611346,2611381,35,1,0,0,2
2611347,2611371,24,1,0,0,1
2611372,2614738,3366,0,0,1,1
2611382,2614738,3356,0,0,1,2
2614739,2614825,86,1,0,0,1
2614739,2614829,90,1,0,0,2
2614826,2614920,94,0,0,1,1
2614830,2614919,89,0,0,1,2
2614920,2614965,45,1,0,0,2
2614921,2614966,45,1,0,0,1
2614966,2615228,262,0,0,1,2
2614967,2615229,262,0,0,1,1
2615229,2615259,30,1,0,0,2
2615230,2615257,27,1,0,0,1
2615258,2616354,1096,0,0,1,1
2615260,2616353,1093,0,0,1,2
2616354,2616409,55,1,0,0,2
2616355,2616405,50,1,0,0,1
2616406,2619498,3092,0,0,1,1
2616410,2619499,3089,0,0,1,2
2619499,2619577,78,1,0,0,1
2619500,2619577,77,1,0,0,2
2619578,2620113,535,0,0,1,1
2619578,2620114,536,0,0,1,2
2620114,2620178,64,1,0,0,1
2620115,2620182,67,1,0,0,2
2620179,2620289,110,0,0,1,1
2620183,2620288,105,0,0,1,2
2620289,2620319,30,1,0,0,2
2620290,2620319,29,1,0,0,1
2620320,2620661,341,0,0,1,1
2620320,2620663,343,0,0,1,2
2620662,2620679,17,1,0,0,1
2620664,2620680,16,1,0,0,2
2620680,2621382,702,0,0,1,1
2620681,2621380,699,0,0,1,2
2621381,2621427,46,1,0,0,2
2621383,2621436,53,1,0,0,1
2621428,2621575,147,0,0,1,2
2621437,2621574,137,0,0,1,1
2621575,2621600,25,1,0,0,1
2621576,2621608,32,1,0,0,2
2621601,2621962,361,0,0,1,1
2621609,2621962,353,0,0,1,2
2621963,2622007,44,1,0,0,2
2621963,2622353,390,1,0,0,1
2622008,2622042,34,0,0,1,2
2622043,2622300,257,1,0,0,2
2622085,2622260,175,0,1,0,1
2622116,2622208,92,0,1,0,2
2622301,2624698,2397,0,0,1,2
2622354,2624699,2345,0,0,1,1
2624699,2624752,53,1,0,0,2
2624700,2624751,51,1,0,0,1
2624752,2625013,261,0,0,1,1
2624753,2625014,261,0,0,1,2
2625014,2625042,28,1,0,0,1
2625015,2625044,29,1,0,0,2
2625043,2625367,324,0,0,1,1
2625045,2625366,321,0,0,1,2
2625367,2625404,37,1,0,0,2
2625368,2625401,33,1,0,0,1
2625402,2625752,350,0,0,1,1
2625405,2625752,347,0,0,1,2
2625753,2625783,30,1,0,0,1
2625753,2625804,51,1,0,0,2
2625784,2626573,789,0,0,1,1
2625805,2626573,768,0,0,1,2
2626574,2626634,60,1,0,0,2
2626574,2626635,61,1,0,0,1
2626635,2626808,173,0,0,1,2
2626636,2626808,172,0,0,1,1
2626809,2626842,33,1,0,0,1
2626809,2626842,33,1,0,0,2
2626843,2627634,791,0,0,1,1
2626843,2627635,792,0,0,1,2
2627635,2627677,42,1,0,0,1
2627636,2627689,53,1,0,0,2
2627678,2627963,285,0,0,1,1
2627690,2627962,272,0,0,1,2
2627963,2628002,39,1,0,0,2
2627964,2627999,35,1,0,0,1
2628000,2628900,900,0,0,1,1
2628003,2628900,897,0,0,1,2
2628901,2628942,41,1,0,0,2
2628901,2628949,48,1,0,0,1
2628943,2630537,1594,0,0,1,2
2628950,2630537,1587,0,0,1,1
2630538,2630598,60,1,0,0,1
2630538,2630599,61,1,0,0,2
2630599,2630733,134,0,0,1,1
2630600,2630732,132,0,0,1,2
2630733,2630766,33,1,0,0,2
2630734,2630764,30,1,0,0,1
2630765,2630956,191,0,0,1,1
2630767,2630958,191,0,0,1,2
2630957,2630986,29,1,0,0,1
2630959,2630987,28,1,0,0,2
2630987,2631878,891,0,0,1,1
2630988,2631877,889,0,0,1,2
2631878,2631940,62,1,0,0,2
2631879,2631938,59,1,0,0,1
2631939,2632130,191,0,0,1,1
2631941,2632124,183,0,0,1,2
2632125,2632157,32,1,0,0,2
2632131,2632150,19,1,0,0,1
2632151,2632494,343,0,0,1,1
2632158,2632494,336,0,0,1,2
2632495,2632531,36,1,0,0,1
2632495,2632532,37,1,0,0,2
2632532,2634158,1626,0,0,1,1
2632533,2634159,1626,0,0,1,2
2634159,2634222,63,1,0,0,1
2634160,2634237,77,1,0,0,2
2634223,2635372,1149,0,0,1,1
2634238,2635373,1135,0,0,1,2
2635373,2635444,71,1,0,0,1
2635374,2635438,64,1,0,0,2
2635439,2635536,97,0,0,1,2
2635445,2635537,92,0,0,1,1
2635537,2635573,36,1,0,0,2
2635538,2635577,39,1,0,0,1
2635574,2635860,286,0,0,1,2
2635578,2635855,277,0,0,1,1
2635856,2635884,28,1,0,0,1
2635861,2635884,23,1,0,0,2
2635885,2637052,1167,0,0,1,2
2635885,2637054,1169,0,0,1,1
2637053,2637148,95,1,0,0,2
2637055,2637118,63,1,0,0,1
2637119,2637363,244,0,0,1,1
2637149,2637261,112,0,0,1,2
2637262,2637299,37,1,0,0,2
2637300,2637363,63,0,0,1,2
2637364,2637401,37,1,0,0,1
2637364,2637408,44,1,0,0,2
2637402,2639131,1729,0,0,1,1
2637409,2637646,237,0,0,1,2
2637647,2637676,29,1,0,0,2
2637677,2639132,1455,0,0,1,2
2639132,2639185,53,1,0,0,1
2639133,2639187,54,1,0,0,2
2639186,2639366,180,0,0,1,1
2639188,2639272,84,0,0,1,2
2639273,2639277,4,1,0,0,2
2639278,2639366,88,0,0,1,2
2639367,2639422,55,1,0,0,1
2639367,2639424,57,1,0,0,2
2639423,2640854,1431,0,0,1,1
2639425,2640853,1428,0,0,1,2
2640854,2640943,89,1,0,0,2
2640855,2640935,80,1,0,0,1
2640936,2641035,99,0,0,1,1
2640944,2641036,92,0,0,1,2
2641036,2641068,32,1,0,0,1
2641037,2641070,33,1,0,0,2
2641069,2641851,782,0,0,1,1
2641071,2641845,774,0,0,1,2
2641846,2641855,9,1,0,0,2
2641852,2641857,5,1,0,0,1
2641856,2642546,690,0,0,1,2
2641858,2642546,688,0,0,1,1
2642547,2642600,53,1,0,0,2
2642547,2642602,55,1,0,0,1
2642601,2642927,326,0,0,1,2
2642603,2642926,323,0,0,1,1
2642927,2642959,32,1,0,0,1
2642928,2642979,51,1,0,0,2
2642960,2646510,3550,0,0,1,1
2642980,2644312,1332,0,0,1,2
2644313,2644390,77,1,0,0,2
2644391,2646509,2118,0,0,1,2
2646510,2646617,107,1,0,0,2
2646511,2646639,128,1,0,0,1
2646618,2646704,86,0,0,1,2
2646640,2646704,64,0,0,1,1
2646705,2646740,35,1,0,0,2
2646705,2646747,42,1,0,0,1
2646741,2646886,145,0,0,1,2
2646748,2646891,143,0,0,1,1
2646887,2646916,29,1,0,0,2
2646892,2646914,22,1,0,0,1
2646915,2647089,174,0,0,1,1
2646917,2647087,170,0,0,1,2
2647088,2647117,29,1,0,0,2
2647090,2647116,26,1,0,0,1
2647117,2648356,1239,0,0,1,1
2647118,2648353,1235,0,0,1,2
2648354,2648423,69,1,0,0,2
2648357,2648414,57,1,0,0,1
2648415,2648445,30,0,0,1,1
2648424,2648621,197,0,0,1,2
2648446,2648513,67,1,0,0,1
2648514,2648621,107,0,0,1,1
2648622,2648649,27,1,0,0,1
2648622,2648651,29,1,0,0,2
2648650,2650517,1867,0,0,1,1
2648652,2650516,1864,0,0,1,2
2650517,2650593,76,1,0,0,2
2650518,2650594,76,1,0,0,1
2650594,2650989,395,0,0,1,2
2650595,2650990,395,0,0,1,1
2650990,2651026,36,1,0,0,2
2650991,2651027,36,1,0,0,1
2651027,2652431,1404,0,0,1,2
2651028,2652431,1403,0,0,1,1
2652432,2652489,57,1,0,0,1
2652432,2652491,59,1,0,0,2
2652490,2652593,103,0,0,1,1
2652492,2652596,104,0,0,1,2
2652594,2652624,30,1,0,0,1
2652597,2652631,34,1,0,0,2
2652625,2653458,833,0,0,1,1
2652632,2653458,826,0,0,1,2
2653459,2653490,31,1,0,0,1
2653459,2653492,33,1,0,0,2
2653491,2654241,750,0,0,1,1
2653493,2654241,748,0,0,1,2
2654242,2654285,43,1,0,0,1
2654242,2654292,50,1,0,0,2
2654286,2654530,244,0,0,1,1
2654293,2654530,237,0,0,1,2
2654531,2654559,28,1,0,0,1
2654531,2654563,32,1,0,0,2
2654560,2655136,576,0,0,1,1
2654564,2655136,572,0,0,1,2
2655137,2655176,39,1,0,0,2
2655137,2655178,41,1,0,0,1
2655177,2655350,173,0,0,1,2
2655179,2655351,172,0,0,1,1
2655351,2655382,31,1,0,0,2
2655352,2655379,27,1,0,0,1
2655380,2656852,1472,0,0,1,1
2655383,2656851,1468,0,0,1,2
2656852,2656896,44,1,0,0,2
2656853,2656887,34,1,0,0,1
2656888,2658156,1268,0,0,1,1
2656897,2658155,1258,0,0,1,2
2658156,2658215,59,1,0,0,2
2658157,2658215,58,1,0,0,1
2658216,2658323,107,0,0,1,1
2658216,2658323,107,0,0,1,2
2658324,2658355,31,1,0,0,1
2658324,2658356,32,1,0,0,2
2658356,2658776,420,0,0,1,1
2658357,2658777,420,0,0,1,2
2658777,2658811,34,1,0,0,1
2658778,2658810,32,1,0,0,2
2658811,2659668,857,0,0,1,2
2658812,2659677,865,0,0,1,1
2659669,2659692,23,1,0,0,2
2659678,2659691,13,1,0,0,1
2659692,2659838,146,0,0,1,1
2659693,2659852,159,0,0,1,2
2659839,2661750,1911,1,0,0,1
2659853,2661757,1904,1,0,0,2
2659895,2661739,1844,0,1,0,2
2660102,2660159,57,0,1,0,1
2660468,2660590,122,0,1,0,1
2660915,2661731,816,0,1,0,1
2661751,2661899,148,0,0,1,1
2661758,2661900,142,0,0,1,2
2661900,2661930,30,1,0,0,1
2661901,2661934,33,1,0,0,2
2661931,2662067,136,0,0,1,1
2661935,2662065,130,0,0,1,2
2662066,2662098,32,1,0,0,2
2662068,2662098,30,1,0,0,1
2662099,2662326,227,0,0,1,2
2662099,2663182,1083,0,0,1,1
2662327,2662339,12,1,0,0,2
2662340,2663183,843,0,0,1,2
2663183,2663231,48,1,0,0,1
2663184,2663231,47,1,0,0,2
2663232,2663747,515,0,0,1,2
2663232,2663750,518,0,0,1,1
2663748,2663777,29,1,0,0,2
2663751,2663765,14,1,0,0,1
2663766,2665871,2105,0,0,1,1
2663778,2665871,2093,0,0,1,2
2665872,2665916,44,1,0,0,2
2665872,2665917,45,1,0,0,1
2665917,2666582,665,0,0,1,2
2665918,2666583,665,0,0,1,1
2666583,2666638,55,1,0,0,2
2666584,2666629,45,1,0,0,1
2666630,2666765,135,0,0,1,1
2666639,2666766,127,0,0,1,2
2666766,2666784,18,1,0,0,1
2666767,2666815,48,1,0,0,2
2666785,2667455,670,0,0,1,1
2666816,2667455,639,0,0,1,2
2667456,2667484,28,1,0,0,1
2667456,2667487,31,1,0,0,2
2667485,2668925,1440,0,0,1,1
2667488,2668924,1436,0,0,1,2
2668925,2668986,61,1,0,0,2
2668926,2668984,58,1,0,0,1
2668985,2669173,188,0,0,1,1
2668987,2669174,187,0,0,1,2
2669174,2669201,27,1,0,0,1
2669175,2669194,19,1,0,0,2
2669195,2669811,616,0,0,1,2
2669202,2669812,610,0,0,1,1
2669812,2669842,30,1,0,0,2
2669813,2669844,31,1,0,0,1
2669843,2671121,1278,0,0,1,2
2669845,2671121,1276,0,0,1,1
2671122,2671190,68,1,0,0,1
2671122,2671191,69,1,0,0,2
2671191,2671374,183,0,0,1,1
2671192,2671374,182,0,0,1,2
2671375,2671437,62,1,0,0,1
2671375,2671447,72,1,0,0,2
2671438,2671836,398,0,0,1,1
2671448,2671837,389,0,0,1,2
2671837,2671894,57,1,0,0,1
2671838,2671889,51,1,0,0,2
2671890,2672627,737,0,0,1,2
2671895,2672628,733,0,0,1,1
2672628,2672692,64,1,0,0,2
2672629,2672679,50,1,0,0,1
2672680,2673005,325,0,0,1,1
2672693,2673004,311,0,0,1,2
2673005,2673073,68,1,0,0,2
2673006,2673074,68,1,0,0,1
2673074,2673470,396,0,0,1,2
2673075,2673468,393,0,0,1,1
2673469,2673481,12,1,0,0,1
2673471,2673481,10,1,0,0,2
2673482,2673830,348,0,0,1,1
2673482,2673830,348,0,0,1,2
2673831,2673846,15,1,0,0,1
2673831,2673848,17,1,0,0,2
2673847,2674964,1117,0,0,1,1
2673849,2674964,1115,0,0,1,2
2674965,2675006,41,1,0,0,1
2674965,2675012,47,1,0,0,2
2675007,2675660,653,0,0,1,1
2675013,2675660,647,0,0,1,2
2675661,2675691,30,1,0,0,1
2675661,2675695,34,1,0,0,2
2675692,2676023,331,0,0,1,1
2675696,2676024,328,0,0,1,2
2676024,2676058,34,1,0,0,1
2676025,2676063,38,1,0,0,2
2676059,2677159,1100,0,0,1,1
2676064,2677160,1096,0,0,1,2
2677160,2677222,62,1,0,0,1
2677161,2677232,71,1,0,0,2
2677223,2677493,270,0,0,1,1
2677233,2677493,260,0,0,1,2
2677494,2677547,53,1,0,0,1
2677494,2677554,60,1,0,0,2
2677548,2677816,268,0,0,1,1
2677555,2677817,262,0,0,1,2
2677817,2677872,55,1,0,0,1
2677818,2677878,60,1,0,0,2
2677873,2678712,839,0,0,1,1
2677879,2678712,833,0,0,1,2
2678713,2678767,54,1,0,0,2
2678713,2678768,55,1,0,0,1
2678768,2678875,107,0,0,1,2
2678769,2678873,104,0,0,1,1
2678874,2678898,24,1,0,0,1
2678876,2678897,21,1,0,0,2
2678898,2680219,1321,0,0,1,2
2678899,2679884,985,0,0,1,1
2679885,2679893,8,1,0,0,1
2679894,2680218,324,0,0,1,1
2680219,2680270,51,1,0,0,1
2680220,2680273,53,1,0,0,2
2680271,2680550,279,0,0,1,1
2680274,2680552,278,0,0,1,2
2680551,2680582,31,1,0,0,1
2680553,2680586,33,1,0,0,2
2680583,2683836,3253,0,0,1,1
2680587,2683838,3251,0,0,1,2
2683837,2683924,87,1,0,0,1
2683839,2683911,72,1,0,0,2
2683912,2684034,122,0,0,1,2
2683925,2684034,109,0,0,1,1
2684035,2684069,34,1,0,0,2
2684035,2684102,67,1,0,0,1
2684070,2684284,214,0,0,1,2
2684103,2684285,182,0,0,1,1
2684285,2684316,31,1,0,0,2
2684286,2684314,28,1,0,0,1
2684315,2685495,1180,0,0,1,1
2684317,2685497,1180,0,0,1,2
2685496,2685556,60,1,0,0,1
2685498,2685556,58,1,0,0,2
2685557,2685695,138,0,0,1,2
2685557,2685696,139,0,0,1,1
2685696,2685737,41,1,0,0,2
2685697,2685734,37,1,0,0,1
2685735,2686342,607,0,0,1,1
2685738,2686341,603,0,0,1,2
2686342,2686376,34,1,0,0,2
2686343,2686366,23,1,0,0,1
2686367,2686642,275,0,0,1,1
2686377,2686642,265,0,0,1,2
2686643,2686679,36,1,0,0,1
2686643,2686683,40,1,0,0,2
2686680,2687208,528,0,0,1,1
2686684,2687207,523,0,0,1,2
2687208,2687245,37,1,0,0,2
2687209,2687245,36,1,0,0,1
2687246,2687800,554,0,0,1,1
2687246,2687801,555,0,0,1,2
2687801,2687835,34,1,0,0,1
2687802,2687834,32,1,0,0,2
2687835,2688027,192,0,0,1,2
2687836,2688027,191,0,0,1,1
2688028,2688088,60,1,0,0,2
2688028,2688089,61,1,0,0,1
2688089,2688249,160,0,0,1,2
2688090,2688248,158,0,0,1,1
2688249,2688314,65,1,0,0,1
2688250,2688313,63,1,0,0,2
2688314,2688519,205,0,0,1,2
2688315,2688520,205,0,0,1,1
2688520,2688578,58,1,0,0,2
2688521,2688584,63,1,0,0,1
2688579,2689012,433,0,0,1,2
2688585,2689011,426,0,0,1,1
2689012,2689062,50,1,0,0,1
2689013,2689065,52,1,0,0,2
2689063,2689272,209,0,0,1,1
2689066,2689273,207,0,0,1,2
2689273,2689326,53,1,0,0,1
2689274,2689327,53,1,0,0,2
2689327,2689439,112,0,0,1,1
2689328,2689439,111,0,0,1,2
2689440,2689518,78,1,0,0,1
2689440,2689561,121,1,0,0,2
2689519,2689612,93,0,0,1,1
2689562,2689610,48,0,0,1,2
2689611,2689660,49,1,0,0,2
2689613,2689656,43,1,0,0,1
2689657,2689801,144,0,0,1,1
2689661,2689799,138,0,0,1,2
2689800,2689871,71,1,0,0,2
2689802,2689833,31,1,0,0,1
2689834,2690032,198,0,0,1,1
2689872,2690031,159,0,0,1,2
2690032,2690064,32,1,0,0,2
2690033,2690063,30,1,0,0,1
2690064,2690255,191,0,0,1,1
2690065,2690256,191,0,0,1,2
2690256,2690283,27,1,0,0,1
2690257,2690284,27,1,0,0,2
2690284,2690948,664,0,0,1,1
2690285,2690946,661,0,0,1,2
2690947,2690976,29,1,0,0,2
2690949,2690977,28,1,0,0,1
2690977,2691167,190,0,0,1,2
2690978,2691166,188,0,0,1,1
2691167,2691223,56,1,0,0,1
2691168,2691231,63,1,0,0,2
2691224,2692016,792,0,0,1,1
2691232,2692035,803,0,0,1,2
2692017,2692503,486,1,0,0,1
2692036,2692442,406,1,0,0,2
2692092,2692465,373,0,1,0,1
2692128,2692345,217,0,1,0,2
2692443,2692846,403,0,0,1,2
2692504,2692844,340,0,0,1,1
2692845,2692891,46,1,0,0,1
2692847,2692891,44,1,0,0,2
2692892,2694846,1954,0,0,1,2
2692892,2694848,1956,0,0,1,1
2694847,2694908,61,1,0,0,2
2694849,2694912,63,1,0,0,1
2694909,2695027,118,0,0,1,2
2694913,2695027,114,0,0,1,1
2695028,2695048,20,1,0,0,1
2695028,2695056,28,1,0,0,2
2695049,2695390,341,0,0,1,1
2695057,2695391,334,0,0,1,2
2695391,2695422,31,1,0,0,1
2695392,2695422,30,1,0,0,2
2695423,2696681,1258,0,0,1,1
2695423,2696681,1258,0,0,1,2
2696682,2696723,41,1,0,0,1
2696682,2696735,53,1,0,0,2
2696724,2696930,206,0,0,1,1
2696736,2696929,193,0,0,1,2
2696930,2696961,31,1,0,0,2
2696931,2696953,22,1,0,0,1
2696954,2699311,2357,0,0,1,1
2696962,2699311,2349,0,0,1,2
2699312,2699348,36,1,0,0,1
2699312,2699361,49,1,0,0,2
2699349,2700198,849,0,0,1,1
2699362,2700198,836,0,0,1,2
2700199,2700260,61,1,0,0,2
2700199,2700261,62,1,0,0,1
2700261,2700674,413,0,0,1,2
2700262,2700675,413,0,0,1,1
2700675,2700741,66,1,0,0,2
2700676,2700746,70,1,0,0,1
2700742,2700855,113,0,0,1,2
2700747,2700855,108,0,0,1,1
2700856,2700883,27,1,0,0,1
2700856,2700887,31,1,0,0,2
2700884,2701302,418,0,0,1,1
2700888,2701107,219,0,0,1,2
2701108,2701119,11,1,0,0,2
2701120,2701643,523,0,0,1,2
2701303,2701312,9,1,0,0,1
2701313,2701641,328,0,0,1,1
2701642,2701659,17,1,0,0,1
2701644,2701667,23,1,0,0,2
2701660,2702032,372,0,0,1,1
2701668,2702033,365,0,0,1,2
2702033,2702093,60,1,0,0,1
2702034,2702090,56,1,0,0,2
2702091,2702397,306,0,0,1,2
2702094,2702396,302,0,0,1,1
2702397,2702439,42,1,0,0,1
2702398,2702451,53,1,0,0,2
2702440,2702585,145,0,0,1,1
2702452,2702598,146,0,0,1,2
2702586,2703081,495,1,0,0,1
2702599,2702910,311,1,0,0,2
2702636,2702971,335,0,1,0,1
2702654,2702833,179,0,1,0,2
2702911,2703823,912,0,0,1,2
2703082,2703824,742,0,0,1,1
2703824,2703874,50,1,0,0,2
2703825,2703867,42,1,0,0,1
2703868,2704149,281,0,0,1,1
2703875,2704150,275,0,0,1,2
2704150,2704229,79,1,0,0,1
2704151,2704237,86,1,0,0,2
2704230,2704591,361,0,0,1,1
2704238,2704591,353,0,0,1,2
2704592,2704631,39,1,0,0,2
2704592,2704632,40,1,0,0,1
2704632,2705366,734,0,0,1,2
2704633,2705365,732,0,0,1,1
2705366,2705414,48,1,0,0,1
2705367,2705412,45,1,0,0,2
2705413,2705705,292,0,0,1,2
2705415,2705703,288,0,0,1,1
2705704,2705789,85,1,0,0,1
2705706,2705801,95,1,0,0,2
2705790,2705879,89,0,0,1,1
2705802,2705879,77,0,0,1,2
2705880,2705912,32,1,0,0,2
2705880,2705914,34,1,0,0,1
2705913,2706143,230,0,0,1,2
2705915,2706143,228,0,0,1,1
2706144,2706170,26,1,0,0,1
2706144,2706183,39,1,0,0,2
2706171,2707367,1196,0,0,1,1
2706184,2707369,1185,0,0,1,2
2707368,2707423,55,1,0,0,1
2707370,2707420,50,1,0,0,2
2707421,2707882,461,0,0,1,2
2707424,2707864,440,0,0,1,1
2707865,2708356,491,1,0,0,1
2707883,2708249,366,1,0,0,2
2707938,2708214,276,0,1,0,1
2707944,2708143,199,0,1,0,2
2708241,2708241,0,0,1,0,1
2708250,2708735,485,0,0,1,2
2708357,2708377,20,0,0,1,1
2708378,2708540,162,1,0,0,1
2708541,2708773,232,0,0,1,1
2708736,2708751,15,1,0,0,2
2708752,2708773,21,0,0,1,2
2708774,2708806,32,1,0,0,1
2708774,2708816,42,1,0,0,2
2708807,2709004,197,0,0,1,1
2708817,2709004,187,0,0,1,2
2709005,2709059,54,1,0,0,1
2709005,2709078,73,1,0,0,2
2709060,2709097,37,0,0,1,1
2709079,2709473,394,0,0,1,2
2709098,2709160,62,1,0,0,1
2709161,2709472,311,0,0,1,1
2709473,2709532,59,1,0,0,1
2709474,2709549,75,1,0,0,2
2709533,2709847,314,0,0,1,1
2709550,2709851,301,0,0,1,2
2709848,2710216,368,1,0,0,1
2709852,2710176,324,1,0,0,2
2709884,2710167,283,0,1,0,1
2709898,2710100,202,0,1,0,2
2710177,2710944,767,0,0,1,2
2710217,2710943,726,0,0,1,1
2710944,2710992,48,1,0,0,1
2710945,2711003,58,1,0,0,2
2710993,2711173,180,0,0,1,1
2711004,2711174,170,0,0,1,2
2711174,2711224,50,1,0,0,1
2711175,2711223,48,1,0,0,2
2711224,2711350,126,0,0,1,2
2711225,2711351,126,0,0,1,1
2711351,2711385,34,1,0,0,2
2711352,2711378,26,1,0,0,1
2711379,2711646,267,0,0,1,1
2711386,2711646,260,0,0,1,2
2711647,2711683,36,1,0,0,1
2711647,2711684,37,1,0,0,2
2711684,2711875,191,0,0,1,1
2711685,2711875,190,0,0,1,2
2711876,2711916,40,1,0,0,2
2711876,2711919,43,1,0,0,1
2711917,2712108,191,0,0,1,2
2711920,2712107,187,0,0,1,1
2712108,2712151,43,1,0,0,1
2712109,2712162,53,1,0,0,2
2712152,2712339,187,0,0,1,1
2712163,2712313,150,0,0,1,2
2712314,2712322,8,1,0,0,2
2712323,2712359,36,0,0,1,2
2712340,2719603,7263,1,0,0,1
2712360,2719447,7087,1,0,0,2
2712433,2719444,7011,0,1,0,1
2712453,2719427,6974,0,1,0,2
2719448,2719538,90,0,0,1,2
2719539,2719598,59,1,0,0,2
2719599,2719712,113,0,0,1,2
2719604,2719859,255,0,0,1,1
2719713,2719727,14,1,0,0,2
2719728,2719845,117,0,0,1,2
2719846,2719894,48,1,0,0,2
2719860,2719886,26,1,0,0,1
2719887,2720155,268,0,0,1,1
2719895,2720156,261,0,0,1,2
2720156,2720187,31,1,0,0,1
2720157,2720191,34,1,0,0,2
2720188,2720351,163,0,0,1,1
2720192,2720352,160,0,0,1,2
2720352,2720385,33,1,0,0,1
2720353,2720389,36,1,0,0,2
2720386,2720512,126,0,0,1,1
2720390,2720512,122,0,0,1,2
2767738,2767822,84,0,0,1,1
2767738,2767823,85,0,0,1,2
2767823,2767863,40,1,0,0,1
2767824,2767867,43,1,0,0,2
2767864,2768042,178,0,0,1,1
2767868,2768045,177,0,0,1,2
2768043,2768111,68,1,0,0,1
2768046,2768121,75,1,0,0,2
2768112,2768195,83,0,0,1,1
2768122,2768193,71,0,0,1,2
2768194,2768230,36,1,0,0,2
2768196,2768244,48,1,0,0,1
2768231,2768616,385,0,0,1,2
2768245,2768618,373,0,0,1,1
2768617,2768652,35,1,0,0,2
2768619,2768651,32,1,0,0,1
2768652,2769660,1008,0,0,1,1
2768653,2769660,1007,0,0,1,2
2769661,2769753,92,1,0,0,1
2769661,2769753,92,1,0,0,2
2769754,2770057,303,0,0,1,2
2769754,2770058,304,0,0,1,1
2770058,2770130,72,1,0,0,2
2770059,2770130,71,1,0,0,1
2770131,2770232,101,0,0,1,1
2770131,2770232,101,0,0,1,2
2770233,2770265,32,1,0,0,2
2770233,2770266,33,1,0,0,1
2770266,2770566,300,0,0,1,2
2770267,2770559,292,0,0,1,1
2770560,2770579,19,1,0,0,1
2770567,2770580,13,1,0,0,2
2770580,2772092,1512,0,0,1,1
2770581,2772092,1511,0,0,1,2
2772093,2772180,87,1,0,0,1
2772093,2772183,90,1,0,0,2
2772181,2772306,125,0,0,1,1
2772184,2772306,122,0,0,1,2
2772307,2772375,68,1,0,0,1
2772307,2772376,69,1,0,0,2
2772376,2772485,109,0,0,1,1
2772377,2772486,109,0,0,1,2
2772486,2772517,31,1,0,0,1
2772487,2772521,34,1,0,0,2
2772518,2774485,1967,0,0,1,1
2772522,2774485,1963,0,0,1,2
2774486,2774556,70,1,0,0,2
2774486,2774558,72,1,0,0,1
2774557,2776431,1874,0,0,1,2
2774559,2776431,1872,0,0,1,1
2776432,2776494,62,1,0,0,1
2776432,2776499,67,1,0,0,2
2776495,2776606,111,0,0,1,1
2776500,2776606,106,0,0,1,2
2776607,2776637,30,1,0,0,1
2776607,2776644,37,1,0,0,2
2776638,2778011,1373,0,0,1,1
2776645,2778012,1367,0,0,1,2
2778012,2778088,76,1,0,0,1
2778013,2778091,78,1,0,0,2
2778089,2778280,191,0,0,1,1
2778092,2778282,190,0,0,1,2
2778281,2778345,64,1,0,0,1
2778283,2778363,80,1,0,0,2
2778346,2778416,70,0,0,1,1
2778364,2778417,53,0,0,1,2
2778417,2778465,48,1,0,0,1
2778418,2778493,75,1,0,0,2
2778466,2780297,1831,0,0,1,1
2778494,2780298,1804,0,0,1,2
2780298,2780370,72,1,0,0,1
2780299,2780369,70,1,0,0,2
2780370,2780453,83,0,0,1,2
2780371,2780454,83,0,0,1,1
2780454,2780490,36,1,0,0,2
2780455,2780494,39,1,0,0,1
2780491,2780741,250,0,0,1,2
2780495,2780739,244,0,0,1,1
2780740,2780785,45,1,0,0,1
2780742,2780776,34,1,0,0,2
2780777,2782297,1520,0,0,1,2
2780786,2782297,1511,0,0,1,1
2782298,2782381,83,1,0,0,1
2782298,2782391,93,1,0,0,2
2782382,2782581,199,0,0,1,1
2782392,2782581,189,0,0,1,2
2782582,2782611,29,1,0,0,1
2782582,2782612,30,1,0,0,2
2782612,2783054,442,0,0,1,1
2782613,2783054,441,0,0,1,2
2783055,2783086,31,1,0,0,2
2783055,2783088,33,1,0,0,1
2783087,2783709,622,0,0,1,2
2783089,2783708,619,0,0,1,1
2783709,2783784,75,1,0,0,1
2783710,2783783,73,1,0,0,2
2783784,2784071,287,0,0,1,2
2783785,2784070,285,0,0,1,1
2784071,2784161,90,1,0,0,1
2784072,2784165,93,1,0,0,2
2784162,2784282,120,0,0,1,1
2784166,2784281,115,0,0,1,2
2784282,2784314,32,1,0,0,2
2784283,2784304,21,1,0,0,1
2784305,2784642,337,0,0,1,1
2784315,2784641,326,0,0,1,2
2784642,2784686,44,1,0,0,2
2784643,2784673,30,1,0,0,1
2784674,2785954,1280,0,0,1,1
2784687,2785953,1266,0,0,1,2
2785954,2786050,96,1,0,0,2
2785955,2786051,96,1,0,0,1
2786051,2786122,71,0,0,1,2
2786052,2786124,72,0,0,1,1
2786123,2786189,66,1,0,0,2
2786125,2786179,54,1,0,0,1
2786180,2786487,307,0,0,1,1
2786190,2786485,295,0,0,1,2
2786486,2786518,32,1,0,0,2
2786488,2786519,31,1,0,0,1
2786519,2787935,1416,0,0,1,2
2786520,2787935,1415,0,0,1,1
2787936,2788024,88,1,0,0,1
2787936,2788118,182,1,0,0,2
2788025,2789734,1709,0,0,1,1
2788119,2788679,560,0,0,1,2
2788680,2788694,14,1,0,0,2
2788695,2789734,1039,0,0,1,2
2789735,2789840,105,1,0,0,1
2789735,2789843,108,1,0,0,2
2789841,2789934,93,0,0,1,1
2789844,2789932,88,0,0,1,2
2789933,2789980,47,1,0,0,2
2789935,2789978,43,1,0,0,1
2789979,2790254,275,0,0,1,1
2789981,2790252,271,0,0,1,2
2790253,2790274,21,1,0,0,2
2790255,2790269,14,1,0,0,1
2790270,2791367,1097,0,0,1,1
2790275,2791366,1091,0,0,1,2
2791367,2791446,79,1,0,0,2
2791368,2791446,78,1,0,0,1
2791447,2791560,113,0,0,1,2
2791447,2791566,119,0,0,1,1
2791561,2791633,72,1,0,0,2
2791567,2791641,74,1,0,0,1
2791634,2791729,95,0,0,1,2
2791642,2791729,87,0,0,1,1
2791730,2791763,33,1,0,0,1
2791730,2791770,40,1,0,0,2
2791764,2791871,107,0,0,1,1
2791771,2793106,1335,0,0,1,2
2791872,2791887,15,1,0,0,1
2791888,2793105,1217,0,0,1,1
2793106,2793257,151,1,0,0,1
2793107,2793208,101,1,0,0,2
2793209,2793324,115,0,0,1,2
2793258,2793324,66,0,0,1,1
2793325,2793353,28,1,0,0,2
2793325,2793370,45,1,0,0,1
2793354,2793634,280,0,0,1,2
2793371,2793632,261,0,0,1,1
2793633,2793666,33,1,0,0,1
2793635,2793667,32,1,0,0,2
2793667,2794403,736,0,0,1,1
2793668,2794401,733,0,0,1,2
2794402,2794473,71,1,0,0,2
2794404,2794474,70,1,0,0,1
2794474,2794743,269,0,0,1,2
2794475,2794741,266,0,0,1,1
2794742,2794796,54,1,0,0,1
2794744,2794797,53,1,0,0,2
2794797,2794903,106,0,0,1,1
2794798,2794903,105,0,0,1,2
2794904,2794930,26,1,0,0,2
2794904,2794937,33,1,0,0,1
2794931,2795308,377,0,0,1,2
2794938,2795314,376,0,0,1,1
2795309,2795341,32,1,0,0,2
2795315,2795339,24,1,0,0,1
2795340,2796310,970,0,0,1,1
2795342,2796311,969,0,0,1,2
2796311,2796374,63,1,0,0,1
2796312,2796384,72,1,0,0,2
2796375,2796484,109,0,0,1,1
2796385,2796484,99,0,0,1,2
2796485,2796514,29,1,0,0,1
2796485,2796514,29,1,0,0,2
2796515,2796695,180,0,0,1,1
2796515,2796695,180,0,0,1,2
2796696,2796726,30,1,0,0,1
2796696,2796728,32,1,0,0,2
2796727,2797291,564,0,0,1,1
2796729,2797292,563,0,0,1,2
2797292,2797359,67,1,0,0,1
2797293,2797367,74,1,0,0,2
2797360,2797548,188,0,0,1,1
2797368,2797547,179,0,0,1,2
2797548,2797617,69,1,0,0,2
2797549,2797615,66,1,0,0,1
2797616,2797701,85,0,0,1,1
2797618,2797702,84,0,0,1,2
2797702,2797761,59,1,0,0,1
2797703,2797763,60,1,0,0,2
2797762,2797876,114,0,0,1,1
2797764,2797876,112,0,0,1,2
2797877,2797905,28,1,0,0,1
2797877,2797910,33,1,0,0,2
2797906,2798773,867,0,0,1,1
2797911,2798774,863,0,0,1,2
2798774,2798824,50,1,0,0,1
2798775,2798833,58,1,0,0,2
2798825,2799089,264,0,0,1,1
2798834,2799090,256,0,0,1,2
2799090,2799149,59,1,0,0,1
2799091,2799159,68,1,0,0,2
2799150,2799278,128,0,0,1,1
2799160,2799274,114,0,0,1,2
2799275,2799308,33,1,0,0,2
2799279,2799300,21,1,0,0,1
2799301,2800298,997,0,0,1,1
2799309,2800299,990,0,0,1,2
2800299,2800375,76,1,0,0,1
2800300,2800378,78,1,0,0,2
2800376,2800622,246,0,0,1,1
2800379,2800625,246,0,0,1,2
2800623,2800697,74,1,0,0,1
2800626,2800697,71,1,0,0,2
2800698,2800906,208,0,0,1,2
2800698,2800910,212,0,0,1,1
2800907,2800936,29,1,0,0,2
2800911,2800934,23,1,0,0,1
2800935,2801225,290,0,0,1,1
2800937,2801224,287,0,0,1,2
2801225,2801257,32,1,0,0,2
2801226,2801255,29,1,0,0,1
2801256,2802051,795,0,0,1,1
2801258,2802050,792,0,0,1,2
2802051,2802166,115,1,0,0,2
2802052,2802160,108,1,0,0,1
2802161,2802232,71,0,0,1,1
2802167,2802228,61,0,0,1,2
2802229,2802283,54,1,0,0,2
2802233,2802286,53,1,0,0,1
2802284,2802552,268,0,0,1,2
2802287,2802554,267,0,0,1,1
2802553,2802582,29,1,0,0,2
2802555,2802581,26,1,0,0,1
2802582,2803864,1282,0,0,1,1
2802583,2803865,1282,0,0,1,2
2803865,2803979,114,1,0,0,1
2803866,2803972,106,1,0,0,2
2803973,2804154,181,0,0,1,2
2803980,2804152,172,0,0,1,1
2804153,2804185,32,1,0,0,1
2804155,2804187,32,1,0,0,2
2804186,2805276,1090,0,0,1,1
2804188,2805276,1088,0,0,1,2
2805277,2805346,69,1,0,0,1
2805277,2805363,86,1,0,0,2
2805347,2805504,157,0,0,1,1
2805364,2805502,138,0,0,1,2
2805503,2805585,82,1,0,0,2
2805505,2805595,90,1,0,0,1
2805586,2805695,109,0,0,1,2
2805596,2805693,97,0,0,1,1
2805694,2805726,32,1,0,0,1
2805696,2805723,27,1,0,0,2
2805724,2805857,133,0,0,1,2
2805727,2805857,130,0,0,1,1
2805858,2805887,29,1,0,0,2
2805858,2805888,30,1,0,0,1
2805888,2807458,1570,0,0,1,2
2805889,2807458,1569,0,0,1,1
2807459,2807541,82,1,0,0,1
2807459,2807544,85,1,0,0,2
2807542,2807638,96,0,0,1,1
2807545,2807638,93,0,0,1,2
2807639,2807671,32,1,0,0,1
2807639,2807686,47,1,0,0,2
2807672,2808875,1203,0,0,1,1
2807687,2808876,1189,0,0,1,2
2808876,2808991,115,1,0,0,1
2808877,2808954,77,1,0,0,2
2808955,2809173,218,0,0,1,2
2808992,2809173,181,0,0,1,1
2809174,2809241,67,1,0,0,1
2809174,2809247,73,1,0,0,2
2809242,2809327,85,0,0,1,1
2809248,2809328,80,0,0,1,2
2809328,2809355,27,1,0,0,1
2809329,2809362,33,1,0,0,2
2809356,2809634,278,0,0,1,1
2809363,2810371,1008,0,0,1,2
2809635,2809843,208,1,0,0,1
2809844,2809924,80,0,0,1,1
2809925,2809931,6,1,0,0,1
2809932,2810090,158,0,0,1,1
2810091,2810151,60,1,0,0,1
2810152,2810281,129,0,0,1,1
2810282,2810453,171,1,0,0,1
2810372,2810465,93,1,0,0,2
2810454,2810579,125,0,0,1,1
2810466,2810580,114,0,0,1,2
2810580,2810667,87,1,0,0,1
2810581,2810660,79,1,0,0,2
2810661,2810760,99,0,0,1,2
2810668,2810755,87,0,0,1,1
2810756,2810793,37,1,0,0,1
2810761,2810807,46,1,0,0,2
2810794,2811074,280,0,0,1,1
2810808,2811075,267,0,0,1,2
2811075,2811101,26,1,0,0,1
2811076,2811092,16,1,0,0,2
2811093,2811888,795,0,0,1,2
2811102,2812451,1349,0,0,1,1
2811889,2811913,24,1,0,0,2
2811914,2811957,43,0,0,1,2
2811958,2811962,4,1,0,0,2
2811963,2812158,195,0,0,1,2
2812159,2812229,70,1,0,0,2
2812230,2812293,63,0,0,1,2
2812294,2812310,16,1,0,0,2
2812311,2812463,152,0,0,1,2
2812452,2812551,99,1,0,0,1
2812464,2812553,89,1,0,0,2
2812552,2812671,119,0,0,1,1
2812554,2812669,115,0,0,1,2
2812670,2812707,37,1,0,0,2
2812672,2812709,37,1,0,0,1
2812708,2814343,1635,0,0,1,2
2812710,2814342,1632,0,0,1,1
2814343,2814497,154,1,0,0,1
2814344,2814493,149,1,0,0,2
2814494,2814547,53,0,0,1,2
2814498,2814543,45,0,0,1,1
2814544,2814576,32,1,0,0,1
2814548,2814595,47,1,0,0,2
2814577,2816093,1516,0,0,1,1
2814596,2814877,281,0,0,1,2
2814878,2814898,20,1,0,0,2
2814899,2816090,1191,0,0,1,2
2816091,2816180,89,1,0,0,2
2816094,2816194,100,1,0,0,1
2816181,2816305,124,0,0,1,2
2816195,2816305,110,0,0,1,1
2816306,2816337,31,1,0,0,1
2816306,2816340,34,1,0,0,2
2816338,2817964,1626,0,0,1,1
2816341,2817561,1220,0,0,1,2
2817562,2817594,32,1,0,0,2
2817595,2817687,92,0,0,1,2
2817688,2817810,122,1,0,0,2
2817811,2817962,151,0,0,1,2
2817963,2818045,82,1,0,0,2
2817965,2818073,108,1,0,0,1
2818046,2818144,98,0,0,1,2
2818074,2818142,68,0,0,1,1
2818143,2818175,32,1,0,0,1
2818145,2818173,28,1,0,0,2
2818174,2818595,421,0,0,1,2
2818176,2818592,416,0,0,1,1
2818593,2818623,30,1,0,0,1
2818596,2818623,27,1,0,0,2
2818624,2819790,1166,0,0,1,1
2818624,2819791,1167,0,0,1,2
2819791,2819834,43,1,0,0,1
2819792,2819840,48,1,0,0,2
2819835,2820568,733,0,0,1,1
2819841,2820570,729,0,0,1,2
2820569,2820601,32,1,0,0,1
2820571,2820599,28,1,0,0,2
2820600,2820953,353,0,0,1,2
2820602,2820952,350,0,0,1,1
2820953,2821007,54,1,0,0,1
2820954,2821002,48,1,0,0,2
2821003,2821177,174,0,0,1,2
2821008,2821176,168,0,0,1,1
2821177,2821253,76,1,0,0,1
2821178,2821256,78,1,0,0,2
2821254,2821338,84,0,0,1,1
2821257,2821337,80,0,0,1,2
2821338,2821382,44,1,0,0,2
2821339,2821382,43,1,0,0,1
2821383,2821569,186,0,0,1,1
2821383,2821573,190,0,0,1,2
2821570,2821635,65,1,0,0,1
2821574,2821602,28,1,0,0,2
2821603,2822372,769,0,0,1,2
2821636,2821839,203,0,0,1,1
2821840,2821849,9,1,0,0,1
2821850,2822076,226,0,0,1,1
2822077,2822119,42,1,0,0,1
2822120,2822230,110,0,0,1,1
2822231,2822252,21,1,0,0,1
2822253,2822374,121,0,0,1,1
2822373,2822481,108,1,0,0,2
2822375,2822466,91,1,0,0,1
2822467,2822730,263,0,0,1,1
2822482,2822731,249,0,0,1,2
2822731,2822814,83,1,0,0,1
2822732,2822811,79,1,0,0,2
2822812,2822893,81,0,0,1,2
2822815,2822894,79,0,0,1,1
2822894,2822940,46,1,0,0,2
2822895,2822937,42,1,0,0,1
2822938,2823231,293,0,0,1,1
2822941,2823230,289,0,0,1,2
2823231,2823263,32,1,0,0,2
2823232,2823260,28,1,0,0,1
2823261,2823908,647,0,0,1,1
2823264,2823903,639,0,0,1,2
2823904,2823999,95,1,0,0,2
2823909,2823986,77,1,0,0,1
2823987,2824177,190,0,0,1,1
2824000,2824178,178,0,0,1,2
2824178,2824221,43,1,0,0,1
2824179,2824234,55,1,0,0,2
2824222,2824327,105,0,0,1,1
2824235,2824329,94,0,0,1,2
2824328,2824372,44,1,0,0,1
2824330,2824360,30,1,0,0,2
2824361,2825801,1440,0,0,1,2
2824373,2824664,291,0,0,1,1
2824665,2824725,60,1,0,0,1
2824726,2825246,520,0,0,1,1
2825247,2825251,4,1,0,0,1
2825252,2825802,550,0,0,1,1
2825802,2825898,96,1,0,0,2
2825803,2825892,89,1,0,0,1
2825893,2825998,105,0,0,1,1
2825899,2825997,98,0,0,1,2
2825998,2826024,26,1,0,0,2
2825999,2826025,26,1,0,0,1
2826025,2826216,191,0,0,1,2
2826026,2826223,197,0,0,1,1
2826217,2826256,39,1,0,0,2
2826224,2826255,31,1,0,0,1
2826256,2826373,117,0,0,1,1
2826257,2826367,110,0,0,1,2
2826368,2826400,32,1,0,0,2
2826374,2826398,24,1,0,0,1
2826399,2826557,158,0,0,1,1
2826401,2826730,329,0,0,1,2
2826558,2826572,14,1,0,0,1
2826573,2826726,153,0,0,1,1
2826727,2826869,142,1,0,0,1
2826731,2826782,51,1,0,0,2
2826783,2826959,176,0,0,1,2
2826870,2826974,104,0,0,1,1
2826960,2827006,46,1,0,0,2
2826975,2827009,34,1,0,0,1
2827007,2827340,333,0,0,1,2
2827010,2827341,331,0,0,1,1
2827341,2827460,119,1,0,0,2
2827342,2827451,109,1,0,0,1
2827452,2827876,424,0,0,1,1
2827461,2827875,414,0,0,1,2
2827876,2827927,51,1,0,0,2
2827877,2827930,53,1,0,0,1
2827928,2828177,249,0,0,1,2
2827931,2828173,242,0,0,1,1
2828174,2828265,91,1,0,0,1
2828178,2828207,29,1,0,0,2
2828208,2828366,158,0,0,1,2
2828266,2828377,111,0,0,1,1
2828367,2828391,24,1,0,0,2
2828378,2828405,27,1,0,0,1
2828392,2828928,536,0,0,1,2
2828406,2829100,694,0,0,1,1
2828929,2828945,16,1,0,0,2
2828946,2829203,257,0,0,1,2
2829101,2829116,15,1,0,0,1
2829117,2829382,265,0,0,1,1
2829204,2829211,7,1,0,0,2
2829212,2829383,171,0,0,1,2
2829383,2829448,65,1,0,0,1
2829384,2829547,163,1,0,0,2
2829449,2829636,187,0,0,1,1
2829548,2829600,52,0,0,1,2
2829601,2829698,97,1,0,0,2
2829637,2829697,60,1,0,0,1
2829698,2829782,84,0,0,1,1
2829699,2829781,82,0,0,1,2
2829782,2829825,43,1,0,0,2
2829783,2829819,36,1,0,0,1
2829820,2830476,656,0,0,1,1
2829826,2830749,923,0,0,1,2
2830477,2830490,13,1,0,0,1
2830491,2830748,257,0,0,1,1
2830749,2830787,38,1,0,0,1
2830750,2830783,33,1,0,0,2
2830784,2831249,465,0,0,1,2
2830788,2831249,461,0,0,1,1
2831250,2831295,45,1,0,0,1
2831250,2831295,45,1,0,0,2
2831296,2831432,136,0,0,1,1
2831296,2831432,136,0,0,1,2
2831433,2831484,51,1,0,0,1
2831433,2831497,64,1,0,0,2
2831485,2831632,147,0,0,1,1
2831498,2831631,133,0,0,1,2
2831632,2831712,80,1,0,0,2
2831633,2831710,77,1,0,0,1
2831711,2831790,79,0,0,1,1
2831713,2831791,78,0,0,1,2
2831791,2831837,46,1,0,0,1
2831792,2831834,42,1,0,0,2
2831835,2832492,657,0,0,1,2
2831838,2832492,654,0,0,1,1
2832493,2832526,33,1,0,0,2
2832493,2832528,35,1,0,0,1
2832527,2832813,286,0,0,1,2
2832529,2832813,284,0,0,1,1
2832814,2832845,31,1,0,0,2
2832814,2832847,33,1,0,0,1
2832846,2833685,839,0,0,1,2
2832848,2833685,837,0,0,1,1
2833686,2833785,99,1,0,0,1
2833686,2833785,99,1,0,0,2
2833786,2833872,86,0,0,1,2
2833786,2833873,87,0,0,1,1
2833873,2833909,36,1,0,0,2
2833874,2833916,42,1,0,0,1
2833910,2834203,293,0,0,1,2
2833917,2834202,285,0,0,1,1
2834203,2834234,31,1,0,0,1
2834204,2834234,30,1,0,0,2
2834235,2834389,154,0,0,1,1
2834235,2834391,156,0,0,1,2
2834390,2834438,48,1,0,0,1
2834392,2834420,28,1,0,0,2
2834421,2835414,993,0,0,1,2
2834439,2835413,974,0,0,1,1
2835414,2835579,165,1,0,0,1
2835415,2835574,159,1,0,0,2
2835575,2835672,97,0,0,1,2
2835580,2835670,90,0,0,1,1
2835671,2835704,33,1,0,0,1
2835673,2835706,33,1,0,0,2
2835705,2835927,222,0,0,1,1
2835707,2835925,218,0,0,1,2
2835926,2835958,32,1,0,0,2
2835928,2835956,28,1,0,0,1
2835957,2836516,559,0,0,1,1
2835959,2836516,557,0,0,1,2
2836517,2836544,27,1,0,0,1
2836517,2836601,84,1,0,0,2
2836545,2836953,408,0,0,1,1
2836602,2836953,351,0,0,1,2
2836954,2837068,114,1,0,0,1
2836954,2837075,121,1,0,0,2
2837069,2837367,298,0,0,1,1
2837076,2837365,289,0,0,1,2
2837366,2837423,57,1,0,0,2
2837368,2837427,59,1,0,0,1
2837424,2837522,98,0,0,1,2
2837428,2837521,93,0,0,1,1
2837522,2837557,35,1,0,0,1
2837523,2837554,31,1,0,0,2
2837555,2837883,328,0,0,1,2
2837558,2837883,325,0,0,1,1
2837884,2837906,22,1,0,0,2
2837884,2837915,31,1,0,0,1
2837907,2838978,1071,0,0,1,2
2837916,2838977,1061,0,0,1,1
2838978,2839029,51,1,0,0,1
2838979,2839032,53,1,0,0,2
2839030,2839196,166,0,0,1,1
2839033,2839197,164,0,0,1,2
2839197,2839272,75,1,0,0,1
2839198,2839284,86,1,0,0,2
2839273,2839365,92,0,0,1,1
2839285,2839364,79,0,0,1,2
2839365,2839409,44,1,0,0,2
2839366,2839398,32,1,0,0,1
2839399,2840030,631,0,0,1,1
2839410,2840038,628,0,0,1,2
2840031,2840301,270,1,0,0,1
2840039,2840268,229,1,0,0,2
2840075,2840230,155,0,1,0,1
2840078,2840203,125,0,1,0,2
2840269,2840986,717,0,0,1,2
2840302,2840987,685,0,0,1,1
2840987,2841044,57,1,0,0,2
2840988,2841044,56,1,0,0,1
2841045,2841132,87,0,0,1,1
2841045,2841132,87,0,0,1,2
2841133,2841162,29,1,0,0,1
2841133,2841176,43,1,0,0,2
2841163,2842516,1353,0,0,1,1
2841177,2842516,1339,0,0,1,2
2842517,2842564,47,1,0,0,1
2842517,2842564,47,1,0,0,2
2842565,2842841,276,0,0,1,1
2842565,2842841,276,0,0,1,2
2842842,2842917,75,1,0,0,2
2842842,2842927,85,1,0,0,1
2842918,2842984,66,0,0,1,2
2842928,2842983,55,0,0,1,1
2842984,2843019,35,1,0,0,1
2842985,2843023,38,1,0,0,2
2843020,2844231,1211,0,0,1,1
2843024,2844232,1208,0,0,1,2
2844232,2844315,83,1,0,0,1
2844233,2844315,82,1,0,0,2
2844316,2844562,246,0,0,1,1
2844316,2844562,246,0,0,1,2
2844563,2844635,72,1,0,0,1
2844563,2844643,80,1,0,0,2
2844636,2844742,106,0,0,1,1
2844644,2844740,96,0,0,1,2
2844741,2844788,47,1,0,0,2
2844743,2844764,21,1,0,0,1
2844765,2844945,180,0,0,1,1
2844789,2844944,155,0,0,1,2
2844945,2844987,42,1,0,0,2
2844946,2844977,31,1,0,0,1
2844978,2845929,951,0,0,1,1
2844988,2845925,937,0,0,1,2
2845926,2846009,83,1,0,0,2
2845930,2846010,80,1,0,0,1
2846010,2846227,217,0,0,1,2
2846011,2846224,213,0,0,1,1
2846225,2846284,59,1,0,0,1
2846228,2846284,56,1,0,0,2
2846285,2846391,106,0,0,1,1
2846285,2846392,107,0,0,1,2
2846392,2846445,53,1,0,0,1
2846393,2846448,55,1,0,0,2
2846446,2846651,205,0,0,1,1
2846449,2846648,199,0,0,1,2
2846649,2846664,15,1,0,0,2
2846652,2846658,6,1,0,0,1
2846659,2847079,420,0,0,1,1
2846665,2847081,416,0,0,1,2
2847080,2847111,31,1,0,0,1
2847082,2847110,28,1,0,0,2
2847111,2848101,990,0,0,1,2
2847112,2848099,987,0,0,1,1
2848100,2848178,78,1,0,0,1
2848102,2848178,76,1,0,0,2
2848179,2848265,86,0,0,1,1
2848179,2848267,88,0,0,1,2
2848266,2848298,32,1,0,0,1
2848268,2848300,32,1,0,0,2
2848299,2849636,1337,0,0,1,1
2848301,2849636,1335,0,0,1,2
2849637,2849730,93,1,0,0,1
2849637,2849730,93,1,0,0,2
2849731,2849766,35,0,0,1,2
2849731,2849768,37,0,0,1,1
2849767,2849853,86,1,0,0,2
2849769,2849856,87,1,0,0,1
2849854,2849933,79,0,0,1,2
2849857,2849933,76,0,0,1,1
2849934,2849968,34,1,0,0,2
2849934,2849993,59,1,0,0,1
2849969,2851623,1654,0,0,1,2
2849994,2851622,1628,0,0,1,1
2851623,2851721,98,1,0,0,1
2851624,2851735,111,1,0,0,2
2851722,2851892,170,0,0,1,1
2851736,2851889,153,0,0,1,2
2851890,2851927,37,1,0,0,2
2851893,2851923,30,1,0,0,1
2851924,2852185,261,0,0,1,1
2851928,2852182,254,0,0,1,2
2852183,2852206,23,1,0,0,2
2852186,2852201,15,1,0,0,1
2852202,2853233,1031,0,0,1,1
2852207,2853231,1024,0,0,1,2
2853232,2853343,111,1,0,0,2
2853234,2853324,90,1,0,0,1
2853325,2853626,301,0,0,1,1
2853344,2853626,282,0,0,1,2
2853627,2853678,51,1,0,0,1
2853627,2853712,85,1,0,0,2
2853679,2853891,212,0,0,1,1
2853713,2853882,169,0,0,1,2
2853883,2853966,83,1,0,0,2
2853892,2853904,12,1,0,0,1
2853905,2854995,1090,0,0,1,1
2853967,2854079,112,0,0,1,2
2854080,2854125,45,1,0,0,2
2854126,2854169,43,0,0,1,2
2854170,2854186,16,1,0,0,2
2854187,2854261,74,0,0,1,2
2854262,2854298,36,1,0,0,2
2854299,2854995,696,0,0,1,2
2854996,2855041,45,1,0,0,1
2854996,2855051,55,1,0,0,2
2855042,2855458,416,0,0,1,1
2855052,2855459,407,0,0,1,2
2855459,2855510,51,1,0,0,1
2855460,2855520,60,1,0,0,2
2855511,2855712,201,0,0,1,1
2855521,2855711,190,0,0,1,2
2855712,2855741,29,1,0,0,2
2855713,2855741,28,1,0,0,1
2855742,2856118,376,0,0,1,1
2855742,2856118,376,0,0,1,2
2856119,2856150,31,1,0,0,1
2856119,2856150,31,1,0,0,2
2856151,2856251,100,0,0,1,1
2856151,2856254,103,0,0,1,2
2856252,2856280,28,1,0,0,1
2856255,2856282,27,1,0,0,2
2856281,2856447,166,0,0,1,1
2856283,2856452,169,0,0,1,2
2856448,2856479,31,1,0,0,1
2856453,2856467,14,1,0,0,2
2856468,2857350,882,0,0,1,2
2856480,2857349,869,0,0,1,1
2857350,2857396,46,1,0,0,1
2857351,2857395,44,1,0,0,2
2857396,2859790,2394,0,0,1,2
2857397,2859789,2392,0,0,1,1
2859790,2859852,62,1,0,0,1
2859791,2859851,60,1,0,0,2
2859852,2860210,358,0,0,1,2
2859853,2860210,357,0,0,1,1
2860211,2860263,52,1,0,0,1
2860211,2860272,61,1,0,0,2
2860264,2860757,493,0,0,1,1
2860273,2860756,483,0,0,1,2
2860757,2860842,85,1,0,0,2
2860758,2860828,70,1,0,0,1
2860829,2860930,101,0,0,1,1
2860843,2860929,86,0,0,1,2
2860930,2860966,36,1,0,0,2
2860931,2860959,28,1,0,0,1
2860960,2861118,158,0,0,1,1
2860967,2861119,152,0,0,1,2
2861119,2861150,31,1,0,0,1
2861120,2861152,32,1,0,0,2
2861151,2862494,1343,0,0,1,1
2861153,2862494,1341,0,0,1,2
2862495,2862531,36,1,0,0,1
2862495,2862545,50,1,0,0,2
2862532,2862691,159,0,0,1,1
2862546,2862690,144,0,0,1,2
2862691,2862722,31,1,0,0,2
2862692,2862722,30,1,0,0,1
2862723,2866319,3596,0,0,1,2
2862723,2866321,3598,0,0,1,1
2866320,2866397,77,1,0,0,2
2866322,2866397,75,1,0,0,1
2866398,2866561,163,0,0,1,1
2866398,2866561,163,0,0,1,2
2866562,2866588,26,1,0,0,1
2866562,2866592,30,1,0,0,2
2866589,2867654,1065,0,0,1,1
2866593,2867652,1059,0,0,1,2
2867653,2867708,55,1,0,0,2
2867655,2867698,43,1,0,0,1
2867699,2867859,160,0,0,1,1
2867709,2867860,151,0,0,1,2
2867860,2867893,33,1,0,0,1
2867861,2867894,33,1,0,0,2
2867894,2868491,597,0,0,1,1
2867895,2868491,596,0,0,1,2
2868492,2868527,35,1,0,0,2
2868492,2868531,39,1,0,0,1
2868528,2868718,190,0,0,1,2
2868532,2868719,187,0,0,1,1
2868719,2868742,23,1,0,0,2
2868720,2868750,30,1,0,0,1
2868743,2869783,1040,0,0,1,2
2868751,2869783,1032,0,0,1,1
2869784,2869822,38,1,0,0,1
2869784,2869822,38,1,0,0,2
2869823,2870168,345,0,0,1,1
2869823,2870168,345,0,0,1,2
2870169,2870217,48,1,0,0,1
2870169,2870217,48,1,0,0,2
2870218,2870413,195,0,0,1,1
2870218,2870414,196,0,0,1,2
2870414,2870452,38,1,0,0,1
2870415,2870460,45,1,0,0,2
2870453,2871045,592,0,0,1,1
2870461,2871043,582,0,0,1,2
2871044,2871108,64,1,0,0,2
2871046,2871108,62,1,0,0,1
2871109,2871216,107,0,0,1,2
2871109,2871217,108,0,0,1,1
2871217,2871252,35,1,0,0,2
2871218,2871286,68,1,0,0,1
2871253,2871447,194,0,0,1,2
2871287,2871445,158,0,0,1,1
2871446,2871476,30,1,0,0,1
2871448,2871473,25,1,0,0,2
2871474,2872909,1435,0,0,1,2
2871477,2872910,1433,0,0,1,1
2872910,2872942,32,1,0,0,2
2872911,2872944,33,1,0,0,1
2872943,2873165,222,0,0,1,2
2872945,2873166,221,0,0,1,1
2873166,2873242,76,1,0,0,2
2873167,2873245,78,1,0,0,1
2873243,2877274,4031,0,0,1,2
2873246,2874200,954,0,0,1,1
2874201,2874414,213,1,0,0,1
2874415,2877276,2861,0,0,1,1
2877275,2877387,112,1,0,0,2
2877277,2877387,110,1,0,0,1
2877388,2877470,82,0,0,1,1
2877388,2877472,84,0,0,1,2
2877471,2877488,17,1,0,0,1
2877473,2877493,20,1,0,0,2
2877489,2878660,1171,0,0,1,1
2877494,2878660,1166,0,0,1,2
2878661,2878716,55,1,0,0,1
2878661,2878730,69,1,0,0,2
2878717,2878818,101,0,0,1,1
2878731,2878819,88,0,0,1,2
2878819,2878843,24,1,0,0,1
2878820,2878843,23,1,0,0,2
2878844,2879072,228,0,0,1,2
2878844,2879076,232,0,0,1,1
2879073,2879100,27,1,0,0,2
2879077,2879100,23,1,0,0,1
2879101,2879294,193,0,0,1,2
2879101,2879295,194,0,0,1,1
2879295,2879323,28,1,0,0,2
2879296,2879324,28,1,0,0,1
2879324,2879610,286,0,0,1,2
2879325,2879609,284,0,0,1,1
2879610,2879640,30,1,0,0,1
2879611,2879639,28,1,0,0,2
2879640,2881926,2286,0,0,1,2
2879641,2881925,2284,0,0,1,1
2881926,2881989,63,1,0,0,1
2881927,2882009,82,1,0,0,2
2881990,2882259,269,0,0,1,1
2882010,2882259,249,0,0,1,2
2882260,2882293,33,1,0,0,1
2882260,2882293,33,1,0,0,2
2882294,2882406,112,0,0,1,1
2882294,2882406,112,0,0,1,2
2882407,2882429,22,1,0,0,1
2882407,2882439,32,1,0,0,2
2882430,2883441,1011,0,0,1,1
2882440,2883442,1002,0,0,1,2
2883442,2883498,56,1,0,0,1
2883443,2883499,56,1,0,0,2
2883499,2885977,2478,0,0,1,1
2883500,2885975,2475,0,0,1,2
2885976,2886028,52,1,0,0,2
2885978,2886029,51,1,0,0,1
2886029,2886980,951,0,0,1,2
2886030,2886982,952,0,0,1,1
2886981,2887044,63,1,0,0,2
2886983,2887037,54,1,0,0,1
2887038,2887141,103,0,0,1,1
2887045,2887142,97,0,0,1,2
2887142,2887220,78,1,0,0,1
2887143,2887222,79,1,0,0,2
2887221,2887285,64,0,0,1,1
2887223,2887288,65,0,0,1,2
2887286,2887381,95,1,0,0,1
2887289,2887355,66,1,0,0,2
2887356,2887459,103,0,0,1,2
2887382,2887459,77,0,0,1,1
2887460,2887490,30,1,0,0,1
2887460,2887490,30,1,0,0,2
2887491,2888926,1435,0,0,1,2
2887491,2888927,1436,0,0,1,1
2888927,2888984,57,1,0,0,2
2888928,2888994,66,1,0,0,1
2888985,2889239,254,0,0,1,2
2888995,2889240,245,0,0,1,1
2889240,2889272,32,1,0,0,2
2889241,2889271,30,1,0,0,1
2889272,2889814,542,0,0,1,1
2889273,2889813,540,0,0,1,2
2889814,2889850,36,1,0,0,2
2889815,2889848,33,1,0,0,1
2889849,2890039,190,0,0,1,1
2889851,2890038,187,0,0,1,2
2890039,2890075,36,1,0,0,2
2890040,2890077,37,1,0,0,1
2890076,2890992,916,0,0,1,2
2890078,2890993,915,0,0,1,1
2890993,2891080,87,1,0,0,2
2890994,2891011,17,1,0,0,1
2891012,2891034,22,0,0,1,1
2891035,2891064,29,1,0,0,1
2891065,2891511,446,0,0,1,1
2891081,2891511,430,0,0,1,2
2891512,2891805,293,1,0,0,2
2891512,2891883,371,1,0,0,1
2891570,2891771,201,0,1,0,1
2891591,2891715,124,0,1,0,2
2891806,2892731,925,0,0,1,2
2891884,2892731,847,0,0,1,1
2892732,2892784,52,1,0,0,1
2892732,2892804,72,1,0,0,2
2892785,2893004,219,0,0,1,1
2892805,2893001,196,0,0,1,2
2893002,2893035,33,1,0,0,2
2893005,2893035,30,1,0,0,1
2893036,2893215,179,0,0,1,2
2893036,2893375,339,0,0,1,1
2893216,2893253,37,1,0,0,2
2893254,2893289,35,0,0,1,2
2893290,2893295,5,1,0,0,2
2893296,2893375,79,0,0,1,2
2893376,2893409,33,1,0,0,1
2893376,2893410,34,1,0,0,2
2893410,2893819,409,0,0,1,1
2893411,2893745,334,0,0,1,2
2893746,2893761,15,1,0,0,2
2893762,2893811,49,0,0,1,2
2893812,2893857,45,1,0,0,2
2893820,2893848,28,1,0,0,1
2893849,2893989,140,0,0,1,1
2893858,2893987,129,0,0,1,2
2893988,2894028,40,1,0,0,2
2893990,2894037,47,1,0,0,1
2894029,2894718,689,0,0,1,2
2894038,2894721,683,0,0,1,1
2894719,2894751,32,1,0,0,2
2894722,2894740,18,1,0,0,1
2894741,2896187,1446,0,0,1,1
2894752,2896187,1435,0,0,1,2
2896188,2896215,27,1,0,0,2
2896188,2896227,39,1,0,0,1
2896216,2896544,328,0,0,1,2
2896228,2897455,1227,0,0,1,1
2896545,2896565,20,1,0,0,2
2896566,2897044,478,0,0,1,2
2897045,2897052,7,1,0,0,2
2897053,2897084,31,0,0,1,2
2897085,2897112,27,1,0,0,2
2897113,2897350,237,0,0,1,2
2897351,2897399,48,1,0,0,2
2897400,2897445,45,0,0,1,2
2897446,2897547,101,1,0,0,2
2897456,2897559,103,1,0,0,1
2897548,2897655,107,0,0,1,2
2897560,2897655,95,0,0,1,1
2897656,2897682,26,1,0,0,2
2897656,2897691,35,1,0,0,1
2897683,2897990,307,0,0,1,2
2897692,2899387,1695,0,0,1,1
2897991,2897997,6,1,0,0,2
2897998,2899386,1388,0,0,1,2
2899387,2899431,44,1,0,0,2
2899388,2899427,39,1,0,0,1
2899428,2899688,260,0,0,1,1
2899432,2899687,255,0,0,1,2
2899688,2899720,32,1,0,0,2
2899689,2899717,28,1,0,0,1
2899718,2899874,156,0,0,1,1
2899721,2899874,153,0,0,1,2
2899875,2899904,29,1,0,0,2
2899875,2899911,36,1,0,0,1
2899905,2900151,246,0,0,1,2
2899912,2900151,239,0,0,1,1
2900152,2900176,24,1,0,0,1
2900152,2900186,34,1,0,0,2
2900177,2901510,1333,0,0,1,1
2900187,2901507,1320,0,0,1,2
2901508,2901555,47,1,0,0,2
2901511,2901547,36,1,0,0,1
2901548,2902468,920,0,0,1,1
2901556,2902468,912,0,0,1,2
2902469,2902514,45,1,0,0,2
2902469,2902516,47,1,0,0,1
2902515,2903403,888,0,0,1,2
2902517,2903403,886,0,0,1,1
2903404,2903447,43,1,0,0,1
2903404,2903456,52,1,0,0,2
2903448,2903575,127,0,0,1,1
2903457,2903575,118,0,0,1,2
2903576,2903598,22,1,0,0,1
2903576,2903604,28,1,0,0,2
2903599,2903784,185,0,0,1,1
2903605,2903972,367,0,0,1,2
2903785,2903793,8,1,0,0,1
2903794,2903971,177,0,0,1,1
2903972,2903998,26,1,0,0,1
2903973,2903991,18,1,0,0,2
2903992,2904220,228,0,0,1,2
2903999,2904222,223,0,0,1,1
2904221,2904252,31,1,0,0,2
2904223,2904249,26,1,0,0,1
2904250,2904387,137,0,0,1,1
2904253,2904386,133,0,0,1,2
2904387,2904453,66,1,0,0,2
2904388,2904516,128,1,0,0,1
2904454,2904667,213,0,0,1,2
2904517,2904667,150,0,0,1,1
2904668,2904698,30,1,0,0,1
2904668,2904701,33,1,0,0,2
2904699,2907669,2970,0,0,1,1
2904702,2907668,2966,0,0,1,2
2907669,2907731,62,1,0,0,2
2907670,2907726,56,1,0,0,1
2907727,2907846,119,0,0,1,1
2907732,2907844,112,0,0,1,2
2907845,2907874,29,1,0,0,2
2907847,2907874,27,1,0,0,1
2907875,2908033,158,0,0,1,1
2907875,2908034,159,0,0,1,2
2908034,2908054,20,1,0,0,1
2908035,2908064,29,1,0,0,2
2908055,2908956,901,0,0,1,1
2908065,2908951,886,0,0,1,2
2908952,2908976,24,1,0,0,2
2908957,2908976,19,1,0,0,1
2908977,2909520,543,0,0,1,1
2908977,2909520,543,0,0,1,2
2909521,2909564,43,1,0,0,1
2909521,2909575,54,1,0,0,2
2909565,2909788,223,0,0,1,1
2909576,2909787,211,0,0,1,2
2909788,2909822,34,1,0,0,2
2909789,2909819,30,1,0,0,1
2909820,2913356,3536,0,0,1,1
2909823,2913357,3534,0,0,1,2
2913357,2913421,64,1,0,0,1
2913358,2913420,62,1,0,0,2
2913421,2913520,99,0,0,1,2
2913422,2913520,98,0,0,1,1
2913521,2913550,29,1,0,0,2
2913521,2913552,31,1,0,0,1
2913551,2913779,228,0,0,1,2
2913553,2913774,221,0,0,1,1
2913775,2913800,25,1,0,0,1
2913780,2913795,15,1,0,0,2
2913796,2914988,1192,0,0,1,2
2913801,2914988,1187,0,0,1,1
2914989,2915039,50,1,0,0,1
2914989,2915049,60,1,0,0,2
2915040,2918813,3773,0,0,1,1
2915050,2918814,3764,0,0,1,2
2918814,2918903,89,1,0,0,1
2918815,2918894,79,1,0,0,2
2918895,2919012,117,0,0,1,2
2918904,2919011,107,0,0,1,1
2919012,2919045,33,1,0,0,1
2919013,2919049,36,1,0,0,2
2919046,2919215,169,0,0,1,1
2919050,2919215,165,0,0,1,2
2919216,2919247,31,1,0,0,1
2919216,2919249,33,1,0,0,2
2919248,2920646,1398,0,0,1,1
2919250,2920645,1395,0,0,1,2
2920646,2920716,70,1,0,0,2
2920647,2920709,62,1,0,0,1
2920710,2921020,310,0,0,1,1
2920717,2921021,304,0,0,1,2
2921021,2921046,25,1,0,0,1
2921022,2921058,36,1,0,0,2
2921047,2924597,3550,0,0,1,1
2921059,2924597,3538,0,0,1,2
2924598,2924677,79,1,0,0,1
2924598,2924691,93,1,0,0,2
2924678,2924830,152,0,0,1,1
2924692,2924837,145,0,0,1,2
2924831,2924858,27,1,0,0,1
2924838,2924861,23,1,0,0,2
2924859,2925618,759,0,0,1,1
2924862,2925619,757,0,0,1,2
2925619,2925654,35,1,0,0,1
2925620,2925655,35,1,0,0,2
2925655,2926474,819,0,0,1,1
2925656,2926474,818,0,0,1,2
2926475,2926507,32,1,0,0,1
2926475,2926519,44,1,0,0,2
2926508,2930509,4001,0,0,1,1
2926520,2930508,3988,0,0,1,2
2930509,2930623,114,1,0,0,2
2930510,2930629,119,1,0,0,1
2930624,2930689,65,0,0,1,2
2930630,2930690,60,0,0,1,1
2930690,2930722,32,1,0,0,2
2930691,2930723,32,1,0,0,1
2930723,2930842,119,0,0,1,2
2930724,2930849,125,0,0,1,1
2930843,2930869,26,1,0,0,2
2930850,2930869,19,1,0,0,1
2930870,2931929,1059,0,0,1,2
2930870,2932155,1285,0,0,1,1
2931930,2931973,43,1,0,0,2
2931974,2932158,184,0,0,1,2
2932156,2932258,102,1,0,0,1
2932159,2932206,47,1,0,0,2
2932207,2935931,3724,0,0,1,2
2932259,2935932,3673,0,0,1,1
2935932,2936013,81,1,0,0,2
2935933,2936012,79,1,0,0,1
2936013,2936113,100,0,0,1,1
2936014,2936113,99,0,0,1,2
2936114,2936150,36,1,0,0,2
2936114,2936152,38,1,0,0,1
2936151,2937978,1827,0,0,1,2
2936153,2937083,930,0,0,1,1
2937084,2937281,197,1,0,0,1
2937282,2937977,695,0,0,1,1
2937978,2938041,63,1,0,0,1
2937979,2938047,68,1,0,0,2
2938042,2941959,3917,0,0,1,1
2938048,2941958,3910,0,0,1,2
2941959,2942032,73,1,0,0,2
2941960,2942031,71,1,0,0,1
2942032,2942140,108,0,0,1,1
2942033,2942140,107,0,0,1,2
2942141,2942173,32,1,0,0,1
2942141,2942175,34,1,0,0,2
2942174,2942363,189,0,0,1,1
2942176,2942364,188,0,0,1,2
2942364,2942397,33,1,0,0,1
2942365,2942396,31,1,0,0,2
2942397,2943467,1070,0,0,1,2
2942398,2943466,1068,0,0,1,1
2943467,2943514,47,1,0,0,1
2943468,2943516,48,1,0,0,2
2943515,2946888,3373,0,0,1,1
2943517,2946888,3371,0,0,1,2
2946889,2946957,68,1,0,0,2
2946889,2946963,74,1,0,0,1
2946958,2947053,95,0,0,1,2
2946964,2947051,87,0,0,1,1
2947052,2947100,48,1,0,0,1
2947054,2947100,46,1,0,0,2
2947101,2949079,1978,0,0,1,1
2947101,2949080,1979,0,0,1,2
2949080,2949129,49,1,0,0,1
2949081,2949149,68,1,0,0,2
2949130,2949347,217,0,0,1,1
2949150,2949349,199,0,0,1,2
2949348,2949383,35,1,0,0,1
2949350,2949385,35,1,0,0,2
2949384,2953172,3788,0,0,1,1
2949386,2953172,3786,0,0,1,2
2953173,2953221,48,1,0,0,2
2953173,2953224,51,1,0,0,1
2953222,2953891,669,0,0,1,2
2953225,2953886,661,0,0,1,1
2953887,2954357,470,1,0,0,1
2953892,2954154,262,1,0,0,2
2953946,2954178,232,0,1,0,1
2953962,2954081,119,0,1,0,2
2954155,2954275,120,0,0,1,2
2954276,2954307,31,1,0,0,2
2954308,2955139,831,0,0,1,2
2954358,2955139,781,0,0,1,1
2955140,2955191,51,1,0,0,1
2955140,2955200,60,1,0,0,2
2955192,2958522,3330,0,0,1,1
2955201,2958521,3320,0,0,1,2
2958522,2958577,55,1,0,0,2
2958523,2958606,83,1,0,0,1
2958578,2958680,102,0,0,1,2
2958607,2958681,74,0,0,1,1
2958681,2958729,48,1,0,0,2
2958682,2958723,41,1,0,0,1
2958724,2959576,852,0,0,1,1
2958730,2959576,846,0,0,1,2
2959577,2959603,26,1,0,0,1
2959577,2959607,30,1,0,0,2
2959604,2960319,715,0,0,1,1
2959608,2960320,712,0,0,1,2
2960320,2960394,74,1,0,0,1
2960321,2960389,68,1,0,0,2
2960390,2960867,477,0,0,1,2
2960395,2960851,456,0,0,1,1
2960852,2961381,529,1,0,0,1
2960868,2961192,324,1,0,0,2
2960917,2961201,284,0,1,0,1
2960951,2961093,142,0,1,0,2
2961193,2962408,1215,0,0,1,2
2961382,2961717,335,0,0,1,1
2961718,2961794,76,1,0,0,1
2961795,2962407,612,0,0,1,1
2962408,2962477,69,1,0,0,1
2962409,2962478,69,1,0,0,2
2962478,2962691,213,0,0,1,1
2962479,2962691,212,0,0,1,2
2962692,2962756,64,1,0,0,1
2962692,2962766,74,1,0,0,2
2962757,2964267,1510,0,0,1,1
2962767,2964266,1499,0,0,1,2
2964267,2964407,140,1,0,0,2
2964268,2964333,65,1,0,0,1
2964334,2964448,114,0,0,1,1
2964408,2964448,40,0,0,1,2
2964449,2964497,48,1,0,0,1
2964449,2964517,68,1,0,0,2
2964498,2964633,135,0,0,1,1
2964518,2964636,118,0,0,1,2
2964634,2964652,18,1,0,0,1
2964637,2964765,128,1,0,0,2
2964653,2964993,340,0,0,1,1
2964766,2965003,237,0,0,1,2
2964994,2965024,30,1,0,0,1
2965004,2965075,71,1,0,0,2
2965025,2965298,273,0,0,1,1
2965076,2965300,224,0,0,1,2
2965299,2965331,32,1,0,0,1
2965301,2965362,61,1,0,0,2
2965332,2966103,771,0,0,1,1
2965363,2965492,129,0,0,1,2
2965493,2965716,223,1,0,0,2
2965717,2965744,27,0,0,1,2
2965745,2965841,96,1,0,0,2
2965842,2965939,97,0,0,1,2
2965940,2965969,29,1,0,0,2
2965970,2966000,30,0,0,1,2
2966001,2966031,30,1,0,0,2
2966032,2966066,34,0,0,1,2
2966067,2966083,16,1,0,0,2
2966084,2966106,22,0,0,1,2
2966104,2966137,33,1,0,0,1
2966107,2966148,41,1,0,0,2
2966138,2966285,147,0,0,1,1
2966149,2966291,142,0,0,1,2
2966286,2966302,16,1,0,0,1
2966292,2966337,45,1,0,0,2
2966303,2966403,100,0,0,1,1
2966338,2966404,66,0,0,1,2
2966404,2966449,45,1,0,0,1
2966405,2966450,45,1,0,0,2
2966450,2966673,223,0,0,1,1
2966451,2966676,225,0,0,1,2
2966674,2966695,21,1,0,0,1
2966677,2966691,14,1,0,0,2
2966692,2966913,221,0,0,1,2
2966696,2966914,218,0,0,1,1
2966914,2966945,31,1,0,0,2
2966915,2966945,30,1,0,0,1
2966946,2968537,1591,0,0,1,1
2966946,2968538,1592,0,0,1,2
2968538,2968594,56,1,0,0,1
2968539,2968594,55,1,0,0,2
2968595,2969064,469,0,0,1,1
2968595,2969065,470,0,0,1,2
2969065,2969592,527,1,0,0,1
2969066,2969447,381,1,0,0,2
2969142,2969435,293,0,1,0,1
2969160,2969352,192,0,1,0,2
2969448,2969477,29,0,0,1,2
2969470,2969470,0,0,1,0,1
2969478,2969488,10,1,0,0,2
2969489,2969557,68,0,0,1,2
2969498,2969499,1,0,1,0,1
2969558,2969701,143,1,0,0,2
2969593,2969652,59,0,0,1,1
2969653,2969699,46,1,0,0,1
2969700,2969935,235,0,0,1,1
2969702,2969934,232,0,0,1,2
2969935,2970014,79,1,0,0,2
2969936,2970019,83,1,0,0,1
2970015,2970099,84,0,0,1,2
2970020,2970098,78,0,0,1,1
2970099,2970141,42,1,0,0,1
2970100,2970128,28,1,0,0,2
2970129,2970312,183,0,0,1,2
2970142,2970313,171,0,0,1,1
2970313,2970345,32,1,0,0,2
2970314,2970344,30,1,0,0,1
2970345,2971119,774,0,0,1,1
2970346,2971120,774,0,0,1,2
2971120,2971162,42,1,0,0,1
2971121,2971161,40,1,0,0,2
2971162,2971259,97,0,0,1,2
2971163,2971259,96,0,0,1,1
2971260,2971306,46,1,0,0,2
2971260,2971311,51,1,0,0,1
2971307,2971491,184,0,0,1,2
2971312,2971492,180,0,0,1,1
2971492,2971521,29,1,0,0,2
2971493,2971523,30,1,0,0,1
2971522,2972195,673,0,0,1,2
2971524,2972195,671,0,0,1,1
2972196,2972217,21,1,0,0,1
2972196,2972217,21,1,0,0,2
2972218,2972525,307,0,0,1,1
2972218,2972525,307,0,0,1,2
2972526,2972556,30,1,0,0,1
2972526,2972557,31,1,0,0,2
2972557,2973411,854,0,0,1,1
2972558,2973410,852,0,0,1,2
2973411,2973474,63,1,0,0,2
2973412,2973466,54,1,0,0,1
2973467,2973781,314,0,0,1,1
2973475,2973782,307,0,0,1,2
2973782,2973825,43,1,0,0,1
2973783,2973838,55,1,0,0,2
2973826,2974686,860,0,0,1,1
2973839,2974687,848,0,0,1,2
2974687,2974772,85,1,0,0,1
2974688,2974788,100,1,0,0,2
2974773,2974864,91,0,0,1,1
2974789,2974863,74,0,0,1,2
2974864,2974909,45,1,0,0,2
2974865,2974894,29,1,0,0,1
2974895,2975144,249,0,0,1,1
2974910,2975137,227,0,0,1,2
2975138,2975166,28,1,0,0,2
2975145,2975156,11,1,0,0,1
2975157,2975622,465,0,0,1,1
2975167,2975622,455,0,0,1,2
2975623,2975655,32,1,0,0,1
2975623,2975657,34,1,0,0,2
2975656,2975813,157,0,0,1,1
2975658,2975813,155,0,0,1,2
2975814,2975876,62,1,0,0,1
2975814,2975888,74,1,0,0,2
2975877,2976399,522,0,0,1,1
2975889,2976398,509,0,0,1,2
2976399,2976434,35,1,0,0,2
2976400,2976435,35,1,0,0,1
2976435,2977937,1502,0,0,1,2
2976436,2977938,1502,0,0,1,1
2977938,2978012,74,1,0,0,2
2977939,2978002,63,1,0,0,1
2978003,2978294,291,0,0,1,1
2978013,2978293,280,0,0,1,2
2978294,2978342,48,1,0,0,2
2978295,2978346,51,1,0,0,1
2978343,2978508,165,0,0,1,2
2978347,2978508,161,0,0,1,1
2978509,2978550,41,1,0,0,1
2978509,2978553,44,1,0,0,2
2978551,2979146,595,0,0,1,1
2978554,2979148,594,0,0,1,2
2979147,2979225,78,1,0,0,1
2979149,2979224,75,1,0,0,2
2979225,2979331,106,0,0,1,2
2979226,2979332,106,0,0,1,1
2979332,2979362,30,1,0,0,2
2979333,2979360,27,1,0,0,1
2979361,2979528,167,0,0,1,1
2979363,2979527,164,0,0,1,2
2979528,2979566,38,1,0,0,2
2979529,2979556,27,1,0,0,1
2979557,2980142,585,0,0,1,1
2979567,2980134,567,0,0,1,2
2980135,2980163,28,1,0,0,2
2980143,2980152,9,1,0,0,1
2980153,2980980,827,0,0,1,1
2980164,2980979,815,0,0,1,2
2980980,2981051,71,1,0,0,2
2980981,2981043,62,1,0,0,1
2981044,2981086,42,0,0,1,1
2981052,2981862,810,0,0,1,2
2981087,2981119,32,1,0,0,1
2981120,2981860,740,0,0,1,1
2981861,2981911,50,1,0,0,1
2981863,2981915,52,1,0,0,2
2981912,2982709,797,0,0,1,1
2981916,2982565,649,0,0,1,2
2982566,2982582,16,1,0,0,2
2982583,2982632,49,0,0,1,2
2982633,2982690,57,1,0,0,2
2982691,2983013,322,0,0,1,2
2982710,2982730,20,1,0,0,1
2982731,2983279,548,0,0,1,1
2983014,2983035,21,1,0,0,2
2983036,2983278,242,0,0,1,2
2983279,2983625,346,1,0,0,2
2983280,2983390,110,1,0,0,1
2983391,2983572,181,0,0,1,1
2983573,2983623,50,1,0,0,1
2983624,2985093,1469,0,0,1,1
2983626,2985096,1470,0,0,1,2
2985094,2985186,92,1,0,0,1
2985097,2985145,48,1,0,0,2
2985146,2985254,108,0,0,1,2
2985187,2985254,67,0,0,1,1
2985255,2985285,30,1,0,0,1
2985255,2985288,33,1,0,0,2
2985286,2985593,307,0,0,1,1
2985289,2985588,299,0,0,1,2
2985589,2985618,29,1,0,0,2
2985594,2985618,24,1,0,0,1
2985619,2985766,147,0,0,1,1
2985619,2985766,147,0,0,1,2
2985767,2985798,31,1,0,0,2
2985767,2985809,42,1,0,0,1
2985799,2987036,1237,0,0,1,2
2985810,2986455,645,0,0,1,1
2986456,2986460,4,1,0,0,1
2986461,2987037,576,0,0,1,1
2987037,2987090,53,1,0,0,2
2987038,2987078,40,1,0,0,1
2987079,2991051,3972,0,0,1,1
2987091,2991050,3959,0,0,1,2
2991051,2991108,57,1,0,0,2
2991052,2991108,56,1,0,0,1
2991109,2991234,125,0,0,1,1
2991109,2991236,127,0,0,1,2
2991235,2991262,27,1,0,0,1
2991237,2991267,30,1,0,0,2
2991263,2991682,419,0,0,1,1
2991268,2991682,414,0,0,1,2
2991683,2991717,34,1,0,0,1
2991683,2991718,35,1,0,0,2
2991718,2992205,487,0,0,1,1
2991719,2992203,484,0,0,1,2
2992204,2992237,33,1,0,0,2
2992206,2992237,31,1,0,0,1
2992238,2993134,896,0,0,1,1
2992238,2993134,896,0,0,1,2
2993135,2993184,49,1,0,0,1
2993135,2993187,52,1,0,0,2
2993185,2993671,486,0,0,1,1
2993188,2993671,483,0,0,1,2
2993672,2993708,36,1,0,0,1
2993672,2993710,38,1,0,0,2
2993709,2995644,1935,0,0,1,1
2993711,2995644,1933,0,0,1,2
2995645,2995703,58,1,0,0,1
2995645,2995713,68,1,0,0,2
2995704,2997324,1620,0,0,1,1
2995714,2997322,1608,0,0,1,2
2997323,2997390,67,1,0,0,2
2997325,2997389,64,1,0,0,1
2997390,2999126,1736,0,0,1,1
2997391,2999128,1737,0,0,1,2
2999127,2999193,66,1,0,0,1
2999129,2999199,70,1,0,0,2
2999194,3001669,2475,0,0,1,1
2999200,3001669,2469,0,0,1,2
3001670,3001976,306,1,0,0,2
3001670,3001986,316,1,0,0,1
3001739,3001919,180,0,1,0,1
3001744,3001896,152,0,1,0,2
3001977,3002960,983,0,0,1,2
3001987,3002960,973,0,0,1,1
3002961,3002997,36,1,0,0,1
3002961,3003006,45,1,0,0,2
3002998,3003146,148,0,0,1,1
3003007,3003142,135,0,0,1,2
3003143,3003168,25,1,0,0,2
3003147,3003165,18,1,0,0,1
3003166,3004506,1340,0,0,1,1
3003169,3004504,1335,0,0,1,2
3004505,3004567,62,1,0,0,2
3004507,3004564,57,1,0,0,1
3004565,3008021,3456,0,0,1,1
3004568,3008021,3453,0,0,1,2
