start,end,duration,saccade,blink,fixation,eye
15172618,15172734,116,0,0,1,1
15172618,15172748,130,0,0,1,2
15172735,15173619,884,1,0,0,1
15172749,15172906,157,1,0,0,2
15172756,15173608,852,0,1,0,1
15172760,15172870,110,0,1,0,2
15172907,15172984,77,0,0,1,2
15172985,15173709,724,1,0,0,2
15173021,15173609,588,0,1,0,2
15173620,15173677,57,0,0,1,1
15173678,15173703,25,1,0,0,1
15173704,15175716,2012,0,0,1,1
15173710,15175715,2005,0,0,1,2
15175716,15176153,437,1,0,0,2
15175717,15176142,425,1,0,0,1
15175850,15176107,257,0,1,0,1
15175856,15176088,232,0,1,0,2
15176143,15176245,102,0,0,1,1
15176154,15176247,93,0,0,1,2
15176246,15176317,71,1,0,0,1
15176248,15176318,70,1,0,0,2
15176318,15176458,140,0,0,1,1
15176319,15176458,139,0,0,1,2
15176459,15176478,19,1,0,0,1
15176459,15176482,23,1,0,0,2
15176479,15176820,341,0,0,1,1
15176483,15176820,337,0,0,1,2
15176821,15176908,87,1,0,0,1
15176821,15177612,791,1,0,0,2
15176909,15176977,68,0,0,1,1
15176978,15177558,580,1,0,0,1
15177028,15177578,550,0,1,0,2
15177033,15177547,514,0,1,0,1
15177559,15177866,307,0,0,1,1
15177613,15177866,253,0,0,1,2
15177867,15177946,79,1,0,0,1
15177867,15177960,93,1,0,0,2
15177947,15178597,650,0,0,1,1
15177961,15178588,627,0,0,1,2
15178589,15178636,47,1,0,0,2
15178598,15178635,37,1,0,0,1
15178636,15178805,169,0,0,1,1
15178637,15178797,160,0,0,1,2
15178798,15179035,237,1,0,0,2
15178806,15179047,241,1,0,0,1
15178843,15179003,160,0,1,0,2
15178847,15178999,152,0,1,0,1
15179036,15179098,62,0,0,1,2
15179048,15179099,51,0,0,1,1
15179099,15179125,26,1,0,0,2
15179100,15179124,24,1,0,0,1
15179125,15179290,165,0,0,1,1
15179126,15179296,170,0,0,1,2
15179291,15179301,10,1,0,0,1
15179297,15179301,4,1,0,0,2
15179302,15179671,369,0,0,1,1
15179302,15179671,369,0,0,1,2
15179672,15181422,1750,1,0,0,1
15179672,15181477,1805,1,0,0,2
15179819,15181233,1414,0,1,0,1
15179829,15181464,1635,0,1,0,2
15181256,15181395,139,0,1,0,1
15181423,15181657,234,0,0,1,1
15181478,15181652,174,0,0,1,2
15181653,15182519,866,1,0,0,2
15181658,15181715,57,1,0,0,1
15181698,15182471,773,0,1,0,2
15181716,15182317,601,0,0,1,1
15182318,15182485,167,1,0,0,1
15182362,15182453,91,0,1,0,1
15182486,15182603,117,0,0,1,1
15182520,15182597,77,0,0,1,2
15182598,15183291,693,1,0,0,2
15182604,15183299,695,1,0,0,1
15182620,15182763,143,0,1,0,2
15182624,15182760,136,0,1,0,1
15182856,15183168,312,0,1,0,1
15182861,15183129,268,0,1,0,2
15183190,15183264,74,0,1,0,1
15183208,15183239,31,0,1,0,2
15183292,15183368,76,0,0,1,2
15183300,15183367,67,0,0,1,1
15183368,15183403,35,1,0,0,1
15183369,15183407,38,1,0,0,2
15183404,15183553,149,0,0,1,1
15183408,15183551,143,0,0,1,2
15183552,15183567,15,1,0,0,2
15183554,15183564,10,1,0,0,1
15183565,15183592,27,0,0,1,1
15183568,15183593,25,0,0,1,2
15183593,15184639,1046,1,0,0,1
15183594,15184638,1044,1,0,0,2
15183646,15184628,982,0,1,0,1
15183657,15184628,971,0,1,0,2
15184639,15184692,53,0,0,1,2
15184640,15184691,51,0,0,1,1
15184692,15184721,29,1,0,0,1
15184693,15184722,29,1,0,0,2
15184722,15186033,1311,0,0,1,1
15184723,15184913,190,0,0,1,2
15184914,15184924,10,1,0,0,2
15184925,15186038,1113,0,0,1,2
15186034,15186455,421,1,0,0,1
15186039,15186481,442,1,0,0,2
15186057,15186210,153,0,1,0,1
15186061,15186470,409,0,1,0,2
15186242,15186407,165,0,1,0,1
15186456,15186513,57,0,0,1,1
15186482,15186505,23,0,0,1,2
15186506,15186525,19,1,0,0,2
15186514,15186522,8,1,0,0,1
15186523,15189014,2491,0,0,1,1
15186526,15186688,162,0,0,1,2
15186689,15186699,10,1,0,0,2
15186700,15189013,2313,0,0,1,2
15189014,15189054,40,1,0,0,2
15189015,15189056,41,1,0,0,1
15189055,15189259,204,0,0,1,2
15189057,15189174,117,0,0,1,1
15189175,15189193,18,1,0,0,1
15189194,15190797,1603,0,0,1,1
15189260,15189291,31,1,0,0,2
15189292,15190798,1506,0,0,1,2
15190798,15191008,210,1,0,0,1
15190799,15191036,237,1,0,0,2
15190824,15190959,135,0,1,0,1
15190826,15190969,143,0,1,0,2
15191009,15191080,71,0,0,1,1
15191037,15191084,47,0,0,1,2
15191081,15191093,12,1,0,0,1
15191085,15191096,11,1,0,0,2
15191094,15192976,1882,0,0,1,1
15191097,15191335,238,0,0,1,2
15191336,15191346,10,1,0,0,2
15191347,15192976,1629,0,0,1,2
15192977,15193066,89,1,0,0,1
15192977,15193070,93,1,0,0,2
15193067,15193141,74,0,0,1,1
15193071,15193143,72,0,0,1,2
15193142,15193173,31,1,0,0,1
15193144,15193766,622,1,0,0,2
15193174,15193311,137,0,0,1,1
15193178,15193724,546,0,1,0,2
15193312,15193322,10,1,0,0,1
15193323,15195395,2072,0,0,1,1
15193767,15193788,21,0,0,1,2
15193799,15195504,1705,0,1,0,2
15195396,15195466,70,1,0,0,1
15195467,15195566,99,0,0,1,1
15195514,15195514,0,1,0,0,2
15195515,15195566,51,0,0,1,2
15195567,15195577,10,1,0,0,1
15195567,15195577,10,1,0,0,2
15195578,15197468,1890,0,0,1,1
15195578,15197468,1890,0,0,1,2
15197469,15197536,67,1,0,0,1
15197469,15197539,70,1,0,0,2
15197537,15197639,102,0,0,1,1
15197540,15198110,570,0,0,1,2
15197640,15197645,5,1,0,0,1
15197646,15197797,151,0,0,1,1
15197798,15197803,5,1,0,0,1
15197804,15199486,1682,0,0,1,1
15198111,15198161,50,1,0,0,2
15198162,15199490,1328,0,0,1,2
15199487,15200796,1309,1,0,0,1
15199491,15200844,1353,1,0,0,2
15199527,15200761,1234,0,1,0,1
15199529,15200807,1278,0,1,0,2
15200797,15202736,1939,0,0,1,1
15200845,15201519,674,0,0,1,2
15201520,15201536,16,1,0,0,2
15201537,15202442,905,0,0,1,2
15202443,15202474,31,1,0,0,2
15202475,15202690,215,0,0,1,2
15202691,15202822,131,1,0,0,2
15202737,15202803,66,1,0,0,1
15202804,15202885,81,0,0,1,1
15202823,15202885,62,0,0,1,2
15202886,15202907,21,1,0,0,2
15202886,15202908,22,1,0,0,1
15202908,15204907,1999,0,0,1,2
15202909,15203337,428,0,0,1,1
15203338,15203347,9,1,0,0,1
15203348,15203734,386,0,0,1,1
15203735,15203750,15,1,0,0,1
15203751,15203981,230,0,0,1,1
15203982,15204077,95,1,0,0,1
15204078,15204157,79,0,0,1,1
15204158,15204234,76,1,0,0,1
15204235,15204382,147,0,0,1,1
15204383,15204515,132,1,0,0,1
15204516,15204825,309,0,0,1,1
15204826,15204953,127,1,0,0,1
15204908,15204954,46,1,0,0,2
15204954,15207118,2164,0,0,1,1
15204955,15207118,2163,0,0,1,2
15207119,15207200,81,1,0,0,2
15207119,15207206,87,1,0,0,1
15207201,15207297,96,0,0,1,2
15207207,15207300,93,0,0,1,1
15207298,15207381,83,1,0,0,2
15207301,15207337,36,1,0,0,1
15207338,15209108,1770,0,0,1,1
15207382,15209109,1727,0,0,1,2
15209109,15210466,1357,1,0,0,1
15209110,15212605,3495,1,0,0,2
15209161,15210457,1296,0,1,0,1
15209165,15212594,3429,0,1,0,2
15210467,15212483,2016,0,0,1,1
15212484,15212670,186,1,0,0,1
15212606,15212644,38,0,0,1,2
15212645,15212671,26,1,0,0,2
15212671,15214649,1978,0,0,1,1
15212672,15214650,1978,0,0,1,2
15214650,15214745,95,1,0,0,1
15214651,15214750,99,1,0,0,2
15214746,15214835,89,0,0,1,1
15214751,15214833,82,0,0,1,2
15214834,15214869,35,1,0,0,2
15214836,15214870,34,1,0,0,1
15214870,15214994,124,0,0,1,2
15214871,15216659,1788,0,0,1,1
15214995,15215025,30,1,0,0,2
15215026,15215190,164,0,0,1,2
15215191,15215332,141,1,0,0,2
15215333,15215372,39,0,0,1,2
15215373,15216777,1404,1,0,0,2
15216371,15216411,40,0,1,0,2
15216496,15216665,169,0,1,0,2
15216660,15216729,69,1,0,0,1
15216699,15216711,12,0,1,0,2
15216730,15218701,1971,0,0,1,1
15216778,15218702,1924,0,0,1,2
15218702,15218799,97,1,0,0,1
15218703,15218849,146,1,0,0,2
15218800,15218879,79,0,0,1,1
15218850,15218876,26,0,0,1,2
15218877,15218914,37,1,0,0,2
15218880,15218905,25,1,0,0,1
15218906,15220371,1465,0,0,1,1
15218915,15219299,384,0,0,1,2
15219300,15219315,15,1,0,0,2
15219316,15220382,1066,0,0,1,2
15220372,15220831,459,1,0,0,1
15220383,15221169,786,1,0,0,2
15220401,15220807,406,0,1,0,1
15220408,15220851,443,0,1,0,2
15220832,15220889,57,0,0,1,1
15220890,15221174,284,1,0,0,1
15220910,15221120,210,0,1,0,1
15220910,15221134,224,0,1,0,2
15221170,15221241,71,0,0,1,2
15221175,15221239,64,0,0,1,1
15221240,15221267,27,1,0,0,1
15221242,15221268,26,1,0,0,2
15221268,15221439,171,0,0,1,1
15221269,15221438,169,0,0,1,2
15221439,15221657,218,1,0,0,2
15221440,15221654,214,1,0,0,1
15221463,15221610,147,0,1,0,1
15221466,15221623,157,0,1,0,2
15221655,15223565,1910,0,0,1,1
15221658,15221735,77,0,0,1,2
15221736,15221764,28,1,0,0,2
15221765,15221919,154,0,0,1,2
15221920,15221933,13,1,0,0,2
15221934,15223565,1631,0,0,1,2
15223566,15223643,77,1,0,0,1
15223566,15223778,212,1,0,0,2
15223644,15223729,85,0,0,1,1
15223730,15223759,29,1,0,0,1
15223760,15224726,966,0,0,1,1
15223779,15223914,135,0,0,1,2
15223915,15223921,6,1,0,0,2
15223922,15224101,179,0,0,1,2
15224102,15224116,14,1,0,0,2
15224117,15224652,535,0,0,1,2
15224653,15224740,87,1,0,0,2
15224727,15224731,4,1,0,0,1
15224732,15225611,879,0,0,1,1
15224741,15224879,138,0,0,1,2
15224880,15225030,150,1,0,0,2
15225031,15225367,336,0,0,1,2
15225368,15225454,86,1,0,0,2
15225455,15225600,145,0,0,1,2
15225601,15225733,132,1,0,0,2
15225612,15225736,124,1,0,0,1
15225734,15225803,69,0,0,1,2
15225737,15225803,66,0,0,1,1
15225804,15225841,37,1,0,0,2
15225804,15225843,39,1,0,0,1
15225842,15226032,190,0,0,1,2
15225844,15227653,1809,0,0,1,1
15226033,15226039,6,1,0,0,2
15226040,15227652,1612,0,0,1,2
15227653,15227849,196,1,0,0,2
15227654,15227721,67,1,0,0,1
15227722,15227805,83,0,0,1,1
15227806,15227828,22,1,0,0,1
15227829,15229611,1782,0,0,1,1
15227850,15227895,45,0,0,1,2
15227896,15227921,25,1,0,0,2
15227922,15227946,24,0,0,1,2
15227947,15228033,86,1,0,0,2
15228034,15228077,43,0,0,1,2
15228078,15228381,303,1,0,0,2
15228382,15228403,21,0,0,1,2
15228404,15228627,223,1,0,0,2
15228628,15228680,52,0,0,1,2
15228681,15228747,66,1,0,0,2
15228748,15228819,71,0,0,1,2
15228820,15228824,4,1,0,0,2
15228825,15228952,127,0,0,1,2
15228953,15229324,371,1,0,0,2
15229325,15229610,285,0,0,1,2
15229611,15229707,96,1,0,0,2
15229612,15229798,186,1,0,0,1
15229708,15229767,59,0,0,1,2
15229768,15229800,32,1,0,0,2
15229799,15231579,1780,0,0,1,1
15229801,15231029,1228,0,0,1,2
15231030,15231047,17,1,0,0,2
15231048,15231559,511,0,0,1,2
15231560,15231630,70,1,0,0,2
15231580,15231633,53,1,0,0,1
15231631,15231749,118,0,0,1,2
15231634,15231751,117,0,0,1,1
15231750,15231764,14,1,0,0,2
15231752,15231762,10,1,0,0,1
15231763,15232027,264,0,0,1,1
15231765,15232452,687,0,0,1,2
15232028,15232039,11,1,0,0,1
15232040,15232458,418,0,0,1,1
15232453,15232811,358,1,0,0,2
15232459,15232811,352,1,0,0,1
15232492,15232759,267,0,1,0,2
15232495,15232718,223,0,1,0,1
15232812,15232977,165,0,0,1,2
15232812,15232983,171,0,0,1,1
15232978,15233255,277,1,0,0,2
15232984,15233222,238,1,0,0,1
15233002,15233178,176,0,1,0,1
15233003,15233208,205,0,1,0,2
15233223,15233317,94,0,0,1,1
15233256,15233318,62,0,0,1,2
15233318,15233370,52,1,0,0,1
15233319,15233371,52,1,0,0,2
15233371,15233473,102,0,0,1,1
15233372,15233475,103,0,0,1,2
15233474,15233492,18,1,0,0,1
15233476,15233492,16,1,0,0,2
15233493,15235471,1978,0,0,1,2
15233493,15235472,1979,0,0,1,1
15235472,15235535,63,1,0,0,2
15235473,15235533,60,1,0,0,1
15235534,15235631,97,0,0,1,1
15235536,15235632,96,0,0,1,2
15235632,15235650,18,1,0,0,1
15235633,15235648,15,1,0,0,2
15235649,15237446,1797,0,0,1,2
15235651,15237445,1794,0,0,1,1
15237446,15237513,67,1,0,0,1
15237447,15237524,77,1,0,0,2
15237514,15237604,90,0,0,1,1
15237525,15237603,78,0,0,1,2
15237604,15237674,70,1,0,0,2
15237605,15237670,65,1,0,0,1
15237671,15237754,83,0,0,1,1
15237675,15237751,76,0,0,1,2
15237752,15237821,69,1,0,0,2
15237755,15237783,28,1,0,0,1
15237784,15237895,111,0,0,1,1
15237822,15237895,73,0,0,1,2
15237896,15237919,23,1,0,0,1
15237896,15240611,2715,1,0,0,2
15237920,15238257,337,0,0,1,1
15237924,15240472,2548,0,1,0,2
15238268,15238291,23,0,1,0,1
15238301,15238329,28,1,0,0,1
15238312,15238319,7,0,1,0,1
15238330,15238362,32,0,0,1,1
15238373,15238497,124,0,1,0,1
15238507,15239560,1053,1,0,0,1
15238540,15238555,15,0,1,0,1
15238576,15239530,954,0,1,0,1
15239561,15239593,32,0,0,1,1
15239604,15240184,580,0,1,0,1
15240194,15240217,23,1,0,0,1
15240218,15240254,36,0,0,1,1
15240265,15240265,0,0,1,0,1
15240274,15240274,0,1,0,0,1
15240275,15240391,116,0,0,1,1
15240392,15240466,74,1,0,0,1
15240467,15240492,25,0,0,1,1
15240493,15240530,37,1,0,0,1
15240513,15240577,64,0,1,0,2
15240531,15242737,2206,0,0,1,1
15240612,15242738,2126,0,0,1,2
15242738,15242838,100,1,0,0,1
15242739,15242843,104,1,0,0,2
15242839,15242907,68,0,0,1,1
15242844,15242907,63,0,0,1,2
15242908,15242938,30,1,0,0,1
15242908,15242938,30,1,0,0,2
15242939,15243120,181,0,0,1,2
15242939,15245139,2200,0,0,1,1
15243121,15243133,12,1,0,0,2
15243134,15245140,2006,0,0,1,2
15245140,15245998,858,1,0,0,1
15245141,15246005,864,1,0,0,2
15245202,15245788,586,0,1,0,1
15245205,15245791,586,0,1,0,2
15245821,15245968,147,0,1,0,1
15245825,15245978,153,0,1,0,2
15245999,15246073,74,0,0,1,1
15246006,15246071,65,0,0,1,2
15246072,15246105,33,1,0,0,2
15246074,15246091,17,1,0,0,1
15246092,15248067,1975,0,0,1,1
15246106,15246273,167,0,0,1,2
15246274,15246285,11,1,0,0,2
15246286,15248069,1783,0,0,1,2
15248068,15248463,395,1,0,0,1
15248070,15248189,119,1,0,0,2
15248171,15248318,147,0,1,0,1
15248190,15248246,56,0,0,1,2
15248247,15248288,41,1,0,0,2
15248289,15250269,1980,0,0,1,2
15248464,15249644,1180,0,0,1,1
15249645,15249698,53,1,0,0,1
15249657,15249689,32,0,1,0,1
15249699,15249855,156,0,0,1,1
15249866,15249886,20,0,1,0,1
15249896,15249991,95,1,0,0,1
15249970,15249982,12,0,1,0,1
15249992,15250295,303,0,0,1,1
15250270,15250289,19,1,0,0,2
15250290,15250389,99,0,0,1,2
15250306,15250311,5,0,1,0,1
15250320,15250320,0,1,0,0,1
15250321,15250373,52,0,0,1,1
15250384,15250391,7,0,1,0,1
15250390,15250452,62,1,0,0,2
15250401,15250469,68,1,0,0,1
15250421,15250423,2,0,1,0,1
15250453,15250543,90,0,0,1,2
15250470,15250542,72,0,0,1,1
15250543,15250567,24,1,0,0,1
15250544,15250566,22,1,0,0,2
15250567,15252695,2128,0,0,1,2
15250568,15252696,2128,0,0,1,1
15252696,15252792,96,1,0,0,2
15252697,15252785,88,1,0,0,1
15252786,15252878,92,0,0,1,1
15252793,15252877,84,0,0,1,2
15252878,15252899,21,1,0,0,2
15252879,15252933,54,1,0,0,1
15252900,15253445,545,0,0,1,2
15252934,15256012,3078,0,0,1,1
15253446,15253453,7,1,0,0,2
15253454,15256005,2551,0,0,1,2
15256006,15256341,335,1,0,0,2
15256013,15256343,330,1,0,0,1
15256047,15256296,249,0,1,0,2
15256049,15256266,217,0,1,0,1
15256342,15258543,2201,0,0,1,2
15256344,15258546,2202,0,0,1,1
15258544,15258652,108,1,0,0,2
15258547,15258616,69,1,0,0,1
15258617,15258694,77,0,0,1,1
15258653,15258692,39,0,0,1,2
15258693,15258715,22,1,0,0,2
15258695,15258716,21,1,0,0,1
15258716,15258819,103,0,0,1,2
15258717,15258816,99,0,0,1,1
15258817,15258843,26,1,0,0,1
15258820,15258837,17,1,0,0,2
15258838,15261060,2222,0,0,1,2
15258844,15261063,2219,0,0,1,1
15261061,15261383,322,1,0,0,2
15261064,15261325,261,1,0,0,1
15261114,15261314,200,0,1,0,1
15261115,15261320,205,0,1,0,2
15261326,15261351,25,0,0,1,1
15261352,15261392,40,1,0,0,1
15261384,15261535,151,0,0,1,2
15261393,15261424,31,0,0,1,1
15261425,15261433,8,1,0,0,1
15261434,15261657,223,0,0,1,1
15261536,15261540,4,1,0,0,2
15261541,15263221,1680,0,0,1,2
15261658,15261674,16,1,0,0,1
15261675,15262317,642,0,0,1,1
15262318,15262329,11,1,0,0,1
15262330,15263222,892,0,0,1,1
15263222,15263287,65,1,0,0,2
15263223,15263291,68,1,0,0,1
15263288,15263585,297,0,0,1,2
15263292,15263585,293,0,0,1,1
15263586,15263656,70,1,0,0,1
15263586,15263657,71,1,0,0,2
15263657,15263761,104,0,0,1,1
15263658,15263760,102,0,0,1,2
15263761,15263822,61,1,0,0,2
15263762,15263781,19,1,0,0,1
15263782,15264887,1105,0,0,1,1
15263823,15264872,1049,0,0,1,2
15264873,15265086,213,1,0,0,2
15264888,15265076,188,1,0,0,1
15264913,15265029,116,0,1,0,1
15264916,15265034,118,0,1,0,2
15265077,15266992,1915,0,0,1,1
15265087,15265176,89,0,0,1,2
15265177,15265241,64,1,0,0,2
15265242,15266160,918,0,0,1,2
15266161,15266222,61,1,0,0,2
15266223,15266992,769,0,0,1,2
15266993,15267052,59,1,0,0,1
15266993,15267068,75,1,0,0,2
15267053,15267150,97,0,0,1,1
15267069,15267146,77,0,0,1,2
15267147,15267171,24,1,0,0,2
15267151,15267171,20,1,0,0,1
15267172,15269119,1947,0,0,1,2
15267172,15269121,1949,0,0,1,1
15269120,15269216,96,1,0,0,2
15269122,15269217,95,1,0,0,1
15269217,15269291,74,0,0,1,2
15269218,15269290,72,0,0,1,1
15269291,15269321,30,1,0,0,1
15269292,15269320,28,1,0,0,2
15269321,15271158,1837,0,0,1,2
15269322,15271158,1836,0,0,1,1
15271159,15271230,71,1,0,0,1
15271159,15271238,79,1,0,0,2
15271231,15271320,89,0,0,1,1
15271239,15271323,84,0,0,1,2
15271321,15271345,24,1,0,0,1
15271324,15271346,22,1,0,0,2
15271346,15273072,1726,0,0,1,1
15271347,15273073,1726,0,0,1,2
15273073,15273406,333,1,0,0,1
15273074,15273509,435,1,0,0,2
15273127,15273376,249,0,1,0,1
15273131,15273408,277,0,1,0,2
15273407,15273479,72,0,0,1,1
15273480,15273506,26,1,0,0,1
15273507,15273809,302,0,0,1,1
15273510,15273755,245,0,0,1,2
15273756,15273771,15,1,0,0,2
15273772,15273810,38,0,0,1,2
15273810,15274161,351,1,0,0,1
15273811,15274191,380,1,0,0,2
15273847,15274142,295,0,1,0,2
15273849,15274105,256,0,1,0,1
15274162,15274230,68,0,0,1,1
15274192,15274220,28,0,0,1,2
15274221,15274475,254,1,0,0,2
15274231,15274430,199,1,0,0,1
15274249,15274420,171,0,1,0,2
15274250,15274393,143,0,1,0,1
15274431,15274537,106,0,0,1,1
15274476,15274532,56,0,0,1,2
15274533,15274549,16,1,0,0,2
15274538,15274552,14,1,0,0,1
15274550,15276391,1841,0,0,1,2
15274553,15276391,1838,0,0,1,1
15276392,15276472,80,1,0,0,1
15276392,15279016,2624,1,0,0,2
15276473,15276557,84,0,0,1,1
15276558,15276611,53,1,0,0,1
15276601,15278961,2360,0,1,0,2
15276612,15278900,2288,0,0,1,1
15278901,15279010,109,1,0,0,1
15279011,15279162,151,0,0,1,1
15279017,15279164,147,0,0,1,2
15279163,15279198,35,1,0,0,1
15279165,15279187,22,1,0,0,2
15279188,15280739,1551,0,0,1,2
15279199,15279791,592,0,0,1,1
15279792,15279808,16,1,0,0,1
15279809,15280113,304,0,0,1,1
15280114,15280157,43,1,0,0,1
15280158,15280276,118,0,0,1,1
15280277,15280292,15,1,0,0,1
15280293,15280742,449,0,0,1,1
15280740,15280830,90,1,0,0,2
15280743,15280831,88,1,0,0,1
15280831,15280904,73,0,0,1,2
15280832,15280904,72,0,0,1,1
15280905,15280940,35,1,0,0,1
15280905,15280940,35,1,0,0,2
15280941,15282762,1821,0,0,1,2
15280941,15282763,1822,0,0,1,1
15282763,15282866,103,1,0,0,2
15282764,15282873,109,1,0,0,1
15282867,15283039,172,0,0,1,2
15282874,15282930,56,0,0,1,1
15282931,15283079,148,1,0,0,1
15283040,15283082,42,1,0,0,2
15283080,15283185,105,0,0,1,1
15283083,15283241,158,0,0,1,2
15283186,15283191,5,1,0,0,1
15283192,15283236,44,0,0,1,1
15283237,15283261,24,1,0,0,1
15283242,15283273,31,1,0,0,2
15283262,15283518,256,0,0,1,1
15283274,15283615,341,0,0,1,2
15283519,15283528,9,1,0,0,1
15283529,15283617,88,0,0,1,1
15283616,15283815,199,1,0,0,2
15283618,15283799,181,1,0,0,1
15283648,15283748,100,0,1,0,1
15283648,15283758,110,0,1,0,2
15283800,15284800,1000,0,0,1,1
15283816,15283931,115,0,0,1,2
15283932,15283959,27,1,0,0,2
15283960,15284800,840,0,0,1,2
15284801,15286259,1458,1,0,0,1
15284801,15286308,1507,1,0,0,2
15284853,15285804,951,0,1,0,2
15284856,15285754,898,0,1,0,1
15285842,15286248,406,0,1,0,1
15285845,15286288,443,0,1,0,2
15286260,15286285,25,0,0,1,1
15286286,15286309,23,1,0,0,1
15286309,15286465,156,0,0,1,2
15286310,15288103,1793,0,0,1,1
15286466,15286480,14,1,0,0,2
15286481,15288104,1623,0,0,1,2
15288104,15288186,82,1,0,0,1
15288105,15288198,93,1,0,0,2
15288187,15288277,90,0,0,1,1
15288199,15288277,78,0,0,1,2
15288278,15288303,25,1,0,0,1
15288278,15288311,33,1,0,0,2
15288304,15290270,1966,0,0,1,1
15288312,15288508,196,0,0,1,2
15288509,15288547,38,1,0,0,2
15288548,15290270,1722,0,0,1,2
15290271,15290365,94,1,0,0,2
15290271,15290367,96,1,0,0,1
15290366,15290434,68,0,0,1,2
15290368,15290434,66,0,0,1,1
15290435,15290468,33,1,0,0,2
15290435,15290469,34,1,0,0,1
15290469,15290567,98,0,0,1,2
15290470,15290566,96,0,0,1,1
15290567,15290593,26,1,0,0,1
15290568,15290594,26,1,0,0,2
15290594,15292528,1934,0,0,1,1
15290595,15292527,1932,0,0,1,2
15292528,15292618,90,1,0,0,2
15292529,15292737,208,1,0,0,1
15292619,15292708,89,0,0,1,2
15292709,15292743,34,1,0,0,2
15292738,15292908,170,0,0,1,1
15292744,15292904,160,0,0,1,2
15292905,15292919,14,1,0,0,2
15292909,15292918,9,1,0,0,1
15292919,15294639,1720,0,0,1,1
15292920,15294638,1718,0,0,1,2
15294639,15294703,64,1,0,0,2
15294640,15294703,63,1,0,0,1
15294704,15294802,98,0,0,1,2
15294704,15294804,100,0,0,1,1
15294803,15294822,19,1,0,0,2
15294805,15294821,16,1,0,0,1
15294822,15296658,1836,0,0,1,1
15294823,15296658,1835,0,0,1,2
15296659,15296704,45,1,0,0,2
15296659,15296746,87,1,0,0,1
15296705,15297120,415,0,0,1,2
15296747,15296950,203,0,0,1,1
15296951,15296972,21,1,0,0,1
15296973,15297236,263,0,0,1,1
15297121,15297219,98,1,0,0,2
15297220,15297409,189,0,0,1,2
15297237,15297281,44,1,0,0,1
15297282,15298118,836,0,0,1,1
15297410,15297443,33,1,0,0,2
15297444,15298495,1051,0,0,1,2
15298119,15298123,4,1,0,0,1
15298124,15298495,371,0,0,1,1
15298496,15301739,3243,1,0,0,1
15298496,15301767,3271,1,0,0,2
15298542,15301756,3214,0,1,0,2
15298549,15301727,3178,0,1,0,1
15301740,15304026,2286,0,0,1,1
15301768,15302076,308,0,0,1,2
15302077,15302202,125,1,0,0,2
15302203,15302235,32,0,0,1,2
15302236,15302376,140,1,0,0,2
15302377,15302496,119,0,0,1,2
15302497,15302508,11,1,0,0,2
15302509,15302563,54,0,0,1,2
15302564,15302622,58,1,0,0,2
15302623,15303980,1357,0,0,1,2
15303981,15303989,8,1,0,0,2
15303990,15304023,33,0,0,1,2
15304024,15304168,144,1,0,0,2
15304027,15304143,116,1,0,0,1
15304144,15304498,354,0,0,1,1
15304169,15304377,208,0,0,1,2
15304378,15304391,13,1,0,0,2
15304392,15304492,100,0,0,1,2
15304493,15305081,588,1,0,0,2
15304499,15304734,235,1,0,0,1
15304527,15304709,182,0,1,0,1
15304532,15304737,205,0,1,0,2
15304735,15304777,42,0,0,1,1
15304778,15305023,245,1,0,0,1
15304796,15305030,234,0,1,0,2
15304805,15304991,186,0,1,0,1
15305024,15305121,97,0,0,1,1
15305082,15305110,28,0,0,1,2
15305111,15305347,236,1,0,0,2
15305122,15305323,201,1,0,0,1
15305130,15305316,186,0,1,0,2
15305140,15305291,151,0,1,0,1
15305324,15305780,456,0,0,1,1
15305348,15305780,432,0,0,1,2
15305781,15305829,48,1,0,0,1
15305781,15305846,65,1,0,0,2
15305830,15306747,917,0,0,1,1
15305847,15306596,749,0,0,1,2
15306597,15306614,17,1,0,0,2
15306615,15306748,133,0,0,1,2
15306748,15306828,80,1,0,0,1
15306749,15308110,1361,1,0,0,2
15306829,15307251,422,0,0,1,1
15306838,15308099,1261,0,1,0,2
15307252,15307321,69,1,0,0,1
15307322,15307343,21,0,0,1,1
15307344,15307359,15,1,0,0,1
15307360,15307478,118,0,0,1,1
15307479,15308060,581,1,0,0,1
15307490,15307716,226,0,1,0,1
15307774,15308028,254,0,1,0,1
15308061,15308342,281,0,0,1,1
15308111,15308333,222,0,0,1,2
15308334,15308644,310,1,0,0,2
15308343,15308604,261,1,0,0,1
15308363,15308571,208,0,1,0,1
15308364,15308600,236,0,1,0,2
15308605,15308697,92,0,0,1,1
15308645,15308696,51,0,0,1,2
15308697,15308731,34,1,0,0,2
15308698,15308720,22,1,0,0,1
15308721,15308986,265,0,0,1,1
15308732,15308988,256,0,0,1,2
15308987,15309007,20,1,0,0,1
15308989,15309009,20,1,0,0,2
15309008,15309240,232,0,0,1,1
15309010,15309239,229,0,0,1,2
15309240,15310064,824,1,0,0,2
15309241,15309782,541,1,0,0,1
15309293,15309771,478,0,1,0,1
15309294,15309809,515,0,1,0,2
15309783,15309825,42,0,0,1,1
15309826,15310017,191,1,0,0,1
15309840,15310007,167,0,1,0,2
15309843,15309981,138,0,1,0,1
15310018,15310223,205,0,0,1,1
15310065,15310230,165,0,0,1,2
15310224,15310238,14,1,0,0,1
15310231,15310260,29,1,0,0,2
15310239,15310783,544,0,0,1,1
15310261,15310695,434,0,0,1,2
15310696,15310736,40,1,0,0,2
15310737,15310783,46,0,0,1,2
15310784,15310845,61,1,0,0,2
15310784,15310895,111,1,0,0,1
15310846,15310937,91,0,0,1,2
15310896,15310932,36,0,0,1,1
15310933,15310967,34,1,0,0,1
15310938,15311000,62,1,0,0,2
15310968,15311253,285,0,0,1,1
15311001,15311094,93,0,0,1,2
15311095,15311099,4,1,0,0,2
15311100,15311351,251,0,0,1,2
15311254,15311267,13,1,0,0,1
15311268,15313419,2151,0,0,1,1
15311352,15311356,4,1,0,0,2
15311357,15311592,235,0,0,1,2
15311593,15311630,37,1,0,0,2
15311631,15311742,111,0,0,1,2
15311743,15311948,205,1,0,0,2
15311949,15312012,63,0,0,1,2
15312013,15312063,50,1,0,0,2
15312064,15312224,160,0,0,1,2
15312225,15312280,55,1,0,0,2
15312281,15312357,76,0,0,1,2
15312358,15312381,23,1,0,0,2
15312382,15312492,110,0,0,1,2
15312493,15312711,218,1,0,0,2
15312712,15312781,69,0,0,1,2
15312782,15312971,189,1,0,0,2
15312972,15313428,456,0,0,1,2
15313420,15313433,13,1,0,0,1
15313429,15313450,21,1,0,0,2
15313434,15313628,194,0,0,1,1
15313451,15313602,151,0,0,1,2
15313603,15313617,14,1,0,0,2
15313618,15314421,803,0,0,1,2
15313629,15313673,44,1,0,0,1
15313674,15313999,325,0,0,1,1
15314000,15314038,38,1,0,0,1
15314039,15314332,293,0,0,1,1
15314333,15314362,29,1,0,0,1
15314363,15315263,900,0,0,1,1
15314422,15314444,22,1,0,0,2
15314445,15315267,822,0,0,1,2
15315264,15315460,196,1,0,0,1
15315268,15315464,196,1,0,0,2
15315298,15315386,88,0,1,0,1
15315301,15315388,87,0,1,0,2
15315461,15315572,111,0,0,1,1
15315465,15315522,57,0,0,1,2
15315523,15315666,143,1,0,0,2
15315573,15315620,47,1,0,0,1
15315621,15316150,529,0,0,1,1
15315667,15315737,70,0,0,1,2
15315738,15315771,33,1,0,0,2
15315772,15315936,164,0,0,1,2
15315937,15315941,4,1,0,0,2
15315942,15316187,245,0,0,1,2
15316151,15316200,49,1,0,0,1
15316188,15316277,89,1,0,0,2
15316201,15316990,789,0,0,1,1
15316278,15316334,56,0,0,1,2
15316335,15316359,24,1,0,0,2
15316360,15316699,339,0,0,1,2
15316700,15316751,51,1,0,0,2
15316752,15316801,49,0,0,1,2
15316802,15316876,74,1,0,0,2
15316877,15316900,23,0,0,1,2
15316901,15316935,34,1,0,0,2
15316936,15317085,149,0,0,1,2
15316991,15317009,18,1,0,0,1
15317010,15317061,51,0,0,1,1
15317062,15317185,123,1,0,0,1
15317086,15317119,33,1,0,0,2
15317120,15317297,177,0,0,1,2
15317186,15317212,26,0,0,1,1
15317213,15317229,16,1,0,0,1
15317230,15317293,63,0,0,1,1
15317294,15317599,305,1,0,0,1
15317298,15317638,340,1,0,0,2
15317355,15317571,216,0,1,0,2
15317358,15317546,188,0,1,0,1
15317600,15317701,101,0,0,1,1
15317639,15317702,63,0,0,1,2
15317702,15317726,24,1,0,0,1
15317703,15317810,107,1,0,0,2
15317727,15318651,924,0,0,1,1
15317811,15317872,61,0,0,1,2
15317873,15317990,117,1,0,0,2
15317991,15318033,42,0,0,1,2
15318034,15318121,87,1,0,0,2
15318122,15318249,127,0,0,1,2
15318250,15318291,41,1,0,0,2
15318292,15319079,787,0,0,1,2
15318652,15318753,101,1,0,0,1
15318754,15319167,413,0,0,1,1
15319080,15319223,143,1,0,0,2
15319168,15319182,14,1,0,0,1
15319183,15319352,169,0,0,1,1
15319224,15319274,50,0,0,1,2
15319275,15319279,4,1,0,0,2
15319280,15319676,396,0,0,1,2
15319353,15319422,69,1,0,0,1
15319423,15319678,255,0,0,1,1
15319677,15319720,43,1,0,0,2
15319679,15319783,104,1,0,0,1
15319721,15319882,161,0,0,1,2
15319784,15319880,96,0,0,1,1
15319881,15319908,27,1,0,0,1
15319883,15319898,15,1,0,0,2
15319899,15323145,3246,0,0,1,2
15319909,15323146,3237,0,0,1,1
15323146,15323191,45,1,0,0,2
15323147,15323191,44,1,0,0,1
15323192,15323622,430,0,0,1,2
15323192,15323629,437,0,0,1,1
15323623,15323896,273,1,0,0,2
15323630,15323828,198,1,0,0,1
15323648,15323795,147,0,1,0,1
15323648,15323829,181,0,1,0,2
15323829,15323946,117,0,0,1,1
15323897,15326109,2212,0,0,1,2
15323947,15323951,4,1,0,0,1
15323952,15326107,2155,0,0,1,1
15326108,15326150,42,1,0,0,1
15326110,15326152,42,1,0,0,2
15326151,15329492,3341,0,0,1,1
15326153,15328635,2482,0,0,1,2
15328636,15328683,47,1,0,0,2
15328684,15329492,808,0,0,1,2
15329493,15329552,59,1,0,0,1
15329493,15329566,73,1,0,0,2
15329553,15329931,378,0,0,1,1
15329567,15329868,301,0,0,1,2
15329869,15329888,19,1,0,0,2
15329889,15329932,43,0,0,1,2
15329932,15330201,269,1,0,0,1
15329933,15330231,298,1,0,0,2
15330005,15330162,157,0,1,0,1
15330008,15330170,162,0,1,0,2
15330202,15330282,80,0,0,1,1
15330232,15330312,80,0,0,1,2
15330283,15330294,11,1,0,0,1
15330295,15332799,2504,0,0,1,1
15330313,15330334,21,1,0,0,2
15330335,15330800,465,0,0,1,2
15330801,15330823,22,1,0,0,2
15330824,15332800,1976,0,0,1,2
15332800,15332852,52,1,0,0,1
15332801,15332860,59,1,0,0,2
15332853,15334844,1991,0,0,1,1
15332861,15334853,1992,0,0,1,2
15334845,15335648,803,1,0,0,1
15334854,15335628,774,1,0,0,2
15334876,15335606,730,0,1,0,1
15334885,15335615,730,0,1,0,2
15335629,15335704,75,0,0,1,2
15335649,15335674,25,0,0,1,1
15335675,15335960,285,1,0,0,1
15335705,15335971,266,1,0,0,2
15335726,15335909,183,0,1,0,1
15335731,15335942,211,0,1,0,2
15335961,15336057,96,0,0,1,1
15335972,15336057,85,0,0,1,2
15336058,15336093,35,1,0,0,2
15336058,15336097,39,1,0,0,1
15336094,15336193,99,0,0,1,2
15336098,15336192,94,0,0,1,1
15336193,15336213,20,1,0,0,1
15336194,15336213,19,1,0,0,2
15336214,15339333,3119,0,0,1,1
15336214,15339333,3119,0,0,1,2
15339334,15339377,43,1,0,0,2
15339334,15339378,44,1,0,0,1
15339378,15342454,3076,0,0,1,2
15339379,15342779,3400,0,0,1,1
15342455,15342469,14,1,0,0,2
15342470,15342777,307,0,0,1,2
15342778,15342974,196,1,0,0,2
15342780,15342951,171,1,0,0,1
15342815,15342917,102,0,1,0,1
15342817,15342927,110,0,1,0,2
15342952,15343066,114,0,0,1,1
15342975,15343067,92,0,0,1,2
15343067,15343078,11,1,0,0,1
15343068,15343079,11,1,0,0,2
15343079,15345185,2106,0,0,1,1
15343080,15344912,1832,0,0,1,2
15344913,15344934,21,1,0,0,2
15344935,15345189,254,0,0,1,2
15345186,15345260,74,1,0,0,1
15345190,15345254,64,1,0,0,2
15345255,15345436,181,0,0,1,2
15345261,15345435,174,0,0,1,1
15345436,15345452,16,1,0,0,1
15345437,15345451,14,1,0,0,2
15345452,15348230,2778,0,0,1,2
15345453,15348233,2780,0,0,1,1
15348231,15348312,81,1,0,0,2
15348234,15348335,101,1,0,0,1
15348313,15348365,52,0,0,1,2
15348336,15348450,114,0,0,1,1
15348366,15348382,16,1,0,0,2
15348383,15348846,463,0,0,1,2
15348451,15348584,133,1,0,0,1
15348585,15348608,23,0,0,1,1
15348609,15348632,23,1,0,0,1
15348633,15348709,76,0,0,1,1
15348710,15348726,16,1,0,0,1
15348727,15348830,103,0,0,1,1
15348831,15348862,31,1,0,0,1
15348847,15348943,96,1,0,0,2
15348863,15348913,50,0,0,1,1
15348914,15349016,102,1,0,0,1
15348944,15349351,407,0,0,1,2
15349017,15349478,461,0,0,1,1
15349352,15349370,18,1,0,0,2
15349371,15350603,1232,0,0,1,2
15349479,15349531,52,1,0,0,1
15349532,15349659,127,0,0,1,1
15349660,15349684,24,1,0,0,1
15349685,15349759,74,0,0,1,1
15349760,15349940,180,1,0,0,1
15349941,15350068,127,0,0,1,1
15350069,15350160,91,1,0,0,1
15350161,15350495,334,0,0,1,1
15350496,15350500,4,1,0,0,1
15350501,15350570,69,0,0,1,1
15350571,15350679,108,1,0,0,1
15350604,15350665,61,1,0,0,2
15350666,15350699,33,0,0,1,2
15350680,15351029,349,0,0,1,1
15350700,15350762,62,1,0,0,2
15350763,15351068,305,0,0,1,2
15351030,15351035,5,1,0,0,1
15351036,15352727,1691,0,0,1,1
15351069,15351079,10,1,0,0,2
15351080,15351225,145,0,0,1,2
15351226,15351236,10,1,0,0,2
15351237,15352722,1485,0,0,1,2
15352723,15356078,3355,1,0,0,2
15352728,15354857,2129,1,0,0,1
15352765,15354827,2062,0,1,0,1
15352768,15354830,2062,0,1,0,2
15354858,15354895,37,0,0,1,1
15354896,15356000,1104,1,0,0,1
15354915,15355969,1054,0,1,0,1
15354919,15356047,1128,0,1,0,2
15356001,15356035,34,0,0,1,1
15356036,15356056,20,1,0,0,1
15356057,15358658,2601,0,0,1,1
15356079,15356341,262,0,0,1,2
15356342,15356369,27,1,0,0,2
15356370,15358208,1838,0,0,1,2
15358209,15358229,20,1,0,0,2
15358230,15358655,425,0,0,1,2
15358656,15358718,62,1,0,0,2
15358659,15358709,50,1,0,0,1
15358710,15358928,218,0,0,1,1
15358719,15358926,207,0,0,1,2
15358927,15358949,22,1,0,0,2
15358929,15358940,11,1,0,0,1
15358941,15360941,2000,0,0,1,1
15358950,15358988,38,0,0,1,2
15358989,15359002,13,1,0,0,2
15359003,15359070,67,0,0,1,2
15359071,15359092,21,1,0,0,2
15359093,15359439,346,0,0,1,2
15359440,15359529,89,1,0,0,2
15359530,15359683,153,0,0,1,2
15359684,15359750,66,1,0,0,2
15359751,15360048,297,0,0,1,2
15360049,15360077,28,1,0,0,2
15360078,15360935,857,0,0,1,2
15360936,15361330,394,1,0,0,2
15360942,15361255,313,1,0,0,1
15361012,15361215,203,0,1,0,1
15361019,15361260,241,0,1,0,2
15361256,15362670,1414,0,0,1,1
15361331,15361607,276,0,0,1,2
15361608,15361622,14,1,0,0,2
15361623,15362671,1048,0,0,1,2
15362671,15362734,63,1,0,0,1
15362672,15362737,65,1,0,0,2
15362735,15362823,88,0,0,1,1
15362738,15362823,85,0,0,1,2
15362824,15362843,19,1,0,0,1
15362824,15362863,39,1,0,0,2
15362844,15365724,2880,0,0,1,1
15362864,15363349,485,0,0,1,2
15363350,15363361,11,1,0,0,2
15363362,15365725,2363,0,0,1,2
15365725,15365766,41,1,0,0,1
15365726,15365764,38,1,0,0,2
15365765,15366603,838,0,0,1,2
15365767,15367485,1718,0,0,1,1
15366604,15366633,29,1,0,0,2
15366634,15366718,84,0,0,1,2
15366719,15366753,34,1,0,0,2
15366754,15367477,723,0,0,1,2
15367478,15368334,856,1,0,0,2
15367486,15368262,776,1,0,0,1
15367506,15367984,478,0,1,0,1
15367512,15368323,811,0,1,0,2
15368019,15368236,217,0,1,0,1
15368263,15368715,452,0,0,1,1
15368335,15368713,378,0,0,1,2
15368714,15369137,423,1,0,0,2
15368716,15368984,268,1,0,0,1
15368743,15369126,383,0,1,0,2
15368745,15368973,228,0,1,0,1
15368985,15369020,35,0,0,1,1
15369021,15369048,27,1,0,0,1
15369049,15369069,20,0,0,1,1
15369070,15369127,57,1,0,0,1
15369128,15369236,108,0,0,1,1
15369138,15369236,98,0,0,1,2
15369237,15369266,29,1,0,0,1
15369247,15369325,78,0,1,0,2
15369267,15371347,2080,0,0,1,1
15369334,15369334,0,1,0,0,2
15369335,15369361,26,0,0,1,2
15369372,15369373,1,0,1,0,2
15369383,15369384,1,1,0,0,2
15369385,15369825,440,0,0,1,2
15369836,15369842,6,0,1,0,2
15369851,15369851,0,1,0,0,2
15369852,15369970,118,0,0,1,2
15369981,15370393,412,0,1,0,2
15370402,15370402,0,1,0,0,2
15370403,15371348,945,0,0,1,2
15371348,15371420,72,1,0,0,1
15371349,15371461,112,1,0,0,2
15371387,15371391,4,0,1,0,2
15371421,15373411,1990,0,0,1,1
15371462,15372669,1207,0,0,1,2
15372670,15372680,10,1,0,0,2
15372681,15372888,207,0,0,1,2
15372889,15372898,9,1,0,0,2
15372899,15373412,513,0,0,1,2
15373412,15373684,272,1,0,0,1
15373413,15374110,697,1,0,0,2
15373434,15373645,211,0,1,0,1
15373436,15373692,256,0,1,0,2
15373685,15373739,54,0,0,1,1
15373740,15374086,346,1,0,0,1
15373772,15374063,291,0,1,0,2
15373778,15374031,253,0,1,0,1
15374087,15374145,58,0,0,1,1
15374111,15374343,232,0,0,1,2
15374146,15374153,7,1,0,0,1
15374154,15374346,192,0,0,1,1
15374344,15374643,299,1,0,0,2
15374347,15374604,257,1,0,0,1
15374364,15374608,244,0,1,0,2
15374372,15374555,183,0,1,0,1
15374605,15375171,566,0,0,1,1
15374644,15375171,527,0,0,1,2
15375172,15375250,78,1,0,0,1
15375172,15375250,78,1,0,0,2
15375251,15375370,119,0,0,1,2
15375251,15375375,124,0,0,1,1
15375371,15375398,27,1,0,0,2
15375376,15375387,11,1,0,0,1
15375388,15378092,2704,0,0,1,1
15375399,15378090,2691,0,0,1,2
15378091,15382096,4005,1,0,0,2
15378093,15378147,54,1,0,0,1
15378140,15382065,3925,0,1,0,2
15378148,15378290,142,0,0,1,1
15378291,15378311,20,1,0,0,1
15378312,15378834,522,0,0,1,1
15378845,15382054,3209,0,1,0,1
15382064,15382064,0,1,0,0,1
15382065,15382280,215,0,0,1,1
15382097,15382281,184,0,0,1,2
15382281,15382349,68,1,0,0,1
15382282,15382325,43,1,0,0,2
15382326,15382446,120,0,0,1,2
15382350,15382442,92,0,0,1,1
15382443,15382459,16,1,0,0,1
15382447,15382458,11,1,0,0,2
15382459,15382713,254,0,0,1,2
15382460,15385206,2746,0,0,1,1
15382714,15382740,26,1,0,0,2
15382741,15383002,261,0,0,1,2
15383003,15383052,49,1,0,0,2
15383053,15383198,145,0,0,1,2
15383199,15383249,50,1,0,0,2
15383250,15383376,126,0,0,1,2
15383387,15385003,1616,0,1,0,2
15385013,15385046,33,1,0,0,2
15385029,15385037,8,0,1,0,2
15385047,15385087,40,0,0,1,2
15385088,15385117,29,1,0,0,2
15385100,15385108,8,0,1,0,2
15385118,15385164,46,0,0,1,2
15385165,15385548,383,1,0,0,2
15385207,15385502,295,1,0,0,1
15385224,15385494,270,0,1,0,2
15385231,15385443,212,0,1,0,1
15385503,15385985,482,0,0,1,1
15385549,15387212,1663,0,0,1,2
15385986,15386028,42,1,0,0,1
15386029,15386076,47,0,0,1,1
15386077,15386144,67,1,0,0,1
15386145,15387211,1066,0,0,1,1
15387212,15387581,369,1,0,0,1
15387213,15387664,451,1,0,0,2
15387252,15387623,371,0,1,0,2
15387266,15387551,285,0,1,0,1
15387582,15387710,128,0,0,1,1
15387665,15387709,44,0,0,1,2
15387710,15388051,341,1,0,0,2
15387711,15387981,270,1,0,0,1
15387753,15387992,239,0,1,0,2
15387764,15387947,183,0,1,0,1
15387982,15388111,129,0,0,1,1
15388052,15388108,56,0,0,1,2
15388109,15388221,112,1,0,0,2
15388112,15388225,113,1,0,0,1
15388222,15388698,476,0,0,1,2
15388226,15388697,471,0,0,1,1
15388698,15388747,49,1,0,0,1
15388699,15388747,48,1,0,0,2
15388748,15388978,230,0,0,1,1
15388748,15388979,231,0,0,1,2
15388979,15389027,48,1,0,0,1
15388980,15389030,50,1,0,0,2
15389028,15389080,52,0,0,1,1
15389031,15389079,48,0,0,1,2
15389080,15389178,98,1,0,0,2
15389081,15389107,26,1,0,0,1
15389108,15389263,155,0,0,1,1
15389179,15390347,1168,0,0,1,2
15389264,15389272,8,1,0,0,1
15389273,15391097,1824,0,0,1,1
15390348,15390442,94,1,0,0,2
15390443,15391098,655,0,0,1,2
15391098,15391158,60,1,0,0,1
15391099,15391163,64,1,0,0,2
15391159,15391633,474,0,0,1,1
15391164,15391629,465,0,0,1,2
15391630,15391647,17,1,0,0,2
15391634,15391648,14,1,0,0,1
15391648,15393031,1383,0,0,1,2
15391649,15393030,1381,0,0,1,1
15393031,15393755,724,1,0,0,1
15393032,15394105,1073,1,0,0,2
15393082,15393776,694,0,1,0,2
15393088,15393745,657,0,1,0,1
15393756,15393821,65,0,0,1,1
15393822,15394064,242,1,0,0,1
15393827,15394039,212,0,1,0,2
15393838,15394008,170,0,1,0,1
15394065,15394171,106,0,0,1,1
15394106,15394159,53,0,0,1,2
15394160,15394438,278,1,0,0,2
15394172,15394412,240,1,0,0,1
15394187,15394374,187,0,1,0,1
15394187,15394405,218,0,1,0,2
15394413,15394885,472,0,0,1,1
15394439,15394884,445,0,0,1,2
15394885,15394937,52,1,0,0,2
15394886,15394932,46,1,0,0,1
15394933,15395038,105,0,0,1,1
15394938,15395036,98,0,0,1,2
15395037,15395057,20,1,0,0,2
15395039,15395067,28,1,0,0,1
15395058,15395157,99,0,0,1,2
15395068,15396132,1064,0,0,1,1
15395158,15395165,7,1,0,0,2
15395166,15395693,527,0,0,1,2
15395694,15395711,17,1,0,0,2
15395712,15395895,183,0,0,1,2
15395896,15395911,15,1,0,0,2
15395912,15396132,220,0,0,1,2
15396133,15396176,43,1,0,0,1
15396133,15396227,94,1,0,0,2
15396177,15398130,1953,0,0,1,1
15396228,15398131,1903,0,0,1,2
15398131,15398743,612,1,0,0,1
15398132,15401980,3848,1,0,0,2
15398149,15401959,3810,0,1,0,2
15398158,15398672,514,0,1,0,1
15398744,15398864,120,0,0,1,1
15398865,15399186,321,1,0,0,1
15398890,15399170,280,0,1,0,1
15399187,15399938,751,0,0,1,1
15399939,15400024,85,1,0,0,1
15400025,15400119,94,0,0,1,1
15400120,15400432,312,1,0,0,1
15400433,15400461,28,0,0,1,1
15400462,15400516,54,1,0,0,1
15400517,15400727,210,0,0,1,1
15400728,15400751,23,1,0,0,1
15400752,15401595,843,0,0,1,1
15401596,15401610,14,1,0,0,1
15401611,15401688,77,0,0,1,1
15401689,15401694,5,1,0,0,1
15401695,15401876,181,0,0,1,1
15401877,15401950,73,1,0,0,1
15401951,15402134,183,0,0,1,1
15401981,15402137,156,0,0,1,2
15402135,15402149,14,1,0,0,1
15402138,15402218,80,1,0,0,2
15402150,15404084,1934,0,0,1,1
15402219,15402866,647,0,0,1,2
15402867,15402872,5,1,0,0,2
15402873,15404089,1216,0,0,1,2
15404085,15404748,663,1,0,0,1
15404090,15405338,1248,1,0,0,2
15404107,15404729,622,0,1,0,1
15404112,15405141,1029,0,1,0,2
15404749,15404847,98,0,0,1,1
15404848,15405132,284,1,0,0,1
15404866,15405051,185,0,1,0,1
15405133,15405221,88,0,0,1,1
15405222,15405282,60,1,0,0,1
15405256,15405271,15,0,1,0,2
15405283,15407228,1945,0,0,1,1
15405339,15407232,1893,0,0,1,2
15407229,15407282,53,1,0,0,1
15407233,15407282,49,1,0,0,2
15407283,15407652,369,0,0,1,1
15407283,15409393,2110,0,0,1,2
15407653,15407660,7,1,0,0,1
15407661,15409390,1729,0,0,1,1
15409391,15410979,1588,1,0,0,1
15409394,15411107,1713,1,0,0,2
15409418,15410954,1536,0,1,0,1
15409419,15411021,1602,0,1,0,2
15410980,15411024,44,0,0,1,1
15411025,15411132,107,1,0,0,1
15411108,15411146,38,0,0,1,2
15411133,15411176,43,0,0,1,1
15411147,15411208,61,1,0,0,2
15411177,15411201,24,1,0,0,1
15411202,15411501,299,0,0,1,1
15411209,15411361,152,0,0,1,2
15411362,15411379,17,1,0,0,2
15411380,15413108,1728,0,0,1,2
15411502,15411517,15,1,0,0,1
15411518,15411681,163,0,0,1,1
15411682,15411755,73,1,0,0,1
15411756,15411891,135,0,0,1,1
15411892,15411949,57,1,0,0,1
15411950,15412178,228,0,0,1,1
15412179,15412187,8,1,0,0,1
15412188,15412953,765,0,0,1,1
15412954,15412974,20,1,0,0,1
15412975,15412995,20,0,0,1,1
15412996,15413024,28,1,0,0,1
15413025,15413184,159,0,0,1,1
15413109,15413163,54,1,0,0,2
15413164,15413387,223,0,0,1,2
15413185,15413200,15,1,0,0,1
15413201,15413333,132,0,0,1,1
15413334,15413401,67,1,0,0,1
15413388,15413827,439,1,0,0,2
15413402,15413469,67,0,0,1,1
15413470,15413485,15,1,0,0,1
15413486,15413542,56,0,0,1,1
15413543,15413584,41,1,0,0,1
15413585,15413851,266,0,0,1,1
15413828,15414074,246,0,0,1,2
15413852,15413897,45,1,0,0,1
15413898,15413983,85,0,0,1,1
15413984,15414032,48,1,0,0,1
15414033,15414254,221,0,0,1,1
15414075,15414091,16,1,0,0,2
15414092,15414147,55,0,0,1,2
15414148,15414196,48,1,0,0,2
15414197,15414317,120,0,0,1,2
15414255,15414306,51,1,0,0,1
15414307,15414425,118,0,0,1,1
15414318,15414478,160,1,0,0,2
15414426,15414523,97,1,0,0,1
15414479,15414528,49,0,0,1,2
15414524,15414827,303,0,0,1,1
15414529,15414784,255,1,0,0,2
15414785,15414848,63,0,0,1,2
15414828,15414845,17,1,0,0,1
15414846,15415557,711,0,0,1,1
15414849,15414887,38,1,0,0,2
15414888,15414927,39,0,0,1,2
15414928,15414940,12,1,0,0,2
15414941,15415070,129,0,0,1,2
15415071,15415108,37,1,0,0,2
15415109,15415136,27,0,0,1,2
15415137,15415141,4,1,0,0,2
15415142,15415388,246,0,0,1,2
15415389,15415523,134,1,0,0,2
15415524,15415551,27,0,0,1,2
15415552,15417069,1517,1,0,0,2
15415558,15416782,1224,1,0,0,1
15415600,15416771,1171,0,1,0,1
15415601,15415971,370,0,1,0,2
15416000,15416987,987,0,1,0,2
15416783,15416952,169,0,0,1,1
15416953,15417074,121,1,0,0,1
15417070,15417352,282,0,0,1,2
15417075,15417351,276,0,0,1,1
15417352,15417412,60,1,0,0,1
15417353,15417413,60,1,0,0,2
15417413,15417523,110,0,0,1,1
15417414,15417523,109,0,0,1,2
15417524,15417545,21,1,0,0,1
15417524,15417554,30,1,0,0,2
15417546,15417737,191,0,0,1,1
15417555,15417737,182,0,0,1,2
15417738,15418003,265,1,0,0,1
15417738,15418014,276,1,0,0,2
15417775,15417961,186,0,1,0,1
15417776,15417983,207,0,1,0,2
15418004,15418130,126,0,0,1,1
15418015,15418126,111,0,0,1,2
15418127,15418145,18,1,0,0,2
15418131,15418143,12,1,0,0,1
15418144,15420001,1857,0,0,1,1
15418146,15420002,1856,0,0,1,2
15420002,15420061,59,1,0,0,1
15420003,15420058,55,1,0,0,2
15420059,15420093,34,0,0,1,2
15420062,15422174,2112,0,0,1,1
15420094,15420104,10,1,0,0,2
15420105,15420253,148,0,0,1,2
15420254,15420268,14,1,0,0,2
15420269,15422187,1918,0,0,1,2
15422175,15422411,236,1,0,0,1
15422188,15422414,226,1,0,0,2
15422221,15422356,135,0,1,0,1
15422224,15422368,144,0,1,0,2
15422412,15423380,968,0,0,1,1
15422415,15423380,965,0,0,1,2
15423381,15423472,91,1,0,0,1
15423381,15423472,91,1,0,0,2
15423473,15423610,137,0,0,1,1
15423473,15423681,208,0,0,1,2
15423611,15423620,9,1,0,0,1
15423621,15423685,64,0,0,1,1
15423682,15424375,693,1,0,0,2
15423686,15424242,556,1,0,0,1
15423709,15424266,557,0,1,0,2
15423711,15423952,241,0,1,0,1
15423987,15424196,209,0,1,0,1
15424243,15424325,82,0,0,1,1
15424326,15424369,43,1,0,0,1
15424370,15424484,114,0,0,1,1
15424376,15424492,116,0,0,1,2
15424485,15424503,18,1,0,0,1
15424493,15424506,13,1,0,0,2
15424504,15426871,2367,0,0,1,1
15424507,15426871,2364,0,0,1,2
15426872,15426914,42,1,0,0,2
15426872,15426916,44,1,0,0,1
15426915,15428850,1935,0,0,1,2
15426917,15428854,1937,0,0,1,1
15428851,15429821,970,1,0,0,2
15428855,15429815,960,1,0,0,1
15428878,15429804,926,0,1,0,1
15428878,15429804,926,0,1,0,2
15429816,15429993,177,0,0,1,1
15429822,15429992,170,0,0,1,2
15429993,15430024,31,1,0,0,2
15429994,15430020,26,1,0,0,1
15430021,15430678,657,0,0,1,1
15430025,15430679,654,0,0,1,2
15430679,15430771,92,1,0,0,1
15430680,15430746,66,1,0,0,2
15430747,15430852,105,0,0,1,2
15430772,15430849,77,0,0,1,1
15430850,15430874,24,1,0,0,1
15430853,15430878,25,1,0,0,2
15430875,15431021,146,0,0,1,1
15430879,15430980,101,0,0,1,2
15430981,15432129,1148,1,0,0,2
15431022,15431306,284,1,0,0,1
15431054,15431258,204,0,1,0,1
15431055,15431280,225,0,1,0,2
15431307,15431330,23,0,0,1,1
15431331,15431886,555,1,0,0,1
15431397,15431875,478,0,1,0,1
15431398,15431876,478,0,1,0,2
15431887,15431909,22,0,0,1,1
15431910,15432132,222,1,0,0,1
15431927,15432083,156,0,1,0,1
15431928,15432096,168,0,1,0,2
15432130,15432197,67,0,0,1,2
15432133,15432198,65,0,0,1,1
15432198,15432218,20,1,0,0,2
15432199,15432220,21,1,0,0,1
15432219,15434553,2334,0,0,1,2
15432221,15434552,2331,0,0,1,1
15434553,15434597,44,1,0,0,1
15434554,15434610,56,1,0,0,2
15434598,15437694,3096,0,0,1,1
15434611,15436738,2127,0,0,1,2
15436739,15436803,64,1,0,0,2
15436804,15437708,904,0,0,1,2
15437695,15438038,343,1,0,0,1
15437709,15438087,378,1,0,0,2
15437729,15437990,261,0,1,0,1
15437742,15438033,291,0,1,0,2
15438039,15438196,157,0,0,1,1
15438088,15438194,106,0,0,1,2
15438195,15438287,92,1,0,0,2
15438197,15438263,66,1,0,0,1
15438264,15438354,90,0,0,1,1
15438288,15438369,81,0,0,1,2
15438355,15438457,102,1,0,0,1
15438370,15438414,44,1,0,0,2
15438415,15438451,36,0,0,1,2
15438452,15438526,74,1,0,0,2
15438458,15438556,98,0,0,1,1
15438527,15438559,32,0,0,1,2
15438557,15438644,87,1,0,0,1
15438560,15438628,68,1,0,0,2
15438629,15438712,83,0,0,1,2
15438645,15438986,341,0,0,1,1
15438713,15438742,29,1,0,0,2
15438743,15438794,51,0,0,1,2
15438795,15439021,226,1,0,0,2
15438987,15439043,56,1,0,0,1
15439022,15439058,36,0,0,1,2
15439044,15439554,510,0,0,1,1
15439059,15439126,67,1,0,0,2
15439127,15439159,32,0,0,1,2
15439160,15439447,287,1,0,0,2
15439448,15439469,21,0,0,1,2
15439470,15440088,618,1,0,0,2
15439555,15439589,34,1,0,0,1
15439590,15440572,982,0,0,1,1
15440089,15440151,62,0,0,1,2
15440152,15440232,80,1,0,0,2
15440233,15440506,273,0,0,1,2
15440507,15440521,14,1,0,0,2
15440522,15440548,26,0,0,1,2
15440549,15440833,284,1,0,0,2
15440573,15440781,208,1,0,0,1
15440594,15440743,149,0,1,0,1
15440597,15440751,154,0,1,0,2
15440782,15440841,59,0,0,1,1
15440834,15441091,257,0,0,1,2
15440842,15440863,21,1,0,0,1
15440864,15440995,131,0,0,1,1
15440996,15441053,57,1,0,0,1
15441054,15441144,90,0,0,1,1
15441092,15441123,31,1,0,0,2
15441124,15441838,714,0,0,1,2
15441145,15441164,19,1,0,0,1
15441165,15441376,211,0,0,1,1
15441377,15441502,125,1,0,0,1
15441503,15441982,479,0,0,1,1
15441839,15441900,61,1,0,0,2
15441901,15442148,247,0,0,1,2
15441983,15442127,144,1,0,0,1
15442128,15442397,269,0,0,1,1
15442149,15442161,12,1,0,0,2
15442162,15442257,95,0,0,1,2
15442258,15442262,4,1,0,0,2
15442263,15442472,209,0,0,1,2
15442398,15442414,16,1,0,0,1
15442415,15442612,197,0,0,1,1
15442473,15442494,21,1,0,0,2
15442495,15442847,352,0,0,1,2
15442613,15442682,69,1,0,0,1
15442683,15442847,164,0,0,1,1
15442848,15442913,65,1,0,0,2
15442848,15442922,74,1,0,0,1
15442914,15444066,1152,0,0,1,2
15442923,15443007,84,0,0,1,1
15443008,15443023,15,1,0,0,1
15443024,15443044,20,0,0,1,1
15443045,15443197,152,1,0,0,1
15443198,15443218,20,0,0,1,1
15443219,15445394,2175,1,0,0,1
15444067,15444098,31,1,0,0,2
15444099,15444764,665,0,0,1,2
15444765,15445432,667,1,0,0,2
15444785,15445407,622,0,1,0,2
15444788,15445374,586,0,1,0,1
15445395,15445467,72,0,0,1,1
15445433,15445463,30,0,0,1,2
15445464,15445804,340,1,0,0,2
15445468,15445739,271,1,0,0,1
15445488,15445737,249,0,1,0,2
15445489,15445701,212,0,1,0,1
15445740,15446286,546,0,0,1,1
15445805,15446391,586,0,0,1,2
15446287,15446296,9,1,0,0,1
15446297,15446391,94,0,0,1,1
15446392,15446405,13,1,0,0,2
15446392,15446427,35,1,0,0,1
15446406,15446515,109,0,0,1,2
15446428,15446851,423,0,0,1,1
15446516,15446546,30,1,0,0,2
15446547,15446796,249,0,0,1,2
15446797,15446811,14,1,0,0,2
15446812,15447134,322,0,0,1,2
15446852,15446868,16,1,0,0,1
15446869,15446921,52,0,0,1,1
15446922,15447044,122,1,0,0,1
15447045,15447212,167,0,0,1,1
15447135,15447156,21,1,0,0,2
15447157,15447758,601,0,0,1,2
15447213,15447232,19,1,0,0,1
15447233,15448165,932,0,0,1,1
15447759,15447774,15,1,0,0,2
15447775,15447870,95,0,0,1,2
15447871,15447894,23,1,0,0,2
15447895,15448166,271,0,0,1,2
15448166,15448209,43,1,0,0,1
15448167,15448241,74,1,0,0,2
15448210,15448334,124,0,0,1,1
15448242,15448330,88,0,0,1,2
15448331,15448346,15,1,0,0,2
15448335,15448346,11,1,0,0,1
15448347,15448920,573,0,0,1,2
15448347,15449912,1565,0,0,1,1
15448921,15448931,10,1,0,0,2
15448932,15449374,442,0,0,1,2
15449375,15449393,18,1,0,0,2
15449394,15449896,502,0,0,1,2
15449897,15449999,102,1,0,0,2
15449913,15450767,854,1,0,0,1
15450000,15450024,24,0,0,1,2
15450025,15450827,802,1,0,0,2
15450039,15450312,273,0,1,0,1
15450041,15450303,262,0,1,0,2
15450379,15450716,337,0,1,0,2
15450384,15450756,372,0,1,0,1
15450768,15451518,750,0,0,1,1
15450828,15451518,690,0,0,1,2
15451519,15451579,60,1,0,0,1
15451519,15451584,65,1,0,0,2
15451580,15451698,118,0,0,1,1
15451585,15451700,115,0,0,1,2
15451699,15451714,15,1,0,0,1
15451701,15451716,15,1,0,0,2
15451715,15454608,2893,0,0,1,1
15451717,15454608,2891,0,0,1,2
15454609,15454670,61,1,0,0,1
15454609,15454723,114,1,0,0,2
15454671,15456519,1848,0,0,1,1
15454724,15456505,1781,0,0,1,2
15456506,15457012,506,1,0,0,2
15456520,15456888,368,1,0,0,1
15456570,15456835,265,0,1,0,1
15456575,15456946,371,0,1,0,2
15456889,15457136,247,0,0,1,1
15457013,15457113,100,0,0,1,2
15457114,15457447,333,1,0,0,2
15457137,15457356,219,1,0,0,1
15457146,15457376,230,0,1,0,2
15457156,15457326,170,0,1,0,1
15457357,15458515,1158,0,0,1,1
15457448,15458510,1062,0,0,1,2
15458511,15459620,1109,1,0,0,2
15458516,15459600,1084,1,0,0,1
15458558,15459607,1049,0,1,0,2
15458567,15459225,658,0,1,0,1
15459340,15459546,206,0,1,0,1
15459601,15461154,1553,0,0,1,1
15459621,15459760,139,0,0,1,2
15459761,15459788,27,1,0,0,2
15459789,15459988,199,0,0,1,2
15459989,15460087,98,1,0,0,2
15460088,15460123,35,0,0,1,2
15460124,15460135,11,1,0,0,2
15460136,15460609,473,0,0,1,2
15460610,15460659,49,1,0,0,2
15460660,15461256,596,0,0,1,2
15461155,15461163,8,1,0,0,1
15461164,15462003,839,0,0,1,1
15461257,15461271,14,1,0,0,2
15461272,15461318,46,0,0,1,2
15461319,15461471,152,1,0,0,2
15461472,15461614,142,0,0,1,2
15461615,15461691,76,1,0,0,2
15461692,15461859,167,0,0,1,2
15461860,15461979,119,1,0,0,2
15461980,15462003,23,0,0,1,2
15462004,15462049,45,1,0,0,1
15462004,15462055,51,1,0,0,2
15462050,15462295,245,0,0,1,1
15462056,15462296,240,0,0,1,2
15462296,15462329,33,1,0,0,1
15462297,15462314,17,1,0,0,2
15462315,15465144,2829,0,0,1,2
15462330,15465148,2818,0,0,1,1
15465145,15465381,236,1,0,0,2
15465149,15465371,222,1,0,0,1
15465170,15465347,177,0,1,0,2
15465177,15465317,140,0,1,0,1
15465372,15465526,154,0,0,1,1
15465382,15465518,136,0,0,1,2
15465519,15465540,21,1,0,0,2
15465527,15465537,10,1,0,0,1
15465538,15465725,187,0,0,1,1
15465541,15465724,183,0,0,1,2
15465725,15466053,328,1,0,0,2
15465726,15466043,317,1,0,0,1
15465768,15465984,216,0,1,0,1
15465770,15466019,249,0,1,0,2
15466044,15466085,41,0,0,1,1
15466054,15466090,36,0,0,1,2
15466086,15466350,264,1,0,0,1
15466091,15466355,264,1,0,0,2
15466111,15466299,188,0,1,0,1
15466111,15466318,207,0,1,0,2
15466351,15468396,2045,0,0,1,1
15466356,15468397,2041,0,0,1,2
15468397,15468449,52,1,0,0,1
15468398,15468448,50,1,0,0,2
15468449,15470552,2103,0,0,1,2
15468450,15470542,2092,0,0,1,1
15470543,15471068,525,1,0,0,1
15470553,15471400,847,1,0,0,2
15470572,15471050,478,0,1,0,1
15470577,15471092,515,0,1,0,2
15471069,15471113,44,0,0,1,1
15471114,15471380,266,1,0,0,1
15471139,15471346,207,0,1,0,1
15471143,15471362,219,0,1,0,2
15471381,15472142,761,0,0,1,1
15471401,15472076,675,0,0,1,2
15472077,15472225,148,1,0,0,2
15472143,15472197,54,1,0,0,1
15472198,15472318,120,0,0,1,1
15472226,15472315,89,0,0,1,2
15472316,15472426,110,1,0,0,2
15472319,15472334,15,1,0,0,1
15472335,15472755,420,0,0,1,1
15472427,15472595,168,0,0,1,2
15472596,15472652,56,1,0,0,2
15472653,15472752,99,0,0,1,2
15472753,15472968,215,1,0,0,2
15472756,15472947,191,1,0,0,1
15472787,15472897,110,0,1,0,1
15472788,15472899,111,0,1,0,2
15472948,15473062,114,0,0,1,1
15472969,15473062,93,0,0,1,2
15473063,15473080,17,1,0,0,1
15473063,15473082,19,1,0,0,2
15473081,15474996,1915,0,0,1,1
15473083,15474996,1913,0,0,1,2
15474997,15475037,40,1,0,0,1
15474997,15475037,40,1,0,0,2
15475038,15475221,183,0,0,1,2
15475038,15475222,184,0,0,1,1
15475222,15475233,11,1,0,0,2
15475223,15475228,5,1,0,0,1
15475229,15477036,1807,0,0,1,1
15475234,15476644,1410,0,0,1,2
15476645,15476679,34,1,0,0,2
15476680,15476718,38,0,0,1,2
15476719,15476746,27,1,0,0,2
15476747,15477029,282,0,0,1,2
15477030,15477431,401,1,0,0,2
15477037,15477380,343,1,0,0,1
15477082,15477341,259,0,1,0,1
15477086,15477420,334,0,1,0,2
15477381,15477616,235,0,0,1,1
15477432,15477611,179,0,0,1,2
15477612,15477922,310,1,0,0,2
15477617,15477863,246,1,0,0,1
15477634,15477878,244,0,1,0,2
15477636,15477834,198,0,1,0,1
15477864,15478323,459,0,0,1,1
15477923,15478321,398,0,0,1,2
15478322,15478374,52,1,0,0,2
15478324,15478387,63,1,0,0,1
15478375,15478495,120,0,0,1,2
15478388,15478486,98,0,0,1,1
15478487,15478504,17,1,0,0,1
15478496,15478528,32,1,0,0,2
15478505,15480088,1583,0,0,1,1
15478529,15481093,2564,0,0,1,2
15480089,15480098,9,1,0,0,1
15480099,15480125,26,0,0,1,1
15480126,15480227,101,1,0,0,1
15480228,15481091,863,0,0,1,1
15481092,15481142,50,1,0,0,1
15481094,15481196,102,1,0,0,2
15481143,15483359,2216,0,0,1,1
15481197,15483348,2151,0,0,1,2
15483349,15483813,464,1,0,0,2
15483360,15483761,401,1,0,0,1
15483372,15483778,406,0,1,0,2
15483381,15483751,370,0,1,0,1
15483762,15483912,150,0,0,1,1
15483814,15483895,81,0,0,1,2
15483896,15484176,280,1,0,0,2
15483913,15484146,233,1,0,0,1
15483922,15484141,219,0,1,0,2
15483931,15484110,179,0,1,0,1
15484147,15485274,1127,0,0,1,1
15484177,15485275,1098,0,0,1,2
15485275,15485321,46,1,0,0,1
15485276,15485327,51,1,0,0,2
15485322,15487909,2587,0,0,1,1
15485328,15485501,173,0,0,1,2
15485502,15485509,7,1,0,0,2
15485510,15487909,2399,0,0,1,2
15487910,15487961,51,1,0,0,1
15487910,15488268,358,1,0,0,2
15487962,15487995,33,0,0,1,1
15487996,15488217,221,1,0,0,1
15488021,15488190,169,0,1,0,2
15488024,15488165,141,0,1,0,1
15488218,15488584,366,0,0,1,1
15488269,15488326,57,0,0,1,2
15488327,15488437,110,1,0,0,2
15488438,15488470,32,0,0,1,2
15488471,15488503,32,1,0,0,2
15488504,15488528,24,0,0,1,2
15488529,15488591,62,1,0,0,2
15488585,15488599,14,1,0,0,1
15488592,15488794,202,0,0,1,2
15488600,15489534,934,0,0,1,1
15488795,15488846,51,1,0,0,2
15488847,15488867,20,0,0,1,2
15488868,15488921,53,1,0,0,2
15488922,15488942,20,0,0,1,2
15488943,15489058,115,1,0,0,2
15489059,15489335,276,0,0,1,2
15489336,15489384,48,1,0,0,2
15489385,15489472,87,0,0,1,2
15489473,15489503,30,1,0,0,2
15489504,15489559,55,0,0,1,2
15489535,15489540,5,1,0,0,1
15489541,15489787,246,0,0,1,1
15489560,15490094,534,1,0,0,2
15489788,15489795,7,1,0,0,1
15489796,15489864,68,0,0,1,1
15489865,15489894,29,1,0,0,1
15489895,15490055,160,0,0,1,1
15490056,15490105,49,1,0,0,1
15490095,15490166,71,0,0,1,2
15490106,15490470,364,0,0,1,1
15490167,15490624,457,1,0,0,2
15490471,15490480,9,1,0,0,1
15490481,15490553,72,0,0,1,1
15490554,15490640,86,1,0,0,1
15490625,15490708,83,0,0,1,2
15490641,15490867,226,0,0,1,1
15490709,15490819,110,1,0,0,2
15490820,15490870,50,0,0,1,2
15490868,15491099,231,1,0,0,1
15490871,15491114,243,1,0,0,2
15490910,15491056,146,0,1,0,1
15490913,15491068,155,0,1,0,2
15491100,15491496,396,0,0,1,1
15491115,15491496,381,0,0,1,2
15491497,15491562,65,1,0,0,1
15491497,15491656,159,1,0,0,2
15491563,15491765,202,0,0,1,1
15491657,15491762,105,0,0,1,2
15491763,15491778,15,1,0,0,2
15491766,15491777,11,1,0,0,1
15491778,15493369,1591,0,0,1,1
15491779,15492334,555,0,0,1,2
15492335,15492388,53,1,0,0,2
15492389,15492420,31,0,0,1,2
15492421,15492501,80,1,0,0,2
15492502,15492598,96,0,0,1,2
15492599,15492621,22,1,0,0,2
15492622,15493096,474,0,0,1,2
15493097,15493202,105,1,0,0,2
15493203,15493267,64,0,0,1,2
15493268,15493282,14,1,0,0,2
15493283,15493370,87,0,0,1,2
15493370,15493424,54,1,0,0,1
15493371,15493459,88,1,0,0,2
15493425,15495471,2046,0,0,1,1
15493460,15495471,2011,0,0,1,2
15495472,15495812,340,1,0,0,2
15495472,15495831,359,1,0,0,1
15495498,15495719,221,0,1,0,1
15495498,15495748,250,0,1,0,2
15495813,15495852,39,0,0,1,2
15495832,15496003,171,0,0,1,1
15495853,15495857,4,1,0,0,2
15495858,15496002,144,0,0,1,2
15496003,15496062,59,1,0,0,2
15496004,15496049,45,1,0,0,1
15496050,15496414,364,0,0,1,1
15496063,15496280,217,0,0,1,2
15496281,15496353,72,1,0,0,2
15496354,15496392,38,0,0,1,2
15496393,15497379,986,1,0,0,2
15496415,15497369,954,1,0,0,1
15496436,15497325,889,0,1,0,1
15496436,15497362,926,0,1,0,2
15497370,15497461,91,0,0,1,1
15497380,15497460,80,0,0,1,2
15497461,15497495,34,1,0,0,2
15497462,15497489,27,1,0,0,1
15497490,15498010,520,0,0,1,1
15497496,15498013,517,0,0,1,2
15498011,15498055,44,1,0,0,1
15498014,15498053,39,1,0,0,2
15498054,15498512,458,0,0,1,2
15498056,15498512,456,0,0,1,1
15498513,15498995,482,1,0,0,1
15498513,15498997,484,1,0,0,2
15498639,15498911,272,0,1,0,2
15498646,15498876,230,0,1,0,1
15498996,15499060,64,0,0,1,1
15498998,15499050,52,0,0,1,2
15499051,15499285,234,1,0,0,2
15499061,15499258,197,1,0,0,1
15499077,15499220,143,0,1,0,1
15499078,15499244,166,0,1,0,2
15499259,15499362,103,0,0,1,1
15499286,15499361,75,0,0,1,2
15499362,15499389,27,1,0,0,2
15499363,15499394,31,1,0,0,1
15499390,15499458,68,0,0,1,2
15499395,15499458,63,0,0,1,1
15545098,15545512,414,0,0,1,2
15545098,15545514,416,0,0,1,1
15545513,15545601,88,1,0,0,2
15545515,15545593,78,1,0,0,1
15545594,15545678,84,0,0,1,1
15545602,15545676,74,0,0,1,2
15545677,15545734,57,1,0,0,2
15545679,15545706,27,1,0,0,1
15545707,15546702,995,0,0,1,1
15545735,15546705,970,0,0,1,2
15546703,15546944,241,1,0,0,1
15546706,15546961,255,1,0,0,2
15546742,15546912,170,0,1,0,1
15546743,15546927,184,0,1,0,2
15546945,15547048,103,0,0,1,1
15546962,15547047,85,0,0,1,2
15547048,15548987,1939,1,0,0,2
15547049,15548986,1937,1,0,0,1
15547074,15548596,1522,0,1,0,1
15547077,15548599,1522,0,1,0,2
15548620,15548754,134,0,1,0,2
15548623,15548737,114,0,1,0,1
15548816,15548954,138,0,1,0,2
15548820,15548951,131,0,1,0,1
15548987,15549072,85,0,0,1,1
15548988,15549072,84,0,0,1,2
15549073,15549252,179,1,0,0,1
15549073,15549260,187,1,0,0,2
15549097,15549216,119,0,1,0,1
15549098,15549226,128,0,1,0,2
15549253,15551816,2563,0,0,1,1
15549261,15549541,280,0,0,1,2
15549542,15549558,16,1,0,0,2
15549559,15551816,2257,0,0,1,2
15551817,15551866,49,1,0,0,1
15551817,15551876,59,1,0,0,2
15551867,15551948,81,0,0,1,1
15551877,15551948,71,0,0,1,2
15551949,15551973,24,1,0,0,1
15551949,15551992,43,1,0,0,2
15551974,15554320,2346,0,0,1,1
15551993,15554319,2326,0,0,1,2
15554320,15554424,104,1,0,0,2
15554321,15554429,108,1,0,0,1
15554425,15554516,91,0,0,1,2
15554430,15554514,84,0,0,1,1
15554515,15554542,27,1,0,0,1
15554517,15554541,24,1,0,0,2
15554542,15554704,162,0,0,1,2
15554543,15556158,1615,0,0,1,1
15554705,15554715,10,1,0,0,2
15554716,15555501,785,0,0,1,2
15555502,15555512,10,1,0,0,2
15555513,15555586,73,0,0,1,2
15555587,15555724,137,1,0,0,2
15555725,15555763,38,0,0,1,2
15555764,15555770,6,1,0,0,2
15555771,15555833,62,0,0,1,2
15555834,15555848,14,1,0,0,2
15555849,15556731,882,0,0,1,2
15556159,15556203,44,1,0,0,1
15556204,15556730,526,0,0,1,1
15556731,15556778,47,1,0,0,1
15556732,15556810,78,1,0,0,2
15556779,15556877,98,0,0,1,1
15556811,15556878,67,0,0,1,2
15556878,15556888,10,1,0,0,1
15556879,15556886,7,1,0,0,2
15556887,15559025,2138,0,0,1,2
15556889,15559032,2143,0,0,1,1
15559026,15562777,3751,1,0,0,2
15559033,15562773,3740,1,0,0,1
15559049,15562381,3332,0,1,0,2
15559053,15562748,3695,0,1,0,1
15562504,15562506,2,0,1,0,2
15562687,15562723,36,0,1,0,2
15562774,15562858,84,0,0,1,1
15562778,15562858,80,0,0,1,2
15562859,15562886,27,1,0,0,1
15562859,15562892,33,1,0,0,2
15562887,15565046,2159,0,0,1,1
15562893,15563008,115,0,0,1,2
15563009,15563026,17,1,0,0,2
15563027,15565045,2018,0,0,1,2
15565046,15565168,122,1,0,0,2
15565047,15565172,125,1,0,0,1
15565169,15565252,83,0,0,1,2
15565173,15565243,70,0,0,1,1
15565244,15567933,2689,1,0,0,1
15565253,15565292,39,1,0,0,2
15565256,15567911,2655,0,1,0,1
15565293,15565444,151,0,0,1,2
15565445,15565474,29,1,0,0,2
15565475,15565518,43,0,0,1,2
15565519,15565523,4,1,0,0,2
15565524,15565553,29,0,0,1,2
15565554,15568045,2491,1,0,0,2
15565605,15567955,2350,0,1,0,2
15567934,15568012,78,0,0,1,1
15568013,15568045,32,1,0,0,1
15568046,15568278,232,0,0,1,1
15568046,15568278,232,0,0,1,2
15568279,15568501,222,1,0,0,1
15568279,15568590,311,1,0,0,2
15568305,15568503,198,0,1,0,2
15568311,15568466,155,0,1,0,1
15568502,15568570,68,0,0,1,1
15568571,15568581,10,1,0,0,1
15568582,15570365,1783,0,0,1,1
15568591,15570365,1774,0,0,1,2
15570366,15570424,58,1,0,0,1
15570366,15570456,90,1,0,0,2
15570425,15574263,3838,0,0,1,1
15570457,15570865,408,0,0,1,2
15570866,15570886,20,1,0,0,2
15570887,15570914,27,0,0,1,2
15570915,15570924,9,1,0,0,2
15570925,15571194,269,0,0,1,2
15571195,15571212,17,1,0,0,2
15571213,15571451,238,0,0,1,2
15571452,15571456,4,1,0,0,2
15571457,15574261,2804,0,0,1,2
15574262,15574358,96,1,0,0,2
15574264,15574323,59,1,0,0,1
15574324,15574435,111,0,0,1,1
15574359,15574432,73,0,0,1,2
15574433,15574452,19,1,0,0,2
15574436,15574452,16,1,0,0,1
15574453,15574863,410,0,0,1,1
15574453,15574871,418,0,0,1,2
15574864,15575903,1039,1,0,0,1
15574872,15575941,1069,1,0,0,2
15574916,15575682,766,0,1,0,1
15574921,15575895,974,0,1,0,2
15575738,15575854,116,0,1,0,1
15575904,15575987,83,0,0,1,1
15575942,15575982,40,0,0,1,2
15575983,15576076,93,1,0,0,2
15575988,15576092,104,1,0,0,1
15576077,15576174,97,0,0,1,2
15576093,15576174,81,0,0,1,1
15576175,15576202,27,1,0,0,1
15576175,15576208,33,1,0,0,2
15576203,15577851,1648,0,0,1,1
15576209,15577850,1641,0,0,1,2
15577851,15577960,109,1,0,0,2
15577852,15577957,105,1,0,0,1
15577958,15578041,83,0,0,1,1
15577961,15578042,81,0,0,1,2
15578042,15578180,138,1,0,0,1
15578043,15583568,5525,1,0,0,2
15578078,15578135,57,0,1,0,1
15578106,15583533,5427,0,1,0,2
15578181,15578263,82,0,0,1,1
15578274,15580913,2639,0,1,0,1
15580923,15580954,31,1,0,0,1
15580955,15581084,129,0,0,1,1
15581085,15581514,429,1,0,0,1
15581098,15581504,406,0,1,0,1
15581515,15581551,36,0,0,1,1
15581552,15581566,14,1,0,0,1
15581567,15581624,57,0,0,1,1
15581625,15581639,14,1,0,0,1
15581640,15582457,817,0,0,1,1
15582458,15582492,34,1,0,0,1
15582493,15583149,656,0,0,1,1
15583160,15583286,126,0,1,0,1
15583296,15583296,0,1,0,0,1
15583297,15583439,142,0,0,1,1
15583440,15583550,110,1,0,0,1
15583551,15583630,79,0,0,1,1
15583569,15583630,61,0,0,1,2
15583631,15583658,27,1,0,0,2
15583631,15584044,413,1,0,0,1
15583659,15586269,2610,0,0,1,2
15584045,15584125,80,0,0,1,1
15584126,15584197,71,1,0,0,1
15584198,15584637,439,0,0,1,1
15584638,15584663,25,1,0,0,1
15584664,15584739,75,0,0,1,1
15584740,15584762,22,1,0,0,1
15584763,15584996,233,0,0,1,1
15584997,15585099,102,1,0,0,1
15585100,15585304,204,0,0,1,1
15585305,15585338,33,1,0,0,1
15585339,15585388,49,0,0,1,1
15585389,15585405,16,1,0,0,1
15585406,15585532,126,0,0,1,1
15585533,15585650,117,1,0,0,1
15585651,15585741,90,0,0,1,1
15585742,15585749,7,1,0,0,1
15585750,15585898,148,0,0,1,1
15585899,15585938,39,1,0,0,1
15585939,15586185,246,0,0,1,1
15586186,15586199,13,1,0,0,1
15586200,15586276,76,0,0,1,1
15586270,15586770,500,1,0,0,2
15586277,15586742,465,1,0,0,1
15586316,15586759,443,0,1,0,2
15586325,15586731,406,0,1,0,1
15586743,15586810,67,0,0,1,1
15586771,15586812,41,0,0,1,2
15586811,15587037,226,1,0,0,1
15586813,15587055,242,1,0,0,2
15586845,15587003,158,0,1,0,1
15586849,15587019,170,0,1,0,2
15587038,15587138,100,0,0,1,1
15587056,15587140,84,0,0,1,2
15587139,15587145,6,1,0,0,1
15587141,15587157,16,1,0,0,2
15587146,15589292,2146,0,0,1,1
15587158,15587375,217,0,0,1,2
15587376,15587400,24,1,0,0,2
15587401,15587443,42,0,0,1,2
15587444,15587496,52,1,0,0,2
15587497,15587587,90,0,0,1,2
15587588,15587649,61,1,0,0,2
15587650,15589215,1565,0,0,1,2
15589216,15589231,15,1,0,0,2
15589232,15589293,61,0,0,1,2
15589293,15589339,46,1,0,0,1
15589294,15589337,43,1,0,0,2
15589338,15591727,2389,0,0,1,2
15589340,15591727,2387,0,0,1,1
15591728,15591842,114,1,0,0,2
15591728,15591847,119,1,0,0,1
15591843,15591925,82,0,0,1,2
15591848,15591921,73,0,0,1,1
15591922,15591946,24,1,0,0,1
15591926,15591948,22,1,0,0,2
15591947,15591980,33,0,0,1,1
15591949,15591978,29,0,0,1,2
15591979,15592319,340,1,0,0,2
15591981,15592276,295,1,0,0,1
15592009,15592241,232,0,1,0,1
15592010,15592286,276,0,1,0,2
15592277,15592387,110,0,0,1,1
15592320,15592388,68,0,0,1,2
15592388,15592881,493,1,0,0,1
15592389,15592858,469,1,0,0,2
15592406,15592813,407,0,1,0,2
15592410,15592743,333,0,1,0,1
15592859,15592983,124,0,0,1,2
15592882,15593241,359,0,0,1,1
15592984,15593117,133,1,0,0,2
15593118,15593157,39,0,0,1,2
15593158,15593305,147,1,0,0,2
15593242,15593246,4,1,0,0,1
15593247,15595037,1790,0,0,1,1
15593306,15593381,75,0,0,1,2
15593382,15593420,38,1,0,0,2
15593421,15593589,168,0,0,1,2
15593590,15593628,38,1,0,0,2
15593629,15593862,233,0,0,1,2
15593863,15593870,7,1,0,0,2
15593871,15593971,100,0,0,1,2
15593972,15594026,54,1,0,0,2
15594027,15594248,221,0,0,1,2
15594249,15594320,71,1,0,0,2
15594321,15594683,362,0,0,1,2
15594684,15594696,12,1,0,0,2
15594697,15594882,185,0,0,1,2
15594883,15594957,74,1,0,0,2
15594958,15595036,78,0,0,1,2
15595037,15595113,76,1,0,0,2
15595038,15595103,65,1,0,0,1
15595104,15595164,60,0,0,1,1
15595114,15595164,50,0,0,1,2
15595165,15595199,34,1,0,0,1
15595165,15595232,67,1,0,0,2
15595200,15597149,1949,0,0,1,1
15595233,15595555,322,0,0,1,2
15595556,15595587,31,1,0,0,2
15595588,15595707,119,0,0,1,2
15595708,15595729,21,1,0,0,2
15595730,15596180,450,0,0,1,2
15596181,15596226,45,1,0,0,2
15596227,15596468,241,0,0,1,2
15596469,15596473,4,1,0,0,2
15596474,15596620,146,0,0,1,2
15596621,15596637,16,1,0,0,2
15596638,15596957,319,0,0,1,2
15596958,15597043,85,1,0,0,2
15597044,15597142,98,0,0,1,2
15597143,15599415,2272,1,0,0,2
15597150,15597431,281,1,0,0,1
15597166,15599389,2223,0,1,0,2
15597172,15597373,201,0,1,0,1
15597432,15597631,199,0,0,1,1
15597632,15597642,10,1,0,0,1
15597643,15598607,964,0,0,1,1
15598608,15598622,14,1,0,0,1
15598623,15599320,697,0,0,1,1
15599321,15599415,94,1,0,0,1
15599416,15599488,72,0,0,1,2
15599416,15599489,73,0,0,1,1
15599489,15599515,26,1,0,0,2
15599490,15599515,25,1,0,0,1
15599516,15601543,2027,0,0,1,1
15599516,15601543,2027,0,0,1,2
15601544,15601625,81,1,0,0,1
15601544,15601632,88,1,0,0,2
15601626,15601674,48,0,0,1,1
15601633,15601670,37,0,0,1,2
15601671,15601863,192,1,0,0,2
15601675,15601885,210,1,0,0,1
15601702,15601828,126,0,1,0,1
15601707,15601834,127,0,1,0,2
15601864,15602009,145,0,0,1,2
15601886,15603765,1879,0,0,1,1
15602010,15602025,15,1,0,0,2
15602026,15602503,477,0,0,1,2
15602504,15602508,4,1,0,0,2
15602509,15603762,1253,0,0,1,2
15603763,15604220,457,1,0,0,2
15603766,15604200,434,1,0,0,1
15603835,15604169,334,0,1,0,1
15603836,15604207,371,0,1,0,2
15604201,15604271,70,0,0,1,1
15604221,15604271,50,0,0,1,2
15604272,15604296,24,1,0,0,2
15604272,15604341,69,1,0,0,1
15604297,15604448,151,0,0,1,2
15604342,15604446,104,0,0,1,1
15604447,15604470,23,1,0,0,1
15604449,15604524,75,1,0,0,2
15604471,15606199,1728,0,0,1,1
15604525,15606198,1673,0,0,1,2
15606199,15606279,80,1,0,0,2
15606200,15606269,69,1,0,0,1
15606270,15606358,88,0,0,1,1
15606280,15606358,78,0,0,1,2
15606359,15606385,26,1,0,0,1
15606359,15606386,27,1,0,0,2
15606386,15608283,1897,0,0,1,1
15606387,15608282,1895,0,0,1,2
15608283,15608359,76,1,0,0,2
15608284,15608359,75,1,0,0,1
15608360,15608435,75,0,0,1,1
15608360,15608436,76,0,0,1,2
15608436,15608464,28,1,0,0,1
15608437,15608462,25,1,0,0,2
15608463,15608600,137,0,0,1,2
15608465,15608599,134,0,0,1,1
15608600,15608614,14,1,0,0,1
15608601,15608612,11,1,0,0,2
15608613,15610637,2024,0,0,1,2
15608615,15610636,2021,0,0,1,1
15610637,15614157,3520,1,0,0,1
15610638,15615075,4437,1,0,0,2
15610695,15615062,4367,0,1,0,2
15610704,15614012,3308,0,1,0,1
15614158,15614229,71,0,0,1,1
15614230,15614265,35,1,0,0,1
15614266,15615905,1639,0,0,1,1
15615076,15615165,89,0,0,1,2
15615166,15615297,131,1,0,0,2
15615298,15616388,1090,0,0,1,2
15615906,15615929,23,1,0,0,1
15615930,15616343,413,0,0,1,1
15616344,15616389,45,1,0,0,1
15616389,15616414,25,1,0,0,2
15616390,15616558,168,0,0,1,1
15616415,15616488,73,0,0,1,2
15616489,15616593,104,1,0,0,2
15616541,15616549,8,0,1,0,2
15616559,15616587,28,1,0,0,1
15616588,15616784,196,0,0,1,1
15616594,15616642,48,0,0,1,2
15616643,15616702,59,1,0,0,2
15616703,15616733,30,0,0,1,2
15616734,15616836,102,1,0,0,2
15616785,15616863,78,1,0,0,1
15616837,15616901,64,0,0,1,2
15616864,15616997,133,0,0,1,1
15616902,15616923,21,1,0,0,2
15616924,15616968,44,0,0,1,2
15616969,15617251,282,1,0,0,2
15616997,15617202,205,0,1,0,2
15616998,15617225,227,1,0,0,1
15617018,15617174,156,0,1,0,1
15617226,15617321,95,0,0,1,1
15617252,15617321,69,0,0,1,2
15617322,15617338,16,1,0,0,1
15617322,15617343,21,1,0,0,2
15617339,15619869,2530,0,0,1,1
15617344,15617557,213,0,0,1,2
15617558,15617568,10,1,0,0,2
15617569,15618805,1236,0,0,1,2
15618806,15618810,4,1,0,0,2
15618811,15619061,250,0,0,1,2
15619062,15619097,35,1,0,0,2
15619098,15619870,772,0,0,1,2
15619870,15619996,126,1,0,0,1
15619871,15619995,124,1,0,0,2
15619996,15620052,56,0,0,1,2
15619997,15620101,104,0,0,1,1
15620053,15620068,15,1,0,0,2
15620069,15620100,31,0,0,1,2
15620101,15620162,61,1,0,0,2
15620102,15620131,29,1,0,0,1
15620132,15620242,110,0,0,1,1
15620163,15620243,80,0,0,1,2
15620243,15620265,22,1,0,0,1
15620244,15620264,20,1,0,0,2
15620265,15622737,2472,0,0,1,2
15620266,15622740,2474,0,0,1,1
15622738,15622799,61,1,0,0,2
15622741,15622803,62,1,0,0,1
15622800,15622869,69,0,0,1,2
15622804,15622864,60,0,0,1,1
15622865,15622899,34,1,0,0,1
15622870,15622882,12,1,0,0,2
15622883,15622990,107,0,0,1,2
15622900,15622987,87,0,0,1,1
15622988,15623013,25,1,0,0,1
15622991,15623008,17,1,0,0,2
15623009,15624642,1633,0,0,1,2
15623014,15623171,157,0,0,1,1
15623172,15623187,15,1,0,0,1
15623188,15624645,1457,0,0,1,1
15624643,15626006,1363,1,0,0,2
15624646,15625956,1310,1,0,0,1
15624669,15625975,1306,0,1,0,2
15624677,15625946,1269,0,1,0,1
15625957,15626053,96,0,0,1,1
15626007,15626056,49,0,0,1,2
15626054,15626229,175,1,0,0,1
15626057,15626275,218,1,0,0,2
15626076,15626182,106,0,1,0,1
15626077,15626210,133,0,1,0,2
15626230,15626291,61,0,0,1,1
15626276,15626296,20,0,0,1,2
15626292,15626402,110,1,0,0,1
15626297,15626322,25,1,0,0,2
15626323,15628788,2465,0,0,1,2
15626403,15626451,48,0,0,1,1
15626452,15627153,701,1,0,0,1
15627154,15627264,110,0,0,1,1
15627265,15627314,49,1,0,0,1
15627315,15628790,1475,0,0,1,1
15628789,15628868,79,1,0,0,2
15628791,15628875,84,1,0,0,1
15628869,15628940,71,0,0,1,2
15628876,15628942,66,0,0,1,1
15628941,15628966,25,1,0,0,2
15628943,15628984,41,1,0,0,1
15628967,15629083,116,0,0,1,2
15628985,15629082,97,0,0,1,1
15629083,15629109,26,1,0,0,1
15629084,15629105,21,1,0,0,2
15629106,15629540,434,0,0,1,2
15629110,15631088,1978,0,0,1,1
15629541,15629561,20,1,0,0,2
15629562,15629740,178,0,0,1,2
15629741,15629761,20,1,0,0,2
15629762,15629840,78,0,0,1,2
15629841,15629845,4,1,0,0,2
15629846,15629892,46,0,0,1,2
15629893,15629952,59,1,0,0,2
15629953,15630110,157,0,0,1,2
15630111,15630115,4,1,0,0,2
15630116,15630218,102,0,0,1,2
15630219,15630243,24,1,0,0,2
15630244,15630312,68,0,0,1,2
15630313,15630325,12,1,0,0,2
15630326,15631091,765,0,0,1,2
15631089,15631320,231,1,0,0,1
15631092,15631108,16,1,0,0,2
15631109,15631129,20,0,0,1,2
15631130,15631318,188,1,0,0,2
15631319,15631586,267,0,0,1,2
15631321,15631584,263,0,0,1,1
15631585,15631639,54,1,0,0,1
15631587,15631639,52,1,0,0,2
15631640,15631695,55,0,0,1,1
15631640,15631697,57,0,0,1,2
15631696,15631990,294,1,0,0,1
15631698,15632089,391,1,0,0,2
15631743,15631938,195,0,1,0,1
15631746,15631975,229,0,1,0,2
15631991,15632067,76,0,0,1,1
15632068,15632099,31,1,0,0,1
15632090,15632264,174,0,0,1,2
15632100,15632164,64,0,0,1,1
15632165,15632188,23,1,0,0,1
15632189,15632312,123,0,0,1,1
15632265,15632276,11,1,0,0,2
15632277,15632923,646,0,0,1,2
15632313,15632322,9,1,0,0,1
15632323,15632495,172,0,0,1,1
15632496,15632509,13,1,0,0,1
15632510,15634115,1605,0,0,1,1
15632924,15632930,6,1,0,0,2
15632931,15633264,333,0,0,1,2
15633265,15633296,31,1,0,0,2
15633297,15633578,281,0,0,1,2
15633579,15633596,17,1,0,0,2
15633597,15634116,519,0,0,1,2
15634116,15634182,66,1,0,0,1
15634117,15634188,71,1,0,0,2
15634183,15634238,55,0,0,1,1
15634189,15634236,47,0,0,1,2
15634237,15634283,46,1,0,0,2
15634239,15634673,434,1,0,0,1
15634284,15635656,1372,0,0,1,2
15634674,15634705,31,0,0,1,1
15634706,15634784,78,1,0,0,1
15634785,15634835,50,0,0,1,1
15634836,15634857,21,1,0,0,1
15634858,15634881,23,0,0,1,1
15634882,15634985,103,1,0,0,1
15634986,15635311,325,0,0,1,1
15635312,15635390,78,1,0,0,1
15635391,15635692,301,0,0,1,1
15635657,15635661,4,1,0,0,2
15635662,15636561,899,0,0,1,2
15635693,15635889,196,1,0,0,1
15635890,15636015,125,0,0,1,1
15636016,15636041,25,1,0,0,1
15636042,15636104,62,0,0,1,1
15636105,15636241,136,1,0,0,1
15636242,15636415,173,0,0,1,1
15636416,15636702,286,1,0,0,1
15636562,15636728,166,1,0,0,2
15636703,15636755,52,0,0,1,1
15636729,15636759,30,0,0,1,2
15636756,15636780,24,1,0,0,1
15636760,15636809,49,1,0,0,2
15636781,15636836,55,0,0,1,1
15636810,15636833,23,0,0,1,2
15636834,15636858,24,1,0,0,2
15636837,15636854,17,1,0,0,1
15636855,15636994,139,0,0,1,1
15636859,15636988,129,0,0,1,2
15636989,15637046,57,1,0,0,2
15636995,15637000,5,1,0,0,1
15637001,15639421,2420,0,0,1,1
15637047,15637199,152,0,0,1,2
15637200,15637214,14,1,0,0,2
15637215,15637443,228,0,0,1,2
15637444,15637486,42,1,0,0,2
15637487,15637890,403,0,0,1,2
15637891,15637895,4,1,0,0,2
15637896,15638363,467,0,0,1,2
15638364,15638381,17,1,0,0,2
15638382,15638457,75,0,0,1,2
15638458,15638467,9,1,0,0,2
15638468,15639419,951,0,0,1,2
15639420,15643047,3627,1,0,0,2
15639422,15639479,57,1,0,0,1
15639456,15643028,3572,0,1,0,2
15639480,15639566,86,0,0,1,1
15639567,15639587,20,1,0,0,1
15639588,15641721,2133,0,0,1,1
15641722,15643004,1282,1,0,0,1
15641733,15642787,1054,0,1,0,1
15642832,15642970,138,0,1,0,1
15643005,15643148,143,0,0,1,1
15643048,15643488,440,0,0,1,2
15643149,15643160,11,1,0,0,1
15643161,15644822,1661,0,0,1,1
15643489,15643505,16,1,0,0,2
15643506,15644823,1317,0,0,1,2
15644823,15644923,100,1,0,0,1
15644824,15644899,75,1,0,0,2
15644900,15644986,86,0,0,1,2
15644924,15644990,66,0,0,1,1
15644987,15645015,28,1,0,0,2
15644991,15645010,19,1,0,0,1
15645011,15647233,2222,0,0,1,1
15645016,15645898,882,0,0,1,2
15645899,15645909,10,1,0,0,2
15645910,15646343,433,0,0,1,2
15646344,15646363,19,1,0,0,2
15646364,15646409,45,0,0,1,2
15646410,15647183,773,1,0,0,2
15646531,15646760,229,0,1,0,2
15647184,15647223,39,0,0,1,2
15647224,15652345,5121,1,0,0,2
15647234,15647575,341,1,0,0,1
15647252,15652334,5082,0,1,0,2
15647257,15647490,233,0,1,0,1
15647576,15649766,2190,0,0,1,1
15649767,15649849,82,1,0,0,1
15649850,15652076,2226,0,0,1,1
15652077,15652330,253,1,0,0,1
15652107,15652276,169,0,1,0,1
15652331,15652377,46,0,0,1,1
15652346,15652374,28,0,0,1,2
15652375,15652398,23,1,0,0,2
15652378,15652397,19,1,0,0,1
15652398,15652762,364,0,0,1,1
15652399,15652766,367,0,0,1,2
15652763,15653416,653,1,0,0,1
15652767,15653410,643,1,0,0,2
15652798,15653204,406,0,1,0,1
15652803,15653386,583,0,1,0,2
15653225,15653381,156,0,1,0,1
15653411,15653455,44,0,0,1,2
15653417,15653445,28,0,0,1,1
15653446,15653676,230,1,0,0,1
15653456,15653666,210,1,0,0,2
15653471,15653637,166,0,1,0,2
15653472,15653633,161,0,1,0,1
15653667,15655798,2131,0,0,1,2
15653677,15653992,315,0,0,1,1
15653993,15654000,7,1,0,0,1
15654001,15655797,1796,0,0,1,1
15655798,15655833,35,1,0,0,1
15655799,15655832,33,1,0,0,2
15655833,15658308,2475,0,0,1,2
15655834,15658305,2471,0,0,1,1
15658306,15658528,222,1,0,0,1
15658309,15658548,239,1,0,0,2
15658330,15658501,171,0,1,0,1
15658332,15658515,183,0,1,0,2
15658529,15660600,2071,0,0,1,1
15658549,15658890,341,0,0,1,2
15658891,15658914,23,1,0,0,2
15658915,15659405,490,0,0,1,2
15659406,15659420,14,1,0,0,2
15659421,15660602,1181,0,0,1,2
15660601,15660649,48,1,0,0,1
15660603,15660649,46,1,0,0,2
15660650,15660794,144,0,0,1,2
15660650,15660795,145,0,0,1,1
15660795,15660811,16,1,0,0,2
15660796,15660810,14,1,0,0,1
15660811,15662748,1937,0,0,1,1
15660812,15662748,1936,0,0,1,2
15662749,15662877,128,1,0,0,2
15662749,15662915,166,1,0,0,1
15662878,15662955,77,0,0,1,2
15662916,15662952,36,0,0,1,1
15662953,15662981,28,1,0,0,1
15662956,15663003,47,1,0,0,2
15662982,15665101,2119,0,0,1,1
15663004,15663158,154,0,0,1,2
15663159,15663171,12,1,0,0,2
15663172,15664313,1141,0,0,1,2
15664314,15664322,8,1,0,0,2
15664323,15665102,779,0,0,1,2
15665102,15665154,52,1,0,0,1
15665103,15665163,60,1,0,0,2
15665155,15665254,99,0,0,1,1
15665164,15665237,73,0,0,1,2
15665238,15665280,42,1,0,0,2
15665255,15665298,43,1,0,0,1
15665281,15665398,117,0,0,1,2
15665299,15665505,206,0,0,1,1
15665399,15665683,284,1,0,0,2
15665506,15665667,161,1,0,0,1
15665537,15665630,93,0,1,0,1
15665540,15665628,88,0,1,0,2
15665668,15665959,291,0,0,1,1
15665684,15665740,56,0,0,1,2
15665741,15665757,16,1,0,0,2
15665758,15665798,40,0,0,1,2
15665799,15665833,34,1,0,0,2
15665834,15665958,124,0,0,1,2
15665959,15666670,711,1,0,0,2
15665960,15666674,714,1,0,0,1
15665991,15666397,406,0,1,0,1
15665992,15666610,618,0,1,0,2
15666457,15666586,129,0,1,0,1
15666671,15666697,26,0,0,1,2
15666675,15666724,49,0,0,1,1
15666698,15666941,243,1,0,0,2
15666725,15666891,166,1,0,0,1
15666743,15666858,115,0,1,0,1
15666745,15666873,128,0,1,0,2
15666892,15667757,865,0,0,1,1
15666942,15667038,96,0,0,1,2
15667039,15667072,33,1,0,0,2
15667073,15667271,198,0,0,1,2
15667272,15667285,13,1,0,0,2
15667286,15668010,724,0,0,1,2
15667758,15667762,4,1,0,0,1
15667763,15668756,993,0,0,1,1
15668011,15668015,4,1,0,0,2
15668016,15668729,713,0,0,1,2
15668730,15668824,94,1,0,0,2
15668757,15668829,72,1,0,0,1
15668825,15668917,92,0,0,1,2
15668830,15668917,87,0,0,1,1
15668918,15668942,24,1,0,0,1
15668918,15668952,34,1,0,0,2
15668943,15671336,2393,0,0,1,1
15668953,15670821,1868,0,0,1,2
15670822,15670868,46,1,0,0,2
15670869,15671334,465,0,0,1,2
15671335,15671523,188,1,0,0,2
15671337,15671530,193,1,0,0,1
15671365,15671480,115,0,1,0,1
15671366,15671489,123,0,1,0,2
15671524,15673760,2236,0,0,1,2
15671531,15671553,22,0,0,1,1
15671554,15671567,13,1,0,0,1
15671568,15673758,2190,0,0,1,1
15673759,15673801,42,1,0,0,1
15673761,15673800,39,1,0,0,2
15673801,15673901,100,0,0,1,2
15673802,15675758,1956,0,0,1,1
15673902,15673910,8,1,0,0,2
15673911,15675757,1846,0,0,1,2
15675758,15675824,66,1,0,0,2
15675759,15675810,51,1,0,0,1
15675811,15675945,134,0,0,1,1
15675825,15675948,123,0,0,1,2
15675946,15675958,12,1,0,0,1
15675949,15675961,12,1,0,0,2
15675959,15677595,1636,0,0,1,1
15675962,15677596,1634,0,0,1,2
15677596,15677698,102,1,0,0,1
15677597,15677722,125,1,0,0,2
15677699,15677815,116,0,0,1,1
15677723,15677815,92,0,0,1,2
15677816,15677835,19,1,0,0,1
15677816,15677837,21,1,0,0,2
15677836,15679259,1423,0,0,1,1
15677838,15678077,239,0,0,1,2
15678078,15678099,21,1,0,0,2
15678100,15678275,175,0,0,1,2
15678276,15678295,19,1,0,0,2
15678296,15678768,472,0,0,1,2
15678769,15678819,50,1,0,0,2
15678820,15679019,199,0,0,1,2
15679020,15679028,8,1,0,0,2
15679029,15679256,227,0,0,1,2
15679257,15682343,3086,1,0,0,2
15679260,15682048,2788,1,0,0,1
15679298,15682037,2739,0,1,0,1
15679298,15682306,3008,0,1,0,2
15682049,15682072,23,0,0,1,1
15682073,15682312,239,1,0,0,1
15682098,15682262,164,0,1,0,1
15682313,15682429,116,0,0,1,1
15682344,15682379,35,0,0,1,2
15682380,15682394,14,1,0,0,2
15682395,15682430,35,0,0,1,2
15682430,15682476,46,1,0,0,1
15682431,15682480,49,1,0,0,2
15682477,15682632,155,0,0,1,1
15682481,15682561,80,0,0,1,2
15682562,15682575,13,1,0,0,2
15682576,15682636,60,0,0,1,2
15682633,15682671,38,1,0,0,1
15682637,15682660,23,1,0,0,2
15682661,15682865,204,0,0,1,2
15682672,15682877,205,0,0,1,1
15682866,15683998,1132,1,0,0,2
15682878,15683125,247,1,0,0,1
15682894,15683107,213,0,1,0,1
15682894,15683929,1035,0,1,0,2
15683126,15684455,1329,0,0,1,1
15683999,15684048,49,0,0,1,2
15684059,15684107,48,0,1,0,2
15684117,15684132,15,1,0,0,2
15684133,15684207,74,0,0,1,2
15684208,15684673,465,1,0,0,2
15684220,15684235,15,0,1,0,2
15684268,15684313,45,0,1,0,2
15684456,15684461,5,1,0,0,1
15684462,15684950,488,0,0,1,1
15684488,15684500,12,0,1,0,2
15684674,15685415,741,0,0,1,2
15684951,15684965,14,1,0,0,1
15684966,15685078,112,0,0,1,1
15685079,15685083,4,1,0,0,1
15685084,15685415,331,0,0,1,1
15685416,15685471,55,1,0,0,1
15685416,15688181,2765,1,0,0,2
15685453,15688171,2718,0,1,0,2
15685472,15685663,191,0,0,1,1
15685664,15685675,11,1,0,0,1
15685676,15687491,1815,0,0,1,1
15687502,15687835,333,0,1,0,1
15687845,15687862,17,1,0,0,1
15687863,15689114,1251,0,0,1,1
15688182,15688486,304,0,0,1,2
15688487,15688532,45,1,0,0,2
15688533,15688615,82,0,0,1,2
15688626,15689628,1002,0,1,0,2
15689115,15689539,424,1,0,0,1
15689138,15689508,370,0,1,0,1
15689540,15689579,39,0,0,1,1
15689580,15689600,20,1,0,0,1
15689601,15692129,2528,0,0,1,1
15689638,15689639,1,1,0,0,2
15689640,15691201,1561,0,0,1,2
15691212,15691523,311,0,1,0,2
15691532,15691532,0,1,0,0,2
15691533,15692131,598,0,0,1,2
15692130,15692210,80,1,0,0,1
15692132,15694992,2860,1,0,0,2
15692148,15694981,2833,0,1,0,2
15692211,15692341,130,0,0,1,1
15692342,15692346,4,1,0,0,1
15692347,15693961,1614,0,0,1,1
15693962,15694265,303,1,0,0,1
15693979,15694250,271,0,1,0,1
15694266,15695098,832,0,0,1,1
15694993,15695098,105,0,0,1,2
15695099,15695153,54,1,0,0,1
15695099,15696594,1495,1,0,0,2
15695112,15695891,779,0,1,0,2
15695154,15695175,21,0,0,1,1
15695176,15695777,601,1,0,0,1
15695224,15695750,526,0,1,0,1
15695778,15695938,160,0,0,1,1
15695936,15696515,579,0,1,0,2
15695939,15696317,378,1,0,0,1
15695956,15696177,221,0,1,0,1
15696318,15696411,93,0,0,1,1
15696412,15696417,5,1,0,0,1
15696418,15698136,1718,0,0,1,1
15696595,15696646,51,0,0,1,2
15696647,15696859,212,1,0,0,2
15696678,15696764,86,0,1,0,2
15696860,15696925,65,0,0,1,2
15696926,15697962,1036,1,0,0,2
15696977,15696978,1,0,1,0,2
15697028,15697316,288,0,1,0,2
15697337,15697375,38,0,1,0,2
15697420,15697515,95,0,1,0,2
15697551,15697566,15,0,1,0,2
15697596,15697735,139,0,1,0,2
15697963,15698002,39,0,0,1,2
15698003,15698160,157,1,0,0,2
15698137,15698141,4,1,0,0,1
15698142,15698181,39,0,0,1,1
15698161,15698183,22,0,0,1,2
15698182,15698233,51,1,0,0,1
15698184,15698301,117,1,0,0,2
15698203,15698220,17,0,1,0,2
15698234,15700175,1941,0,0,1,1
15698302,15698900,598,0,0,1,2
15698901,15698923,22,1,0,0,2
15698924,15698951,27,0,0,1,2
15698952,15698961,9,1,0,0,2
15698962,15700164,1202,0,0,1,2
15700165,15700985,820,1,0,0,2
15700176,15700947,771,1,0,0,1
15700186,15700954,768,0,1,0,2
15700192,15700849,657,0,1,0,1
15700948,15701028,80,0,0,1,1
15700986,15701025,39,0,0,1,2
15701026,15701063,37,1,0,0,2
15701029,15701214,185,1,0,0,1
15701064,15701507,443,0,0,1,2
15701215,15701348,133,0,0,1,1
15701349,15701395,46,1,0,0,1
15701396,15701507,111,0,0,1,1
15701508,15701594,86,1,0,0,2
15701508,15701597,89,1,0,0,1
15701595,15701684,89,0,0,1,2
15701598,15701684,86,0,0,1,1
15701685,15701709,24,1,0,0,2
15701685,15701710,25,1,0,0,1
15701710,15702196,486,0,0,1,2
15701711,15702196,485,0,0,1,1
15702197,15702250,53,1,0,0,2
15702197,15702254,57,1,0,0,1
15702251,15702507,256,0,0,1,2
15702255,15702507,252,0,0,1,1
15702508,15702528,20,1,0,0,1
15702508,15702529,21,1,0,0,2
15702529,15704038,1509,0,0,1,1
15702530,15704039,1509,0,0,1,2
15704039,15704324,285,1,0,0,1
15704040,15704717,677,1,0,0,2
15704067,15704285,218,0,1,0,1
15704070,15704318,248,0,1,0,2
15704325,15704430,105,0,0,1,1
15704431,15704674,243,1,0,0,1
15704447,15704648,201,0,1,0,2
15704450,15704632,182,0,1,0,1
15704675,15705545,870,0,0,1,1
15704718,15705546,828,0,0,1,2
15705546,15705605,59,1,0,0,1
15705547,15705635,88,1,0,0,2
15705606,15705707,101,0,0,1,1
15705636,15705707,71,0,0,1,2
15705708,15705730,22,1,0,0,1
15705708,15705731,23,1,0,0,2
15705731,15708063,2332,0,0,1,1
15705732,15708064,2332,0,0,1,2
15708064,15708120,56,1,0,0,1
15708065,15708116,51,1,0,0,2
15708117,15708289,172,0,0,1,2
15708121,15708283,162,0,0,1,1
15708284,15708303,19,1,0,0,1
15708290,15708306,16,1,0,0,2
15708304,15709994,1690,0,0,1,1
15708307,15708538,231,0,0,1,2
15708539,15708562,23,1,0,0,2
15708563,15709991,1428,0,0,1,2
15709992,15710886,894,1,0,0,2
15709995,15710811,816,1,0,0,1
15710030,15710544,514,0,1,0,1
15710037,15710848,811,0,1,0,2
15710577,15710775,198,0,1,0,1
15710812,15710997,185,0,0,1,1
15710887,15710997,110,0,0,1,2
15710998,15711032,34,1,0,0,1
15710998,15711035,37,1,0,0,2
15711033,15711329,296,0,0,1,1
15711036,15711286,250,0,0,1,2
15711287,15711306,19,1,0,0,2
15711307,15711327,20,0,0,1,2
15711328,15711350,22,1,0,0,2
15711330,15711387,57,1,0,0,1
15711351,15711460,109,0,0,1,2
15711388,15711511,123,0,0,1,1
15711461,15711479,18,1,0,0,2
15711480,15711564,84,0,0,1,2
15711512,15711802,290,1,0,0,1
15711565,15711901,336,1,0,0,2
15711586,15711758,172,0,1,0,1
15711589,15711777,188,0,1,0,2
15711803,15711845,42,0,0,1,1
15711846,15711921,75,1,0,0,1
15711902,15711922,20,0,0,1,2
15711922,15712011,89,0,0,1,1
15711923,15711938,15,1,0,0,2
15711939,15712014,75,0,0,1,2
15712012,15712059,47,1,0,0,1
15712015,15712048,33,1,0,0,2
15712049,15712834,785,0,0,1,2
15712060,15712203,143,0,0,1,1
15712204,15712259,55,1,0,0,1
15712260,15712334,74,0,0,1,1
15712335,15712375,40,1,0,0,1
15712376,15714413,2037,0,0,1,1
15712835,15712842,7,1,0,0,2
15712843,15713998,1155,0,0,1,2
15713999,15714024,25,1,0,0,2
15714025,15714230,205,0,0,1,2
15714231,15714251,20,1,0,0,2
15714252,15714318,66,0,0,1,2
15714319,15714341,22,1,0,0,2
15714342,15714545,203,0,0,1,2
15714414,15714429,15,1,0,0,1
15714430,15714682,252,0,0,1,1
15714546,15714556,10,1,0,0,2
15714557,15714667,110,0,0,1,2
15714668,15714676,8,1,0,0,2
15714677,15714929,252,0,0,1,2
15714683,15714688,5,1,0,0,1
15714689,15715266,577,0,0,1,1
15714930,15714969,39,1,0,0,2
15714970,15715388,418,0,0,1,2
15715267,15715284,17,1,0,0,1
15715285,15715388,103,0,0,1,1
15715389,15715448,59,1,0,0,2
15715389,15715642,253,1,0,0,1
15715449,15715549,100,0,0,1,2
15715550,15715566,16,1,0,0,2
15715567,15715822,255,0,0,1,2
15715643,15715715,72,0,0,1,1
15715716,15715807,91,1,0,0,1
15715808,15715859,51,0,0,1,1
15715823,15715838,15,1,0,0,2
15715839,15716940,1101,0,0,1,2
15715860,15715939,79,1,0,0,1
15715940,15716037,97,0,0,1,1
15716038,15716087,49,1,0,0,1
15716088,15716119,31,0,0,1,1
15716120,15716239,119,1,0,0,1
15716240,15716423,183,0,0,1,1
15716424,15716454,30,1,0,0,1
15716455,15716612,157,0,0,1,1
15716613,15716742,129,1,0,0,1
15716743,15716828,85,0,0,1,1
15716829,15716855,26,1,0,0,1
15716856,15716883,27,0,0,1,1
15716884,15717055,171,1,0,0,1
15716941,15716958,17,1,0,0,2
15716959,15717154,195,0,0,1,2
15717056,15717157,101,0,0,1,1
15717155,15717181,26,1,0,0,2
15717158,15717176,18,1,0,0,1
15717177,15717277,100,0,0,1,1
15717182,15717369,187,0,0,1,2
15717278,15718408,1130,1,0,0,1
15717370,15718465,1095,1,0,0,2
15717414,15718360,946,0,1,0,1
15717419,15718402,983,0,1,0,2
15718409,15718431,22,0,0,1,1
15718432,15718463,31,1,0,0,1
15718464,15718600,136,0,0,1,1
15718466,15718602,136,0,0,1,2
15718601,15718634,33,1,0,0,1
15718603,15718632,29,1,0,0,2
15718633,15719321,688,0,0,1,2
15718635,15719321,686,0,0,1,1
15719322,15719415,93,1,0,0,2
15719322,15719424,102,1,0,0,1
15719416,15719452,36,0,0,1,2
15719425,15719502,77,0,0,1,1
15719453,15719469,16,1,0,0,2
15719470,15719502,32,0,0,1,2
15719503,15719540,37,1,0,0,2
15719503,15719547,44,1,0,0,1
15719541,15719863,322,0,0,1,2
15719548,15719752,204,0,0,1,1
15719753,15719767,14,1,0,0,1
15719768,15719869,101,0,0,1,1
15719864,15723274,3410,1,0,0,2
15719880,15720259,379,0,1,0,1
15719891,15723232,3341,0,1,0,2
15720268,15720268,0,1,0,0,1
15720269,15720857,588,0,0,1,1
15720858,15720878,20,1,0,0,1
15720879,15720914,35,0,0,1,1
15720915,15721025,110,1,0,0,1
15721026,15721508,482,0,0,1,1
15721509,15721523,14,1,0,0,1
15721524,15722103,579,0,0,1,1
15722104,15722204,100,1,0,0,1
15722205,15722575,370,0,0,1,1
15722576,15722590,14,1,0,0,1
15722591,15722937,346,0,0,1,1
15722938,15723015,77,1,0,0,1
15723016,15723052,36,0,0,1,1
15723053,15723057,4,1,0,0,1
15723058,15723134,76,0,0,1,1
15723135,15723148,13,1,0,0,1
15723149,15723169,20,0,0,1,1
15723170,15723252,82,1,0,0,1
15723253,15723384,131,0,0,1,1
15723275,15723379,104,0,0,1,2
15723380,15723403,23,1,0,0,2
15723385,15723395,10,1,0,0,1
15723396,15725112,1716,0,0,1,1
15723404,15725118,1714,0,0,1,2
15725113,15725713,600,1,0,0,1
15725119,15725756,637,1,0,0,2
15725145,15725695,550,0,1,0,1
15725151,15725738,587,0,1,0,2
15725714,15725852,138,0,0,1,1
15725757,15725856,99,0,0,1,2
15725853,15725877,24,1,0,0,1
15725857,15725916,59,1,0,0,2
15725878,15726432,554,0,0,1,1
15725917,15726352,435,0,0,1,2
15726353,15726362,9,1,0,0,2
15726363,15726429,66,0,0,1,2
15726430,15726462,32,1,0,0,2
15726433,15726460,27,1,0,0,1
15726461,15726758,297,0,0,1,1
15726463,15727056,593,0,0,1,2
15726759,15726812,53,1,0,0,1
15726813,15727067,254,0,0,1,1
15727057,15727136,79,1,0,0,2
15727068,15727134,66,1,0,0,1
15727135,15727237,102,0,0,1,1
15727137,15727233,96,0,0,1,2
15727234,15727349,115,1,0,0,2
15727238,15727271,33,1,0,0,1
15727272,15727505,233,0,0,1,1
15727350,15727524,174,0,0,1,2
15727506,15727772,266,1,0,0,1
15727525,15727766,241,1,0,0,2
15727539,15727729,190,0,1,0,1
15727540,15727745,205,0,1,0,2
15727767,15727832,65,0,0,1,2
15727773,15727838,65,0,0,1,1
15727833,15727871,38,1,0,0,2
15727839,15727845,6,1,0,0,1
15727846,15730340,2494,0,0,1,1
15727872,15730340,2468,0,0,1,2
15730341,15730385,44,1,0,0,1
15730341,15730390,49,1,0,0,2
15730386,15730607,221,0,0,1,1
15730391,15730603,212,0,0,1,2
15730604,15730619,15,1,0,0,2
15730608,15730620,12,1,0,0,1
15730620,15732570,1950,0,0,1,2
15730621,15732570,1949,0,0,1,1
15732571,15733120,549,1,0,0,1
15732571,15733152,581,1,0,0,2
15732597,15733111,514,0,1,0,1
15732613,15733126,513,0,1,0,2
15733121,15733900,779,0,0,1,1
15733153,15733900,747,0,0,1,2
15733901,15733965,64,1,0,0,1
15733901,15733973,72,1,0,0,2
15733966,15734271,305,0,0,1,1
15733974,15734001,27,0,0,1,2
15734002,15734117,115,1,0,0,2
15734118,15734145,27,0,0,1,2
15734146,15734396,250,1,0,0,2
15734272,15734288,16,1,0,0,1
15734289,15736237,1948,0,0,1,1
15734397,15734436,39,0,0,1,2
15734437,15734613,176,1,0,0,2
15734614,15734681,67,0,0,1,2
15734682,15734731,49,1,0,0,2
15734732,15736235,1503,0,0,1,2
15736236,15736315,79,1,0,0,2
15736238,15736289,51,1,0,0,1
15736290,15736363,73,0,0,1,1
15736316,15736363,47,0,0,1,2
15736364,15736385,21,1,0,0,1
15736364,15736501,137,1,0,0,2
15736386,15736566,180,0,0,1,1
15736502,15736862,360,0,0,1,2
15736567,15736579,12,1,0,0,1
15736580,15738358,1778,0,0,1,1
15736863,15736937,74,1,0,0,2
15736938,15736966,28,0,0,1,2
15736967,15736990,23,1,0,0,2
15736991,15737230,239,0,0,1,2
15737231,15737238,7,1,0,0,2
15737239,15737276,37,0,0,1,2
15737277,15737391,114,1,0,0,2
15737392,15737518,126,0,0,1,2
15737519,15737540,21,1,0,0,2
15737541,15737675,134,0,0,1,2
15737676,15737680,4,1,0,0,2
15737681,15737949,268,0,0,1,2
15737950,15738015,65,1,0,0,2
15738016,15738036,20,0,0,1,2
15738037,15738060,23,1,0,0,2
15738061,15738287,226,0,0,1,2
15738288,15738304,16,1,0,0,2
15738305,15738354,49,0,0,1,2
15738355,15739265,910,1,0,0,2
15738359,15739306,947,1,0,0,1
15738391,15738558,167,0,1,0,1
15738403,15738553,150,0,1,0,2
15738621,15739171,550,0,1,0,1
15738624,15739211,587,0,1,0,2
15739266,15739484,218,0,0,1,2
15739307,15739486,179,0,0,1,1
15739485,15739549,64,1,0,0,2
15739487,15739742,255,1,0,0,1
15739550,15739576,26,0,0,1,2
15739577,15739632,55,1,0,0,2
15739633,15739663,30,0,0,1,2
15739664,15739695,31,1,0,0,2
15739696,15740399,703,0,0,1,2
15739743,15739770,27,0,0,1,1
15739771,15739792,21,1,0,0,1
15739793,15739870,77,0,0,1,1
15739871,15739922,51,1,0,0,1
15739923,15739949,26,0,0,1,1
15739950,15740012,62,1,0,0,1
15740013,15740196,183,0,0,1,1
15740197,15740246,49,1,0,0,1
15740247,15740578,331,0,0,1,1
15740400,15740422,22,1,0,0,2
15740423,15741972,1549,0,0,1,2
15740579,15740601,22,1,0,0,1
15740602,15741973,1371,0,0,1,1
15741973,15742032,59,1,0,0,2
15741974,15742029,55,1,0,0,1
15742030,15742141,111,0,0,1,1
15742033,15742142,109,0,0,1,2
15742142,15742160,18,1,0,0,1
15742143,15742188,45,1,0,0,2
15742161,15744226,2065,0,0,1,1
15742189,15743001,812,0,0,1,2
15743002,15743014,12,1,0,0,2
15743015,15743574,559,0,0,1,2
15743575,15743580,5,1,0,0,2
15743581,15745311,1730,0,0,1,2
15744227,15744235,8,1,0,0,1
15744236,15744406,170,0,0,1,1
15744407,15744412,5,1,0,0,1
15744413,15745313,900,0,0,1,1
15745312,15749024,3712,1,0,0,2
15745314,15745593,279,1,0,0,1
15745357,15745577,220,0,1,0,1
15745362,15745623,261,0,1,0,2
15745594,15745654,60,0,0,1,1
15745655,15746348,693,1,0,0,1
15745675,15749003,3328,0,1,0,2
15745681,15746338,657,0,1,0,1
15746349,15748907,2558,0,0,1,1
15748908,15749095,187,1,0,0,1
15749025,15749054,29,0,0,1,2
15749055,15749143,88,1,0,0,2
15749096,15749735,639,0,0,1,1
15749144,15750889,1745,0,0,1,2
15749736,15749751,15,1,0,0,1
15749752,15750099,347,0,0,1,1
15750100,15750115,15,1,0,0,1
15750116,15750335,219,0,0,1,1
15750336,15750366,30,1,0,0,1
15750367,15750531,164,0,0,1,1
15750532,15750556,24,1,0,0,1
15750557,15750608,51,0,0,1,1
15750609,15750689,80,1,0,0,1
15750690,15750732,42,0,0,1,1
15750733,15750750,17,1,0,0,1
15750751,15750798,47,0,0,1,1
15750799,15751491,692,1,0,0,1
15750890,15751513,623,1,0,0,2
15750917,15751503,586,0,1,0,2
15750919,15751468,549,0,1,0,1
15751492,15751690,198,0,0,1,1
15751514,15752689,1175,0,0,1,2
15751691,15751815,124,1,0,0,1
15751816,15751909,93,0,0,1,1
15751910,15751942,32,1,0,0,1
15751943,15752026,83,0,0,1,1
15752027,15752036,9,1,0,0,1
15752037,15752534,497,0,0,1,1
15752535,15752552,17,1,0,0,1
15752553,15752688,135,0,0,1,1
15752689,15752757,68,1,0,0,1
15752690,15752954,264,1,0,0,2
15752758,15752853,95,0,0,1,1
15752854,15752879,25,1,0,0,1
15752880,15752918,38,0,0,1,1
15752919,15752923,4,1,0,0,1
15752924,15753483,559,0,0,1,1
15752955,15753121,166,0,0,1,2
15753122,15753179,57,1,0,0,2
15753180,15753235,55,0,0,1,2
15753236,15753251,15,1,0,0,2
15753252,15753338,86,0,0,1,2
15753339,15753431,92,1,0,0,2
15753432,15755676,2244,0,0,1,2
15753484,15753503,19,1,0,0,1
15753504,15755678,2174,0,0,1,1
15755677,15755750,73,1,0,0,2
15755679,15755726,47,1,0,0,1
15755727,15755899,172,0,0,1,1
15755751,15757537,1786,0,0,1,2
15755900,15755912,12,1,0,0,1
15755913,15757513,1600,0,0,1,1
15757514,15758462,948,1,0,0,1
15757538,15758513,975,1,0,0,2
15757541,15758127,586,0,1,0,1
15757561,15758443,882,0,1,0,2
15758200,15758394,194,0,1,0,1
15758463,15759379,916,0,0,1,1
15758514,15758549,35,0,0,1,2
15758550,15758608,58,1,0,0,2
15758609,15759377,768,0,0,1,2
15759378,15759448,70,1,0,0,2
15759380,15759453,73,1,0,0,1
15759449,15759537,88,0,0,1,2
15759454,15759538,84,0,0,1,1
15759538,15759569,31,1,0,0,2
15759539,15759561,22,1,0,0,1
15759562,15759690,128,0,0,1,1
15759570,15759692,122,0,0,1,2
15759691,15759709,18,1,0,0,1
15759693,15759710,17,1,0,0,2
15759710,15759974,264,0,0,1,1
15759711,15759975,264,0,0,1,2
15759975,15760653,678,1,0,0,1
15759976,15760751,775,1,0,0,2
15760015,15760673,658,0,1,0,2
15760020,15760642,622,0,1,0,1
15760654,15760725,71,0,0,1,1
15760726,15760751,25,1,0,0,1
15760752,15760925,173,0,0,1,2
15760752,15763470,2718,0,0,1,1
15760926,15760936,10,1,0,0,2
15760937,15763470,2533,0,0,1,2
15763471,15763531,60,1,0,0,1
15763471,15763549,78,1,0,0,2
15763532,15764478,946,0,0,1,1
15763550,15764478,928,0,0,1,2
15764479,15764483,4,1,0,0,1
15764479,15764504,25,1,0,0,2
15764484,15764893,409,0,0,1,1
15764505,15765638,1133,0,0,1,2
15764894,15764906,12,1,0,0,1
15764907,15765642,735,0,0,1,1
15765639,15765665,26,1,0,0,2
15765643,15765654,11,1,0,0,1
15765655,15766235,580,0,0,1,1
15765666,15766234,568,0,0,1,2
15766235,15766261,26,1,0,0,2
15766236,15766256,20,1,0,0,1
15766257,15767066,809,0,0,1,1
15766262,15766711,449,0,0,1,2
15766712,15766718,6,1,0,0,2
15766719,15767069,350,0,0,1,2
15767067,15767322,255,1,0,0,1
15767070,15767311,241,1,0,0,2
15767105,15767275,170,0,1,0,1
15767110,15767282,172,0,1,0,2
15767312,15767404,92,0,0,1,2
15767323,15767404,81,0,0,1,1
15767405,15767424,19,1,0,0,1
15767405,15767424,19,1,0,0,2
15767425,15767768,343,0,0,1,1
15767425,15767770,345,0,0,1,2
15767769,15768279,510,1,0,0,1
15767771,15768283,512,1,0,0,2
15767810,15768015,205,0,1,0,1
15767812,15768032,220,0,1,0,2
15768077,15768251,174,0,1,0,2
15768078,15768238,160,0,1,0,1
15768280,15770647,2367,0,0,1,1
15768284,15770330,2046,0,0,1,2
15770331,15770337,6,1,0,0,2
15770338,15770645,307,0,0,1,2
15770646,15770714,68,1,0,0,2
15770648,15770714,66,1,0,0,1
15770715,15770894,179,0,0,1,1
15770715,15770895,180,0,0,1,2
15770895,15770914,19,1,0,0,1
15770896,15770913,17,1,0,0,2
15770914,15771769,855,0,0,1,2
15770915,15771762,847,0,0,1,1
15771763,15771779,16,1,0,0,1
15771770,15771781,11,1,0,0,2
15771780,15772508,728,0,0,1,1
15771782,15772526,744,0,0,1,2
15772509,15773606,1097,1,0,0,1
15772527,15773586,1059,1,0,0,2
15772542,15773416,874,0,1,0,1
15772549,15773423,874,0,1,0,2
15773587,15773718,131,0,0,1,2
15773607,15773710,103,0,0,1,1
15773711,15773966,255,1,0,0,1
15773719,15773976,257,1,0,0,2
15773743,15773893,150,0,1,0,1
15773745,15773910,165,0,1,0,2
15773967,15774024,57,0,0,1,1
15773977,15774024,47,0,0,1,2
15774025,15774065,40,1,0,0,1
15774025,15774120,95,1,0,0,2
15774066,15774168,102,0,0,1,1
15774121,15774168,47,0,0,1,2
15774169,15774195,26,1,0,0,1
15774169,15774203,34,1,0,0,2
15774196,15774630,434,0,0,1,1
15774204,15774788,584,0,0,1,2
15774631,15774666,35,1,0,0,1
15774667,15777056,2389,0,0,1,1
15774789,15774821,32,1,0,0,2
15774822,15775180,358,0,0,1,2
15775181,15775196,15,1,0,0,2
15775197,15775753,556,0,0,1,2
15775754,15775762,8,1,0,0,2
15775763,15776016,253,0,0,1,2
15776017,15776032,15,1,0,0,2
15776033,15776211,178,0,0,1,2
15776212,15776273,61,1,0,0,2
15776274,15776413,139,0,0,1,2
15776414,15776418,4,1,0,0,2
15776419,15776606,187,0,0,1,2
15776607,15776632,25,1,0,0,2
15776633,15777058,425,0,0,1,2
15777057,15777146,89,1,0,0,1
15777059,15777208,149,1,0,0,2
15777147,15777266,119,0,0,1,1
15777209,15777264,55,0,0,1,2
15777265,15777384,119,1,0,0,2
15777267,15777287,20,1,0,0,1
15777288,15778987,1699,0,0,1,1
15777385,15777494,109,0,0,1,2
15777495,15777553,58,1,0,0,2
15777554,15777608,54,0,0,1,2
15777609,15777637,28,1,0,0,2
15777638,15777819,181,0,0,1,2
15777820,15777835,15,1,0,0,2
15777836,15778330,494,0,0,1,2
15778331,15778398,67,1,0,0,2
15778399,15778775,376,0,0,1,2
15778776,15778790,14,1,0,0,2
15778791,15778824,33,0,0,1,2
15778825,15778916,91,1,0,0,2
15778917,15778948,31,0,0,1,2
15778949,15779341,392,1,0,0,2
15778988,15779293,305,1,0,0,1
15779013,15779285,272,0,1,0,2
15779016,15779268,252,0,1,0,1
15779294,15779423,129,0,0,1,1
15779342,15779423,81,0,0,1,2
15779424,15779664,240,1,0,0,1
15779424,15779716,292,1,0,0,2
15779454,15779638,184,0,1,0,1
15779455,15779666,211,0,1,0,2
15779665,15779769,104,0,0,1,1
15779717,15779761,44,0,0,1,2
15779762,15779998,236,1,0,0,2
15779770,15779966,196,1,0,0,1
15779786,15779934,148,0,1,0,1
15779787,15779959,172,0,1,0,2
15779967,15780788,821,0,0,1,1
15779999,15780788,789,0,0,1,2
15780789,15780847,58,1,0,0,1
15780789,15780859,70,1,0,0,2
15780848,15780955,107,0,0,1,1
15780860,15780950,90,0,0,1,2
15780951,15780978,27,1,0,0,2
15780956,15780967,11,1,0,0,1
15780968,15781178,210,0,0,1,1
15780979,15781178,199,0,0,1,2
15781179,15781917,738,1,0,0,1
15781179,15781929,750,1,0,0,2
15781198,15781400,202,0,1,0,1
15781200,15781424,224,0,1,0,2
15781472,15781917,445,0,1,0,2
15781475,15781672,197,0,1,0,1
15781698,15781886,188,0,1,0,1
15781918,15781973,55,0,0,1,1
15781930,15781973,43,0,0,1,2
15781974,15782000,26,1,0,0,2
15781974,15782021,47,1,0,0,1
15782001,15783856,1855,0,0,1,2
15782022,15783855,1833,0,0,1,1
15783856,15783900,44,1,0,0,1
15783857,15783927,70,1,0,0,2
15783901,15784069,168,0,0,1,1
15783928,15784067,139,0,0,1,2
15784068,15784085,17,1,0,0,2
15784070,15784088,18,1,0,0,1
15784086,15786632,2546,0,0,1,2
15784089,15786943,2854,0,0,1,1
15786633,15786649,16,1,0,0,2
15786650,15786945,295,0,0,1,2
15786944,15786986,42,1,0,0,1
15786946,15786987,41,1,0,0,2
15786987,15787055,68,0,0,1,1
15786988,15787056,68,0,0,1,2
15787056,15787597,541,1,0,0,1
15787057,15787616,559,1,0,0,2
15787082,15787560,478,0,1,0,1
15787085,15787601,516,0,1,0,2
15787598,15787722,124,0,0,1,1
15787617,15787721,104,0,0,1,2
15787722,15787744,22,1,0,0,2
15787723,15787744,21,1,0,0,1
15787745,15789760,2015,0,0,1,1
15787745,15789761,2016,0,0,1,2
15789761,15789828,67,1,0,0,1
15789762,15789859,97,1,0,0,2
15789829,15789937,108,0,0,1,1
15789860,15789935,75,0,0,1,2
15789936,15789963,27,1,0,0,2
15789938,15789957,19,1,0,0,1
15789958,15792035,2077,0,0,1,1
15789964,15790718,754,0,0,1,2
15790719,15790728,9,1,0,0,2
15790729,15791406,677,0,0,1,2
15791407,15791419,12,1,0,0,2
15791420,15791615,195,0,0,1,2
15791616,15791642,26,1,0,0,2
15791643,15791706,63,0,0,1,2
15791707,15791724,17,1,0,0,2
15791725,15791795,70,0,0,1,2
15791796,15791801,5,1,0,0,2
15791802,15792034,232,0,0,1,2
15792035,15792353,318,1,0,0,2
15792036,15792338,302,1,0,0,1
15792065,15792282,217,0,1,0,1
15792073,15792321,248,0,1,0,2
15792339,15793859,1520,0,0,1,1
15792354,15793158,804,0,0,1,2
15793159,15793173,14,1,0,0,2
15793174,15793362,188,0,0,1,2
15793363,15793418,55,1,0,0,2
15793419,15793488,69,0,0,1,2
15793489,15793503,14,1,0,0,2
15793504,15793689,185,0,0,1,2
15793690,15793703,13,1,0,0,2
15793704,15794387,683,0,0,1,2
15793860,15793877,17,1,0,0,1
15793878,15795350,1472,0,0,1,1
15794388,15794408,20,1,0,0,2
15794409,15795353,944,0,0,1,2
15795351,15795413,62,1,0,0,1
15795354,15795459,105,1,0,0,2
15795414,15797032,1618,0,0,1,1
15795460,15795819,359,0,0,1,2
15795820,15796017,197,1,0,0,2
15796018,15796150,132,0,0,1,2
15796151,15796181,30,1,0,0,2
15796182,15796409,227,0,0,1,2
15796410,15796414,4,1,0,0,2
15796415,15796545,130,0,0,1,2
15796546,15796561,15,1,0,0,2
15796562,15796752,190,0,0,1,2
15796753,15796825,72,1,0,0,2
15796826,15796859,33,0,0,1,2
15796860,15796880,20,1,0,0,2
15796881,15796929,48,0,0,1,2
15796930,15796938,8,1,0,0,2
15796939,15797344,405,0,0,1,2
15797033,15797039,6,1,0,0,1
15797040,15797352,312,0,0,1,1
15797345,15797500,155,1,0,0,2
15797353,15797370,17,1,0,0,1
15797371,15797581,210,0,0,1,1
15797501,15797563,62,0,0,1,2
15797564,15798140,576,1,0,0,2
15797582,15798087,505,1,0,0,1
15797605,15797825,220,0,1,0,1
15797609,15798129,520,0,1,0,2
15797871,15798056,185,0,1,0,1
15798088,15798352,264,0,0,1,1
15798141,15798351,210,0,0,1,2
15798352,15798661,309,1,0,0,2
15798353,15798598,245,1,0,0,1
15798379,15798562,183,0,1,0,1
15798381,15798589,208,0,1,0,2
15798599,15798800,201,0,0,1,1
15798662,15798798,136,0,0,1,2
15798799,15798875,76,1,0,0,2
15798801,15798849,48,1,0,0,1
15798850,15798952,102,0,0,1,1
15798876,15798957,81,0,0,1,2
15798953,15798999,46,1,0,0,1
15798958,15799022,64,1,0,0,2
15799000,15801325,2325,0,0,1,1
15799023,15799179,156,0,0,1,2
15799180,15799336,156,1,0,0,2
15799337,15799414,77,0,0,1,2
15799415,15799450,35,1,0,0,2
15799451,15799690,239,0,0,1,2
15799691,15799739,48,1,0,0,2
15799740,15799787,47,0,0,1,2
15799788,15799817,29,1,0,0,2
15799818,15799977,159,0,0,1,2
15799978,15800191,213,1,0,0,2
15800192,15800309,117,0,0,1,2
15800310,15800530,220,1,0,0,2
15800531,15800668,137,0,0,1,2
15800669,15800744,75,1,0,0,2
15800745,15801085,340,0,0,1,2
15801086,15801101,15,1,0,0,2
15801102,15801156,54,0,0,1,2
15801157,15801178,21,1,0,0,2
15801179,15801295,116,0,0,1,2
15801296,15801300,4,1,0,0,2
15801301,15801324,23,0,0,1,2
15801325,15801394,69,1,0,0,2
15801326,15801384,58,1,0,0,1
15801385,15801522,137,0,0,1,1
15801395,15801514,119,0,0,1,2
15801515,15801539,24,1,0,0,2
15801523,15801530,7,1,0,0,1
15801531,15801671,140,0,0,1,1
15801540,15801670,130,0,0,1,2
15801671,15801684,13,1,0,0,2
15801672,15801683,11,1,0,0,1
15801684,15802904,1220,0,0,1,1
15801685,15802889,1204,0,0,1,2
15802890,15803203,313,1,0,0,2
15802905,15803202,297,1,0,0,1
15802921,15803139,218,0,1,0,1
15802925,15803165,240,0,1,0,2
15803203,15803774,571,0,0,1,1
15803204,15803247,43,0,0,1,2
15803248,15803259,11,1,0,0,2
15803260,15803774,514,0,0,1,2
15803775,15803806,31,1,0,0,2
15803775,15804512,737,1,0,0,1
15803807,15803835,28,0,0,1,2
15803836,15804515,679,1,0,0,2
15803857,15804125,268,0,1,0,1
15803859,15804458,599,0,1,0,2
15804221,15804419,198,0,1,0,1
15804513,15804621,108,0,0,1,1
15804516,15804626,110,0,0,1,2
15804622,15804642,20,1,0,0,1
15804627,15804640,13,1,0,0,2
15804641,15804840,199,0,0,1,2
15804643,15805027,384,0,0,1,1
15804841,15804900,59,1,0,0,2
15804901,15804946,45,0,0,1,2
15804947,15804979,32,1,0,0,2
15804980,15805027,47,0,0,1,2
15805028,15805094,66,1,0,0,2
15805028,15805096,68,1,0,0,1
15805095,15805139,44,0,0,1,2
15805097,15805140,43,0,0,1,1
15805140,15805170,30,1,0,0,2
15805141,15805173,32,1,0,0,1
15805171,15805220,49,0,0,1,2
15805174,15805211,37,0,0,1,1
15805212,15805233,21,1,0,0,1
15805221,15805245,24,1,0,0,2
15805234,15806911,1677,0,0,1,1
15805246,15807161,1915,0,0,1,2
15806912,15806917,5,1,0,0,1
15806918,15807160,242,0,0,1,1
15807161,15807227,66,1,0,0,1
15807162,15807240,78,1,0,0,2
15807228,15807422,194,0,0,1,1
15807241,15809170,1929,0,0,1,2
15807423,15807441,18,1,0,0,1
15807442,15809181,1739,0,0,1,1
15809171,15810453,1282,1,0,0,2
15809182,15810405,1223,1,0,0,1
15809196,15810394,1198,0,1,0,1
15809207,15810442,1235,0,1,0,2
15810406,15810494,88,0,0,1,1
15810454,15810495,41,0,0,1,2
15810495,15810547,52,1,0,0,1
15810496,15810552,56,1,0,0,2
15810548,15810641,93,0,0,1,1
15810553,15810643,90,0,0,1,2
15810642,15810671,29,1,0,0,1
15810644,15810675,31,1,0,0,2
15810672,15810743,71,0,0,1,1
15810676,15810734,58,0,0,1,2
15810735,15811728,993,1,0,0,2
15810744,15811630,886,1,0,0,1
15810759,15810963,204,0,1,0,2
15810761,15810962,201,0,1,0,1
15810988,15811260,272,0,1,0,1
15810996,15811258,262,0,1,0,2
15811331,15811552,221,0,1,0,1
15811336,15811709,373,0,1,0,2
15811631,15813362,1731,0,0,1,1
15811729,15811932,203,0,0,1,2
15811933,15811976,43,1,0,0,2
15811977,15812491,514,0,0,1,2
15812492,15812538,46,1,0,0,2
15812539,15813362,823,0,0,1,2
15813363,15813416,53,1,0,0,2
15813363,15813423,60,1,0,0,1
15813417,15813590,173,0,0,1,2
15813424,15816909,3485,0,0,1,1
15813591,15813602,11,1,0,0,2
15813603,15814993,1390,0,0,1,2
15814994,15815004,10,1,0,0,2
15815005,15815791,786,0,0,1,2
15815792,15815807,15,1,0,0,2
15815808,15816476,668,0,0,1,2
15816477,15816551,74,1,0,0,2
15816552,15816909,357,0,0,1,2
15816910,15817103,193,1,0,0,1
15816910,15817120,210,1,0,0,2
15816943,15817064,121,0,1,0,1
15816946,15817073,127,0,1,0,2
15817104,15817212,108,0,0,1,1
15817121,15817206,85,0,0,1,2
15817207,15817225,18,1,0,0,2
15817213,15817224,11,1,0,0,1
15817225,15817409,184,0,0,1,1
15817226,15817403,177,0,0,1,2
15817404,15817627,223,1,0,0,2
15817410,15817607,197,1,0,0,1
15817436,15817574,138,0,1,0,1
15817440,15817589,149,0,1,0,2
15817608,15817679,71,0,0,1,1
15817628,15817685,57,0,0,1,2
15817680,15817865,185,1,0,0,1
15817686,15817896,210,1,0,0,2
15817702,15817830,128,0,1,0,1
15817707,15817846,139,0,1,0,2
15817866,15817983,117,0,0,1,1
15817897,15817989,92,0,0,1,2
15817984,15818001,17,1,0,0,1
15817990,15818002,12,1,0,0,2
15818002,15820028,2026,0,0,1,1
15818003,15820029,2026,0,0,1,2
15820029,15820096,67,1,0,0,1
15820030,15820078,48,1,0,0,2
15820079,15820331,252,0,0,1,2
15820097,15820334,237,0,0,1,1
15820332,15820389,57,1,0,0,2
15820335,15820346,11,1,0,0,1
15820347,15824021,3674,0,0,1,1
15820390,15820776,386,0,0,1,2
15820777,15820806,29,1,0,0,2
15820807,15821408,601,0,0,1,2
15821409,15821437,28,1,0,0,2
15821438,15821866,428,0,0,1,2
15821867,15821881,14,1,0,0,2
15821882,15821956,74,0,0,1,2
15821957,15821962,5,1,0,0,2
15821963,15822092,129,0,0,1,2
15822093,15822163,70,1,0,0,2
15822164,15822285,121,0,0,1,2
15822286,15822433,147,1,0,0,2
15822434,15822468,34,0,0,1,2
15822469,15822523,54,1,0,0,2
15822524,15822738,214,0,0,1,2
15822739,15822761,22,1,0,0,2
15822762,15823868,1106,0,0,1,2
15823869,15823891,22,1,0,0,2
15823892,15824027,135,0,0,1,2
15824022,15824795,773,1,0,0,1
15824028,15824997,969,1,0,0,2
15824070,15824276,206,0,1,0,1
15824073,15824921,848,0,1,0,2
15824301,15824778,477,0,1,0,1
15824796,15824829,33,0,0,1,1
15824830,15824890,60,1,0,0,1
15824891,15827341,2450,0,0,1,1
15824998,15825253,255,0,0,1,2
15825254,15825260,6,1,0,0,2
15825261,15827341,2080,0,0,1,2
15827342,15827390,48,1,0,0,1
15827342,15827426,84,1,0,0,2
15827391,15827556,165,0,0,1,1
15827427,15827557,130,0,0,1,2
15827557,15827575,18,1,0,0,1
15827558,15827576,18,1,0,0,2
15827576,15827789,213,0,0,1,1
15827577,15831373,3796,0,0,1,2
15827790,15827797,7,1,0,0,1
15827798,15831377,3579,0,0,1,1
15831374,15832302,928,1,0,0,2
15831378,15832274,896,1,0,0,1
15831416,15832290,874,0,1,0,2
15831421,15832259,838,0,1,0,1
15832275,15834498,2223,0,0,1,1
15832303,15834497,2194,0,0,1,2
15834498,15834556,58,1,0,0,2
15834499,15834573,74,1,0,0,1
15834557,15834686,129,0,0,1,2
15834574,15834687,113,0,0,1,1
15834687,15834707,20,1,0,0,2
15834688,15834708,20,1,0,0,1
15834708,15838246,3538,0,0,1,2
15834709,15838246,3537,0,0,1,1
15838247,15839245,998,1,0,0,1
15838247,15839356,1109,1,0,0,2
15838294,15839168,874,0,1,0,1
15838297,15839283,986,0,1,0,2
15839246,15841359,2113,0,0,1,1
15839357,15841358,2001,0,0,1,2
15841359,15841433,74,1,0,0,2
15841360,15841424,64,1,0,0,1
15841425,15843679,2254,0,0,1,1
15841434,15843671,2237,0,0,1,2
15843672,15844449,777,1,0,0,2
15843680,15844407,727,1,0,0,1
15843695,15843908,213,0,1,0,1
15843696,15844438,742,0,1,0,2
15843955,15844363,408,0,1,0,1
15844408,15844669,261,0,0,1,1
15844450,15844668,218,0,0,1,2
15844669,15844743,74,1,0,0,2
15844670,15844741,71,1,0,0,1
15844742,15844845,103,0,0,1,1
15844744,15844844,100,0,0,1,2
15844845,15844864,19,1,0,0,2
15844846,15844863,17,1,0,0,1
15844864,15847777,2913,0,0,1,1
15844865,15847778,2913,0,0,1,2
15847778,15847841,63,1,0,0,1
15847779,15847843,64,1,0,0,2
15847842,15847890,48,0,0,1,1
15847844,15847894,50,0,0,1,2
15847891,15847911,20,1,0,0,1
15847895,15847911,16,1,0,0,2
15847912,15848010,98,0,0,1,2
15847912,15848016,104,0,0,1,1
15848011,15848039,28,1,0,0,2
15848017,15848031,14,1,0,0,1
15848032,15848170,138,0,0,1,1
15848040,15848171,131,0,0,1,2
15848171,15848185,14,1,0,0,1
15848172,15848232,60,1,0,0,2
15848186,15850005,1819,0,0,1,1
15848233,15849405,1172,0,0,1,2
15849406,15849414,8,1,0,0,2
15849415,15849922,507,0,0,1,2
15849923,15849945,22,1,0,0,2
15849946,15850015,69,0,0,1,2
15850006,15850846,840,1,0,0,1
15850016,15850960,944,1,0,0,2
15850029,15850831,802,0,1,0,1
15850034,15850949,915,0,1,0,2
15850847,15851086,239,0,0,1,1
15850961,15851092,131,0,0,1,2
15851087,15851381,294,1,0,0,1
15851103,15851381,278,0,1,0,2
15851128,15851341,213,0,1,0,1
15851382,15851711,329,0,0,1,1
15851391,15851436,45,1,0,0,2
15851437,15851654,217,0,0,1,2
15851655,15851754,99,1,0,0,2
15851712,15851756,44,1,0,0,1
15851755,15852057,302,0,0,1,2
15851757,15854050,2293,0,0,1,1
15852058,15852070,12,1,0,0,2
15852071,15854049,1978,0,0,1,2
15854050,15854096,46,1,0,0,2
15854051,15854093,42,1,0,0,1
15854094,15855720,1626,0,0,1,1
15854097,15854269,172,0,0,1,2
15854270,15854289,19,1,0,0,2
15854290,15854351,61,0,0,1,2
15854352,15854368,16,1,0,0,2
15854369,15854486,117,0,0,1,2
15854487,15854551,64,1,0,0,2
15854552,15854927,375,0,0,1,2
15854928,15855012,84,1,0,0,2
15855013,15855214,201,0,0,1,2
15855215,15855225,10,1,0,0,2
15855226,15855310,84,0,0,1,2
15855311,15855321,10,1,0,0,2
15855322,15855363,41,0,0,1,2
15855364,15855428,64,1,0,0,2
15855429,15855464,35,0,0,1,2
15855465,15855503,38,1,0,0,2
15855504,15855933,429,0,0,1,2
15855721,15855745,24,1,0,0,1
15855746,15856010,264,0,0,1,1
15855934,15855955,21,1,0,0,2
15855956,15856004,48,0,0,1,2
15856005,15857047,1042,1,0,0,2
15856011,15856037,26,1,0,0,1
15856038,15856068,30,0,0,1,1
15856069,15857000,931,1,0,0,1
15856087,15856316,229,0,1,0,1
15856089,15857016,927,0,1,0,2
15856402,15856671,269,0,1,0,1
15856750,15856958,208,0,1,0,1
15857001,15857506,505,0,0,1,1
15857048,15857506,458,0,0,1,2
15857507,15858255,748,1,0,0,1
15857507,15858391,884,1,0,0,2
15857538,15858242,704,0,1,0,1
15857538,15858323,785,0,1,0,2
15858256,15858304,48,0,0,1,1
15858305,15858337,32,1,0,0,1
15858338,15860448,2110,0,0,1,1
15858392,15859602,1210,0,0,1,2
15859603,15859607,4,1,0,0,2
15859608,15860215,607,0,0,1,2
15860216,15860230,14,1,0,0,2
15860231,15860386,155,0,0,1,2
15860387,15860401,14,1,0,0,2
15860402,15860449,47,0,0,1,2
15860449,15860524,75,1,0,0,1
15860450,15860510,60,1,0,0,2
15860511,15863599,3088,0,0,1,2
15860525,15863599,3074,0,0,1,1
15863600,15863652,52,1,0,0,1
15863600,15863679,79,1,0,0,2
15863653,15863759,106,0,0,1,1
15863680,15863759,79,0,0,1,2
15863760,15863778,18,1,0,0,1
15863760,15863792,32,1,0,0,2
15863779,15863891,112,0,0,1,1
15863793,15863897,104,0,0,1,2
15863892,15864095,203,1,0,0,1
15863898,15864107,209,1,0,0,2
15863913,15864054,141,0,1,0,1
15863916,15864078,162,0,1,0,2
15864096,15864204,108,0,0,1,1
15864108,15864206,98,0,0,1,2
15864205,15864227,22,1,0,0,1
15864207,15864231,24,1,0,0,2
15864228,15864914,686,0,0,1,1
15864232,15864915,683,0,0,1,2
15864915,15864955,40,1,0,0,1
15864916,15864958,42,1,0,0,2
15864956,15865021,65,0,0,1,1
15864959,15865021,62,0,0,1,2
15865022,15865694,672,1,0,0,1
15865022,15865765,743,1,0,0,2
15865081,15865703,622,0,1,0,2
15865085,15865670,585,0,1,0,1
15865695,15865823,128,0,0,1,1
15865766,15865823,57,0,0,1,2
15865824,15865878,54,1,0,0,1
15865824,15865889,65,1,0,0,2
15865879,15865998,119,0,0,1,1
15865890,15865998,108,0,0,1,2
15916549,15917354,805,0,0,1,1
15916549,15917355,806,0,0,1,2
15917355,15918687,1332,1,0,0,1
15917356,15918488,1132,1,0,0,2
15917410,15918454,1044,0,1,0,2
15917413,15918661,1248,0,1,0,1
15918489,15918606,117,0,0,1,2
15918607,15918613,6,1,0,0,2
15918614,15918814,200,0,0,1,2
15918688,15918892,204,0,0,1,1
15918815,15918997,182,1,0,0,2
15918852,15918987,135,0,1,0,2
15918893,15918907,14,1,0,0,1
15918908,15919160,252,0,0,1,1
15918998,15919096,98,0,0,1,2
15919097,15919138,41,1,0,0,2
15919110,15919120,10,0,1,0,2
15919139,15919165,26,0,0,1,2
15919161,15919250,89,1,0,0,1
15919166,15919177,11,1,0,0,2
15919178,15919225,47,0,0,1,2
15919226,15919325,99,1,0,0,2
15919238,15919284,46,0,1,0,2
15919251,15919533,282,0,0,1,1
15919326,15919396,70,0,0,1,2
15919407,15921642,2235,0,1,0,2
15919534,15920718,1184,1,0,0,1
15919559,15920000,441,0,1,0,1
15920042,15920172,130,0,1,0,1
15920237,15920652,415,0,1,0,1
15920719,15921008,289,0,0,1,1
15921009,15921032,23,1,0,0,1
15921033,15921210,177,0,0,1,1
15921211,15921225,14,1,0,0,1
15921226,15922125,899,0,0,1,1
15921652,15922891,1239,1,0,0,2
15921663,15922880,1217,0,1,0,2
15922126,15922189,63,1,0,0,1
15922137,15922159,22,0,1,0,1
15922190,15922273,83,0,0,1,1
15922284,15922857,573,0,1,0,1
15922866,15922866,0,1,0,0,1
15922867,15922925,58,0,0,1,1
15922892,15922925,33,0,0,1,2
15922926,15922951,25,1,0,0,1
15922926,15922953,27,1,0,0,2
15922952,15923103,151,0,0,1,1
15922954,15925802,2848,0,0,1,2
15923104,15923110,6,1,0,0,1
15923111,15925801,2690,0,0,1,1
15925802,15925876,74,1,0,0,1
15925803,15925880,77,1,0,0,2
15925877,15925961,84,0,0,1,1
15925881,15925960,79,0,0,1,2
15925961,15926053,92,1,0,0,2
15925962,15925983,21,1,0,0,1
15925984,15927987,2003,0,0,1,1
15926054,15926190,136,0,0,1,2
15926191,15926239,48,1,0,0,2
15926240,15926300,60,0,0,1,2
15926301,15926348,47,1,0,0,2
15926349,15927987,1638,0,0,1,2
15927988,15928913,925,1,0,0,2
15927988,15928916,928,1,0,0,1
15928139,15928905,766,0,1,0,1
15928172,15928902,730,0,1,0,2
15928914,15929116,202,0,0,1,2
15928917,15929116,199,0,0,1,1
15929117,15929211,94,1,0,0,1
15929117,15929236,119,1,0,0,2
15929212,15929289,77,0,0,1,1
15929237,15929290,53,0,0,1,2
15929290,15929359,69,1,0,0,1
15929291,15929317,26,1,0,0,2
15929318,15931573,2255,0,0,1,2
15929360,15929481,121,0,0,1,1
15929482,15929493,11,1,0,0,1
15929494,15929644,150,0,0,1,1
15929645,15929915,270,1,0,0,1
15929916,15930052,136,0,0,1,1
15930053,15930064,11,1,0,0,1
15930065,15930090,25,0,0,1,1
15930091,15930599,508,1,0,0,1
15930600,15931575,975,0,0,1,1
15931574,15931662,88,1,0,0,2
15931576,15931637,61,1,0,0,1
15931638,15931717,79,0,0,1,1
15931663,15931717,54,0,0,1,2
15931718,15931741,23,1,0,0,1
15931718,15931750,32,1,0,0,2
15931742,15931839,97,0,0,1,1
15931751,15931838,87,0,0,1,2
15931839,15932068,229,1,0,0,2
15931840,15932051,211,1,0,0,1
15931870,15932027,157,0,1,0,2
15931874,15932006,132,0,1,0,1
15932052,15932161,109,0,0,1,1
15932069,15933995,1926,0,0,1,2
15932162,15932166,4,1,0,0,1
15932167,15933991,1824,0,0,1,1
15933992,15934212,220,1,0,0,1
15933996,15934222,226,1,0,0,2
15934033,15934169,136,0,1,0,1
15934041,15934171,130,0,1,0,2
15934213,15934401,188,0,0,1,1
15934223,15934400,177,0,0,1,2
15934401,15934463,62,1,0,0,2
15934402,15934472,70,1,0,0,1
15934464,15934570,106,0,0,1,2
15934473,15934570,97,0,0,1,1
15934571,15934589,18,1,0,0,1
15934571,15934592,21,1,0,0,2
15934590,15936826,2236,0,0,1,1
15934593,15936665,2072,0,0,1,2
15936666,15936679,13,1,0,0,2
15936680,15936826,146,0,0,1,2
15936827,15938058,1231,1,0,0,1
15936827,15938091,1264,1,0,0,2
15936985,15938080,1095,0,1,0,2
15936993,15938047,1054,0,1,0,1
15938059,15939676,1617,0,0,1,1
15938092,15939682,1590,0,0,1,2
15939677,15939968,291,1,0,0,1
15939683,15939968,285,1,0,0,2
15939694,15939901,207,0,1,0,1
15939696,15939931,235,0,1,0,2
15939969,15940022,53,0,0,1,1
15939969,15940022,53,0,0,1,2
15940023,15940042,19,1,0,0,1
15940023,15940057,34,1,0,0,2
15940043,15940248,205,0,0,1,1
15940058,15940248,190,0,0,1,2
15940249,15940304,55,1,0,0,2
15940249,15940376,127,1,0,0,1
15940305,15942394,2089,0,0,1,2
15940377,15942397,2020,0,0,1,1
15942395,15944799,2404,1,0,0,2
15942398,15942499,101,1,0,0,1
15942500,15942554,54,0,0,1,1
15942555,15942982,427,1,0,0,1
15942623,15944784,2161,0,1,0,2
15942625,15942958,333,0,1,0,1
15942983,15943526,543,0,0,1,1
15943527,15943542,15,1,0,0,1
15943543,15943946,403,0,0,1,1
15943947,15943951,4,1,0,0,1
15943952,15944366,414,0,0,1,1
15944367,15944371,4,1,0,0,1
15944372,15944487,115,0,0,1,1
15944488,15944750,262,1,0,0,1
15944515,15944708,193,0,1,0,1
15944751,15945035,284,0,0,1,1
15944800,15945036,236,0,0,1,2
15945036,15945112,76,1,0,0,1
15945037,15945112,75,1,0,0,2
15945113,15945218,105,0,0,1,2
15945113,15945219,106,0,0,1,1
15945219,15945247,28,1,0,0,2
15945220,15945238,18,1,0,0,1
15945239,15947393,2154,0,0,1,1
15945248,15947394,2146,0,0,1,2
15947394,15947656,262,1,0,0,1
15947395,15947656,261,1,0,0,2
15947440,15947593,153,0,1,0,1
15947440,15947616,176,0,1,0,2
15947657,15947731,74,0,0,1,1
15947657,15947731,74,0,0,1,2
15947732,15947751,19,1,0,0,2
15947732,15947752,20,1,0,0,1
15947752,15949562,1810,0,0,1,2
15947753,15949564,1811,0,0,1,1
15949563,15949768,205,1,0,0,2
15949565,15949748,183,1,0,0,1
15949749,15949838,89,0,0,1,1
15949769,15949839,70,0,0,1,2
15949839,15949878,39,1,0,0,1
15949840,15949880,40,1,0,0,2
15949879,15950214,335,0,0,1,1
15949881,15950210,329,0,0,1,2
15950211,15950537,326,1,0,0,2
15950215,15950480,265,1,0,0,1
15950261,15950413,152,0,1,0,1
15950262,15950480,218,0,1,0,2
15950481,15950514,33,0,0,1,1
15950515,15950530,15,1,0,0,1
15950531,15951193,662,0,0,1,1
15950538,15950600,62,0,0,1,2
15950601,15950605,4,1,0,0,2
15950606,15950840,234,0,0,1,2
15950841,15950859,18,1,0,0,2
15950860,15952145,1285,0,0,1,2
15951194,15951220,26,1,0,0,1
15951221,15951583,362,0,0,1,1
15951584,15951588,4,1,0,0,1
15951589,15952486,897,0,0,1,1
15952146,15952167,21,1,0,0,2
15952168,15952246,78,0,0,1,2
15952247,15953682,1435,1,0,0,2
15952428,15953639,1211,0,1,0,2
15952487,15953660,1173,1,0,0,1
15952524,15953397,873,0,1,0,1
15953477,15953619,142,0,1,0,1
15953661,15953786,125,0,0,1,1
15953683,15953785,102,0,0,1,2
15953786,15953838,52,1,0,0,2
15953787,15953845,58,1,0,0,1
15953839,15953918,79,0,0,1,2
15953846,15953919,73,0,0,1,1
15953919,15953949,30,1,0,0,2
15953920,15953952,32,1,0,0,1
15953950,15953986,36,0,0,1,2
15953953,15954051,98,0,0,1,1
15953987,15954324,337,1,0,0,2
15954052,15954077,25,1,0,0,1
15954078,15955571,1493,0,0,1,1
15954325,15954351,26,0,0,1,2
15954352,15954453,101,1,0,0,2
15954454,15955563,1109,0,0,1,2
15955564,15955787,223,1,0,0,2
15955572,15955760,188,1,0,0,1
15955584,15955747,163,0,1,0,2
15955591,15955726,135,0,1,0,1
15955761,15955967,206,0,0,1,1
15955788,15955900,112,0,0,1,2
15955901,15956034,133,1,0,0,2
15955968,15956029,61,1,0,0,1
15956030,15956126,96,0,0,1,1
15956035,15956127,92,0,0,1,2
15956127,15956150,23,1,0,0,1
15956128,15956148,20,1,0,0,2
15956149,15958742,2593,0,0,1,2
15956151,15958741,2590,0,0,1,1
15958742,15958941,199,1,0,0,1
15958743,15958951,208,1,0,0,2
15958787,15958903,116,0,1,0,1
15958790,15958902,112,0,1,0,2
15958942,15959241,299,0,0,1,1
15958952,15959240,288,0,0,1,2
15959241,15959273,32,1,0,0,2
15959242,15959248,6,1,0,0,1
15959249,15961792,2543,0,0,1,1
15959274,15961794,2520,0,0,1,2
15961793,15961919,126,1,0,0,1
15961795,15961918,123,1,0,0,2
15961919,15961985,66,0,0,1,2
15961920,15961985,65,0,0,1,1
15961986,15962019,33,1,0,0,1
15961986,15962031,45,1,0,0,2
15962020,15962108,88,0,0,1,1
15962032,15962093,61,0,0,1,2
15962094,15964392,2298,1,0,0,2
15962109,15962131,22,1,0,0,1
15962114,15964349,2235,0,1,0,2
15962132,15962159,27,0,0,1,1
15962170,15962583,413,0,1,0,1
15962593,15962593,0,1,0,0,1
15962594,15962633,39,0,0,1,1
15962634,15962725,91,1,0,0,1
15962726,15962839,113,0,0,1,1
15962850,15962878,28,0,1,0,1
15962888,15962910,22,1,0,0,1
15962911,15963090,179,0,0,1,1
15963091,15963187,96,1,0,0,1
15963188,15963269,81,0,0,1,1
15963270,15963294,24,1,0,0,1
15963295,15963749,454,0,0,1,1
15963750,15963902,152,1,0,0,1
15963903,15963962,59,0,0,1,1
15963963,15963969,6,1,0,0,1
15963970,15964101,131,0,0,1,1
15964102,15964150,48,1,0,0,1
15964151,15964188,37,0,0,1,1
15964189,15964204,15,1,0,0,1
15964205,15964270,65,0,0,1,1
15964271,15964389,118,1,0,0,1
15964390,15964453,63,0,0,1,1
15964393,15964452,59,0,0,1,2
15964453,15964484,31,1,0,0,2
15964454,15964478,24,1,0,0,1
15964479,15964789,310,0,0,1,1
15964485,15964933,448,0,0,1,2
15964790,15964800,10,1,0,0,1
15964801,15964907,106,0,0,1,1
15964908,15964959,51,1,0,0,1
15964934,15964948,14,1,0,0,2
15964949,15966472,1523,0,0,1,2
15964960,15965033,73,0,0,1,1
15965034,15965038,4,1,0,0,1
15965039,15965804,765,0,0,1,1
15965805,15965887,82,1,0,0,1
15965888,15966078,190,0,0,1,1
15966079,15966084,5,1,0,0,1
15966085,15966471,386,0,0,1,1
15966472,15966601,129,1,0,0,1
15966473,15966629,156,1,0,0,2
15966602,15966702,100,0,0,1,1
15966630,15966706,76,0,0,1,2
15966703,15966708,5,1,0,0,1
15966707,15966725,18,1,0,0,2
15966709,15966754,45,0,0,1,1
15966726,15966758,32,0,0,1,2
15966755,15967032,277,1,0,0,1
15966759,15967082,323,1,0,0,2
15966777,15967003,226,0,1,0,1
15966779,15967013,234,0,1,0,2
15967033,15967061,28,0,0,1,1
15967062,15967083,21,1,0,0,1
15967083,15968886,1803,0,0,1,2
15967084,15968885,1801,0,0,1,1
15968886,15968990,104,1,0,0,1
15968887,15968988,101,1,0,0,2
15968989,15969073,84,0,0,1,2
15968991,15969073,82,0,0,1,1
15969074,15969101,27,1,0,0,1
15969074,15969125,51,1,0,0,2
15969102,15969207,105,0,0,1,1
15969126,15969204,78,0,0,1,2
15969205,15971384,2179,1,0,0,2
15969208,15969235,27,1,0,0,1
15969236,15969784,548,0,0,1,1
15969297,15969355,58,0,1,0,2
15969420,15971361,1941,0,1,0,2
15969785,15969800,15,1,0,0,1
15969801,15970005,204,0,0,1,1
15970006,15970026,20,1,0,0,1
15970027,15970222,195,0,0,1,1
15970223,15970261,38,1,0,0,1
15970262,15970819,557,0,0,1,1
15970820,15970867,47,1,0,0,1
15970868,15971275,407,0,0,1,1
15971276,15971381,105,1,0,0,1
15971382,15971482,100,0,0,1,1
15971385,15971481,96,0,0,1,2
15971482,15971503,21,1,0,0,2
15971483,15971504,21,1,0,0,1
15971504,15971911,407,0,0,1,2
15971505,15973450,1945,0,0,1,1
15971912,15971950,38,1,0,0,2
15971951,15973449,1498,0,0,1,2
15973450,15973515,65,1,0,0,2
15973451,15973499,48,1,0,0,1
15973500,15973620,120,0,0,1,1
15973516,15973618,102,0,0,1,2
15973619,15973637,18,1,0,0,2
15973621,15973636,15,1,0,0,1
15973637,15975896,2259,0,0,1,1
15973638,15974097,459,0,0,1,2
15974098,15974133,35,1,0,0,2
15974134,15975543,1409,0,0,1,2
15975544,15975548,4,1,0,0,2
15975549,15975899,350,0,0,1,2
15975897,15975987,90,1,0,0,1
15975900,15976460,560,1,0,0,2
15975988,15976068,80,0,0,1,1
15976069,15976379,310,1,0,0,1
15976142,15976328,186,0,1,0,1
15976142,15976344,202,0,1,0,2
15976380,15976419,39,0,0,1,1
15976420,15976437,17,1,0,0,1
15976438,15976728,290,0,0,1,1
15976461,15976728,267,0,0,1,2
15976729,15978075,1346,1,0,0,1
15976729,15978125,1396,1,0,0,2
15976750,15978058,1308,0,1,0,2
15976752,15978007,1255,0,1,0,1
15978076,15979964,1888,0,0,1,1
15978126,15978274,148,0,0,1,2
15978275,15978320,45,1,0,0,2
15978321,15978436,115,0,0,1,2
15978437,15978463,26,1,0,0,2
15978464,15978848,384,0,0,1,2
15978849,15978932,83,1,0,0,2
15978933,15979365,432,0,0,1,2
15979366,15979383,17,1,0,0,2
15979384,15979479,95,0,0,1,2
15979480,15979557,77,1,0,0,2
15979558,15979965,407,0,0,1,2
15979965,15980012,47,1,0,0,1
15979966,15980016,50,1,0,0,2
15980013,15980115,102,0,0,1,1
15980017,15980114,97,0,0,1,2
15980115,15980137,22,1,0,0,2
15980116,15980146,30,1,0,0,1
15980138,15981267,1129,0,0,1,2
15980147,15981273,1126,0,0,1,1
15981268,15981520,252,1,0,0,2
15981274,15981490,216,1,0,0,1
15981297,15981434,137,0,1,0,1
15981300,15981461,161,0,1,0,2
15981491,15982295,804,0,0,1,1
15981521,15981597,76,0,0,1,2
15981598,15981615,17,1,0,0,2
15981616,15982295,679,0,0,1,2
15982296,15982370,74,1,0,0,1
15982296,15982374,78,1,0,0,2
15982371,15982459,88,0,0,1,1
15982375,15982462,87,0,0,1,2
15982460,15982486,26,1,0,0,1
15982463,15982482,19,1,0,0,2
15982483,15982723,240,0,0,1,2
15982487,15982738,251,0,0,1,1
15982724,15982728,4,1,0,0,2
15982729,15984226,1497,0,0,1,2
15982739,15982753,14,1,0,0,1
15982754,15984229,1475,0,0,1,1
15984227,15985515,1288,1,0,0,2
15984230,15985484,1254,1,0,0,1
15984304,15985504,1200,0,1,0,2
15984312,15985437,1125,0,1,0,1
15985485,15987869,2384,0,0,1,1
15985516,15985890,374,0,0,1,2
15985891,15985908,17,1,0,0,2
15985909,15986025,116,0,0,1,2
15986026,15986031,5,1,0,0,2
15986032,15987398,1366,0,0,1,2
15987399,15987415,16,1,0,0,2
15987416,15987868,452,0,0,1,2
15987869,15988062,193,1,0,0,2
15987870,15988056,186,1,0,0,1
15987896,15988004,108,0,1,0,1
15987897,15988018,121,0,1,0,2
15988057,15988158,101,0,0,1,1
15988063,15988158,95,0,0,1,2
15988159,15988181,22,1,0,0,2
15988159,15988182,23,1,0,0,1
15988182,15990306,2124,0,0,1,2
15988183,15990306,2123,0,0,1,1
15990307,15990415,108,1,0,0,1
15990307,15990423,116,1,0,0,2
15990416,15990464,48,0,0,1,1
15990424,15990461,37,0,0,1,2
15990462,15990512,50,1,0,0,2
15990465,15990501,36,1,0,0,1
15990502,15990638,136,0,0,1,1
15990513,15990637,124,0,0,1,2
15990638,15990818,180,1,0,0,2
15990639,15990650,11,1,0,0,1
15990651,15992540,1889,0,0,1,1
15990819,15991140,321,0,0,1,2
15991141,15991182,41,1,0,0,2
15991183,15991218,35,0,0,1,2
15991219,15991231,12,1,0,0,2
15991232,15991623,391,0,0,1,2
15991624,15991681,57,1,0,0,2
15991682,15991756,74,0,0,1,2
15991757,15991776,19,1,0,0,2
15991777,15991836,59,0,0,1,2
15991837,15991909,72,1,0,0,2
15991910,15992077,167,0,0,1,2
15992078,15992113,35,1,0,0,2
15992114,15992231,117,0,0,1,2
15992232,15992798,566,1,0,0,2
15992541,15992827,286,1,0,0,1
15992579,15992740,161,0,1,0,1
15992582,15992763,181,0,1,0,2
15992799,15992852,53,0,0,1,2
15992828,15992853,25,0,0,1,1
15992853,15992888,35,1,0,0,2
15992854,15992878,24,1,0,0,1
15992879,15993152,273,0,0,1,1
15992889,15993370,481,0,0,1,2
15993153,15993157,4,1,0,0,1
15993158,15994341,1183,0,0,1,1
15993371,15993375,4,1,0,0,2
15993376,15994337,961,0,0,1,2
15994338,15994679,341,1,0,0,2
15994342,15994632,290,1,0,0,1
15994385,15994587,202,0,1,0,1
15994389,15994636,247,0,1,0,2
15994633,15994776,143,0,0,1,1
15994680,15994713,33,0,0,1,2
15994714,15994719,5,1,0,0,2
15994720,15994775,55,0,0,1,2
15994776,15994839,63,1,0,0,2
15994777,15994838,61,1,0,0,1
15994839,15994924,85,0,0,1,1
15994840,15994924,84,0,0,1,2
15994925,15994948,23,1,0,0,1
15994925,15994948,23,1,0,0,2
15994949,15997097,2148,0,0,1,2
15994949,15997099,2150,0,0,1,1
15997098,15998727,1629,1,0,0,2
15997100,15998651,1551,1,0,0,1
15997232,15998702,1470,0,1,0,2
15997250,15998580,1330,0,1,0,1
15998652,15998764,112,0,0,1,1
15998728,15998751,23,0,0,1,2
15998762,15998766,4,0,1,0,2
15998765,15998787,22,1,0,0,1
15998776,15998782,6,1,0,0,2
15998783,15998954,171,0,0,1,2
15998788,16000371,1583,0,0,1,1
15998965,15999037,72,0,1,0,2
15999046,15999046,0,1,0,0,2
15999047,15999108,61,0,0,1,2
15999119,15999162,43,0,1,0,2
15999171,15999171,0,1,0,0,2
15999172,15999505,333,0,0,1,2
15999516,15999524,8,0,1,0,2
15999533,15999533,0,1,0,0,2
15999534,15999612,78,0,0,1,2
15999623,15999770,147,0,1,0,2
15999780,16000108,328,1,0,0,2
15999796,16000099,303,0,1,0,2
16000109,16000130,21,0,0,1,2
16000141,16000545,404,0,1,0,2
16000372,16000567,195,1,0,0,1
16000407,16000522,115,0,1,0,1
16000555,16000573,18,1,0,0,2
16000568,16000623,55,0,0,1,1
16000574,16000623,49,0,0,1,2
16000624,16000648,24,1,0,0,1
16000624,16000653,29,1,0,0,2
16000649,16003045,2396,0,0,1,1
16000654,16003045,2391,0,0,1,2
16003046,16003662,616,1,0,0,1
16003046,16003691,645,1,0,0,2
16003109,16003623,514,0,1,0,1
16003114,16003678,564,0,1,0,2
16003663,16004387,724,0,0,1,1
16003692,16004818,1126,0,0,1,2
16004388,16004426,38,1,0,0,1
16004427,16004497,70,0,0,1,1
16004498,16004536,38,1,0,0,1
16004537,16005136,599,0,0,1,1
16004829,16004857,28,0,1,0,2
16004866,16004866,0,1,0,0,2
16004867,16005210,343,0,0,1,2
16005137,16005155,18,1,0,0,1
16005156,16005457,301,0,0,1,1
16005221,16005230,9,0,1,0,2
16005239,16005239,0,1,0,0,2
16005240,16005322,82,0,0,1,2
16005333,16005339,6,0,1,0,2
16005348,16005348,0,1,0,0,2
16005349,16005707,358,0,0,1,2
16005458,16005482,24,1,0,0,1
16005483,16005564,81,0,0,1,1
16005565,16005585,20,1,0,0,1
16005586,16005650,64,0,0,1,1
16005651,16005667,16,1,0,0,1
16005668,16005703,35,0,0,1,1
16005704,16005993,289,1,0,0,1
16005708,16006047,339,1,0,0,2
16005729,16005996,267,0,1,0,2
16005762,16005952,190,0,1,0,1
16005994,16007971,1977,0,0,1,1
16006048,16007967,1919,0,0,1,2
16007968,16008031,63,1,0,0,2
16007972,16008042,70,1,0,0,1
16008032,16008053,21,0,0,1,2
16008043,16008134,91,0,0,1,1
16008054,16008070,16,1,0,0,2
16008071,16008128,57,0,0,1,2
16008129,16008150,21,1,0,0,2
16008135,16008147,12,1,0,0,1
16008148,16010136,1988,0,0,1,1
16008151,16010135,1984,0,0,1,2
16010136,16010180,44,1,0,0,2
16010137,16010179,42,1,0,0,1
16010180,16012619,2439,0,0,1,1
16010181,16012615,2434,0,0,1,2
16012616,16012824,208,1,0,0,2
16012620,16012838,218,1,0,0,1
16012655,16012788,133,0,1,0,2
16012660,16012782,122,0,1,0,1
16012825,16012907,82,0,0,1,2
16012839,16012908,69,0,0,1,1
16012908,16012962,54,1,0,0,2
16012909,16012948,39,1,0,0,1
16012949,16013547,598,0,0,1,1
16012963,16013546,583,0,0,1,2
16013547,16013992,445,1,0,0,2
16013548,16013997,449,1,0,0,1
16013688,16013868,180,0,1,0,2
16013693,16013847,154,0,1,0,1
16013993,16014074,81,0,0,1,2
16013998,16014074,76,0,0,1,1
16014075,16014104,29,1,0,0,1
16014075,16014112,37,1,0,0,2
16014105,16015824,1719,0,0,1,1
16014113,16015826,1713,0,0,1,2
16015825,16016226,401,1,0,0,1
16015827,16021120,5293,1,0,0,2
16015874,16016111,237,0,1,0,1
16015879,16017001,1122,0,1,0,2
16016227,16016307,80,0,0,1,1
16016308,16016318,10,1,0,0,1
16016319,16016387,68,0,0,1,1
16016388,16016402,14,1,0,0,1
16016403,16016644,241,0,0,1,1
16016645,16017693,1048,1,0,0,1
16017173,16019323,2150,0,1,0,2
16017694,16017729,35,0,0,1,1
16017730,16021057,3327,1,0,0,1
16018127,16021039,2912,0,1,0,1
16019374,16019408,34,0,1,0,2
16019446,16019497,51,0,1,0,2
16019532,16019679,147,0,1,0,2
16019788,16019796,8,0,1,0,2
16019841,16019880,39,0,1,0,2
16019921,16020011,90,0,1,0,2
16020039,16020044,5,0,1,0,2
16020174,16020206,32,0,1,0,2
16020231,16020484,253,0,1,0,2
16020514,16020522,8,0,1,0,2
16020549,16020550,1,0,1,0,2
16020653,16020696,43,0,1,0,2
16020893,16021037,144,0,1,0,2
16021058,16021142,84,0,0,1,1
16021121,16021143,22,0,0,1,2
16021143,16021170,27,1,0,0,1
16021144,16021191,47,1,0,0,2
16021171,16022468,1297,0,0,1,1
16021192,16022464,1272,0,0,1,2
16022465,16022482,17,1,0,0,2
16022469,16022484,15,1,0,0,1
16022483,16024289,1806,0,0,1,2
16022485,16024290,1805,0,0,1,1
16024290,16024350,60,1,0,0,2
16024291,16024338,47,1,0,0,1
16024339,16024498,159,0,0,1,1
16024351,16024496,145,0,0,1,2
16024497,16024511,14,1,0,0,2
16024499,16024513,14,1,0,0,1
16024512,16025363,851,0,0,1,2
16024514,16026908,2394,0,0,1,1
16025364,16025368,4,1,0,0,2
16025369,16025432,63,0,0,1,2
16025433,16025480,47,1,0,0,2
16025481,16026100,619,0,0,1,2
16026101,16026122,21,1,0,0,2
16026123,16026542,419,0,0,1,2
16026543,16026564,21,1,0,0,2
16026565,16026628,63,0,0,1,2
16026629,16026646,17,1,0,0,2
16026647,16026918,271,0,0,1,2
16026909,16027181,272,1,0,0,1
16026919,16027254,335,1,0,0,2
16026967,16027138,171,0,1,0,1
16026971,16027182,211,0,1,0,2
16027182,16027403,221,0,0,1,1
16027255,16027395,140,0,0,1,2
16027396,16027413,17,1,0,0,2
16027404,16027413,9,1,0,0,1
16027414,16029571,2157,0,0,1,2
16027414,16029572,2158,0,0,1,1
16029572,16029632,60,1,0,0,2
16029573,16029635,62,1,0,0,1
16029633,16029729,96,0,0,1,2
16029636,16029730,94,0,0,1,1
16029730,16029748,18,1,0,0,2
16029731,16029753,22,1,0,0,1
16029749,16032304,2555,0,0,1,2
16029754,16032305,2551,0,0,1,1
16032305,16032415,110,1,0,0,2
16032306,16032411,105,1,0,0,1
16032412,16032497,85,0,0,1,1
16032416,16032496,80,0,0,1,2
16032497,16032532,35,1,0,0,2
16032498,16032533,35,1,0,0,1
16032533,16032572,39,0,0,1,2
16032534,16033042,508,0,0,1,1
16032573,16032585,12,1,0,0,2
16032586,16032654,68,0,0,1,2
16032655,16032685,30,1,0,0,2
16032686,16032910,224,0,0,1,2
16032911,16032928,17,1,0,0,2
16032929,16032949,20,0,0,1,2
16032950,16034215,1265,1,0,0,2
16033053,16034125,1072,0,1,0,1
16033525,16033586,61,0,1,0,2
16033608,16034196,588,0,1,0,2
16034135,16034212,77,1,0,0,1
16034213,16034416,203,0,0,1,1
16034216,16034262,46,0,0,1,2
16034263,16034274,11,1,0,0,2
16034275,16034416,141,0,0,1,2
16034417,16034503,86,1,0,0,2
16034417,16034508,91,1,0,0,1
16034504,16034627,123,0,0,1,2
16034509,16034621,112,0,0,1,1
16034622,16034644,22,1,0,0,1
16034628,16034817,189,1,0,0,2
16034645,16036996,2351,0,0,1,1
16034818,16034983,165,0,0,1,2
16034984,16035031,47,1,0,0,2
16035032,16035134,102,0,0,1,2
16035135,16035225,90,1,0,0,2
16035226,16035383,157,0,0,1,2
16035384,16035400,16,1,0,0,2
16035401,16036996,1595,0,0,1,2
16036997,16037102,105,1,0,0,1
16036997,16037103,106,1,0,0,2
16037103,16037161,58,0,0,1,1
16037104,16037161,57,0,0,1,2
16037162,16037177,15,1,0,0,2
16037162,16037188,26,1,0,0,1
16037178,16037315,137,0,0,1,2
16037189,16039777,2588,0,0,1,1
16037316,16037321,5,1,0,0,2
16037322,16039777,2455,0,0,1,2
16039778,16039835,57,1,0,0,1
16039778,16039837,59,1,0,0,2
16039836,16039904,68,0,0,1,1
16039838,16039901,63,0,0,1,2
16039902,16040142,240,1,0,0,2
16039905,16040145,240,1,0,0,1
16039933,16040076,143,0,1,0,2
16039936,16040052,116,0,1,0,1
16040143,16042733,2590,0,0,1,2
16040146,16040213,67,0,0,1,1
16040214,16041696,1482,1,0,0,1
16041697,16041723,26,0,0,1,1
16041724,16041735,11,1,0,0,1
16041736,16041772,36,0,0,1,1
16041773,16042416,643,1,0,0,1
16042417,16042472,55,0,0,1,1
16042473,16042515,42,1,0,0,1
16042516,16042556,40,0,0,1,1
16042557,16043360,803,1,0,0,1
16042734,16042922,188,1,0,0,2
16042923,16042984,61,0,0,1,2
16042985,16045932,2947,1,0,0,2
16043006,16043377,371,0,1,0,2
16043016,16043260,244,0,1,0,1
16043361,16043438,77,0,0,1,1
16043439,16043468,29,1,0,0,1
16043469,16043559,90,0,0,1,1
16043475,16045827,2352,0,1,0,2
16043560,16043564,4,1,0,0,1
16043565,16045272,1707,0,0,1,1
16045273,16045296,23,1,0,0,1
16045297,16045591,294,0,0,1,1
16045592,16045851,259,1,0,0,1
16045622,16045751,129,0,1,0,1
16045852,16045900,48,0,0,1,1
16045901,16045931,30,1,0,0,1
16045932,16046263,331,0,0,1,1
16045933,16048530,2597,0,0,1,2
16046264,16046341,77,1,0,0,1
16046342,16046400,58,0,0,1,1
16046401,16046422,21,1,0,0,1
16046423,16046558,135,0,0,1,1
16046559,16046575,16,1,0,0,1
16046576,16046891,315,0,0,1,1
16046892,16047055,163,1,0,0,1
16047056,16047343,287,0,0,1,1
16047344,16047652,308,1,0,0,1
16047653,16047755,102,0,0,1,1
16047756,16048162,406,1,0,0,1
16048163,16048368,205,0,0,1,1
16048369,16048458,89,1,0,0,1
16048459,16048532,73,0,0,1,1
16048531,16052281,3750,1,0,0,2
16048533,16048663,130,1,0,0,1
16048664,16048712,48,0,0,1,1
16048713,16049309,596,1,0,0,1
16048769,16052262,3493,0,1,0,2
16048777,16049254,477,0,1,0,1
16049310,16049365,55,0,0,1,1
16049366,16049374,8,1,0,0,1
16049375,16049420,45,0,0,1,1
16049421,16049460,39,1,0,0,1
16049461,16049554,93,0,0,1,1
16049555,16049649,94,1,0,0,1
16049568,16049634,66,0,1,0,1
16049650,16049736,86,0,0,1,1
16049747,16052253,2506,0,1,0,1
16052263,16052264,1,1,0,0,1
16052265,16052322,57,0,0,1,1
16052282,16052321,39,0,0,1,2
16052322,16052553,231,1,0,0,2
16052323,16052536,213,1,0,0,1
16052351,16052485,134,0,1,0,2
16052357,16052471,114,0,1,0,1
16052537,16052605,68,0,0,1,1
16052554,16052592,38,0,0,1,2
16052593,16052625,32,1,0,0,2
16052606,16052679,73,1,0,0,1
16052626,16052704,78,0,0,1,2
16052680,16052704,24,0,0,1,1
16052705,16053474,769,1,0,0,2
16052705,16053699,994,1,0,0,1
16052733,16053463,730,0,1,0,2
16052736,16053466,730,0,1,0,1
16053475,16053509,34,0,0,1,2
16053510,16053730,220,1,0,0,2
16053528,16053684,156,0,1,0,2
16053530,16053662,132,0,1,0,1
16053700,16053789,89,0,0,1,1
16053731,16053791,60,0,0,1,2
16053790,16053835,45,1,0,0,1
16053792,16053866,74,1,0,0,2
16053836,16053929,93,0,0,1,1
16053867,16053930,63,0,0,1,2
16053930,16054132,202,1,0,0,1
16053931,16054180,249,1,0,0,2
16053956,16054106,150,0,1,0,1
16053957,16054120,163,0,1,0,2
16054133,16054233,100,0,0,1,1
16054181,16054229,48,0,0,1,2
16054230,16054340,110,1,0,0,2
16054234,16054264,30,1,0,0,1
16054265,16055939,1674,0,0,1,1
16054341,16054414,73,0,0,1,2
16054415,16054433,18,1,0,0,2
16054434,16054513,79,0,0,1,2
16054514,16054530,16,1,0,0,2
16054531,16054908,377,0,0,1,2
16054909,16054922,13,1,0,0,2
16054923,16055936,1013,0,0,1,2
16055937,16056025,88,1,0,0,2
16055940,16055988,48,1,0,0,1
16055989,16057750,1761,0,0,1,1
16056026,16057752,1726,0,0,1,2
16057751,16058010,259,1,0,0,1
16057753,16058056,303,1,0,0,2
16057774,16058001,227,0,1,0,2
16057780,16057965,185,0,1,0,1
16058011,16058556,545,0,0,1,1
16058057,16059129,1072,0,0,1,2
16058557,16058758,201,1,0,0,1
16058759,16059196,437,0,0,1,1
16059130,16059257,127,1,0,0,2
16059197,16059264,67,1,0,0,1
16059258,16059364,106,0,0,1,2
16059265,16059374,109,0,0,1,1
16059365,16059392,27,1,0,0,2
16059375,16059385,10,1,0,0,1
16059386,16059652,266,0,0,1,1
16059393,16059980,587,0,0,1,2
16059653,16059669,16,1,0,0,1
16059670,16060384,714,0,0,1,1
16059981,16059985,4,1,0,0,2
16059986,16061131,1145,0,0,1,2
16060385,16060407,22,1,0,0,1
16060408,16060459,51,0,0,1,1
16060460,16060476,16,1,0,0,1
16060477,16060547,70,0,0,1,1
16060548,16060559,11,1,0,0,1
16060560,16060760,200,0,0,1,1
16060761,16060765,4,1,0,0,1
16060766,16061128,362,0,0,1,1
16061129,16061144,15,1,0,0,1
16061132,16061142,10,1,0,0,2
16061143,16061722,579,0,0,1,2
16061145,16062089,944,0,0,1,1
16061723,16061923,200,1,0,0,2
16061924,16062014,90,0,0,1,2
16062015,16062682,667,1,0,0,2
16062090,16062144,54,1,0,0,1
16062145,16062209,64,0,0,1,1
16062210,16062286,76,1,0,0,1
16062287,16062425,138,0,0,1,1
16062426,16062454,28,1,0,0,1
16062455,16062546,91,0,0,1,1
16062547,16062588,41,1,0,0,1
16062589,16062629,40,0,0,1,1
16062630,16064358,1728,1,0,0,1
16062683,16062758,75,0,0,1,2
16062759,16062770,11,1,0,0,2
16062771,16064625,1854,0,0,1,2
16064359,16064400,41,0,0,1,1
16064401,16064488,87,1,0,0,1
16064489,16064620,131,0,0,1,1
16064621,16065639,1018,1,0,0,1
16064626,16065932,1306,1,0,0,2
16064673,16065656,983,0,1,0,2
16064682,16065628,946,0,1,0,1
16065640,16065668,28,0,0,1,1
16065669,16065918,249,1,0,0,1
16065684,16065885,201,0,1,0,2
16065694,16065854,160,0,1,0,1
16065919,16066116,197,0,0,1,1
16065933,16066119,186,0,0,1,2
16066117,16066319,202,1,0,0,1
16066120,16066385,265,1,0,0,2
16066143,16066326,183,0,1,0,2
16066150,16066288,138,0,1,0,1
16066320,16066510,190,0,0,1,1
16066386,16066510,124,0,0,1,2
16066511,16066587,76,1,0,0,2
16066511,16066592,81,1,0,0,1
16066588,16066692,104,0,0,1,2
16066593,16066695,102,0,0,1,1
16066693,16066722,29,1,0,0,2
16066696,16066713,17,1,0,0,1
16066714,16070233,3519,0,0,1,1
16066723,16070231,3508,0,0,1,2
16070232,16070274,42,1,0,0,2
16070234,16070271,37,1,0,0,1
16070272,16070469,197,0,0,1,1
16070275,16070468,193,0,0,1,2
16070469,16070476,7,1,0,0,2
16070470,16070475,5,1,0,0,1
16070476,16072083,1607,0,0,1,1
16070477,16072096,1619,0,0,1,2
16072084,16073783,1699,1,0,0,1
16072097,16073823,1726,1,0,0,2
16072123,16073753,1630,0,1,0,1
16072127,16073793,1666,0,1,0,2
16073784,16073878,94,0,0,1,1
16073824,16073877,53,0,0,1,2
16073878,16073916,38,1,0,0,2
16073879,16073915,36,1,0,0,1
16073916,16074089,173,0,0,1,1
16073917,16074086,169,0,0,1,2
16074087,16078117,4030,1,0,0,2
16074090,16074697,607,1,0,0,1
16074123,16074637,514,0,1,0,1
16074125,16078106,3981,0,1,0,2
16074698,16074790,92,0,0,1,1
16074791,16075155,364,1,0,0,1
16074884,16074953,69,0,1,0,1
16075156,16075368,212,0,0,1,1
16075369,16075385,16,1,0,0,1
16075386,16075420,34,0,0,1,1
16075421,16075469,48,1,0,0,1
16075470,16075958,488,0,0,1,1
16075959,16076117,158,1,0,0,1
16076002,16076108,106,0,1,0,1
16076118,16076212,94,0,0,1,1
16076213,16076266,53,1,0,0,1
16076224,16076257,33,0,1,0,1
16076267,16076384,117,0,0,1,1
16076385,16076410,25,1,0,0,1
16076411,16076731,320,0,0,1,1
16076732,16076771,39,1,0,0,1
16076772,16077633,861,0,0,1,1
16077634,16077944,310,1,0,0,1
16077652,16077900,248,0,1,0,1
16077945,16079572,1627,0,0,1,1
16078118,16078342,224,0,0,1,2
16078343,16078347,4,1,0,0,2
16078348,16079063,715,0,0,1,2
16079074,16081668,2594,0,1,0,2
16079573,16081620,2047,1,0,0,1
16079606,16081595,1989,0,1,0,1
16081621,16081773,152,0,0,1,1
16081678,16081678,0,1,0,0,2
16081679,16081771,92,0,0,1,2
16081772,16081812,40,1,0,0,2
16081774,16081814,40,1,0,0,1
16081813,16081886,73,0,0,1,2
16081815,16081888,73,0,0,1,1
16081887,16082186,299,1,0,0,2
16081889,16082097,208,1,0,0,1
16081912,16082082,170,0,1,0,2
16081915,16082061,146,0,1,0,1
16082098,16082170,72,0,0,1,1
16082171,16082190,19,1,0,0,1
16082187,16085089,2902,0,0,1,2
16082191,16085091,2900,0,0,1,1
16085090,16085144,54,1,0,0,2
16085092,16085140,48,1,0,0,1
16085141,16085281,140,0,0,1,1
16085145,16085283,138,0,0,1,2
16085282,16085289,7,1,0,0,1
16085284,16085295,11,1,0,0,2
16085290,16087128,1838,0,0,1,1
16085296,16087138,1842,0,0,1,2
16087129,16087979,850,1,0,0,1
16087139,16087999,860,1,0,0,2
16087175,16087969,794,0,1,0,1
16087175,16087984,809,0,1,0,2
16087980,16088322,342,0,0,1,1
16088000,16088321,321,0,0,1,2
16088322,16088384,62,1,0,0,2
16088323,16088555,232,1,0,0,1
16088385,16088433,48,0,0,1,2
16088434,16088462,28,1,0,0,2
16088463,16088507,44,0,0,1,2
16088508,16088553,45,1,0,0,2
16088554,16089603,1049,0,0,1,2
16088556,16089078,522,0,0,1,1
16089079,16089088,9,1,0,0,1
16089089,16089223,134,0,0,1,1
16089224,16089283,59,1,0,0,1
16089284,16089322,38,0,0,1,1
16089323,16089327,4,1,0,0,1
16089328,16089448,120,0,0,1,1
16089449,16089511,62,1,0,0,1
16089512,16089936,424,0,0,1,1
16089604,16089619,15,1,0,0,2
16089620,16090060,440,0,0,1,2
16089937,16090039,102,1,0,0,1
16090040,16090220,180,0,0,1,1
16090061,16090074,13,1,0,0,2
16090075,16091229,1154,0,0,1,2
16090221,16090248,27,1,0,0,1
16090249,16090482,233,0,0,1,1
16090483,16090492,9,1,0,0,1
16090493,16090653,160,0,0,1,1
16090654,16090783,129,1,0,0,1
16090784,16090876,92,0,0,1,1
16090877,16090890,13,1,0,0,1
16090891,16091230,339,0,0,1,1
16091230,16091313,83,1,0,0,2
16091231,16091320,89,1,0,0,1
16091314,16091442,128,0,0,1,2
16091321,16091445,124,0,0,1,1
16091443,16091457,14,1,0,0,2
16091446,16091457,11,1,0,0,1
16091458,16091637,179,0,0,1,1
16091458,16091645,187,0,0,1,2
16091638,16091654,16,1,0,0,1
16091646,16091654,8,1,0,0,2
16091655,16093180,1525,0,0,1,2
16091655,16093193,1538,0,0,1,1
16093181,16095506,2325,1,0,0,2
16093194,16095459,2265,1,0,0,1
16093232,16095474,2242,0,1,0,2
16093234,16095439,2205,0,1,0,1
16095460,16095674,214,0,0,1,1
16095507,16095671,164,0,0,1,2
16095672,16095928,256,1,0,0,2
16095675,16095841,166,1,0,0,1
16095709,16095811,102,0,1,0,2
16095712,16095799,87,0,1,0,1
16095842,16096023,181,0,0,1,1
16095929,16096024,95,0,0,1,2
16096024,16096124,100,1,0,0,1
16096025,16096079,54,1,0,0,2
16096080,16096385,305,0,0,1,2
16096125,16096165,40,0,0,1,1
16096166,16096307,141,1,0,0,1
16096308,16096673,365,0,0,1,1
16096386,16096452,66,1,0,0,2
16096453,16096548,95,0,0,1,2
16096549,16096807,258,1,0,0,2
16096674,16096688,14,1,0,0,1
16096689,16098028,1339,0,0,1,1
16096808,16096835,27,0,0,1,2
16096836,16096861,25,1,0,0,2
16096862,16097298,436,0,0,1,2
16097299,16097313,14,1,0,0,2
16097314,16097565,251,0,0,1,2
16097566,16097688,122,1,0,0,2
16097689,16098042,353,0,0,1,2
16098029,16098774,745,1,0,0,1
16098043,16098811,768,1,0,0,2
16098150,16098759,609,0,1,0,1
16098156,16098778,622,0,1,0,2
16098775,16099061,286,0,0,1,1
16098812,16099059,247,0,0,1,2
16099060,16099099,39,1,0,0,2
16099062,16099098,36,1,0,0,1
16099099,16099261,162,0,0,1,1
16099100,16099260,160,0,0,1,2
16099261,16099311,50,1,0,0,2
16099262,16099319,57,1,0,0,1
16099312,16099436,124,0,0,1,2
16099320,16099437,117,0,0,1,1
16099437,16099455,18,1,0,0,2
16099438,16099464,26,1,0,0,1
16099456,16101248,1792,0,0,1,2
16099465,16101248,1783,0,0,1,1
16101249,16101301,52,1,0,0,2
16101249,16101303,54,1,0,0,1
16101302,16101404,102,0,0,1,2
16101304,16101404,100,0,0,1,1
16101405,16101428,23,1,0,0,1
16101405,16101433,28,1,0,0,2
16101429,16103179,1750,0,0,1,1
16101434,16102954,1520,0,0,1,2
16102955,16102985,30,1,0,0,2
16102986,16103173,187,0,0,1,2
16103174,16103849,675,1,0,0,2
16103180,16103845,665,1,0,0,1
16103212,16103834,622,0,1,0,1
16103214,16103835,621,0,1,0,2
16103846,16104188,342,0,0,1,1
16103850,16104186,336,0,0,1,2
16104187,16104210,23,1,0,0,2
16104189,16104213,24,1,0,0,1
16104211,16104389,178,0,0,1,2
16104214,16104387,173,0,0,1,1
16104388,16104417,29,1,0,0,1
16104390,16104440,50,1,0,0,2
16104418,16104539,121,0,0,1,1
16104441,16104541,100,0,0,1,2
16104540,16104563,23,1,0,0,1
16104542,16104568,26,1,0,0,2
16104564,16106295,1731,0,0,1,1
16104569,16106297,1728,0,0,1,2
16106296,16106353,57,1,0,0,1
16106298,16106357,59,1,0,0,2
16106354,16106473,119,0,0,1,1
16106358,16106469,111,0,0,1,2
16106470,16106489,19,1,0,0,2
16106474,16106490,16,1,0,0,1
16106490,16106999,509,0,0,1,2
16106491,16108603,2112,0,0,1,1
16107000,16107004,4,1,0,0,2
16107005,16108672,1667,0,0,1,2
16108604,16108619,15,1,0,0,1
16108620,16108673,53,0,0,1,1
16108673,16108956,283,1,0,0,2
16108674,16108966,292,1,0,0,1
16108708,16108905,197,0,1,0,1
16108713,16108927,214,0,1,0,2
16108957,16109691,734,0,0,1,2
16108967,16109489,522,0,0,1,1
16109490,16109502,12,1,0,0,1
16109503,16109687,184,0,0,1,1
16109688,16109747,59,1,0,0,1
16109692,16109732,40,1,0,0,2
16109733,16109863,130,0,0,1,2
16109748,16109860,112,0,0,1,1
16109861,16109891,30,1,0,0,1
16109864,16110030,166,1,0,0,2
16109892,16112490,2598,0,0,1,1
16110031,16110061,30,0,0,1,2
16110062,16110066,4,1,0,0,2
16110067,16110321,254,0,0,1,2
16110322,16110344,22,1,0,0,2
16110345,16110784,439,0,0,1,2
16110785,16110879,94,1,0,0,2
16110880,16111090,210,0,0,1,2
16111091,16111147,56,1,0,0,2
16111148,16111200,52,0,0,1,2
16111201,16111289,88,1,0,0,2
16111290,16112351,1061,0,0,1,2
16112352,16112434,82,1,0,0,2
16112435,16112488,53,0,0,1,2
16112489,16112540,51,1,0,0,2
16112491,16112531,40,1,0,0,1
16112532,16112657,125,0,0,1,1
16112541,16112660,119,0,0,1,2
16112658,16112680,22,1,0,0,1
16112661,16112681,20,1,0,0,2
16112681,16114451,1770,0,0,1,1
16112682,16113034,352,0,0,1,2
16113035,16113106,71,1,0,0,2
16113107,16113737,630,0,0,1,2
16113738,16113757,19,1,0,0,2
16113758,16113849,91,0,0,1,2
16113850,16113867,17,1,0,0,2
16113868,16114441,573,0,0,1,2
16114442,16116369,1927,1,0,0,2
16114452,16115874,1422,1,0,0,1
16114520,16115862,1342,0,1,0,1
16114537,16115917,1380,0,1,0,2
16115875,16115917,42,0,0,1,1
16115918,16116088,170,1,0,0,1
16115947,16116098,151,0,1,0,2
16115959,16116066,107,0,1,0,1
16116089,16116148,59,0,0,1,1
16116149,16116324,175,1,0,0,1
16116177,16116318,141,0,1,0,2
16116185,16116300,115,0,1,0,1
16116325,16116473,148,0,0,1,1
16116370,16116473,103,0,0,1,2
16116474,16116524,50,1,0,0,1
16116474,16116535,61,1,0,0,2
16116525,16116629,104,0,0,1,1
16116536,16116584,48,0,0,1,2
16116585,16116659,74,1,0,0,2
16116630,16116660,30,1,0,0,1
16116660,16116737,77,0,0,1,2
16116661,16116743,82,0,0,1,1
16116738,16116796,58,1,0,0,2
16116744,16116785,41,1,0,0,1
16116786,16118920,2134,0,0,1,1
16116797,16116835,38,0,0,1,2
16116836,16116844,8,1,0,0,2
16116845,16117309,464,0,0,1,2
16117310,16117332,22,1,0,0,2
16117333,16117528,195,0,0,1,2
16117529,16117581,52,1,0,0,2
16117582,16117847,265,0,0,1,2
16117848,16117882,34,1,0,0,2
16117883,16118662,779,0,0,1,2
16118663,16118670,7,1,0,0,2
16118671,16118921,250,0,0,1,2
16118921,16118996,75,1,0,0,1
16118922,16118997,75,1,0,0,2
16118997,16119396,399,0,0,1,1
16118998,16121231,2233,0,0,1,2
16119397,16119406,9,1,0,0,1
16119407,16121215,1808,0,0,1,1
16121216,16121507,291,1,0,0,1
16121232,16121494,262,1,0,0,2
16121239,16121462,223,0,1,0,1
16121246,16121465,219,0,1,0,2
16121495,16122407,912,0,0,1,2
16121508,16122408,900,0,0,1,1
16122408,16122479,71,1,0,0,2
16122409,16122481,72,1,0,0,1
16122480,16122561,81,0,0,1,2
16122482,16122562,80,0,0,1,1
16122562,16122597,35,1,0,0,2
16122563,16122587,24,1,0,0,1
16122588,16122943,355,0,0,1,1
16122598,16123524,926,0,0,1,2
16122944,16122964,20,1,0,0,1
16122965,16125154,2189,0,0,1,1
16123525,16123603,78,1,0,0,2
16123604,16125098,1494,0,0,1,2
16125099,16125108,9,1,0,0,2
16125109,16125392,283,0,0,1,2
16125155,16125250,95,1,0,0,1
16125251,16125319,68,0,0,1,1
16125320,16125351,31,1,0,0,1
16125352,16125391,39,0,0,1,1
16125392,16125455,63,1,0,0,1
16125393,16125451,58,1,0,0,2
16125452,16125816,364,0,0,1,2
16125456,16125809,353,0,0,1,1
16125810,16125832,22,1,0,0,1
16125817,16125831,14,1,0,0,2
16125832,16126403,571,0,0,1,2
16125833,16127331,1498,0,0,1,1
16126404,16126416,12,1,0,0,2
16126417,16127320,903,0,0,1,2
16127321,16128275,954,1,0,0,2
16127332,16128294,962,1,0,0,1
16127348,16128258,910,0,1,0,2
16127373,16128283,910,0,1,0,1
16128276,16128362,86,0,0,1,2
16128295,16128361,66,0,0,1,1
16128362,16128550,188,1,0,0,1
16128363,16128561,198,1,0,0,2
16128387,16128519,132,0,1,0,1
16128390,16128530,140,0,1,0,2
16128551,16128584,33,0,0,1,1
16128562,16128587,25,0,0,1,2
16128585,16128850,265,1,0,0,1
16128588,16128991,403,1,0,0,2
16128609,16128846,237,0,1,0,2
16128611,16128788,177,0,1,0,1
16128851,16129210,359,0,0,1,1
16128871,16128872,1,0,1,0,2
16128992,16129104,112,0,0,1,2
16129105,16129109,4,1,0,0,2
16129110,16129211,101,0,0,1,2
16129211,16129275,64,1,0,0,1
16129212,16129280,68,1,0,0,2
16129276,16129399,123,0,0,1,1
16129281,16129389,108,0,0,1,2
16129390,16129406,16,1,0,0,2
16129400,16129404,4,1,0,0,1
16129405,16131454,2049,0,0,1,1
16129407,16131453,2046,0,0,1,2
16131454,16131498,44,1,0,0,2
16131455,16131500,45,1,0,0,1
16131499,16133249,1750,0,0,1,2
16131501,16133253,1752,0,0,1,1
16133250,16134379,1129,1,0,0,2
16133254,16134387,1133,1,0,0,1
16133275,16133897,622,0,1,0,1
16133278,16134368,1090,0,1,0,2
16133936,16134095,159,0,1,0,1
16134173,16134323,150,0,1,0,1
16134380,16134555,175,0,0,1,2
16134388,16134555,167,0,0,1,1
16134556,16134625,69,1,0,0,2
16134556,16134626,70,1,0,0,1
16134626,16135286,660,0,0,1,2
16134627,16137304,2677,0,0,1,1
16135287,16135301,14,1,0,0,2
16135302,16136277,975,0,0,1,2
16136278,16136318,40,1,0,0,2
16136319,16137307,988,0,0,1,2
16137305,16137360,55,1,0,0,1
16137308,16137382,74,1,0,0,2
16137361,16139395,2034,0,0,1,1
16137383,16139403,2020,0,0,1,2
16139396,16139645,249,1,0,0,1
16139404,16140211,807,1,0,0,2
16139435,16139612,177,0,1,0,1
16139436,16139635,199,0,1,0,2
16139646,16139694,48,0,0,1,1
16139695,16140174,479,1,0,0,1
16139718,16140163,445,0,1,0,1
16139718,16140200,482,0,1,0,2
16140175,16140812,637,0,0,1,1
16140212,16140812,600,0,0,1,2
16140813,16140870,57,1,0,0,1
16140813,16140871,58,1,0,0,2
16140871,16140947,76,0,0,1,1
16140872,16140949,77,0,0,1,2
16140948,16140973,25,1,0,0,1
16140950,16140978,28,1,0,0,2
16140974,16143651,2677,0,0,1,1
16140979,16143655,2676,0,0,1,2
16143652,16143707,55,1,0,0,1
16143656,16143707,51,1,0,0,2
16143708,16143883,175,0,0,1,1
16143708,16143885,177,0,0,1,2
16143884,16143906,22,1,0,0,1
16143886,16143909,23,1,0,0,2
16143907,16145528,1621,0,0,1,1
16143910,16145535,1625,0,0,1,2
16145529,16145820,291,1,0,0,1
16145536,16146463,927,1,0,0,2
16145563,16145785,222,0,1,0,1
16145564,16145832,268,0,1,0,2
16145821,16145866,45,0,0,1,1
16145867,16146412,545,1,0,0,1
16145878,16146428,550,0,1,0,2
16145883,16146397,514,0,1,0,1
16146413,16147045,632,0,0,1,1
16146464,16147046,582,0,0,1,2
16147046,16147114,68,1,0,0,1
16147047,16147114,67,1,0,0,2
16147115,16147206,91,0,0,1,1
16147115,16147208,93,0,0,1,2
16147207,16147236,29,1,0,0,1
16147209,16147254,45,1,0,0,2
16147237,16150070,2833,0,0,1,1
16147255,16149850,2595,0,0,1,2
16149851,16149855,4,1,0,0,2
16149856,16150371,515,0,0,1,2
16150071,16150125,54,1,0,0,1
16150126,16150297,171,0,0,1,1
16150298,16150324,26,1,0,0,1
16150325,16150373,48,0,0,1,1
16150372,16150479,107,1,0,0,2
16150374,16150446,72,1,0,0,1
16150447,16152284,1837,0,0,1,1
16150480,16150991,511,0,0,1,2
16150992,16151007,15,1,0,0,2
16151008,16151582,574,0,0,1,2
16151583,16151598,15,1,0,0,2
16151599,16151749,150,0,0,1,2
16151750,16151759,9,1,0,0,2
16151760,16152106,346,0,0,1,2
16152107,16152119,12,1,0,0,2
16152120,16152293,173,0,0,1,2
16152285,16153169,884,1,0,0,1
16152294,16153264,970,1,0,0,2
16152321,16153159,838,0,1,0,1
16152330,16153206,876,0,1,0,2
16153170,16153315,145,0,0,1,1
16153265,16153314,49,0,0,1,2
16153315,16153351,36,1,0,0,2
16153316,16153349,33,1,0,0,1
16153350,16153564,214,0,0,1,1
16153352,16153839,487,0,0,1,2
16153565,16153660,95,1,0,0,1
16153661,16153779,118,0,0,1,1
16153780,16153907,127,1,0,0,1
16153840,16153904,64,1,0,0,2
16153905,16154000,95,0,0,1,2
16153908,16153995,87,0,0,1,1
16153996,16154010,14,1,0,0,1
16154001,16154013,12,1,0,0,2
16154011,16156485,2474,0,0,1,1
16154014,16156484,2470,0,0,1,2
16156485,16156529,44,1,0,0,2
16156486,16156529,43,1,0,0,1
16156530,16156717,187,0,0,1,2
16156530,16156722,192,0,0,1,1
16156718,16156736,18,1,0,0,2
16156723,16156737,14,1,0,0,1
16156737,16159502,2765,0,0,1,2
16156738,16159502,2764,0,0,1,1
16159503,16159570,67,1,0,0,2
16159503,16159640,137,1,0,0,1
16159571,16159611,40,0,0,1,2
16159612,16159673,61,1,0,0,2
16159641,16159774,133,0,0,1,1
16159674,16159732,58,0,0,1,2
16159733,16160063,330,1,0,0,2
16159775,16160014,239,1,0,0,1
16159816,16159998,182,0,1,0,2
16159817,16159963,146,0,1,0,1
16160015,16160073,58,0,0,1,1
16160064,16160101,37,0,0,1,2
16160074,16160136,62,1,0,0,1
16160102,16160122,20,1,0,0,2
16160123,16160259,136,0,0,1,2
16160137,16160466,329,0,0,1,1
16160260,16160336,76,1,0,0,2
16160337,16160571,234,0,0,1,2
16160467,16160471,4,1,0,0,1
16160472,16160665,193,0,0,1,1
16160572,16160576,4,1,0,0,2
16160577,16161965,1388,0,0,1,2
16160666,16160688,22,1,0,0,1
16160689,16161098,409,0,0,1,1
16161099,16161146,47,1,0,0,1
16161147,16161242,95,0,0,1,1
16161243,16161334,91,1,0,0,1
16161335,16161468,133,0,0,1,1
16161469,16161673,204,1,0,0,1
16161674,16161889,215,0,0,1,1
16161890,16162065,175,1,0,0,1
16161966,16161983,17,1,0,0,2
16161984,16162467,483,0,0,1,2
16162066,16162136,70,0,0,1,1
16162137,16162239,102,1,0,0,1
16162240,16162260,20,0,0,1,1
16162261,16162377,116,1,0,0,1
16162378,16162471,93,0,0,1,1
16162468,16162496,28,1,0,0,2
16162472,16162555,83,1,0,0,1
16162497,16162526,29,0,0,1,2
16162527,16162531,4,1,0,0,2
16162532,16162656,124,0,0,1,2
16162556,16162866,310,0,0,1,1
16162657,16162676,19,1,0,0,2
16162677,16164252,1575,0,0,1,2
16162867,16162914,47,1,0,0,1
16162915,16162960,45,0,0,1,1
16162961,16163941,980,1,0,0,1
16163942,16164019,77,0,0,1,1
16164020,16165187,1167,1,0,0,1
16164253,16164606,353,1,0,0,2
16164292,16164481,189,0,1,0,1
16164295,16164545,250,0,1,0,2
16164607,16164751,144,0,0,1,2
16164752,16165018,266,1,0,0,2
16164779,16164948,169,0,1,0,1
16164780,16164976,196,0,1,0,2
16165019,16165126,107,0,0,1,2
16165127,16165163,36,1,0,0,2
16165164,16165465,301,0,0,1,2
16165188,16165465,277,0,0,1,1
16165466,16165525,59,1,0,0,2
16165466,16165535,69,1,0,0,1
16165526,16165606,80,0,0,1,2
16165536,16165601,65,0,0,1,1
16165602,16165644,42,1,0,0,1
16165607,16165663,56,1,0,0,2
16165645,16165775,130,0,0,1,1
16165664,16165782,118,0,0,1,2
16165776,16165796,20,1,0,0,1
16165783,16165796,13,1,0,0,2
16165797,16165950,153,0,0,1,1
16165797,16168438,2641,0,0,1,2
16165951,16165964,13,1,0,0,1
16165965,16167164,1199,0,0,1,1
16167165,16167284,119,1,0,0,1
16167285,16168439,1154,0,0,1,1
16168439,16168491,52,1,0,0,2
16168440,16168490,50,1,0,0,1
16168491,16170589,2098,0,0,1,1
16168492,16169947,1455,0,0,1,2
16169958,16169973,15,0,1,0,2
16169983,16171738,1755,1,0,0,2
16170013,16171727,1714,0,1,0,2
16170590,16170629,39,1,0,0,1
16170630,16170686,56,0,0,1,1
16170687,16171620,933,1,0,0,1
16170716,16171158,442,0,1,0,1
16171260,16171522,262,0,1,0,1
16171621,16171981,360,0,0,1,1
16171739,16171775,36,0,0,1,2
16171786,16173063,1277,0,1,0,2
16171982,16173037,1055,1,0,0,1
16171996,16173014,1018,0,1,0,1
16173038,16173123,85,0,0,1,1
16173073,16173074,1,1,0,0,2
16173075,16173125,50,0,0,1,2
16173124,16173264,140,1,0,0,1
16173126,16173172,46,1,0,0,2
16173173,16173300,127,0,0,1,2
16173265,16173309,44,0,0,1,1
16173301,16173317,16,1,0,0,2
16173310,16173314,4,1,0,0,1
16173315,16173449,134,0,0,1,1
16173318,16175463,2145,0,0,1,2
16173450,16173478,28,1,0,0,1
16173479,16175464,1985,0,0,1,1
16175464,16175547,83,1,0,0,2
16175465,16175542,77,1,0,0,1
16175543,16177458,1915,0,0,1,1
16175548,16175708,160,0,0,1,2
16175709,16175726,17,1,0,0,2
16175727,16175825,98,0,0,1,2
16175826,16175843,17,1,0,0,2
16175844,16175911,67,0,0,1,2
16175912,16175973,61,1,0,0,2
16175974,16176092,118,0,0,1,2
16176093,16176099,6,1,0,0,2
16176100,16176329,229,0,0,1,2
16176330,16176364,34,1,0,0,2
16176365,16177039,674,0,0,1,2
16177040,16177077,37,1,0,0,2
16177078,16177563,485,0,0,1,2
16177459,16177465,6,1,0,0,1
16177466,16177573,107,0,0,1,1
16177564,16178361,797,1,0,0,2
16177574,16178352,778,1,0,0,1
16177596,16178226,630,0,1,0,1
16177596,16178318,722,0,1,0,2
16178353,16178633,280,0,0,1,1
16178362,16178634,272,0,0,1,2
16178634,16178692,58,1,0,0,1
16178635,16178685,50,1,0,0,2
16178686,16178797,111,0,0,1,2
16178693,16178793,100,0,0,1,1
16178794,16178821,27,1,0,0,1
16178798,16178816,18,1,0,0,2
16178817,16179253,436,0,0,1,2
16178822,16179258,436,0,0,1,1
16179254,16179738,484,1,0,0,2
16179259,16179592,333,1,0,0,1
16179267,16179683,416,0,1,0,2
16179284,16179565,281,0,1,0,1
16179593,16179615,22,0,0,1,1
16179616,16179689,73,1,0,0,1
16179690,16179780,90,0,0,1,1
16179739,16182441,2702,0,0,1,2
16179781,16179797,16,1,0,0,1
16179798,16179972,174,0,0,1,1
16179973,16179983,10,1,0,0,1
16179984,16180921,937,0,0,1,1
16180922,16180943,21,1,0,0,1
16180944,16182091,1147,0,0,1,1
16182092,16182109,17,1,0,0,1
16182110,16182188,78,0,0,1,1
16182189,16182231,42,1,0,0,1
16182232,16182313,81,0,0,1,1
16182314,16182387,73,1,0,0,1
16182388,16182442,54,0,0,1,1
16182442,16182534,92,1,0,0,2
16182443,16182494,51,1,0,0,1
16182495,16182640,145,0,0,1,1
16182535,16182641,106,0,0,1,2
16182641,16182669,28,1,0,0,1
16182642,16182658,16,1,0,0,2
16182659,16184475,1816,0,0,1,2
16182670,16184500,1830,0,0,1,1
16184476,16185461,985,1,0,0,2
16184501,16184836,335,1,0,0,1
16184512,16185441,929,0,1,0,2
16184527,16184796,269,0,1,0,1
16184837,16184868,31,0,0,1,1
16184869,16184875,6,1,0,0,1
16184876,16185050,174,0,0,1,1
16185051,16185436,385,1,0,0,1
16185066,16185400,334,0,1,0,1
16185437,16185661,224,0,0,1,1
16185462,16185932,470,0,0,1,2
16185662,16185712,50,1,0,0,1
16185713,16185895,182,0,0,1,1
16185896,16185900,4,1,0,0,1
16185901,16186068,167,0,0,1,1
16185933,16185951,18,1,0,0,2
16185952,16186292,340,0,0,1,2
16186069,16186311,242,1,0,0,1
16186293,16186323,30,1,0,0,2
16186312,16186352,40,0,0,1,1
16186324,16186496,172,0,0,1,2
16186353,16186386,33,1,0,0,1
16186387,16186447,60,0,0,1,1
16186448,16186453,5,1,0,0,1
16186454,16186488,34,0,0,1,1
16186489,16187414,925,1,0,0,1
16186497,16187472,975,1,0,0,2
16186532,16187418,886,0,1,0,2
16186536,16187181,645,0,1,0,1
16187232,16187381,149,0,1,0,1
16187415,16187534,119,0,0,1,1
16187473,16187525,52,0,0,1,2
16187526,16187680,154,1,0,0,2
16187535,16187582,47,1,0,0,1
16187583,16190847,3264,0,0,1,1
16187681,16187732,51,0,0,1,2
16187733,16187763,30,1,0,0,2
16187764,16187993,229,0,0,1,2
16187994,16188010,16,1,0,0,2
16188011,16188057,46,0,0,1,2
16188058,16188138,80,1,0,0,2
16188139,16188499,360,0,0,1,2
16188500,16188504,4,1,0,0,2
16188505,16188571,66,0,0,1,2
16188572,16188618,46,1,0,0,2
16188619,16188835,216,0,0,1,2
16188836,16188851,15,1,0,0,2
16188852,16189312,460,0,0,1,2
16189313,16189324,11,1,0,0,2
16189325,16189899,574,0,0,1,2
16189900,16189918,18,1,0,0,2
16189919,16190352,433,0,0,1,2
16190353,16190383,30,1,0,0,2
16190384,16190740,356,0,0,1,2
16190741,16190761,20,1,0,0,2
16190762,16190850,88,0,0,1,2
16190848,16190918,70,1,0,0,1
16190851,16190910,59,1,0,0,2
16190911,16191002,91,0,0,1,2
16190919,16190998,79,0,0,1,1
16190999,16191026,27,1,0,0,1
16191003,16191032,29,1,0,0,2
16191027,16192859,1832,0,0,1,1
16191033,16192860,1827,0,0,1,2
16192860,16194042,1182,1,0,0,1
16192861,16194084,1223,1,0,0,2
16192898,16193772,874,0,1,0,1
16192910,16194042,1132,0,1,0,2
16193809,16193979,170,0,1,0,1
16194043,16194169,126,0,0,1,1
16194085,16194142,57,0,0,1,2
16194143,16194212,69,1,0,0,2
16194170,16194212,42,1,0,0,1
16194213,16194322,109,0,0,1,1
16194213,16194322,109,0,0,1,2
16194323,16194345,22,1,0,0,1
16194323,16194425,102,1,0,0,2
16194346,16194580,234,0,0,1,1
16194426,16194611,185,0,0,1,2
16194581,16194585,4,1,0,0,1
16194586,16197863,3277,0,0,1,1
16194612,16194636,24,1,0,0,2
16194637,16194845,208,0,0,1,2
16194846,16194850,4,1,0,0,2
16194851,16195062,211,0,0,1,2
16195063,16195086,23,1,0,0,2
16195087,16195625,538,0,0,1,2
16195626,16195631,5,1,0,0,2
16195632,16195781,149,0,0,1,2
16195782,16195825,43,1,0,0,2
16195826,16195999,173,0,0,1,2
16196000,16196015,15,1,0,0,2
16196016,16196761,745,0,0,1,2
16196762,16196778,16,1,0,0,2
16196779,16197274,495,0,0,1,2
16197275,16197308,33,1,0,0,2
16197309,16197787,478,0,0,1,2
16197788,16198409,621,1,0,0,2
16197864,16198358,494,1,0,0,1
16197905,16198347,442,0,1,0,1
16197919,16198398,479,0,1,0,2
16198359,16198445,86,0,0,1,1
16198410,16198561,151,0,0,1,2
16198446,16198453,7,1,0,0,1
16198454,16198562,108,0,0,1,1
16198562,16198641,79,1,0,0,2
16198563,16198570,7,1,0,0,1
16198571,16199957,1386,0,0,1,1
16198642,16199285,643,0,0,1,2
16199286,16199301,15,1,0,0,2
16199302,16199957,655,0,0,1,2
16199958,16200556,598,1,0,0,2
16199958,16200558,600,1,0,0,1
16200026,16200468,442,0,1,0,1
16200033,16200512,479,0,1,0,2
16200557,16200680,123,0,0,1,2
16200559,16200680,121,0,0,1,1
16200681,16200705,24,1,0,0,1
16200681,16200711,30,1,0,0,2
16200706,16201736,1030,0,0,1,1
16200712,16201734,1022,0,0,1,2
16201735,16201801,66,1,0,0,2
16201737,16201798,61,1,0,0,1
16201799,16201894,95,0,0,1,1
16201802,16201896,94,0,0,1,2
16201895,16201991,96,1,0,0,1
16201897,16201927,30,1,0,0,2
16201928,16204767,2839,0,0,1,2
16201992,16202248,256,0,0,1,1
16202249,16202265,16,1,0,0,1
16202266,16202306,40,0,0,1,1
16202307,16202324,17,1,0,0,1
16202325,16202698,373,0,0,1,1
16202699,16202708,9,1,0,0,1
16202709,16203436,727,0,0,1,1
16203437,16203486,49,1,0,0,1
16203487,16203508,21,0,0,1,1
16203509,16203546,37,1,0,0,1
16203547,16203594,47,0,0,1,1
16203595,16203617,22,1,0,0,1
16203618,16203658,40,0,0,1,1
16203659,16203701,42,1,0,0,1
16203702,16203880,178,0,0,1,1
16203881,16203917,36,1,0,0,1
16203918,16204085,167,0,0,1,1
16204086,16204092,6,1,0,0,1
16204093,16204132,39,0,0,1,1
16204133,16204169,36,1,0,0,1
16204170,16204265,95,0,0,1,1
16204266,16204405,139,1,0,0,1
16204406,16204527,121,0,0,1,1
16204528,16204548,20,1,0,0,1
16204549,16204879,330,0,0,1,1
16204778,16204830,52,0,1,0,2
16204840,16204848,8,1,0,0,2
16204849,16204869,20,0,0,1,2
16204870,16209495,4625,1,0,0,2
16204880,16205383,503,1,0,0,1
16204891,16209159,4268,0,1,0,2
16204931,16205372,441,0,1,0,1
16205384,16206054,670,0,0,1,1
16206065,16206074,9,0,1,0,1
16206083,16206083,0,1,0,0,1
16206084,16206129,45,0,0,1,1
16206140,16206167,27,0,1,0,1
16206177,16206211,34,1,0,0,1
16206199,16206202,3,0,1,0,1
16206212,16206345,133,0,0,1,1
16206356,16209137,2781,0,1,0,1
16209147,16209147,0,1,0,0,1
16209148,16209222,74,0,0,1,1
16209223,16209407,184,1,0,0,1
16209234,16209410,176,0,1,0,2
16209245,16209366,121,0,1,0,1
16209408,16209565,157,0,0,1,1
16209496,16209564,68,0,0,1,2
16209565,16209645,80,1,0,0,2
16209566,16209669,103,1,0,0,1
16209646,16209714,68,0,0,1,2
16209670,16209713,43,0,0,1,1
16209714,16209750,36,1,0,0,1
16209715,16209851,136,1,0,0,2
16209751,16209808,57,0,0,1,1
16209809,16209841,32,1,0,0,1
16209842,16209981,139,0,0,1,1
16209852,16209916,64,0,0,1,2
16209917,16209937,20,1,0,0,2
16209938,16209983,45,0,0,1,2
16209982,16210002,20,1,0,0,1
16209984,16210371,387,1,0,0,2
16210003,16211149,1146,0,0,1,1
16210372,16210510,138,0,0,1,2
16210511,16210536,25,1,0,0,2
16210537,16210616,79,0,0,1,2
16210617,16210650,33,1,0,0,2
16210651,16210693,42,0,0,1,2
16210694,16210705,11,1,0,0,2
16210706,16210898,192,0,0,1,2
16210899,16210915,16,1,0,0,2
16210916,16211150,234,0,0,1,2
16211150,16211191,41,1,0,0,1
16211151,16211191,40,1,0,0,2
16211192,16211366,174,0,0,1,1
16211192,16211370,178,0,0,1,2
16211367,16211376,9,1,0,0,1
16211371,16211381,10,1,0,0,2
16211377,16213125,1748,0,0,1,1
16211382,16212873,1491,0,0,1,2
16212874,16212892,18,1,0,0,2
16212893,16213128,235,0,0,1,2
16213126,16213823,697,1,0,0,1
16213129,16213821,692,1,0,0,2
16213147,16213806,659,0,1,0,2
16213148,16213770,622,0,1,0,1
16213822,16213918,96,0,0,1,2
16213824,16213917,93,0,0,1,1
16213918,16213968,50,1,0,0,1
16213919,16213976,57,1,0,0,2
16213969,16214171,202,0,0,1,1
16213977,16214170,193,0,0,1,2
16214171,16214193,22,1,0,0,2
16214172,16214195,23,1,0,0,1
16214194,16215190,996,0,0,1,2
16214196,16215190,994,0,0,1,1
16215191,16215279,88,1,0,0,1
16215191,16215280,89,1,0,0,2
16215280,16215385,105,0,0,1,1
16215281,16215383,102,0,0,1,2
16215384,16215423,39,1,0,0,2
16215386,16215406,20,1,0,0,1
16215407,16217504,2097,0,0,1,1
16215424,16217506,2082,0,0,1,2
16217505,16217558,53,1,0,0,1
16217507,16217562,55,1,0,0,2
16217559,16219638,2079,0,0,1,1
16217563,16219535,1972,0,0,1,2
16219536,16219543,7,1,0,0,2
16219544,16219636,92,0,0,1,2
16219637,16219903,266,1,0,0,2
16219639,16219942,303,1,0,0,1
16219667,16219863,196,0,1,0,1
16219672,16219847,175,0,1,0,2
16219904,16220487,583,0,0,1,2
16219943,16220327,384,0,0,1,1
16220328,16220355,27,1,0,0,1
16220356,16220797,441,0,0,1,1
16220488,16220492,4,1,0,0,2
16220493,16220792,299,0,0,1,2
16220793,16220872,79,1,0,0,2
16220798,16220875,77,1,0,0,1
16220873,16220972,99,0,0,1,2
16220876,16220973,97,0,0,1,1
16220973,16221013,40,1,0,0,2
16220974,16221002,28,1,0,0,1
16221003,16221223,220,0,0,1,1
16221014,16221234,220,0,0,1,2
16221224,16221499,275,1,0,0,1
16221235,16221534,299,1,0,0,2
16221257,16221465,208,0,1,0,1
16221262,16221497,235,0,1,0,2
16221500,16221585,85,0,0,1,1
16221535,16221586,51,0,0,1,2
16221586,16221590,4,1,0,0,1
16221587,16221594,7,1,0,0,2
16221591,16223809,2218,0,0,1,1
16221595,16223811,2216,0,0,1,2
16223810,16223931,121,1,0,0,1
16223812,16223928,116,1,0,0,2
16223929,16224150,221,0,0,1,2
16223932,16224452,520,0,0,1,1
16224151,16224231,80,1,0,0,2
16224232,16224471,239,0,0,1,2
16224453,16224525,72,1,0,0,1
16224472,16224603,131,1,0,0,2
16224526,16224750,224,0,0,1,1
16224604,16224818,214,0,0,1,2
16224751,16224755,4,1,0,0,1
16224756,16225588,832,0,0,1,1
16224819,16224840,21,1,0,0,2
16224841,16225082,241,0,0,1,2
16225083,16225095,12,1,0,0,2
16225096,16225783,687,0,0,1,2
16225589,16225602,13,1,0,0,1
16225603,16225785,182,0,0,1,1
16225784,16226189,405,1,0,0,2
16225786,16226151,365,1,0,0,1
16225834,16226116,282,0,1,0,1
16225843,16226178,335,0,1,0,2
16226152,16226247,95,0,0,1,1
16226190,16226240,50,0,0,1,2
16226241,16226260,19,1,0,0,2
16226248,16226254,6,1,0,0,1
16226255,16226561,306,0,0,1,1
16226261,16226568,307,0,0,1,2
16226562,16226576,14,1,0,0,1
16226569,16226590,21,1,0,0,2
16226577,16227317,740,0,0,1,1
16226591,16227316,725,0,0,1,2
16227317,16227348,31,1,0,0,2
16227318,16227342,24,1,0,0,1
16227343,16227685,342,0,0,1,1
16227349,16227692,343,0,0,1,2
16227686,16227958,272,1,0,0,1
16227693,16227972,279,1,0,0,2
16227710,16227914,204,0,1,0,1
16227712,16227933,221,0,1,0,2
16227959,16230628,2669,0,0,1,1
16227973,16230629,2656,0,0,1,2
16230629,16230689,60,1,0,0,1
16230630,16230699,69,1,0,0,2
16230690,16230761,71,0,0,1,1
16230700,16230765,65,0,0,1,2
16230762,16230783,21,1,0,0,1
16230766,16230823,57,1,0,0,2
16230784,16232907,2123,0,0,1,1
16230824,16230871,47,0,0,1,2
16230872,16230921,49,1,0,0,2
16230922,16232904,1982,0,0,1,2
16232905,16233919,1014,1,0,0,2
16232908,16233880,972,1,0,0,1
16232932,16233626,694,0,1,0,1
16232941,16233673,732,0,1,0,2
16233695,16233874,179,0,1,0,2
16233705,16233847,142,0,1,0,1
16233881,16234385,504,0,0,1,1
16233920,16234384,464,0,0,1,2
16234385,16234410,25,1,0,0,2
16234386,16234411,25,1,0,0,1
16234411,16234515,104,0,0,1,2
16234412,16234515,103,0,0,1,1
16234516,16234559,43,1,0,0,1
16234516,16234615,99,1,0,0,2
16234560,16234750,190,0,0,1,1
16234616,16234751,135,0,0,1,2
16234751,16234771,20,1,0,0,1
16234752,16234784,32,1,0,0,2
16234772,16234994,222,0,0,1,1
16234785,16234994,209,0,0,1,2
16234995,16235022,27,1,0,0,1
16234995,16235027,32,1,0,0,2
16235023,16235187,164,0,0,1,1
16235028,16235188,160,0,0,1,2
16235188,16235228,40,1,0,0,1
16235189,16235229,40,1,0,0,2
16235229,16235315,86,0,0,1,1
16235230,16235323,93,0,0,1,2
16235316,16235531,215,1,0,0,1
16235324,16235563,239,1,0,0,2
16235337,16235494,157,0,1,0,1
16235340,16235521,181,0,1,0,2
16235532,16235652,120,0,0,1,1
16235564,16235653,89,0,0,1,2
16235653,16235679,26,1,0,0,1
16235654,16235677,23,1,0,0,2
16235678,16235815,137,0,0,1,2
16235680,16235813,133,0,0,1,1
16235814,16235846,32,1,0,0,1
16235816,16235841,25,1,0,0,2
16235842,16236009,167,0,0,1,2
16235847,16236010,163,0,0,1,1
16236010,16236077,67,1,0,0,2
16236011,16236080,69,1,0,0,1
16236078,16236256,178,0,0,1,2
16236081,16236151,70,0,0,1,1
16236152,16236692,540,1,0,0,1
16236192,16236638,446,0,1,0,1
16236257,16236832,575,1,0,0,2
16236290,16236737,447,0,1,0,2
16236693,16236727,34,0,0,1,1
16236728,16236836,108,1,0,0,1
16236833,16236957,124,0,0,1,2
16236837,16236957,120,0,0,1,1
16287690,16287832,142,0,0,1,1
16287690,16287832,142,0,0,1,2
16287833,16287866,33,1,0,0,1
16287833,16287880,47,1,0,0,2
16287867,16287940,73,0,0,1,1
16287881,16287940,59,0,0,1,2
16287941,16287993,52,1,0,0,1
16287941,16287996,55,1,0,0,2
16287994,16288100,106,0,0,1,1
16287997,16288104,107,0,0,1,2
16288101,16288125,24,1,0,0,1
16288105,16288124,19,1,0,0,2
16288125,16289427,1302,0,0,1,2
16288126,16288438,312,0,0,1,1
16288439,16288452,13,1,0,0,1
16288453,16289425,972,0,0,1,1
16289426,16290556,1130,1,0,0,1
16289428,16290597,1169,1,0,0,2
16289491,16290545,1054,0,1,0,1
16289495,16290586,1091,0,1,0,2
16290557,16290636,79,0,0,1,1
16290598,16290636,38,0,0,1,2
16290637,16290666,29,1,0,0,1
16290637,16290676,39,1,0,0,2
16290667,16292402,1735,0,0,1,1
16290677,16292401,1724,0,0,1,2
16292402,16292544,142,1,0,0,2
16292403,16292822,419,1,0,0,1
16292545,16292575,30,0,0,1,2
16292576,16294697,2121,1,0,0,2
16292604,16292609,5,0,1,0,2
16292647,16294682,2035,0,1,0,2
16292823,16292844,21,0,0,1,1
16292845,16292958,113,1,0,0,1
16292959,16293026,67,0,0,1,1
16293027,16293069,42,1,0,0,1
16293070,16293119,49,0,0,1,1
16293120,16293140,20,1,0,0,1
16293141,16293666,525,0,0,1,1
16293667,16293690,23,1,0,0,1
16293691,16293807,116,0,0,1,1
16293808,16293823,15,1,0,0,1
16293824,16293960,136,0,0,1,1
16293961,16294053,92,1,0,0,1
16294054,16294088,34,0,0,1,1
16294089,16294173,84,1,0,0,1
16294174,16294244,70,0,0,1,1
16294245,16294672,427,1,0,0,1
16294445,16294634,189,0,1,0,1
16294673,16294748,75,0,0,1,1
16294698,16294748,50,0,0,1,2
16294749,16294765,16,1,0,0,1
16294749,16294767,18,1,0,0,2
16294766,16296601,1835,0,0,1,1
16294768,16296602,1834,0,0,1,2
16296602,16296684,82,1,0,0,1
16296603,16296701,98,1,0,0,2
16296685,16296778,93,0,0,1,1
16296702,16296789,87,0,0,1,2
16296779,16296849,70,1,0,0,1
16296790,16296822,32,1,0,0,2
16296823,16298842,2019,0,0,1,2
16296850,16297437,587,0,0,1,1
16297438,16297447,9,1,0,0,1
16297448,16297975,527,0,0,1,1
16297976,16298003,27,1,0,0,1
16298004,16298212,208,0,0,1,1
16298213,16298217,4,1,0,0,1
16298218,16298847,629,0,0,1,1
16298843,16298953,110,1,0,0,2
16298848,16298940,92,1,0,0,1
16298941,16299001,60,0,0,1,1
16298954,16299004,50,0,0,1,2
16299002,16299011,9,1,0,0,1
16299005,16299037,32,1,0,0,2
16299012,16299085,73,0,0,1,1
16299038,16299086,48,0,0,1,2
16299086,16299108,22,1,0,0,1
16299087,16299109,22,1,0,0,2
16299109,16299980,871,0,0,1,1
16299110,16299665,555,0,0,1,2
16299666,16299676,10,1,0,0,2
16299677,16300632,955,0,0,1,2
16299981,16300005,24,1,0,0,1
16300006,16300957,951,0,0,1,1
16300633,16300648,15,1,0,0,2
16300649,16300834,185,0,0,1,2
16300835,16300865,30,1,0,0,2
16300866,16300949,83,0,0,1,2
16300950,16301184,234,1,0,0,2
16300958,16301155,197,1,0,0,1
16301010,16301109,99,0,1,0,1
16301022,16301098,76,0,1,0,2
16301156,16301410,254,0,0,1,1
16301185,16301272,87,0,0,1,2
16301273,16301281,8,1,0,0,2
16301282,16301347,65,0,0,1,2
16301348,16301489,141,1,0,0,2
16301411,16301489,78,1,0,0,1
16301490,16301582,92,0,0,1,1
16301490,16301583,93,0,0,1,2
16301583,16301607,24,1,0,0,1
16301584,16301618,34,1,0,0,2
16301608,16303158,1550,0,0,1,1
16301619,16301787,168,0,0,1,2
16301788,16301884,96,1,0,0,2
16301885,16302041,156,0,0,1,2
16302042,16302052,10,1,0,0,2
16302053,16302928,875,0,0,1,2
16302929,16302957,28,1,0,0,2
16302958,16303050,92,0,0,1,2
16303051,16303059,8,1,0,0,2
16303060,16303152,92,0,0,1,2
16303153,16304077,924,1,0,0,2
16303159,16304030,871,1,0,0,1
16303215,16304017,802,0,1,0,1
16303241,16304043,802,0,1,0,2
16304031,16304124,93,0,0,1,1
16304078,16304129,51,0,0,1,2
16304125,16304182,57,1,0,0,1
16304130,16304172,42,1,0,0,2
16304173,16306523,2350,0,0,1,2
16304183,16306523,2340,0,0,1,1
16306524,16306609,85,1,0,0,1
16306524,16306609,85,1,0,0,2
16306610,16306678,68,0,0,1,2
16306610,16306682,72,0,0,1,1
16306679,16306720,41,1,0,0,2
16306683,16306729,46,1,0,0,1
16306721,16306908,187,0,0,1,2
16306730,16308353,1623,0,0,1,1
16306909,16306923,14,1,0,0,2
16306924,16308421,1497,0,0,1,2
16308354,16308767,413,1,0,0,1
16308422,16308526,104,1,0,0,2
16308527,16308680,153,0,0,1,2
16308681,16308755,74,1,0,0,2
16308756,16309023,267,0,0,1,2
16308768,16309021,253,0,0,1,1
16309022,16309242,220,1,0,0,1
16309024,16309204,180,1,0,0,2
16309205,16309270,65,0,0,1,2
16309243,16309272,29,0,0,1,1
16309271,16309340,69,1,0,0,2
16309273,16309303,30,1,0,0,1
16309304,16309424,120,0,0,1,1
16309341,16309434,93,0,0,1,2
16309425,16309608,183,1,0,0,1
16309435,16309439,4,1,0,0,2
16309440,16309461,21,0,0,1,2
16309462,16309478,16,1,0,0,2
16309479,16309625,146,0,0,1,2
16309609,16309631,22,0,0,1,1
16309626,16309638,12,1,0,0,2
16309632,16310894,1262,1,0,0,1
16309639,16309715,76,0,0,1,2
16309644,16310717,1073,0,1,0,1
16309716,16309725,9,1,0,0,2
16309726,16309827,101,0,0,1,2
16309828,16309969,141,1,0,0,2
16309866,16309919,53,0,1,0,2
16309970,16310016,46,0,0,1,2
16310017,16310937,920,1,0,0,2
16310181,16310196,15,0,1,0,2
16310260,16310702,442,0,1,0,2
16310728,16310746,18,0,1,0,2
16310895,16310970,75,0,0,1,1
16310938,16311070,132,0,0,1,2
16310971,16311018,47,1,0,0,1
16311019,16311076,57,0,0,1,1
16311071,16311086,15,1,0,0,2
16311077,16311442,365,1,0,0,1
16311087,16311130,43,0,0,1,2
16311131,16311363,232,1,0,0,2
16311364,16311435,71,0,0,1,2
16311436,16314201,2765,1,0,0,2
16311443,16311485,42,0,0,1,1
16311486,16314107,2621,1,0,0,1
16311864,16314091,2227,0,1,0,1
16311865,16312130,265,0,1,0,2
16312832,16314129,1297,0,1,0,2
16314108,16314132,24,0,0,1,1
16314133,16314149,16,1,0,0,1
16314150,16314251,101,0,0,1,1
16314202,16314251,49,0,0,1,2
16314252,16314354,102,1,0,0,2
16314252,16314356,104,1,0,0,1
16314355,16314391,36,0,0,1,2
16314357,16314429,72,0,0,1,1
16314392,16316962,2570,1,0,0,2
16314415,16314417,2,0,1,0,2
16314430,16316884,2454,1,0,0,1
16314439,16316899,2460,0,1,0,2
16314525,16316874,2349,0,1,0,1
16316885,16316919,34,0,0,1,1
16316920,16316953,33,1,0,0,1
16316954,16316985,31,0,0,1,1
16316963,16316987,24,0,0,1,2
16316986,16317084,98,1,0,0,1
16316988,16317087,99,1,0,0,2
16317085,16317242,157,0,0,1,1
16317088,16317234,146,0,0,1,2
16317235,16317275,40,1,0,0,2
16317243,16317274,31,1,0,0,1
16317275,16317412,137,0,0,1,1
16317276,16317416,140,0,0,1,2
16317413,16317524,111,1,0,0,1
16317417,16317528,111,1,0,0,2
16317525,16317594,69,0,0,1,1
16317529,16317622,93,0,0,1,2
16317595,16317708,113,1,0,0,1
16317623,16317779,156,1,0,0,2
16317709,16317826,117,0,0,1,1
16317780,16317825,45,0,0,1,2
16317826,16317918,92,1,0,0,2
16317827,16317852,25,1,0,0,1
16317853,16317986,133,0,0,1,1
16317919,16317990,71,0,0,1,2
16317987,16318006,19,1,0,0,1
16317991,16318084,93,1,0,0,2
16318007,16319550,1543,0,0,1,1
16318085,16318283,198,0,0,1,2
16318284,16318300,16,1,0,0,2
16318301,16319562,1261,0,0,1,2
16319551,16320013,462,1,0,0,1
16319563,16319573,10,1,0,0,2
16319574,16319595,21,0,0,1,2
16319596,16320002,406,0,1,0,1
16319596,16320074,478,1,0,0,2
16319620,16320063,443,0,1,0,2
16320014,16320154,140,0,0,1,1
16320075,16320154,79,0,0,1,2
16320155,16320264,109,1,0,0,2
16320155,16320276,121,1,0,0,1
16320265,16320350,85,0,0,1,2
16320277,16320350,73,0,0,1,1
16320351,16320388,37,1,0,0,2
16320351,16320396,45,1,0,0,1
16320389,16320479,90,0,0,1,2
16320397,16320507,110,0,0,1,1
16320480,16320538,58,1,0,0,2
16320508,16320580,72,1,0,0,1
16320539,16320671,132,0,0,1,2
16320581,16320698,117,0,0,1,1
16320672,16320676,4,1,0,0,2
16320677,16322046,1369,0,0,1,2
16320699,16320717,18,1,0,0,1
16320718,16322015,1297,0,0,1,1
16322016,16322319,303,1,0,0,1
16322047,16322340,293,1,0,0,2
16322080,16322279,199,0,1,0,1
16322094,16322298,204,0,1,0,2
16322320,16322438,118,0,0,1,1
16322341,16322437,96,0,0,1,2
16322438,16322885,447,1,0,0,2
16322439,16322859,420,1,0,0,1
16322560,16322848,288,0,1,0,2
16322564,16322828,264,0,1,0,1
16322860,16322973,113,0,0,1,1
16322886,16322969,83,0,0,1,2
16322970,16323259,289,1,0,0,2
16322974,16323350,376,1,0,0,1
16323037,16323194,157,0,1,0,1
16323040,16323207,167,0,1,0,2
16323260,16323324,64,0,0,1,2
16323325,16323348,23,1,0,0,2
16323349,16323607,258,0,0,1,2
16323351,16323559,208,0,0,1,1
16323560,16323653,93,1,0,0,1
16323608,16323617,9,1,0,0,2
16323618,16325266,1648,0,0,1,2
16323654,16323732,78,0,0,1,1
16323733,16323816,83,1,0,0,1
16323817,16323969,152,0,0,1,1
16323970,16323989,19,1,0,0,1
16323990,16324309,319,0,0,1,1
16324310,16324324,14,1,0,0,1
16324325,16324364,39,0,0,1,1
16324365,16324396,31,1,0,0,1
16324397,16324466,69,0,0,1,1
16324467,16324506,39,1,0,0,1
16324507,16325265,758,0,0,1,1
16325266,16325433,167,1,0,0,1
16325267,16325434,167,1,0,0,2
16325434,16325479,45,0,0,1,1
16325435,16325478,43,0,0,1,2
16325479,16325508,29,1,0,0,2
16325480,16325505,25,1,0,0,1
16325506,16325564,58,0,0,1,1
16325509,16325563,54,0,0,1,2
16325564,16325586,22,1,0,0,2
16325565,16325581,16,1,0,0,1
16325582,16325738,156,0,0,1,1
16325587,16325737,150,0,0,1,2
16325738,16325745,7,1,0,0,2
16325739,16325754,15,1,0,0,1
16325746,16327227,1481,0,0,1,2
16325755,16327227,1472,0,0,1,1
16327228,16327393,165,1,0,0,2
16327228,16327422,194,1,0,0,1
16327394,16327669,275,0,0,1,2
16327423,16327668,245,0,0,1,1
16327669,16327721,52,1,0,0,1
16327670,16327725,55,1,0,0,2
16327722,16327805,83,0,0,1,1
16327726,16327807,81,0,0,1,2
16327806,16328108,302,1,0,0,1
16327808,16328240,432,1,0,0,2
16327829,16328100,271,0,1,0,2
16327832,16328057,225,0,1,0,1
16328109,16328146,37,0,0,1,1
16328125,16328127,2,0,1,0,2
16328147,16328230,83,1,0,0,1
16328231,16328398,167,0,0,1,1
16328241,16328396,155,0,0,1,2
16328397,16328414,17,1,0,0,2
16328399,16328409,10,1,0,0,1
16328410,16330452,2042,0,0,1,1
16328415,16330452,2037,0,0,1,2
16330453,16330535,82,1,0,0,1
16330453,16330536,83,1,0,0,2
16330536,16330632,96,0,0,1,1
16330537,16330633,96,0,0,1,2
16330633,16330653,20,1,0,0,1
16330634,16330654,20,1,0,0,2
16330654,16333019,2365,0,0,1,1
16330655,16333022,2367,0,0,1,2
16333020,16333142,122,1,0,0,1
16333023,16333091,68,1,0,0,2
16333092,16333222,130,0,0,1,2
16333143,16333221,78,0,0,1,1
16333222,16333244,22,1,0,0,1
16333223,16333239,16,1,0,0,2
16333240,16333297,57,0,0,1,2
16333245,16333293,48,0,0,1,1
16333294,16333313,19,1,0,0,1
16333298,16333325,27,1,0,0,2
16333314,16334675,1361,0,0,1,1
16333326,16334665,1339,0,0,1,2
16334666,16335324,658,1,0,0,2
16334676,16335256,580,1,0,0,1
16334697,16335247,550,0,1,0,1
16334699,16335286,587,0,1,0,2
16335257,16335296,39,0,0,1,1
16335297,16335322,25,1,0,0,1
16335323,16335497,174,0,0,1,1
16335325,16335495,170,0,0,1,2
16335496,16335769,273,1,0,0,2
16335498,16335734,236,1,0,0,1
16335526,16335735,209,0,1,0,2
16335528,16335708,180,0,1,0,1
16335735,16335823,88,0,0,1,1
16335770,16335811,41,0,0,1,2
16335812,16335888,76,1,0,0,2
16335824,16335856,32,1,0,0,1
16335857,16337870,2013,0,0,1,1
16335889,16335996,107,0,0,1,2
16335997,16336032,35,1,0,0,2
16336033,16336129,96,0,0,1,2
16336130,16336138,8,1,0,0,2
16336139,16336186,47,0,0,1,2
16336187,16336238,51,1,0,0,2
16336239,16336317,78,0,0,1,2
16336318,16336374,56,1,0,0,2
16336375,16336405,30,0,0,1,2
16336406,16336487,81,1,0,0,2
16336488,16337872,1384,0,0,1,2
16337871,16337945,74,1,0,0,1
16337873,16337937,64,1,0,0,2
16337938,16338021,83,0,0,1,2
16337946,16338021,75,0,0,1,1
16338022,16338047,25,1,0,0,1
16338022,16338047,25,1,0,0,2
16338048,16339981,1933,0,0,1,1
16338048,16339982,1934,0,0,1,2
16339982,16340029,47,1,0,0,1
16339983,16340029,46,1,0,0,2
16340030,16340147,117,0,0,1,1
16340030,16340148,118,0,0,1,2
16340148,16340163,15,1,0,0,1
16340149,16340165,16,1,0,0,2
16340164,16341575,1411,0,0,1,1
16340166,16341574,1408,0,0,1,2
16341575,16341815,240,1,0,0,2
16341576,16341793,217,1,0,0,1
16341609,16341766,157,0,1,0,1
16341614,16341778,164,0,1,0,2
16341794,16341988,194,0,0,1,1
16341816,16341989,173,0,0,1,2
16341989,16342052,63,1,0,0,1
16341990,16342051,61,1,0,0,2
16342052,16342101,49,0,0,1,2
16342053,16342098,45,0,0,1,1
16342099,16342114,15,1,0,0,1
16342102,16342112,10,1,0,0,2
16342113,16343763,1650,0,0,1,2
16342115,16343898,1783,0,0,1,1
16343764,16343780,16,1,0,0,2
16343781,16343841,60,0,0,1,2
16343842,16343862,20,1,0,0,2
16343863,16343908,45,0,0,1,2
16343899,16343907,8,1,0,0,1
16343908,16344094,186,0,0,1,1
16343909,16343945,36,1,0,0,2
16343946,16344057,111,0,0,1,2
16344058,16344062,4,1,0,0,2
16344063,16344091,28,0,0,1,2
16344092,16344190,98,1,0,0,2
16344095,16344185,90,1,0,0,1
16344186,16344236,50,0,0,1,1
16344191,16344247,56,0,0,1,2
16344237,16344287,50,1,0,0,1
16344248,16344261,13,1,0,0,2
16344262,16344338,76,0,0,1,2
16344288,16344344,56,0,0,1,1
16344339,16344364,25,1,0,0,2
16344345,16344359,14,1,0,0,1
16344360,16344483,123,0,0,1,1
16344365,16344547,182,0,0,1,2
16344484,16344488,4,1,0,0,1
16344489,16344543,54,0,0,1,1
16344544,16344568,24,1,0,0,1
16344548,16344562,14,1,0,0,2
16344563,16346437,1874,0,0,1,2
16344569,16344964,395,0,0,1,1
16344965,16344970,5,1,0,0,1
16344971,16345238,267,0,0,1,1
16345239,16345270,31,1,0,0,1
16345271,16345465,194,0,0,1,1
16345466,16345506,40,1,0,0,1
16345507,16345627,120,0,0,1,1
16345628,16345635,7,1,0,0,1
16345636,16345753,117,0,0,1,1
16345754,16345830,76,1,0,0,1
16345831,16346129,298,0,0,1,1
16346130,16346146,16,1,0,0,1
16346147,16346399,252,0,0,1,1
16346400,16346694,294,1,0,0,1
16346438,16346714,276,1,0,0,2
16346483,16346637,154,0,1,0,1
16346486,16346662,176,0,1,0,2
16346695,16346825,130,0,0,1,1
16346715,16346823,108,0,0,1,2
16346824,16349392,2568,1,0,0,2
16346826,16346919,93,1,0,0,1
16346920,16346985,65,0,0,1,1
16346986,16347015,29,1,0,0,1
16347012,16347273,261,0,1,0,2
16347016,16348325,1309,0,0,1,1
16347329,16349281,1952,0,1,0,2
16348326,16349250,924,1,0,0,1
16348352,16349237,885,0,1,0,1
16349251,16349300,49,0,0,1,1
16349301,16349386,85,1,0,0,1
16349387,16349520,133,0,0,1,1
16349393,16349516,123,0,0,1,2
16349517,16349543,26,1,0,0,2
16349521,16350966,1445,1,0,0,1
16349544,16350961,1417,0,0,1,2
16350962,16350974,12,1,0,0,2
16350967,16350999,32,0,0,1,1
16350975,16351013,38,0,0,1,2
16351000,16351306,306,1,0,0,1
16351014,16351353,339,1,0,0,2
16351032,16351262,230,0,1,0,1
16351040,16351287,247,0,1,0,2
16351307,16351431,124,0,0,1,1
16351354,16351431,77,0,0,1,2
16351432,16351505,73,1,0,0,1
16351432,16351507,75,1,0,0,2
16351506,16351541,35,0,0,1,1
16351508,16351543,35,0,0,1,2
16351542,16351606,64,1,0,0,1
16351544,16351596,52,1,0,0,2
16351597,16351713,116,0,0,1,2
16351607,16353150,1543,0,0,1,1
16351714,16351736,22,1,0,0,2
16351737,16351977,240,0,0,1,2
16351978,16352041,63,1,0,0,2
16352042,16352249,207,0,0,1,2
16352250,16352289,39,1,0,0,2
16352290,16352360,70,0,0,1,2
16352361,16352444,83,1,0,0,2
16352445,16352564,119,0,0,1,2
16352565,16352569,4,1,0,0,2
16352570,16352692,122,0,0,1,2
16352693,16355299,2606,1,0,0,2
16352708,16355288,2580,0,1,0,2
16353151,16355279,2128,1,0,0,1
16353163,16355261,2098,0,1,0,1
16355280,16355338,58,0,0,1,1
16355300,16355338,38,0,0,1,2
16355339,16355397,58,1,0,0,1
16355339,16355404,65,1,0,0,2
16355398,16355438,40,0,0,1,1
16355405,16355438,33,0,0,1,2
16355439,16355475,36,1,0,0,1
16355439,16355476,37,1,0,0,2
16355476,16355552,76,0,0,1,1
16355477,16355554,77,0,0,1,2
16355553,16355996,443,1,0,0,1
16355555,16355593,38,1,0,0,2
16355594,16355712,118,0,0,1,2
16355713,16355732,19,1,0,0,2
16355733,16358050,2317,0,0,1,2
16355997,16356051,54,0,0,1,1
16356052,16357803,1751,1,0,0,1
16357804,16357964,160,0,0,1,1
16357965,16358196,231,1,0,0,1
16358051,16358196,145,1,0,0,2
16358197,16358280,83,0,0,1,1
16358197,16358285,88,0,0,1,2
16358281,16358328,47,1,0,0,1
16358286,16358305,19,1,0,0,2
16358306,16358402,96,0,0,1,2
16358329,16358445,116,0,0,1,1
16358403,16358454,51,1,0,0,2
16358446,16360827,2381,1,0,0,1
16358455,16358610,155,0,0,1,2
16358457,16360800,2343,0,1,0,1
16358611,16358634,23,1,0,0,2
16358635,16358726,91,0,0,1,2
16358727,16360829,2102,1,0,0,2
16358773,16358775,2,0,1,0,2
16358797,16360418,1621,0,1,0,2
16360545,16360802,257,0,1,0,2
16360828,16361066,238,0,0,1,1
16360830,16361066,236,0,0,1,2
16361067,16361137,70,1,0,0,1
16361067,16361138,71,1,0,0,2
16361138,16363175,2037,0,0,1,1
16361139,16361624,485,0,0,1,2
16361625,16361646,21,1,0,0,2
16361647,16362072,425,0,0,1,2
16362073,16362089,16,1,0,0,2
16362090,16363176,1086,0,0,1,2
16363176,16363443,267,1,0,0,1
16363177,16363471,294,1,0,0,2
16363212,16363402,190,0,1,0,1
16363217,16363441,224,0,1,0,2
16363444,16363522,78,0,0,1,1
16363472,16363521,49,0,0,1,2
16363522,16363601,79,1,0,0,2
16363523,16363588,65,1,0,0,1
16363589,16366085,2496,0,0,1,1
16363602,16363721,119,0,0,1,2
16363722,16363738,16,1,0,0,2
16363739,16366086,2347,0,0,1,2
16366086,16366135,49,1,0,0,1
16366087,16366137,50,1,0,0,2
16366136,16366225,89,0,0,1,1
16366138,16366220,82,0,0,1,2
16366221,16366243,22,1,0,0,2
16366226,16366537,311,1,0,0,1
16366244,16366271,27,0,0,1,2
16366272,16366562,290,1,0,0,2
16366283,16366521,238,0,1,0,1
16366289,16366532,243,0,1,0,2
16366538,16368217,1679,0,0,1,1
16366563,16366589,26,0,0,1,2
16366590,16366607,17,1,0,0,2
16366608,16368700,2092,0,0,1,2
16368218,16368226,8,1,0,0,1
16368227,16368691,464,0,0,1,1
16368701,16368984,283,1,0,0,2
16368702,16368913,211,0,1,0,1
16368716,16368941,225,0,1,0,2
16368923,16368969,46,1,0,0,1
16368970,16369029,59,0,0,1,1
16368985,16369030,45,0,0,1,2
16369030,16369054,24,1,0,0,1
16369031,16369055,24,1,0,0,2
16369055,16369185,130,0,0,1,1
16369056,16369181,125,0,0,1,2
16369182,16369198,16,1,0,0,2
16369186,16369205,19,1,0,0,1
16369199,16371657,2458,0,0,1,2
16369206,16369569,363,0,0,1,1
16369570,16369586,16,1,0,0,1
16369587,16371657,2070,0,0,1,1
16371658,16371753,95,1,0,0,1
16371658,16371848,190,1,0,0,2
16371754,16371794,40,0,0,1,1
16371795,16371851,56,1,0,0,1
16371849,16371911,62,0,0,1,2
16371852,16371918,66,0,0,1,1
16371912,16372195,283,1,0,0,2
16371919,16372153,234,1,0,0,1
16371955,16372125,170,0,1,0,1
16371956,16372140,184,0,1,0,2
16372154,16374112,1958,0,0,1,1
16372196,16372350,154,0,0,1,2
16372351,16372374,23,1,0,0,2
16372375,16374073,1698,0,0,1,2
16374074,16375390,1316,1,0,0,2
16374113,16375363,1250,1,0,0,1
16374154,16375352,1198,0,1,0,1
16374175,16375373,1198,0,1,0,2
16375364,16375462,98,0,0,1,1
16375391,16375422,31,0,0,1,2
16375423,16375443,20,1,0,0,2
16375444,16375468,24,0,0,1,2
16375463,16375498,35,1,0,0,1
16375469,16375485,16,1,0,0,2
16375486,16375632,146,0,0,1,2
16375499,16375640,141,0,0,1,1
16375633,16375640,7,1,0,0,2
16375641,16375709,68,0,0,1,2
16375641,16375793,152,1,0,0,1
16375710,16375841,131,1,0,0,2
16375794,16375903,109,0,0,1,1
16375842,16375901,59,0,0,1,2
16375902,16375955,53,1,0,0,2
16375904,16375928,24,1,0,0,1
16375929,16377553,1624,0,0,1,1
16375956,16377559,1603,0,0,1,2
16377554,16377879,325,1,0,0,1
16377560,16377954,394,1,0,0,2
16377670,16377844,174,0,1,0,1
16377674,16377882,208,0,1,0,2
16377880,16380091,2211,0,0,1,1
16377955,16380098,2143,0,0,1,2
16380092,16380837,745,1,0,0,1
16380099,16383818,3719,1,0,0,2
16380134,16380801,667,0,1,0,1
16380134,16380818,684,0,1,0,2
16380838,16381029,191,0,0,1,1
16380916,16380966,50,0,1,0,2
16381007,16381552,545,0,1,0,2
16381030,16381509,479,1,0,0,1
16381069,16381439,370,0,1,0,1
16381510,16381607,97,0,0,1,1
16381608,16381616,8,1,0,0,1
16381617,16381993,376,0,0,1,1
16381901,16381945,44,0,1,0,2
16381990,16383695,1705,0,1,0,2
16381994,16382003,9,1,0,0,1
16382004,16382028,24,0,0,1,1
16382029,16383673,1644,1,0,0,1
16382104,16383662,1558,0,1,0,1
16383674,16383705,31,0,0,1,1
16383706,16383712,6,1,0,0,1
16383713,16383773,60,0,0,1,1
16383774,16383798,24,1,0,0,1
16383799,16383869,70,0,0,1,1
16383819,16383869,50,0,0,1,2
16383870,16383898,28,1,0,0,1
16383870,16383905,35,1,0,0,2
16383899,16384033,134,0,0,1,1
16383906,16384031,125,0,0,1,2
16384032,16384041,9,1,0,0,2
16384034,16384054,20,1,0,0,1
16384042,16386013,1971,0,0,1,2
16384055,16384458,403,0,0,1,1
16384459,16384465,6,1,0,0,1
16384466,16386020,1554,0,0,1,1
16386014,16386231,217,1,0,0,2
16386021,16386210,189,1,0,0,1
16386045,16386195,150,0,1,0,2
16386054,16386165,111,0,1,0,1
16386211,16386328,117,0,0,1,1
16386232,16386330,98,0,0,1,2
16386329,16386354,25,1,0,0,1
16386331,16386392,61,1,0,0,2
16386355,16386540,185,0,0,1,1
16386393,16386535,142,0,0,1,2
16386536,16386551,15,1,0,0,2
16386541,16386546,5,1,0,0,1
16386547,16388428,1881,0,0,1,1
16386552,16388384,1832,0,0,1,2
16388385,16388397,12,1,0,0,2
16388398,16388426,28,0,0,1,2
16388427,16388479,52,1,0,0,2
16388429,16388511,82,1,0,0,1
16388480,16388693,213,0,0,1,2
16388512,16388547,35,0,0,1,1
16388548,16388563,15,1,0,0,1
16388564,16388610,46,0,0,1,1
16388611,16388661,50,1,0,0,1
16388662,16388690,28,0,0,1,1
16388691,16388709,18,1,0,0,1
16388694,16388705,11,1,0,0,2
16388706,16389820,1114,0,0,1,2
16388710,16389821,1111,0,0,1,1
16389821,16393758,3937,1,0,0,2
16389822,16393727,3905,1,0,0,1
16389854,16393716,3862,0,1,0,1
16389863,16393726,3863,0,1,0,2
16393728,16393906,178,0,0,1,1
16393759,16393905,146,0,0,1,2
16393906,16393975,69,1,0,0,2
16393907,16393987,80,1,0,0,1
16393976,16394117,141,0,0,1,2
16393988,16394119,131,0,0,1,1
16394118,16394139,21,1,0,0,2
16394120,16394367,247,1,0,0,1
16394140,16396470,2330,0,0,1,2
16394368,16394407,39,0,0,1,1
16394408,16394415,7,1,0,0,1
16394416,16394488,72,0,0,1,1
16394489,16394506,17,1,0,0,1
16394507,16394605,98,0,0,1,1
16394606,16394904,298,1,0,0,1
16394905,16395142,237,0,0,1,1
16395143,16395183,40,1,0,0,1
16395184,16395385,201,0,0,1,1
16395386,16395413,27,1,0,0,1
16395414,16395494,80,0,0,1,1
16395495,16395764,269,1,0,0,1
16395765,16395901,136,0,0,1,1
16395902,16395940,38,1,0,0,1
16395941,16396166,225,0,0,1,1
16396167,16396300,133,1,0,0,1
16396301,16396469,168,0,0,1,1
16396470,16396571,101,1,0,0,1
16396471,16396589,118,1,0,0,2
16396572,16396639,67,0,0,1,1
16396590,16396633,43,0,0,1,2
16396634,16396857,223,1,0,0,2
16396640,16396845,205,1,0,0,1
16396670,16396806,136,0,1,0,1
16396672,16396812,140,0,1,0,2
16396846,16396952,106,0,0,1,1
16396858,16396947,89,0,0,1,2
16396948,16396977,29,1,0,0,2
16396953,16396970,17,1,0,0,1
16396971,16398747,1776,0,0,1,1
16396978,16397018,40,0,0,1,2
16397019,16397060,41,1,0,0,2
16397061,16397130,69,0,0,1,2
16397131,16397193,62,1,0,0,2
16397194,16398394,1200,0,0,1,2
16398395,16398408,13,1,0,0,2
16398409,16398748,339,0,0,1,2
16398748,16398877,129,1,0,0,1
16398749,16398880,131,1,0,0,2
16398878,16398933,55,0,0,1,1
16398881,16398931,50,0,0,1,2
16398932,16398987,55,1,0,0,2
16398934,16398971,37,1,0,0,1
16398972,16399073,101,0,0,1,1
16398988,16399077,89,0,0,1,2
16399074,16399103,29,1,0,0,1
16399078,16401453,2375,1,0,0,2
16399104,16399869,765,0,0,1,1
16399774,16400227,453,0,1,0,2
16399870,16399953,83,1,0,0,1
16399954,16400870,916,0,0,1,1
16400352,16400361,9,0,1,0,2
16400763,16400795,32,0,1,0,2
16400818,16400846,28,0,1,0,2
16400871,16401189,318,1,0,0,1
16400888,16401166,278,0,1,0,2
16400957,16401119,162,0,1,0,1
16401190,16401217,27,0,0,1,1
16401203,16401278,75,0,1,0,2
16401218,16401240,22,1,0,0,1
16401241,16403101,1860,0,0,1,1
16401454,16401547,93,0,0,1,2
16401548,16401643,95,1,0,0,2
16401644,16402870,1226,0,0,1,2
16402871,16402875,4,1,0,0,2
16402876,16403092,216,0,0,1,2
16403093,16403328,235,1,0,0,2
16403102,16403329,227,1,0,0,1
16403118,16403286,168,0,1,0,2
16403130,16403269,139,0,1,0,1
16403329,16403361,32,0,0,1,2
16403330,16403434,104,0,0,1,1
16403362,16403367,5,1,0,0,2
16403368,16403434,66,0,0,1,2
16403435,16403463,28,1,0,0,1
16403435,16403471,36,1,0,0,2
16403464,16405488,2024,0,0,1,1
16403472,16403596,124,0,0,1,2
16403597,16403614,17,1,0,0,2
16403615,16405478,1863,0,0,1,2
16405479,16405625,146,1,0,0,2
16405489,16405607,118,1,0,0,1
16405608,16405683,75,0,0,1,1
16405626,16405680,54,0,0,1,2
16405681,16405723,42,1,0,0,2
16405684,16405721,37,1,0,0,1
16405722,16405782,60,0,0,1,1
16405724,16405781,57,0,0,1,2
16405782,16408067,2285,1,0,0,2
16405783,16405800,17,1,0,0,1
16405801,16406390,589,0,0,1,1
16405861,16408056,2195,0,1,0,2
16406401,16407995,1594,0,1,0,1
16408005,16408066,61,1,0,0,1
16408067,16408122,55,0,0,1,1
16408068,16408409,341,0,0,1,2
16408123,16408211,88,1,0,0,1
16408212,16408243,31,0,0,1,1
16408244,16408251,7,1,0,0,1
16408252,16408546,294,0,0,1,1
16408410,16408425,15,1,0,0,2
16408426,16408763,337,0,0,1,2
16408547,16408568,21,1,0,0,1
16408569,16409869,1300,0,0,1,1
16408764,16408799,35,1,0,0,2
16408800,16408996,196,0,0,1,2
16408997,16409047,50,1,0,0,2
16409048,16409199,151,0,0,1,2
16409200,16409232,32,1,0,0,2
16409233,16409823,590,0,0,1,2
16409824,16409890,66,1,0,0,2
16409870,16409874,4,1,0,0,1
16409875,16409956,81,0,0,1,1
16409891,16409920,29,0,0,1,2
16409921,16409934,13,1,0,0,2
16409935,16409984,49,0,0,1,2
16409957,16410015,58,1,0,0,1
16409985,16410602,617,1,0,0,2
16409996,16410030,34,0,1,0,2
16410016,16410047,31,0,0,1,1
16410048,16410092,44,1,0,0,1
16410065,16410076,11,0,1,0,2
16410093,16410187,94,0,0,1,1
16410099,16410572,473,0,1,0,2
16410188,16410576,388,1,0,0,1
16410232,16410474,242,0,1,0,1
16410577,16410810,233,0,0,1,1
16410603,16410630,27,0,0,1,2
16410631,16411424,793,1,0,0,2
16410811,16410891,80,1,0,0,1
16410892,16410932,40,0,0,1,1
16410933,16411115,182,1,0,0,1
16411116,16411186,70,0,0,1,1
16411187,16411205,18,1,0,0,1
16411206,16411238,32,0,0,1,1
16411239,16411255,16,1,0,0,1
16411256,16411404,148,0,0,1,1
16411405,16411409,4,1,0,0,1
16411410,16412864,1454,0,0,1,1
16411425,16411495,70,0,0,1,2
16411496,16411797,301,1,0,0,2
16411798,16412031,233,0,0,1,2
16412032,16412109,77,1,0,0,2
16412110,16412311,201,0,0,1,2
16412312,16412321,9,1,0,0,2
16412322,16412662,340,0,0,1,2
16412663,16412678,15,1,0,0,2
16412679,16412774,95,0,0,1,2
16412775,16413190,415,1,0,0,2
16412865,16413159,294,1,0,0,1
16412949,16413138,189,0,1,0,2
16412952,16413124,172,0,1,0,1
16413160,16413304,144,0,0,1,1
16413191,16413307,116,0,0,1,2
16413305,16413367,62,1,0,0,1
16413308,16413327,19,1,0,0,2
16413328,16414881,1553,0,0,1,2
16413368,16414276,908,0,0,1,1
16414277,16414323,46,1,0,0,1
16414324,16414880,556,0,0,1,1
16414881,16414981,100,1,0,0,1
16414882,16414971,89,1,0,0,2
16414972,16415072,100,0,0,1,2
16414982,16415030,48,0,0,1,1
16415031,16415564,533,1,0,0,1
16415073,16415614,541,1,0,0,2
16415110,16415552,442,0,1,0,1
16415116,16415558,442,0,1,0,2
16415565,16415642,77,0,0,1,1
16415615,16415644,29,0,0,1,2
16415643,16415700,57,1,0,0,1
16415645,16415702,57,1,0,0,2
16415701,16415774,73,0,0,1,1
16415703,16415771,68,0,0,1,2
16415772,16415825,53,1,0,0,2
16415775,16415839,64,1,0,0,1
16415826,16415906,80,0,0,1,2
16415840,16416054,214,0,0,1,1
16415907,16415925,18,1,0,0,2
16415926,16416046,120,0,0,1,2
16416047,16416089,42,1,0,0,2
16416055,16416070,15,1,0,0,1
16416071,16417949,1878,0,0,1,1
16416090,16417277,1187,0,0,1,2
16417278,16418886,1608,1,0,0,2
16417632,16418876,1244,0,1,0,2
16417950,16418889,939,1,0,0,1
16418006,16418879,873,0,1,0,1
16418887,16419066,179,0,0,1,2
16418890,16419066,176,0,0,1,1
16419067,16419144,77,1,0,0,2
16419067,16419145,78,1,0,0,1
16419145,16419224,79,0,0,1,2
16419146,16419223,77,0,0,1,1
16419224,16419261,37,1,0,0,1
16419225,16419270,45,1,0,0,2
16419262,16419514,252,0,0,1,1
16419271,16419509,238,0,0,1,2
16419510,16419528,18,1,0,0,2
16419515,16419527,12,1,0,0,1
16419528,16421116,1588,0,0,1,1
16419529,16419670,141,0,0,1,2
16419671,16419686,15,1,0,0,2
16419687,16420913,1226,0,0,1,2
16420914,16420931,17,1,0,0,2
16420932,16421083,151,0,0,1,2
16421084,16421408,324,1,0,0,2
16421117,16421369,252,1,0,0,1
16421133,16421361,228,0,1,0,2
16421145,16421323,178,0,1,0,1
16421370,16421390,20,0,0,1,1
16421391,16421409,18,1,0,0,1
16421409,16421570,161,0,0,1,2
16421410,16421570,160,0,0,1,1
16421571,16421611,40,1,0,0,2
16421571,16421612,41,1,0,0,1
16421612,16421713,101,0,0,1,2
16421613,16421706,93,0,0,1,1
16421707,16421755,48,1,0,0,1
16421714,16421769,55,1,0,0,2
16421756,16421859,103,0,0,1,1
16421770,16421856,86,0,0,1,2
16421857,16422038,181,1,0,0,2
16421860,16421873,13,1,0,0,1
16421874,16423109,1235,0,0,1,1
16422039,16422220,181,0,0,1,2
16422221,16422311,90,1,0,0,2
16422312,16423007,695,0,0,1,2
16423008,16423023,15,1,0,0,2
16423024,16423515,491,0,0,1,2
16423110,16423114,4,1,0,0,1
16423115,16423514,399,0,0,1,1
16423515,16423593,78,1,0,0,1
16423516,16423532,16,1,0,0,2
16423533,16423574,41,0,0,1,2
16423575,16423582,7,1,0,0,2
16423583,16423711,128,0,0,1,2
16423594,16423737,143,0,0,1,1
16423712,16423770,58,1,0,0,2
16423738,16423768,30,1,0,0,1
16423769,16423893,124,0,0,1,1
16423771,16423893,122,0,0,1,2
16423894,16423989,95,1,0,0,1
16423894,16424006,112,1,0,0,2
16423990,16424181,191,0,0,1,1
16424007,16424037,30,0,0,1,2
16424038,16424043,5,1,0,0,2
16424044,16424188,144,0,0,1,2
16424182,16424197,15,1,0,0,1
16424189,16424200,11,1,0,0,2
16424198,16424230,32,0,0,1,1
16424201,16424232,31,0,0,1,2
16424231,16424428,197,1,0,0,1
16424233,16424437,204,1,0,0,2
16424266,16424389,123,0,1,0,1
16424266,16424404,138,0,1,0,2
16424429,16424535,106,0,0,1,1
16424438,16424535,97,0,0,1,2
16424536,16424554,18,1,0,0,1
16424536,16424561,25,1,0,0,2
16424555,16424704,149,0,0,1,1
16424562,16424700,138,0,0,1,2
16424701,16424715,14,1,0,0,2
16424705,16424709,4,1,0,0,1
16424710,16427144,2434,0,0,1,1
16424716,16424938,222,0,0,1,2
16424939,16425009,70,1,0,0,2
16425010,16425402,392,0,0,1,2
16425403,16425407,4,1,0,0,2
16425408,16425775,367,0,0,1,2
16425776,16425813,37,1,0,0,2
16425814,16426601,787,0,0,1,2
16426602,16426611,9,1,0,0,2
16426612,16427144,532,0,0,1,2
16427145,16427362,217,1,0,0,1
16427145,16427467,322,1,0,0,2
16427186,16427353,167,0,1,0,2
16427189,16427312,123,0,1,0,1
16427363,16427444,81,0,0,1,1
16427445,16427468,23,1,0,0,1
16427468,16428853,1385,0,0,1,2
16427469,16427701,232,0,0,1,1
16427702,16427720,18,1,0,0,1
16427721,16428470,749,0,0,1,1
16428481,16532167,103686,0,1,0,1
16428864,16531952,103088,0,1,0,2
16531962,16532047,85,1,0,0,2
16532048,16532176,128,0,0,1,2
16532177,16532348,171,1,0,0,1
16532177,16532349,172,1,0,0,2
16532207,16532297,90,0,1,0,1
16532214,16532294,80,0,1,0,2
16532349,16532702,353,0,0,1,1
16532350,16532701,351,0,0,1,2
16532702,16532768,66,1,0,0,2
16532703,16532768,65,1,0,0,1
16532769,16532988,219,0,0,1,2
16532769,16532989,220,0,0,1,1
16532989,16533063,74,1,0,0,2
16532990,16533040,50,1,0,0,1
16533041,16533336,295,0,0,1,1
16533064,16533335,271,0,0,1,2
16533336,16533421,85,1,0,0,2
16533337,16533414,77,1,0,0,1
16533415,16533575,160,0,0,1,1
16533422,16533476,54,0,0,1,2
16533477,16533492,15,1,0,0,2
16533493,16533575,82,0,0,1,2
16533576,16533834,258,1,0,0,1
16533576,16533892,316,1,0,0,2
16533603,16533844,241,0,1,0,2
16533605,16533803,198,0,1,0,1
16533835,16534000,165,0,0,1,1
16533893,16534000,107,0,0,1,2
16534001,16534064,63,1,0,0,2
16534001,16534065,64,1,0,0,1
16534065,16534593,528,0,0,1,2
16534066,16534594,528,0,0,1,1
16534594,16534698,104,1,0,0,2
16534595,16534688,93,1,0,0,1
16534689,16534844,155,0,0,1,1
16534699,16534847,148,0,0,1,2
16534845,16534927,82,1,0,0,1
16534848,16534939,91,1,0,0,2
16534928,16535048,120,0,0,1,1
16534940,16535043,103,0,0,1,2
16535044,16535331,287,1,0,0,2
16535049,16535271,222,1,0,0,1
16535077,16535234,157,0,1,0,1
16535079,16535273,194,0,1,0,2
16535272,16535368,96,0,0,1,1
16535332,16535370,38,0,0,1,2
16535369,16535395,26,1,0,0,1
16535371,16535394,23,1,0,0,2
16535395,16537505,2110,0,0,1,2
16535396,16537507,2111,0,0,1,1
16537506,16537560,54,1,0,0,2
16537508,16537558,50,1,0,0,1
16537559,16539532,1973,0,0,1,1
16537561,16539542,1981,0,0,1,2
16539533,16539796,263,1,0,0,1
16539543,16539815,272,1,0,0,2
16539561,16539769,208,0,1,0,2
16539563,16539751,188,0,1,0,1
16539797,16541102,1305,0,0,1,1
16539816,16541102,1286,0,0,1,2
16541103,16541168,65,1,0,0,1
16541103,16541434,331,1,0,0,2
16541169,16541300,131,0,0,1,1
16541301,16541316,15,1,0,0,1
16541317,16541514,197,0,0,1,1
16541435,16541513,78,0,0,1,2
16541514,16541554,40,1,0,0,2
16541515,16541532,17,1,0,0,1
16541533,16542978,1445,0,0,1,1
16541555,16542978,1423,0,0,1,2
16542979,16543030,51,1,0,0,2
16542979,16543036,57,1,0,0,1
16543031,16543516,485,0,0,1,2
16543037,16545451,2414,0,0,1,1
16543517,16543522,5,1,0,0,2
16543523,16543743,220,0,0,1,2
16543744,16543762,18,1,0,0,2
16543763,16545004,1241,0,0,1,2
16545005,16545041,36,1,0,0,2
16545042,16545450,408,0,0,1,2
16545451,16545693,242,1,0,0,2
16545452,16545647,195,1,0,0,1
16545468,16545640,172,0,1,0,2
16545478,16545607,129,0,1,0,1
16545648,16546193,545,0,0,1,1
16545694,16546193,499,0,0,1,2
16546194,16546242,48,1,0,0,1
16546194,16546252,58,1,0,0,2
16546243,16546358,115,0,0,1,1
16546253,16546361,108,0,0,1,2
16546359,16546378,19,1,0,0,1
16546362,16546411,49,1,0,0,2
16546379,16548411,2032,0,0,1,1
16546412,16548410,1998,0,0,1,2
16548411,16548467,56,1,0,0,2
16548412,16548467,55,1,0,0,1
16548468,16548654,186,0,0,1,1
16548468,16548657,189,0,0,1,2
16548655,16548669,14,1,0,0,1
16548658,16548673,15,1,0,0,2
16548670,16550328,1658,0,0,1,1
16548674,16550337,1663,0,0,1,2
16550329,16550855,526,1,0,0,1
16550338,16550894,556,1,0,0,2
16550360,16550584,224,0,1,0,1
16550361,16550605,244,0,1,0,2
16550647,16550838,191,0,1,0,2
16550651,16550817,166,0,1,0,1
16550856,16552239,1383,0,0,1,1
16550895,16552240,1345,0,0,1,2
16552240,16552302,62,1,0,0,1
16552241,16552304,63,1,0,0,2
16552303,16554121,1818,0,0,1,1
16552305,16554123,1818,0,0,1,2
16554122,16554166,44,1,0,0,1
16554124,16554165,41,1,0,0,2
16554166,16556182,2016,0,0,1,2
16554167,16556173,2006,0,0,1,1
16556174,16556429,255,1,0,0,1
16556183,16556698,515,1,0,0,2
16556202,16556395,193,0,1,0,1
16556204,16556422,218,0,1,0,2
16556430,16556457,27,0,0,1,1
16556458,16556679,221,1,0,0,1
16556471,16556641,170,0,1,0,1
16556472,16556667,195,0,1,0,2
16556680,16557576,896,0,0,1,1
16556699,16557575,876,0,0,1,2
16557576,16557617,41,1,0,0,2
16557577,16557618,41,1,0,0,1
16557618,16557737,119,0,0,1,2
16557619,16559308,1689,0,0,1,1
16557738,16557753,15,1,0,0,2
16557754,16559307,1553,0,0,1,2
16559308,16559354,46,1,0,0,2
16559309,16559359,50,1,0,0,1
16559355,16561448,2093,0,0,1,2
16559360,16561437,2077,0,0,1,1
16561438,16561683,245,1,0,0,1
16561449,16561724,275,1,0,0,2
16561471,16561650,179,0,1,0,1
16561474,16561670,196,0,1,0,2
16561684,16562421,737,0,0,1,1
16561725,16562422,697,0,0,1,2
16562422,16562481,59,1,0,0,1
16562423,16562476,53,1,0,0,2
16562477,16562592,115,0,0,1,2
16562482,16562588,106,0,0,1,1
16562589,16562606,17,1,0,0,1
16562593,16562607,14,1,0,0,2
16562607,16564626,2019,0,0,1,1
16562608,16564060,1452,0,0,1,2
16564061,16564077,16,1,0,0,2
16564078,16564627,549,0,0,1,2
16564627,16564677,50,1,0,0,1
16564628,16564677,49,1,0,0,2
16564678,16565134,456,0,0,1,1
16564678,16566589,1911,0,0,1,2
16565135,16565143,8,1,0,0,1
16565144,16566589,1445,0,0,1,1
16566590,16567179,589,1,0,0,1
16566590,16567695,1105,1,0,0,2
16566618,16567168,550,0,1,0,1
16566629,16567217,588,0,1,0,2
16567180,16567255,75,0,0,1,1
16567256,16567639,383,1,0,0,1
16567270,16567680,410,0,1,0,2
16567278,16567397,119,0,1,0,1
16567476,16567602,126,0,1,0,1
16567640,16567875,235,0,0,1,1
16567696,16567877,181,0,0,1,2
16567876,16567929,53,1,0,0,1
16567878,16567929,51,1,0,0,2
16567930,16568457,527,0,0,1,1
16567930,16568458,528,0,0,1,2
16568458,16568551,93,1,0,0,1
16568459,16568520,61,1,0,0,2
16568521,16568645,124,0,0,1,2
16568552,16568644,92,0,0,1,1
16568645,16568664,19,1,0,0,1
16568646,16568666,20,1,0,0,2
16568665,16570359,1694,0,0,1,1
16568667,16570358,1691,0,0,1,2
16570359,16570417,58,1,0,0,2
16570360,16570418,58,1,0,0,1
16570418,16570635,217,0,0,1,2
16570419,16570626,207,0,0,1,1
16570627,16570640,13,1,0,0,1
16570636,16570642,6,1,0,0,2
16570641,16572324,1683,0,0,1,1
16570643,16572341,1698,0,0,1,2
16572325,16572576,251,1,0,0,1
16572342,16572593,251,1,0,0,2
16572366,16572539,173,0,1,0,1
16572370,16572554,184,0,1,0,2
16572577,16572933,356,0,0,1,1
16572594,16572933,339,0,0,1,2
16572934,16572981,47,1,0,0,1
16572934,16572982,48,1,0,0,2
16572982,16573738,756,0,0,1,1
16572983,16573739,756,0,0,1,2
16573739,16573871,132,1,0,0,1
16573740,16573807,67,1,0,0,2
16573808,16573930,122,0,0,1,2
16573872,16574693,821,0,0,1,1
16573931,16573942,11,1,0,0,2
16573943,16575089,1146,0,0,1,2
16574694,16574698,4,1,0,0,1
16574699,16575102,403,0,0,1,1
16575090,16575312,222,1,0,0,2
16575103,16575286,183,1,0,0,1
16575123,16575244,121,0,1,0,1
16575124,16575275,151,0,1,0,2
16575287,16575550,263,0,0,1,1
16575313,16575548,235,0,0,1,2
16575549,16575591,42,1,0,0,2
16575551,16575615,64,1,0,0,1
16575592,16577719,2127,0,0,1,2
16575616,16576183,567,0,0,1,1
16576184,16576198,14,1,0,0,1
16576199,16576356,157,0,0,1,1
16576357,16576367,10,1,0,0,1
16576368,16576507,139,0,0,1,1
16576508,16576523,15,1,0,0,1
16576524,16576911,387,0,0,1,1
16576912,16576978,66,1,0,0,1
16576979,16577723,744,0,0,1,1
16577720,16577973,253,1,0,0,2
16577724,16577945,221,1,0,0,1
16577754,16577930,176,0,1,0,2
16577756,16577908,152,0,1,0,1
16577946,16578932,986,0,0,1,1
16577974,16578137,163,0,0,1,2
16578138,16578173,35,1,0,0,2
16578174,16578511,337,0,0,1,2
16578512,16578593,81,1,0,0,2
16578594,16578930,336,0,0,1,2
16578931,16578967,36,1,0,0,2
16578933,16578979,46,1,0,0,1
16578968,16579410,442,0,0,1,2
16578980,16579181,201,0,0,1,1
16579182,16579223,41,1,0,0,1
16579224,16580702,1478,0,0,1,1
16579411,16579426,15,1,0,0,2
16579427,16580701,1274,0,0,1,2
16580702,16580741,39,1,0,0,2
16580703,16580805,102,1,0,0,1
16580742,16582688,1946,0,0,1,2
16580806,16580888,82,0,0,1,1
16580889,16580944,55,1,0,0,1
16580945,16581108,163,0,0,1,1
16581109,16581320,211,1,0,0,1
16581321,16581446,125,0,0,1,1
16581447,16581460,13,1,0,0,1
16581461,16581659,198,0,0,1,1
16581660,16581831,171,1,0,0,1
16581832,16581948,116,0,0,1,1
16581949,16582564,615,1,0,0,1
16582565,16582619,54,0,0,1,1
16582620,16582944,324,1,0,0,1
16582689,16583001,312,1,0,0,2
16582730,16582885,155,0,1,0,1
16582733,16582916,183,0,1,0,2
16582945,16583030,85,0,0,1,1
16583002,16583040,38,0,0,1,2
16583031,16583243,212,1,0,0,1
16583041,16583257,216,1,0,0,2
16583063,16583196,133,0,1,0,1
16583065,16583221,156,0,1,0,2
16583244,16583325,81,0,0,1,1
16583258,16584374,1116,0,0,1,2
16583326,16583364,38,1,0,0,1
16583365,16584373,1008,0,0,1,1
16584374,16584398,24,1,0,0,1
16584375,16584415,40,1,0,0,2
16584399,16586259,1860,0,0,1,1
16584416,16586260,1844,0,0,1,2
16586260,16586323,63,1,0,0,1
16586261,16586322,61,1,0,0,2
16586323,16588254,1931,0,0,1,2
16586324,16588252,1928,0,0,1,1
16588253,16588945,692,1,0,0,1
16588255,16588998,743,1,0,0,2
16588276,16588934,658,0,1,0,1
16588289,16588984,695,0,1,0,2
16588946,16589045,99,0,0,1,1
16588999,16589027,28,0,0,1,2
16589028,16589278,250,1,0,0,2
16589046,16589230,184,1,0,0,1
16589058,16589228,170,0,1,0,2
16589065,16589185,120,0,1,0,1
16589231,16589732,501,0,0,1,1
16589279,16589731,452,0,0,1,2
16589732,16589800,68,1,0,0,2
16589733,16589815,82,1,0,0,1
16589801,16589919,118,0,0,1,2
16589816,16589920,104,0,0,1,1
16589920,16589963,43,1,0,0,2
16589921,16589979,58,1,0,0,1
16589964,16590090,126,0,0,1,2
16589980,16591893,1913,0,0,1,1
16590091,16590100,9,1,0,0,2
16590101,16592264,2163,0,0,1,2
16591894,16591909,15,1,0,0,1
16591910,16592265,355,0,0,1,1
16592265,16592328,63,1,0,0,2
16592266,16592316,50,1,0,0,1
16592317,16592471,154,0,0,1,1
16592329,16594268,1939,0,0,1,2
16592472,16592485,13,1,0,0,1
16592486,16594274,1788,0,0,1,1
16594269,16594564,295,1,0,0,2
16594275,16594507,232,1,0,0,1
16594300,16594473,173,0,1,0,1
16594300,16594496,196,0,1,0,2
16594508,16594743,235,0,0,1,1
16594565,16594616,51,0,0,1,2
16594617,16594669,52,1,0,0,2
16594670,16594743,73,0,0,1,2
16594744,16594783,39,1,0,0,2
16594744,16594788,44,1,0,0,1
16594784,16596022,1238,0,0,1,2
16594789,16596022,1233,0,0,1,1
16596023,16596096,73,1,0,0,1
16596023,16596121,98,1,0,0,2
16596097,16596212,115,0,0,1,1
16596122,16596210,88,0,0,1,2
16596211,16596239,28,1,0,0,2
16596213,16596235,22,1,0,0,1
16596236,16598576,2340,0,0,1,1
16596240,16598577,2337,0,0,1,2
16598577,16598617,40,1,0,0,1
16598578,16598630,52,1,0,0,2
16598618,16600713,2095,0,0,1,1
16598631,16599095,464,0,0,1,2
16599096,16599167,71,1,0,0,2
16599168,16599265,97,0,0,1,2
16599266,16599311,45,1,0,0,2
16599312,16599443,131,0,0,1,2
16599444,16599488,44,1,0,0,2
16599489,16600107,618,0,0,1,2
16600108,16600128,20,1,0,0,2
16600129,16600722,593,0,0,1,2
16600714,16601114,400,1,0,0,1
16600723,16601143,420,1,0,0,2
16600740,16601035,295,0,1,0,1
16600747,16601119,372,0,1,0,2
16601115,16601255,140,0,0,1,1
16601144,16601256,112,0,0,1,2
16601256,16601307,51,1,0,0,1
16601257,16601309,52,1,0,0,2
16601308,16602500,1192,0,0,1,1
16601310,16602501,1191,0,0,1,2
16602501,16602561,60,1,0,0,1
16602502,16602560,58,1,0,0,2
16602561,16602659,98,0,0,1,2
16602562,16602660,98,0,0,1,1
16602660,16602684,24,1,0,0,2
16602661,16602683,22,1,0,0,1
16602684,16605210,2526,0,0,1,1
16602685,16605209,2524,0,0,1,2
16605210,16605260,50,1,0,0,2
16605211,16605264,53,1,0,0,1
16605261,16607138,1877,0,0,1,2
16605265,16607156,1891,0,0,1,1
16607139,16608820,1681,1,0,0,2
16607157,16608216,1059,1,0,0,1
16607187,16608242,1055,0,1,0,2
16607189,16608206,1017,0,1,0,1
16608217,16608264,47,0,0,1,1
16608265,16608767,502,1,0,0,1
16608279,16608799,520,0,1,0,2
16608281,16608507,226,0,1,0,1
16608528,16608730,202,0,1,0,1
16608768,16608878,110,0,0,1,1
16608821,16608876,55,0,0,1,2
16608877,16608901,24,1,0,0,2
16608879,16608902,23,1,0,0,1
16608902,16611494,2592,0,0,1,2
16608903,16611496,2593,0,0,1,1
16611495,16611563,68,1,0,0,2
16611497,16611554,57,1,0,0,1
16611555,16613574,2019,0,0,1,1
16611564,16611905,341,0,0,1,2
16611906,16611980,74,1,0,0,2
16611981,16612055,74,0,0,1,2
16612056,16612092,36,1,0,0,2
16612093,16612293,200,0,0,1,2
16612294,16612509,215,1,0,0,2
16612510,16612754,244,0,0,1,2
16612755,16612942,187,1,0,0,2
16612943,16613060,117,0,0,1,2
16613061,16613139,78,1,0,0,2
16613140,16613244,104,0,0,1,2
16613245,16613412,167,1,0,0,2
16613413,16613505,92,0,0,1,2
16613506,16613529,23,1,0,0,2
16613530,16613585,55,0,0,1,2
16613575,16613859,284,1,0,0,1
16613586,16613946,360,1,0,0,2
16613600,16613799,199,0,1,0,1
16613605,16613841,236,0,1,0,2
16613860,16613883,23,0,0,1,1
16613884,16613888,4,1,0,0,1
16613889,16613926,37,0,0,1,1
16613927,16613934,7,1,0,0,1
16613935,16614385,450,0,0,1,1
16613947,16614068,121,0,0,1,2
16614069,16614099,30,1,0,0,2
16614100,16614264,164,0,0,1,2
16614265,16614360,95,1,0,0,2
16614361,16614406,45,0,0,1,2
16614386,16614460,74,1,0,0,1
16614407,16614464,57,1,0,0,2
16614461,16615448,987,0,0,1,1
16614465,16615163,698,0,0,1,2
16615164,16615179,15,1,0,0,2
16615180,16615449,269,0,0,1,2
16615449,16615519,70,1,0,0,1
16615450,16615523,73,1,0,0,2
16615520,16615653,133,0,0,1,1
16615524,16615642,118,0,0,1,2
16615643,16615671,28,1,0,0,2
16615654,16615665,11,1,0,0,1
16615666,16615822,156,0,0,1,1
16615672,16615828,156,0,0,1,2
16615823,16615837,14,1,0,0,1
16615829,16615849,20,1,0,0,2
16615838,16618056,2218,0,0,1,1
16615850,16615916,66,0,0,1,2
16615917,16615921,4,1,0,0,2
16615922,16616296,374,0,0,1,2
16616297,16616321,24,1,0,0,2
16616322,16616468,146,0,0,1,2
16616469,16616483,14,1,0,0,2
16616484,16616595,111,0,0,1,2
16616596,16616607,11,1,0,0,2
16616608,16616654,46,0,0,1,2
16616655,16616667,12,1,0,0,2
16616668,16618427,1759,0,0,1,2
16618057,16618065,8,1,0,0,1
16618066,16618693,627,0,0,1,1
16618428,16618444,16,1,0,0,2
16618445,16618690,245,0,0,1,2
16618691,16618985,294,1,0,0,2
16618694,16618755,61,1,0,0,1
16618756,16619360,604,0,0,1,1
16618986,16619090,104,0,0,1,2
16619091,16619290,199,1,0,0,2
16619291,16619431,140,0,0,1,2
16619361,16619396,35,1,0,0,1
16619397,16620532,1135,0,0,1,1
16619432,16619551,119,1,0,0,2
16619552,16619611,59,0,0,1,2
16619612,16619781,169,1,0,0,2
16619782,16619805,23,0,0,1,2
16619806,16619915,109,1,0,0,2
16619916,16619949,33,0,0,1,2
16619950,16620154,204,1,0,0,2
16620155,16620215,60,0,0,1,2
16620216,16620340,124,1,0,0,2
16620341,16620444,103,0,0,1,2
16620445,16621969,1524,1,0,0,2
16620533,16621926,1393,1,0,0,1
16620580,16621886,1306,0,1,0,1
16620589,16621932,1343,0,1,0,2
16621927,16621997,70,0,0,1,1
16621970,16621994,24,0,0,1,2
16621995,16622086,91,1,0,0,2
16621998,16622086,88,1,0,0,1
16622087,16622272,185,0,0,1,1
16622087,16622272,185,0,0,1,2
16622273,16622342,69,1,0,0,1
16622273,16622345,72,1,0,0,2
16622343,16622463,120,0,0,1,1
16622346,16622467,121,0,0,1,2
16622464,16622530,66,1,0,0,1
16622468,16622532,64,1,0,0,2
16622531,16622581,50,0,0,1,1
16622533,16622581,48,0,0,1,2
16622582,16622669,87,1,0,0,2
16622582,16622686,104,1,0,0,1
16622670,16622740,70,0,0,1,2
16622687,16622781,94,0,0,1,1
16622741,16622820,79,1,0,0,2
16622782,16622816,34,1,0,0,1
16622817,16623367,550,0,0,1,1
16622821,16622878,57,0,0,1,2
16622879,16622975,96,1,0,0,2
16622976,16623118,142,0,0,1,2
16623119,16623137,18,1,0,0,2
16623138,16623252,114,0,0,1,2
16623253,16623261,8,1,0,0,2
16623262,16623361,99,0,0,1,2
16623362,16623616,254,1,0,0,2
16623368,16623636,268,1,0,0,1
16623400,16623526,126,0,1,0,2
16623400,16623534,134,0,1,0,1
16623617,16623832,215,0,0,1,2
16623637,16625821,2184,0,0,1,1
16623833,16623864,31,1,0,0,2
16623865,16623900,35,0,0,1,2
16623901,16623981,80,1,0,0,2
16623982,16624102,120,0,0,1,2
16624103,16624119,16,1,0,0,2
16624120,16624225,105,0,0,1,2
16624226,16624241,15,1,0,0,2
16624242,16624275,33,0,0,1,2
16624276,16624419,143,1,0,0,2
16624420,16625821,1401,0,0,1,2
16625822,16625883,61,1,0,0,1
16625822,16625886,64,1,0,0,2
16625884,16628695,2811,0,0,1,1
16625887,16627196,1309,0,0,1,2
16627197,16627211,14,1,0,0,2
16627212,16627310,98,0,0,1,2
16627311,16627325,14,1,0,0,2
16627326,16628705,1379,0,0,1,2
16628696,16628960,264,1,0,0,1
16628706,16628962,256,1,0,0,2
16628742,16628908,166,0,1,0,1
16628750,16628926,176,0,1,0,2
16628961,16628990,29,0,0,1,1
16628963,16629130,167,0,0,1,2
16628991,16629029,38,1,0,0,1
16629030,16629129,99,0,0,1,1
16629130,16629206,76,1,0,0,1
16629131,16629203,72,1,0,0,2
16629204,16629314,110,0,0,1,2
16629207,16629312,105,0,0,1,1
16629313,16629334,21,1,0,0,1
16629315,16629338,23,1,0,0,2
16629335,16629668,333,0,0,1,1
16629339,16629666,327,0,0,1,2
16629667,16630159,492,1,0,0,2
16629669,16630115,446,1,0,0,1
16629703,16630148,445,0,1,0,2
16629706,16629900,194,0,1,0,1
16629955,16630082,127,0,1,0,1
16630116,16630205,89,0,0,1,1
16630160,16630203,43,0,0,1,2
16630204,16630303,99,1,0,0,2
16630206,16630278,72,1,0,0,1
16630279,16630401,122,0,0,1,1
16630304,16630400,96,0,0,1,2
16630401,16630427,26,1,0,0,2
16630402,16630444,42,1,0,0,1
16630428,16632087,1659,0,0,1,2
16630445,16632539,2094,0,0,1,1
16632088,16632110,22,1,0,0,2
16632111,16632536,425,0,0,1,2
16632537,16632597,60,1,0,0,2
16632540,16632601,61,1,0,0,1
16632598,16634532,1934,0,0,1,2
16632602,16632759,157,0,0,1,1
16632760,16632769,9,1,0,0,1
16632770,16634525,1755,0,0,1,1
16634526,16634982,456,1,0,0,1
16634533,16635023,490,1,0,0,2
16634565,16634971,406,0,1,0,1
16634568,16635012,444,0,1,0,2
16634983,16635118,135,0,0,1,1
16635024,16635126,102,0,0,1,2
16635119,16635339,220,1,0,0,1
16635127,16635386,259,1,0,0,2
16635154,16635313,159,0,1,0,1
16635154,16635346,192,0,1,0,2
16635340,16635763,423,0,0,1,1
16635387,16635765,378,0,0,1,2
16635764,16635809,45,1,0,0,1
16635766,16635810,44,1,0,0,2
16635810,16636032,222,0,0,1,1
16635811,16636035,224,0,0,1,2
16636033,16636090,57,1,0,0,1
16636036,16636092,56,1,0,0,2
16636091,16636193,102,0,0,1,1
16636093,16636193,100,0,0,1,2
16636194,16636235,41,1,0,0,1
16636194,16636245,51,1,0,0,2
16636236,16638870,2634,0,0,1,1
16636246,16638871,2625,0,0,1,2
16638871,16638931,60,1,0,0,1
16638872,16638935,63,1,0,0,2
16638932,16638998,66,0,0,1,1
16638936,16639001,65,0,0,1,2
16638999,16639195,196,1,0,0,1
16639002,16639225,223,1,0,0,2
16639030,16639185,155,0,1,0,2
16639031,16639157,126,0,1,0,1
16639196,16639621,425,0,0,1,1
16639226,16641052,1826,0,0,1,2
16639622,16639636,14,1,0,0,1
16639637,16641031,1394,0,0,1,1
16641032,16641702,670,1,0,0,1
16641053,16641763,710,1,0,0,2
16641069,16641691,622,0,1,0,1
16641079,16641738,659,0,1,0,2
16641703,16641848,145,0,0,1,1
16641764,16641840,76,0,0,1,2
16641841,16642073,232,1,0,0,2
16641849,16642035,186,1,0,0,1
16641868,16642026,158,0,1,0,2
16641874,16642006,132,0,1,0,1
16642036,16642366,330,0,0,1,1
16642074,16642366,292,0,0,1,2
16642367,16642426,59,1,0,0,1
16642367,16642436,69,1,0,0,2
16642427,16642527,100,0,0,1,1
16642437,16642527,90,0,0,1,2
16642528,16642553,25,1,0,0,2
16642528,16642554,26,1,0,0,1
16642554,16644571,2017,0,0,1,2
16642555,16644571,2016,0,0,1,1
16644572,16644652,80,1,0,0,1
16644572,16644704,132,1,0,0,2
16644653,16644745,92,0,0,1,1
16644705,16644746,41,0,0,1,2
16644746,16644763,17,1,0,0,1
16644747,16644950,203,1,0,0,2
16644764,16645610,846,0,0,1,1
16644951,16645006,55,0,0,1,2
16645007,16645164,157,1,0,0,2
16645165,16645654,489,0,0,1,2
16645611,16645626,15,1,0,0,1
16645627,16645905,278,0,0,1,1
16645655,16645672,17,1,0,0,2
16645673,16646386,713,0,0,1,2
16645906,16645926,20,1,0,0,1
16645927,16646226,299,0,0,1,1
16646227,16646231,4,1,0,0,1
16646232,16646393,161,0,0,1,1
16646394,16646999,605,1,0,0,1
16646397,16647058,661,0,1,0,2
16646420,16646970,550,0,1,0,1
16647000,16647119,119,0,0,1,1
16647068,16647473,405,1,0,0,2
16647119,16647409,290,0,1,0,2
16647120,16647415,295,1,0,0,1
16647145,16647350,205,0,1,0,1
16647416,16647640,224,0,0,1,1
16647474,16647641,167,0,0,1,2
16647641,16647726,85,1,0,0,1
16647642,16647754,112,1,0,0,2
16647727,16647819,92,0,0,1,1
16647755,16647817,62,0,0,1,2
16647818,16647875,57,1,0,0,2
16647820,16647861,41,1,0,0,1
16647862,16647962,100,0,0,1,1
16647876,16648816,940,0,0,1,2
16647963,16647975,12,1,0,0,1
16647976,16650826,2850,0,0,1,1
16648817,16648823,6,1,0,0,2
16648824,16650473,1649,0,0,1,2
16650474,16650489,15,1,0,0,2
16650490,16650826,336,0,0,1,2
16650827,16650893,66,1,0,0,1
16650827,16653771,2944,1,0,0,2
16650871,16653720,2849,0,1,0,2
16650894,16650996,102,0,0,1,1
16651007,16653644,2637,0,1,0,1
16653654,16653737,83,1,0,0,1
16653738,16653800,62,0,0,1,1
16653772,16653801,29,0,0,1,2
16653801,16653855,54,1,0,0,1
16653802,16653850,48,1,0,0,2
16653851,16654007,156,0,0,1,2
16653856,16654004,148,0,0,1,1
16654005,16654061,56,1,0,0,1
16654008,16654062,54,1,0,0,2
16654062,16654274,212,0,0,1,1
16654063,16654275,212,0,0,1,2
16654275,16654294,19,1,0,0,1
16654276,16654308,32,1,0,0,2
16654295,16654437,142,0,0,1,1
16654309,16654437,128,0,0,1,2
16654438,16654523,85,1,0,0,1
16654438,16654645,207,1,0,0,2
16654524,16654630,106,0,0,1,1
16654631,16654646,15,1,0,0,1
16654646,16654749,103,0,0,1,2
16654647,16657123,2476,0,0,1,1
16654750,16654782,32,1,0,0,2
16654783,16655486,703,0,0,1,2
16655487,16655515,28,1,0,0,2
16655516,16657123,1607,0,0,1,2
16657124,16657189,65,1,0,0,1
16657124,16657259,135,1,0,0,2
16657190,16657359,169,0,0,1,1
16657260,16657364,104,0,0,1,2
16657360,16657375,15,1,0,0,1
16657365,16657380,15,1,0,0,2
16657376,16660281,2905,0,0,1,1
16657381,16657713,332,0,0,1,2
16657714,16657788,74,1,0,0,2
16657789,16659368,1579,0,0,1,2
16659369,16659398,29,1,0,0,2
16659399,16660099,700,0,0,1,2
16660100,16660145,45,1,0,0,2
16660146,16660227,81,0,0,1,2
16660228,16660243,15,1,0,0,2
16660244,16660282,38,0,0,1,2
16660282,16660346,64,1,0,0,1
16660283,16660366,83,1,0,0,2
16660347,16660442,95,0,0,1,1
16660367,16660389,22,0,0,1,2
16660390,16660418,28,1,0,0,2
16660419,16660448,29,0,0,1,2
16660443,16660499,56,1,0,0,1
16660449,16660923,474,1,0,0,2
16660500,16660575,75,0,0,1,1
16660576,16660870,294,1,0,0,1
16660597,16660817,220,0,1,0,1
16660598,16660868,270,0,1,0,2
16660871,16661732,861,0,0,1,1
16660924,16663512,2588,0,0,1,2
16661733,16661748,15,1,0,0,1
16661749,16663511,1762,0,0,1,1
16663512,16663596,84,1,0,0,1
16663513,16670637,7124,1,0,0,2
16663573,16667837,4264,0,1,0,2
16663597,16664008,411,0,0,1,1
16664009,16664017,8,1,0,0,1
16664018,16665073,1055,0,0,1,1
16665074,16667343,2269,1,0,0,1
16665085,16667003,1918,0,1,0,1
16667071,16667305,234,0,1,0,1
16667344,16667382,38,0,0,1,1
16667383,16667468,85,1,0,0,1
16667469,16667597,128,0,0,1,1
16667598,16667616,18,1,0,0,1
16667617,16670202,2585,0,0,1,1
16668097,16670467,2370,0,1,0,2
16670203,16670249,46,1,0,0,1
16670250,16670358,108,0,0,1,1
16670359,16670382,23,1,0,0,1
16670383,16672338,1955,0,0,1,1
16670638,16670812,174,0,0,1,2
16670813,16670817,4,1,0,0,2
16670818,16670844,26,0,0,1,2
16670845,16670942,97,1,0,0,2
16670943,16671165,222,0,0,1,2
16671166,16673430,2264,1,0,0,2
16671348,16671506,158,0,1,0,2
16671573,16673365,1792,0,1,0,2
16672339,16672382,43,1,0,0,1
16672383,16672533,150,0,0,1,1
16672534,16672562,28,1,0,0,1
16672563,16673894,1331,0,0,1,1
16673431,16673487,56,0,0,1,2
16673488,16673829,341,1,0,0,2
16673499,16673531,32,0,1,0,2
16673598,16673610,12,0,1,0,2
16673725,16673741,16,0,1,0,2
16673763,16673764,1,0,1,0,2
16673830,16673864,34,0,0,1,2
16673865,16674343,478,1,0,0,2
16673895,16674320,425,1,0,0,1
16673931,16673938,7,0,1,0,2
16673975,16674278,303,0,1,0,2
16673985,16674246,261,0,1,0,1
16674321,16675151,830,0,0,1,1
16674344,16675084,740,0,0,1,2
16675085,16675112,27,1,0,0,2
16675113,16675323,210,0,0,1,2
16675152,16675174,22,1,0,0,1
16675175,16675298,123,0,0,1,1
16675299,16675507,208,1,0,0,1
16675324,16675334,10,1,0,0,2
16675335,16676051,716,0,0,1,2
16675508,16675650,142,0,0,1,1
16675661,16675661,0,0,1,0,1
16675671,16675671,0,1,0,0,1
16675672,16675796,124,0,0,1,1
16675807,16675821,14,0,1,0,1
16675831,16675894,63,1,0,0,1
16675859,16675885,26,0,1,0,1
16675895,16676921,1026,0,0,1,1
16676062,16676064,2,0,1,0,2
16676073,16676073,0,1,0,0,2
16676074,16676338,264,0,0,1,2
16676339,16676343,4,1,0,0,2
16676344,16676916,572,0,0,1,2
16676917,16677287,370,1,0,0,2
16676922,16677262,340,1,0,0,1
16676938,16677229,291,0,1,0,2
16676945,16677167,222,0,1,0,1
16677263,16677448,185,0,0,1,1
16677288,16677738,450,0,0,1,2
16677449,16677459,10,1,0,0,1
16677460,16678863,1403,0,0,1,1
16677739,16677752,13,1,0,0,2
16677753,16678642,889,0,0,1,2
16678643,16678665,22,1,0,0,2
16678666,16678864,198,0,0,1,2
16678864,16679509,645,1,0,0,1
16678865,16679509,644,1,0,0,2
16678893,16679479,586,0,1,0,2
16678905,16679454,549,0,1,0,1
16679510,16679899,389,0,0,1,2
16679510,16679907,397,0,0,1,1
16679900,16680372,472,1,0,0,2
16679908,16680325,417,1,0,0,1
16679938,16680308,370,0,1,0,1
16679939,16680347,408,0,1,0,2
16680326,16680488,162,0,0,1,1
16680373,16680488,115,0,0,1,2
16680489,16680529,40,1,0,0,2
16680489,16680531,42,1,0,0,1
16680530,16682219,1689,0,0,1,2
16680532,16682218,1686,0,0,1,1
16682219,16682266,47,1,0,0,1
16682220,16682266,46,1,0,0,2
16682267,16682446,179,0,0,1,2
16682267,16684385,2118,0,0,1,1
16682447,16682468,21,1,0,0,2
16682469,16684383,1914,0,0,1,2
16684384,16685887,1503,1,0,0,2
16684386,16685602,1216,1,0,0,1
16684423,16685585,1162,0,1,0,1
16684433,16685876,1443,0,1,0,2
16685603,16685627,24,0,0,1,1
16685628,16685833,205,1,0,0,1
16685647,16685797,150,0,1,0,1
16685834,16686060,226,0,0,1,1
16685888,16686061,173,0,0,1,2
16686061,16686147,86,1,0,0,1
16686062,16686132,70,1,0,0,2
16686133,16686246,113,0,0,1,2
16686148,16686243,95,0,0,1,1
16686244,16686258,14,1,0,0,1
16686247,16686260,13,1,0,0,2
16686259,16688534,2275,0,0,1,1
16686261,16688329,2068,0,0,1,2
16688330,16688342,12,1,0,0,2
16688343,16688533,190,0,0,1,2
16688534,16688575,41,1,0,0,2
16688535,16688578,43,1,0,0,1
16688576,16690336,1760,0,0,1,2
16688579,16690444,1865,0,0,1,1
16690337,16690353,16,1,0,0,2
16690354,16690460,106,0,0,1,2
16690445,16691284,839,1,0,0,1
16690461,16691497,1036,1,0,0,2
16690495,16691261,766,0,1,0,1
16690504,16691307,803,0,1,0,2
16691285,16691352,67,0,0,1,1
16691353,16691376,23,1,0,0,1
16691377,16691474,97,0,0,1,1
16691475,16691494,19,1,0,0,1
16691495,16691872,377,0,0,1,1
16691498,16691866,368,0,0,1,2
16691867,16691883,16,1,0,0,2
16691873,16691900,27,1,0,0,1
16691884,16692128,244,0,0,1,2
16691901,16692127,226,0,0,1,1
16692128,16692214,86,1,0,0,1
16692129,16692214,85,1,0,0,2
16692215,16692254,39,0,0,1,2
16692215,16692257,42,0,0,1,1
16692255,16692351,96,1,0,0,2
16692258,16692346,88,1,0,0,1
16692347,16692521,174,0,0,1,1
16692352,16692508,156,0,0,1,2
16692509,16692540,31,1,0,0,2
16692522,16692538,16,1,0,0,1
16692539,16692840,301,0,0,1,1
16692541,16693917,1376,0,0,1,2
16692841,16692883,42,1,0,0,1
16692884,16693750,866,0,0,1,1
16693751,16693847,96,1,0,0,1
16693848,16694043,195,0,0,1,1
16693918,16693934,16,1,0,0,2
16693935,16694293,358,0,0,1,2
16694044,16694052,8,1,0,0,1
16694053,16694148,95,0,0,1,1
16694149,16694168,19,1,0,0,1
16694169,16694336,167,0,0,1,1
16694304,16694329,25,0,1,0,2
16694337,16694357,20,1,0,0,1
16694338,16694338,0,1,0,0,2
16694339,16694555,216,0,0,1,2
16694358,16694565,207,0,0,1,1
16694556,16694847,291,1,0,0,2
16694566,16694849,283,1,0,0,1
16694574,16694816,242,0,1,0,2
16694584,16694791,207,0,1,0,1
16694848,16696247,1399,0,0,1,2
16694850,16696443,1593,0,0,1,1
16696248,16696260,12,1,0,0,2
16696261,16696456,195,0,0,1,2
16696444,16698673,2229,1,0,0,1
16696457,16699162,2705,1,0,0,2
16696475,16698654,2179,0,1,0,1
16696495,16698740,2245,0,1,0,2
16698674,16698765,91,0,0,1,1
16698766,16699028,262,1,0,0,1
16698767,16698966,199,0,1,0,2
16698785,16698923,138,0,1,0,1
16699029,16699102,73,0,0,1,1
16699103,16699158,55,1,0,0,1
16699159,16699305,146,0,0,1,1
16699163,16699304,141,0,0,1,2
16699305,16699315,10,1,0,0,2
16699306,16699317,11,1,0,0,1
16699316,16699671,355,0,0,1,2
16699318,16699673,355,0,0,1,1
16699672,16699683,11,1,0,0,2
16699674,16699712,38,1,0,0,1
16699684,16701668,1984,0,0,1,2
16699713,16701668,1955,0,0,1,1
16701669,16701727,58,1,0,0,1
16701669,16701742,73,1,0,0,2
16701728,16701884,156,0,0,1,1
16701743,16701882,139,0,0,1,2
16701883,16701927,44,1,0,0,2
16701885,16701899,14,1,0,0,1
16701900,16703499,1599,0,0,1,1
16701928,16701973,45,0,0,1,2
16701974,16701988,14,1,0,0,2
16701989,16702106,117,0,0,1,2
16702107,16702174,67,1,0,0,2
16702175,16702253,78,0,0,1,2
16702254,16702290,36,1,0,0,2
16702291,16702361,70,0,0,1,2
16702362,16702397,35,1,0,0,2
16702398,16702495,97,0,0,1,2
16702496,16702500,4,1,0,0,2
16702501,16702539,38,0,0,1,2
16702540,16702578,38,1,0,0,2
16702579,16702691,112,0,0,1,2
16702692,16702700,8,1,0,0,2
16702701,16702814,113,0,0,1,2
16702815,16702839,24,1,0,0,2
16702840,16703415,575,0,0,1,2
16703416,16704264,848,1,0,0,2
16703500,16704234,734,1,0,0,1
16703540,16704198,658,0,1,0,1
16703543,16704239,696,0,1,0,2
16704235,16704368,133,0,0,1,1
16704265,16704363,98,0,0,1,2
16704364,16704620,256,1,0,0,2
16704369,16704602,233,1,0,0,1
16704392,16704596,204,0,1,0,2
16704397,16704553,156,0,1,0,1
16704603,16705200,597,0,0,1,1
16704621,16705201,580,0,0,1,2
16705201,16705241,40,1,0,0,1
16705202,16705244,42,1,0,0,2
16705242,16705351,109,0,0,1,1
16705245,16705349,104,0,0,1,2
16705350,16705393,43,1,0,0,2
16705352,16705393,41,1,0,0,1
16705394,16705789,395,0,0,1,1
16705394,16705792,398,0,0,1,2
16705790,16705809,19,1,0,0,1
16705793,16705813,20,1,0,0,2
16705810,16706076,266,0,0,1,1
16705814,16706075,261,0,0,1,2
16706076,16706155,79,1,0,0,2
16706077,16706114,37,1,0,0,1
16706115,16706484,369,0,0,1,1
16706156,16706483,327,0,0,1,2
16706484,16706508,24,1,0,0,2
16706485,16706519,34,1,0,0,1
16706509,16706677,168,0,0,1,2
16706520,16706670,150,0,0,1,1
16706671,16965766,259095,1,0,0,1
16706678,16965623,258945,1,0,0,2
16706696,16706937,241,0,1,0,1
16706701,16706899,198,0,1,0,2
16706975,16965747,258772,0,1,0,1
16706998,16965614,258616,0,1,0,2
16965624,16965720,96,0,0,1,2
16965721,16965746,25,1,0,0,2
16965747,16965994,247,0,0,1,2
16965767,16965994,227,0,0,1,1
16965995,16966036,41,1,0,0,1
16965995,16966036,41,1,0,0,2
16966037,16966328,291,0,0,1,1
16966037,16966328,291,0,0,1,2
16966329,16966723,394,1,0,0,1
16966329,16966937,608,1,0,0,2
16966521,16966716,195,0,1,0,2
16966527,16966688,161,0,1,0,1
16966724,16966755,31,0,0,1,1
16966756,16966931,175,1,0,0,1
16966768,16966903,135,0,1,0,2
16966777,16966892,115,0,1,0,1
16966932,16966967,35,0,0,1,1
16966938,16966967,29,0,0,1,2
16966968,16966998,30,1,0,0,2
16966968,16966999,31,1,0,0,1
16966999,16967236,237,0,0,1,2
16967000,16967237,237,0,0,1,1
16967237,16967287,50,1,0,0,2
16967238,16967294,56,1,0,0,1
16967288,16967766,478,0,0,1,2
16967295,16967765,470,0,0,1,1
16967766,16967828,62,1,0,0,1
16967767,16967806,39,1,0,0,2
16967807,16967965,158,0,0,1,2
16967829,16967867,38,0,0,1,1
16967868,16967885,17,1,0,0,1
16967886,16968127,241,0,0,1,1
16967966,16967982,16,1,0,0,2
16967983,16968128,145,0,0,1,2
16968128,16968168,40,1,0,0,1
16968129,16968168,39,1,0,0,2
16968169,16968437,268,0,0,1,1
16968169,16968442,273,0,0,1,2
16968438,16968678,240,1,0,0,1
16968443,16968698,255,1,0,0,2
16968458,16968638,180,0,1,0,1
16968466,16968648,182,0,1,0,2
16968679,16969032,353,0,0,1,1
16968699,16969033,334,0,0,1,2
16969033,16969071,38,1,0,0,1
16969034,16969072,38,1,0,0,2
16969072,16969201,129,0,0,1,1
16969073,16969199,126,0,0,1,2
16969200,16970289,1089,1,0,0,2
16969202,16970542,1340,1,0,0,1
16969234,16970271,1037,0,1,0,1
16969234,16970271,1037,0,1,0,2
16970290,16970312,22,0,0,1,2
16970313,16970555,242,1,0,0,2
16970346,16970510,164,0,1,0,1
16970348,16970516,168,0,1,0,2
16970543,16970710,167,0,0,1,1
16970556,16970711,155,0,0,1,2
16970711,16970772,61,1,0,0,1
16970712,16970766,54,1,0,0,2
16970767,16970821,54,0,0,1,2
16970773,16970820,47,0,0,1,1
16970821,16971035,214,1,0,0,1
16970822,16971079,257,1,0,0,2
16970843,16970998,155,0,1,0,1
16970850,16971003,153,0,1,0,2
16971036,16971138,102,0,0,1,1
16971080,16971139,59,0,0,1,2
16971139,16971533,394,1,0,0,1
16971140,16971535,395,1,0,0,2
16971324,16971502,178,0,1,0,1
16971346,16971500,154,0,1,0,2
16971534,16971630,96,0,0,1,1
16971536,16971642,106,0,0,1,2
16971631,16971833,202,1,0,0,1
16971643,16971824,181,1,0,0,2
16971689,16971784,95,0,1,0,1
16971694,16971785,91,0,1,0,2
16971825,16971877,52,0,0,1,2
16971834,16971876,42,0,0,1,1
16971877,16972119,242,1,0,0,1
16971878,16972147,269,1,0,0,2
16971923,16972081,158,0,1,0,1
16971924,16972106,182,0,1,0,2
16972120,16972431,311,0,0,1,1
16972148,16972443,295,0,0,1,2
16972432,16972472,40,1,0,0,1
16972444,16972474,30,1,0,0,2
16972473,16972741,268,0,0,1,1
16972475,16972747,272,0,0,1,2
16972742,16972986,244,1,0,0,1
16972748,16973095,347,1,0,0,2
16972762,16972937,175,0,1,0,1
16972768,16972981,213,0,1,0,2
16972987,16973192,205,0,0,1,1
16973096,16973192,96,0,0,1,2
16973193,16973228,35,1,0,0,2
16973193,16973230,37,1,0,0,1
16973229,16973499,270,0,0,1,2
16973231,16973500,269,0,0,1,1
16973500,16973549,49,1,0,0,2
16973501,16973925,424,1,0,0,1
16973550,16973925,375,0,0,1,2
17021536,17021821,285,0,0,1,2
17021536,17021822,286,0,0,1,1
17021822,17021908,86,1,0,0,2
17021823,17021897,74,1,0,0,1
17021898,17021991,93,0,0,1,1
17021909,17021990,81,0,0,1,2
17021991,17022020,29,1,0,0,2
17021992,17022013,21,1,0,0,1
17022014,17024475,2461,0,0,1,1
17022021,17023071,1050,0,0,1,2
17023072,17023096,24,1,0,0,2
17023097,17023358,261,0,0,1,2
17023359,17023363,4,1,0,0,2
17023364,17024471,1107,0,0,1,2
17024472,17024603,131,1,0,0,2
17024476,17024603,127,1,0,0,1
17024604,17024665,61,0,0,1,2
17024604,17024666,62,0,0,1,1
17024666,17024697,31,1,0,0,2
17024667,17024691,24,1,0,0,1
17024692,17024815,123,0,0,1,1
17024698,17024810,112,0,0,1,2
17024811,17024822,11,1,0,0,2
17024816,17024822,6,1,0,0,1
17024823,17026181,1358,0,0,1,2
17024823,17027018,2195,0,0,1,1
17026182,17026199,17,1,0,0,2
17026200,17026321,121,0,0,1,2
17026322,17026380,58,1,0,0,2
17026381,17026828,447,0,0,1,2
17026829,17026855,26,1,0,0,2
17026856,17026879,23,0,0,1,2
17026880,17026900,20,1,0,0,2
17026901,17027016,115,0,0,1,2
17027017,17027134,117,1,0,0,2
17027019,17027084,65,1,0,0,1
17027085,17027168,83,0,0,1,1
17027135,17027168,33,0,0,1,2
17027169,17027192,23,1,0,0,2
17027169,17027193,24,1,0,0,1
17027193,17029374,2181,0,0,1,2
17027194,17029374,2180,0,0,1,1
17029375,17029424,49,1,0,0,2
17029375,17029428,53,1,0,0,1
17029425,17030040,615,0,0,1,2
17029429,17031597,2168,0,0,1,1
17030041,17030068,27,1,0,0,2
17030069,17031145,1076,0,0,1,2
17031146,17031159,13,1,0,0,2
17031160,17031594,434,0,0,1,2
17031595,17031739,144,1,0,0,2
17031598,17031677,79,1,0,0,1
17031678,17031793,115,0,0,1,1
17031740,17031791,51,0,0,1,2
17031792,17031820,28,1,0,0,2
17031794,17031808,14,1,0,0,1
17031809,17031924,115,0,0,1,1
17031821,17031922,101,0,0,1,2
17031923,17031938,15,1,0,0,2
17031925,17031930,5,1,0,0,1
17031931,17033338,1407,0,0,1,1
17031939,17032107,168,0,0,1,2
17032108,17032113,5,1,0,0,2
17032114,17032450,336,0,0,1,2
17032451,17032468,17,1,0,0,2
17032469,17032534,65,0,0,1,2
17032535,17032869,334,1,0,0,2
17032870,17033107,237,0,0,1,2
17033108,17033279,171,1,0,0,2
17033280,17033327,47,0,0,1,2
17033328,17034007,679,1,0,0,2
17033339,17033690,351,1,0,0,1
17033362,17033648,286,0,1,0,1
17033364,17033736,372,0,1,0,2
17033691,17033760,69,0,0,1,1
17033761,17034081,320,1,0,0,1
17033783,17033968,185,0,1,0,1
17033785,17033965,180,0,1,0,2
17034008,17034099,91,0,0,1,2
17034082,17034269,187,0,0,1,1
17034100,17034110,10,1,0,0,2
17034111,17034677,566,0,0,1,2
17034270,17034293,23,1,0,0,1
17034294,17035487,1193,0,0,1,1
17034678,17034686,8,1,0,0,2
17034687,17035490,803,0,0,1,2
17035488,17035807,319,1,0,0,1
17035491,17035823,332,1,0,0,2
17035535,17035767,232,0,1,0,1
17035540,17035786,246,0,1,0,2
17035808,17035938,130,0,0,1,1
17035824,17035938,114,0,0,1,2
17035939,17035982,43,1,0,0,1
17035939,17035991,52,1,0,0,2
17035983,17036034,51,0,0,1,1
17035992,17036035,43,0,0,1,2
17036035,17036647,612,1,0,0,1
17036036,17036647,611,1,0,0,2
17036182,17036418,236,0,1,0,2
17036185,17036407,222,0,1,0,1
17036464,17036603,139,0,1,0,2
17036466,17036588,122,0,1,0,1
17036648,17036751,103,0,0,1,1
17036648,17036752,104,0,0,1,2
17036752,17036789,37,1,0,0,1
17036753,17036821,68,1,0,0,2
17036790,17036917,127,0,0,1,1
17036822,17036918,96,0,0,1,2
17036918,17036928,10,1,0,0,1
17036919,17036932,13,1,0,0,2
17036929,17037530,601,0,0,1,1
17036933,17037540,607,0,0,1,2
17037531,17037734,203,1,0,0,1
17037541,17037771,230,1,0,0,2
17037564,17037703,139,0,1,0,1
17037567,17037713,146,0,1,0,2
17037735,17039164,1429,0,0,1,1
17037772,17038509,737,0,0,1,2
17038510,17038524,14,1,0,0,2
17038525,17039166,641,0,0,1,2
17039165,17040262,1097,1,0,0,1
17039167,17040254,1087,1,0,0,2
17039417,17039955,538,0,1,0,1
17039483,17039721,238,0,1,0,2
17039813,17039969,156,0,1,0,2
17040064,17040233,169,0,1,0,2
17040066,17040191,125,0,1,0,1
17040255,17040416,161,0,0,1,2
17040263,17040412,149,0,0,1,1
17040413,17040431,18,1,0,0,1
17040417,17040439,22,1,0,0,2
17040432,17040747,315,0,0,1,1
17040440,17040746,306,0,0,1,2
17040747,17041066,319,1,0,0,2
17040748,17041107,359,1,0,0,1
17040767,17041035,268,0,1,0,1
17040769,17040994,225,0,1,0,2
17041067,17042780,1713,0,0,1,2
17041108,17041359,251,0,0,1,1
17041360,17041369,9,1,0,0,1
17041370,17041467,97,0,0,1,1
17041468,17041493,25,1,0,0,1
17041494,17041595,101,0,0,1,1
17041596,17041610,14,1,0,0,1
17041611,17042778,1167,0,0,1,1
17042779,17042985,206,1,0,0,1
17042781,17043010,229,1,0,0,2
17042811,17042969,158,0,1,0,2
17042813,17042955,142,0,1,0,1
17042986,17043081,95,0,0,1,1
17043011,17043079,68,0,0,1,2
17043080,17043104,24,1,0,0,2
17043082,17043101,19,1,0,0,1
17043102,17045115,2013,0,0,1,1
17043105,17044993,1888,0,0,1,2
17044994,17045007,13,1,0,0,2
17045008,17045111,103,0,0,1,2
17045112,17045249,137,1,0,0,2
17045116,17045233,117,1,0,0,1
17045234,17045342,108,0,0,1,1
17045250,17045341,91,0,0,1,2
17045342,17045448,106,1,0,0,2
17045343,17045363,20,1,0,0,1
17045364,17047385,2021,0,0,1,1
17045449,17045592,143,0,0,1,2
17045593,17045637,44,1,0,0,2
17045638,17045677,39,0,0,1,2
17045678,17045693,15,1,0,0,2
17045694,17045865,171,0,0,1,2
17045866,17045883,17,1,0,0,2
17045884,17045983,99,0,0,1,2
17045984,17046006,22,1,0,0,2
17046007,17047387,1380,0,0,1,2
17047386,17047604,218,1,0,0,1
17047388,17047625,237,1,0,0,2
17047418,17047558,140,0,1,0,1
17047422,17047574,152,0,1,0,2
17047605,17047702,97,0,0,1,1
17047626,17047700,74,0,0,1,2
17047701,17047752,51,1,0,0,2
17047703,17047727,24,1,0,0,1
17047728,17049980,2252,0,0,1,1
17047753,17049981,2228,0,0,1,2
17049981,17050203,222,1,0,0,1
17049982,17050252,270,1,0,0,2
17050019,17050168,149,0,1,0,1
17050021,17050205,184,0,1,0,2
17050204,17050290,86,0,0,1,1
17050253,17052086,1833,0,0,1,2
17050291,17050317,26,1,0,0,1
17050318,17052471,2153,0,0,1,1
17052097,17052505,408,0,1,0,2
17052472,17052513,41,1,0,0,1
17052514,17054897,2383,0,0,1,1
17052515,17052516,1,1,0,0,2
17052517,17054902,2385,0,0,1,2
17054898,17055141,243,1,0,0,1
17054903,17055186,283,1,0,0,2
17054947,17055116,169,0,1,0,2
17054956,17055088,132,0,1,0,1
17055142,17056021,879,0,0,1,1
17055187,17055265,78,0,0,1,2
17055266,17055276,10,1,0,0,2
17055277,17057134,1857,0,0,1,2
17056022,17056078,56,1,0,0,1
17056079,17057132,1053,0,0,1,1
17057133,17057234,101,1,0,0,1
17057145,17057152,7,0,1,0,2
17057162,17057274,112,1,0,0,2
17057235,17057294,59,0,0,1,1
17057275,17057296,21,0,0,1,2
17057295,17057323,28,1,0,0,1
17057297,17057339,42,1,0,0,2
17057324,17057418,94,0,0,1,1
17057340,17057422,82,0,0,1,2
17057419,17057441,22,1,0,0,1
17057423,17057486,63,1,0,0,2
17057442,17059823,2381,0,0,1,1
17057487,17059167,1680,0,0,1,2
17059168,17059182,14,1,0,0,2
17059183,17059642,459,0,0,1,2
17059643,17059647,4,1,0,0,2
17059648,17059822,174,0,0,1,2
17059823,17059876,53,1,0,0,2
17059824,17059865,41,1,0,0,1
17059866,17062405,2539,0,0,1,1
17059877,17060013,136,0,0,1,2
17060014,17060018,4,1,0,0,2
17060019,17060354,335,0,0,1,2
17060355,17060430,75,1,0,0,2
17060431,17060549,118,0,0,1,2
17060550,17060559,9,1,0,0,2
17060560,17060826,266,0,0,1,2
17060827,17060929,102,1,0,0,2
17060930,17061390,460,0,0,1,2
17061391,17061395,4,1,0,0,2
17061396,17061712,316,0,0,1,2
17061713,17061774,61,1,0,0,2
17061775,17061868,93,0,0,1,2
17061869,17061952,83,1,0,0,2
17061953,17062135,182,0,0,1,2
17062136,17062151,15,1,0,0,2
17062152,17062343,191,0,0,1,2
17062344,17062669,325,1,0,0,2
17062406,17062665,259,1,0,0,1
17062415,17062632,217,0,1,0,2
17062425,17062616,191,0,1,0,1
17062666,17065439,2773,0,0,1,1
17062670,17062746,76,0,0,1,2
17062747,17062765,18,1,0,0,2
17062766,17065440,2674,0,0,1,2
17065440,17066010,570,1,0,0,1
17065441,17065868,427,1,0,0,2
17065468,17065915,447,0,1,0,1
17065469,17065742,273,0,1,0,2
17065869,17066294,425,0,0,1,2
17066011,17066157,146,0,0,1,1
17066158,17066274,116,1,0,0,1
17066275,17066366,91,0,0,1,1
17066295,17066304,9,1,0,0,2
17066305,17066878,573,0,0,1,2
17066367,17066737,370,1,0,0,1
17066738,17066808,70,0,0,1,1
17066809,17067166,357,1,0,0,1
17066879,17066924,45,1,0,0,2
17066925,17067208,283,0,0,1,2
17067167,17067204,37,0,0,1,1
17067205,17067289,84,1,0,0,1
17067209,17067258,49,1,0,0,2
17067259,17067670,411,0,0,1,2
17067290,17067394,104,0,0,1,1
17067395,17067515,120,1,0,0,1
17067516,17067635,119,0,0,1,1
17067636,17067665,29,1,0,0,1
17067666,17067727,61,0,0,1,1
17067671,17067702,31,1,0,0,2
17067703,17067926,223,0,0,1,2
17067728,17067743,15,1,0,0,1
17067744,17067912,168,0,0,1,1
17067913,17067953,40,1,0,0,1
17067927,17067935,8,1,0,0,2
17067936,17068038,102,0,0,1,2
17067954,17068027,73,0,0,1,1
17068028,17068322,294,1,0,0,1
17068039,17068375,336,1,0,0,2
17068053,17068273,220,0,1,0,1
17068061,17068316,255,0,1,0,2
17068323,17068355,32,0,0,1,1
17068356,17068376,20,1,0,0,1
17068376,17068499,123,0,0,1,2
17068377,17070808,2431,0,0,1,1
17068500,17068510,10,1,0,0,2
17068511,17068766,255,0,0,1,2
17068767,17068797,30,1,0,0,2
17068798,17069824,1026,0,0,1,2
17069825,17069845,20,1,0,0,2
17069846,17070060,214,0,0,1,2
17070061,17070102,41,1,0,0,2
17070103,17070808,705,0,0,1,2
17070809,17070856,47,1,0,0,1
17070809,17070874,65,1,0,0,2
17070857,17070986,129,0,0,1,1
17070875,17070982,107,0,0,1,2
17070983,17071000,17,1,0,0,2
17070987,17070995,8,1,0,0,1
17070996,17071948,952,0,0,1,1
17071001,17071393,392,0,0,1,2
17071394,17071448,54,1,0,0,2
17071449,17071619,170,0,0,1,2
17071620,17071625,5,1,0,0,2
17071626,17071655,29,0,0,1,2
17071656,17071669,13,1,0,0,2
17071670,17071903,233,0,0,1,2
17071904,17072243,339,1,0,0,2
17071949,17072207,258,1,0,0,1
17071981,17072200,219,0,1,0,2
17071986,17072170,184,0,1,0,1
17072208,17072277,69,0,0,1,1
17072244,17072276,32,0,0,1,2
17072277,17072433,156,1,0,0,2
17072278,17072292,14,1,0,0,1
17072293,17074512,2219,0,0,1,1
17072434,17072674,240,0,0,1,2
17072675,17072735,60,1,0,0,2
17072736,17074031,1295,0,0,1,2
17074032,17074073,41,1,0,0,2
17074074,17074282,208,0,0,1,2
17074283,17074306,23,1,0,0,2
17074307,17074508,201,0,0,1,2
17074509,17074726,217,1,0,0,2
17074513,17074694,181,1,0,0,1
17074542,17074665,123,0,1,0,1
17074544,17074685,141,0,1,0,2
17074695,17074809,114,0,0,1,1
17074727,17074799,72,0,0,1,2
17074800,17074825,25,1,0,0,2
17074810,17074818,8,1,0,0,1
17074819,17077467,2648,0,0,1,1
17074826,17075277,451,0,0,1,2
17075278,17075292,14,1,0,0,2
17075293,17077467,2174,0,0,1,2
17077468,17077719,251,1,0,0,2
17077468,17077741,273,1,0,0,1
17077528,17077677,149,0,1,0,1
17077531,17077687,156,0,1,0,2
17077720,17077809,89,0,0,1,2
17077742,17077813,71,0,0,1,1
17077810,17077840,30,1,0,0,2
17077814,17077840,26,1,0,0,1
17077841,17077962,121,0,0,1,2
17077841,17077971,130,0,0,1,1
17077963,17077971,8,1,0,0,2
17077972,17077983,11,1,0,0,1
17077972,17079106,1134,0,0,1,2
17077984,17080293,2309,0,0,1,1
17079107,17079140,33,1,0,0,2
17079141,17080290,1149,0,0,1,2
17080291,17080573,282,1,0,0,2
17080294,17080532,238,1,0,0,1
17080337,17080483,146,0,1,0,1
17080339,17080518,179,0,1,0,2
17080533,17080616,83,0,0,1,1
17080574,17082327,1753,0,0,1,2
17080617,17080634,17,1,0,0,1
17080635,17080680,45,0,0,1,1
17080681,17081608,927,1,0,0,1
17081609,17082119,510,0,0,1,1
17082120,17082133,13,1,0,0,1
17082134,17082299,165,0,0,1,1
17082300,17082383,83,1,0,0,1
17082328,17082343,15,1,0,0,2
17082344,17082987,643,0,0,1,2
17082384,17082986,602,0,0,1,1
17082987,17083191,204,1,0,0,1
17082988,17083229,241,1,0,0,2
17083019,17083176,157,0,1,0,2
17083020,17083150,130,0,1,0,1
17083192,17085870,2678,0,0,1,1
17083230,17084592,1362,0,0,1,2
17084593,17084612,19,1,0,0,2
17084613,17084939,326,0,0,1,2
17084940,17084955,15,1,0,0,2
17084956,17085343,387,0,0,1,2
17085344,17085348,4,1,0,0,2
17085349,17085374,25,0,0,1,2
17085375,17085379,4,1,0,0,2
17085380,17085858,478,0,0,1,2
17085859,17086130,271,1,0,0,2
17085871,17086103,232,1,0,0,1
17085905,17086076,171,0,1,0,1
17085907,17086104,197,0,1,0,2
17086104,17086188,84,0,0,1,1
17086131,17086187,56,0,0,1,2
17086188,17086213,25,1,0,0,2
17086189,17086210,21,1,0,0,1
17086211,17088719,2508,0,0,1,1
17086214,17086893,679,0,0,1,2
17086894,17086935,41,1,0,0,2
17086936,17087669,733,0,0,1,2
17087670,17087675,5,1,0,0,2
17087676,17088721,1045,0,0,1,2
17088720,17088931,211,1,0,0,1
17088722,17089001,279,1,0,0,2
17088750,17088937,187,0,1,0,2
17088758,17088897,139,0,1,0,1
17088932,17089034,102,0,0,1,1
17089002,17091449,2447,0,0,1,2
17089035,17089049,14,1,0,0,1
17089050,17089197,147,0,0,1,1
17089198,17089210,12,1,0,0,1
17089211,17091447,2236,0,0,1,1
17091448,17091788,340,1,0,0,1
17091450,17091928,478,1,0,0,2
17091481,17091753,272,0,1,0,2
17091488,17091700,212,0,1,0,1
17091789,17091889,100,0,0,1,1
17091890,17091927,37,1,0,0,1
17091928,17093954,2026,0,0,1,1
17091929,17093939,2010,0,0,1,2
17093940,17094331,391,1,0,0,2
17093955,17094262,307,1,0,0,1
17093956,17094291,335,0,1,0,2
17093973,17094227,254,0,1,0,1
17094263,17094440,177,0,0,1,1
17094332,17094440,108,0,0,1,2
17094441,17094504,63,1,0,0,1
17094441,17094504,63,1,0,0,2
17094505,17094620,115,0,0,1,2
17094505,17094625,120,0,0,1,1
17094621,17094640,19,1,0,0,2
17094626,17094638,12,1,0,0,1
17094639,17096523,1884,0,0,1,1
17094641,17094706,65,0,0,1,2
17094707,17094764,57,1,0,0,2
17094765,17095020,255,0,0,1,2
17095021,17095103,82,1,0,0,2
17095104,17095612,508,0,0,1,2
17095613,17095633,20,1,0,0,2
17095634,17096080,446,0,0,1,2
17096081,17096086,5,1,0,0,2
17096087,17096437,350,0,0,1,2
17096438,17096483,45,1,0,0,2
17096484,17096518,34,0,0,1,2
17096519,17096868,349,1,0,0,2
17096524,17096808,284,1,0,0,1
17096562,17096755,193,0,1,0,1
17096565,17096801,236,0,1,0,2
17096809,17096995,186,0,0,1,1
17096869,17096996,127,0,0,1,2
17096996,17097062,66,1,0,0,1
17096997,17097069,72,1,0,0,2
17097063,17097159,96,0,0,1,1
17097070,17097156,86,0,0,1,2
17097157,17097185,28,1,0,0,2
17097160,17097188,28,1,0,0,1
17097186,17097343,157,0,0,1,2
17097189,17100138,2949,0,0,1,1
17097344,17097361,17,1,0,0,2
17097362,17100135,2773,0,0,1,2
17100136,17100411,275,1,0,0,2
17100139,17100349,210,1,0,0,1
17100176,17100319,143,0,1,0,1
17100177,17100355,178,0,1,0,2
17100350,17100437,87,0,0,1,1
17100412,17100438,26,0,0,1,2
17100438,17100468,30,1,0,0,1
17100439,17100470,31,1,0,0,2
17100469,17103215,2746,0,0,1,1
17100471,17103205,2734,0,0,1,2
17103206,17106222,3016,1,0,0,2
17103216,17103579,363,1,0,0,1
17103226,17106211,2985,0,1,0,2
17103233,17103461,228,0,1,0,1
17103580,17103720,140,0,0,1,1
17103721,17103725,4,1,0,0,1
17103726,17104212,486,0,0,1,1
17104213,17104227,14,1,0,0,1
17104228,17104713,485,0,0,1,1
17104714,17104722,8,1,0,0,1
17104723,17104967,244,0,0,1,1
17104968,17104993,25,1,0,0,1
17104994,17105036,42,0,0,1,1
17105037,17105053,16,1,0,0,1
17105054,17105299,245,0,0,1,1
17105300,17105374,74,1,0,0,1
17105375,17105949,574,0,0,1,1
17105950,17106163,213,1,0,0,1
17105978,17106130,152,0,1,0,1
17106164,17106252,88,0,0,1,1
17106223,17106256,33,0,0,1,2
17106253,17106274,21,1,0,0,1
17106257,17106276,19,1,0,0,2
17106275,17108644,2369,0,0,1,1
17106277,17108645,2368,0,0,1,2
17108645,17108961,316,1,0,0,1
17108646,17108940,294,1,0,0,2
17108702,17108901,199,0,1,0,1
17108711,17108897,186,0,1,0,2
17108941,17109687,746,0,0,1,2
17108962,17111246,2284,0,0,1,1
17109688,17109713,25,1,0,0,2
17109714,17111245,1531,0,0,1,2
17111246,17111546,300,1,0,0,2
17111247,17111525,278,1,0,0,1
17111299,17111504,205,0,1,0,2
17111305,17111457,152,0,1,0,1
17111526,17111608,82,0,0,1,1
17111547,17111619,72,0,0,1,2
17111609,17111658,49,1,0,0,1
17111620,17111643,23,1,0,0,2
17111644,17113620,1976,0,0,1,2
17111659,17111989,330,0,0,1,1
17111990,17112063,73,1,0,0,1
17112064,17112423,359,0,0,1,1
17112424,17112443,19,1,0,0,1
17112444,17112666,222,0,0,1,1
17112667,17112795,128,1,0,0,1
17112796,17112935,139,0,0,1,1
17112936,17112954,18,1,0,0,1
17112955,17113106,151,0,0,1,1
17113107,17113214,107,1,0,0,1
17113215,17113614,399,0,0,1,1
17113615,17113671,56,1,0,0,1
17113621,17113691,70,1,0,0,2
17113672,17115417,1745,0,0,1,1
17113692,17114847,1155,0,0,1,2
17114848,17114862,14,1,0,0,2
17114863,17115413,550,0,0,1,2
17115414,17115534,120,1,0,0,2
17115418,17115535,117,1,0,0,1
17115535,17115602,67,0,0,1,2
17115536,17115598,62,0,0,1,1
17115599,17115628,29,1,0,0,1
17115603,17115632,29,1,0,0,2
17115629,17115722,93,0,0,1,1
17115633,17115717,84,0,0,1,2
17115718,17115735,17,1,0,0,2
17115723,17115739,16,1,0,0,1
17115736,17117387,1651,0,0,1,2
17115740,17117388,1648,0,0,1,1
17117388,17120230,2842,1,0,0,2
17117389,17118251,862,1,0,0,1
17117449,17120191,2742,0,1,0,2
17117453,17118218,765,0,1,0,1
17118252,17119978,1726,0,0,1,1
17119979,17120197,218,1,0,0,1
17120004,17120129,125,0,1,0,1
17120198,17120376,178,0,0,1,1
17120231,17120372,141,0,0,1,2
17120373,17120393,20,1,0,0,2
17120377,17120411,34,1,0,0,1
17120394,17121202,808,0,0,1,2
17120412,17120541,129,0,0,1,1
17120542,17120546,4,1,0,0,1
17120547,17120889,342,0,0,1,1
17120890,17120952,62,1,0,0,1
17120953,17121256,303,0,0,1,1
17121203,17121216,13,1,0,0,2
17121217,17122119,902,0,0,1,2
17121257,17121297,40,1,0,0,1
17121298,17122249,951,0,0,1,1
17122120,17122131,11,1,0,0,2
17122132,17122249,117,0,0,1,2
17122250,17122353,103,1,0,0,1
17122250,17122354,104,1,0,0,2
17122354,17122431,77,0,0,1,1
17122355,17122434,79,0,0,1,2
17122432,17122469,37,1,0,0,1
17122435,17122472,37,1,0,0,2
17122470,17122584,114,0,0,1,1
17122473,17122586,113,0,0,1,2
17122585,17122605,20,1,0,0,1
17122587,17122606,19,1,0,0,2
17122606,17124413,1807,0,0,1,1
17122607,17123318,711,0,0,1,2
17123319,17123341,22,1,0,0,2
17123342,17124414,1072,0,0,1,2
17124414,17124518,104,1,0,0,1
17124415,17124528,113,1,0,0,2
17124519,17124583,64,0,0,1,1
17124529,17124583,54,0,0,1,2
17124584,17124605,21,1,0,0,2
17124584,17124609,25,1,0,0,1
17124606,17126606,2000,0,0,1,2
17124610,17126605,1995,0,0,1,1
17126606,17126714,108,1,0,0,1
17126607,17126722,115,1,0,0,2
17126715,17126797,82,0,0,1,1
17126723,17126794,71,0,0,1,2
17126795,17126822,27,1,0,0,2
17126798,17126821,23,1,0,0,1
17126822,17126908,86,0,0,1,1
17126823,17126909,86,0,0,1,2
17126909,17127133,224,1,0,0,1
17126910,17127137,227,1,0,0,2
17126944,17127097,153,0,1,0,1
17126949,17127104,155,0,1,0,2
17127134,17127212,78,0,0,1,1
17127138,17127206,68,0,0,1,2
17127207,17127268,61,1,0,0,2
17127213,17127221,8,1,0,0,1
17127222,17129142,1920,0,0,1,1
17127269,17129141,1872,0,0,1,2
17129142,17129182,40,1,0,0,2
17129143,17129183,40,1,0,0,1
17129183,17131127,1944,0,0,1,2
17129184,17129299,115,0,0,1,1
17129300,17129311,11,1,0,0,1
17129312,17131129,1817,0,0,1,1
17131128,17131504,376,1,0,0,2
17131130,17131475,345,1,0,0,1
17131155,17131438,283,0,1,0,1
17131158,17131493,335,0,1,0,2
17131476,17131574,98,0,0,1,1
17131505,17131573,68,0,0,1,2
17131574,17131603,29,1,0,0,2
17131575,17131595,20,1,0,0,1
17131596,17131664,68,0,0,1,1
17131604,17131665,61,0,0,1,2
17131665,17131840,175,1,0,0,1
17131666,17131850,184,1,0,0,2
17131694,17131806,112,0,1,0,1
17131696,17131815,119,0,1,0,2
17131841,17133876,2035,0,0,1,1
17131851,17133249,1398,0,0,1,2
17133250,17133265,15,1,0,0,2
17133266,17133877,611,0,0,1,2
17133877,17133965,88,1,0,0,1
17133878,17133969,91,1,0,0,2
17133966,17134027,61,0,0,1,1
17133970,17134027,57,0,0,1,2
17134028,17134059,31,1,0,0,1
17134028,17134060,32,1,0,0,2
17134060,17134162,102,0,0,1,1
17134061,17134164,103,0,0,1,2
17134163,17134180,17,1,0,0,1
17134165,17134183,18,1,0,0,2
17134181,17136198,2017,0,0,1,1
17134184,17136197,2013,0,0,1,2
17136198,17136451,253,1,0,0,2
17136199,17136418,219,1,0,0,1
17136254,17136361,107,0,1,0,1
17136254,17136387,133,0,1,0,2
17136419,17136481,62,0,0,1,1
17136452,17136480,28,0,0,1,2
17136481,17136503,22,1,0,0,2
17136482,17136503,21,1,0,0,1
17136504,17136630,126,0,0,1,2
17136504,17138665,2161,0,0,1,1
17136631,17136636,5,1,0,0,2
17136637,17138665,2028,0,0,1,2
17138666,17139100,434,1,0,0,1
17138666,17139102,436,1,0,0,2
17138725,17139031,306,0,1,0,2
17138729,17138982,253,0,1,0,1
17139101,17139129,28,0,0,1,1
17139103,17139134,31,0,0,1,2
17139130,17139346,216,1,0,0,1
17139135,17139343,208,1,0,0,2
17139151,17139307,156,0,1,0,1
17139153,17139320,167,0,1,0,2
17139344,17139399,55,0,0,1,2
17139347,17139397,50,0,0,1,1
17139398,17139418,20,1,0,0,1
17139400,17139419,19,1,0,0,2
17139419,17141662,2243,0,0,1,1
17139420,17141662,2242,0,0,1,2
17141663,17141769,106,1,0,0,1
17141663,17141891,228,1,0,0,2
17141770,17141849,79,0,0,1,1
17141850,17141877,27,1,0,0,1
17141878,17141985,107,0,0,1,1
17141892,17141954,62,0,0,1,2
17141955,17142111,156,1,0,0,2
17141986,17141998,12,1,0,0,1
17141999,17143183,1184,0,0,1,1
17142112,17142191,79,0,0,1,2
17142192,17142315,123,1,0,0,2
17142316,17142421,105,0,0,1,2
17142422,17142856,434,1,0,0,2
17142857,17142880,23,0,0,1,2
17142881,17143932,1051,1,0,0,2
17143184,17143605,421,1,0,0,1
17143211,17143656,445,0,1,0,2
17143216,17143550,334,0,1,0,1
17143606,17143700,94,0,0,1,1
17143701,17143886,185,1,0,0,1
17143710,17143877,167,0,1,0,2
17143719,17143848,129,0,1,0,1
17143887,17144213,326,0,0,1,1
17143933,17143985,52,0,0,1,2
17143986,17144005,19,1,0,0,2
17144006,17144206,200,0,0,1,2
17144207,17144399,192,1,0,0,2
17144214,17144345,131,1,0,0,1
17144346,17144421,75,0,0,1,1
17144400,17144423,23,0,0,1,2
17144422,17144452,30,1,0,0,1
17144424,17144451,27,1,0,0,2
17144452,17144489,37,0,0,1,2
17144453,17145242,789,0,0,1,1
17144490,17144499,9,1,0,0,2
17144500,17144660,160,0,0,1,2
17144661,17144716,55,1,0,0,2
17144717,17146656,1939,0,0,1,2
17145243,17145278,35,1,0,0,1
17145279,17145648,369,0,0,1,1
17145649,17145670,21,1,0,0,1
17145671,17146635,964,0,0,1,1
17146636,17146699,63,1,0,0,1
17146657,17146701,44,1,0,0,2
17146700,17146792,92,0,0,1,1
17146702,17147571,869,0,0,1,2
17146793,17146797,4,1,0,0,1
17146798,17149488,2690,0,0,1,1
17147572,17147598,26,1,0,0,2
17147599,17148697,1098,0,0,1,2
17148698,17148708,10,1,0,0,2
17148709,17149236,527,0,0,1,2
17149237,17149248,11,1,0,0,2
17149249,17149302,53,0,0,1,2
17149313,17149337,24,0,1,0,2
17149346,17149346,0,1,0,0,2
17149347,17149454,107,0,0,1,2
17149455,17149459,4,1,0,0,2
17149460,17149488,28,0,0,1,2
17149489,17149581,92,1,0,0,1
17149489,17149593,104,1,0,0,2
17149582,17149759,177,0,0,1,1
17149594,17149901,307,0,0,1,2
17149760,17149765,5,1,0,0,1
17149766,17149908,142,0,0,1,1
17149902,17150669,767,1,0,0,2
17149909,17150152,243,1,0,0,1
17149930,17150148,218,0,1,0,2
17149931,17150120,189,0,1,0,1
17150153,17150179,26,0,0,1,1
17150180,17150580,400,1,0,0,1
17150196,17150602,406,0,1,0,2
17150199,17150569,370,0,1,0,1
17150581,17150650,69,0,0,1,1
17150651,17150671,20,1,0,0,1
17150670,17152355,1685,0,0,1,2
17150672,17152355,1683,0,0,1,1
17152356,17152398,42,1,0,0,2
17152356,17152411,55,1,0,0,1
17152399,17154476,2077,0,0,1,2
17152412,17154480,2068,0,0,1,1
17154477,17154740,263,1,0,0,2
17154481,17154709,228,1,0,0,1
17154509,17154699,190,0,1,0,2
17154510,17154672,162,0,1,0,1
17154710,17155030,320,0,0,1,1
17154741,17155023,282,0,0,1,2
17155024,17155291,267,1,0,0,2
17155031,17155252,221,1,0,0,1
17155051,17155211,160,0,1,0,1
17155051,17155245,194,0,1,0,2
17155253,17155346,93,0,0,1,1
17155292,17155335,43,0,0,1,2
17155336,17155602,266,1,0,0,2
17155347,17155556,209,1,0,0,1
17155362,17155551,189,0,1,0,2
17155365,17155519,154,0,1,0,1
17155557,17155917,360,0,0,1,1
17155603,17155917,314,0,0,1,2
17155918,17155982,64,1,0,0,1
17155918,17155982,64,1,0,0,2
17155983,17156099,116,0,0,1,1
17155983,17156101,118,0,0,1,2
17156100,17156119,19,1,0,0,1
17156102,17156118,16,1,0,0,2
17156119,17158281,2162,0,0,1,2
17156120,17158282,2162,0,0,1,1
17158282,17158346,64,1,0,0,2
17158283,17158338,55,1,0,0,1
17158339,17160192,1853,0,0,1,1
17158347,17160197,1850,0,0,1,2
17160193,17160785,592,1,0,0,1
17160198,17160853,655,1,0,0,2
17160227,17160842,615,0,1,0,2
17160228,17160477,249,0,1,0,1
17160569,17160762,193,0,1,0,1
17160786,17161813,1027,0,0,1,1
17160854,17161813,959,0,0,1,2
17161814,17161864,50,1,0,0,1
17161814,17161865,51,1,0,0,2
17161865,17164098,2233,0,0,1,1
17161866,17164094,2228,0,0,1,2
17164095,17164173,78,1,0,0,2
17164099,17164177,78,1,0,0,1
17164174,17164653,479,0,0,1,2
17164178,17164802,624,0,0,1,1
17164654,17164673,19,1,0,0,2
17164674,17165164,490,0,0,1,2
17164803,17164878,75,1,0,0,1
17164879,17166071,1192,0,0,1,1
17165165,17165169,4,1,0,0,2
17165170,17166072,902,0,0,1,2
17166072,17166679,607,1,0,0,1
17166073,17166739,666,1,0,0,2
17166118,17166668,550,0,1,0,1
17166121,17166672,551,0,1,0,2
17166680,17166871,191,0,0,1,1
17166740,17166774,34,0,0,1,2
17166775,17166807,32,1,0,0,2
17166808,17166876,68,0,0,1,2
17166872,17167108,236,1,0,0,1
17166877,17167170,293,1,0,0,2
17166906,17167067,161,0,1,0,1
17166912,17167093,181,0,1,0,2
17167109,17167278,169,0,0,1,1
17167171,17167282,111,0,0,1,2
17167279,17167312,33,1,0,0,1
17167283,17167313,30,1,0,0,2
17167313,17167381,68,0,0,1,1
17167314,17167388,74,0,0,1,2
17167382,17167413,31,1,0,0,1
17167389,17167407,18,1,0,0,2
17167408,17167436,28,0,0,1,2
17167414,17167611,197,0,0,1,1
17167437,17167441,4,1,0,0,2
17167442,17167592,150,0,0,1,2
17167593,17167700,107,1,0,0,2
17167612,17167647,35,1,0,0,1
17167648,17167892,244,0,0,1,1
17167701,17167893,192,0,0,1,2
17167893,17167966,73,1,0,0,1
17167894,17168040,146,1,0,0,2
17167967,17168071,104,0,0,1,1
17168041,17168074,33,0,0,1,2
17168072,17168097,25,1,0,0,1
17168075,17168105,30,1,0,0,2
17168098,17168232,134,0,0,1,1
17168106,17168141,35,0,0,1,2
17168142,17168174,32,1,0,0,2
17168175,17168225,50,0,0,1,2
17168226,17168245,19,1,0,0,2
17168233,17168250,17,1,0,0,1
17168246,17168502,256,0,0,1,2
17168251,17170868,2617,0,0,1,1
17168503,17168557,54,1,0,0,2
17168558,17168632,74,0,0,1,2
17168633,17168638,5,1,0,0,2
17168639,17169020,381,0,0,1,2
17169021,17169058,37,1,0,0,2
17169059,17169110,51,0,0,1,2
17169111,17169115,4,1,0,0,2
17169116,17170444,1328,0,0,1,2
17170445,17170453,8,1,0,0,2
17170454,17170488,34,0,0,1,2
17170489,17170504,15,1,0,0,2
17170505,17170553,48,0,0,1,2
17170554,17170570,16,1,0,0,2
17170571,17170863,292,0,0,1,2
17170864,17170932,68,1,0,0,2
17170869,17170910,41,1,0,0,1
17170911,17171133,222,0,0,1,1
17170933,17172838,1905,0,0,1,2
17171134,17171167,33,1,0,0,1
17171168,17171308,140,0,0,1,1
17171309,17171313,4,1,0,0,1
17171314,17171351,37,0,0,1,1
17171352,17171356,4,1,0,0,1
17171357,17171448,91,0,0,1,1
17171449,17171577,128,1,0,0,1
17171578,17171869,291,0,0,1,1
17171870,17171874,4,1,0,0,1
17171875,17172087,212,0,0,1,1
17172088,17172113,25,1,0,0,1
17172114,17172483,369,0,0,1,1
17172484,17172670,186,1,0,0,1
17172671,17172812,141,0,0,1,1
17172813,17173395,582,1,0,0,1
17172839,17173445,606,1,0,0,2
17172882,17173360,478,0,1,0,1
17172888,17173402,514,0,1,0,2
17173396,17173521,125,0,0,1,1
17173446,17173508,62,0,0,1,2
17173509,17174632,1123,1,0,0,2
17173522,17173794,272,1,0,0,1
17173545,17173746,201,0,1,0,1
17173550,17173784,234,0,1,0,2
17173795,17174611,816,0,0,1,1
17174612,17174627,15,1,0,0,1
17174628,17174761,133,0,0,1,1
17174633,17174666,33,0,0,1,2
17174667,17174672,5,1,0,0,2
17174673,17174763,90,0,0,1,2
17174762,17174821,59,1,0,0,1
17174764,17174831,67,1,0,0,2
17174822,17176841,2019,0,0,1,1
17174832,17174970,138,0,0,1,2
17174971,17174987,16,1,0,0,2
17174988,17175270,282,0,0,1,2
17175271,17175293,22,1,0,0,2
17175294,17176837,1543,0,0,1,2
17176838,17176890,52,1,0,0,2
17176842,17176910,68,1,0,0,1
17176891,17178738,1847,0,0,1,2
17176911,17178653,1742,0,0,1,1
17178654,17180126,1472,1,0,0,1
17178739,17180074,1335,1,0,0,2
17178782,17179992,1210,0,1,0,1
17178815,17180020,1205,0,1,0,2
17180075,17180105,30,0,0,1,2
17180106,17180130,24,1,0,0,2
17180127,17180399,272,0,0,1,1
17180131,17180401,270,0,0,1,2
17180400,17180499,99,1,0,0,1
17180402,17180474,72,1,0,0,2
17180475,17180524,49,0,0,1,2
17180500,17180527,27,0,0,1,1
17180525,17181078,553,1,0,0,2
17180528,17181004,476,1,0,0,1
17180548,17180990,442,0,1,0,1
17180552,17181067,515,0,1,0,2
17181005,17183499,2494,0,0,1,1
17181079,17182549,1470,0,0,1,2
17182550,17182628,78,1,0,0,2
17182629,17182892,263,0,0,1,2
17182893,17182916,23,1,0,0,2
17182917,17183330,413,0,0,1,2
17183331,17183437,106,1,0,0,2
17183438,17183476,38,0,0,1,2
17183477,17183559,82,1,0,0,2
17183500,17183551,51,1,0,0,1
17183552,17185461,1909,0,0,1,1
17183560,17185464,1904,0,0,1,2
17185462,17186235,773,1,0,0,1
17185465,17186276,811,1,0,0,2
17185494,17186224,730,0,1,0,1
17185497,17186265,768,0,1,0,2
17186236,17186508,272,0,0,1,1
17186277,17186510,233,0,0,1,2
17186509,17186543,34,1,0,0,1
17186511,17186544,33,1,0,0,2
17186544,17186647,103,0,0,1,1
17186545,17186647,102,0,0,1,2
17186648,17186668,20,1,0,0,1
17186648,17186675,27,1,0,0,2
17186669,17187168,499,0,0,1,1
17186676,17187166,490,0,0,1,2
17187167,17187179,12,1,0,0,2
17187169,17187176,7,1,0,0,1
17187177,17187438,261,0,0,1,1
17187180,17187441,261,0,0,1,2
17187439,17187498,59,1,0,0,1
17187442,17187562,120,1,0,0,2
17187499,17187606,107,0,0,1,1
17187563,17187604,41,0,0,1,2
17187605,17187697,92,1,0,0,2
17187607,17187633,26,1,0,0,1
17187634,17190458,2824,0,0,1,1
17187698,17188173,475,0,0,1,2
17188174,17188196,22,1,0,0,2
17188197,17188554,357,0,0,1,2
17188555,17188560,5,1,0,0,2
17188561,17189603,1042,0,0,1,2
17189604,17189627,23,1,0,0,2
17189628,17190462,834,0,0,1,2
17190459,17190518,59,1,0,0,1
17190463,17190525,62,1,0,0,2
17190519,17194034,3515,0,0,1,1
17190526,17190640,114,0,0,1,2
17190641,17190656,15,1,0,0,2
17190657,17194036,3379,0,0,1,2
17194035,17194086,51,1,0,0,1
17194037,17194084,47,1,0,0,2
17194085,17194193,108,0,0,1,2
17194087,17194198,111,0,0,1,1
17194194,17194209,15,1,0,0,2
17194199,17194206,7,1,0,0,1
17194207,17196899,2692,0,0,1,1
17194210,17196900,2690,0,0,1,2
17196900,17196952,52,1,0,0,1
17196901,17196981,80,1,0,0,2
17196953,17197067,114,0,0,1,1
17196982,17197060,78,0,0,1,2
17197061,17197076,15,1,0,0,2
17197068,17197080,12,1,0,0,1
17197077,17197401,324,0,0,1,2
17197081,17198856,1775,0,0,1,1
17197402,17197409,7,1,0,0,2
17197410,17197632,222,0,0,1,2
17197633,17197650,17,1,0,0,2
17197651,17197839,188,0,0,1,2
17197840,17197863,23,1,0,0,2
17197864,17197998,134,0,0,1,2
17197999,17198013,14,1,0,0,2
17198014,17198112,98,0,0,1,2
17198113,17198118,5,1,0,0,2
17198119,17198839,720,0,0,1,2
17198840,17199990,1150,1,0,0,2
17198857,17199944,1087,1,0,0,1
17198905,17199707,802,0,1,0,1
17198910,17199971,1061,0,1,0,2
17199760,17199907,147,0,1,0,1
17199945,17200110,165,0,0,1,1
17199991,17200108,117,0,0,1,2
17200109,17200349,240,1,0,0,2
17200111,17200302,191,1,0,0,1
17200130,17200302,172,0,1,0,2
17200133,17200274,141,0,1,0,1
17200303,17200597,294,0,0,1,1
17200350,17200599,249,0,0,1,2
17200598,17200845,247,1,0,0,1
17200600,17200873,273,1,0,0,2
17200662,17200814,152,0,1,0,1
17200663,17200836,173,0,1,0,2
17200846,17200907,61,0,0,1,1
17200874,17200908,34,0,0,1,2
17200908,17200948,40,1,0,0,1
17200909,17200948,39,1,0,0,2
17200949,17201060,111,0,0,1,1
17200949,17201061,112,0,0,1,2
17201061,17201080,19,1,0,0,1
17201062,17201086,24,1,0,0,2
17201081,17203225,2144,0,0,1,1
17201087,17201273,186,0,0,1,2
17201274,17201320,46,1,0,0,2
17201321,17203222,1901,0,0,1,2
17203223,17203275,52,1,0,0,2
17203226,17203277,51,1,0,0,1
17203276,17203371,95,0,0,1,2
17203278,17203377,99,0,0,1,1
17203372,17203386,14,1,0,0,2
17203378,17203393,15,1,0,0,1
17203387,17203623,236,0,0,1,2
17203394,17205003,1609,0,0,1,1
17203624,17203640,16,1,0,0,2
17203641,17203957,316,0,0,1,2
17203958,17203962,4,1,0,0,2
17203963,17204188,225,0,0,1,2
17204189,17204227,38,1,0,0,2
17204228,17204828,600,0,0,1,2
17204829,17204846,17,1,0,0,2
17204847,17204992,145,0,0,1,2
17204993,17206172,1179,1,0,0,2
17205004,17206113,1109,1,0,0,1
17205045,17206099,1054,0,1,0,1
17205047,17206100,1053,0,1,0,2
17206114,17206150,36,0,0,1,1
17206151,17206176,25,1,0,0,1
17206173,17206305,132,0,0,1,2
17206177,17206305,128,0,0,1,1
17206306,17206361,55,1,0,0,1
17206306,17206362,56,1,0,0,2
17206362,17206475,113,0,0,1,1
17206363,17206476,113,0,0,1,2
17206476,17206514,38,1,0,0,1
17206477,17206512,35,1,0,0,2
17206513,17206634,121,0,0,1,2
17206515,17206635,120,0,0,1,1
17206635,17206649,14,1,0,0,2
17206636,17206644,8,1,0,0,1
17206645,17206921,276,0,0,1,1
17206650,17206920,270,0,0,1,2
17206921,17207261,340,1,0,0,2
17206922,17207195,273,1,0,0,1
17206943,17207156,213,0,1,0,1
17206944,17207190,246,0,1,0,2
17207196,17209556,2360,0,0,1,1
17207262,17207621,359,0,0,1,2
17207622,17207637,15,1,0,0,2
17207638,17208807,1169,0,0,1,2
17208808,17208858,50,1,0,0,2
17208859,17209253,394,0,0,1,2
17209254,17209293,39,1,0,0,2
17209294,17209558,264,0,0,1,2
17209557,17209600,43,1,0,0,1
17209559,17209773,214,1,0,0,2
17209601,17209715,114,0,0,1,1
17209716,17209731,15,1,0,0,1
17209732,17209917,185,0,0,1,1
17209774,17209891,117,0,0,1,2
17209892,17210012,120,1,0,0,2
17209918,17209932,14,1,0,0,1
17209933,17211640,1707,0,0,1,1
17210013,17210164,151,0,0,1,2
17210165,17210179,14,1,0,0,2
17210180,17210312,132,0,0,1,2
17210313,17210337,24,1,0,0,2
17210338,17210530,192,0,0,1,2
17210531,17210556,25,1,0,0,2
17210557,17210602,45,0,0,1,2
17210603,17210622,19,1,0,0,2
17210623,17211660,1037,0,0,1,2
17211641,17212302,661,1,0,0,1
17211661,17212651,990,1,0,0,2
17211686,17212272,586,0,1,0,1
17211693,17212615,922,0,1,0,2
17212303,17212512,209,0,0,1,1
17212513,17212518,5,1,0,0,1
17212519,17212579,60,0,0,1,1
17212580,17212605,25,1,0,0,1
17212606,17213510,904,0,0,1,1
17212652,17213510,858,0,0,1,2
17213511,17213545,34,1,0,0,2
17213511,17213553,42,1,0,0,1
17213546,17215845,2299,0,0,1,2
17213554,17215778,2224,0,0,1,1
17215779,17215783,4,1,0,0,1
17215784,17215863,79,0,0,1,1
17215846,17215899,53,1,0,0,2
17215864,17215879,15,1,0,0,1
17215880,17215964,84,0,0,1,1
17215900,17215955,55,0,0,1,2
17215956,17215996,40,1,0,0,2
17215965,17215970,5,1,0,0,1
17215971,17217611,1640,0,0,1,1
17215997,17216030,33,0,0,1,2
17216031,17216065,34,1,0,0,2
17216066,17216271,205,0,0,1,2
17216272,17216298,26,1,0,0,2
17216299,17216342,43,0,0,1,2
17216343,17216394,51,1,0,0,2
17216395,17216931,536,0,0,1,2
17216932,17216945,13,1,0,0,2
17216946,17217378,432,0,0,1,2
17217379,17217393,14,1,0,0,2
17217394,17217584,190,0,0,1,2
17217585,17218627,1042,1,0,0,2
17217612,17218195,583,1,0,0,1
17217627,17218600,973,0,1,0,2
17217634,17218184,550,0,1,0,1
17218196,17218216,20,0,0,1,1
17218217,17218540,323,1,0,0,1
17218240,17218491,251,0,1,0,1
17218541,17218967,426,0,0,1,1
17218628,17218965,337,0,0,1,2
17218966,17218970,4,1,0,0,2
17218968,17218985,17,1,0,0,1
17218971,17219254,283,0,0,1,2
17218986,17219250,264,0,0,1,1
17219251,17219342,91,1,0,0,1
17219255,17219455,200,1,0,0,2
17219343,17219405,62,0,0,1,1
17219406,17219440,34,1,0,0,1
17219441,17219479,38,0,0,1,1
17219456,17219477,21,0,0,1,2
17219478,17219517,39,1,0,0,2
17219480,17219508,28,1,0,0,1
17219509,17219867,358,0,0,1,1
17219518,17219594,76,0,0,1,2
17219595,17219605,10,1,0,0,2
17219606,17219653,47,0,0,1,2
17219654,17219667,13,1,0,0,2
17219668,17219720,52,0,0,1,2
17219721,17219800,79,1,0,0,2
17219801,17219856,55,0,0,1,2
17219857,17220023,166,1,0,0,2
17219868,17219878,10,1,0,0,1
17219879,17222333,2454,0,0,1,1
17220024,17220143,119,0,0,1,2
17220144,17220229,85,1,0,0,2
17220230,17222338,2108,0,0,1,2
17222334,17222406,72,1,0,0,1
17222339,17222411,72,1,0,0,2
17222407,17222580,173,0,0,1,1
17222412,17222580,168,0,0,1,2
17222581,17222587,6,1,0,0,1
17222581,17222782,201,1,0,0,2
17222588,17223105,517,0,0,1,1
17222783,17222813,30,0,0,1,2
17222814,17222832,18,1,0,0,2
17222833,17222931,98,0,0,1,2
17222932,17222951,19,1,0,0,2
17222952,17222991,39,0,0,1,2
17222992,17223044,52,1,0,0,2
17223045,17223097,52,0,0,1,2
17223098,17223619,521,1,0,0,2
17223106,17223564,458,1,0,0,1
17223148,17223554,406,0,1,0,1
17223154,17223569,415,0,1,0,2
17223565,17223727,162,0,0,1,1
17223620,17223723,103,0,0,1,2
17223724,17223748,24,1,0,0,2
17223728,17223737,9,1,0,0,1
17223738,17224543,805,0,0,1,1
17223749,17224498,749,0,0,1,2
17224499,17225076,577,1,0,0,2
17224544,17225023,479,1,0,0,1
17224570,17225012,442,0,1,0,1
17224586,17225065,479,0,1,0,2
17225024,17225133,109,0,0,1,1
17225077,17225141,64,0,0,1,2
17225134,17225433,299,1,0,0,1
17225142,17225383,241,1,0,0,2
17225161,17225335,174,0,1,0,2
17225167,17225300,133,0,1,0,1
17225384,17225604,220,0,0,1,2
17225434,17225460,26,0,0,1,1
17225461,17225481,20,1,0,0,1
17225482,17225601,119,0,0,1,1
17225602,17226005,403,1,0,0,1
17225605,17225659,54,1,0,0,2
17225660,17225914,254,0,0,1,2
17225915,17226024,109,1,0,0,2
17226006,17226126,120,0,0,1,1
17226025,17226126,101,0,0,1,2
17226127,17226167,40,1,0,0,1
17226127,17226194,67,1,0,0,2
17226168,17226257,89,0,0,1,1
17226195,17226244,49,0,0,1,2
17226245,17226522,277,1,0,0,2
17226258,17226267,9,1,0,0,1
17226268,17228127,1859,0,0,1,1
17226523,17227758,1235,0,0,1,2
17227759,17227772,13,1,0,0,2
17227773,17228126,353,0,0,1,2
17228127,17228225,98,1,0,0,2
17228128,17228195,67,1,0,0,1
17228196,17228282,86,0,0,1,1
17228226,17228279,53,0,0,1,2
17228280,17228300,20,1,0,0,2
17228283,17228305,22,1,0,0,1
17228301,17228505,204,0,0,1,2
17228306,17230142,1836,0,0,1,1
17228506,17228521,15,1,0,0,2
17228522,17228561,39,0,0,1,2
17228562,17228698,136,1,0,0,2
17228699,17228731,32,0,0,1,2
17228732,17228774,42,1,0,0,2
17228775,17228929,154,0,0,1,2
17228930,17229376,446,1,0,0,2
17229377,17229739,362,0,0,1,2
17229740,17230114,374,1,0,0,2
17230115,17230151,36,0,0,1,2
17230143,17230148,5,1,0,0,1
17230149,17230184,35,0,0,1,1
17230152,17231732,1580,1,0,0,2
17230169,17231634,1465,0,1,0,2
17230185,17231462,1277,1,0,0,1
17230204,17231401,1197,0,1,0,1
17231463,17231527,64,0,0,1,1
17231528,17231534,6,1,0,0,1
17231535,17231636,101,0,0,1,1
17231637,17231725,88,1,0,0,1
17231726,17231826,100,0,0,1,1
17231733,17231826,93,0,0,1,2
17231827,17231874,47,1,0,0,2
17231827,17231903,76,1,0,0,1
17231875,17231976,101,0,0,1,2
17231904,17231975,71,0,0,1,1
17231976,17232001,25,1,0,0,1
17231977,17232031,54,1,0,0,2
17232002,17234547,2545,0,0,1,1
17232032,17232374,342,0,0,1,2
17232375,17232538,163,1,0,0,2
17232539,17233363,824,0,0,1,2
17233364,17233473,109,1,0,0,2
17233474,17233553,79,0,0,1,2
17233554,17233653,99,1,0,0,2
17233654,17233780,126,0,0,1,2
17233781,17233861,80,1,0,0,2
17233862,17234035,173,0,0,1,2
17234036,17234230,194,1,0,0,2
17234231,17234539,308,0,0,1,2
17234540,17235160,620,1,0,0,2
17234548,17234619,71,1,0,0,1
17234620,17234714,94,0,0,1,1
17234715,17234730,15,1,0,0,1
17234731,17236357,1626,0,0,1,1
17235161,17235259,98,0,0,1,2
17235260,17235568,308,1,0,0,2
17235569,17235642,73,0,0,1,2
17235643,17235685,42,1,0,0,2
17235686,17235840,154,0,0,1,2
17235841,17235856,15,1,0,0,2
17235857,17235902,45,0,0,1,2
17235903,17235941,38,1,0,0,2
17235942,17236335,393,0,0,1,2
17236336,17239618,3282,1,0,0,2
17236358,17239487,3129,1,0,0,1
17236406,17239476,3070,0,1,0,1
17236414,17239521,3107,0,1,0,2
17239488,17239670,182,0,0,1,1
17239619,17239673,54,0,0,1,2
17239671,17239716,45,1,0,0,1
17239674,17239725,51,1,0,0,2
17239717,17239805,88,0,0,1,1
17239726,17239806,80,0,0,1,2
17239806,17239836,30,1,0,0,1
17239807,17240205,398,1,0,0,2
17239837,17240002,165,0,0,1,1
17240003,17240013,10,1,0,0,1
17240014,17240080,66,0,0,1,1
17240081,17240096,15,1,0,0,1
17240097,17241766,1669,0,0,1,1
17240206,17241766,1560,0,0,1,2
17241767,17241813,46,1,0,0,1
17241767,17241815,48,1,0,0,2
17241814,17242012,198,0,0,1,1
17241816,17242008,192,0,0,1,2
17242009,17242027,18,1,0,0,2
17242013,17242021,8,1,0,0,1
17242022,17243813,1791,0,0,1,1
17242028,17243822,1794,0,0,1,2
17243814,17244344,530,1,0,0,1
17243823,17244769,946,1,0,0,2
17243851,17244333,482,0,1,0,1
17243851,17244371,520,0,1,0,2
17244345,17244433,88,0,0,1,1
17244434,17244696,262,1,0,0,1
17244446,17244657,211,0,1,0,2
17244454,17244618,164,0,1,0,1
17244697,17244722,25,0,0,1,1
17244723,17244771,48,1,0,0,1
17244770,17245218,448,0,0,1,2
17244772,17245217,445,0,0,1,1
17245218,17245273,55,1,0,0,1
17245219,17245274,55,1,0,0,2
17245274,17247283,2009,0,0,1,1
17245275,17247282,2007,0,0,1,2
17247283,17247329,46,1,0,0,2
17247284,17247333,49,1,0,0,1
17247330,17249409,2079,0,0,1,2
17247334,17249390,2056,0,0,1,1
17249391,17250255,864,1,0,0,1
17249410,17250360,950,1,0,0,2
17249455,17249933,478,0,1,0,1
17249461,17250274,813,0,1,0,2
17249987,17250206,219,0,1,0,1
17250256,17250276,20,0,0,1,1
17250277,17250321,44,1,0,0,1
17250322,17250552,230,0,0,1,1
17250361,17250551,190,0,0,1,2
17250552,17250714,162,1,0,0,2
17250553,17250619,66,1,0,0,1
17250620,17250644,24,0,0,1,1
17250645,17250709,64,1,0,0,1
17250710,17250741,31,0,0,1,1
17250715,17250741,26,0,0,1,2
17250742,17250765,23,1,0,0,1
17250742,17250781,39,1,0,0,2
17250766,17250937,171,0,0,1,1
17250782,17250936,154,0,0,1,2
17250937,17251007,70,1,0,0,2
17250938,17250952,14,1,0,0,1
17250953,17251117,164,0,0,1,1
17251008,17251072,64,0,0,1,2
17251073,17251145,72,1,0,0,2
17251118,17251122,4,1,0,0,1
17251123,17253852,2729,0,0,1,1
17251146,17251432,286,0,0,1,2
17251433,17251448,15,1,0,0,2
17251449,17251895,446,0,0,1,2
17251896,17251910,14,1,0,0,2
17251911,17252281,370,0,0,1,2
17252282,17252286,4,1,0,0,2
17252287,17252702,415,0,0,1,2
17252703,17252707,4,1,0,0,2
17252708,17252862,154,0,0,1,2
17252863,17252896,33,1,0,0,2
17252897,17253097,200,0,0,1,2
17253098,17253139,41,1,0,0,2
17253140,17253852,712,0,0,1,2
17253853,17253911,58,1,0,0,1
17253853,17253955,102,1,0,0,2
17253912,17253992,80,0,0,1,1
17253956,17253990,34,0,0,1,2
17253991,17254029,38,1,0,0,2
17253993,17254018,25,1,0,0,1
17254019,17254193,174,0,0,1,1
17254030,17254737,707,0,0,1,2
17254194,17254206,12,1,0,0,1
17254207,17255878,1671,0,0,1,1
17254738,17254763,25,1,0,0,2
17254764,17254843,79,0,0,1,2
17254844,17254863,19,1,0,0,2
17254864,17254957,93,0,0,1,2
17254958,17255087,129,1,0,0,2
17255088,17255264,176,0,0,1,2
17255265,17255286,21,1,0,0,2
17255287,17255445,158,0,0,1,2
17255446,17258706,3260,1,0,0,2
17255879,17255908,29,1,0,0,1
17255909,17255997,88,0,0,1,1
17255998,17258247,2249,1,0,0,1
17256027,17256793,766,0,1,0,1
17256032,17258574,2542,0,1,0,2
17256890,17258195,1305,0,1,0,1
17258248,17258376,128,0,0,1,1
17258377,17258390,13,1,0,0,1
17258391,17258620,229,0,0,1,1
17258604,17258606,2,0,1,0,2
17258621,17258695,74,1,0,0,1
17258696,17258733,37,0,0,1,1
17258707,17258826,119,0,0,1,2
17258734,17258850,116,1,0,0,1
17258827,17258848,21,1,0,0,2
17258849,17259039,190,0,0,1,2
17258851,17261595,2744,0,0,1,1
17259040,17259054,14,1,0,0,2
17259055,17259565,510,0,0,1,2
17259566,17259570,4,1,0,0,2
17259571,17260609,1038,0,0,1,2
17260610,17260614,4,1,0,0,2
17260615,17261592,977,0,0,1,2
17261593,17261764,171,1,0,0,2
17261596,17261654,58,1,0,0,1
17261655,17261732,77,0,0,1,1
17261733,17261749,16,1,0,0,1
17261750,17262268,518,0,0,1,1
17261765,17262604,839,0,0,1,2
17262269,17262372,103,1,0,0,1
17262373,17262398,25,0,0,1,1
17262399,17262441,42,1,0,0,1
17262442,17262566,124,0,0,1,1
17262567,17263190,623,1,0,0,1
17262605,17262973,368,1,0,0,2
17262632,17262884,252,0,1,0,1
17262670,17262912,242,0,1,0,2
17262974,17263100,126,0,0,1,2
17263101,17263118,17,1,0,0,2
17263119,17263321,202,0,0,1,2
17263191,17263254,63,0,0,1,1
17263255,17263345,90,1,0,0,1
17263322,17263340,18,1,0,0,2
17263341,17263835,494,0,0,1,2
17263346,17263410,64,0,0,1,1
17263411,17263475,64,1,0,0,1
17263476,17263854,378,0,0,1,1
17263836,17264406,570,1,0,0,2
17263855,17264359,504,1,0,0,1
17263875,17264046,171,0,1,0,1
17263877,17264080,203,0,1,0,2
17264153,17264350,197,0,1,0,2
17264158,17264312,154,0,1,0,1
17264360,17265429,1069,0,0,1,1
17264407,17265428,1021,0,0,1,2
17265429,17265477,48,1,0,0,2
17265430,17265487,57,1,0,0,1
17265478,17265602,124,0,0,1,2
17265488,17265618,130,0,0,1,1
17265603,17265636,33,1,0,0,2
17265619,17265623,4,1,0,0,1
17265624,17265685,61,0,0,1,1
17265637,17265687,50,0,0,1,2
17265686,17265912,226,1,0,0,1
17265688,17265957,269,1,0,0,2
17265719,17265851,132,0,1,0,1
17265721,17265883,162,0,1,0,2
17265913,17268542,2629,0,0,1,1
17265958,17266392,434,0,0,1,2
17266393,17266408,15,1,0,0,2
17266409,17266451,42,0,0,1,2
17266452,17266721,269,1,0,0,2
17266722,17266752,30,0,0,1,2
17266753,17267323,570,1,0,0,2
17267324,17267598,274,0,0,1,2
17267599,17267615,16,1,0,0,2
17267616,17267674,58,0,0,1,2
17267675,17267691,16,1,0,0,2
17267692,17268539,847,0,0,1,2
17268540,17268588,48,1,0,0,2
17268543,17268589,46,1,0,0,1
17268589,17270490,1901,0,0,1,2
17268590,17270500,1910,0,0,1,1
17270491,17271028,537,1,0,0,2
17270501,17270998,497,1,0,0,1
17270530,17270729,199,0,1,0,1
17270531,17271014,483,0,1,0,2
17270780,17270955,175,0,1,0,1
17270999,17271085,86,0,0,1,1
17271029,17271073,44,0,0,1,2
17271074,17271349,275,1,0,0,2
17271086,17271290,204,1,0,0,1
17271100,17271295,195,0,1,0,2
17271107,17271257,150,0,1,0,1
17271291,17271910,619,0,0,1,1
17271350,17271909,559,0,0,1,2
17271910,17271982,72,1,0,0,2
17271911,17271981,70,1,0,0,1
17271982,17272132,150,0,0,1,1
17271983,17272132,149,0,0,1,2
17272133,17272177,44,1,0,0,2
17272133,17272181,48,1,0,0,1
17272178,17272285,107,0,0,1,2
17272182,17272285,103,0,0,1,1
17272286,17272306,20,1,0,0,1
17272286,17272307,21,1,0,0,2
17272307,17275019,2712,0,0,1,1
17272308,17275018,2710,0,0,1,2
17275019,17275077,58,1,0,0,2
17275020,17275077,57,1,0,0,1
17275078,17275153,75,0,0,1,2
17275078,17275155,77,0,0,1,1
17275154,17275181,27,1,0,0,2
17275156,17275175,19,1,0,0,1
17275176,17275349,173,0,0,1,1
17275182,17275350,168,0,0,1,2
17275350,17275371,21,1,0,0,1
17275351,17275374,23,1,0,0,2
17275372,17276888,1516,0,0,1,1
17275375,17277186,1811,0,0,1,2
17276889,17276893,4,1,0,0,1
17276894,17277189,295,0,0,1,1
17277187,17277890,703,1,0,0,2
17277190,17277871,681,1,0,0,1
17277218,17277840,622,0,1,0,1
17277219,17277879,660,0,1,0,2
17277872,17279073,1201,0,0,1,1
17277891,17278775,884,0,0,1,2
17278776,17278792,16,1,0,0,2
17278793,17278857,64,0,0,1,2
17278858,17278887,29,1,0,0,2
17278888,17279072,184,0,0,1,2
17279073,17279140,67,1,0,0,2
17279074,17279140,66,1,0,0,1
17279141,17279248,107,0,0,1,1
17279141,17279249,108,0,0,1,2
17279249,17279272,23,1,0,0,1
17279250,17279271,21,1,0,0,2
17279272,17279418,146,0,0,1,2
17279273,17279412,139,0,0,1,1
17279413,17279429,16,1,0,0,1
17279419,17279424,5,1,0,0,2
17279425,17281611,2186,0,0,1,2
17279430,17281613,2183,0,0,1,1
17281612,17281674,62,1,0,0,2
17281614,17281675,61,1,0,0,1
17281675,17281820,145,0,0,1,2
17281676,17281822,146,0,0,1,1
17281821,17281841,20,1,0,0,2
17281823,17281827,4,1,0,0,1
17281828,17283680,1852,0,0,1,1
17281842,17283671,1829,0,0,1,2
17283672,17286523,2851,1,0,0,2
17283681,17286128,2447,1,0,0,1
17283721,17286107,2386,0,1,0,1
17283723,17286110,2387,0,1,0,2
17286129,17286195,66,0,0,1,1
17286196,17286471,275,1,0,0,1
17286209,17286444,235,0,1,0,2
17286217,17286395,178,0,1,0,1
17286472,17286651,179,0,0,1,1
17286524,17286760,236,0,0,1,2
17286652,17286668,16,1,0,0,1
17286669,17288581,1912,0,0,1,1
17286761,17286775,14,1,0,0,2
17286776,17286826,50,0,0,1,2
17286827,17286836,9,1,0,0,2
17286837,17287605,768,0,0,1,2
17287606,17287641,35,1,0,0,2
17287642,17287959,317,0,0,1,2
17287960,17287964,4,1,0,0,2
17287965,17288099,134,0,0,1,2
17288110,17288112,2,0,1,0,2
17288122,17288144,22,1,0,0,2
17288145,17288369,224,0,0,1,2
17288370,17288418,48,1,0,0,2
17288419,17288532,113,0,0,1,2
17288533,17288845,312,1,0,0,2
17288582,17288806,224,1,0,0,1
17288587,17288796,209,0,1,0,2
17288609,17288768,159,0,1,0,1
17288807,17288937,130,0,0,1,1
17288846,17288947,101,0,0,1,2
17288938,17288951,13,1,0,0,1
17288948,17288960,12,1,0,0,2
17288952,17289061,109,0,0,1,1
17288961,17289061,100,0,0,1,2
17289062,17289069,7,1,0,0,1
17289062,17289082,20,1,0,0,2
17289070,17290688,1618,0,0,1,1
17289083,17290687,1604,0,0,1,2
17290688,17291392,704,1,0,0,2
17290689,17291323,634,1,0,0,1
17290712,17290886,174,0,1,0,1
17290713,17291381,668,0,1,0,2
17290933,17291123,190,0,1,0,1
17291159,17291297,138,0,1,0,1
17291324,17291492,168,0,0,1,1
17291393,17291488,95,0,0,1,2
17291489,17291575,86,1,0,0,2
17291493,17291586,93,1,0,0,1
17291576,17292082,506,0,0,1,2
17291587,17292081,494,0,0,1,1
17292082,17292133,51,1,0,0,1
17292083,17292133,50,1,0,0,2
17292134,17292235,101,0,0,1,1
17292134,17292235,101,0,0,1,2
17292236,17292262,26,1,0,0,2
17292236,17292266,30,1,0,0,1
17292263,17292392,129,0,0,1,2
17292267,17292389,122,0,0,1,1
17292390,17292412,22,1,0,0,1
17292393,17292411,18,1,0,0,2
17292412,17292725,313,0,0,1,2
17292413,17294714,2301,0,0,1,1
17292726,17292743,17,1,0,0,2
17292744,17292803,59,0,0,1,2
17292804,17292838,34,1,0,0,2
17292839,17292997,158,0,0,1,2
17292998,17293010,12,1,0,0,2
17293011,17294169,1158,0,0,1,2
17294170,17294175,5,1,0,0,2
17294176,17294209,33,0,0,1,2
17294210,17294319,109,1,0,0,2
17294320,17294474,154,0,0,1,2
17294475,17294522,47,1,0,0,2
17294523,17294636,113,0,0,1,2
17294637,17294687,50,1,0,0,2
17294688,17294715,27,0,0,1,2
17294715,17294785,70,1,0,0,1
17294716,17294768,52,1,0,0,2
17294769,17294909,140,0,0,1,2
17294786,17294914,128,0,0,1,1
17294910,17295163,253,1,0,0,2
17294915,17294929,14,1,0,0,1
17294930,17298358,3428,0,0,1,1
17295164,17295274,110,0,0,1,2
17295275,17295391,116,1,0,0,2
17295392,17295431,39,0,0,1,2
17295432,17295505,73,1,0,0,2
17295506,17295619,113,0,0,1,2
17295620,17295951,331,1,0,0,2
17295952,17296085,133,0,0,1,2
17296086,17296106,20,1,0,0,2
17296107,17296326,219,0,0,1,2
17296327,17296345,18,1,0,0,2
17296346,17297613,1267,0,0,1,2
17297614,17297618,4,1,0,0,2
17297619,17298363,744,0,0,1,2
17298359,17298573,214,1,0,0,1
17298364,17299059,695,1,0,0,2
17298387,17298556,169,0,1,0,2
17298389,17298532,143,0,1,0,1
17298574,17298598,24,0,0,1,1
17298599,17298828,229,1,0,0,1
17298614,17298804,190,0,1,0,2
17298618,17298777,159,0,1,0,1
17298829,17298864,35,0,0,1,1
17298865,17299040,175,1,0,0,1
17298884,17299017,133,0,1,0,2
17298887,17298996,109,0,1,0,1
17299041,17299158,117,0,0,1,1
17299060,17301044,1984,0,0,1,2
17299159,17299168,9,1,0,0,1
17299169,17301377,2208,0,0,1,1
17301045,17301076,31,1,0,0,2
17301077,17301211,134,0,0,1,2
17301212,17301235,23,1,0,0,2
17301236,17301382,146,0,0,1,2
17301378,17301436,58,1,0,0,1
17301383,17301474,91,1,0,0,2
17301437,17302828,1391,0,0,1,1
17301475,17301659,184,0,0,1,2
17301660,17301684,24,1,0,0,2
17301685,17301747,62,0,0,1,2
17301748,17301835,87,1,0,0,2
17301836,17302002,166,0,0,1,2
17302003,17302015,12,1,0,0,2
17302016,17302184,168,0,0,1,2
17302185,17302209,24,1,0,0,2
17302210,17302250,40,0,0,1,2
17302251,17302312,61,1,0,0,2
17302313,17302468,155,0,0,1,2
17302469,17302482,13,1,0,0,2
17302483,17302833,350,0,0,1,2
17302829,17302851,22,1,0,0,1
17302834,17302868,34,1,0,0,2
17302852,17303468,616,0,0,1,1
17302869,17303452,583,0,0,1,2
17303453,17304296,843,1,0,0,2
17303469,17304309,840,1,0,0,1
17303528,17304258,730,0,1,0,1
17303531,17304261,730,0,1,0,2
17304297,17304567,270,0,0,1,2
17304310,17304547,237,0,0,1,1
17304548,17304605,57,1,0,0,1
17304568,17304612,44,1,0,0,2
17304606,17304694,88,0,0,1,1
17304613,17304692,79,0,0,1,2
17304693,17304748,55,1,0,0,2
17304695,17304748,53,1,0,0,1
17304749,17304879,130,0,0,1,1
17304749,17304881,132,0,0,1,2
17304880,17304943,63,1,0,0,1
17304882,17304982,100,1,0,0,2
17304944,17305192,248,0,0,1,1
17304983,17305192,209,0,0,1,2
17305193,17305244,51,1,0,0,1
17305193,17305274,81,1,0,0,2
17305245,17305352,107,0,0,1,1
17305275,17305344,69,0,0,1,2
17305345,17305396,51,1,0,0,2
17305353,17305371,18,1,0,0,1
17305372,17305542,170,0,0,1,1
17305397,17305522,125,0,0,1,2
17305523,17305598,75,1,0,0,2
17305543,17305553,10,1,0,0,1
17305554,17305795,241,0,0,1,1
17305599,17305793,194,0,0,1,2
17305794,17305990,196,1,0,0,2
17305796,17305957,161,1,0,0,1
17305825,17305936,111,0,1,0,1
17305830,17305939,109,0,1,0,2
17305958,17308199,2241,0,0,1,1
17305991,17306151,160,0,0,1,2
17306152,17306166,14,1,0,0,2
17306167,17306675,508,0,0,1,2
17306676,17306712,36,1,0,0,2
17306713,17307382,669,0,0,1,2
17307383,17307463,80,1,0,0,2
17307464,17308198,734,0,0,1,2
17308199,17308362,163,1,0,0,2
17308200,17308245,45,1,0,0,1
17308246,17308350,104,0,0,1,1
17308351,17308367,16,1,0,0,1
17308363,17308549,186,0,0,1,2
17308368,17308554,186,0,0,1,1
17308550,17308569,19,1,0,0,2
17308555,17308566,11,1,0,0,1
17308567,17311995,3428,0,0,1,1
17308570,17309280,710,0,0,1,2
17309281,17309285,4,1,0,0,2
17309286,17309552,266,0,0,1,2
17309553,17309569,16,1,0,0,2
17309570,17309631,61,0,0,1,2
17309632,17309647,15,1,0,0,2
17309648,17309803,155,0,0,1,2
17309804,17309924,120,1,0,0,2
17309925,17311992,2067,0,0,1,2
17311993,17312255,262,1,0,0,2
17311996,17312225,229,1,0,0,1
17312041,17312195,154,0,1,0,1
17312047,17312191,144,0,1,0,2
17312226,17312360,134,0,0,1,1
17312256,17312362,106,0,0,1,2
17312361,17312370,9,1,0,0,1
17312363,17312372,9,1,0,0,2
17312371,17314943,2572,0,0,1,1
17312373,17314943,2570,0,0,1,2
17314944,17315009,65,1,0,0,2
17314944,17315010,66,1,0,0,1
17315010,17315217,207,0,0,1,2
17315011,17315219,208,0,0,1,1
17315218,17315236,18,1,0,0,2
17315220,17315235,15,1,0,0,1
17315236,17318618,3382,0,0,1,1
17315237,17318618,3381,0,0,1,2
17318619,17318886,267,1,0,0,1
17318619,17318894,275,1,0,0,2
17318653,17318872,219,0,1,0,2
17318654,17318850,196,0,1,0,1
17318887,17318918,31,0,0,1,1
17318895,17318922,27,0,0,1,2
17318919,17318970,51,1,0,0,1
17318923,17318958,35,1,0,0,2
17318959,17319113,154,0,0,1,2
17318971,17319115,144,0,0,1,1
17319114,17319135,21,1,0,0,2
17319116,17319130,14,1,0,0,1
17319131,17322298,3167,0,0,1,1
17319136,17321041,1905,0,0,1,2
17321042,17321134,92,1,0,0,2
17321135,17321593,458,0,0,1,2
17321594,17321614,20,1,0,0,2
17321615,17321722,107,0,0,1,2
17321723,17321796,73,1,0,0,2
17321797,17322182,385,0,0,1,2
17322183,17322202,19,1,0,0,2
17322203,17322290,87,0,0,1,2
17322291,17325404,3113,1,0,0,2
17322299,17322697,398,1,0,0,1
17322317,17322687,370,0,1,0,1
17322318,17325352,3034,0,1,0,2
17322698,17324259,1561,0,0,1,1
17324260,17325403,1143,1,0,0,1
17324286,17325088,802,0,1,0,1
17325131,17325296,165,0,1,0,1
17325404,17325438,34,0,0,1,1
17325405,17325441,36,0,0,1,2
17325439,17325464,25,1,0,0,1
17325442,17325486,44,1,0,0,2
17325465,17325722,257,0,0,1,1
17325487,17325722,235,0,0,1,2
17325723,17325781,58,1,0,0,1
17325723,17325907,184,1,0,0,2
17325782,17325872,90,0,0,1,1
17325873,17325910,37,1,0,0,1
17325908,17325950,42,0,0,1,2
17325911,17325952,41,0,0,1,1
17325951,17326245,294,1,0,0,2
17325953,17326205,252,1,0,0,1
17325977,17326192,215,0,1,0,2
17325978,17326176,198,0,1,0,1
17326206,17326318,112,0,0,1,1
17326246,17326304,58,0,0,1,2
17326305,17326341,36,1,0,0,2
17326319,17326323,4,1,0,0,1
17326324,17328224,1900,0,0,1,1
17326342,17326525,183,0,0,1,2
17326526,17326537,11,1,0,0,2
17326538,17326996,458,0,0,1,2
17326997,17327061,64,1,0,0,2
17327062,17327468,406,0,0,1,2
17327469,17327495,26,1,0,0,2
17327496,17327550,54,0,0,1,2
17327551,17327555,4,1,0,0,2
17327556,17327618,62,0,0,1,2
17327619,17327634,15,1,0,0,2
17327635,17328223,588,0,0,1,2
17328224,17328315,91,1,0,0,2
17328225,17328304,79,1,0,0,1
17328305,17331207,2902,0,0,1,1
17328316,17331207,2891,0,0,1,2
