start,end,duration,saccade,blink,fixation,eye
22619320,22619580,260,1,0,0,2
22619321,22619437,116,0,1,0,2
22619327,22619474,147,0,1,0,1
22619531,22619531,0,0,0,1,1
22619532,22619559,27,1,0,0,1
22619560,22619603,43,0,0,1,1
22619581,22619605,24,0,0,1,2
22619604,22619652,48,1,0,0,1
22619606,22619666,60,1,0,0,2
22619653,22619753,100,0,0,1,1
22619667,22619750,83,0,0,1,2
22619751,22619781,30,1,0,0,2
22619754,22619782,28,1,0,0,1
22619782,22619961,179,0,0,1,2
22619783,22619963,180,0,0,1,1
22619962,22619970,8,1,0,0,2
22619964,22619973,9,1,0,0,1
22619971,22620741,770,0,0,1,2
22619974,22622168,2194,0,0,1,1
22620742,22620751,9,1,0,0,2
22620752,22622165,1413,0,0,1,2
22622166,22622317,151,1,0,0,2
22622169,22622323,154,1,0,0,1
22622195,22622246,51,0,1,0,2
22622202,22622244,42,0,1,0,1
22622318,22622391,73,0,0,1,2
22622324,22622392,68,0,0,1,1
22622392,22622409,17,1,0,0,2
22622393,22622410,17,1,0,0,1
22622410,22622986,576,0,0,1,2
22622411,22622986,575,0,0,1,1
22622987,22623043,56,1,0,0,2
22622987,22623045,58,1,0,0,1
22623044,22623312,268,0,0,1,2
22623046,22623313,267,0,0,1,1
22623313,22623525,212,1,0,0,2
22623314,22623487,173,1,0,0,1
22623337,22623418,81,0,1,0,2
22623340,22623428,88,0,1,0,1
22623488,22623711,223,0,0,1,1
22623526,22623711,185,0,0,1,2
22623712,22623727,15,1,0,0,1
22623712,22623728,16,1,0,0,2
22623728,22626445,2717,0,0,1,1
22623729,22624589,860,0,0,1,2
22624590,22624598,8,1,0,0,2
22624599,22625838,1239,0,0,1,2
22625839,22625853,14,1,0,0,2
22625854,22626443,589,0,0,1,2
22626444,22626455,11,1,0,0,2
22626446,22626454,8,1,0,0,1
22626455,22627552,1097,0,0,1,1
22626456,22627550,1094,0,0,1,2
22627551,22628358,807,1,0,0,2
22627553,22628372,819,1,0,0,1
22627630,22628361,731,0,1,0,1
22627631,22628342,711,0,1,0,2
22628359,22628478,119,0,0,1,2
22628373,22628475,102,0,0,1,1
22628476,22628501,25,1,0,0,1
22628479,22628501,22,1,0,0,2
22628502,22628775,273,0,0,1,2
22628502,22628776,274,0,0,1,1
22628776,22628784,8,1,0,0,2
22628777,22628797,20,1,0,0,1
22628785,22629032,247,0,0,1,2
22628798,22629030,232,0,0,1,1
22629031,22629216,185,1,0,0,1
22629033,22629249,216,1,0,0,2
22629057,22629158,101,0,1,0,2
22629058,22629160,102,0,1,0,1
22629217,22629351,134,0,0,1,1
22629250,22629351,101,0,0,1,2
22629352,22629368,16,1,0,0,1
22629352,22629371,19,1,0,0,2
22629369,22631701,2332,0,0,1,1
22629372,22630703,1331,0,0,1,2
22630704,22630712,8,1,0,0,2
22630713,22631701,988,0,0,1,2
22631702,22631776,74,1,0,0,2
22631702,22631777,75,1,0,0,1
22631777,22631930,153,0,0,1,2
22631778,22631919,141,0,0,1,1
22631920,22631946,26,1,0,0,1
22631931,22631947,16,1,0,0,2
22631947,22633177,1230,0,0,1,1
22631948,22633613,1665,0,0,1,2
22633178,22633188,10,1,0,0,1
22633189,22633362,173,0,0,1,1
22633363,22633388,25,1,0,0,1
22633389,22633620,231,0,0,1,1
22633614,22633927,313,1,0,0,2
22633621,22636950,3329,1,0,0,1
22633646,22633840,194,0,1,0,1
22633646,22633860,214,0,1,0,2
22633879,22633905,26,0,1,0,1
22633928,22633958,30,0,0,1,2
22633959,22633968,9,1,0,0,2
22633969,22634638,669,0,0,1,2
22634639,22634654,15,1,0,0,2
22634655,22636839,2184,0,0,1,2
22636840,22636908,68,1,0,0,2
22636909,22636990,81,0,0,1,2
22636951,22636991,40,0,0,1,1
22636991,22639428,2437,1,0,0,2
22636992,22640255,3263,1,0,0,1
22639429,22639460,31,0,0,1,2
22639461,22640371,910,1,0,0,2
22640256,22640328,72,0,0,1,1
22640329,22640372,43,1,0,0,1
22640372,22640505,133,0,0,1,2
22640373,22640506,133,0,0,1,1
22640506,22640523,17,1,0,0,2
22640507,22640524,17,1,0,0,1
22640524,22643173,2649,0,0,1,2
22640525,22643173,2648,0,0,1,1
22643174,22643241,67,1,0,0,1
22643174,22643242,68,1,0,0,2
22643242,22643330,88,0,0,1,1
22643243,22643328,85,0,0,1,2
22643329,22643359,30,1,0,0,2
22643331,22643356,25,1,0,0,1
22643357,22643507,150,0,0,1,1
22643360,22643508,148,0,0,1,2
22643508,22643526,18,1,0,0,1
22643509,22643517,8,1,0,0,2
22643518,22645655,2137,0,0,1,2
22643527,22646091,2564,0,0,1,1
22645656,22645684,28,1,0,0,2
22645685,22646090,405,0,0,1,2
22646091,22646141,50,1,0,0,2
22646092,22646149,57,1,0,0,1
22646142,22646263,121,0,0,1,2
22646150,22646262,112,0,0,1,1
22646263,22646271,8,1,0,0,1
22646264,22646277,13,1,0,0,2
22646272,22648590,2318,0,0,1,1
22646278,22646721,443,0,0,1,2
22646722,22646738,16,1,0,0,2
22646739,22647259,520,0,0,1,2
22647260,22647269,9,1,0,0,2
22647270,22648590,1320,0,0,1,2
22648591,22648628,37,1,0,0,2
22648591,22648631,40,1,0,0,1
22648629,22648741,112,0,0,1,2
22648632,22648740,108,0,0,1,1
22648741,22648772,31,1,0,0,1
22648742,22648772,30,1,0,0,2
22648773,22648832,59,0,0,1,2
22648773,22650532,1759,0,0,1,1
22648833,22649133,300,1,0,0,2
22649134,22649993,859,0,0,1,2
22649994,22650258,264,1,0,0,2
22650259,22650347,88,0,0,1,2
22650348,22650455,107,1,0,0,2
22650456,22650532,76,0,0,1,2
22650533,22650567,34,1,0,0,1
22650533,22651100,567,1,0,0,2
22650568,22651018,450,0,0,1,1
22651019,22651098,79,1,0,0,1
22651099,22651192,93,0,0,1,1
22651101,22651195,94,0,0,1,2
22651193,22651214,21,1,0,0,1
22651196,22651212,16,1,0,0,2
22651213,22653329,2116,0,0,1,2
22651215,22651768,553,0,0,1,1
22651769,22651779,10,1,0,0,1
22651780,22652883,1103,0,0,1,1
22652884,22652893,9,1,0,0,1
22652894,22653328,434,0,0,1,1
22653329,22653397,68,1,0,0,1
22653330,22653403,73,1,0,0,2
22653398,22653540,142,0,0,1,1
22653404,22653541,137,0,0,1,2
22653541,22653616,75,1,0,0,1
22653542,22653613,71,1,0,0,2
22653614,22653706,92,0,0,1,2
22653617,22653703,86,0,0,1,1
22653704,22653728,24,1,0,0,1
22653707,22653744,37,1,0,0,2
22653729,22655663,1934,0,0,1,1
22653745,22653891,146,0,0,1,2
22653892,22653896,4,1,0,0,2
22653897,22654386,489,0,0,1,2
22654387,22654395,8,1,0,0,2
22654396,22655663,1267,0,0,1,2
22655664,22655712,48,1,0,0,1
22655664,22655713,49,1,0,0,2
22655713,22655843,130,0,0,1,1
22655714,22655844,130,0,0,1,2
22655844,22655904,60,1,0,0,1
22655845,22655912,67,1,0,0,2
22655905,22655991,86,0,0,1,1
22655913,22656002,89,0,0,1,2
22655992,22656020,28,1,0,0,1
22656003,22656025,22,1,0,0,2
22656021,22656412,391,0,0,1,1
22656026,22656891,865,0,0,1,2
22656413,22656430,17,1,0,0,1
22656431,22657355,924,0,0,1,1
22656892,22656896,4,1,0,0,2
22656897,22657241,344,0,0,1,2
22657242,22657272,30,1,0,0,2
22657273,22657698,425,0,0,1,2
22657356,22657453,97,1,0,0,1
22657454,22657708,254,0,0,1,1
22657699,22657719,20,1,0,0,2
22657709,22657776,67,1,0,0,1
22657720,22658011,291,0,0,1,2
22657777,22657997,220,0,0,1,1
22657998,22658057,59,1,0,0,1
22658012,22658072,60,1,0,0,2
22658058,22658396,338,0,0,1,1
22658073,22658398,325,0,0,1,2
22658397,22658471,74,1,0,0,1
22658399,22658474,75,1,0,0,2
22658472,22658549,77,0,0,1,1
22658475,22658549,74,0,0,1,2
22658550,22658587,37,1,0,0,1
22658550,22658587,37,1,0,0,2
22658588,22658700,112,0,0,1,1
22658588,22658704,116,0,0,1,2
22658701,22658717,16,1,0,0,1
22658705,22658717,12,1,0,0,2
22658718,22660576,1858,0,0,1,1
22658718,22660578,1860,0,0,1,2
22660577,22660648,71,1,0,0,1
22660579,22660648,69,1,0,0,2
22660649,22660749,100,0,0,1,2
22660649,22660752,103,0,0,1,1
22660750,22660799,49,1,0,0,2
22660753,22660800,47,1,0,0,1
22660800,22660918,118,0,0,1,2
22660801,22660916,115,0,0,1,1
22660917,22660961,44,1,0,0,1
22660919,22660960,41,1,0,0,2
22660961,22662752,1791,0,0,1,2
22660962,22661200,238,0,0,1,1
22661201,22661210,9,1,0,0,1
22661211,22662479,1268,0,0,1,1
22662480,22662488,8,1,0,0,1
22662489,22663230,741,0,0,1,1
22662753,22662982,229,1,0,0,2
22662983,22663229,246,0,0,1,2
22663230,22663305,75,1,0,0,2
22663231,22663296,65,1,0,0,1
22663297,22663374,77,0,0,1,1
22663306,22663377,71,0,0,1,2
22663375,22663447,72,1,0,0,1
22663378,22663444,66,1,0,0,2
22663445,22663682,237,0,0,1,2
22663448,22666434,2986,0,0,1,1
22663683,22663687,4,1,0,0,2
22663688,22665415,1727,0,0,1,2
22665416,22665424,8,1,0,0,2
22665425,22666435,1010,0,0,1,2
22666435,22666487,52,1,0,0,1
22666436,22666486,50,1,0,0,2
22666487,22666792,305,0,0,1,2
22666488,22666791,303,0,0,1,1
22666792,22666870,78,1,0,0,1
22666793,22666841,48,1,0,0,2
22666842,22666946,104,0,0,1,2
22666871,22666945,74,0,0,1,1
22666946,22667009,63,1,0,0,1
22666947,22666971,24,1,0,0,2
22666972,22667138,166,0,0,1,2
22667010,22667083,73,0,0,1,1
22667084,22667099,15,1,0,0,1
22667100,22667551,451,0,0,1,1
22667139,22667155,16,1,0,0,2
22667156,22668897,1741,0,0,1,2
22667552,22667563,11,1,0,0,1
22667564,22667720,156,0,0,1,1
22667721,22667737,16,1,0,0,1
22667738,22667902,164,0,0,1,1
22667903,22667918,15,1,0,0,1
22667919,22668898,979,0,0,1,1
22668898,22668946,48,1,0,0,2
22668899,22668946,47,1,0,0,1
22668947,22669322,375,0,0,1,1
22668947,22669322,375,0,0,1,2
22669323,22669431,108,1,0,0,1
22669323,22669431,108,1,0,0,2
22669432,22669484,52,0,0,1,1
22669432,22669486,54,0,0,1,2
22669485,22669524,39,1,0,0,1
22669487,22669523,36,1,0,0,2
22669524,22669658,134,0,0,1,2
22669525,22669659,134,0,0,1,1
22669659,22669676,17,1,0,0,2
22669660,22669677,17,1,0,0,1
22669677,22670742,1065,0,0,1,2
22669678,22670742,1064,0,0,1,1
22670743,22670753,10,1,0,0,1
22670743,22670753,10,1,0,0,2
22670754,22671715,961,0,0,1,2
22670754,22671716,962,0,0,1,1
22671716,22671778,62,1,0,0,2
22671717,22671780,63,1,0,0,1
22671779,22671944,165,0,0,1,2
22671781,22671945,164,0,0,1,1
22671945,22671996,51,1,0,0,2
22671946,22671997,51,1,0,0,1
22671997,22672119,122,0,0,1,2
22671998,22672124,126,0,0,1,1
22672120,22672138,18,1,0,0,2
22672125,22672133,8,1,0,0,1
22672134,22672471,337,0,0,1,1
22672139,22672464,325,0,0,1,2
22672465,22672481,16,1,0,0,2
22672472,22672480,8,1,0,0,1
22672481,22673852,1371,0,0,1,1
22672482,22673852,1370,0,0,1,2
22673853,22673907,54,1,0,0,1
22673853,22673928,75,1,0,0,2
22673908,22674048,140,0,0,1,1
22673929,22674048,119,0,0,1,2
22674049,22674057,8,1,0,0,2
22674049,22674059,10,1,0,0,1
22674058,22676119,2061,0,0,1,2
22674060,22675354,1294,0,0,1,1
22675355,22675359,4,1,0,0,1
22675360,22676126,766,0,0,1,1
22676120,22676139,19,1,0,0,2
22676127,22676140,13,1,0,0,1
22676140,22676834,694,0,0,1,2
22676141,22676834,693,0,0,1,1
22676835,22676909,74,1,0,0,1
22676835,22676915,80,1,0,0,2
22676910,22676990,80,0,0,1,1
22676916,22676990,74,0,0,1,2
22676991,22677031,40,1,0,0,1
22676991,22677038,47,1,0,0,2
22677032,22678302,1270,0,0,1,1
22677039,22677202,163,0,0,1,2
22677203,22677212,9,1,0,0,2
22677213,22678304,1091,0,0,1,2
22678303,22678324,21,1,0,0,1
22678305,22678326,21,1,0,0,2
22678325,22678449,124,0,0,1,1
22678327,22678449,122,0,0,1,2
22678450,22678466,16,1,0,0,2
22678450,22678468,18,1,0,0,1
22678467,22679409,942,0,0,1,2
22678469,22678515,46,0,0,1,1
22678516,22678530,14,1,0,0,1
22678531,22678910,379,0,0,1,1
22678911,22679009,98,1,0,0,1
22679010,22679058,48,0,0,1,1
22679059,22679146,87,1,0,0,1
22679147,22679408,261,0,0,1,1
22679409,22679475,66,1,0,0,1
22679410,22679463,53,1,0,0,2
22679464,22679567,103,0,0,1,2
22679476,22679568,92,0,0,1,1
22679568,22679604,36,1,0,0,2
22679569,22679603,34,1,0,0,1
22679604,22679780,176,0,0,1,1
22679605,22679779,174,0,0,1,2
22679780,22679790,10,1,0,0,2
22679781,22679789,8,1,0,0,1
22679790,22679999,209,0,0,1,1
22679791,22679998,207,0,0,1,2
22679999,22680011,12,1,0,0,2
22680000,22680016,16,1,0,0,1
22680012,22682054,2042,0,0,1,2
22680017,22682054,2037,0,0,1,1
22682055,22682117,62,1,0,0,1
22682055,22682121,66,1,0,0,2
22682118,22682264,146,0,0,1,1
22682122,22682268,146,0,0,1,2
22682265,22682286,21,1,0,0,1
22682269,22682286,17,1,0,0,2
22682287,22683970,1683,0,0,1,1
22682287,22683970,1683,0,0,1,2
22683971,22684000,29,1,0,0,2
22683971,22684002,31,1,0,0,1
22684001,22684411,410,0,0,1,2
22684003,22684409,406,0,0,1,1
22684410,22684463,53,1,0,0,1
22684412,22684467,55,1,0,0,2
22684464,22684574,110,0,0,1,1
22684468,22684573,105,0,0,1,2
22684574,22684592,18,1,0,0,2
22684575,22684591,16,1,0,0,1
22684592,22684751,159,0,0,1,1
22684593,22684752,159,0,0,1,2
22684752,22684762,10,1,0,0,1
22684753,22684764,11,1,0,0,2
22684763,22686766,2003,0,0,1,1
22684765,22686767,2002,0,0,1,2
22686767,22686840,73,1,0,0,1
22686768,22686836,68,1,0,0,2
22686837,22686926,89,0,0,1,2
22686841,22686927,86,0,0,1,1
22686927,22686953,26,1,0,0,2
22686928,22686955,27,1,0,0,1
22686954,22687096,142,0,0,1,2
22686956,22687097,141,0,0,1,1
22687097,22687113,16,1,0,0,2
22687098,22687113,15,1,0,0,1
22687114,22689038,1924,0,0,1,1
22687114,22689038,1924,0,0,1,2
22689039,22689106,67,1,0,0,2
22689039,22689113,74,1,0,0,1
22689107,22689207,100,0,0,1,2
22689114,22689208,94,0,0,1,1
22689208,22689229,21,1,0,0,2
22689209,22689229,20,1,0,0,1
22689230,22689418,188,0,0,1,1
22689230,22689795,565,0,0,1,2
22689419,22689427,8,1,0,0,1
22689428,22689590,162,0,0,1,1
22689591,22689605,14,1,0,0,1
22689606,22689795,189,0,0,1,1
22689796,22689801,5,1,0,0,1
22689796,22689805,9,1,0,0,2
22689802,22691178,1376,0,0,1,1
22689806,22691178,1372,0,0,1,2
22691179,22691239,60,1,0,0,1
22691179,22691241,62,1,0,0,2
22691240,22691327,87,0,0,1,1
22691242,22691328,86,0,0,1,2
22691328,22691356,28,1,0,0,1
22691329,22691353,24,1,0,0,2
22691354,22691513,159,0,0,1,2
22691357,22691517,160,0,0,1,1
22691514,22691528,14,1,0,0,2
22691518,22691526,8,1,0,0,1
22691527,22692978,1451,0,0,1,1
22691529,22692976,1447,0,0,1,2
22692977,22693026,49,1,0,0,2
22692979,22693027,48,1,0,0,1
22693027,22693391,364,0,0,1,2
22693028,22693391,363,0,0,1,1
22693392,22693452,60,1,0,0,2
22693392,22693455,63,1,0,0,1
22693453,22693591,138,0,0,1,2
22693456,22693594,138,0,0,1,1
22693592,22693609,17,1,0,0,2
22693595,22693609,14,1,0,0,1
22693610,22695397,1787,0,0,1,1
22693610,22695397,1787,0,0,1,2
22695398,22695506,108,1,0,0,1
22695398,22695507,109,1,0,0,2
22695507,22695652,145,0,0,1,1
22695508,22695652,144,0,0,1,2
22695653,22695715,62,1,0,0,2
22695653,22695716,63,1,0,0,1
22695716,22695813,97,0,0,1,2
22695717,22695813,96,0,0,1,1
22695814,22695833,19,1,0,0,2
22695814,22695835,21,1,0,0,1
22695834,22696004,170,0,0,1,2
22695836,22696001,165,0,0,1,1
22696002,22696017,15,1,0,0,1
22696005,22696015,10,1,0,0,2
22696016,22696642,626,0,0,1,2
22696018,22696640,622,0,0,1,1
22696641,22696660,19,1,0,0,1
22696643,22696657,14,1,0,0,2
22696658,22697008,350,0,0,1,2
22696661,22697008,347,0,0,1,1
22697009,22697016,7,1,0,0,1
22697009,22697016,7,1,0,0,2
22697017,22697553,536,0,0,1,2
22697017,22697554,537,0,0,1,1
22697554,22697613,59,1,0,0,2
22697555,22697613,58,1,0,0,1
22697614,22698034,420,0,0,1,1
22697614,22698034,420,0,0,1,2
22698035,22698076,41,1,0,0,1
22698035,22698077,42,1,0,0,2
22698077,22698207,130,0,0,1,1
22698078,22698209,131,0,0,1,2
22698208,22698225,17,1,0,0,1
22698210,22698224,14,1,0,0,2
22698225,22700022,1797,0,0,1,2
22698226,22700021,1795,0,0,1,1
22700022,22700059,37,1,0,0,1
22700023,22700059,36,1,0,0,2
22700060,22700153,93,0,0,1,1
22700060,22700153,93,0,0,1,2
22700154,22700174,20,1,0,0,1
22700154,22700177,23,1,0,0,2
22700175,22701342,1167,0,0,1,1
22700178,22701342,1164,0,0,1,2
22701343,22701353,10,1,0,0,1
22701343,22701369,26,1,0,0,2
22701354,22701959,605,0,0,1,1
22701370,22701959,589,0,0,1,2
22701960,22702013,53,1,0,0,2
22701960,22702018,58,1,0,0,1
22702014,22702120,106,0,0,1,2
22702019,22702118,99,0,0,1,1
22702119,22702141,22,1,0,0,1
22702121,22702140,19,1,0,0,2
22702141,22704074,1933,0,0,1,2
22702142,22704075,1933,0,0,1,1
22704075,22704118,43,1,0,0,2
22704076,22704118,42,1,0,0,1
22704119,22704329,210,0,0,1,2
22704119,22704330,211,0,0,1,1
22704330,22704339,9,1,0,0,2
22704331,22704341,10,1,0,0,1
22704340,22706090,1750,0,0,1,2
22704342,22706090,1748,0,0,1,1
22706091,22706172,81,1,0,0,2
22706091,22706177,86,1,0,0,1
22706173,22706301,128,0,0,1,2
22706178,22706300,122,0,0,1,1
22706301,22706327,26,1,0,0,1
22706302,22706328,26,1,0,0,2
22706328,22706710,382,0,0,1,1
22706329,22708209,1880,0,0,1,2
22706711,22706715,4,1,0,0,1
22706716,22708208,1492,0,0,1,1
22708209,22708285,76,1,0,0,1
22708210,22708281,71,1,0,0,2
22708282,22708375,93,0,0,1,2
22708286,22708373,87,0,0,1,1
22708374,22708396,22,1,0,0,1
22708376,22708397,21,1,0,0,2
22708397,22709805,1408,0,0,1,1
22708398,22709805,1407,0,0,1,2
22709806,22709858,52,1,0,0,2
22709806,22709867,61,1,0,0,1
22709859,22710092,233,0,0,1,2
22709868,22710091,223,0,0,1,1
22710092,22710144,52,1,0,0,1
22710093,22710145,52,1,0,0,2
22710145,22710280,135,0,0,1,1
22710146,22710282,136,0,0,1,2
22710281,22710363,82,1,0,0,1
22710283,22710363,80,1,0,0,2
22710364,22710458,94,0,0,1,1
22710364,22710458,94,0,0,1,2
22710459,22710486,27,1,0,0,2
22710459,22710499,40,1,0,0,1
22710487,22710655,168,0,0,1,2
22710500,22710658,158,0,0,1,1
22710656,22710666,10,1,0,0,2
22710659,22710666,7,1,0,0,1
22710667,22712211,1544,0,0,1,1
22710667,22712215,1548,0,0,1,2
22712212,22712288,76,1,0,0,1
22712216,22712298,82,1,0,0,2
22712289,22712387,98,0,0,1,1
22712299,22712387,88,0,0,1,2
22712388,22712453,65,1,0,0,1
22712388,22712463,75,1,0,0,2
22712454,22712536,82,0,0,1,1
22712464,22712537,73,0,0,1,2
22712537,22712568,31,1,0,0,1
22712538,22712569,31,1,0,0,2
22712569,22714292,1723,0,0,1,1
22712570,22714291,1721,0,0,1,2
22714292,22714371,79,1,0,0,2
22714293,22714376,83,1,0,0,1
22714372,22714495,123,0,0,1,2
22714377,22714495,118,0,0,1,1
22714496,22714517,21,1,0,0,1
22714496,22714519,23,1,0,0,2
22714518,22716170,1652,0,0,1,1
22714520,22715480,960,0,0,1,2
22715481,22715486,5,1,0,0,2
22715487,22716170,683,0,0,1,2
22716171,22716218,47,1,0,0,1
22716171,22716221,50,1,0,0,2
22716219,22716543,324,0,0,1,1
22716222,22716543,321,0,0,1,2
22716544,22716605,61,1,0,0,2
22716544,22716606,62,1,0,0,1
22716606,22716748,142,0,0,1,2
22716607,22716748,141,0,0,1,1
22716749,22716762,13,1,0,0,1
22716749,22716765,16,1,0,0,2
22716763,22717388,625,0,0,1,1
22716766,22718506,1740,0,0,1,2
22717389,22717403,14,1,0,0,1
22717404,22718503,1099,0,0,1,1
22718504,22718569,65,1,0,0,1
22718507,22718580,73,1,0,0,2
22718570,22718691,121,0,0,1,1
22718581,22718689,108,0,0,1,2
22718690,22718699,9,1,0,0,2
22718692,22718705,13,1,0,0,1
22718700,22720489,1789,0,0,1,2
22718706,22719386,680,0,0,1,1
22719387,22719393,6,1,0,0,1
22719394,22720491,1097,0,0,1,1
22720490,22720578,88,1,0,0,2
22720492,22720596,104,1,0,0,1
22720579,22720680,101,0,0,1,2
22720597,22720679,82,0,0,1,1
22720680,22720709,29,1,0,0,1
22720681,22720703,22,1,0,0,2
22720704,22720859,155,0,0,1,2
22720710,22720860,150,0,0,1,1
22720860,22720876,16,1,0,0,2
22720861,22720877,16,1,0,0,1
22720877,22722535,1658,0,0,1,2
22720878,22722537,1659,0,0,1,1
22722536,22722617,81,1,0,0,2
22722538,22722631,93,1,0,0,1
22722618,22722704,86,0,0,1,2
22722632,22722703,71,0,0,1,1
22722704,22722793,89,1,0,0,1
22722705,22722738,33,1,0,0,2
22722739,22724670,1931,0,0,1,2
22722794,22722839,45,0,0,1,1
22722840,22722876,36,1,0,0,1
22722877,22723015,138,0,0,1,1
22723016,22723110,94,1,0,0,1
22723111,22723425,314,0,0,1,1
22723426,22723554,128,1,0,0,1
22723555,22723642,87,0,0,1,1
22723643,22723715,72,1,0,0,1
22723716,22723825,109,0,0,1,1
22723826,22723918,92,1,0,0,1
22723919,22724035,116,0,0,1,1
22724036,22724073,37,1,0,0,1
22724074,22724130,56,0,0,1,1
22724131,22724146,15,1,0,0,1
22724147,22724167,20,0,0,1,1
22724168,22724207,39,1,0,0,1
22724208,22724341,133,0,0,1,1
22724342,22724411,69,1,0,0,1
22724412,22724476,64,0,0,1,1
22724477,22724608,131,1,0,0,1
22724609,22724672,63,0,0,1,1
22724671,22724750,79,1,0,0,2
22724673,22724752,79,1,0,0,1
22724751,22724822,71,0,0,1,2
22724753,22724821,68,0,0,1,1
22724822,22724865,43,1,0,0,1
22724823,22724858,35,1,0,0,2
22724859,22726744,1885,0,0,1,2
22724866,22726744,1878,0,0,1,1
22726745,22726864,119,1,0,0,1
22726745,22727283,538,1,0,0,2
22726865,22726979,114,0,0,1,1
22726980,22727001,21,1,0,0,1
22727002,22727180,178,0,0,1,1
22727181,22727190,9,1,0,0,1
22727191,22728562,1371,0,0,1,1
22727284,22727314,30,0,0,1,2
22727315,22727438,123,1,0,0,2
22727439,22727534,95,0,0,1,2
22727535,22727698,163,1,0,0,2
22727699,22727812,113,0,0,1,2
22727813,22727829,16,1,0,0,2
22727830,22728031,201,0,0,1,2
22728032,22728044,12,1,0,0,2
22728045,22728395,350,0,0,1,2
22728396,22728753,357,1,0,0,2
22728563,22728653,90,1,0,0,1
22728654,22729023,369,0,0,1,1
22728754,22728882,128,0,0,1,2
22728883,22728904,21,1,0,0,2
22728905,22729022,117,0,0,1,2
22729023,22729094,71,1,0,0,2
22729024,22729087,63,1,0,0,1
22729088,22729268,180,0,0,1,1
22729095,22731199,2104,0,0,1,2
22729269,22729277,8,1,0,0,1
22729278,22731198,1920,0,0,1,1
22731199,22731352,153,1,0,0,1
22731200,22731328,128,1,0,0,2
22731329,22731499,170,0,0,1,2
22731353,22731407,54,0,0,1,1
22731408,22731436,28,1,0,0,1
22731437,22731520,83,0,0,1,1
22731500,22731521,21,1,0,0,2
22731521,22731542,21,1,0,0,1
22731522,22731590,68,0,0,1,2
22731543,22731689,146,0,0,1,1
22731591,22731802,211,1,0,0,2
22731690,22731696,6,1,0,0,1
22731697,22732099,402,0,0,1,1
22731803,22731836,33,0,0,1,2
22731837,22731858,21,1,0,0,2
22731859,22731979,120,0,0,1,2
22731980,22732715,735,1,0,0,2
22732100,22732117,17,1,0,0,1
22732118,22732335,217,0,0,1,1
22732336,22732366,30,1,0,0,1
22732367,22732525,158,0,0,1,1
22732526,22732545,19,1,0,0,1
22732546,22732852,306,0,0,1,1
22732716,22732808,92,0,0,1,2
22732809,22732947,138,1,0,0,2
22732853,22732936,83,1,0,0,1
22732937,22733120,183,0,0,1,1
22732948,22733120,172,0,0,1,2
22733121,22733164,43,1,0,0,1
22733121,22733164,43,1,0,0,2
22733165,22733434,269,0,0,1,2
22733165,22733435,270,0,0,1,1
22733435,22733489,54,1,0,0,2
22733436,22733488,52,1,0,0,1
22733489,22733596,107,0,0,1,1
22733490,22733595,105,0,0,1,2
22733596,22733618,22,1,0,0,2
22733597,22733620,23,1,0,0,1
22733619,22733994,375,0,0,1,2
22733621,22733700,79,0,0,1,1
22733701,22733756,55,1,0,0,1
22733757,22735325,1568,0,0,1,1
22733995,22734034,39,1,0,0,2
22734035,22734178,143,0,0,1,2
22734179,22734247,68,1,0,0,2
22734248,22734378,130,0,0,1,2
22734379,22734420,41,1,0,0,2
22734421,22734880,459,0,0,1,2
22734881,22734991,110,1,0,0,2
22734992,22735029,37,0,0,1,2
22735030,22735045,15,1,0,0,2
22735046,22735326,280,0,0,1,2
22735326,22735407,81,1,0,0,1
22735327,22735448,121,1,0,0,2
22735408,22735486,78,0,0,1,1
22735449,22735490,41,0,0,1,2
22735487,22735532,45,1,0,0,1
22735491,22737442,1951,1,0,0,2
22735533,22735706,173,0,0,1,1
22735707,22735785,78,1,0,0,1
22735786,22735837,51,0,0,1,1
22735838,22735855,17,1,0,0,1
22735856,22735925,69,0,0,1,1
22735926,22735969,43,1,0,0,1
22735970,22736153,183,0,0,1,1
22736154,22737445,1291,1,0,0,1
22736194,22737116,922,0,1,0,1
22737356,22737357,1,0,1,0,1
22737443,22737515,72,0,0,1,2
22737446,22737515,69,0,0,1,1
22737516,22737550,34,1,0,0,2
22737516,22737554,38,1,0,0,1
22737551,22737686,135,0,0,1,2
22737555,22737685,130,0,0,1,1
22737686,22737702,16,1,0,0,1
22737687,22737703,16,1,0,0,2
22737703,22739189,1486,0,0,1,1
22737704,22739190,1486,0,0,1,2
22739190,22739314,124,1,0,0,1
22739191,22739313,122,1,0,0,2
22739314,22739413,99,0,0,1,2
22739315,22739411,96,0,0,1,1
22739412,22739527,115,1,0,0,1
22739414,22739487,73,1,0,0,2
22739488,22739600,112,0,0,1,2
22739528,22739608,80,0,0,1,1
22739601,22739644,43,1,0,0,2
22739609,22740263,654,1,0,0,1
22739645,22739811,166,0,0,1,2
22739812,22739826,14,1,0,0,2
22739827,22739938,111,0,0,1,2
22739939,22741013,1074,1,0,0,2
22740264,22740325,61,0,0,1,1
22740326,22740998,672,1,0,0,1
22740999,22741364,365,0,0,1,1
22741014,22741366,352,0,0,1,2
22741365,22741453,88,1,0,0,1
22741367,22741433,66,1,0,0,2
22741434,22741533,99,0,0,1,2
22741454,22741533,79,0,0,1,1
22741534,22741553,19,1,0,0,2
22741534,22741590,56,1,0,0,1
22741554,22743195,1641,0,0,1,2
22741591,22741705,114,0,0,1,1
22741706,22741744,38,1,0,0,1
22741745,22742254,509,0,0,1,1
22742255,22742259,4,1,0,0,1
22742260,22743191,931,0,0,1,1
22743192,22743261,69,1,0,0,1
22743196,22743259,63,1,0,0,2
22743260,22743416,156,0,0,1,2
22743262,22743415,153,0,0,1,1
22743416,22743525,109,1,0,0,1
22743417,22743507,90,1,0,0,2
22743508,22743575,67,0,0,1,2
22743526,22743576,50,0,0,1,1
22743576,22743617,41,1,0,0,2
22743577,22743635,58,1,0,0,1
22743618,22744527,909,0,0,1,2
22743636,22743731,95,0,0,1,1
22743732,22743747,15,1,0,0,1
22743748,22743786,38,0,0,1,1
22743787,22743823,36,1,0,0,1
22743824,22743874,50,0,0,1,1
22743875,22745375,1500,1,0,0,1
22744528,22744947,419,1,0,0,2
22744566,22744769,203,0,1,0,2
22744577,22744885,308,0,1,0,1
22744948,22745221,273,0,0,1,2
22745222,22745359,137,1,0,0,2
22745360,22745795,435,0,0,1,2
22745376,22745798,422,0,0,1,1
22745796,22745848,52,1,0,0,2
22745799,22745850,51,1,0,0,1
22745849,22746601,752,0,0,1,2
22745851,22746612,761,0,0,1,1
22746602,22746815,213,1,0,0,2
22746613,22746757,144,1,0,0,1
22746630,22746714,84,0,1,0,2
22746642,22746714,72,0,1,0,1
22746758,22747144,386,0,0,1,1
22746816,22747146,330,0,0,1,2
22747145,22747200,55,1,0,0,1
22747147,22747196,49,1,0,0,2
22747197,22747364,167,0,0,1,2
22747201,22747366,165,0,0,1,1
22747365,22747418,53,1,0,0,2
22747367,22747417,50,1,0,0,1
22747418,22747878,460,0,0,1,1
22747419,22747879,460,0,0,1,2
22747879,22747906,27,1,0,0,1
22747880,22747903,23,1,0,0,2
22747904,22748763,859,0,0,1,2
22747907,22748763,856,0,0,1,1
22748764,22748819,55,1,0,0,1
22748764,22748820,56,1,0,0,2
22748820,22749001,181,0,0,1,1
22748821,22749002,181,0,0,1,2
22749002,22749055,53,1,0,0,1
22749003,22749056,53,1,0,0,2
22749056,22749212,156,0,0,1,1
22749057,22749201,144,0,0,1,2
22749202,22749418,216,1,0,0,2
22749213,22749386,173,1,0,0,1
22749230,22749332,102,0,1,0,2
22749234,22749344,110,0,1,0,1
22749387,22749802,415,0,0,1,1
22749419,22749800,381,0,0,1,2
22749801,22749835,34,1,0,0,2
22749803,22749836,33,1,0,0,1
22749836,22750073,237,0,0,1,2
22749837,22750072,235,0,0,1,1
22750073,22750134,61,1,0,0,1
22750074,22750134,60,1,0,0,2
22750135,22750447,312,0,0,1,1
22750135,22750450,315,0,0,1,2
22750448,22750518,70,1,0,0,1
22750451,22750517,66,1,0,0,2
22750518,22750907,389,0,0,1,2
22750519,22750907,388,0,0,1,1
22750908,22750941,33,1,0,0,2
22750908,22750942,34,1,0,0,1
22750942,22751245,303,0,0,1,2
22750943,22751248,305,0,0,1,1
22751246,22751314,68,1,0,0,2
22751249,22751301,52,1,0,0,1
22751302,22751585,283,0,0,1,1
22751315,22751584,269,0,0,1,2
22751585,22751634,49,1,0,0,2
22751586,22751634,48,1,0,0,1
22751635,22751738,103,0,0,1,2
22751635,22751743,108,0,0,1,1
22751739,22751970,231,1,0,0,2
22751744,22751961,217,1,0,0,1
22751763,22751875,112,0,1,0,2
22751771,22751893,122,0,1,0,1
22751962,22752619,657,0,0,1,1
22751971,22752618,647,0,0,1,2
22752619,22752650,31,1,0,0,2
22752620,22752645,25,1,0,0,1
22752646,22753005,359,0,0,1,1
22752651,22753011,360,0,0,1,2
22753006,22753189,183,1,0,0,1
22753012,22753196,184,1,0,0,2
22753039,22753084,45,0,1,0,2
22753042,22753110,68,0,1,0,1
22753190,22753466,276,0,0,1,1
22753197,22753467,270,0,0,1,2
22753467,22753510,43,1,0,0,1
22753468,22753511,43,1,0,0,2
22753511,22753791,280,0,0,1,1
22753512,22753790,278,0,0,1,2
22753791,22753994,203,1,0,0,2
22753792,22753952,160,1,0,0,1
22753817,22753888,71,0,1,0,2
22753818,22753899,81,0,1,0,1
22753953,22754294,341,0,0,1,1
22753995,22754294,299,0,0,1,2
22754295,22754340,45,1,0,0,2
22754295,22754341,46,1,0,0,1
22754341,22754530,189,0,0,1,2
22754342,22754530,188,0,0,1,1
22754531,22754597,66,1,0,0,1
22754531,22754597,66,1,0,0,2
22754598,22754791,193,0,0,1,1
22754598,22754791,193,0,0,1,2
22754792,22754971,179,1,0,0,1
22754792,22754978,186,1,0,0,2
22754812,22754910,98,0,1,0,1
22754814,22754899,85,0,1,0,2
22754972,22755137,165,0,0,1,1
22754979,22755140,161,0,0,1,2
22755138,22755228,90,1,0,0,1
22755141,22755230,89,1,0,0,2
22755229,22755318,89,0,0,1,1
22755231,22755319,88,0,0,1,2
22755319,22755375,56,1,0,0,1
22755320,22755378,58,1,0,0,2
22755376,22755512,136,0,0,1,1
22755379,22755516,137,0,0,1,2
22755513,22755541,28,1,0,0,1
22755517,22755556,39,1,0,0,2
22755542,22755819,277,0,0,1,1
22755557,22755820,263,0,0,1,2
22755820,22755913,93,1,0,0,1
22755821,22755916,95,1,0,0,2
22755914,22756048,134,0,0,1,1
22755917,22756045,128,0,0,1,2
22756046,22756193,147,1,0,0,2
22756049,22756189,140,1,0,0,1
22756069,22756122,53,0,1,0,1
22756071,22756113,42,0,1,0,2
22756190,22756357,167,0,0,1,1
22756194,22756358,164,0,0,1,2
22756358,22756417,59,1,0,0,1
22756359,22756416,57,1,0,0,2
22756417,22756995,578,0,0,1,2
22756418,22756996,578,0,0,1,1
22756996,22757044,48,1,0,0,2
22756997,22757044,47,1,0,0,1
22757045,22757438,393,0,0,1,1
22757045,22757438,393,0,0,1,2
22757439,22757479,40,1,0,0,1
22757439,22757479,40,1,0,0,2
22757480,22757782,302,0,0,1,2
22757480,22757786,306,0,0,1,1
22757783,22757970,187,1,0,0,2
22757787,22757976,189,1,0,0,1
22757811,22757897,86,0,1,0,1
22757813,22757879,66,0,1,0,2
22757971,22758188,217,0,0,1,2
22757977,22758196,219,0,0,1,1
22758189,22758509,320,1,0,0,2
22758197,22758504,307,1,0,0,1
22758226,22758384,158,0,1,0,2
22758228,22758413,185,0,1,0,1
22758505,22758740,235,0,0,1,1
22758510,22758739,229,0,0,1,2
22758740,22758783,43,1,0,0,2
22758741,22758782,41,1,0,0,1
22758783,22759070,287,0,0,1,1
22758784,22759072,288,0,0,1,2
22759071,22759118,47,1,0,0,1
22759073,22759118,45,1,0,0,2
22759119,22759275,156,0,0,1,1
22759119,22759277,158,0,0,1,2
22759276,22759545,269,1,0,0,1
22759278,22759536,258,1,0,0,2
22759302,22759453,151,0,1,0,2
22759307,22759475,168,0,1,0,1
22759537,22759877,340,0,0,1,2
22759546,22759876,330,0,0,1,1
22759877,22759917,40,1,0,0,1
22759878,22759929,51,1,0,0,2
22759918,22760061,143,0,0,1,1
22759930,22760056,126,0,0,1,2
22760057,22760313,256,1,0,0,2
22760062,22760294,232,1,0,0,1
22760083,22760236,153,0,1,0,2
22760083,22760257,174,0,1,0,1
22760295,22760625,330,0,0,1,1
22760314,22760622,308,0,0,1,2
22760623,22760870,247,1,0,0,2
22760626,22760847,221,1,0,0,1
22760648,22760783,135,0,1,0,2
22760648,22760799,151,0,1,0,1
22760848,22761174,326,0,0,1,1
22760871,22761172,301,0,0,1,2
22761173,22761240,67,1,0,0,2
22761175,22761235,60,1,0,0,1
22761236,22761456,220,0,0,1,1
22761241,22761457,216,0,0,1,2
22761457,22761655,198,1,0,0,1
22761458,22761720,262,1,0,0,2
22761483,22761585,102,0,1,0,1
22761484,22761586,102,0,1,0,2
22761656,22761854,198,0,0,1,1
22761721,22761852,131,0,0,1,2
22761853,22761917,64,1,0,0,2
22761855,22761917,62,1,0,0,1
22761918,22762143,225,0,0,1,2
22761918,22762147,229,0,0,1,1
22762144,22762407,263,1,0,0,2
22762148,22762402,254,1,0,0,1
22762168,22762299,131,0,1,0,2
22762170,22762310,140,0,1,0,1
22762403,22762641,238,0,0,1,1
22762408,22762639,231,0,0,1,2
22762640,22762708,68,1,0,0,2
22762642,22762709,67,1,0,0,1
22762709,22762899,190,0,0,1,2
22762710,22762902,192,0,0,1,1
22762900,22763133,233,1,0,0,2
22762903,22763094,191,1,0,0,1
22762926,22763027,101,0,1,0,2
22762928,22763020,92,0,1,0,1
22763095,22763697,602,0,0,1,1
22763134,22763683,549,0,0,1,2
22763684,22763950,266,1,0,0,2
22763698,22763881,183,1,0,0,1
22763717,22763815,98,0,1,0,2
22763720,22763805,85,0,1,0,1
22763845,22763848,3,0,1,0,2
22763882,22764203,321,0,0,1,1
22763951,22764202,251,0,0,1,2
22764203,22764282,79,1,0,0,2
22764204,22764272,68,1,0,0,1
22764273,22764491,218,0,0,1,1
22764283,22764469,186,0,0,1,2
22764470,22764817,347,1,0,0,2
22764492,22764762,270,1,0,0,1
22764512,22764661,149,0,1,0,2
22764514,22764683,169,0,1,0,1
22764763,22765073,310,0,0,1,1
22764818,22765059,241,0,0,1,2
22765060,22765354,294,1,0,0,2
22765074,22765333,259,1,0,0,1
22765093,22765256,163,0,1,0,2
22765101,22765276,175,0,1,0,1
22765334,22765794,460,0,0,1,1
22765355,22765791,436,0,0,1,2
22765792,22766110,318,1,0,0,2
22765795,22766046,251,1,0,0,1
22765821,22765978,157,0,1,0,2
22765824,22765981,157,0,1,0,1
22766047,22766338,291,0,0,1,1
22766111,22766337,226,0,0,1,2
22766338,22766403,65,1,0,0,2
22766339,22766395,56,1,0,0,1
22766396,22766747,351,0,0,1,1
22766404,22766747,343,0,0,1,2
22766748,22766832,84,1,0,0,1
22766748,22766833,85,1,0,0,2
22766833,22767054,221,0,0,1,1
22766834,22767039,205,0,0,1,2
22767040,22767345,305,1,0,0,2
22767055,22767317,262,1,0,0,1
22767078,22767225,147,0,1,0,2
22767093,22767259,166,0,1,0,1
22767318,22767692,374,0,0,1,1
22767346,22767686,340,0,0,1,2
22767687,22767962,275,1,0,0,2
22767693,22767942,249,1,0,0,1
22767723,22767853,130,0,1,0,2
22767723,22767868,145,0,1,0,1
22767943,22768383,440,0,0,1,1
22767963,22768383,420,0,0,1,2
22768384,22768410,26,1,0,0,1
22768384,22768412,28,1,0,0,2
22768411,22768667,256,0,0,1,1
22768413,22768665,252,0,0,1,2
22768666,22768953,287,1,0,0,2
22768668,22768938,270,1,0,0,1
22768690,22768857,167,0,1,0,2
22768697,22768872,175,0,1,0,1
22768939,22769170,231,0,0,1,1
22768954,22768974,20,0,0,1,2
22768975,22769043,68,1,0,0,2
22769044,22769157,113,0,0,1,2
22769158,22769414,256,1,0,0,2
22769171,22769379,208,1,0,0,1
22769190,22769311,121,0,1,0,2
22769198,22769343,145,0,1,0,1
22769380,22769550,170,0,0,1,1
22769415,22769550,135,0,0,1,2
22769551,22769598,47,1,0,0,1
22769551,22769601,50,1,0,0,2
22769599,22769800,201,0,0,1,1
22769602,22769788,186,0,0,1,2
22769789,22770103,314,1,0,0,2
22769801,22770072,271,1,0,0,1
22769828,22769989,161,0,1,0,2
22769828,22770012,184,0,1,0,1
22770073,22770284,211,0,0,1,1
22770104,22770281,177,0,0,1,2
22770282,22770653,371,1,0,0,2
22770285,22770545,260,1,0,0,1
22770314,22770456,142,0,1,0,2
22770315,22770442,127,0,1,0,1
22770546,22770755,209,0,0,1,1
22770654,22770756,102,0,0,1,2
22770756,22770807,51,1,0,0,1
22770757,22770813,56,1,0,0,2
22770808,22771025,217,0,0,1,1
22770814,22771025,211,0,0,1,2
22771026,22771086,60,1,0,0,1
22771026,22771088,62,1,0,0,2
22771087,22771400,313,0,0,1,1
22771089,22771398,309,0,0,1,2
22771399,22771638,239,1,0,0,2
22771401,22771596,195,1,0,0,1
22771422,22771511,89,0,1,0,2
22771424,22771527,103,0,1,0,1
22771597,22772146,549,0,0,1,1
22771639,22772140,501,0,0,1,2
22772141,22772408,267,1,0,0,2
22772147,22772394,247,1,0,0,1
22772173,22772298,125,0,1,0,2
22772178,22772321,143,0,1,0,1
22772395,22772896,501,0,0,1,1
22772409,22772896,487,0,0,1,2
22772897,22772947,50,1,0,0,1
22772897,22772947,50,1,0,0,2
22772948,22773709,761,0,0,1,1
22772948,22773709,761,0,0,1,2
22773710,22773997,287,1,0,0,1
22773710,22773997,287,1,0,0,2
22773741,22773877,136,0,1,0,2
22773743,22773896,153,0,1,0,1
22773998,22775006,1008,0,0,1,1
22773998,22775006,1008,0,0,1,2
22775007,22775069,62,1,0,0,1
22775007,22775086,79,1,0,0,2
22775070,22775155,85,0,0,1,1
22775087,22775157,70,0,0,1,2
22775156,22775183,27,1,0,0,1
22775158,22775184,26,1,0,0,2
22775184,22776310,1126,0,0,1,1
22775185,22776314,1129,0,0,1,2
22776311,22776329,18,1,0,0,1
22776315,22776329,14,1,0,0,2
22776330,22776895,565,0,0,1,1
22776330,22776895,565,0,0,1,2
22776896,22776905,9,1,0,0,1
22776896,22776908,12,1,0,0,2
22776906,22778665,1759,0,0,1,1
22776909,22778663,1754,0,0,1,2
22778664,22778704,40,1,0,0,2
22778666,22778703,37,1,0,0,1
22778704,22779073,369,0,0,1,1
22778705,22779072,367,0,0,1,2
22779073,22779089,16,1,0,0,2
22779074,22779091,17,1,0,0,1
22779090,22779914,824,0,0,1,2
22779092,22779916,824,0,0,1,1
22779915,22779927,12,1,0,0,2
22779917,22779922,5,1,0,0,1
22779923,22781647,1724,0,0,1,1
22779928,22781643,1715,0,0,1,2
22781644,22781700,56,1,0,0,2
22781648,22781701,53,1,0,0,1
22781701,22782103,402,0,0,1,2
22781702,22782103,401,0,0,1,1
22782104,22782139,35,1,0,0,1
22782104,22782157,53,1,0,0,2
22782140,22782261,121,0,0,1,1
22782158,22782263,105,0,0,1,2
22782262,22782283,21,1,0,0,1
22782264,22782285,21,1,0,0,2
22782284,22784773,2489,0,0,1,1
22782286,22784774,2488,0,0,1,2
22784774,22784834,60,1,0,0,1
22784775,22784843,68,1,0,0,2
22784835,22785155,320,0,0,1,1
22784844,22785155,311,0,0,1,2
22785156,22785177,21,1,0,0,2
22785156,22785179,23,1,0,0,1
22785178,22786245,1067,0,0,1,2
22785180,22786244,1064,0,0,1,1
22786245,22786264,19,1,0,0,1
22786246,22786264,18,1,0,0,2
22786265,22787106,841,0,0,1,1
22786265,22787106,841,0,0,1,2
22787107,22787151,44,1,0,0,1
22787107,22787152,45,1,0,0,2
22787152,22787744,592,0,0,1,1
22787153,22787740,587,0,0,1,2
22787741,22787764,23,1,0,0,2
22787745,22787771,26,1,0,0,1
22787765,22788618,853,0,0,1,2
22787772,22788621,849,0,0,1,1
22788619,22788664,45,1,0,0,2
22788622,22788665,43,1,0,0,1
22788665,22788784,119,0,0,1,2
22788666,22788783,117,0,0,1,1
22788784,22788804,20,1,0,0,1
22788785,22788804,19,1,0,0,2
22788805,22791506,2701,0,0,1,1
22788805,22791508,2703,0,0,1,2
22791507,22791518,11,1,0,0,1
22791509,22791518,9,1,0,0,2
22791519,22792463,944,0,0,1,2
22791519,22792754,1235,0,0,1,1
22792464,22792468,4,1,0,0,2
22792469,22792755,286,0,0,1,2
22792755,22792793,38,1,0,0,1
22792756,22792793,37,1,0,0,2
22792794,22792924,130,0,0,1,1
22792794,22792924,130,0,0,1,2
22792925,22792943,18,1,0,0,1
22792925,22792946,21,1,0,0,2
22792944,22794666,1722,0,0,1,1
22792947,22793945,998,0,0,1,2
22793946,22793951,5,1,0,0,2
22793952,22794665,713,0,0,1,2
22794666,22794687,21,1,0,0,2
22794667,22794686,19,1,0,0,1
22794687,22795145,458,0,0,1,1
22794688,22795144,456,0,0,1,2
22795145,22795190,45,1,0,0,2
22795146,22795189,43,1,0,0,1
22795190,22796241,1051,0,0,1,1
22795191,22796241,1050,0,0,1,2
22796242,22796318,76,1,0,0,2
22796242,22796322,80,1,0,0,1
22796319,22796428,109,0,0,1,2
22796323,22796428,105,0,0,1,1
22796429,22796454,25,1,0,0,2
22796429,22796473,44,1,0,0,1
22796455,22796623,168,0,0,1,2
22796474,22798651,2177,0,0,1,1
22796624,22796628,4,1,0,0,2
22796629,22797319,690,0,0,1,2
22797320,22797326,6,1,0,0,2
22797327,22798864,1537,0,0,1,2
22798652,22798667,15,1,0,0,1
22798668,22798866,198,0,0,1,1
22798865,22798934,69,1,0,0,2
22798867,22798948,81,1,0,0,1
22798935,22799069,134,0,0,1,2
22798949,22799028,79,0,0,1,1
22799029,22799094,65,1,0,0,1
22799070,22799120,50,1,0,0,2
22799095,22799240,145,0,0,1,1
22799121,22801030,1909,0,0,1,2
22799241,22799264,23,1,0,0,1
22799265,22800120,855,0,0,1,1
22800121,22800182,61,1,0,0,1
22800183,22800320,137,0,0,1,1
22800321,22800418,97,1,0,0,1
22800419,22800588,169,0,0,1,1
22800589,22800611,22,1,0,0,1
22800612,22800674,62,0,0,1,1
22800675,22800704,29,1,0,0,1
22800705,22800736,31,0,0,1,1
22800737,22800805,68,1,0,0,1
22800806,22800917,111,0,0,1,1
22800918,22800929,11,1,0,0,1
22800930,22801030,100,0,0,1,1
22801031,22801117,86,1,0,0,1
22801031,22801124,93,1,0,0,2
22801118,22801337,219,0,0,1,1
22801125,22801338,213,0,0,1,2
22801338,22801399,61,1,0,0,1
22801339,22801447,108,1,0,0,2
22801400,22802364,964,0,0,1,1
22801448,22802364,916,0,0,1,2
22802365,22802395,30,1,0,0,2
22802365,22802398,33,1,0,0,1
22802396,22802609,213,0,0,1,2
22802399,22802611,212,0,0,1,1
22802610,22802677,67,1,0,0,2
22802612,22802675,63,1,0,0,1
22802676,22802789,113,0,0,1,1
22802678,22802790,112,0,0,1,2
22802790,22802822,32,1,0,0,1
22802791,22802837,46,1,0,0,2
22802823,22802987,164,0,0,1,1
22802838,22805329,2491,0,0,1,2
22802988,22802996,8,1,0,0,1
22802997,22805329,2332,0,0,1,1
22805330,22805379,49,1,0,0,1
22805330,22805419,89,1,0,0,2
22805380,22805495,115,0,0,1,1
22805420,22805495,75,0,0,1,2
22805496,22805512,16,1,0,0,1
22805496,22805514,18,1,0,0,2
22805513,22807433,1920,0,0,1,1
22805515,22806091,576,0,0,1,2
22806092,22806096,4,1,0,0,2
22806097,22806568,471,0,0,1,2
22806569,22806623,54,1,0,0,2
22806624,22807434,810,0,0,1,2
22807434,22807471,37,1,0,0,1
22807435,22807459,24,1,0,0,2
22807460,22807626,166,0,0,1,2
22807472,22807647,175,0,0,1,1
22807627,22807771,144,1,0,0,2
22807648,22807737,89,1,0,0,1
22807738,22809264,1526,0,0,1,1
22807772,22809263,1491,0,0,1,2
22809264,22809311,47,1,0,0,2
22809265,22809309,44,1,0,0,1
22809310,22809427,117,0,0,1,1
22809312,22809429,117,0,0,1,2
22809428,22809450,22,1,0,0,1
22809430,22809450,20,1,0,0,2
22809451,22810354,903,0,0,1,2
22809451,22810371,920,0,0,1,1
22810355,22810496,141,1,0,0,2
22810372,22810527,155,1,0,0,1
22810497,22811927,1430,0,0,1,2
22810528,22811927,1399,0,0,1,1
22811928,22811968,40,1,0,0,2
22811928,22811971,43,1,0,0,1
22811969,22813976,2007,0,0,1,2
22811972,22813978,2006,0,0,1,1
22813977,22814028,51,1,0,0,2
22813979,22814028,49,1,0,0,1
22814029,22814130,101,0,0,1,1
22814029,22814130,101,0,0,1,2
22814131,22814173,42,1,0,0,1
22814131,22814175,44,1,0,0,2
22814174,22814566,392,0,0,1,1
22814176,22814565,389,0,0,1,2
22814566,22814614,48,1,0,0,2
22814567,22814615,48,1,0,0,1
22814615,22814770,155,0,0,1,2
22814616,22814770,154,0,0,1,1
22814771,22814799,28,1,0,0,1
22814771,22814802,31,1,0,0,2
22814800,22815122,322,0,0,1,1
22814803,22815122,319,0,0,1,2
22815123,22815185,62,1,0,0,1
22815123,22815194,71,1,0,0,2
22815186,22815400,214,0,0,1,1
22815195,22815402,207,0,0,1,2
22815401,22815460,59,1,0,0,1
22815403,22815462,59,1,0,0,2
22815461,22815812,351,0,0,1,1
22815463,22815811,348,0,0,1,2
22815812,22815865,53,1,0,0,2
22815813,22815889,76,1,0,0,1
22815866,22815979,113,0,0,1,2
22815890,22815980,90,0,0,1,1
22815980,22816035,55,1,0,0,2
22815981,22816043,62,1,0,0,1
22816036,22816136,100,0,0,1,2
22816044,22816134,90,0,0,1,1
22816135,22816157,22,1,0,0,1
22816137,22816159,22,1,0,0,2
22816158,22816447,289,0,0,1,1
22816160,22816433,273,0,0,1,2
22816434,22816728,294,1,0,0,2
22816448,22816779,331,1,0,0,1
22816469,22816657,188,0,1,0,2
22816470,22816651,181,0,1,0,1
22816729,22816756,27,0,0,1,2
22816757,22816859,102,1,0,0,2
22816780,22817249,469,0,0,1,1
22816860,22816903,43,0,0,1,2
22816904,22817179,275,1,0,0,2
22817180,22817243,63,0,0,1,2
22817244,22817709,465,1,0,0,2
22817250,22817658,408,1,0,0,1
22817277,22817529,252,0,1,0,2
22817278,22817505,227,0,1,0,1
22817659,22818039,380,0,0,1,1
22817710,22817830,120,0,0,1,2
22817831,22818504,673,1,0,0,2
22818040,22818405,365,1,0,0,1
22818059,22818270,211,0,1,0,2
22818066,22818268,202,0,1,0,1
22818406,22818533,127,0,0,1,1
22818505,22818560,55,0,0,1,2
22818534,22818610,76,1,0,0,1
22818561,22818751,190,1,0,0,2
22818611,22820649,2038,0,0,1,1
22818752,22818788,36,0,0,1,2
22818789,22819138,349,1,0,0,2
22819139,22819288,149,0,0,1,2
22819289,22819295,6,1,0,0,2
22819296,22819354,58,0,0,1,2
22819355,22819477,122,1,0,0,2
22819478,22819564,86,0,0,1,2
22819565,22820708,1143,1,0,0,2
22820650,22820694,44,1,0,0,1
22820695,22822435,1740,0,0,1,1
22820709,22822421,1712,0,0,1,2
22822422,22822740,318,1,0,0,2
22822436,22822770,334,1,0,0,1
22822461,22822644,183,0,1,0,1
22822464,22822664,200,0,1,0,2
22822741,22823037,296,0,0,1,2
22822771,22823036,265,0,0,1,1
22823037,22823091,54,1,0,0,1
22823038,22823108,70,1,0,0,2
22823092,22823492,400,0,0,1,1
22823109,22823485,376,0,0,1,2
22823486,22823764,278,1,0,0,2
22823493,22823744,251,1,0,0,1
22823516,22823674,158,0,1,0,1
22823516,22823678,162,0,1,0,2
22823745,22824213,468,0,0,1,1
22823765,22824212,447,0,0,1,2
22824213,22824248,35,1,0,0,2
22824214,22824248,34,1,0,0,1
22824249,22824467,218,0,0,1,1
22824249,22824467,218,0,0,1,2
22824468,22824547,79,1,0,0,1
22824468,22824548,80,1,0,0,2
22824548,22824640,92,0,0,1,1
22824549,22824635,86,0,0,1,2
22824636,22824687,51,1,0,0,2
22824641,22824684,43,1,0,0,1
22824685,22824813,128,0,0,1,1
22824688,22825421,733,0,0,1,2
22824814,22824841,27,1,0,0,1
22824842,22825094,252,0,0,1,1
22825095,22825099,4,1,0,0,1
22825100,22825529,429,0,0,1,1
22825422,22825431,9,1,0,0,2
22825432,22825830,398,0,0,1,2
22825530,22825739,209,1,0,0,1
22825740,22825828,88,0,0,1,1
22825829,22825846,17,1,0,0,1
22825831,22825847,16,1,0,0,2
22825847,22825991,144,0,0,1,1
22825848,22825992,144,0,0,1,2
22825992,22826002,10,1,0,0,1
22825993,22826000,7,1,0,0,2
22826001,22827095,1094,0,0,1,2
22826003,22826887,884,0,0,1,1
22826888,22826893,5,1,0,0,1
22826894,22827093,199,0,0,1,1
22827094,22827119,25,1,0,0,1
22827096,22827112,16,1,0,0,2
22827113,22827270,157,0,0,1,2
22827120,22827268,148,0,0,1,1
22827269,22827279,10,1,0,0,1
22827271,22827281,10,1,0,0,2
22827280,22827697,417,0,0,1,1
22827282,22827702,420,0,0,1,2
22827698,22827713,15,1,0,0,1
22827703,22827708,5,1,0,0,2
22827709,22829735,2026,0,0,1,2
22827714,22828113,399,0,0,1,1
22828114,22828122,8,1,0,0,1
22828123,22829737,1614,0,0,1,1
22829736,22829791,55,1,0,0,2
22829738,22829790,52,1,0,0,1
22829791,22830054,263,0,0,1,1
22829792,22830053,261,0,0,1,2
22830054,22830074,20,1,0,0,2
22830055,22830074,19,1,0,0,1
22830075,22833399,3324,0,0,1,2
22830075,22833400,3325,0,0,1,1
22833400,22833490,90,1,0,0,2
22833401,22833491,90,1,0,0,1
22833491,22833517,26,0,0,1,2
22833492,22833599,107,0,0,1,1
22833518,22833532,14,1,0,0,2
22833533,22833598,65,0,0,1,2
22833599,22833731,132,1,0,0,2
22833600,22833628,28,1,0,0,1
22833629,22833802,173,0,0,1,1
22833732,22833819,87,0,0,1,2
22833803,22833819,16,1,0,0,1
22833820,22833965,145,1,0,0,2
22833820,22834335,515,0,0,1,1
22833966,22834693,727,0,0,1,2
22834336,22834346,10,1,0,0,1
22834347,22834964,617,0,0,1,1
22834694,22834756,62,1,0,0,2
22834757,22835666,909,0,0,1,2
22834965,22834971,6,1,0,0,1
22834972,22835937,965,0,0,1,1
22835667,22835722,55,1,0,0,2
22835723,22835941,218,0,0,1,2
22835938,22836000,62,1,0,0,1
22835942,22836010,68,1,0,0,2
22836001,22836256,255,0,0,1,1
22836011,22836251,240,0,0,1,2
22836252,22836266,14,1,0,0,2
22836257,22836264,7,1,0,0,1
22836265,22838055,1790,0,0,1,1
22836267,22836995,728,0,0,1,2
22836996,22837001,5,1,0,0,2
22837002,22838056,1054,0,0,1,2
22838056,22838077,21,1,0,0,1
22838057,22838078,21,1,0,0,2
22838078,22838631,553,0,0,1,1
22838079,22838632,553,0,0,1,2
22838632,22838697,65,1,0,0,1
22838633,22838698,65,1,0,0,2
22838698,22838955,257,0,0,1,1
22838699,22838958,259,0,0,1,2
22838956,22839002,46,1,0,0,1
22838959,22839003,44,1,0,0,2
22839003,22839238,235,0,0,1,1
22839004,22839237,233,0,0,1,2
22839238,22839295,57,1,0,0,2
22839239,22839283,44,1,0,0,1
22839284,22839533,249,0,0,1,1
22839296,22839531,235,0,0,1,2
22839532,22839595,63,1,0,0,2
22839534,22839589,55,1,0,0,1
22839590,22839698,108,0,0,1,1
22839596,22839698,102,0,0,1,2
22839699,22839721,22,1,0,0,2
22839699,22839798,99,1,0,0,1
22839722,22841043,1321,0,0,1,2
22839799,22839934,135,0,0,1,1
22839935,22839983,48,1,0,0,1
22839984,22842044,2060,0,0,1,1
22841044,22841049,5,1,0,0,2
22841050,22842045,995,0,0,1,2
22842045,22842100,55,1,0,0,1
22842046,22842101,55,1,0,0,2
22842101,22842851,750,0,0,1,1
22842102,22842844,742,0,0,1,2
22842845,22842869,24,1,0,0,2
22842852,22842867,15,1,0,0,1
22842868,22843768,900,0,0,1,1
22842870,22843764,894,0,0,1,2
22843765,22843796,31,1,0,0,2
22843769,22843797,28,1,0,0,1
22843797,22844328,531,0,0,1,2
22843798,22844328,530,0,0,1,1
22844329,22844367,38,1,0,0,1
22844329,22844368,39,1,0,0,2
22844368,22844553,185,0,0,1,1
22844369,22844549,180,0,0,1,2
22844550,22844582,32,1,0,0,2
22844554,22844586,32,1,0,0,1
22844583,22845444,861,0,0,1,2
22844587,22845444,857,0,0,1,1
22845445,22845559,114,1,0,0,1
22845445,22845717,272,1,0,0,2
22845560,22845690,130,0,0,1,1
22845691,22845716,25,1,0,0,1
22845717,22847066,1349,0,0,1,1
22845718,22845799,81,0,0,1,2
22845800,22846108,308,1,0,0,2
22846109,22846281,172,0,0,1,2
22846282,22846322,40,1,0,0,2
22846323,22846386,63,0,0,1,2
22846387,22846447,60,1,0,0,2
22846448,22846659,211,0,0,1,2
22846660,22846697,37,1,0,0,2
22846698,22846749,51,0,0,1,2
22846750,22846764,14,1,0,0,2
22846765,22847055,290,0,0,1,2
22847056,22847241,185,1,0,0,2
22847067,22847170,103,1,0,0,1
22847096,22847130,34,0,1,0,1
22847171,22847535,364,0,0,1,1
22847242,22847402,160,0,0,1,2
22847403,22847407,4,1,0,0,2
22847408,22847488,80,0,0,1,2
22847489,22847642,153,1,0,0,2
22847536,22847581,45,1,0,0,1
22847582,22847986,404,0,0,1,1
22847643,22847981,338,0,0,1,2
22847982,22848001,19,1,0,0,2
22847987,22848042,55,1,0,0,1
22848002,22848493,491,0,0,1,2
22848043,22848404,361,0,0,1,1
22848405,22848416,11,1,0,0,1
22848417,22849148,731,0,0,1,1
22848494,22848509,15,1,0,0,2
22848510,22849648,1138,0,0,1,2
22849149,22849161,12,1,0,0,1
22849162,22849651,489,0,0,1,1
22849649,22849971,322,1,0,0,2
22849652,22849960,308,1,0,0,1
22849698,22849882,184,0,1,0,2
22849711,22849886,175,0,1,0,1
22849961,22850825,864,0,0,1,1
22849972,22850823,851,0,0,1,2
22850824,22850866,42,1,0,0,2
22850826,22850862,36,1,0,0,1
22850863,22851063,200,0,0,1,1
22850867,22851065,198,0,0,1,2
22851064,22851114,50,1,0,0,1
22851066,22851112,46,1,0,0,2
22851113,22851230,117,0,0,1,2
22851115,22851229,114,0,0,1,1
22851230,22851257,27,1,0,0,1
22851231,22851257,26,1,0,0,2
22851258,22852610,1352,0,0,1,2
22851258,22852775,1517,0,0,1,1
22852611,22852619,8,1,0,0,2
22852620,22853414,794,0,0,1,2
22852776,22852780,4,1,0,0,1
22852781,22853410,629,0,0,1,1
22853411,22853456,45,1,0,0,1
22853415,22853493,78,1,0,0,2
22853457,22855597,2140,0,0,1,1
22853494,22855608,2114,0,0,1,2
22855598,22856014,416,1,0,0,1
22855609,22856021,412,1,0,0,2
22855634,22855822,188,0,1,0,2
22855639,22855853,214,0,1,0,1
22856015,22857012,997,0,0,1,1
22856022,22857013,991,0,0,1,2
22857013,22857063,50,1,0,0,1
22857014,22857082,68,1,0,0,2
22857064,22857513,449,0,0,1,1
22857083,22857514,431,0,0,1,2
22857514,22857577,63,1,0,0,1
22857515,22857578,63,1,0,0,2
22857578,22857682,104,0,0,1,1
22857579,22857680,101,0,0,1,2
22857681,22857719,38,1,0,0,2
22857683,22857729,46,1,0,0,1
22857720,22860489,2769,0,0,1,2
22857730,22859284,1554,0,0,1,1
22859285,22859319,34,1,0,0,1
22859320,22859628,308,0,0,1,1
22859629,22859682,53,1,0,0,1
22859683,22860487,804,0,0,1,1
22860488,22860536,48,1,0,0,1
22860490,22860627,137,1,0,0,2
22860537,22862071,1534,0,0,1,1
22860628,22860660,32,0,0,1,2
22860661,22860753,92,1,0,0,2
22860754,22862078,1324,0,0,1,2
22862072,22862094,22,1,0,0,1
22862079,22862093,14,1,0,0,2
22862094,22862626,532,0,0,1,2
22862095,22862628,533,0,0,1,1
22862627,22862903,276,1,0,0,2
22862629,22862890,261,1,0,0,1
22862654,22862797,143,0,1,0,2
22862662,22862818,156,0,1,0,1
22862891,22863826,935,0,0,1,1
22862904,22863823,919,0,0,1,2
22863824,22863851,27,1,0,0,2
22863827,22863854,27,1,0,0,1
22863852,22863992,140,0,0,1,2
22863855,22863988,133,0,0,1,1
22863989,22864003,14,1,0,0,1
22863993,22864003,10,1,0,0,2
22864004,22865527,1523,0,0,1,1
22864004,22865528,1524,0,0,1,2
22865528,22865617,89,1,0,0,1
22865529,22865599,70,1,0,0,2
22865600,22865721,121,0,0,1,2
22865618,22865720,102,0,0,1,1
22865721,22865739,18,1,0,0,1
22865722,22865734,12,1,0,0,2
22865735,22866859,1124,0,0,1,2
22865740,22866860,1120,0,0,1,1
22866860,22866876,16,1,0,0,2
22866861,22866879,18,1,0,0,1
22866877,22867485,608,0,0,1,2
22866880,22867485,605,0,0,1,1
22867486,22867548,62,1,0,0,2
22867486,22867550,64,1,0,0,1
22867549,22869019,1470,0,0,1,2
22867551,22869020,1469,0,0,1,1
22869020,22869077,57,1,0,0,2
22869021,22869083,62,1,0,0,1
22869078,22870810,1732,0,0,1,2
22869084,22869198,114,0,0,1,1
22869199,22869211,12,1,0,0,1
22869212,22870809,1597,0,0,1,1
22870810,22870854,44,1,0,0,1
22870811,22871144,333,1,0,0,2
22870855,22871115,260,0,0,1,1
22871116,22871134,18,1,0,0,1
22871135,22872814,1679,0,0,1,1
22871145,22871262,117,0,0,1,2
22871263,22871332,69,1,0,0,2
22871333,22871437,104,0,0,1,2
22871438,22871454,16,1,0,0,2
22871455,22872009,554,0,0,1,2
22872010,22872021,11,1,0,0,2
22872022,22872356,334,0,0,1,2
22872357,22872462,105,1,0,0,2
22872463,22872517,54,0,0,1,2
22872518,22872522,4,1,0,0,2
22872523,22872600,77,0,0,1,2
22872601,22872865,264,1,0,0,2
22872815,22872863,48,1,0,0,1
22872864,22872980,116,0,0,1,1
22872866,22872981,115,0,0,1,2
22872981,22873045,64,1,0,0,1
22872982,22873047,65,1,0,0,2
22873046,22873773,727,0,0,1,1
22873048,22873773,725,0,0,1,2
22873774,22873817,43,1,0,0,1
22873774,22873819,45,1,0,0,2
22873818,22873942,124,0,0,1,1
22873820,22873945,125,0,0,1,2
22873943,22873962,19,1,0,0,1
22873946,22873960,14,1,0,0,2
22873961,22875369,1408,0,0,1,2
22873963,22875533,1570,0,0,1,1
22875370,22875381,11,1,0,0,2
22875382,22876543,1161,0,0,1,2
22875534,22875542,8,1,0,0,1
22875543,22876544,1001,0,0,1,1
22876544,22876621,77,1,0,0,2
22876545,22876623,78,1,0,0,1
22876622,22877052,430,0,0,1,2
22876624,22877053,429,0,0,1,1
22877053,22877061,8,1,0,0,2
22877054,22877058,4,1,0,0,1
22877059,22878653,1594,0,0,1,1
22877062,22878653,1591,0,0,1,2
22878654,22878890,236,1,0,0,1
22878654,22878916,262,1,0,0,2
22878724,22878820,96,0,1,0,1
22878725,22878815,90,0,1,0,2
22878891,22879791,900,0,0,1,1
22878917,22879788,871,0,0,1,2
22879789,22879797,8,1,0,0,2
22879792,22879796,4,1,0,0,1
22879797,22880224,427,0,0,1,1
22879798,22880224,426,0,0,1,2
22880225,22880256,31,1,0,0,2
22880225,22880259,34,1,0,0,1
22880257,22880576,319,0,0,1,2
22880260,22880576,316,0,0,1,1
22880577,22880645,68,1,0,0,2
22880577,22880646,69,1,0,0,1
22880646,22881278,632,0,0,1,2
22880647,22881278,631,0,0,1,1
22881279,22881287,8,1,0,0,1
22881279,22881289,10,1,0,0,2
22881288,22881843,555,0,0,1,1
22881290,22881841,551,0,0,1,2
22881842,22881885,43,1,0,0,2
22881844,22881883,39,1,0,0,1
22881884,22884025,2141,0,0,1,1
22881886,22884028,2142,0,0,1,2
22884026,22884094,68,1,0,0,1
22884029,22884107,78,1,0,0,2
22884095,22884688,593,0,0,1,1
22884108,22884689,581,0,0,1,2
22884689,22884728,39,1,0,0,1
22884690,22884730,40,1,0,0,2
22884729,22885090,361,0,0,1,1
22884731,22885091,360,0,0,1,2
22885091,22885173,82,1,0,0,1
22885092,22885181,89,1,0,0,2
22885174,22885281,107,0,0,1,1
22885182,22885282,100,0,0,1,2
22885282,22885322,40,1,0,0,1
22885283,22885323,40,1,0,0,2
22885323,22885985,662,0,0,1,1
22885324,22885954,630,0,0,1,2
22885955,22886054,99,1,0,0,2
22885986,22885995,9,1,0,0,1
22885996,22887333,1337,0,0,1,1
22886055,22886182,127,0,0,1,2
22886183,22887012,829,1,0,0,2
22887013,22887051,38,0,0,1,2
22887052,22887109,57,1,0,0,2
22887110,22887332,222,0,0,1,2
22887333,22887540,207,1,0,0,2
22887334,22887380,46,1,0,0,1
22887381,22889493,2112,0,0,1,1
22887541,22887577,36,0,0,1,2
22887578,22887650,72,1,0,0,2
22887651,22887936,285,0,0,1,2
22887937,22889673,1736,1,0,0,2
22889494,22889647,153,1,0,0,1
22889551,22889570,19,0,1,0,2
22889648,22891180,1532,0,0,1,1
22889674,22891178,1504,0,0,1,2
22891179,22891235,56,1,0,0,2
22891181,22891227,46,1,0,0,1
22891228,22891342,114,0,0,1,1
22891236,22891345,109,0,0,1,2
22891343,22891371,28,1,0,0,1
22891346,22891379,33,1,0,0,2
22891372,22893144,1772,0,0,1,1
22891380,22891522,142,0,0,1,2
22891523,22891531,8,1,0,0,2
22891532,22893145,1613,0,0,1,2
22893145,22893189,44,1,0,0,1
22893146,22893189,43,1,0,0,2
22893190,22895357,2167,0,0,1,2
22893190,22895368,2178,0,0,1,1
22895358,22895478,120,1,0,0,2
22895369,22895444,75,1,0,0,1
22895445,22895558,113,0,0,1,1
22895479,22895563,84,0,0,1,2
22895559,22895607,48,1,0,0,1
22895564,22895604,40,1,0,0,2
22895605,22896916,1311,0,0,1,2
22895608,22896916,1308,0,0,1,1
22896917,22896990,73,1,0,0,1
22896917,22896990,73,1,0,0,2
22896991,22897127,136,0,0,1,1
22896991,22897127,136,0,0,1,2
22897128,22897154,26,1,0,0,1
22897128,22897154,26,1,0,0,2
22897155,22899015,1860,0,0,1,2
22897155,22899017,1862,0,0,1,1
22899016,22899080,64,1,0,0,2
22899018,22899079,61,1,0,0,1
22899080,22899258,178,0,0,1,1
22899081,22899256,175,0,0,1,2
22899257,22899275,18,1,0,0,2
22899259,22899276,17,1,0,0,1
22899276,22900225,949,0,0,1,2
22899277,22900227,950,0,0,1,1
22900226,22900256,30,1,0,0,2
22900228,22900241,13,1,0,0,1
22900242,22901075,833,0,0,1,1
22900257,22901075,818,0,0,1,2
22901076,22901122,46,1,0,0,1
22901076,22901122,46,1,0,0,2
22901123,22901238,115,0,0,1,2
22901123,22901239,116,0,0,1,1
22901239,22901299,60,1,0,0,2
22901240,22901298,58,1,0,0,1
22901299,22901488,189,0,0,1,1
22901300,22901488,188,0,0,1,2
22901489,22901530,41,1,0,0,1
22901489,22901531,42,1,0,0,2
22901531,22902460,929,0,0,1,1
22901532,22902461,929,0,0,1,2
22902461,22902552,91,1,0,0,1
22902462,22902542,80,1,0,0,2
22902543,22902662,119,0,0,1,2
22902553,22902662,109,0,0,1,1
22902663,22902757,94,1,0,0,1
22902663,22902789,126,1,0,0,2
22902758,22902834,76,0,0,1,1
22902790,22902810,20,0,0,1,2
22902811,22902979,168,1,0,0,2
22902835,22902951,116,1,0,0,1
22902952,22903035,83,0,0,1,1
22902980,22903023,43,0,0,1,2
22903024,22903183,159,1,0,0,2
22903036,22904983,1947,1,0,0,1
22903184,22903431,247,0,0,1,2
22903432,22903468,36,1,0,0,2
22903469,22903924,455,0,0,1,2
22903925,22904014,89,1,0,0,2
22904015,22904128,113,0,0,1,2
22904129,22904244,115,1,0,0,2
22904245,22904381,136,0,0,1,2
22904382,22904409,27,1,0,0,2
22904410,22904622,212,0,0,1,2
22904623,22904895,272,1,0,0,2
22904896,22904985,89,0,0,1,2
22904984,22905054,70,0,0,1,1
22904986,22905357,371,1,0,0,2
22905055,22905118,63,1,0,0,1
22905119,22905172,53,0,0,1,1
22905173,22905801,628,1,0,0,1
22905358,22905401,43,0,0,1,2
22905402,22905574,172,1,0,0,2
22905575,22905631,56,0,0,1,2
22905632,22905901,269,1,0,0,2
22905802,22905867,65,0,0,1,1
22905868,22905898,30,1,0,0,1
22905899,22905930,31,0,0,1,1
22905902,22905937,35,0,0,1,2
22905931,22908109,2178,1,0,0,1
22905938,22905948,10,1,0,0,2
22905949,22905998,49,0,0,1,2
22905999,22906189,190,1,0,0,2
22906190,22906238,48,0,0,1,2
22906239,22906302,63,1,0,0,2
22906303,22906324,21,0,0,1,2
22906325,22906430,105,1,0,0,2
22906431,22906496,65,0,0,1,2
22906497,22908147,1650,1,0,0,2
22908110,22908149,39,0,0,1,1
22908148,22908187,39,0,0,1,2
22908150,22908155,5,1,0,0,1
22908156,22908185,29,0,0,1,1
22908186,22908239,53,1,0,0,1
22908188,22908247,59,1,0,0,2
22908240,22909408,1168,0,0,1,1
22908248,22908283,35,0,0,1,2
22908284,22908302,18,1,0,0,2
22908303,22909408,1105,0,0,1,2
22909409,22909459,50,1,0,0,1
22909409,22909460,51,1,0,0,2
22909460,22909578,118,0,0,1,1
22909461,22909575,114,0,0,1,2
22909576,22909600,24,1,0,0,2
22909579,22909599,20,1,0,0,1
22909600,22909974,374,0,0,1,1
22909601,22909805,204,0,0,1,2
22909806,22909810,4,1,0,0,2
22909811,22909981,170,0,0,1,2
22909975,22909985,10,1,0,0,1
22909982,22909989,7,1,0,0,2
22909986,22911607,1621,0,0,1,1
22909990,22911606,1616,0,0,1,2
22911607,22911642,35,1,0,0,2
22911608,22911642,34,1,0,0,1
22911643,22911916,273,0,0,1,2
22911643,22911918,275,0,0,1,1
22911917,22911948,31,1,0,0,2
22911919,22911951,32,1,0,0,1
22911949,22913733,1784,0,0,1,2
22911952,22913731,1779,0,0,1,1
22913732,22914059,327,1,0,0,1
22913734,22914105,371,1,0,0,2
22913775,22913968,193,0,1,0,2
22913784,22913982,198,0,1,0,1
22914060,22915115,1055,0,0,1,1
22914106,22915112,1006,0,0,1,2
22915113,22915158,45,1,0,0,2
22915116,22915159,43,1,0,0,1
22915159,22915568,409,0,0,1,2
22915160,22915564,404,0,0,1,1
22915565,22915647,82,1,0,0,1
22915569,22915637,68,1,0,0,2
22915638,22915746,108,0,0,1,2
22915648,22915747,99,0,0,1,1
22915747,22915778,31,1,0,0,2
22915748,22915787,39,1,0,0,1
22915779,22915983,204,0,0,1,2
22915788,22918272,2484,0,0,1,1
22915984,22915993,9,1,0,0,2
22915994,22918270,2276,0,0,1,2
22918271,22918328,57,1,0,0,2
22918273,22918321,48,1,0,0,1
22918322,22918505,183,0,0,1,1
22918329,22918505,176,0,0,1,2
22918506,22918515,9,1,0,0,1
22918506,22918521,15,1,0,0,2
22918516,22920327,1811,0,0,1,1
22918522,22919550,1028,0,0,1,2
22919551,22919576,25,1,0,0,2
22919577,22920324,747,0,0,1,2
22920325,22920365,40,1,0,0,2
22920328,22920364,36,1,0,0,1
22920365,22920741,376,0,0,1,1
22920366,22920742,376,0,0,1,2
22920742,22920793,51,1,0,0,1
22920743,22920794,51,1,0,0,2
22920794,22922287,1493,0,0,1,1
22920795,22922285,1490,0,0,1,2
22922286,22922348,62,1,0,0,2
22922288,22922347,59,1,0,0,1
22922348,22922456,108,0,0,1,1
22922349,22922456,107,0,0,1,2
22922457,22922481,24,1,0,0,1
22922457,22922483,26,1,0,0,2
22922482,22922637,155,0,0,1,1
22922484,22922637,153,0,0,1,2
22922638,22922648,10,1,0,0,1
22922638,22922649,11,1,0,0,2
22922649,22922799,150,0,0,1,1
22922650,22922799,149,0,0,1,2
22922800,22922809,9,1,0,0,2
22922800,22922813,13,1,0,0,1
22922810,22923427,617,0,0,1,2
22922814,22923428,614,0,0,1,1
22923428,22923438,10,1,0,0,2
22923429,22923439,10,1,0,0,1
22923439,22923604,165,0,0,1,2
22923440,22924668,1228,0,0,1,1
22923605,22923615,10,1,0,0,2
22923616,22924669,1053,0,0,1,2
22924669,22924723,54,1,0,0,1
22924670,22924725,55,1,0,0,2
22924724,22925062,338,0,0,1,1
22924726,22925062,336,0,0,1,2
22925063,22925081,18,1,0,0,1
22925063,22925083,20,1,0,0,2
22925082,22926586,1504,0,0,1,1
22925084,22926585,1501,0,0,1,2
22926586,22926612,26,1,0,0,2
22926587,22926612,25,1,0,0,1
22926613,22926902,289,0,0,1,1
22926613,22926902,289,0,0,1,2
22926903,22926944,41,1,0,0,1
22926903,22926945,42,1,0,0,2
22926945,22927355,410,0,0,1,1
22926946,22927357,411,0,0,1,2
22927356,22927405,49,1,0,0,1
22927358,22927409,51,1,0,0,2
22927406,22927869,463,0,0,1,1
22927410,22927872,462,0,0,1,2
22927870,22927892,22,1,0,0,1
22927873,22927893,20,1,0,0,2
22927893,22928673,780,0,0,1,1
22927894,22928674,780,0,0,1,2
22928674,22928736,62,1,0,0,1
22928675,22928737,62,1,0,0,2
22928737,22928835,98,0,0,1,1
22928738,22928835,97,0,0,1,2
22928836,22928862,26,1,0,0,2
22928836,22928863,27,1,0,0,1
22928863,22929031,168,0,0,1,2
22928864,22929037,173,0,0,1,1
22929032,22929042,10,1,0,0,2
22929038,22929042,4,1,0,0,1
22929043,22929672,629,0,0,1,2
22929043,22931112,2069,0,0,1,1
22929673,22929681,8,1,0,0,2
22929682,22931114,1432,0,0,1,2
22931113,22931248,135,1,0,0,1
22931115,22931222,107,1,0,0,2
22931223,22931343,120,0,0,1,2
22931249,22931345,96,0,0,1,1
22931344,22931385,41,1,0,0,2
22931346,22931369,23,1,0,0,1
22931370,22932595,1225,0,0,1,1
22931386,22932666,1280,0,0,1,2
22932596,22932720,124,1,0,0,1
22932667,22932705,38,1,0,0,2
22932706,22932918,212,0,0,1,2
22932721,22932917,196,0,0,1,1
22932918,22932974,56,1,0,0,1
22932919,22932990,71,1,0,0,2
22932975,22933754,779,0,0,1,1
22932991,22933754,763,0,0,1,2
22933755,22933843,88,1,0,0,1
22933755,22933847,92,1,0,0,2
22933844,22934026,182,0,0,1,1
22933848,22934028,180,0,0,1,2
22934027,22934079,52,1,0,0,1
22934029,22934079,50,1,0,0,2
22934080,22934194,114,0,0,1,1
22934080,22934197,117,0,0,1,2
22934195,22934222,27,1,0,0,1
22934198,22934242,44,1,0,0,2
22934223,22934404,181,0,0,1,1
22934243,22934407,164,0,0,1,2
22934405,22934416,11,1,0,0,1
22934408,22934416,8,1,0,0,2
22934417,22935416,999,0,0,1,1
22934417,22935595,1178,0,0,1,2
22935417,22935428,11,1,0,0,1
22935429,22936721,1292,0,0,1,1
22935596,22935603,7,1,0,0,2
22935604,22936721,1117,0,0,1,2
22936722,22936827,105,1,0,0,2
22936722,22936842,120,1,0,0,1
22936828,22937078,250,0,0,1,2
22936843,22937086,243,0,0,1,1
22937079,22937104,25,1,0,0,2
22937087,22937103,16,1,0,0,1
22937104,22938107,1003,0,0,1,1
22937105,22938104,999,0,0,1,2
22938105,22938131,26,1,0,0,2
22938108,22938129,21,1,0,0,1
22938130,22938720,590,0,0,1,1
22938132,22938709,577,0,0,1,2
22938710,22939116,406,1,0,0,2
22938721,22939137,416,1,0,0,1
22938757,22938962,205,0,1,0,2
22938761,22938990,229,0,1,0,1
22939117,22940633,1516,0,0,1,2
22939138,22940634,1496,0,0,1,1
22940634,22940722,88,1,0,0,2
22940635,22940731,96,1,0,0,1
22940723,22940867,144,0,0,1,2
22940732,22940862,130,0,0,1,1
22940863,22940892,29,1,0,0,1
22940868,22940909,41,1,0,0,2
22940893,22941240,347,0,0,1,1
22940910,22941024,114,0,0,1,2
22941025,22941035,10,1,0,0,2
22941036,22941165,129,0,0,1,2
22941166,22941269,103,1,0,0,2
22941241,22941299,58,1,0,0,1
22941270,22941688,418,0,0,1,2
22941300,22941419,119,0,0,1,1
22941420,22941441,21,1,0,0,1
22941442,22941612,170,0,0,1,1
22941613,22941690,77,1,0,0,1
22941689,22941693,4,1,0,0,2
22941691,22941721,30,0,0,1,1
22941694,22942149,455,0,0,1,2
22941722,22941837,115,1,0,0,1
22941838,22942037,199,0,0,1,1
22942038,22942275,237,1,0,0,1
22942150,22942228,78,1,0,0,2
22942211,22942211,0,0,1,0,1
22942229,22942352,123,0,0,1,2
22942276,22942314,38,0,0,1,1
22942315,22942508,193,1,0,0,1
22942353,22942367,14,1,0,0,2
22942368,22942889,521,0,0,1,2
22942509,22942563,54,0,0,1,1
22942564,22943552,988,1,0,0,1
22942890,22942906,16,1,0,0,2
22942907,22942949,42,0,0,1,2
22942950,22942959,9,1,0,0,2
22942960,22943298,338,0,0,1,2
22943299,22943324,25,1,0,0,2
22943325,22943488,163,0,0,1,2
22943489,22943586,97,1,0,0,2
22943553,22944440,887,0,0,1,1
22943587,22945553,1966,0,0,1,2
22944441,22944472,31,1,0,0,1
22944473,22945565,1092,0,0,1,1
22945554,22945922,368,1,0,0,2
22945566,22945945,379,1,0,0,1
22945586,22945772,186,0,1,0,2
22945593,22945822,229,0,1,0,1
22945923,22946067,144,0,0,1,2
22945946,22946069,123,0,0,1,1
22946068,22946116,48,1,0,0,2
22946070,22946115,45,1,0,0,1
22946116,22947018,902,0,0,1,1
22946117,22947017,900,0,0,1,2
22947018,22947069,51,1,0,0,2
22947019,22947071,52,1,0,0,1
22947070,22947185,115,0,0,1,2
22947072,22947184,112,0,0,1,1
22947185,22947219,34,1,0,0,1
22947186,22947215,29,1,0,0,2
22947216,22949436,2220,0,0,1,2
22947220,22949434,2214,0,0,1,1
22949435,22949493,58,1,0,0,1
22949437,22949491,54,1,0,0,2
22949492,22949628,136,0,0,1,2
22949494,22949628,134,0,0,1,1
22949629,22949653,24,1,0,0,1
22949629,22949655,26,1,0,0,2
22949654,22950408,754,0,0,1,1
22949656,22951228,1572,0,0,1,2
22950409,22950421,12,1,0,0,1
22950422,22951226,804,0,0,1,1
22951227,22951258,31,1,0,0,1
22951229,22951247,18,1,0,0,2
22951248,22951480,232,0,0,1,2
22951259,22951481,222,0,0,1,1
22951481,22951533,52,1,0,0,2
22951482,22951535,53,1,0,0,1
22951534,22952287,753,0,0,1,2
22951536,22952288,752,0,0,1,1
22952288,22952361,73,1,0,0,2
22952289,22952344,55,1,0,0,1
22952345,22952894,549,0,0,1,1
22952362,22952893,531,0,0,1,2
22952894,22952924,30,1,0,0,2
22952895,22952923,28,1,0,0,1
22952924,22953110,186,0,0,1,1
22952925,22953109,184,0,0,1,2
22953110,22953139,29,1,0,0,2
22953111,22953139,28,1,0,0,1
22953140,22953282,142,0,0,1,2
22953140,22953283,143,0,0,1,1
22953283,22953313,30,1,0,0,2
22953284,22953311,27,1,0,0,1
22953312,22953432,120,0,0,1,1
22953314,22953433,119,0,0,1,2
22953433,22953456,23,1,0,0,1
22953434,22953456,22,1,0,0,2
22953457,22953623,166,0,0,1,1
22953457,22953623,166,0,0,1,2
22953624,22953657,33,1,0,0,2
22953624,22953660,36,1,0,0,1
22953658,22953941,283,0,0,1,2
22953661,22953940,279,0,0,1,1
22953941,22953973,32,1,0,0,1
22953942,22953972,30,1,0,0,2
22953973,22954191,218,0,0,1,2
22953974,22954189,215,0,0,1,1
22954190,22954229,39,1,0,0,1
22954192,22954229,37,1,0,0,2
22954230,22954429,199,0,0,1,1
22954230,22954430,200,0,0,1,2
22954430,22954720,290,1,0,0,1
22954431,22954718,287,1,0,0,2
22954456,22954615,159,0,1,0,2
22954464,22954613,149,0,1,0,1
22954719,22954808,89,0,0,1,2
22954721,22954808,87,0,0,1,1
22954809,22954831,22,1,0,0,2
22954809,22954848,39,1,0,0,1
22954832,22954977,145,0,0,1,2
22954849,22954882,33,0,0,1,1
22954883,22965924,11041,1,0,0,1
22954930,22965834,10904,0,1,0,1
22954978,22961516,6538,1,0,0,2
22955033,22961476,6443,0,1,0,2
22961517,22961552,35,0,0,1,2
22961553,22965827,4274,1,0,0,2
22961588,22965668,4080,0,1,0,2
22965828,22966064,236,0,0,1,2
22965925,22966066,141,0,0,1,1
22966065,22966134,69,1,0,0,2
22966067,22966098,31,1,0,0,1
22966099,22966333,234,0,0,1,1
22966135,22966333,198,0,0,1,2
22966334,22966356,22,1,0,0,1
22966334,22966357,23,1,0,0,2
22966357,22966506,149,0,0,1,1
22966358,22966498,140,0,0,1,2
22966499,22966707,208,1,0,0,2
22966507,22966745,238,1,0,0,1
22966530,22966642,112,0,1,0,2
22966534,22966657,123,0,1,0,1
22966708,22967063,355,0,0,1,2
22966746,22967061,315,0,0,1,1
22967062,22967312,250,1,0,0,1
22967064,22967271,207,1,0,0,2
22967093,22967206,113,0,1,0,2
22967096,22967219,123,0,1,0,1
22967272,22967343,71,0,0,1,2
22967313,22967344,31,0,0,1,1
22967344,22967375,31,1,0,0,2
22967345,22967366,21,1,0,0,1
22967367,22967529,162,0,0,1,1
22967376,22967529,153,0,0,1,2
22967530,22967569,39,1,0,0,2
22967530,22967570,40,1,0,0,1
22967570,22967626,56,0,0,1,2
22967571,22967626,55,0,0,1,1
23294569,23294595,26,0,0,1,1
23294569,23294597,28,0,0,1,2
23294596,23294644,48,1,0,0,1
23294598,23294660,62,1,0,0,2
23294645,23294775,130,0,0,1,1
23294661,23294774,113,0,0,1,2
23294775,23294829,54,1,0,0,2
23294776,23294834,58,1,0,0,1
23294830,23294989,159,0,0,1,2
23294835,23294990,155,0,0,1,1
23294990,23295012,22,1,0,0,2
23294991,23295009,18,1,0,0,1
23295010,23295688,678,0,0,1,1
23295013,23295688,675,0,0,1,2
23295689,23295706,17,1,0,0,1
23295689,23295715,26,1,0,0,2
23295707,23295992,285,0,0,1,1
23295716,23295999,283,0,0,1,2
23295993,23296251,258,1,0,0,1
23296000,23296212,212,1,0,0,2
23296026,23296147,121,0,1,0,2
23296032,23296129,97,0,1,0,1
23296213,23296509,296,0,0,1,2
23296252,23296509,257,0,0,1,1
23296510,23296542,32,1,0,0,1
23296510,23296543,33,1,0,0,2
23296543,23296921,378,0,0,1,1
23296544,23296920,376,0,0,1,2
23296921,23297103,182,1,0,0,2
23296922,23297106,184,1,0,0,1
23297104,23297207,103,0,0,1,2
23297107,23297220,113,0,0,1,1
23297208,23297462,254,1,0,0,2
23297221,23297464,243,1,0,0,1
23297230,23297446,216,0,1,0,2
23297243,23297446,203,0,1,0,1
23297463,23297488,25,0,0,1,2
23297465,23297486,21,0,0,1,1
23297487,23297531,44,1,0,0,1
23297489,23297532,43,1,0,0,2
23297532,23297684,152,0,0,1,1
23297533,23297690,157,0,0,1,2
23297685,23297722,37,1,0,0,1
23297691,23297707,16,1,0,0,2
23297708,23297942,234,0,0,1,2
23297723,23298136,413,0,0,1,1
23297943,23297953,10,1,0,0,2
23297954,23298134,180,0,0,1,2
23298135,23298144,9,1,0,0,2
23298137,23298156,19,1,0,0,1
23298145,23299262,1117,0,0,1,2
23298157,23299260,1103,0,0,1,1
23299261,23299289,28,1,0,0,1
23299263,23299290,27,1,0,0,2
23299290,23300096,806,0,0,1,1
23299291,23300097,806,0,0,1,2
23300097,23300198,101,1,0,0,1
23300098,23300188,90,1,0,0,2
23300189,23300266,77,0,0,1,2
23300199,23300266,67,0,0,1,1
23300267,23300306,39,1,0,0,1
23300267,23300310,43,1,0,0,2
23300307,23302369,2062,0,0,1,1
23300311,23302370,2059,0,0,1,2
23302370,23302420,50,1,0,0,1
23302371,23302418,47,1,0,0,2
23302419,23302551,132,0,0,1,2
23302421,23302551,130,0,0,1,1
23302552,23302599,47,1,0,0,2
23302552,23302614,62,1,0,0,1
23302600,23302698,98,0,0,1,2
23302615,23302698,83,0,0,1,1
23302699,23302718,19,1,0,0,1
23302699,23302719,20,1,0,0,2
23302719,23302879,160,0,0,1,1
23302720,23302878,158,0,0,1,2
23302879,23302887,8,1,0,0,2
23302880,23302888,8,1,0,0,1
23302888,23304478,1590,0,0,1,2
23302889,23304478,1589,0,0,1,1
23304479,23304517,38,1,0,0,1
23304479,23304533,54,1,0,0,2
23304518,23304609,91,0,0,1,1
23304534,23304610,76,0,0,1,2
23304610,23304638,28,1,0,0,1
23304611,23304634,23,1,0,0,2
23304635,23304766,131,0,0,1,2
23304639,23304761,122,0,0,1,1
23304762,23304778,16,1,0,0,1
23304767,23304779,12,1,0,0,2
23304779,23306525,1746,0,0,1,1
23304780,23306524,1744,0,0,1,2
23306525,23306634,109,1,0,0,2
23306526,23306636,110,1,0,0,1
23306635,23306711,76,0,0,1,2
23306637,23306709,72,0,0,1,1
23306710,23306750,40,1,0,0,1
23306712,23306745,33,1,0,0,2
23306746,23306885,139,0,0,1,2
23306751,23306887,136,0,0,1,1
23306886,23306907,21,1,0,0,2
23306888,23306906,18,1,0,0,1
23306907,23307084,177,0,0,1,1
23306908,23307082,174,0,0,1,2
23307083,23307103,20,1,0,0,2
23307085,23307100,15,1,0,0,1
23307101,23307301,200,0,0,1,1
23307104,23307297,193,0,0,1,2
23307298,23307312,14,1,0,0,2
23307302,23307312,10,1,0,0,1
23307313,23308305,992,0,0,1,1
23307313,23308306,993,0,0,1,2
23308306,23308451,145,1,0,0,1
23308307,23308406,99,1,0,0,2
23308407,23308524,117,0,0,1,2
23308452,23308524,72,0,0,1,1
23308525,23308590,65,1,0,0,1
23308525,23308597,72,1,0,0,2
23308591,23309703,1112,0,0,1,1
23308598,23309000,402,0,0,1,2
23309001,23309018,17,1,0,0,2
23309019,23309703,684,0,0,1,2
23309704,23309751,47,1,0,0,1
23309704,23309765,61,1,0,0,2
23309752,23310128,376,0,0,1,1
23309766,23310128,362,0,0,1,2
23310129,23310197,68,1,0,0,1
23310129,23310221,92,1,0,0,2
23310198,23310266,68,0,0,1,1
23310222,23310266,44,0,0,1,2
23310267,23310307,40,1,0,0,2
23310267,23310338,71,1,0,0,1
23310308,23310488,180,0,0,1,2
23310339,23310491,152,0,0,1,1
23310489,23310502,13,1,0,0,2
23310492,23310500,8,1,0,0,1
23310501,23310943,442,0,0,1,1
23310503,23311157,654,0,0,1,2
23310944,23310948,4,1,0,0,1
23310949,23312121,1172,0,0,1,1
23311158,23311168,10,1,0,0,2
23311169,23312119,950,0,0,1,2
23312120,23312222,102,1,0,0,2
23312122,23312242,120,1,0,0,1
23312223,23312316,93,0,0,1,2
23312243,23312315,72,0,0,1,1
23312316,23312360,44,1,0,0,1
23312317,23312361,44,1,0,0,2
23312361,23313709,1348,0,0,1,1
23312362,23313708,1346,0,0,1,2
23313709,23313812,103,1,0,0,2
23313710,23313793,83,1,0,0,1
23313794,23314134,340,0,0,1,1
23313813,23314133,320,0,0,1,2
23314134,23314225,91,1,0,0,2
23314135,23314213,78,1,0,0,1
23314214,23314428,214,0,0,1,1
23314226,23314429,203,0,0,1,2
23314429,23314445,16,1,0,0,1
23314430,23314462,32,1,0,0,2
23314446,23314625,179,0,0,1,1
23314463,23314625,162,0,0,1,2
23314626,23314634,8,1,0,0,2
23314626,23314635,9,1,0,0,1
23314635,23315964,1329,0,0,1,2
23314636,23315963,1327,0,0,1,1
23315964,23316251,287,1,0,0,1
23315965,23316103,138,1,0,0,2
23316104,23316179,75,0,0,1,2
23316180,23316223,43,1,0,0,2
23316224,23316256,32,0,0,1,2
23316252,23316500,248,0,0,1,1
23316257,23316297,40,1,0,0,2
23316298,23316502,204,0,0,1,2
23316501,23316522,21,1,0,0,1
23316513,23317950,1437,0,1,0,2
23316523,23316739,216,0,0,1,1
23316740,23317376,636,1,0,0,1
23317377,23317405,28,0,0,1,1
23317406,23317531,125,1,0,0,1
23317532,23317657,125,0,0,1,1
23317658,23317816,158,1,0,0,1
23317817,23317855,38,0,0,1,1
23317856,23317972,116,1,0,0,1
23317960,23317980,20,1,0,0,2
23317973,23318044,71,0,0,1,1
23317981,23318044,63,0,0,1,2
23318045,23318086,41,1,0,0,1
23318045,23318092,47,1,0,0,2
23318087,23318207,120,0,0,1,1
23318093,23318206,113,0,0,1,2
23318207,23318223,16,1,0,0,2
23318208,23318228,20,1,0,0,1
23318224,23319570,1346,0,0,1,2
23318229,23319570,1341,0,0,1,1
23319571,23319645,74,1,0,0,2
23319571,23319646,75,1,0,0,1
23319646,23319740,94,0,0,1,2
23319647,23319740,93,0,0,1,1
23319741,23319765,24,1,0,0,1
23319741,23319766,25,1,0,0,2
23319766,23321237,1471,0,0,1,1
23319767,23319969,202,0,0,1,2
23319970,23319986,16,1,0,0,2
23319987,23321221,1234,0,0,1,2
23321222,23321328,106,1,0,0,2
23321238,23321324,86,1,0,0,1
23321325,23321420,95,0,0,1,1
23321329,23321421,92,0,0,1,2
23321421,23321449,28,1,0,0,1
23321422,23321466,44,1,0,0,2
23321450,23322900,1450,0,0,1,1
23321467,23321882,415,0,0,1,2
23321883,23321907,24,1,0,0,2
23321908,23322657,749,0,0,1,2
23322658,23322684,26,1,0,0,2
23322685,23322903,218,0,0,1,2
23322901,23322978,77,1,0,0,1
23322904,23322989,85,1,0,0,2
23322979,23323070,91,0,0,1,1
23322990,23323069,79,0,0,1,2
23323070,23323091,21,1,0,0,2
23323071,23323111,40,1,0,0,1
23323092,23324559,1467,0,0,1,2
23323112,23324559,1447,0,0,1,1
23324560,23324657,97,1,0,0,2
23324560,23324673,113,1,0,0,1
23324658,23324736,78,0,0,1,2
23324674,23324738,64,0,0,1,1
23324737,23324775,38,1,0,0,2
23324739,23324775,36,1,0,0,1
23324776,23324943,167,0,0,1,1
23324776,23324943,167,0,0,1,2
23324944,23324950,6,1,0,0,2
23324944,23324953,9,1,0,0,1
23324951,23326261,1310,0,0,1,2
23324954,23326261,1307,0,0,1,1
23326262,23326342,80,1,0,0,1
23326262,23326356,94,1,0,0,2
23326343,23326456,113,0,0,1,1
23326357,23326456,99,0,0,1,2
23326457,23326476,19,1,0,0,1
23326457,23326493,36,1,0,0,2
23326477,23326652,175,0,0,1,1
23326494,23326653,159,0,0,1,2
23326653,23326661,8,1,0,0,1
23326654,23326665,11,1,0,0,2
23326662,23326869,207,0,0,1,1
23326666,23326848,182,0,0,1,2
23326849,23327152,303,1,0,0,2
23326870,23327073,203,1,0,0,1
23326884,23327036,152,0,1,0,2
23326896,23327011,115,0,1,0,1
23327074,23327906,832,0,0,1,1
23327153,23327904,751,0,0,1,2
23327905,23327976,71,1,0,0,2
23327907,23327976,69,1,0,0,1
23327977,23328080,103,0,0,1,2
23327977,23328082,105,0,0,1,1
23328081,23328130,49,1,0,0,2
23328083,23328120,37,1,0,0,1
23328121,23328342,221,0,0,1,1
23328131,23328342,211,0,0,1,2
23328343,23328514,171,1,0,0,1
23328343,23328591,248,1,0,0,2
23328359,23328466,107,0,1,0,2
23328371,23328438,67,0,1,0,1
23328515,23328919,404,0,0,1,1
23328592,23328908,316,0,0,1,2
23328909,23329164,255,1,0,0,2
23328920,23329148,228,1,0,0,1
23328946,23329095,149,0,1,0,2
23328956,23329069,113,0,1,0,1
23329149,23329802,653,0,0,1,1
23329165,23329798,633,0,0,1,2
23329799,23329923,124,1,0,0,2
23329803,23329907,104,1,0,0,1
23329908,23329986,78,0,0,1,1
23329924,23330030,106,0,0,1,2
23329987,23329996,9,1,0,0,1
23329997,23330022,25,0,0,1,1
23330023,23330055,32,1,0,0,1
23330031,23330214,183,1,0,0,2
23330056,23330199,143,0,0,1,1
23330200,23330206,6,1,0,0,1
23330207,23331204,997,0,0,1,1
23330215,23330312,97,0,0,1,2
23330313,23330325,12,1,0,0,2
23330326,23330524,198,0,0,1,2
23330525,23330826,301,1,0,0,2
23330827,23331206,379,0,0,1,2
23331205,23331215,10,1,0,0,1
23331207,23331229,22,1,0,0,2
23331216,23332615,1399,0,0,1,1
23331230,23332617,1387,0,0,1,2
23332616,23332636,20,1,0,0,1
23332618,23332649,31,1,0,0,2
23332637,23333015,378,0,0,1,1
23332650,23333014,364,0,0,1,2
23333015,23333101,86,1,0,0,2
23333016,23333102,86,1,0,0,1
23333102,23333197,95,0,0,1,2
23333103,23333197,94,0,0,1,1
23333198,23333235,37,1,0,0,1
23333198,23333235,37,1,0,0,2
23333236,23334417,1181,0,0,1,2
23333236,23334418,1182,0,0,1,1
23334418,23334440,22,1,0,0,2
23334419,23334440,21,1,0,0,1
23334441,23334836,395,0,0,1,1
23334441,23334836,395,0,0,1,2
23334837,23334909,72,1,0,0,2
23334837,23334913,76,1,0,0,1
23334910,23335010,100,0,0,1,2
23334914,23335010,96,0,0,1,1
23335011,23335031,20,1,0,0,1
23335011,23335033,22,1,0,0,2
23335032,23335201,169,0,0,1,1
23335034,23336438,1404,0,0,1,2
23335202,23335211,9,1,0,0,1
23335212,23336441,1229,0,0,1,1
23336439,23336481,42,1,0,0,2
23336442,23336482,40,1,0,0,1
23336482,23336623,141,0,0,1,2
23336483,23336625,142,0,0,1,1
23336624,23336639,15,1,0,0,2
23336626,23336641,15,1,0,0,1
23336640,23338044,1404,0,0,1,2
23336642,23338043,1401,0,0,1,1
23338044,23338122,78,1,0,0,1
23338045,23338119,74,1,0,0,2
23338120,23338206,86,0,0,1,2
23338123,23338204,81,0,0,1,1
23338205,23338234,29,1,0,0,1
23338207,23338232,25,1,0,0,2
23338233,23339110,877,0,0,1,2
23338235,23339110,875,0,0,1,1
23339111,23339129,18,1,0,0,1
23339111,23339129,18,1,0,0,2
23339130,23339763,633,0,0,1,2
23339130,23339765,635,0,0,1,1
23339764,23339803,39,1,0,0,2
23339766,23339801,35,1,0,0,1
23339802,23339907,105,0,0,1,1
23339804,23339905,101,0,0,1,2
23339906,23339925,19,1,0,0,2
23339908,23339924,16,1,0,0,1
23339925,23341034,1109,0,0,1,1
23339926,23341034,1108,0,0,1,2
23341035,23341043,8,1,0,0,1
23341035,23341049,14,1,0,0,2
23341044,23341541,497,0,0,1,1
23341050,23341542,492,0,0,1,2
23341542,23341691,149,1,0,0,1
23341543,23341755,212,1,0,0,2
23341692,23341791,99,0,0,1,1
23341756,23341787,31,0,0,1,2
23341788,23341816,28,1,0,0,2
23341792,23341827,35,1,0,0,1
23341817,23341890,73,0,0,1,2
23341828,23341973,145,0,0,1,1
23341891,23341983,92,1,0,0,2
23341974,23341990,16,1,0,0,1
23341984,23342843,859,0,0,1,2
23341991,23343118,1127,0,0,1,1
23342844,23342861,17,1,0,0,2
23342862,23343119,257,0,0,1,2
23343119,23343157,38,1,0,0,1
23343120,23343158,38,1,0,0,2
23343158,23343303,145,0,0,1,1
23343159,23343307,148,0,0,1,2
23343304,23343335,31,1,0,0,1
23343308,23343335,27,1,0,0,2
23343336,23344806,1470,0,0,1,1
23343336,23344807,1471,0,0,1,2
23344807,23345014,207,1,0,0,1
23344808,23344892,84,1,0,0,2
23344893,23344979,86,0,0,1,2
23344980,23345012,32,1,0,0,2
23345013,23345832,819,0,0,1,2
23345015,23345834,819,0,0,1,1
23345833,23345909,76,1,0,0,2
23345835,23345898,63,1,0,0,1
23345899,23346253,354,0,0,1,1
23345910,23346253,343,0,0,1,2
23346254,23346321,67,1,0,0,2
23346254,23346363,109,1,0,0,1
23346322,23346362,40,0,0,1,2
23346363,23346367,4,1,0,0,2
23346364,23346398,34,0,0,1,1
23346368,23346445,77,0,0,1,2
23346399,23346556,157,1,0,0,1
23346446,23347603,1157,1,0,0,2
23346459,23347440,981,0,1,0,2
23346557,23346578,21,0,0,1,1
23346579,23346694,115,1,0,0,1
23346695,23346718,23,0,0,1,1
23346719,23346842,123,1,0,0,1
23346843,23346879,36,0,0,1,1
23346880,23347545,665,1,0,0,1
23347546,23347665,119,0,0,1,1
23347604,23347642,38,0,0,1,2
23347643,23347668,25,1,0,0,2
23347666,23347799,133,1,0,0,1
23347669,23347698,29,0,0,1,2
23347699,23347836,137,1,0,0,2
23347800,23349170,1370,0,0,1,1
23347837,23347977,140,0,0,1,2
23347978,23347996,18,1,0,0,2
23347997,23349169,1172,0,0,1,2
23349170,23349210,40,1,0,0,2
23349171,23349209,38,1,0,0,1
23349210,23349335,125,0,0,1,1
23349211,23349332,121,0,0,1,2
23349333,23349354,21,1,0,0,2
23349336,23349353,17,1,0,0,1
23349354,23351460,2106,0,0,1,1
23349355,23349932,577,0,0,1,2
23349933,23349941,8,1,0,0,2
23349942,23351460,1518,0,0,1,2
23351461,23351534,73,1,0,0,1
23351461,23351550,89,1,0,0,2
23351535,23351614,79,0,0,1,1
23351551,23351611,60,0,0,1,2
23351612,23351638,26,1,0,0,2
23351615,23351639,24,1,0,0,1
23351639,23352039,400,0,0,1,2
23351640,23353233,1593,0,0,1,1
23352040,23352050,10,1,0,0,2
23352051,23353231,1180,0,0,1,2
23353232,23353356,124,1,0,0,2
23353234,23353355,121,1,0,0,1
23353356,23353409,53,0,0,1,1
23353357,23353382,25,0,0,1,2
23353383,23353640,257,1,0,0,2
23353410,23353504,94,1,0,0,1
23353478,23353493,15,0,1,0,2
23353505,23353729,224,0,0,1,1
23353641,23353677,36,0,0,1,2
23353678,23353762,84,1,0,0,2
23353702,23353721,19,0,1,0,2
23353730,23353769,39,1,0,0,1
23353763,23353926,163,0,0,1,2
23353770,23353814,44,0,0,1,1
23353815,23353819,4,1,0,0,1
23353820,23354073,253,0,0,1,1
23353927,23353933,6,1,0,0,2
23353934,23353960,26,0,0,1,2
23353971,23354616,645,0,1,0,2
23354074,23354131,57,1,0,0,1
23354132,23354567,435,0,0,1,1
23354568,23354655,87,1,0,0,1
23354626,23354707,81,1,0,0,2
23354656,23355064,408,0,0,1,1
23354708,23355065,357,0,0,1,2
23355065,23355111,46,1,0,0,1
23355066,23355114,48,1,0,0,2
23355112,23355212,100,0,0,1,1
23355115,23355212,97,0,0,1,2
23355213,23355245,32,1,0,0,1
23355213,23355257,44,1,0,0,2
23355246,23355367,121,0,0,1,1
23355258,23355366,108,0,0,1,2
23355367,23355385,18,1,0,0,2
23355368,23355384,16,1,0,0,1
23355385,23356855,1470,0,0,1,1
23355386,23356853,1467,0,0,1,2
23356854,23356911,57,1,0,0,2
23356856,23356915,59,1,0,0,1
23356912,23357006,94,0,0,1,2
23356916,23357005,89,0,0,1,1
23357006,23357034,28,1,0,0,1
23357007,23357028,21,1,0,0,2
23357029,23357195,166,0,0,1,2
23357035,23358137,1102,0,0,1,1
23357196,23357213,17,1,0,0,2
23357214,23358136,922,0,0,1,2
23358137,23358160,23,1,0,0,2
23358138,23358161,23,1,0,0,1
23358161,23358534,373,0,0,1,2
23358162,23358536,374,0,0,1,1
23358535,23358621,86,1,0,0,2
23358537,23358617,80,1,0,0,1
23358618,23358760,142,0,0,1,1
23358622,23358757,135,0,0,1,2
23358758,23358785,27,1,0,0,2
23358761,23358778,17,1,0,0,1
23358779,23359184,405,0,0,1,1
23358786,23359752,966,0,0,1,2
23359185,23359195,10,1,0,0,1
23359196,23359751,555,0,0,1,1
23359752,23359799,47,1,0,0,1
23359753,23359795,42,1,0,0,2
23359796,23359877,81,0,0,1,2
23359800,23359877,77,0,0,1,1
23359878,23359921,43,1,0,0,1
23359878,23359923,45,1,0,0,2
23359922,23360253,331,0,0,1,1
23359924,23360254,330,0,0,1,2
23360254,23360376,122,1,0,0,1
23360255,23360351,96,1,0,0,2
23360352,23360445,93,0,0,1,2
23360377,23360448,71,0,0,1,1
23360446,23360485,39,1,0,0,2
23360449,23360494,45,1,0,0,1
23360486,23360622,136,0,0,1,2
23360495,23360619,124,0,0,1,1
23360620,23360647,27,1,0,0,1
23360623,23360639,16,1,0,0,2
23360640,23360907,267,0,0,1,2
23360648,23361009,361,0,0,1,1
23360908,23360981,73,1,0,0,2
23360982,23361006,24,0,0,1,2
23361007,23361023,16,1,0,0,2
23361010,23361020,10,1,0,0,1
23361021,23361461,440,0,0,1,1
23361024,23361069,45,0,0,1,2
23361070,23361098,28,1,0,0,2
23361099,23361293,194,0,0,1,2
23361304,23361316,12,0,1,0,2
23361325,23361325,0,1,0,0,2
23361326,23361365,39,0,0,1,2
23361376,23361382,6,0,1,0,2
23361391,23361391,0,1,0,0,2
23361392,23361453,61,0,0,1,2
23361454,23361533,79,1,0,0,2
23361462,23361516,54,1,0,0,1
23361467,23361471,4,0,1,0,2
23361517,23361686,169,0,0,1,1
23361534,23361686,152,0,0,1,2
23361687,23361736,49,1,0,0,1
23361687,23361737,50,1,0,0,2
23361737,23362020,283,0,0,1,1
23361738,23362019,281,0,0,1,2
23362020,23362082,62,1,0,0,2
23362021,23362068,47,1,0,0,1
23362069,23362258,189,0,0,1,1
23362083,23362938,855,0,0,1,2
23362259,23362285,26,1,0,0,1
23362286,23362937,651,0,0,1,1
23362938,23362955,17,1,0,0,1
23362939,23362956,17,1,0,0,2
23362956,23363669,713,0,0,1,1
23362957,23363669,712,0,0,1,2
23363670,23363809,139,1,0,0,1
23363670,23364971,1301,1,0,0,2
23363770,23363804,34,0,1,0,2
23363810,23363907,97,0,0,1,1
23363830,23363863,33,0,1,0,2
23363908,23363954,46,1,0,0,1
23363915,23364858,943,0,1,0,2
23363955,23364374,419,0,0,1,1
23364375,23364401,26,1,0,0,1
23364402,23364746,344,0,0,1,1
23364747,23364896,149,1,0,0,1
23364818,23364819,1,0,1,0,1
23364897,23365380,483,0,0,1,1
23364972,23365379,407,0,0,1,2
23365380,23365467,87,1,0,0,2
23365381,23365484,103,1,0,0,1
23365468,23365613,145,0,0,1,2
23365485,23365621,136,0,0,1,1
23365614,23365638,24,1,0,0,2
23365622,23365631,9,1,0,0,1
23365632,23366425,793,0,0,1,1
23365639,23365871,232,0,0,1,2
23365872,23366656,784,1,0,0,2
23366426,23366462,36,1,0,0,1
23366463,23366712,249,0,0,1,1
23366657,23366915,258,0,0,1,2
23366713,23366751,38,1,0,0,1
23366752,23366917,165,0,0,1,1
23366916,23366990,74,1,0,0,2
23366918,23366986,68,1,0,0,1
23366987,23367089,102,0,0,1,1
23366991,23367089,98,0,0,1,2
23367090,23367125,35,1,0,0,2
23367090,23367134,44,1,0,0,1
23367126,23367451,325,0,0,1,2
23367135,23367171,36,0,0,1,1
23367172,23367784,612,1,0,0,1
23367452,23367591,139,1,0,0,2
23367592,23367639,47,0,0,1,2
23367640,23368061,421,1,0,0,2
23367785,23367826,41,0,0,1,1
23367827,23368698,871,1,0,0,1
23368062,23368121,59,0,0,1,2
23368122,23370727,2605,1,0,0,2
23368699,23368735,36,0,0,1,1
23368736,23368869,133,1,0,0,1
23368777,23368965,188,0,1,0,2
23368870,23368923,53,0,0,1,1
23368924,23368957,33,1,0,0,1
23368958,23369111,153,0,0,1,1
23369112,23369139,27,1,0,0,1
23369140,23369541,401,0,0,1,1
23369542,23369987,445,1,0,0,1
23369553,23370367,814,0,1,0,2
23369573,23369936,363,0,1,0,1
23369988,23370026,38,0,0,1,1
23370027,23370064,37,1,0,0,1
23370065,23370622,557,0,0,1,1
23370399,23370412,13,0,1,0,2
23370443,23370445,2,0,1,0,2
23370623,23370705,82,1,0,0,1
23370706,23370788,82,0,0,1,1
23370728,23370782,54,0,0,1,2
23370783,23370844,61,1,0,0,2
23370789,23370825,36,1,0,0,1
23370826,23370980,154,0,0,1,1
23370845,23370982,137,0,0,1,2
23370981,23371007,26,1,0,0,1
23370983,23371003,20,1,0,0,2
23371004,23371189,185,0,0,1,2
23371008,23371558,550,0,0,1,1
23371190,23371206,16,1,0,0,2
23371207,23372701,1494,0,0,1,2
23371559,23371571,12,1,0,0,1
23371572,23372701,1129,0,0,1,1
23372702,23372788,86,1,0,0,1
23372702,23372792,90,1,0,0,2
23372789,23372904,115,0,0,1,1
23372793,23372902,109,0,0,1,2
23372903,23372952,49,1,0,0,2
23372905,23372947,42,1,0,0,1
23372948,23373870,922,0,0,1,1
23372953,23373871,918,0,0,1,2
23373871,23373890,19,1,0,0,1
23373872,23373889,17,1,0,0,2
23373890,23374294,404,0,0,1,2
23373891,23374293,402,0,0,1,1
23374294,23374363,69,1,0,0,1
23374295,23374356,61,1,0,0,2
23374357,23374489,132,0,0,1,2
23374364,23374491,127,0,0,1,1
23374490,23374516,26,1,0,0,2
23374492,23374514,22,1,0,0,1
23374515,23375342,827,0,0,1,1
23374517,23375341,824,0,0,1,2
23375342,23375362,20,1,0,0,2
23375343,23375352,9,1,0,0,1
23375353,23376063,710,0,0,1,1
23375363,23376063,700,0,0,1,2
23376064,23376128,64,1,0,0,1
23376064,23376131,67,1,0,0,2
23376129,23376218,89,0,0,1,1
23376132,23376218,86,0,0,1,2
23376219,23376248,29,1,0,0,1
23376219,23376249,30,1,0,0,2
23376249,23376455,206,0,0,1,1
23376250,23377735,1485,0,0,1,2
23376456,23376471,15,1,0,0,1
23376472,23377181,709,0,0,1,1
23377182,23377198,16,1,0,0,1
23377199,23377736,537,0,0,1,1
23377736,23377788,52,1,0,0,2
23377737,23377786,49,1,0,0,1
23377787,23379600,1813,0,0,1,1
23377789,23377958,169,0,0,1,2
23377959,23377969,10,1,0,0,2
23377970,23379601,1631,0,0,1,2
23379601,23379705,104,1,0,0,1
23379602,23379714,112,1,0,0,2
23379706,23379830,124,0,0,1,1
23379715,23379828,113,0,0,1,2
23379829,23379850,21,1,0,0,2
23379831,23379849,18,1,0,0,1
23379850,23381003,1153,0,0,1,1
23379851,23381000,1149,0,0,1,2
23381001,23381012,11,1,0,0,2
23381004,23381016,12,1,0,0,1
23381013,23381439,426,0,0,1,2
23381017,23381440,423,0,0,1,1
23381440,23381483,43,1,0,0,2
23381441,23381518,77,1,0,0,1
23381484,23381616,132,0,0,1,2
23381519,23381616,97,0,0,1,1
23381617,23381631,14,1,0,0,2
23381617,23381632,15,1,0,0,1
23381632,23382575,943,0,0,1,2
23381633,23382574,941,0,0,1,1
23382575,23382591,16,1,0,0,1
23382576,23382592,16,1,0,0,2
23382592,23383079,487,0,0,1,1
23382593,23383076,483,0,0,1,2
23383077,23383173,96,1,0,0,2
23383080,23383192,112,1,0,0,1
23383174,23383254,80,0,0,1,2
23383193,23383229,36,0,0,1,1
23383230,23383288,58,1,0,0,1
23383255,23383284,29,1,0,0,2
23383285,23383518,233,0,0,1,2
23383289,23384637,1348,0,0,1,1
23383519,23383524,5,1,0,0,2
23383525,23384802,1277,0,0,1,2
23384638,23384642,4,1,0,0,1
23384643,23384803,160,0,0,1,1
23384803,23384870,67,1,0,0,2
23384804,23384866,62,1,0,0,1
23384867,23384967,100,0,0,1,1
23384871,23384968,97,0,0,1,2
23384968,23384996,28,1,0,0,1
23384969,23384990,21,1,0,0,2
23384991,23385175,184,0,0,1,2
23384997,23385169,172,0,0,1,1
23385170,23385193,23,1,0,0,1
23385176,23385185,9,1,0,0,2
23385186,23386723,1537,0,0,1,2
23385194,23386722,1528,0,0,1,1
23386723,23386780,57,1,0,0,1
23386724,23386781,57,1,0,0,2
23386781,23386883,102,0,0,1,1
23386782,23386881,99,0,0,1,2
23386882,23386904,22,1,0,0,2
23386884,23386912,28,1,0,0,1
23386905,23387051,146,0,0,1,2
23386913,23389347,2434,0,0,1,1
23387052,23387066,14,1,0,0,2
23387067,23388734,1667,0,0,1,2
23388735,23388745,10,1,0,0,2
23388746,23389345,599,0,0,1,2
23389346,23389392,46,1,0,0,2
23389348,23389401,53,1,0,0,1
23389393,23389555,162,0,0,1,2
23389402,23389550,148,0,0,1,1
23389551,23389571,20,1,0,0,1
23389556,23389569,13,1,0,0,2
23389570,23391021,1451,0,0,1,2
23389572,23390667,1095,0,0,1,1
23390668,23390685,17,1,0,0,1
23390686,23391020,334,0,0,1,1
23391021,23391059,38,1,0,0,1
23391022,23391056,34,1,0,0,2
23391057,23391480,423,0,0,1,2
23391060,23391479,419,0,0,1,1
23391480,23391544,64,1,0,0,1
23391481,23391545,64,1,0,0,2
23391545,23392628,1083,0,0,1,1
23391546,23392628,1082,0,0,1,2
23392629,23392659,30,1,0,0,1
23392629,23392660,31,1,0,0,2
23392660,23392990,330,0,0,1,1
23392661,23392994,333,0,0,1,2
23392991,23393106,115,1,0,0,1
23392995,23393125,130,1,0,0,2
23393107,23393220,113,0,0,1,1
23393126,23393220,94,0,0,1,2
23393221,23393255,34,1,0,0,1
23393221,23393260,39,1,0,0,2
23393256,23394314,1058,0,0,1,1
23393261,23394316,1055,0,0,1,2
23394315,23394368,53,1,0,0,1
23394317,23394406,89,1,0,0,2
23394369,23394609,240,0,0,1,1
23394407,23394608,201,0,0,1,2
23394609,23394638,29,1,0,0,2
23394610,23394633,23,1,0,0,1
23394634,23395264,630,0,0,1,1
23394639,23395268,629,0,0,1,2
23395265,23395287,22,1,0,0,1
23395269,23395285,16,1,0,0,2
23395286,23396281,995,0,0,1,2
23395288,23396283,995,0,0,1,1
23396282,23396317,35,1,0,0,2
23396284,23396316,32,1,0,0,1
23396317,23396446,129,0,0,1,1
23396318,23396449,131,0,0,1,2
23396447,23396512,65,1,0,0,1
23396450,23396512,62,1,0,0,2
23396513,23396867,354,0,0,1,1
23396513,23396870,357,0,0,1,2
23396868,23396915,47,1,0,0,1
23396871,23396915,44,1,0,0,2
23396916,23397389,473,0,0,1,1
23396916,23397390,474,0,0,1,2
23397390,23397437,47,1,0,0,1
23397391,23397435,44,1,0,0,2
23397436,23397542,106,0,0,1,2
23397438,23397541,103,0,0,1,1
23397542,23397567,25,1,0,0,1
23397543,23397566,23,1,0,0,2
23397567,23397711,144,0,0,1,2
23397568,23398969,1401,0,0,1,1
23397712,23397727,15,1,0,0,2
23397728,23398421,693,0,0,1,2
23398422,23398430,8,1,0,0,2
23398431,23399216,785,0,0,1,2
23398970,23398985,15,1,0,0,1
23398986,23399107,121,0,0,1,1
23399108,23399113,5,1,0,0,1
23399114,23399221,107,0,0,1,1
23399217,23399260,43,1,0,0,2
23399222,23399259,37,1,0,0,1
23399260,23399558,298,0,0,1,1
23399261,23399558,297,0,0,1,2
23399559,23399571,12,1,0,0,1
23399559,23399576,17,1,0,0,2
23399572,23401069,1497,0,0,1,1
23399577,23400257,680,0,0,1,2
23400258,23400274,16,1,0,0,2
23400275,23401067,792,0,0,1,2
23401068,23401085,17,1,0,0,2
23401070,23401085,15,1,0,0,1
23401086,23402462,1376,0,0,1,1
23401086,23402463,1377,0,0,1,2
23402463,23402527,64,1,0,0,1
23402464,23402518,54,1,0,0,2
23402519,23402763,244,0,0,1,2
23402528,23402762,234,0,0,1,1
23402763,23402829,66,1,0,0,1
23402764,23402864,100,1,0,0,2
23402830,23402939,109,0,0,1,1
23402865,23402941,76,0,0,1,2
23402940,23402967,27,1,0,0,1
23402942,23402960,18,1,0,0,2
23402961,23405403,2442,0,0,1,2
23402968,23405402,2434,0,0,1,1
23405403,23405461,58,1,0,0,1
23405404,23405464,60,1,0,0,2
23405462,23406155,693,0,0,1,1
23405465,23406159,694,0,0,1,2
23406156,23406166,10,1,0,0,1
23406160,23406165,5,1,0,0,2
23406166,23407489,1323,0,0,1,2
23406167,23407488,1321,0,0,1,1
23407489,23407549,60,1,0,0,1
23407490,23407550,60,1,0,0,2
23407550,23409207,1657,0,0,1,1
23407551,23409206,1655,0,0,1,2
23409207,23409293,86,1,0,0,2
23409208,23409273,65,1,0,0,1
23409274,23409392,118,0,0,1,1
23409294,23409391,97,0,0,1,2
23409392,23409410,18,1,0,0,2
23409393,23409416,23,1,0,0,1
23409411,23410136,725,0,0,1,2
23409417,23410135,718,0,0,1,1
23410136,23410140,4,1,0,0,1
23410137,23410141,4,1,0,0,2
23410141,23411646,1505,0,0,1,1
23410142,23411646,1504,0,0,1,2
23411647,23411697,50,1,0,0,2
23411647,23411699,52,1,0,0,1
23411698,23413418,1720,0,0,1,2
23411700,23413416,1716,0,0,1,1
23413417,23413438,21,1,0,0,1
23413419,23413438,19,1,0,0,2
23413439,23414914,1475,0,0,1,1
23413439,23414914,1475,0,0,1,2
23414915,23414996,81,1,0,0,2
23414915,23415021,106,1,0,0,1
23414997,23415126,129,0,0,1,2
23415022,23415125,103,0,0,1,1
23415126,23415148,22,1,0,0,1
23415127,23415150,23,1,0,0,2
23415149,23415295,146,0,0,1,1
23415151,23415299,148,0,0,1,2
23415296,23415310,14,1,0,0,1
23415300,23415310,10,1,0,0,2
23415311,23416436,1125,0,0,1,1
23415311,23416438,1127,0,0,1,2
23416437,23416494,57,1,0,0,1
23416439,23416493,54,1,0,0,2
23416494,23416744,250,0,0,1,2
23416495,23416744,249,0,0,1,1
23416745,23416764,19,1,0,0,1
23416745,23416765,20,1,0,0,2
23416765,23418003,1238,0,0,1,1
23416766,23418002,1236,0,0,1,2
23418003,23418036,33,1,0,0,2
23418004,23418035,31,1,0,0,1
23418036,23418538,502,0,0,1,1
23418037,23418538,501,0,0,1,2
23418539,23418571,32,1,0,0,1
23418539,23418572,33,1,0,0,2
23418572,23418709,137,0,0,1,1
23418573,23418709,136,0,0,1,2
23418710,23418797,87,1,0,0,1
23418710,23418822,112,1,0,0,2
23418798,23419837,1039,0,0,1,1
23418823,23419838,1015,0,0,1,2
23419838,23419889,51,1,0,0,1
23419839,23419888,49,1,0,0,2
23419889,23420056,167,0,0,1,2
23419890,23420139,249,0,0,1,1
23420057,23420066,9,1,0,0,2
23420067,23420132,65,0,0,1,2
23420133,23420335,202,1,0,0,2
23420140,23420306,166,1,0,0,1
23420159,23420237,78,0,1,0,2
23420169,23420218,49,0,1,0,1
23420307,23421158,851,0,0,1,1
23420336,23421156,820,0,0,1,2
23421157,23421203,46,1,0,0,2
23421159,23421203,44,1,0,0,1
23421204,23421968,764,0,0,1,1
23421204,23421973,769,0,0,1,2
23421969,23421985,16,1,0,0,1
23421974,23422000,26,1,0,0,2
23421986,23422189,203,0,0,1,1
23422001,23422190,189,0,0,1,2
23422190,23422255,65,1,0,0,1
23422191,23422256,65,1,0,0,2
23422256,23423432,1176,0,0,1,1
23422257,23423432,1175,0,0,1,2
23423433,23423488,55,1,0,0,1
23423433,23423488,55,1,0,0,2
23423489,23424259,770,0,0,1,1
23423489,23424259,770,0,0,1,2
23424260,23424316,56,1,0,0,1
23424260,23424317,57,1,0,0,2
23424317,23424444,127,0,0,1,1
23424318,23424444,126,0,0,1,2
23424445,23424538,93,1,0,0,2
23424445,23424557,112,1,0,0,1
23424539,23424656,117,0,0,1,2
23424558,23424659,101,0,0,1,1
23424657,23424685,28,1,0,0,2
23424660,23424693,33,1,0,0,1
23424686,23425371,685,0,0,1,2
23424694,23426189,1495,0,0,1,1
23425372,23425382,10,1,0,0,2
23425383,23426417,1034,0,0,1,2
23426190,23426194,4,1,0,0,1
23426195,23426420,225,0,0,1,1
23426418,23426562,144,1,0,0,2
23426421,23426488,67,1,0,0,1
23426467,23426501,34,0,1,0,2
23426489,23426749,260,0,0,1,1
23426563,23426615,52,0,0,1,2
23426616,23426704,88,1,0,0,2
23426705,23426750,45,0,0,1,2
23426750,23426771,21,1,0,0,1
23426751,23427280,529,1,0,0,2
23426765,23427218,453,0,1,0,2
23426772,23427582,810,0,0,1,1
23427281,23427329,48,0,0,1,2
23427340,23427600,260,0,1,0,2
23427583,23427620,37,1,0,0,1
23427610,23427624,14,1,0,0,2
23427621,23427919,298,0,0,1,1
23427625,23427729,104,0,0,1,2
23427730,23427785,55,1,0,0,2
23427786,23427917,131,0,0,1,2
23427918,23428030,112,1,0,0,2
23427920,23427947,27,1,0,0,1
23427939,23428019,80,0,1,0,2
23427948,23428450,502,0,0,1,1
23428031,23428081,50,0,0,1,2
23428082,23428215,133,1,0,0,2
23428109,23428189,80,0,1,0,2
23428216,23428371,155,0,0,1,2
23428372,23428802,430,1,0,0,2
23428443,23428674,231,0,1,0,2
23428451,23428728,277,1,0,0,1
23428484,23428639,155,0,1,0,1
23428729,23429597,868,0,0,1,1
23428803,23429329,526,0,0,1,2
23429330,23429403,73,1,0,0,2
23429404,23429597,193,0,0,1,2
23429598,23429649,51,1,0,0,1
23429598,23429650,52,1,0,0,2
23429650,23429851,201,0,0,1,1
23429651,23429852,201,0,0,1,2
23429852,23429932,80,1,0,0,1
23429853,23429935,82,1,0,0,2
23429933,23430168,235,0,0,1,1
23429936,23430165,229,0,0,1,2
23430166,23430190,24,1,0,0,2
23430169,23430198,29,1,0,0,1
23430191,23431770,1579,0,0,1,2
23430199,23431770,1571,0,0,1,1
23431771,23431822,51,1,0,0,1
23431771,23431837,66,1,0,0,2
23431823,23432083,260,0,0,1,1
23431838,23432083,245,0,0,1,2
23432084,23432105,21,1,0,0,1
23432084,23432108,24,1,0,0,2
23432106,23432593,487,0,0,1,1
23432109,23432593,484,0,0,1,2
23432594,23432624,30,1,0,0,1
23432594,23432626,32,1,0,0,2
23432625,23432798,173,0,0,1,1
23432627,23432777,150,0,0,1,2
23432778,23433046,268,1,0,0,2
23432799,23432987,188,1,0,0,1
23432814,23432953,139,0,1,0,2
23432832,23432913,81,0,1,0,1
23432988,23434143,1155,0,0,1,1
23433047,23434144,1097,0,0,1,2
23434144,23434184,40,1,0,0,1
23434145,23434184,39,1,0,0,2
23434185,23435195,1010,0,0,1,2
23434185,23435197,1012,0,0,1,1
23435196,23435226,30,1,0,0,2
23435198,23435225,27,1,0,0,1
23435226,23435813,587,0,0,1,1
23435227,23435811,584,0,0,1,2
23435812,23435849,37,1,0,0,2
23435814,23435850,36,1,0,0,1
23435850,23435967,117,0,0,1,2
23435851,23435966,115,0,0,1,1
23435967,23435996,29,1,0,0,1
23435968,23435990,22,1,0,0,2
23435991,23436170,179,0,0,1,2
23435997,23436182,185,0,0,1,1
23436171,23436369,198,1,0,0,2
23436183,23436350,167,1,0,0,1
23436203,23436316,113,0,1,0,2
23436208,23436267,59,0,1,0,1
23436351,23436486,135,0,0,1,1
23436370,23436482,112,0,0,1,2
23436483,23436497,14,1,0,0,2
23436487,23436495,8,1,0,0,1
23436496,23437131,635,0,0,1,1
23436498,23436859,361,0,0,1,2
23436860,23436868,8,1,0,0,2
23436869,23437131,262,0,0,1,2
23437132,23437192,60,1,0,0,2
23437132,23437202,70,1,0,0,1
23437193,23439160,1967,0,0,1,2
23437203,23438760,1557,0,0,1,1
23438761,23438770,9,1,0,0,1
23438771,23439174,403,0,0,1,1
23439161,23439430,269,1,0,0,2
23439175,23439403,228,1,0,0,1
23439201,23439356,155,0,1,0,2
23439212,23439309,97,0,1,0,1
23439404,23440338,934,0,0,1,1
23439431,23440337,906,0,0,1,2
23440338,23440407,69,1,0,0,2
23440339,23440389,50,1,0,0,1
23440390,23440536,146,0,0,1,1
23440408,23440536,128,0,0,1,2
23440537,23440555,18,1,0,0,2
23440537,23440556,19,1,0,0,1
23440556,23442142,1586,0,0,1,2
23440557,23443696,3139,0,0,1,1
23442143,23442154,11,1,0,0,2
23442155,23442300,145,0,0,1,2
23442301,23442311,10,1,0,0,2
23442312,23443356,1044,0,0,1,2
23443357,23443378,21,1,0,0,2
23443379,23443696,317,0,0,1,2
23443697,23443749,52,1,0,0,2
23443697,23443760,63,1,0,0,1
23443750,23443920,170,0,0,1,2
23443761,23443921,160,0,0,1,1
23443921,23443925,4,1,0,0,2
23443922,23443939,17,1,0,0,1
23443926,23445057,1131,0,0,1,2
23443940,23445064,1124,0,0,1,1
23445058,23445357,299,1,0,0,2
23445065,23445313,248,1,0,0,1
23445080,23445339,259,0,1,0,2
23445091,23445245,154,0,1,0,1
23445314,23445905,591,0,0,1,1
23445358,23445891,533,0,0,1,2
23445892,23446295,403,1,0,0,2
23445906,23446210,304,1,0,0,1
23445925,23446185,260,0,1,0,2
23445935,23446161,226,0,1,0,1
23446211,23446234,23,0,0,1,1
23446235,23446239,4,1,0,0,1
23446240,23446683,443,0,0,1,1
23446296,23446678,382,0,0,1,2
23446679,23446928,249,1,0,0,2
23446684,23446901,217,1,0,0,1
23446701,23446876,175,0,1,0,2
23446703,23446846,143,0,1,0,1
23446902,23447553,651,0,0,1,1
23446929,23447542,613,0,0,1,2
23447543,23452513,4970,1,0,0,2
23447554,23447740,186,1,0,0,1
23447569,23447761,192,0,1,0,2
23447573,23447706,133,0,1,0,1
23447741,23447788,47,0,0,1,1
23447789,23447840,51,1,0,0,1
23447804,23450305,2501,0,1,0,2
23447841,23447966,125,0,0,1,1
23447967,23448018,51,1,0,0,1
23448019,23448113,94,0,0,1,1
23448114,23448134,20,1,0,0,1
23448135,23448312,177,0,0,1,1
23448313,23448324,11,1,0,0,1
23448325,23449047,722,0,0,1,1
23449048,23449055,7,1,0,0,1
23449056,23450177,1121,0,0,1,1
23450178,23450235,57,1,0,0,1
23450236,23450336,100,0,0,1,1
23450337,23450384,47,1,0,0,1
23450385,23450702,317,0,0,1,1
23450703,23450725,22,1,0,0,1
23450726,23450924,198,0,0,1,1
23450925,23450947,22,1,0,0,1
23450948,23451218,270,0,0,1,1
23451219,23451250,31,1,0,0,1
23451251,23452404,1153,0,0,1,1
23452405,23452477,72,1,0,0,1
23452443,23452455,12,0,1,0,2
23452478,23453229,751,0,0,1,1
23452514,23453228,714,0,0,1,2
23453229,23453249,20,1,0,0,2
23453230,23453248,18,1,0,0,1
23453249,23453833,584,0,0,1,1
23453250,23453834,584,0,0,1,2
23453834,23453870,36,1,0,0,1
23453835,23453870,35,1,0,0,2
23453871,23454037,166,0,0,1,1
23453871,23454038,167,0,0,1,2
23454038,23454092,54,1,0,0,1
23454039,23454092,53,1,0,0,2
23454093,23454237,144,0,0,1,1
23454093,23454238,145,0,0,1,2
23454238,23454257,19,1,0,0,1
23454239,23454255,16,1,0,0,2
23454256,23454846,590,0,0,1,2
23454258,23454846,588,0,0,1,1
23454847,23454857,10,1,0,0,2
23454847,23454858,11,1,0,0,1
23454858,23456313,1455,0,0,1,2
23454859,23456313,1454,0,0,1,1
23456314,23456404,90,1,0,0,1
23456314,23456405,91,1,0,0,2
23456405,23456576,171,0,0,1,1
23456406,23456576,170,0,0,1,2
23456577,23456592,15,1,0,0,1
23456577,23456593,16,1,0,0,2
23456593,23457753,1160,0,0,1,1
23456594,23457755,1161,0,0,1,2
23457754,23457774,20,1,0,0,1
23457756,23457773,17,1,0,0,2
23457774,23458496,722,0,0,1,2
23457775,23458128,353,0,0,1,1
23458129,23458143,14,1,0,0,1
23458144,23458495,351,0,0,1,1
23458496,23458568,72,1,0,0,1
23458497,23458596,99,1,0,0,2
23458569,23459541,972,0,0,1,1
23458597,23459542,945,0,0,1,2
23459542,23459661,119,1,0,0,1
23459543,23459635,92,1,0,0,2
23459636,23459713,77,0,0,1,2
23459662,23459744,82,0,0,1,1
23459714,23459886,172,1,0,0,2
23459745,23459798,53,1,0,0,1
23459773,23459803,30,0,1,0,2
23459799,23460945,1146,0,0,1,1
23459887,23459934,47,0,0,1,2
23459935,23459941,6,1,0,0,2
23459942,23460003,61,0,0,1,2
23460004,23461998,1994,1,0,0,2
23460946,23460999,53,1,0,0,1
23461000,23461081,81,0,0,1,1
23461082,23461095,13,1,0,0,1
23461096,23461379,283,0,0,1,1
23461380,23461418,38,1,0,0,1
23461419,23461472,53,0,0,1,1
23461473,23461477,4,1,0,0,1
23461478,23461907,429,0,0,1,1
23461707,23461712,5,0,1,0,2
23461908,23461968,60,1,0,0,1
23461969,23461969,0,0,1,0,2
23461969,23462073,104,0,0,1,1
23461999,23462070,71,0,0,1,2
23462071,23462108,37,1,0,0,2
23462074,23462118,44,1,0,0,1
23462109,23462307,198,0,0,1,2
23462119,23462201,82,0,0,1,1
23462202,23462280,78,1,0,0,1
23462281,23462313,32,0,0,1,1
23462308,23462323,15,1,0,0,2
23462314,23462365,51,1,0,0,1
23462324,23464110,1786,0,0,1,2
23462366,23462612,246,0,0,1,1
23462613,23462637,24,1,0,0,1
23462638,23462672,34,0,0,1,1
23462673,23462683,10,1,0,0,1
23462684,23464107,1423,0,0,1,1
23464108,23464171,63,1,0,0,1
23464111,23464198,87,1,0,0,2
23464172,23464341,169,0,0,1,1
23464199,23464342,143,0,0,1,2
23464342,23464394,52,1,0,0,1
23464343,23464397,54,1,0,0,2
23464395,23464773,378,0,0,1,1
23464398,23464772,374,0,0,1,2
23464773,23464823,50,1,0,0,2
23464774,23464822,48,1,0,0,1
23464823,23465493,670,0,0,1,1
23464824,23465494,670,0,0,1,2
23465494,23465520,26,1,0,0,1
23465495,23465519,24,1,0,0,2
23465520,23465789,269,0,0,1,2
23465521,23465795,274,0,0,1,1
23465790,23466640,850,1,0,0,2
23465796,23465936,140,1,0,0,1
23465835,23465934,99,0,1,0,2
23465937,23466039,102,0,0,1,1
23465960,23466494,534,0,1,0,2
23466040,23466085,45,1,0,0,1
23466086,23466748,662,0,0,1,1
23466523,23466536,13,0,1,0,2
23466641,23466714,73,0,0,1,2
23466715,23466729,14,1,0,0,2
23466730,23466785,55,0,0,1,2
23466749,23466764,15,1,0,0,1
23466765,23467116,351,0,0,1,1
23466786,23466800,14,1,0,0,2
23466801,23466905,104,0,0,1,2
23466906,23467028,122,1,0,0,2
23467029,23467134,105,0,0,1,2
23467117,23467128,11,1,0,0,1
23467129,23467914,785,0,0,1,1
23467135,23467232,97,1,0,0,2
23467233,23467340,107,0,0,1,2
23467341,23467395,54,1,0,0,2
23467396,23467464,68,0,0,1,2
23467465,23467861,396,1,0,0,2
23467830,23467837,7,0,1,0,2
23467862,23467916,54,0,0,1,2
23467915,23467958,43,1,0,0,1
23467917,23468679,762,1,0,0,2
23467959,23468550,591,0,0,1,1
23467997,23467998,1,0,1,0,2
23468113,23468135,22,0,1,0,2
23468297,23468305,8,0,1,0,2
23468345,23468351,6,0,1,0,2
23468474,23468474,0,0,1,0,2
23468551,23468568,17,1,0,0,1
23468569,23469926,1357,0,0,1,1
23468680,23468780,100,0,0,1,2
23468791,23468796,5,0,1,0,2
23468806,23468866,60,1,0,0,2
23468867,23468890,23,0,0,1,2
23468891,23469173,282,1,0,0,2
23468965,23469014,49,0,1,0,2
23469091,23469112,21,0,1,0,2
23469174,23469233,59,0,0,1,2
23469244,23469272,28,0,1,0,2
23469282,23469295,13,1,0,0,2
23469296,23469405,109,0,0,1,2
23469406,23469504,98,1,0,0,2
23469447,23469469,22,0,1,0,2
23469505,23469683,178,0,0,1,2
23469694,23469694,0,0,1,0,2
23469704,23469772,68,1,0,0,2
23469773,23469869,96,0,0,1,2
23469880,23469919,39,0,1,0,2
23469927,23470054,127,1,0,0,1
23469929,23470071,142,1,0,0,2
23469941,23469994,53,0,1,0,2
23470055,23470309,254,0,0,1,1
23470072,23470310,238,0,0,1,2
23470310,23470352,42,1,0,0,1
23470311,23470349,38,1,0,0,2
23470350,23471491,1141,0,0,1,2
23470353,23471491,1138,0,0,1,1
23471492,23471559,67,1,0,0,1
23471492,23471568,76,1,0,0,2
23471560,23471692,132,0,0,1,1
23471569,23471693,124,0,0,1,2
23471693,23471748,55,1,0,0,1
23471694,23471749,55,1,0,0,2
23471749,23471842,93,0,0,1,1
23471750,23471847,97,0,0,1,2
23471843,23471865,22,1,0,0,1
23471848,23471864,16,1,0,0,2
23471865,23473563,1698,0,0,1,2
23471866,23473834,1968,0,0,1,1
23473564,23473577,13,1,0,0,2
23473578,23473834,256,0,0,1,2
23473835,23473897,62,1,0,0,1
23473835,23473898,63,1,0,0,2
23473898,23475700,1802,0,0,1,1
23473899,23475700,1801,0,0,1,2
23475701,23475718,17,1,0,0,1
23475701,23475732,31,1,0,0,2
23475719,23476577,858,0,0,1,1
23475733,23476578,845,0,0,1,2
23476578,23476615,37,1,0,0,1
23476579,23476617,38,1,0,0,2
23476616,23477072,456,0,0,1,1
23476618,23477073,455,0,0,1,2
23477073,23477112,39,1,0,0,1
23477074,23477114,40,1,0,0,2
23477113,23477302,189,0,0,1,1
23477115,23477302,187,0,0,1,2
23477303,23477346,43,1,0,0,1
23477303,23477350,47,1,0,0,2
23477347,23477557,210,0,0,1,1
23477351,23477560,209,0,0,1,2
23477558,23477611,53,1,0,0,1
23477561,23477628,67,1,0,0,2
23477612,23477725,113,0,0,1,1
23477629,23477725,96,0,0,1,2
23477726,23477775,49,1,0,0,1
23477726,23477788,62,1,0,0,2
23477776,23478809,1033,0,0,1,1
23477789,23477963,174,0,0,1,2
23477964,23477972,8,1,0,0,2
23477973,23479282,1309,0,0,1,2
23478810,23478830,20,1,0,0,1
23478831,23479287,456,0,0,1,1
23479283,23479292,9,1,0,0,2
23479288,23479324,36,1,0,0,1
23479293,23479494,201,0,0,1,2
23479325,23479482,157,0,0,1,1
23479483,23479501,18,1,0,0,1
23479495,23479504,9,1,0,0,2
23479502,23479647,145,0,0,1,1
23479505,23480424,919,0,0,1,2
23479648,23479655,7,1,0,0,1
23479656,23480423,767,0,0,1,1
23480424,23480467,43,1,0,0,1
23480425,23480547,122,1,0,0,2
23480468,23481150,682,0,0,1,1
23480548,23480714,166,0,0,1,2
23480715,23480734,19,1,0,0,2
23480735,23480783,48,0,0,1,2
23480784,23480799,15,1,0,0,2
23480800,23480846,46,0,0,1,2
23480847,23480884,37,1,0,0,2
23480885,23480972,87,0,0,1,2
23480973,23481051,78,1,0,0,2
23481052,23481121,69,0,0,1,2
23481122,23481202,80,1,0,0,2
23481151,23481172,21,1,0,0,1
23481173,23482003,830,0,0,1,1
23481203,23481454,251,0,0,1,2
23481455,23482587,1132,1,0,0,2
23481538,23481556,18,0,1,0,2
23481681,23481690,9,0,1,0,2
23481715,23481764,49,0,1,0,2
23481796,23481828,32,0,1,0,2
23481944,23482007,63,0,1,0,2
23482004,23482022,18,1,0,0,1
23482023,23482426,403,0,0,1,1
23482055,23482096,41,0,1,0,2
23482126,23482129,3,0,1,0,2
23482151,23482164,13,0,1,0,2
23482427,23482553,126,1,0,0,1
23482434,23482434,0,0,1,0,2
23482469,23482504,35,0,1,0,2
23482554,23484297,1743,0,0,1,1
23482588,23484293,1705,0,0,1,2
23484294,23484346,52,1,0,0,2
23484298,23484350,52,1,0,0,1
23484347,23484507,160,0,0,1,2
23484351,23484506,155,0,0,1,1
23484507,23484523,16,1,0,0,1
23484508,23484524,16,1,0,0,2
23484524,23485085,561,0,0,1,1
23484525,23484897,372,0,0,1,2
23484898,23484909,11,1,0,0,2
23484910,23485083,173,0,0,1,2
23485084,23485095,11,1,0,0,2
23485086,23485094,8,1,0,0,1
23485095,23485782,687,0,0,1,1
23485096,23485783,687,0,0,1,2
23485783,23485852,69,1,0,0,1
23485784,23485852,68,1,0,0,2
23485853,23486193,340,0,0,1,2
23485853,23487470,1617,0,0,1,1
23486194,23486212,18,1,0,0,2
23486213,23487473,1260,0,0,1,2
23487471,23487525,54,1,0,0,1
23487474,23487526,52,1,0,0,2
23487526,23489115,1589,0,0,1,1
23487527,23489117,1590,0,0,1,2
23489116,23489174,58,1,0,0,1
23489118,23489186,68,1,0,0,2
23489175,23489308,133,0,0,1,1
23489187,23489304,117,0,0,1,2
23489305,23489328,23,1,0,0,2
23489309,23489326,17,1,0,0,1
23489327,23489513,186,0,0,1,1
23489329,23489511,182,0,0,1,2
23489512,23489524,12,1,0,0,2
23489514,23489524,10,1,0,0,1
23489525,23490929,1404,0,0,1,2
23489525,23490933,1408,0,0,1,1
23490930,23490969,39,1,0,0,2
23490934,23490975,41,1,0,0,1
23490970,23491125,155,0,0,1,2
23490976,23491125,149,0,0,1,1
23491126,23491146,20,1,0,0,2
23491126,23491150,24,1,0,0,1
23491147,23491318,171,0,0,1,2
23491151,23491317,166,0,0,1,1
23491318,23491329,11,1,0,0,1
23491319,23491330,11,1,0,0,2
23491330,23492216,886,0,0,1,1
23491331,23492214,883,0,0,1,2
23492215,23492227,12,1,0,0,2
23492217,23492224,7,1,0,0,1
23492225,23492700,475,0,0,1,1
23492228,23492947,719,0,0,1,2
23492701,23492715,14,1,0,0,1
23492716,23492941,225,0,0,1,1
23492942,23493075,133,1,0,0,1
23492948,23493088,140,1,0,0,2
23493076,23494587,1511,0,0,1,1
23493089,23494589,1500,0,0,1,2
23494588,23494702,114,1,0,0,1
23494590,23494699,109,1,0,0,2
23494700,23494810,110,0,0,1,2
23494703,23494810,107,0,0,1,1
23494811,23494830,19,1,0,0,1
23494811,23494830,19,1,0,0,2
23494831,23496368,1537,0,0,1,1
23494831,23496369,1538,0,0,1,2
23496369,23496423,54,1,0,0,1
23496370,23496424,54,1,0,0,2
23496424,23497436,1012,0,0,1,1
23496425,23497436,1011,0,0,1,2
23497437,23497470,33,1,0,0,2
23497437,23497472,35,1,0,0,1
23497471,23498503,1032,0,0,1,2
23497473,23498512,1039,0,0,1,1
23498504,23498946,442,1,0,0,2
23498513,23498806,293,1,0,0,1
23498538,23498790,252,0,1,0,2
23498544,23498728,184,0,1,0,1
23498807,23499256,449,0,0,1,1
23498947,23499256,309,0,0,1,2
23499257,23499277,20,1,0,0,2
23499257,23499280,23,1,0,0,1
23499278,23499784,506,0,0,1,2
23499281,23499785,504,0,0,1,1
23499785,23499822,37,1,0,0,2
23499786,23499824,38,1,0,0,1
23499823,23500121,298,0,0,1,2
23499825,23500119,294,0,0,1,1
23500120,23500154,34,1,0,0,1
23500122,23500154,32,1,0,0,2
23500155,23500279,124,0,0,1,1
23500155,23500280,125,0,0,1,2
23500280,23500300,20,1,0,0,1
23500281,23500300,19,1,0,0,2
23500301,23501504,1203,0,0,1,1
23500301,23501504,1203,0,0,1,2
23501505,23501516,11,1,0,0,2
23501505,23501517,12,1,0,0,1
23501517,23501839,322,0,0,1,2
23501518,23501839,321,0,0,1,1
23501840,23501895,55,1,0,0,1
23501840,23501906,66,1,0,0,2
23501896,23502291,395,0,0,1,1
23501907,23502294,387,0,0,1,2
23502292,23502310,18,1,0,0,1
23502295,23502313,18,1,0,0,2
23502311,23503945,1634,0,0,1,1
23502314,23503944,1630,0,0,1,2
23503945,23504014,69,1,0,0,2
23503946,23504016,70,1,0,0,1
23504015,23504292,277,0,0,1,2
23504017,23504294,277,0,0,1,1
23504293,23504344,51,1,0,0,2
23504295,23504345,50,1,0,0,1
23504345,23505575,1230,0,0,1,2
23504346,23505574,1228,0,0,1,1
23505575,23505609,34,1,0,0,1
23505576,23505613,37,1,0,0,2
23505610,23505829,219,0,0,1,1
23505614,23505827,213,0,0,1,2
23505828,23505875,47,1,0,0,2
23505830,23505875,45,1,0,0,1
23505876,23505989,113,0,0,1,2
23505876,23505991,115,0,0,1,1
23505990,23506018,28,1,0,0,2
23505992,23506015,23,1,0,0,1
23506016,23507585,1569,0,0,1,1
23506019,23506179,160,0,0,1,2
23506180,23506186,6,1,0,0,2
23506187,23507967,1780,0,0,1,2
23507586,23507595,9,1,0,0,1
23507596,23507965,369,0,0,1,1
23507966,23507978,12,1,0,0,1
23507968,23507978,10,1,0,0,2
23507979,23508300,321,0,0,1,1
23507979,23508630,651,0,0,1,2
23508301,23508312,11,1,0,0,1
23508313,23508625,312,0,0,1,1
23508626,23508641,15,1,0,0,1
23508631,23508641,10,1,0,0,2
23508642,23509914,1272,0,0,1,2
23508642,23509915,1273,0,0,1,1
23509915,23509926,11,1,0,0,2
23509916,23509925,9,1,0,0,1
23509926,23510119,193,0,0,1,1
23509927,23510375,448,0,0,1,2
23510120,23510130,10,1,0,0,1
23510131,23510374,243,0,0,1,1
23510375,23510397,22,1,0,0,1
23510376,23510409,33,1,0,0,2
23510398,23510539,141,0,0,1,1
23510410,23510541,131,0,0,1,2
23510540,23510569,29,1,0,0,1
23510542,23510571,29,1,0,0,2
23510570,23510841,271,0,0,1,1
23510572,23510840,268,0,0,1,2
23510841,23510859,18,1,0,0,2
23510842,23510860,18,1,0,0,1
23510860,23512570,1710,0,0,1,2
23510861,23512573,1712,0,0,1,1
23512571,23512608,37,1,0,0,2
23512574,23512611,37,1,0,0,1
23512609,23512940,331,0,0,1,2
23512612,23512939,327,0,0,1,1
23512940,23512987,47,1,0,0,1
23512941,23512987,46,1,0,0,2
23512988,23513710,722,0,0,1,2
23512988,23513713,725,0,0,1,1
23513711,23513753,42,1,0,0,2
23513714,23513751,37,1,0,0,1
23513752,23514278,526,0,0,1,1
23513754,23514279,525,0,0,1,2
23514279,23514331,52,1,0,0,1
23514280,23514345,65,1,0,0,2
23514332,23514455,123,0,0,1,1
23514346,23514456,110,0,0,1,2
23514456,23514495,39,1,0,0,1
23514457,23514495,38,1,0,0,2
23514496,23514645,149,0,0,1,1
23514496,23514645,149,0,0,1,2
23514646,23514662,16,1,0,0,1
23514646,23514671,25,1,0,0,2
23514663,23516232,1569,0,0,1,1
23514672,23516224,1552,0,0,1,2
23516225,23516332,107,1,0,0,2
23516233,23516305,72,1,0,0,1
23516306,23516853,547,0,0,1,1
23516333,23516463,130,0,0,1,2
23516464,23516492,28,1,0,0,2
23516493,23516859,366,0,0,1,2
23516854,23516875,21,1,0,0,1
23516860,23516886,26,1,0,0,2
23516876,23518079,1203,0,0,1,1
23516887,23517439,552,0,0,1,2
23517440,23517618,178,1,0,0,2
23517619,23517770,151,0,0,1,2
23517771,23517840,69,1,0,0,2
23517841,23518081,240,0,0,1,2
23518080,23518086,6,1,0,0,1
23518082,23518096,14,1,0,0,2
23518087,23518701,614,0,0,1,1
23518097,23518682,585,0,0,1,2
23518683,23518779,96,1,0,0,2
23518702,23518776,74,1,0,0,1
23518777,23519779,1002,0,0,1,1
23518780,23519783,1003,0,0,1,2
23519780,23519827,47,1,0,0,1
23519784,23519829,45,1,0,0,2
23519828,23520046,218,0,0,1,1
23519830,23520047,217,0,0,1,2
23520047,23520098,51,1,0,0,1
23520048,23520113,65,1,0,0,2
23520099,23520299,200,0,0,1,1
23520114,23520299,185,0,0,1,2
23520300,23520338,38,1,0,0,1
23520300,23520357,57,1,0,0,2
23520339,23520503,164,0,0,1,1
23520358,23520499,141,0,0,1,2
23520500,23520515,15,1,0,0,2
23520504,23520514,10,1,0,0,1
23520515,23522388,1873,0,0,1,1
23520516,23522389,1873,0,0,1,2
23522389,23522458,69,1,0,0,1
23522390,23522456,66,1,0,0,2
23522457,23522614,157,0,0,1,2
23522459,23522616,157,0,0,1,1
23522615,23522626,11,1,0,0,2
23522617,23522627,10,1,0,0,1
23522627,23524391,1764,0,0,1,2
23522628,23524392,1764,0,0,1,1
23524392,23524430,38,1,0,0,2
23524393,23524429,36,1,0,0,1
23524430,23524686,256,0,0,1,1
23524431,23524686,255,0,0,1,2
23524687,23524731,44,1,0,0,2
23524687,23524732,45,1,0,0,1
23524732,23525468,736,0,0,1,2
23524733,23525467,734,0,0,1,1
23525468,23525508,40,1,0,0,1
23525469,23525509,40,1,0,0,2
23525509,23525720,211,0,0,1,1
23525510,23525719,209,0,0,1,2
23525720,23525785,65,1,0,0,2
23525721,23525796,75,1,0,0,1
23525786,23525900,114,0,0,1,2
23525797,23525901,104,0,0,1,1
23525901,23525939,38,1,0,0,2
23525902,23525929,27,1,0,0,1
23525930,23526465,535,0,0,1,1
23525940,23526273,333,0,0,1,2
23526274,23526290,16,1,0,0,2
23526291,23526460,169,0,0,1,2
23526461,23526646,185,1,0,0,2
23526466,23526611,145,1,0,0,1
23526485,23526575,90,0,1,0,2
23526491,23526542,51,0,1,0,1
23526612,23527751,1139,0,0,1,1
23526647,23526843,196,0,0,1,2
23526844,23526854,10,1,0,0,2
23526855,23527751,896,0,0,1,2
23527752,23527788,36,1,0,0,2
23527752,23527799,47,1,0,0,1
23527789,23528152,363,0,0,1,2
23527800,23528151,351,0,0,1,1
23528152,23528176,24,1,0,0,1
23528153,23528178,25,1,0,0,2
23528177,23528839,662,0,0,1,1
23528179,23528838,659,0,0,1,2
23528839,23528861,22,1,0,0,2
23528840,23528861,21,1,0,0,1
23528862,23530096,1234,0,0,1,1
23528862,23530096,1234,0,0,1,2
23530097,23530141,44,1,0,0,1
23530097,23530144,47,1,0,0,2
23530142,23530767,625,0,0,1,1
23530145,23530764,619,0,0,1,2
23530765,23530807,42,1,0,0,2
23530768,23530807,39,1,0,0,1
23530808,23531607,799,0,0,1,2
23530808,23531611,803,0,0,1,1
23531608,23531686,78,1,0,0,2
23531612,23531666,54,1,0,0,1
23531667,23531826,159,0,0,1,1
23531687,23531828,141,0,0,1,2
23531827,23531853,26,1,0,0,1
23531829,23531853,24,1,0,0,2
23531854,23532028,174,0,0,1,1
23531854,23533490,1636,0,0,1,2
23532029,23532035,6,1,0,0,1
23532036,23533488,1452,0,0,1,1
23533489,23533546,57,1,0,0,1
23533491,23533543,52,1,0,0,2
23533544,23534106,562,0,0,1,2
23533547,23534105,558,0,0,1,1
23534106,23534128,22,1,0,0,1
23534107,23534136,29,1,0,0,2
23534129,23535708,1579,0,0,1,1
23534137,23535704,1567,0,0,1,2
23535705,23535966,261,1,0,0,2
23535709,23535921,212,1,0,0,1
23535734,23535853,119,0,1,0,2
23535757,23535824,67,0,1,0,1
23535922,23536652,730,0,0,1,1
23535967,23536651,684,0,0,1,2
23536652,23536683,31,1,0,0,2
23536653,23536681,28,1,0,0,1
23536682,23537261,579,0,0,1,1
23536684,23537262,578,0,0,1,2
23537262,23537316,54,1,0,0,1
23537263,23537316,53,1,0,0,2
23537317,23537522,205,0,0,1,2
23537317,23537523,206,0,0,1,1
23537523,23537625,102,1,0,0,2
23537524,23537584,60,1,0,0,1
23537585,23537728,143,0,0,1,1
23537626,23537728,102,0,0,1,2
23537729,23537744,15,1,0,0,1
23537729,23537779,50,1,0,0,2
23537745,23539574,1829,0,0,1,1
23537780,23537928,148,0,0,1,2
23537929,23537979,50,1,0,0,2
23537980,23538335,355,0,0,1,2
23538336,23538383,47,1,0,0,2
23538384,23538524,140,0,0,1,2
23538525,23538561,36,1,0,0,2
23538562,23539099,537,0,0,1,2
23539100,23539104,4,1,0,0,2
23539105,23539237,132,0,0,1,2
23539238,23539258,20,1,0,0,2
23539259,23539450,191,0,0,1,2
23539451,23539456,5,1,0,0,2
23539457,23539526,69,0,0,1,2
23539527,23539644,117,1,0,0,2
23539575,23539631,56,1,0,0,1
23539632,23540036,404,0,0,1,1
23539645,23540040,395,0,0,1,2
23540037,23540053,16,1,0,0,1
23540041,23540052,11,1,0,0,2
23540053,23540558,505,0,0,1,2
23540054,23540575,521,0,0,1,1
23540559,23540823,264,1,0,0,2
23540576,23540782,206,1,0,0,1
23540589,23540723,134,0,1,0,2
23540601,23540690,89,0,1,0,1
23540783,23542973,2190,0,0,1,1
23540824,23542396,1572,0,0,1,2
23542397,23542421,24,1,0,0,2
23542422,23542977,555,0,0,1,2
23542974,23542995,21,1,0,0,1
23542978,23543002,24,1,0,0,2
23542996,23543388,392,0,0,1,1
23543003,23543391,388,0,0,1,2
23543389,23543449,60,1,0,0,1
23543392,23543450,58,1,0,0,2
23543450,23543489,39,0,0,1,1
23543451,23543491,40,0,0,1,2
23543490,23543575,85,1,0,0,1
23543492,23543574,82,1,0,0,2
23543575,23543634,59,0,0,1,2
23543576,23543664,88,0,0,1,1
23543635,23546368,2733,1,0,0,2
23543665,23543719,54,1,0,0,1
23543699,23543835,136,0,1,0,2
23543720,23543837,117,0,0,1,1
23543838,23543847,9,1,0,0,1
23543848,23544008,160,0,0,1,1
23544009,23544030,21,1,0,0,1
23544031,23544539,508,0,0,1,1
23544540,23544548,8,1,0,0,1
23544549,23544594,45,0,0,1,1
23544595,23544656,61,1,0,0,1
23544657,23544809,152,0,0,1,1
23544810,23544825,15,1,0,0,1
23544826,23544916,90,0,0,1,1
23544917,23544955,38,1,0,0,1
23544956,23545702,746,0,0,1,1
23545703,23545755,52,1,0,0,1
23545738,23546111,373,0,1,0,2
23545756,23546686,930,0,0,1,1
23546140,23546266,126,0,1,0,2
23546289,23546335,46,0,1,0,2
23546369,23546647,278,0,0,1,2
23546648,23547402,754,1,0,0,2
23546687,23546706,19,1,0,0,1
23546707,23547602,895,0,0,1,1
23547403,23547435,32,0,0,1,2
23547436,23547676,240,1,0,0,2
23547603,23547665,62,1,0,0,1
23547636,23547652,16,0,1,0,2
23547666,23548852,1186,0,0,1,1
23547677,23547725,48,0,0,1,2
23547726,23547747,21,1,0,0,2
23547748,23548429,681,0,0,1,2
23548430,23548464,34,1,0,0,2
23548465,23548501,36,0,0,1,2
23548502,23548519,17,1,0,0,2
23548520,23548575,55,0,0,1,2
23548576,23548660,84,1,0,0,2
23548661,23548852,191,0,0,1,2
23548853,23548893,40,1,0,0,1
23548853,23548895,42,1,0,0,2
23548894,23549064,170,0,0,1,1
23548896,23549230,334,0,0,1,2
23549065,23549073,8,1,0,0,1
23549074,23549227,153,0,0,1,1
23549228,23549263,35,1,0,0,1
23549231,23549262,31,1,0,0,2
23549263,23549508,245,0,0,1,2
23549264,23549503,239,0,0,1,1
23549504,23549525,21,1,0,0,1
23549509,23549525,16,1,0,0,2
23549526,23549780,254,0,0,1,1
23549526,23549781,255,0,0,1,2
23549781,23549825,44,1,0,0,1
23549782,23549824,42,1,0,0,2
23549825,23550079,254,0,0,1,2
23549826,23550081,255,0,0,1,1
23550080,23550119,39,1,0,0,2
23550082,23550119,37,1,0,0,1
23550120,23550294,174,0,0,1,2
23550120,23550314,194,0,0,1,1
23550295,23550612,317,1,0,0,2
23550315,23550521,206,1,0,0,1
23550332,23550473,141,0,1,0,2
23550347,23550428,81,0,1,0,1
23550498,23550520,22,0,1,0,2
23550522,23550679,157,0,0,1,1
23550613,23550679,66,0,0,1,2
23550680,23550716,36,1,0,0,1
23550680,23550720,40,1,0,0,2
23550717,23551011,294,0,0,1,1
23550721,23551011,290,0,0,1,2
23551012,23551501,489,1,0,0,1
23551012,23551544,532,1,0,0,2
23551048,23551533,485,0,1,0,2
23551053,23551483,430,0,1,0,1
23551502,23551630,128,0,0,1,1
23551545,23551615,70,0,0,1,2
23551616,23552010,394,1,0,0,2
23551631,23551900,269,1,0,0,1
23551650,23551913,263,0,1,0,2
23551654,23551860,206,0,1,0,1
23551901,23552286,385,0,0,1,1
23552011,23552279,268,0,0,1,2
23552280,23552750,470,1,0,0,2
23552287,23552572,285,1,0,0,1
23552305,23552572,267,0,1,0,2
23552321,23552539,218,0,1,0,1
23552573,23552869,296,0,0,1,1
23552751,23552864,113,0,0,1,2
23552865,23555345,2480,1,0,0,2
23552870,23555146,2276,1,0,0,1
23552934,23555136,2202,0,1,0,1
23552935,23555184,2249,0,1,0,2
23555147,23555306,159,0,0,1,1
23555307,23555346,39,1,0,0,1
23555346,23555545,199,0,0,1,2
23555347,23555544,197,0,0,1,1
23555545,23555573,28,1,0,0,1
23555546,23555582,36,1,0,0,2
23555574,23555809,235,0,0,1,1
23555583,23555809,226,0,0,1,2
23555810,23555830,20,1,0,0,1
23555810,23555832,22,1,0,0,2
23555831,23555957,126,0,0,1,1
23555833,23555960,127,0,0,1,2
23555958,23555996,38,1,0,0,1
23555961,23555991,30,1,0,0,2
23555992,23556451,459,0,0,1,2
23555997,23556453,456,0,0,1,1
23556452,23556473,21,1,0,0,2
23556454,23556470,16,1,0,0,1
23556471,23556538,67,0,0,1,1
23556474,23556538,64,0,0,1,2
23670442,23670465,23,0,0,1,2
23670442,23670467,25,0,0,1,1
23670466,23670503,37,1,0,0,2
23670468,23670500,32,1,0,0,1
23670501,23670669,168,0,0,1,1
23670504,23670670,166,0,0,1,2
23670670,23670789,119,1,0,0,1
23670671,23670764,93,1,0,0,2
23670765,23670872,107,0,0,1,2
23670790,23670812,22,0,0,1,1
23670813,23670833,20,1,0,0,1
23670834,23670875,41,0,0,1,1
23670873,23673651,2778,1,0,0,2
23670876,23676608,5732,1,0,0,1
23670897,23672570,1673,0,1,0,1
23671010,23673229,2219,0,1,0,2
23672596,23672604,8,0,1,0,1
23672642,23672710,68,0,1,0,1
23672737,23672828,91,0,1,0,1
23672849,23672937,88,0,1,0,1
23672989,23673200,211,0,1,0,1
23673652,23673788,136,0,0,1,2
23673789,23673994,205,1,0,0,2
23673995,23674054,59,0,0,1,2
23674055,23674209,154,1,0,0,2
23674210,23674256,46,0,0,1,2
23674257,23674313,56,1,0,0,2
23674314,23674350,36,0,0,1,2
23674351,23674545,194,1,0,0,2
23674546,23674657,111,0,0,1,2
23674658,23674666,8,1,0,0,2
23674667,23674759,92,0,0,1,2
23674760,23674973,213,1,0,0,2
23674974,23675005,31,0,0,1,2
23675006,23675195,189,1,0,0,2
23675196,23675232,36,0,0,1,2
23675233,23676543,1310,1,0,0,2
23676544,23676591,47,0,0,1,2
23676592,23676652,60,1,0,0,2
23676609,23676669,60,0,0,1,1
23676653,23676694,41,0,0,1,2
23676670,23676696,26,1,0,0,1
23676695,23676744,49,1,0,0,2
23676697,23676743,46,0,0,1,1
23676744,23676937,193,1,0,0,1
23676745,23676832,87,0,0,1,2
23676833,23676922,89,1,0,0,2
23676923,23676956,33,0,0,1,2
23676938,23676993,55,0,0,1,1
23676957,23677057,100,1,0,0,2
23676994,23677054,60,1,0,0,1
23677055,23677149,94,0,0,1,1
23677058,23677100,42,0,0,1,2
23677101,23677175,74,1,0,0,2
23677150,23677172,22,1,0,0,1
23677173,23677880,707,0,0,1,1
23677176,23678508,1332,0,0,1,2
23677881,23677891,10,1,0,0,1
23677892,23678072,180,0,0,1,1
23678073,23678078,5,1,0,0,1
23678079,23678850,771,0,0,1,1
23678509,23678524,15,1,0,0,2
23678525,23678737,212,0,0,1,2
23678738,23678779,41,1,0,0,2
23678780,23678831,51,0,0,1,2
23678832,23678868,36,1,0,0,2
23678851,23678869,18,1,0,0,1
23678869,23678899,30,0,0,1,2
23678870,23680623,1753,0,0,1,1
23678900,23679128,228,1,0,0,2
23679129,23680623,1494,0,0,1,2
23680624,23680706,82,1,0,0,1
23680624,23680717,93,1,0,0,2
23680707,23680794,87,0,0,1,1
23680718,23680795,77,0,0,1,2
23680795,23680819,24,1,0,0,1
23680796,23680820,24,1,0,0,2
23680820,23680989,169,0,0,1,1
23680821,23680984,163,0,0,1,2
23680985,23681001,16,1,0,0,2
23680990,23680994,4,1,0,0,1
23680995,23682313,1318,0,0,1,1
23681002,23683545,2543,0,0,1,2
23682314,23682324,10,1,0,0,1
23682325,23683544,1219,0,0,1,1
23683545,23683597,52,1,0,0,1
23683546,23683599,53,1,0,0,2
23683598,23683686,88,0,0,1,1
23683600,23683687,87,0,0,1,2
23683687,23683714,27,1,0,0,1
23683688,23683716,28,1,0,0,2
23683715,23683901,186,0,0,1,1
23683717,23684347,630,0,0,1,2
23683902,23683909,7,1,0,0,1
23683910,23684358,448,0,0,1,1
23684348,23684634,286,1,0,0,2
23684359,23684585,226,1,0,0,1
23684466,23684541,75,0,1,0,2
23684474,23684532,58,0,1,0,1
23684586,23684763,177,0,0,1,1
23684635,23684765,130,0,0,1,2
23684764,23684772,8,1,0,0,1
23684766,23684775,9,1,0,0,2
23684773,23685665,892,0,0,1,1
23684776,23685666,890,0,0,1,2
23685666,23685757,91,1,0,0,1
23685667,23685752,85,1,0,0,2
23685753,23685838,85,0,0,1,2
23685758,23685870,112,0,0,1,1
23685839,23685946,107,1,0,0,2
23685871,23685953,82,1,0,0,1
23685947,23686130,183,0,0,1,2
23685954,23686117,163,0,0,1,1
23686118,23686135,17,1,0,0,1
23686131,23686206,75,1,0,0,2
23686136,23686341,205,0,0,1,1
23686207,23686683,476,0,0,1,2
23686342,23686350,8,1,0,0,1
23686351,23686774,423,0,0,1,1
23686684,23686700,16,1,0,0,2
23686701,23686786,85,0,0,1,2
23686775,23686790,15,1,0,0,1
23686787,23686825,38,1,0,0,2
23686791,23687769,978,0,0,1,1
23686826,23687160,334,0,0,1,2
23687161,23687201,40,1,0,0,2
23687202,23687774,572,0,0,1,2
23687770,23687853,83,1,0,0,1
23687775,23687884,109,1,0,0,2
23687854,23687963,109,0,0,1,1
23687885,23687965,80,0,0,1,2
23687964,23687983,19,1,0,0,1
23687966,23687983,17,1,0,0,2
23687984,23688363,379,0,0,1,1
23687984,23688367,383,0,0,1,2
23688364,23688376,12,1,0,0,1
23688368,23688377,9,1,0,0,2
23688377,23689740,1363,0,0,1,1
23688378,23689740,1362,0,0,1,2
23689741,23689822,81,1,0,0,2
23689741,23689824,83,1,0,0,1
23689823,23689932,109,0,0,1,2
23689825,23689931,106,0,0,1,1
23689932,23689952,20,1,0,0,1
23689933,23689953,20,1,0,0,2
23689953,23691691,1738,0,0,1,1
23689954,23691694,1740,0,0,1,2
23691692,23691740,48,1,0,0,1
23691695,23691741,46,1,0,0,2
23691741,23691857,116,0,0,1,1
23691742,23691857,115,0,0,1,2
23691858,23691882,24,1,0,0,1
23691858,23691888,30,1,0,0,2
23691883,23692673,790,0,0,1,1
23691889,23692250,361,0,0,1,2
23692251,23692260,9,1,0,0,2
23692261,23692529,268,0,0,1,2
23692530,23692539,9,1,0,0,2
23692540,23692675,135,0,0,1,2
23692674,23692724,50,1,0,0,1
23692676,23692719,43,1,0,0,2
23692720,23692886,166,0,0,1,2
23692725,23692891,166,0,0,1,1
23692887,23692901,14,1,0,0,2
23692892,23692933,41,1,0,0,1
23692902,23693661,759,0,0,1,2
23692934,23693660,726,0,0,1,1
23693661,23693734,73,1,0,0,1
23693662,23693734,72,1,0,0,2
23693735,23693809,74,0,0,1,1
23693735,23693810,75,0,0,1,2
23693810,23693840,30,1,0,0,1
23693811,23693851,40,1,0,0,2
23693841,23693997,156,0,0,1,1
23693852,23693998,146,0,0,1,2
23693998,23694014,16,1,0,0,1
23693999,23694028,29,1,0,0,2
23694015,23694235,220,0,0,1,1
23694029,23694224,195,0,0,1,2
23694225,23694250,25,1,0,0,2
23694236,23694240,4,1,0,0,1
23694241,23695452,1211,0,0,1,1
23694251,23695451,1200,0,0,1,2
23695452,23695549,97,1,0,0,2
23695453,23695529,76,1,0,0,1
23695530,23695659,129,0,0,1,1
23695550,23695661,111,0,0,1,2
23695660,23695702,42,1,0,0,1
23695662,23695695,33,1,0,0,2
23695696,23695844,148,0,0,1,2
23695703,23695843,140,0,0,1,1
23695844,23695861,17,1,0,0,1
23695845,23695869,24,1,0,0,2
23695862,23696040,178,0,0,1,1
23695870,23696044,174,0,0,1,2
23696041,23696057,16,1,0,0,1
23696045,23696057,12,1,0,0,2
23696058,23696577,519,0,0,1,1
23696058,23696578,520,0,0,1,2
23696578,23696622,44,1,0,0,1
23696579,23696621,42,1,0,0,2
23696622,23697048,426,0,0,1,2
23696623,23697049,426,0,0,1,1
23697049,23697142,93,1,0,0,2
23697050,23697139,89,1,0,0,1
23697140,23697275,135,0,0,1,1
23697143,23697275,132,0,0,1,2
23697276,23697302,26,1,0,0,1
23697276,23697305,29,1,0,0,2
23697303,23698353,1050,0,0,1,1
23697306,23698353,1047,0,0,1,2
23698354,23698402,48,1,0,0,1
23698354,23698402,48,1,0,0,2
23698403,23698633,230,0,0,1,1
23698403,23698633,230,0,0,1,2
23698634,23698706,72,1,0,0,2
23698634,23698708,74,1,0,0,1
23698707,23698764,57,0,0,1,2
23698709,23698766,57,0,0,1,1
23698765,23698823,58,1,0,0,2
23698767,23698804,37,1,0,0,1
23698805,23698916,111,0,0,1,1
23698824,23698916,92,0,0,1,2
23698917,23698939,22,1,0,0,1
23698917,23698943,26,1,0,0,2
23698940,23699938,998,0,0,1,1
23698944,23699936,992,0,0,1,2
23699937,23700019,82,1,0,0,2
23699939,23700019,80,1,0,0,1
23700020,23700437,417,0,0,1,1
23700020,23700440,420,0,0,1,2
23700438,23700509,71,1,0,0,1
23700441,23700496,55,1,0,0,2
23700497,23700612,115,0,0,1,2
23700510,23700611,101,0,0,1,1
23700612,23700633,21,1,0,0,1
23700613,23700634,21,1,0,0,2
23700634,23700807,173,0,0,1,1
23700635,23700805,170,0,0,1,2
23700806,23700823,17,1,0,0,2
23700808,23700826,18,1,0,0,1
23700824,23701623,799,0,0,1,2
23700827,23701622,795,0,0,1,1
23701623,23701663,40,1,0,0,1
23701624,23701653,29,1,0,0,2
23701654,23702038,384,0,0,1,2
23701664,23702038,374,0,0,1,1
23702039,23702086,47,1,0,0,1
23702039,23702088,49,1,0,0,2
23702087,23702186,99,0,0,1,1
23702089,23702188,99,0,0,1,2
23702187,23702216,29,1,0,0,1
23702189,23702215,26,1,0,0,2
23702216,23703022,806,0,0,1,2
23702217,23703026,809,0,0,1,1
23703023,23703371,348,1,0,0,2
23703027,23703303,276,1,0,0,1
23703072,23703253,181,0,1,0,2
23703084,23703238,154,0,1,0,1
23703304,23703659,355,0,0,1,1
23703372,23703659,287,0,0,1,2
23703660,23703746,86,1,0,0,1
23703660,23703753,93,1,0,0,2
23703747,23703812,65,0,0,1,1
23703754,23703785,31,0,0,1,2
23703786,23703977,191,1,0,0,2
23703813,23703874,61,1,0,0,1
23703875,23704011,136,0,0,1,1
23703978,23704010,32,0,0,1,2
23704011,23704082,71,1,0,0,2
23704012,23704030,18,1,0,0,1
23704031,23704202,171,0,0,1,1
23704083,23704170,87,0,0,1,2
23704171,23704687,516,1,0,0,2
23704192,23704201,9,0,1,0,2
23704203,23704218,15,1,0,0,1
23704219,23704850,631,0,0,1,1
23704246,23704604,358,0,1,0,2
23704688,23704824,136,0,0,1,2
23704825,23704938,113,1,0,0,2
23704840,23704872,32,0,1,0,2
23704851,23704939,88,1,0,0,1
23704939,23705325,386,0,0,1,2
23704940,23705323,383,0,0,1,1
23705324,23705393,69,1,0,0,1
23705326,23705405,79,1,0,0,2
23705394,23705535,141,0,0,1,1
23705406,23705536,130,0,0,1,2
23705536,23705546,10,1,0,0,1
23705537,23705545,8,1,0,0,2
23705546,23706314,768,0,0,1,2
23705547,23707159,1612,0,0,1,1
23706315,23706319,4,1,0,0,2
23706320,23707158,838,0,0,1,2
23707159,23707220,61,1,0,0,2
23707160,23707218,58,1,0,0,1
23707219,23707316,97,0,0,1,1
23707221,23707315,94,0,0,1,2
23707316,23707340,24,1,0,0,2
23707317,23707336,19,1,0,0,1
23707337,23708420,1083,0,0,1,1
23707341,23707668,327,0,0,1,2
23707669,23707680,11,1,0,0,2
23707681,23708418,737,0,0,1,2
23708419,23708482,63,1,0,0,2
23708421,23708482,61,1,0,0,1
23708483,23708838,355,0,0,1,1
23708483,23708838,355,0,0,1,2
23708839,23708906,67,1,0,0,1
23708839,23708926,87,1,0,0,2
23708907,23709044,137,0,0,1,1
23708927,23709042,115,0,0,1,2
23709043,23709086,43,1,0,0,2
23709045,23709067,22,1,0,0,1
23709068,23709521,453,0,0,1,1
23709087,23709259,172,0,0,1,2
23709260,23709276,16,1,0,0,2
23709277,23709511,234,0,0,1,2
23709512,23710129,617,1,0,0,2
23709522,23709870,348,1,0,0,1
23709557,23709805,248,0,1,0,2
23709562,23709770,208,0,1,0,1
23709871,23710002,131,0,0,1,1
23710003,23710035,32,1,0,0,1
23710036,23710381,345,0,0,1,1
23710130,23710380,250,0,0,1,2
23710381,23710448,67,1,0,0,2
23710382,23710447,65,1,0,0,1
23710448,23710661,213,0,0,1,1
23710449,23710661,212,0,0,1,2
23710662,23710760,98,1,0,0,2
23710662,23712034,1372,1,0,0,1
23710761,23710877,116,0,0,1,2
23710878,23711022,144,1,0,0,2
23711023,23711075,52,0,0,1,2
23711076,23711134,58,1,0,0,2
23711135,23711165,30,0,0,1,2
23711166,23711223,57,1,0,0,2
23711224,23711368,144,0,0,1,2
23711369,23712110,741,1,0,0,2
23711407,23711996,589,0,1,0,2
23712035,23712345,310,0,0,1,1
23712111,23712345,234,0,0,1,2
23712346,23712425,79,1,0,0,1
23712346,23712426,80,1,0,0,2
23712426,23712538,112,0,0,1,1
23712427,23712539,112,0,0,1,2
23712539,23712559,20,1,0,0,1
23712540,23712559,19,1,0,0,2
23712560,23713214,654,0,0,1,2
23712560,23713941,1381,0,0,1,1
23713215,23713222,7,1,0,0,2
23713223,23713942,719,0,0,1,2
23713942,23714004,62,1,0,0,1
23713943,23714006,63,1,0,0,2
23714005,23714153,148,0,0,1,1
23714007,23714154,147,0,0,1,2
23714154,23714231,77,1,0,0,1
23714155,23714240,85,1,0,0,2
23714232,23714384,152,0,0,1,1
23714241,23714385,144,0,0,1,2
23714385,23714402,17,1,0,0,1
23714386,23714400,14,1,0,0,2
23714401,23714591,190,0,0,1,2
23714403,23716040,1637,0,0,1,1
23714592,23714610,18,1,0,0,2
23714611,23715091,480,0,0,1,2
23715092,23715102,10,1,0,0,2
23715103,23716038,935,0,0,1,2
23716039,23716141,102,1,0,0,2
23716041,23716141,100,1,0,0,1
23716142,23716244,102,0,0,1,1
23716142,23716249,107,0,0,1,2
23716245,23716276,31,1,0,0,1
23716250,23716273,23,1,0,0,2
23716274,23717047,773,0,0,1,2
23716277,23716437,160,0,0,1,1
23716438,23716450,12,1,0,0,1
23716451,23716640,189,0,0,1,1
23716641,23716650,9,1,0,0,1
23716651,23717047,396,0,0,1,1
23717048,23717062,14,1,0,0,1
23717048,23717062,14,1,0,0,2
23717063,23717250,187,0,0,1,1
23717063,23717250,187,0,0,1,2
23717251,23717316,65,1,0,0,1
23717251,23717318,67,1,0,0,2
23717317,23717661,344,0,0,1,1
23717319,23717662,343,0,0,1,2
23717662,23717759,97,1,0,0,1
23717663,23717756,93,1,0,0,2
23717757,23717829,72,0,0,1,2
23717760,23717827,67,0,0,1,1
23717828,23717854,26,1,0,0,1
23717830,23717859,29,1,0,0,2
23717855,23718003,148,0,0,1,1
23717860,23718010,150,0,0,1,2
23718004,23718021,17,1,0,0,1
23718011,23718019,8,1,0,0,2
23718020,23719009,989,0,0,1,2
23718022,23718620,598,0,0,1,1
23718621,23718648,27,1,0,0,1
23718649,23719008,359,0,0,1,1
23719009,23719105,96,1,0,0,1
23719010,23719105,95,1,0,0,2
23719106,23719379,273,0,0,1,2
23719106,23719382,276,0,0,1,1
23719380,23719450,70,1,0,0,2
23719383,23719442,59,1,0,0,1
23719443,23719546,103,0,0,1,1
23719451,23719545,94,0,0,1,2
23719546,23719570,24,1,0,0,2
23719547,23719564,17,1,0,0,1
23719565,23720778,1213,0,0,1,1
23719571,23719936,365,0,0,1,2
23719937,23719947,10,1,0,0,2
23719948,23721142,1194,0,0,1,2
23720779,23720789,10,1,0,0,1
23720790,23721142,352,0,0,1,1
23721143,23721299,156,1,0,0,1
23721143,23721333,190,1,0,0,2
23721300,23721430,130,0,0,1,1
23721315,23721321,6,0,1,0,2
23721334,23721429,95,0,0,1,2
23721430,23721455,25,1,0,0,2
23721431,23721450,19,1,0,0,1
23721451,23721852,401,0,0,1,1
23721456,23721621,165,0,0,1,2
23721622,23721674,52,1,0,0,2
23721660,23721663,3,0,1,0,2
23721675,23721782,107,0,0,1,2
23721783,23723305,1522,1,0,0,2
23721795,23722567,772,0,1,0,2
23721853,23721860,7,1,0,0,1
23721861,23722570,709,0,0,1,1
23722581,23722887,306,0,1,0,1
23722593,23722614,21,0,1,0,2
23722897,23723272,375,1,0,0,1
23722962,23723133,171,0,1,0,2
23722977,23723252,275,0,1,0,1
23723273,23723379,106,0,0,1,1
23723306,23723367,61,0,0,1,2
23723368,23723426,58,1,0,0,2
23723380,23723398,18,1,0,0,1
23723399,23724159,760,0,0,1,1
23723427,23723538,111,0,0,1,2
23723539,23723601,62,1,0,0,2
23723602,23723631,29,0,0,1,2
23723632,23723694,62,1,0,0,2
23723695,23723875,180,0,0,1,2
23723876,23723914,38,1,0,0,2
23723915,23724145,230,0,0,1,2
23724146,23724650,504,1,0,0,2
23724160,23724603,443,1,0,0,1
23724178,23724345,167,0,1,0,2
23724180,23724545,365,0,1,0,1
23724604,23724812,208,0,0,1,1
23724651,23724815,164,0,0,1,2
23724813,23724944,131,1,0,0,1
23724816,23724938,122,1,0,0,2
23724939,23725045,106,0,0,1,2
23724945,23724968,23,0,0,1,1
23724969,23725084,115,1,0,0,1
23725046,23725077,31,1,0,0,2
23725078,23725202,124,0,0,1,2
23725085,23725209,124,0,0,1,1
23725203,23725609,406,1,0,0,2
23725210,23725597,387,1,0,0,1
23725235,23725398,163,0,1,0,2
23725235,23725491,256,0,1,0,1
23725598,23726207,609,0,0,1,1
23725610,23726197,587,0,0,1,2
23726198,23726611,413,1,0,0,2
23726208,23726477,269,1,0,0,1
23726235,23726371,136,0,1,0,2
23726239,23726421,182,0,1,0,1
23726421,23726424,3,0,1,0,2
23726478,23727013,535,0,0,1,1
23726612,23726768,156,0,0,1,2
23726769,23727201,432,1,0,0,2
23727014,23727074,60,1,0,0,1
23727075,23727182,107,0,0,1,1
23727183,23727204,21,1,0,0,1
23727202,23727264,62,0,0,1,2
23727205,23728773,1568,0,0,1,1
23727265,23727377,112,1,0,0,2
23727378,23727600,222,0,0,1,2
23727601,23727615,14,1,0,0,2
23727616,23727650,34,0,0,1,2
23727651,23727663,12,1,0,0,2
23727664,23727879,215,0,0,1,2
23727880,23727970,90,1,0,0,2
23727971,23728093,122,0,0,1,2
23728094,23728865,771,1,0,0,2
23728774,23728845,71,1,0,0,1
23728846,23728915,69,0,0,1,1
23728866,23728916,50,0,0,1,2
23728916,23728958,42,1,0,0,1
23728917,23728957,40,1,0,0,2
23728958,23729098,140,0,0,1,2
23728959,23729099,140,0,0,1,1
23729099,23729116,17,1,0,0,2
23729100,23729110,10,1,0,0,1
23729111,23729313,202,0,0,1,1
23729117,23730431,1314,0,0,1,2
23729314,23729333,19,1,0,0,1
23729334,23729807,473,0,0,1,1
23729808,23729812,4,1,0,0,1
23729813,23730431,618,0,0,1,1
23730432,23730548,116,1,0,0,1
23730432,23730624,192,1,0,0,2
23730549,23730674,125,0,0,1,1
23730625,23730675,50,0,0,1,2
23730675,23730702,27,1,0,0,1
23730676,23730699,23,1,0,0,2
23730700,23731275,575,0,0,1,2
23730703,23731595,892,0,0,1,1
23731276,23731283,7,1,0,0,2
23731284,23731595,311,0,0,1,2
23731596,23731638,42,1,0,0,1
23731596,23731643,47,1,0,0,2
23731639,23732016,377,0,0,1,1
23731644,23732014,370,0,0,1,2
23732015,23732085,70,1,0,0,2
23732017,23732069,52,1,0,0,1
23732070,23732173,103,0,0,1,1
23732086,23732177,91,0,0,1,2
23732174,23732196,22,1,0,0,1
23732178,23732198,20,1,0,0,2
23732197,23733676,1479,0,0,1,1
23732199,23733677,1478,0,0,1,2
23733677,23733753,76,1,0,0,1
23733678,23733760,82,1,0,0,2
23733754,23733885,131,0,0,1,1
23733761,23733887,126,0,0,1,2
23733886,23733910,24,1,0,0,1
23733888,23733908,20,1,0,0,2
23733909,23734949,1040,0,0,1,2
23733911,23734553,642,0,0,1,1
23734554,23734565,11,1,0,0,1
23734566,23734949,383,0,0,1,1
23734950,23734987,37,1,0,0,2
23734950,23735002,52,1,0,0,1
23734988,23735283,295,0,0,1,2
23735003,23735282,279,0,0,1,1
23735283,23735343,60,1,0,0,1
23735284,23735347,63,1,0,0,2
23735344,23735423,79,0,0,1,1
23735348,23735423,75,0,0,1,2
23735424,23735519,95,1,0,0,1
23735424,23735582,158,1,0,0,2
23735520,23735625,105,0,0,1,1
23735583,23735626,43,0,0,1,2
23735626,23735677,51,1,0,0,1
23735627,23735657,30,1,0,0,2
23735658,23735814,156,0,0,1,2
23735678,23735814,136,0,0,1,1
23735815,23735830,15,1,0,0,2
23735815,23735831,16,1,0,0,1
23735831,23736143,312,0,0,1,2
23735832,23736754,922,0,0,1,1
23736144,23736148,4,1,0,0,2
23736149,23736410,261,0,0,1,2
23736411,23736428,17,1,0,0,2
23736429,23736757,328,0,0,1,2
23736755,23736800,45,1,0,0,1
23736758,23736807,49,1,0,0,2
23736801,23737179,378,0,0,1,1
23736808,23736942,134,0,0,1,2
23736943,23736956,13,1,0,0,2
23736957,23737179,222,0,0,1,2
23737180,23737283,103,1,0,0,1
23737180,23738904,1724,1,0,0,2
23737284,23737352,68,0,0,1,1
23737353,23737403,50,1,0,0,1
23737371,23737378,7,0,1,0,2
23737399,23737477,78,0,1,0,2
23737404,23737566,162,0,0,1,1
23737567,23737583,16,1,0,0,1
23737584,23738521,937,0,0,1,1
23738155,23738192,37,0,1,0,2
23738457,23738472,15,0,1,0,2
23738522,23738560,38,1,0,0,1
23738561,23738791,230,0,0,1,1
23738670,23738683,13,0,1,0,2
23738792,23738946,154,1,0,0,1
23738905,23738935,30,0,0,1,2
23738936,23739101,165,1,0,0,2
23738947,23739012,65,0,0,1,1
23739013,23739080,67,1,0,0,1
23739081,23739166,85,0,0,1,1
23739102,23739167,65,0,0,1,2
23739167,23739202,35,1,0,0,1
23739168,23739203,35,1,0,0,2
23739203,23739331,128,0,0,1,1
23739204,23739330,126,0,0,1,2
23739331,23739351,20,1,0,0,2
23739332,23739349,17,1,0,0,1
23739350,23740848,1498,0,0,1,1
23739352,23740845,1493,0,0,1,2
23740846,23740982,136,1,0,0,2
23740849,23740972,123,1,0,0,1
23740973,23741050,77,0,0,1,1
23740983,23741045,62,0,0,1,2
23741046,23741121,75,1,0,0,2
23741051,23741072,21,1,0,0,1
23741073,23742578,1505,0,0,1,1
23741122,23741218,96,0,0,1,2
23741219,23741234,15,1,0,0,2
23741235,23742576,1341,0,0,1,2
23742577,23742638,61,1,0,0,2
23742579,23742645,66,1,0,0,1
23742639,23742735,96,0,0,1,2
23742646,23742737,91,0,0,1,1
23742736,23742761,25,1,0,0,2
23742738,23742760,22,1,0,0,1
23742761,23743157,396,0,0,1,1
23742762,23743144,382,0,0,1,2
23743145,23743602,457,1,0,0,2
23743158,23743471,313,1,0,0,1
23743172,23743400,228,0,1,0,2
23743177,23743395,218,0,1,0,1
23743427,23743439,12,0,1,0,2
23743472,23743505,33,0,0,1,1
23743506,23743533,27,1,0,0,1
23743534,23743872,338,0,0,1,1
23743603,23743873,270,0,0,1,2
23743873,23743894,21,1,0,0,1
23743874,23743894,20,1,0,0,2
23743895,23744269,374,0,0,1,2
23743895,23744270,375,0,0,1,1
23744270,23744315,45,1,0,0,2
23744271,23744315,44,1,0,0,1
23744316,23744451,135,0,0,1,2
23744316,23744454,138,0,0,1,1
23744452,23744470,18,1,0,0,2
23744455,23744488,33,1,0,0,1
23744471,23746002,1531,0,0,1,2
23744489,23746001,1512,0,0,1,1
23746002,23746105,103,1,0,0,1
23746003,23746097,94,1,0,0,2
23746098,23746238,140,0,0,1,2
23746106,23746242,136,0,0,1,1
23746239,23746269,30,1,0,0,2
23746243,23746266,23,1,0,0,1
23746267,23747963,1696,0,0,1,1
23746270,23746456,186,0,0,1,2
23746457,23746475,18,1,0,0,2
23746476,23746647,171,0,0,1,2
23746648,23746667,19,1,0,0,2
23746668,23747053,385,0,0,1,2
23747054,23747076,22,1,0,0,2
23747077,23747961,884,0,0,1,2
23747962,23748144,182,1,0,0,2
23747964,23748147,183,1,0,0,1
23748145,23748257,112,0,0,1,2
23748148,23748170,22,0,0,1,1
23748171,23748387,216,1,0,0,1
23748258,23748303,45,1,0,0,2
23748304,23748488,184,0,0,1,2
23748388,23749192,804,0,0,1,1
23748499,23748519,20,0,1,0,2
23748528,23748528,0,1,0,0,2
23748529,23748555,26,0,0,1,2
23748566,23748577,11,0,1,0,2
23748587,23749040,453,1,0,0,2
23748635,23748802,167,0,1,0,2
23748831,23748890,59,0,1,0,2
23748917,23749020,103,0,1,0,2
23749041,23749061,20,0,0,1,2
23749062,23749318,256,1,0,0,2
23749095,23749201,106,0,1,0,2
23749193,23749284,91,1,0,0,1
23749285,23749703,418,0,0,1,1
23749319,23749687,368,0,0,1,2
23749688,23749771,83,1,0,0,2
23749704,23749775,71,1,0,0,1
23749772,23749900,128,0,0,1,2
23749776,23749903,127,0,0,1,1
23749901,23749928,27,1,0,0,2
23749904,23749929,25,1,0,0,1
23749929,23750601,672,0,0,1,2
23749930,23750604,674,0,0,1,1
23750602,23750708,106,1,0,0,2
23750605,23750659,54,1,0,0,1
23750660,23751416,756,0,0,1,1
23750709,23750751,42,0,0,1,2
23750752,23751283,531,1,0,0,2
23751284,23751397,113,0,0,1,2
23751398,23751494,96,1,0,0,2
23751417,23751486,69,1,0,0,1
23751487,23751599,112,0,0,1,1
23751495,23751597,102,0,0,1,2
23751598,23751621,23,1,0,0,2
23751600,23751621,21,1,0,0,1
23751622,23752832,1210,0,0,1,2
23751622,23752833,1211,0,0,1,1
23752833,23752902,69,1,0,0,2
23752834,23752903,69,1,0,0,1
23752903,23752993,90,0,0,1,2
23752904,23752992,88,0,0,1,1
23752993,23753014,21,1,0,0,1
23752994,23753015,21,1,0,0,2
23753015,23753165,150,0,0,1,1
23753016,23753986,970,0,0,1,2
23753166,23753177,11,1,0,0,1
23753178,23753996,818,0,0,1,1
23753987,23754309,322,1,0,0,2
23753997,23754293,296,1,0,0,1
23754020,23754276,256,0,1,0,2
23754025,23754217,192,0,1,0,1
23754294,23754485,191,0,0,1,1
23754310,23754348,38,0,0,1,2
23754349,23754398,49,1,0,0,2
23754399,23754483,84,0,0,1,2
23754484,23754583,99,1,0,0,2
23754486,23754582,96,1,0,0,1
23754583,23754625,42,0,0,1,1
23754584,23754633,49,0,0,1,2
23754626,23755181,555,1,0,0,1
23754634,23754730,96,1,0,0,2
23754731,23754818,87,0,0,1,2
23754819,23755236,417,1,0,0,2
23755182,23755235,53,0,0,1,1
23755236,23755344,108,1,0,0,1
23755237,23755276,39,0,0,1,2
23755277,23755516,239,1,0,0,2
23755345,23755371,26,0,0,1,1
23755372,23755518,146,1,0,0,1
23755517,23755577,60,0,0,1,2
23755519,23755570,51,0,0,1,1
23755571,23755724,153,1,0,0,1
23755578,23755969,391,1,0,0,2
23755654,23755680,26,0,1,0,2
23755725,23756188,463,0,0,1,1
23755970,23756188,218,0,0,1,2
23756189,23756249,60,1,0,0,1
23756189,23756275,86,1,0,0,2
23756250,23756336,86,0,0,1,1
23756276,23756335,59,0,0,1,2
23756336,23756385,49,1,0,0,2
23756337,23756372,35,1,0,0,1
23756373,23756536,163,0,0,1,1
23756386,23756537,151,0,0,1,2
23756537,23756550,13,1,0,0,1
23756538,23756549,11,1,0,0,2
23756550,23756945,395,0,0,1,2
23756551,23756945,394,0,0,1,1
23756946,23756960,14,1,0,0,1
23756946,23756961,15,1,0,0,2
23756961,23757308,347,0,0,1,1
23756962,23757309,347,0,0,1,2
23757309,23757485,176,1,0,0,1
23757310,23757946,636,1,0,0,2
23757486,23757871,385,0,0,1,1
23757872,23757957,85,1,0,0,1
23757947,23758067,120,0,0,1,2
23757958,23758068,110,0,0,1,1
23758068,23758094,26,1,0,0,2
23758069,23758088,19,1,0,0,1
23758089,23758246,157,0,0,1,1
23758095,23758821,726,0,0,1,2
23758247,23758251,4,1,0,0,1
23758252,23758814,562,0,0,1,1
23758815,23758831,16,1,0,0,1
23758822,23758832,10,1,0,0,2
23758832,23759203,371,0,0,1,1
23758833,23759204,371,0,0,1,2
23759204,23759290,86,1,0,0,1
23759205,23759292,87,1,0,0,2
23759291,23759620,329,0,0,1,1
23759293,23759620,327,0,0,1,2
23759621,23759662,41,1,0,0,1
23759621,23759663,42,1,0,0,2
23759663,23759787,124,0,0,1,1
23759664,23759792,128,0,0,1,2
23759788,23759813,25,1,0,0,1
23759793,23759809,16,1,0,0,2
23759810,23760616,806,0,0,1,2
23759814,23760621,807,0,0,1,1
23760617,23760631,14,1,0,0,2
23760622,23760631,9,1,0,0,1
23760632,23760766,134,0,0,1,2
23760632,23761166,534,0,0,1,1
23760767,23760824,57,1,0,0,2
23760825,23761036,211,0,0,1,2
23761037,23761062,25,1,0,0,2
23761063,23761555,492,0,0,1,2
23761167,23761185,18,1,0,0,1
23761186,23761556,370,0,0,1,1
23761556,23761593,37,1,0,0,2
23761557,23761629,72,1,0,0,1
23761594,23761739,145,0,0,1,2
23761630,23761740,110,0,0,1,1
23761740,23761759,19,1,0,0,2
23761741,23761755,14,1,0,0,1
23761756,23762704,948,0,0,1,1
23761760,23761927,167,0,0,1,2
23761928,23761944,16,1,0,0,2
23761945,23762125,180,0,0,1,2
23762126,23762142,16,1,0,0,2
23762143,23762704,561,0,0,1,2
23762705,23762720,15,1,0,0,1
23762705,23762724,19,1,0,0,2
23762721,23763525,804,0,0,1,1
23762725,23763028,303,0,0,1,2
23763029,23763127,98,1,0,0,2
23763128,23763309,181,0,0,1,2
23763310,23763317,7,1,0,0,2
23763318,23763475,157,0,0,1,2
23763476,23763784,308,1,0,0,2
23763526,23763668,142,1,0,0,1
23763540,23763633,93,0,1,0,2
23763549,23763618,69,0,1,0,1
23763669,23763755,86,0,0,1,1
23763756,23763794,38,1,0,0,1
23763785,23763922,137,0,0,1,2
23763795,23763919,124,0,0,1,1
23763920,23763935,15,1,0,0,1
23763923,23763933,10,1,0,0,2
23763934,23765596,1662,0,0,1,2
23763936,23765596,1660,0,0,1,1
23765597,23765653,56,1,0,0,2
23765597,23765654,57,1,0,0,1
23765654,23767587,1933,0,0,1,2
23765655,23767589,1934,0,0,1,1
23767588,23767967,379,1,0,0,2
23767590,23767915,325,1,0,0,1
23767617,23767868,251,0,1,0,2
23767625,23767859,234,0,1,0,1
23767916,23768071,155,0,0,1,1
23767968,23768073,105,0,0,1,2
23768072,23768116,44,1,0,0,1
23768074,23768116,42,1,0,0,2
23768117,23768828,711,0,0,1,2
23768117,23768830,713,0,0,1,1
23768829,23768863,34,1,0,0,2
23768831,23768865,34,1,0,0,1
23768864,23769171,307,0,0,1,2
23768866,23769172,306,0,0,1,1
23769172,23769238,66,1,0,0,2
23769173,23769242,69,1,0,0,1
23769239,23769354,115,0,0,1,2
23769243,23769353,110,0,0,1,1
23769354,23769375,21,1,0,0,1
23769355,23769375,20,1,0,0,2
23769376,23769740,364,0,0,1,1
23769376,23770277,901,0,0,1,2
23769741,23769749,8,1,0,0,1
23769750,23770972,1222,0,0,1,1
23770278,23770282,4,1,0,0,2
23770283,23770969,686,0,0,1,2
23770970,23771017,47,1,0,0,2
23770973,23771016,43,1,0,0,1
23771017,23773020,2003,0,0,1,1
23771018,23773006,1988,0,0,1,2
23773007,23773492,485,1,0,0,2
23773021,23773484,463,1,0,0,1
23773047,23773419,372,0,1,0,2
23773057,23773387,330,0,1,0,1
23773485,23773533,48,0,0,1,1
23773493,23773534,41,0,0,1,2
23773534,23773879,345,1,0,0,1
23773535,23773903,368,1,0,0,2
23773551,23773822,271,0,1,0,2
23773554,23773835,281,0,1,0,1
23773880,23773942,62,0,0,1,1
23773904,23773943,39,0,0,1,2
23773943,23774009,66,1,0,0,1
23773944,23774018,74,1,0,0,2
23774010,23774364,354,0,0,1,1
23774019,23774363,344,0,0,1,2
23774364,23774432,68,1,0,0,2
23774365,23774420,55,1,0,0,1
23774421,23776137,1716,0,0,1,1
23774433,23776147,1714,0,0,1,2
23776138,23776164,26,1,0,0,1
23776148,23776153,5,1,0,0,2
23776154,23776662,508,0,0,1,2
23776165,23776661,496,0,0,1,1
23776662,23776732,70,1,0,0,1
23776663,23776723,60,1,0,0,2
23776724,23777290,566,0,0,1,2
23776733,23777291,558,0,0,1,1
23777291,23777313,22,1,0,0,2
23777292,23777313,21,1,0,0,1
23777314,23777568,254,0,0,1,2
23777314,23777583,269,0,0,1,1
23777569,23777729,160,1,0,0,2
23777584,23777688,104,1,0,0,1
23777612,23777631,19,0,1,0,2
23777689,23778042,353,0,0,1,1
23777730,23778041,311,0,0,1,2
23778042,23778073,31,1,0,0,2
23778043,23778071,28,1,0,0,1
23778072,23778257,185,0,0,1,1
23778074,23778258,184,0,0,1,2
23778258,23778283,25,1,0,0,1
23778259,23778284,25,1,0,0,2
23778284,23778595,311,0,0,1,1
23778285,23778596,311,0,0,1,2
23778596,23778615,19,1,0,0,1
23778597,23778615,18,1,0,0,2
23778616,23778890,274,0,0,1,1
23778616,23778890,274,0,0,1,2
23778891,23779204,313,1,0,0,1
23778891,23779204,313,1,0,0,2
23778930,23779119,189,0,1,0,2
23778936,23779123,187,0,1,0,1
23779205,23780142,937,0,0,1,2
23779205,23780145,940,0,0,1,1
23780143,23780208,65,1,0,0,2
23780146,23780207,61,1,0,0,1
23780208,23780538,330,0,0,1,1
23780209,23780535,326,0,0,1,2
23780536,23780593,57,1,0,0,2
23780539,23780576,37,1,0,0,1
23780577,23782490,1913,0,0,1,1
23780594,23782491,1897,0,0,1,2
23782491,23782550,59,1,0,0,1
23782492,23782549,57,1,0,0,2
23782550,23782653,103,0,0,1,2
23782551,23782650,99,0,0,1,1
23782651,23782682,31,1,0,0,1
23782654,23782690,36,1,0,0,2
23782683,23782991,308,0,0,1,1
23782691,23783490,799,0,0,1,2
23782992,23783001,9,1,0,0,1
23783002,23784446,1444,0,0,1,1
23783491,23783509,18,1,0,0,2
23783510,23783582,72,0,0,1,2
23783583,23783600,17,1,0,0,2
23783601,23783982,381,0,0,1,2
23783983,23783996,13,1,0,0,2
23783997,23784128,131,0,0,1,2
23784129,23784145,16,1,0,0,2
23784146,23784438,292,0,0,1,2
23784439,23784951,512,1,0,0,2
23784447,23784782,335,1,0,0,1
23784463,23784740,277,0,1,0,2
23784481,23784742,261,0,1,0,1
23784783,23784910,127,0,0,1,1
23784911,23784950,39,1,0,0,1
23784951,23785863,912,0,0,1,1
23784952,23785865,913,0,0,1,2
23785864,23785918,54,1,0,0,1
23785866,23785923,57,1,0,0,2
23785919,23786031,112,0,0,1,1
23785924,23786030,106,0,0,1,2
23786031,23786081,50,1,0,0,2
23786032,23786075,43,1,0,0,1
23786076,23786259,183,0,0,1,1
23786082,23788190,2108,0,0,1,2
23786260,23786265,5,1,0,0,1
23786266,23788191,1925,0,0,1,1
23788191,23788232,41,1,0,0,2
23788192,23788232,40,1,0,0,1
23788233,23788606,373,0,0,1,1
23788233,23788606,373,0,0,1,2
23788607,23788629,22,1,0,0,1
23788607,23788631,24,1,0,0,2
23788630,23790229,1599,0,0,1,1
23788632,23790231,1599,0,0,1,2
23790230,23790395,165,1,0,0,1
23790232,23790403,171,1,0,0,2
23790309,23790322,13,0,1,0,2
23790396,23790472,76,0,0,1,1
23790404,23790472,68,0,0,1,2
23790473,23790520,47,1,0,0,1
23790473,23790526,53,1,0,0,2
23790521,23791237,716,0,0,1,1
23790527,23791235,708,0,0,1,2
23791236,23791263,27,1,0,0,2
23791238,23791264,26,1,0,0,1
23791264,23791743,479,0,0,1,2
23791265,23791742,477,0,0,1,1
23791743,23791866,123,1,0,0,1
23791744,23791841,97,1,0,0,2
23791842,23791924,82,0,0,1,2
23791867,23791925,58,0,0,1,1
23791925,23791969,44,1,0,0,2
23791926,23791971,45,1,0,0,1
23791970,23792064,94,0,0,1,2
23791972,23792057,85,0,0,1,1
23792058,23792139,81,1,0,0,1
23792065,23792071,6,1,0,0,2
23792072,23793050,978,0,0,1,2
23792140,23792308,168,0,0,1,1
23792309,23792521,212,1,0,0,1
23792522,23792607,85,0,0,1,1
23792608,23792620,12,1,0,0,1
23792621,23792658,37,0,0,1,1
23792659,23792896,237,1,0,0,1
23792897,23792965,68,0,0,1,1
23792966,23793279,313,1,0,0,1
23793051,23793667,616,1,0,0,2
23793280,23793331,51,0,0,1,1
23793332,23793356,24,1,0,0,1
23793357,23793390,33,0,0,1,1
23793391,23793448,57,1,0,0,1
23793449,23793772,323,0,0,1,1
23793668,23793761,93,0,0,1,2
23793762,23796391,2629,1,0,0,2
23793773,23793844,71,1,0,0,1
23793845,23793887,42,0,0,1,1
23793888,23794049,161,1,0,0,1
23794050,23794109,59,0,0,1,1
23794110,23794127,17,1,0,0,1
23794128,23794232,104,0,0,1,1
23794233,23794242,9,1,0,0,1
23794243,23794316,73,0,0,1,1
23794317,23794355,38,1,0,0,1
23794356,23794411,55,0,0,1,1
23794412,23794424,12,1,0,0,1
23794425,23794478,53,0,0,1,1
23794479,23794533,54,1,0,0,1
23794534,23794797,263,0,0,1,1
23794798,23795000,202,1,0,0,1
23795001,23795037,36,0,0,1,1
23795038,23795531,493,1,0,0,1
23795532,23795624,92,0,0,1,1
23795625,23795646,21,1,0,0,1
23795647,23795736,89,0,0,1,1
23795737,23796371,634,1,0,0,1
23795756,23796324,568,0,1,0,2
23795762,23796291,529,0,1,0,1
23796372,23797157,785,0,0,1,1
23796392,23796413,21,0,0,1,2
23796414,23796586,172,1,0,0,2
23796587,23797149,562,0,0,1,2
23797150,23797449,299,1,0,0,2
23797158,23797348,190,1,0,0,1
23797184,23797308,124,0,1,0,2
23797194,23797273,79,0,1,0,1
23797349,23797737,388,0,0,1,1
23797450,23797737,287,0,0,1,2
23797738,23797802,64,1,0,0,1
23797738,23797813,75,1,0,0,2
23797803,23797901,98,0,0,1,1
23797814,23797897,83,0,0,1,2
23797898,23797939,41,1,0,0,2
23797902,23797930,28,1,0,0,1
23797931,23798087,156,0,0,1,1
23797940,23798079,139,0,0,1,2
23798080,23798098,18,1,0,0,2
23798088,23798098,10,1,0,0,1
23798099,23798264,165,0,0,1,2
23798099,23799139,1040,0,0,1,1
23798265,23798274,9,1,0,0,2
23798275,23799141,866,0,0,1,2
23799140,23799187,47,1,0,0,1
23799142,23799182,40,1,0,0,2
23799183,23800070,887,0,0,1,2
23799188,23800073,885,0,0,1,1
23800071,23800109,38,1,0,0,2
23800074,23800118,44,1,0,0,1
23800110,23800427,317,0,0,1,2
23800119,23800423,304,0,0,1,1
23800424,23800465,41,1,0,0,1
23800428,23800461,33,1,0,0,2
23800462,23800961,499,0,0,1,2
23800466,23800963,497,0,0,1,1
23800962,23800991,29,1,0,0,2
23800964,23800985,21,1,0,0,1
23800986,23801266,280,0,0,1,1
23800992,23801263,271,0,0,1,2
23801264,23801327,63,1,0,0,2
23801267,23801320,53,1,0,0,1
23801321,23801511,190,0,0,1,1
23801328,23801510,182,0,0,1,2
23801511,23801605,94,1,0,0,2
23801512,23801587,75,1,0,0,1
23801588,23802675,1087,0,0,1,1
23801606,23802673,1067,0,0,1,2
23802674,23802763,89,1,0,0,2
23802676,23802774,98,1,0,0,1
23802764,23802869,105,0,0,1,2
23802775,23802869,94,0,0,1,1
23802870,23802914,44,1,0,0,2
23802870,23802921,51,1,0,0,1
23802915,23804304,1389,0,0,1,2
23802922,23803146,224,0,0,1,1
23803147,23803224,77,1,0,0,1
23803225,23803253,28,0,0,1,1
23803254,23803292,38,1,0,0,1
23803293,23803589,296,0,0,1,1
23803590,23803678,88,1,0,0,1
23803679,23803921,242,0,0,1,1
23803922,23804000,78,1,0,0,1
23804001,23804200,199,0,0,1,1
23804201,23804205,4,1,0,0,1
23804206,23804260,54,0,0,1,1
23804261,23804271,10,1,0,0,1
23804272,23804370,98,0,0,1,1
23804305,23804354,49,1,0,0,2
23804355,23804967,612,0,0,1,2
23804371,23804399,28,1,0,0,1
23804400,23804717,317,0,0,1,1
23804718,23804769,51,1,0,0,1
23804770,23804898,128,0,0,1,1
23804899,23804924,25,1,0,0,1
23804925,23804962,37,0,0,1,1
23804963,23805113,150,1,0,0,1
23804968,23805035,67,1,0,0,2
23805036,23805586,550,0,0,1,2
23805114,23805778,664,0,0,1,1
23805587,23805591,4,1,0,0,2
23805592,23806318,726,0,0,1,2
23805779,23805800,21,1,0,0,1
23805801,23806318,517,0,0,1,1
23806319,23806513,194,1,0,0,2
23806319,23806618,299,1,0,0,1
23806514,23806968,454,0,0,1,2
23806619,23806727,108,0,0,1,1
23806728,23806748,20,1,0,0,1
23806749,23806884,135,0,0,1,1
23806885,23807388,503,1,0,0,1
23806969,23807390,421,1,0,0,2
23806994,23807374,380,0,1,0,2
23807006,23807369,363,0,1,0,1
23807389,23807465,76,0,0,1,1
23807391,23807468,77,0,0,1,2
23807466,23807764,298,1,0,0,1
23807469,23807805,336,1,0,0,2
23807491,23807714,223,0,1,0,2
23807493,23807723,230,0,1,0,1
23807765,23808303,538,0,0,1,1
23807806,23808302,496,0,0,1,2
23808303,23808338,35,1,0,0,2
23808304,23808337,33,1,0,0,1
23808338,23809383,1045,0,0,1,1
23808339,23808577,238,0,0,1,2
23808578,23808588,10,1,0,0,2
23808589,23809387,798,0,0,1,2
23809384,23809446,62,1,0,0,1
23809388,23809438,50,1,0,0,2
23809439,23811614,2175,0,0,1,2
23809447,23811614,2167,0,0,1,1
23811615,23811663,48,1,0,0,1
23811615,23811665,50,1,0,0,2
23811664,23812977,1313,0,0,1,1
23811666,23812978,1312,0,0,1,2
23812978,23813032,54,1,0,0,1
23812979,23813032,53,1,0,0,2
23813033,23813136,103,0,0,1,1
23813033,23813138,105,0,0,1,2
23813137,23813173,36,1,0,0,1
23813139,23813195,56,1,0,0,2
23813174,23813327,153,0,0,1,1
23813196,23813321,125,0,0,1,2
23813322,23813340,18,1,0,0,2
23813328,23813337,9,1,0,0,1
23813338,23815421,2083,0,0,1,1
23813341,23813641,300,0,0,1,2
23813642,23813652,10,1,0,0,2
23813653,23813877,224,0,0,1,2
23813878,23813882,4,1,0,0,2
23813883,23815420,1537,0,0,1,2
23815421,23815459,38,1,0,0,2
23815422,23815462,40,1,0,0,1
23815460,23815764,304,0,0,1,2
23815463,23815766,303,0,0,1,1
23815765,23815781,16,1,0,0,2
23815767,23815781,14,1,0,0,1
23815782,23816437,655,0,0,1,2
23815782,23816967,1185,0,0,1,1
23816438,23816445,7,1,0,0,2
23816446,23816954,508,0,0,1,2
23816955,23817400,445,1,0,0,2
23816968,23817497,529,1,0,0,1
23816996,23817260,264,0,1,0,2
23816998,23817265,267,0,1,0,1
23817321,23817323,2,0,1,0,2
23817401,23817614,213,0,0,1,2
23817498,23817612,114,0,0,1,1
23817613,23817687,74,1,0,0,1
23817615,23817694,79,1,0,0,2
23817688,23817977,289,0,0,1,1
23817695,23817978,283,0,0,1,2
23817978,23818043,65,1,0,0,1
23817979,23818028,49,1,0,0,2
23818029,23818518,489,0,0,1,2
23818044,23818517,473,0,0,1,1
23818518,23818589,71,1,0,0,1
23818519,23818575,56,1,0,0,2
23818576,23818745,169,0,0,1,2
23818590,23818746,156,0,0,1,1
23818746,23818814,68,1,0,0,2
23818747,23818808,61,1,0,0,1
23818809,23819062,253,0,0,1,1
23818815,23819062,247,0,0,1,2
23819063,23819113,50,1,0,0,1
23819063,23819116,53,1,0,0,2
23819114,23819498,384,0,0,1,1
23819117,23819497,380,0,0,1,2
23819498,23819591,93,1,0,0,2
23819499,23819612,113,1,0,0,1
23819592,23819721,129,0,0,1,2
23819613,23819724,111,0,0,1,1
23819722,23819739,17,1,0,0,2
23819725,23819748,23,1,0,0,1
23819740,23820113,373,0,0,1,2
23819749,23819851,102,0,0,1,1
23819852,23819893,41,1,0,0,1
23819894,23819971,77,0,0,1,1
23819972,23820042,70,1,0,0,1
23820043,23820153,110,0,0,1,1
23820114,23820123,9,1,0,0,2
23820124,23822168,2044,0,0,1,2
23820154,23820266,112,1,0,0,1
23820267,23820386,119,0,0,1,1
23820387,23820454,67,1,0,0,1
23820455,23820572,117,0,0,1,1
23820573,23820626,53,1,0,0,1
23820627,23820737,110,0,0,1,1
23820738,23820748,10,1,0,0,1
23820749,23820962,213,0,0,1,1
23820963,23820975,12,1,0,0,1
23820976,23821066,90,0,0,1,1
23821067,23821089,22,1,0,0,1
23821090,23821482,392,0,0,1,1
23821483,23821562,79,1,0,0,1
23821563,23821694,131,0,0,1,1
23821695,23821718,23,1,0,0,1
23821719,23821796,77,0,0,1,1
23821797,23822009,212,1,0,0,1
23822010,23822132,122,0,0,1,1
23822133,23822161,28,1,0,0,1
23822162,23822637,475,0,0,1,1
23822169,23822195,26,1,0,0,2
23822196,23822639,443,0,0,1,2
23822638,23822726,88,1,0,0,1
23822640,23822694,54,1,0,0,2
23822695,23823984,1289,0,0,1,2
23822727,23822941,214,0,0,1,1
23822942,23822957,15,1,0,0,1
23822958,23823744,786,0,0,1,1
23823745,23823753,8,1,0,0,1
23823754,23823985,231,0,0,1,1
23823985,23823996,11,1,0,0,2
23823986,23824098,112,1,0,0,1
23823997,23824254,257,0,0,1,2
23824099,23824161,62,0,0,1,1
23824162,23825340,1178,1,0,0,1
23824255,23824302,47,1,0,0,2
23824303,23824830,527,0,0,1,2
23824831,23825389,558,1,0,0,2
23824869,23825246,377,0,1,0,2
23824872,23825235,363,0,1,0,1
23825341,23825601,260,0,0,1,1
23825390,23825601,211,0,0,1,2
23825602,23825643,41,1,0,0,2
23825602,23825644,42,1,0,0,1
23825644,23826403,759,0,0,1,2
23825645,23826404,759,0,0,1,1
23826404,23826466,62,1,0,0,2
23826405,23826468,63,1,0,0,1
23826467,23826583,116,0,0,1,2
23826469,23826584,115,0,0,1,1
23826584,23826621,37,1,0,0,2
23826585,23826622,37,1,0,0,1
23826622,23826672,50,0,0,1,2
23826623,23826776,153,0,0,1,1
23826673,23826745,72,1,0,0,2
23826746,23826767,21,0,0,1,2
23826768,23826783,15,1,0,0,2
23826777,23826781,4,1,0,0,1
23826782,23828297,1515,0,0,1,1
23826784,23826827,43,0,0,1,2
23826828,23826918,90,1,0,0,2
23826919,23827626,707,0,0,1,2
23827627,23827650,23,1,0,0,2
23827651,23827821,170,0,0,1,2
23827822,23827908,86,1,0,0,2
23827909,23828490,581,0,0,1,2
23828298,23828303,5,1,0,0,1
23828304,23828708,404,0,0,1,1
23828491,23828659,168,1,0,0,2
23828660,23828709,49,0,0,1,2
23828709,23828756,47,1,0,0,1
23828710,23828754,44,1,0,0,2
23828755,23831650,2895,0,0,1,2
23828757,23828839,82,0,0,1,1
23828840,23828850,10,1,0,0,1
23828851,23828954,103,0,0,1,1
23828955,23829005,50,1,0,0,1
23829006,23829101,95,0,0,1,1
23829102,23829117,15,1,0,0,1
23829118,23829347,229,0,0,1,1
23829348,23829365,17,1,0,0,1
23829366,23829483,117,0,0,1,1
23829484,23829509,25,1,0,0,1
23829510,23829556,46,0,0,1,1
23829557,23829568,11,1,0,0,1
23829569,23829690,121,0,0,1,1
23829691,23830146,455,1,0,0,1
23830147,23830236,89,0,0,1,1
23830237,23830282,45,1,0,0,1
23830283,23831650,1367,0,0,1,1
23831651,23831725,74,1,0,0,1
23831651,23831725,74,1,0,0,2
23831726,23832008,282,0,0,1,1
23831726,23832009,283,0,0,1,2
23832009,23832081,72,1,0,0,1
23832010,23832088,78,1,0,0,2
23832082,23832188,106,0,0,1,1
23832089,23832189,100,0,0,1,2
23832189,23832223,34,1,0,0,1
23832190,23832223,33,1,0,0,2
23832224,23833555,1331,0,0,1,2
23832224,23833556,1332,0,0,1,1
23833556,23833603,47,1,0,0,2
23833557,23833602,45,1,0,0,1
23833603,23834078,475,0,0,1,1
23833604,23834077,473,0,0,1,2
23834078,23834101,23,1,0,0,2
23834079,23834087,8,1,0,0,1
23834088,23835734,1646,0,0,1,1
23834102,23835730,1628,0,0,1,2
23835731,23836031,300,1,0,0,2
23835735,23835998,263,1,0,0,1
23835765,23835935,170,0,1,0,2
23835782,23835901,119,0,1,0,1
23835999,23836527,528,0,0,1,1
23836032,23836526,494,0,0,1,2
23836527,23836554,27,1,0,0,2
23836528,23836561,33,1,0,0,1
23836555,23836776,221,0,0,1,2
23836562,23836775,213,0,0,1,1
23836776,23836834,58,1,0,0,1
23836777,23836834,57,1,0,0,2
23836835,23836934,99,0,0,1,1
23836835,23836936,101,0,0,1,2
23836935,23837020,85,1,0,0,1
23836937,23837031,94,1,0,0,2
23837021,23837129,108,0,0,1,1
23837032,23837130,98,0,0,1,2
23837130,23837169,39,1,0,0,1
23837131,23837176,45,1,0,0,2
23837170,23837305,135,0,0,1,1
23837177,23837309,132,0,0,1,2
23837306,23837320,14,1,0,0,1
23837310,23837320,10,1,0,0,2
23837321,23837668,347,0,0,1,1
23837321,23838007,686,0,0,1,2
23837669,23837676,7,1,0,0,1
23837677,23838684,1007,0,0,1,1
23838008,23838176,168,1,0,0,2
23838177,23838329,152,0,0,1,2
23838330,23838463,133,1,0,0,2
23838464,23838686,222,0,0,1,2
23838685,23838734,49,1,0,0,1
23838687,23838734,47,1,0,0,2
23838735,23838774,39,0,0,1,2
23838735,23838935,200,0,0,1,1
23838775,23839873,1098,1,0,0,2
23838936,23838953,17,1,0,0,1
23838954,23840937,1983,0,0,1,1
23839874,23839901,27,0,0,1,2
23839902,23839917,15,1,0,0,2
23839918,23840151,233,0,0,1,2
23840152,23840176,24,1,0,0,2
23840177,23840209,32,0,0,1,2
23840210,23841292,1082,1,0,0,2
23840938,23840979,41,1,0,0,1
23840980,23841336,356,0,0,1,1
23841293,23841314,21,0,0,1,2
23841315,23841393,78,1,0,0,2
23841337,23841391,54,1,0,0,1
23841392,23842161,769,0,0,1,1
23841394,23842160,766,0,0,1,2
23842161,23842216,55,1,0,0,2
23842162,23842210,48,1,0,0,1
23842211,23842338,127,0,0,1,1
23842217,23842339,122,0,0,1,2
23842339,23842414,75,1,0,0,1
23842340,23842409,69,1,0,0,2
23842410,23842519,109,0,0,1,2
23842415,23842518,103,0,0,1,1
23842519,23842547,28,1,0,0,1
23842520,23842573,53,1,0,0,2
23842548,23843334,786,0,0,1,1
23842574,23842715,141,0,0,1,2
23842716,23842730,14,1,0,0,2
23842731,23842879,148,0,0,1,2
23842880,23842904,24,1,0,0,2
23842905,23842950,45,0,0,1,2
23842951,23843128,177,1,0,0,2
23843129,23843152,23,0,0,1,2
23843153,23843629,476,1,0,0,2
23843335,23843353,18,1,0,0,1
23843354,23844026,672,0,0,1,1
23843630,23843755,125,0,0,1,2
23843756,23844140,384,1,0,0,2
23844027,23844099,72,1,0,0,1
23844100,23844258,158,0,0,1,1
23844141,23844259,118,0,0,1,2
23844259,23844284,25,1,0,0,1
23844260,23844346,86,1,0,0,2
23844285,23846134,1849,0,0,1,1
23844347,23845103,756,0,0,1,2
23845104,23845118,14,1,0,0,2
23845119,23845574,455,0,0,1,2
23845575,23845579,4,1,0,0,2
23845580,23846133,553,0,0,1,2
23846134,23846195,61,1,0,0,2
23846135,23846195,60,1,0,0,1
23846196,23847740,1544,0,0,1,2
23846196,23847741,1545,0,0,1,1
23847741,23847786,45,1,0,0,2
23847742,23847775,33,1,0,0,1
23847776,23848958,1182,0,0,1,1
23847787,23848958,1171,0,0,1,2
23848959,23849014,55,1,0,0,2
23848959,23849075,116,1,0,0,1
23849015,23849178,163,0,0,1,2
23849076,23849177,101,0,0,1,1
23849178,23849218,40,1,0,0,1
23849179,23849208,29,1,0,0,2
23849209,23849751,542,0,0,1,2
23849219,23849533,314,0,0,1,1
23849534,23849609,75,1,0,0,1
23849610,23849884,274,0,0,1,1
23849752,23849899,147,1,0,0,2
23849885,23849912,27,1,0,0,1
23849900,23850038,138,0,0,1,2
23849913,23849952,39,0,0,1,1
23849953,23849976,23,1,0,0,1
23849977,23850037,60,0,0,1,1
23850038,23850064,26,1,0,0,1
23850039,23851395,1356,1,0,0,2
23850065,23850140,75,0,0,1,1
23850141,23850162,21,1,0,0,1
23850163,23850311,148,0,0,1,1
23850312,23850354,42,1,0,0,1
23850355,23850522,167,0,0,1,1
23850523,23850549,26,1,0,0,1
23850550,23850840,290,0,0,1,1
23850841,23850971,130,1,0,0,1
23850972,23851275,303,0,0,1,1
23851276,23851294,18,1,0,0,1
23851295,23851430,135,0,0,1,1
23851396,23851429,33,0,0,1,2
23851430,23851481,51,1,0,0,2
23851431,23851479,48,1,0,0,1
23851480,23852073,593,0,0,1,1
23851482,23852078,596,0,0,1,2
23852074,23852149,75,1,0,0,1
23852079,23852155,76,1,0,0,2
23852150,23852254,104,0,0,1,1
23852156,23852254,98,0,0,1,2
23852255,23852279,24,1,0,0,1
23852255,23852279,24,1,0,0,2
23852280,23852407,127,0,0,1,2
23852280,23853856,1576,0,0,1,1
23852408,23852414,6,1,0,0,2
23852415,23853856,1441,0,0,1,2
23853857,23853895,38,1,0,0,1
23853857,23853921,64,1,0,0,2
23853896,23854459,563,0,0,1,1
23853922,23853957,35,0,0,1,2
23853958,23854176,218,1,0,0,2
23854177,23854403,226,0,0,1,2
23854404,23854546,142,1,0,0,2
23854460,23854487,27,1,0,0,1
23854488,23855042,554,0,0,1,1
23854547,23854665,118,0,0,1,2
23854666,23854766,100,1,0,0,2
23854767,23854843,76,0,0,1,2
23854844,23854898,54,1,0,0,2
23854899,23855046,147,0,0,1,2
23855043,23855063,20,1,0,0,1
23855047,23855127,80,1,0,0,2
23855064,23855574,510,0,0,1,1
23855128,23855172,44,0,0,1,2
23855173,23855193,20,1,0,0,2
23855194,23855214,20,0,0,1,2
23855215,23855236,21,1,0,0,2
23855237,23855382,145,0,0,1,2
23855383,23855469,86,1,0,0,2
23855470,23855522,52,0,0,1,2
23855523,23855967,444,1,0,0,2
23855575,23855588,13,1,0,0,1
23855589,23856372,783,0,0,1,1
23855968,23856007,39,0,0,1,2
23856008,23856030,22,1,0,0,2
23856031,23856060,29,0,0,1,2
23856061,23856108,47,1,0,0,2
23856109,23856190,81,0,0,1,2
23856191,23856549,358,1,0,0,2
23856373,23856446,73,1,0,0,1
23856447,23856981,534,0,0,1,1
23856550,23856984,434,0,0,1,2
23856982,23857022,40,1,0,0,1
23856985,23857024,39,1,0,0,2
23857023,23857636,613,0,0,1,1
23857025,23857438,413,0,0,1,2
23857439,23857480,41,1,0,0,2
23857481,23857636,155,0,0,1,2
23857637,23857705,68,1,0,0,1
23857637,23857721,84,1,0,0,2
23857706,23857824,118,0,0,1,1
23857722,23857822,100,0,0,1,2
23857823,23857852,29,1,0,0,2
23857825,23857848,23,1,0,0,1
23857849,23859210,1361,0,0,1,1
23857853,23858705,852,0,0,1,2
23858716,23858740,24,0,1,0,2
23858750,23859290,540,1,0,0,2
23858779,23859223,444,0,1,0,2
23859211,23859262,51,1,0,0,1
23859263,23859497,234,0,0,1,1
23859291,23859358,67,0,0,1,2
23859359,23860018,659,1,0,0,2
23859498,23859525,27,1,0,0,1
23859526,23862132,2606,0,0,1,1
23860019,23860040,21,0,0,1,2
23860041,23860166,125,1,0,0,2
23860167,23860187,20,0,0,1,2
23860188,23862213,2025,1,0,0,2
23862133,23862195,62,1,0,0,1
23862196,23863004,808,0,0,1,1
23862214,23863003,789,0,0,1,2
23863004,23863093,89,1,0,0,2
23863005,23863098,93,1,0,0,1
23863094,23863184,90,0,0,1,2
23863099,23863184,85,0,0,1,1
23863185,23863216,31,1,0,0,1
23863185,23863224,39,1,0,0,2
23863217,23863365,148,0,0,1,1
23863225,23863364,139,0,0,1,2
23863365,23863376,11,1,0,0,2
23863366,23863379,13,1,0,0,1
23863377,23863870,493,0,0,1,2
23863380,23863879,499,0,0,1,1
23863871,23864118,247,1,0,0,2
23863880,23864066,186,1,0,0,1
23863897,23863996,99,0,1,0,2
23863911,23863967,56,0,1,0,1
23864067,23864983,916,0,0,1,1
23864119,23864176,57,0,0,1,2
23864177,23864189,12,1,0,0,2
23864190,23864420,230,0,0,1,2
23864421,23864435,14,1,0,0,2
23864436,23864983,547,0,0,1,2
23864984,23865018,34,1,0,0,1
23864984,23865021,37,1,0,0,2
23865019,23865149,130,0,0,1,1
23865022,23865150,128,0,0,1,2
23865150,23865178,28,1,0,0,1
23865151,23865172,21,1,0,0,2
23865173,23868634,3461,0,0,1,2
23865179,23868635,3456,0,0,1,1
23868635,23868703,68,1,0,0,2
23868636,23868702,66,1,0,0,1
23868703,23868804,101,0,0,1,1
23868704,23868806,102,0,0,1,2
23868805,23868830,25,1,0,0,1
23868807,23868830,23,1,0,0,2
23868831,23871378,2547,0,0,1,1
23868831,23871378,2547,0,0,1,2
23871379,23871425,46,1,0,0,1
23871379,23871428,49,1,0,0,2
23871426,23871694,268,0,0,1,1
23871429,23871698,269,0,0,1,2
23871695,23871711,16,1,0,0,1
23871699,23871712,13,1,0,0,2
23871712,23872069,357,0,0,1,1
23871713,23872057,344,0,0,1,2
23872058,23872532,474,1,0,0,2
23872070,23872531,461,1,0,0,1
23872100,23872445,345,0,1,0,2
23872101,23872352,251,0,1,0,1
23872532,23872600,68,0,0,1,1
23872533,23872600,67,0,0,1,2
23872601,23872624,23,1,0,0,1
23872601,23872630,29,1,0,0,2
23872625,23873675,1050,0,0,1,1
23872631,23873677,1046,0,0,1,2
23873676,23873715,39,1,0,0,1
23873678,23873723,45,1,0,0,2
23873716,23874502,786,0,0,1,1
23873724,23874502,778,0,0,1,2
23874503,23874543,40,1,0,0,1
23874503,23874545,42,1,0,0,2
23874544,23874823,279,0,0,1,1
23874546,23874822,276,0,0,1,2
23874823,23874906,83,1,0,0,2
23874824,23874918,94,1,0,0,1
23874907,23875029,122,0,0,1,2
23874919,23875033,114,0,0,1,1
23875030,23875060,30,1,0,0,2
23875034,23875061,27,1,0,0,1
23875061,23875452,391,0,0,1,2
23875062,23876617,1555,0,0,1,1
23875453,23875457,4,1,0,0,2
23875458,23875551,93,0,0,1,2
23875552,23876006,454,1,0,0,2
23876007,23876048,41,0,0,1,2
23876049,23876667,618,1,0,0,2
23876290,23876296,6,0,1,0,2
23876437,23876649,212,0,1,0,2
23876618,23876683,65,1,0,0,1
23876668,23876752,84,0,0,1,2
23876684,23877824,1140,0,0,1,1
23876753,23876774,21,1,0,0,2
23876775,23876804,29,0,0,1,2
23876805,23876830,25,1,0,0,2
23876831,23876918,87,0,0,1,2
23876919,23876953,34,1,0,0,2
23876954,23877076,122,0,0,1,2
23877077,23877212,135,1,0,0,2
23877213,23877299,86,0,0,1,2
23877300,23877620,320,1,0,0,2
23877529,23877611,82,0,1,0,2
23877621,23877647,26,0,0,1,2
23877658,23877705,47,0,1,0,2
23877715,23878092,377,1,0,0,2
23877744,23877837,93,0,1,0,2
23877825,23877890,65,1,0,0,1
23877891,23878588,697,0,0,1,1
23878093,23878589,496,0,0,1,2
23878589,23878639,50,1,0,0,1
23878590,23878637,47,1,0,0,2
23878638,23878793,155,0,0,1,2
23878640,23878790,150,0,0,1,1
23878791,23878835,44,1,0,0,1
23878794,23878833,39,1,0,0,2
23878834,23879864,1030,0,0,1,2
23878836,23879864,1028,0,0,1,1
23879865,23879937,72,1,0,0,2
23879865,23879942,77,1,0,0,1
23879938,23880045,107,0,0,1,2
23879943,23880043,100,0,0,1,1
23880044,23880109,65,1,0,0,1
23880046,23880083,37,1,0,0,2
23880084,23880399,315,0,0,1,2
23880110,23880214,104,0,0,1,1
23880215,23880245,30,1,0,0,1
23880246,23880400,154,0,0,1,1
23880400,23880438,38,1,0,0,2
23880401,23880411,10,1,0,0,1
23880412,23880457,45,0,0,1,1
23880439,23881286,847,0,0,1,2
23880458,23880473,15,1,0,0,1
23880474,23880514,40,0,0,1,1
23880515,23880528,13,1,0,0,1
23880529,23880691,162,0,0,1,1
23880692,23880708,16,1,0,0,1
23880709,23880935,226,0,0,1,1
23880936,23880961,25,1,0,0,1
23880962,23881093,131,0,0,1,1
23881094,23881115,21,1,0,0,1
23881116,23881558,442,0,0,1,1
23881287,23881308,21,1,0,0,2
23881309,23881570,261,0,0,1,2
23881559,23881576,17,1,0,0,1
23881571,23881638,67,1,0,0,2
23881577,23881644,67,0,0,1,1
23881639,23881909,270,0,0,1,2
23881645,23882040,395,1,0,0,1
23881910,23882004,94,1,0,0,2
23882005,23882088,83,0,0,1,2
23882041,23882109,68,0,0,1,1
23882089,23883152,1063,1,0,0,2
23882110,23882126,16,1,0,0,1
23882127,23882256,129,0,0,1,1
23882257,23882350,93,1,0,0,1
23882351,23882542,191,0,0,1,1
23882543,23882623,80,1,0,0,1
23882624,23882753,129,0,0,1,1
23882754,23883017,263,1,0,0,1
23883018,23883123,105,0,0,1,1
23883124,23883137,13,1,0,0,1
23883138,23883203,65,0,0,1,1
23883153,23883600,447,0,0,1,2
23883204,23883251,47,1,0,0,1
23883252,23884228,976,0,0,1,1
23883601,23883622,21,1,0,0,2
23883623,23884433,810,0,0,1,2
23884229,23884248,19,1,0,0,1
23884249,23884443,194,0,0,1,1
23884434,23884463,29,1,0,0,2
23884444,23884499,55,1,0,0,1
23884464,23884791,327,0,0,1,2
23884500,23884562,62,0,0,1,1
23884563,23884616,53,1,0,0,1
23884617,23884762,145,0,0,1,1
23884763,23884782,19,1,0,0,1
23884783,23884868,85,0,0,1,1
23884792,23884849,57,1,0,0,2
23884850,23885001,151,0,0,1,2
23884869,23884908,39,1,0,0,1
23884909,23884959,50,0,0,1,1
23884960,23885262,302,1,0,0,1
23885002,23885433,431,1,0,0,2
23885263,23885330,67,0,0,1,1
23885331,23885427,96,1,0,0,1
23885428,23885752,324,0,0,1,1
23885434,23885499,65,0,0,1,2
23885500,23885997,497,1,0,0,2
23885753,23885805,52,1,0,0,1
23885806,23886114,308,0,0,1,1
23885998,23886588,590,0,0,1,2
23886115,23886163,48,1,0,0,1
23886164,23886185,21,0,0,1,1
23886186,23886420,234,1,0,0,1
23886421,23886452,31,0,0,1,1
23886453,23886487,34,1,0,0,1
23886488,23886570,82,0,0,1,1
23886571,23886635,64,1,0,0,1
23886589,23886740,151,1,0,0,2
23886636,23886834,198,0,0,1,1
23886741,23886920,179,0,0,1,2
23886835,23886885,50,1,0,0,1
23886886,23886918,32,0,0,1,1
23886919,23886979,60,1,0,0,1
23886921,23887033,112,1,0,0,2
23886980,23887099,119,0,0,1,1
23887034,23887103,69,0,0,1,2
23887100,23887125,25,1,0,0,1
23887104,23887125,21,1,0,0,2
23887126,23887683,557,0,0,1,2
23887126,23887689,563,0,0,1,1
23887684,23887701,17,1,0,0,2
23887690,23887700,10,1,0,0,1
23887701,23887916,215,0,0,1,1
23887702,23887915,213,0,0,1,2
23887916,23887927,11,1,0,0,2
23887917,23887927,10,1,0,0,1
23887928,23888120,192,0,0,1,1
23887928,23890014,2086,0,0,1,2
23888121,23888133,12,1,0,0,1
23888134,23890014,1880,0,0,1,1
23890015,23890067,52,1,0,0,1
23890015,23890073,58,1,0,0,2
23890068,23890196,128,0,0,1,1
23890074,23890196,122,0,0,1,2
23890197,23890214,17,1,0,0,1
23890197,23890217,20,1,0,0,2
23890215,23891973,1758,0,0,1,1
23890218,23890879,661,0,0,1,2
23890880,23890887,7,1,0,0,2
23890888,23891967,1079,0,0,1,2
23891968,23892284,316,1,0,0,2
23891974,23892267,293,1,0,0,1
23892080,23892206,126,0,1,0,2
23892093,23892156,63,0,1,0,1
23892268,23893414,1146,0,0,1,1
23892285,23892308,23,0,0,1,2
23892309,23892371,62,1,0,0,2
23892372,23893413,1041,0,0,1,2
23893414,23893447,33,1,0,0,2
23893415,23893446,31,1,0,0,1
23893447,23893633,186,0,0,1,1
23893448,23893635,187,0,0,1,2
23893634,23893653,19,1,0,0,1
23893636,23893656,20,1,0,0,2
23893654,23896108,2454,0,0,1,1
23893657,23895401,1744,0,0,1,2
23895402,23895423,21,1,0,0,2
23895424,23895924,500,0,0,1,2
23895925,23895955,30,1,0,0,2
23895956,23896110,154,0,0,1,2
23896109,23896153,44,1,0,0,1
23896111,23896305,194,1,0,0,2
23896154,23896498,344,0,0,1,1
23896306,23896335,29,0,0,1,2
23896336,23896428,92,1,0,0,2
23896429,23896461,32,0,0,1,2
23896462,23896534,72,1,0,0,2
23896499,23896529,30,1,0,0,1
23896530,23898314,1784,0,0,1,1
23896535,23896656,121,0,0,1,2
23896657,23896706,49,1,0,0,2
23896707,23896921,214,0,0,1,2
23896922,23896936,14,1,0,0,2
23896937,23896977,40,0,0,1,2
23896978,23897004,26,1,0,0,2
23897005,23897497,492,0,0,1,2
23897498,23897514,16,1,0,0,2
23897515,23898317,802,0,0,1,2
23898315,23898370,55,1,0,0,1
23898318,23898569,251,1,0,0,2
23898371,23899160,789,0,0,1,1
23898570,23899161,591,0,0,1,2
23899161,23899185,24,1,0,0,1
23899162,23899224,62,1,0,0,2
23899186,23899947,761,0,0,1,1
23899225,23899944,719,0,0,1,2
23899945,23900036,91,1,0,0,2
23899948,23900098,150,1,0,0,1
23900037,23900223,186,0,0,1,2
23900099,23900225,126,0,0,1,1
23900224,23903417,3193,1,0,0,2
23900226,23900267,41,1,0,0,1
23900268,23901742,1474,0,0,1,1
23901743,23901827,84,1,0,0,1
23901828,23901875,47,0,0,1,1
23901876,23901880,4,1,0,0,1
23901881,23902149,268,0,0,1,1
23902150,23902176,26,1,0,0,1
23902177,23902774,597,0,0,1,1
23902775,23902794,19,1,0,0,1
23902795,23903709,914,0,0,1,1
23903418,23903448,30,0,0,1,2
23903449,23904052,603,1,0,0,2
23903710,23903768,58,1,0,0,1
23903769,23903852,83,0,0,1,1
23903853,23903998,145,1,0,0,1
23903999,23904928,929,0,0,1,1
23904053,23904929,876,0,0,1,2
23904929,23905071,142,1,0,0,1
23904930,23905095,165,1,0,0,2
23905072,23905204,132,0,0,1,1
23905096,23905220,124,0,0,1,2
23905205,23905247,42,1,0,0,1
23905221,23905284,63,1,0,0,2
23905248,23907319,2071,0,0,1,1
23905285,23905355,70,0,0,1,2
23905356,23907931,2575,1,0,0,2
23907320,23907345,25,1,0,0,1
23907346,23907465,119,0,0,1,1
23907466,23907518,52,1,0,0,1
23907519,23907658,139,0,0,1,1
23907659,23907679,20,1,0,0,1
23907680,23908216,536,0,0,1,1
23907932,23908141,209,0,0,1,2
23908142,23909987,1845,1,0,0,2
23908217,23908230,13,1,0,0,1
23908231,23908373,142,0,0,1,1
23908374,23908389,15,1,0,0,1
23908390,23908769,379,0,0,1,1
23908770,23908785,15,1,0,0,1
23908786,23908980,194,0,0,1,1
23908981,23909000,19,1,0,0,1
23909001,23909206,205,0,0,1,1
23909207,23909220,13,1,0,0,1
23909221,23909910,689,0,0,1,1
23909911,23909956,45,1,0,0,1
23909957,23910217,260,0,0,1,1
23909988,23910218,230,0,0,1,2
23910218,23910261,43,1,0,0,1
23910219,23910262,43,1,0,0,2
23910262,23910646,384,0,0,1,1
23910263,23910628,365,0,0,1,2
23910629,23911041,412,1,0,0,2
23910647,23911053,406,1,0,0,1
23910666,23910862,196,0,1,0,2
23910675,23910842,167,0,1,0,1
23911042,23911332,290,0,0,1,2
23911054,23911332,278,0,0,1,1
23911333,23911388,55,1,0,0,2
23911333,23911390,57,1,0,0,1
23911389,23911542,153,0,0,1,2
23911391,23911542,151,0,0,1,1
23911543,23911590,47,1,0,0,1
23911543,23911600,57,1,0,0,2
23911591,23911702,111,0,0,1,1
23911601,23911699,98,0,0,1,2
23911700,23911730,30,1,0,0,2
23911703,23911731,28,1,0,0,1
23911731,23912163,432,0,0,1,2
23911732,23912163,431,0,0,1,1
23912164,23912205,41,1,0,0,2
23912164,23912208,44,1,0,0,1
23912206,23912785,579,0,0,1,2
23912209,23912785,576,0,0,1,1
23912786,23912828,42,1,0,0,1
23912786,23912828,42,1,0,0,2
23912829,23913173,344,0,0,1,1
23912829,23913173,344,0,0,1,2
23913174,23913214,40,1,0,0,2
23913174,23913215,41,1,0,0,1
23913215,23913882,667,0,0,1,2
23913216,23913880,664,0,0,1,1
23913881,23913907,26,1,0,0,1
23913883,23913906,23,1,0,0,2
23913907,23914301,394,0,0,1,2
23913908,23914300,392,0,0,1,1
23914301,23914345,44,1,0,0,1
23914302,23914346,44,1,0,0,2
23914346,23914679,333,0,0,1,1
23914347,23914683,336,0,0,1,2
23914680,23914747,67,1,0,0,1
23914684,23914745,61,1,0,0,2
23914746,23915074,328,0,0,1,2
23914748,23915074,326,0,0,1,1
23915075,23915100,25,1,0,0,1
23915075,23915100,25,1,0,0,2
23915101,23915290,189,0,0,1,1
23915101,23915291,190,0,0,1,2
23915291,23915343,52,1,0,0,1
23915292,23915361,69,1,0,0,2
23915344,23915454,110,0,0,1,1
23915362,23915453,91,0,0,1,2
23915454,23915502,48,1,0,0,2
23915455,23915533,78,1,0,0,1
23915503,23916895,1392,0,0,1,2
23915534,23915814,280,0,0,1,1
23915815,23915831,16,1,0,0,1
23915832,23916895,1063,0,0,1,1
23916896,23916911,15,1,0,0,1
23916896,23916912,16,1,0,0,2
23916912,23918131,1219,0,0,1,1
23916913,23917057,144,0,0,1,2
23917058,23917069,11,1,0,0,2
23917070,23918131,1061,0,0,1,2
23918132,23918183,51,1,0,0,1
23918132,23918184,52,1,0,0,2
23918184,23918781,597,0,0,1,1
23918185,23918777,592,0,0,1,2
23918778,23918817,39,1,0,0,2
23918782,23918817,35,1,0,0,1
23918818,23919867,1049,0,0,1,1
23918818,23920338,1520,0,0,1,2
23919868,23919872,4,1,0,0,1
23919873,23920338,465,0,0,1,1
23920339,23920403,64,1,0,0,1
23920339,23920403,64,1,0,0,2
23920404,23921422,1018,0,0,1,1
23920404,23921422,1018,0,0,1,2
23921423,23921485,62,1,0,0,2
23921423,23921486,63,1,0,0,1
23921486,23921619,133,0,0,1,2
23921487,23921618,131,0,0,1,1
23921619,23921645,26,1,0,0,1
23921620,23921646,26,1,0,0,2
23921646,23921901,255,0,0,1,1
23921647,23921903,256,0,0,1,2
23921902,23921942,40,1,0,0,1
23921904,23921943,39,1,0,0,2
23921943,23922185,242,0,0,1,1
23921944,23922174,230,0,0,1,2
23922175,23922591,416,1,0,0,2
23922186,23922592,406,1,0,0,1
23922204,23922486,282,0,1,0,2
23922207,23922434,227,0,1,0,1
23922592,23922637,45,0,0,1,2
23922593,23922640,47,0,0,1,1
23922638,23922659,21,1,0,0,2
23922641,23922662,21,1,0,0,1
23922660,23922811,151,0,0,1,2
23922663,23922809,146,0,0,1,1
23922810,23922830,20,1,0,0,1
23922812,23922832,20,1,0,0,2
23922831,23922936,105,0,0,1,1
23922833,23922937,104,0,0,1,2
23922937,23922970,33,1,0,0,1
23922938,23922992,54,1,0,0,2
23922971,23923181,210,0,0,1,1
23922993,23923181,188,0,0,1,2
23923182,23923220,38,1,0,0,2
23923182,23923221,39,1,0,0,1
23923221,23923476,255,0,0,1,2
23923222,23923475,253,0,0,1,1
23923476,23923573,97,1,0,0,1
23923477,23923617,140,1,0,0,2
23923574,23923797,223,0,0,1,1
23923618,23923745,127,0,0,1,2
23923746,23923750,4,1,0,0,2
23923751,23923793,42,0,0,1,2
23923794,23924058,264,1,0,0,2
23923798,23924027,229,1,0,0,1
23923820,23923972,152,0,1,0,1
23923821,23923952,131,0,1,0,2
23923985,23923990,5,0,1,0,2
23924028,23924093,65,0,0,1,1
23924059,23924082,23,0,0,1,2
23924083,23924243,160,1,0,0,2
23924094,23924222,128,1,0,0,1
23924110,23924149,39,0,1,0,2
23924118,23924170,52,0,1,0,1
23924223,23924455,232,0,0,1,1
23924244,23924439,195,0,0,1,2
23924440,23924763,323,1,0,0,2
23924456,23924665,209,1,0,0,1
23924470,23924609,139,0,1,0,2
23924482,23924628,146,0,1,0,1
23924666,23924822,156,0,0,1,1
23924764,23924823,59,0,0,1,2
23924823,23924840,17,1,0,0,1
23924824,23924840,16,1,0,0,2
23924841,23925056,215,0,0,1,2
23924841,23925065,224,0,0,1,1
23925057,23925938,881,1,0,0,2
23925066,23925955,889,1,0,0,1
23925080,23925899,819,0,1,0,2
23925084,23925944,860,0,1,0,1
23925939,23925981,42,0,0,1,2
23925956,23925989,33,0,0,1,1
23925982,23926395,413,1,0,0,2
23925990,23926351,361,1,0,0,1
23926010,23926341,331,0,1,0,1
23926013,23926352,339,0,1,0,2
23926352,23926438,86,0,0,1,1
23926396,23926440,44,0,0,1,2
23926439,23926492,53,1,0,0,1
23926441,23926483,42,1,0,0,2
23926484,23926607,123,0,0,1,2
23926493,23926613,120,0,0,1,1
23926608,23926670,62,1,0,0,2
23926624,23929163,2539,0,1,0,1
23926671,23926703,32,0,0,1,2
23926704,23927469,765,1,0,0,2
23926793,23927358,565,0,1,0,2
23927426,23927430,4,0,1,0,2
23927470,23927595,125,0,0,1,2
23927596,23927744,148,1,0,0,2
23927615,23927731,116,0,1,0,2
23927745,23927841,96,0,0,1,2
23927842,23929201,1359,1,0,0,2
23927872,23929169,1297,0,1,0,2
23929173,23929174,1,1,0,0,1
23929175,23929200,25,0,0,1,1
23929201,23929216,15,1,0,0,1
23929202,23929277,75,0,0,1,2
23929217,23929276,59,0,0,1,1
23929277,23929314,37,1,0,0,1
23929278,23929327,49,1,0,0,2
23929315,23929441,126,0,0,1,1
23929328,23929449,121,0,0,1,2
23929442,23929687,245,1,0,0,1
23929450,23929707,257,1,0,0,2
23929484,23929632,148,0,1,0,2
23929485,23929643,158,0,1,0,1
23929688,23929953,265,0,0,1,1
23929708,23929950,242,0,0,1,2
23929951,23929972,21,1,0,0,2
23929954,23929967,13,1,0,0,1
23929968,23930166,198,0,0,1,1
23929973,23930160,187,0,0,1,2
23930161,23930404,243,1,0,0,2
23930167,23930389,222,1,0,0,1
23930188,23930340,152,0,1,0,1
23930188,23930345,157,0,1,0,2
23930390,23930748,358,0,0,1,1
23930405,23930743,338,0,0,1,2
23930744,23931079,335,1,0,0,2
23930749,23931007,258,1,0,0,1
23930769,23930945,176,0,1,0,1
23930773,23930947,174,0,1,0,2
23931008,23931325,317,0,0,1,1
23931080,23931327,247,0,0,1,2
23931326,23931352,26,1,0,0,1
23931328,23931344,16,1,0,0,2
23931345,23931521,176,0,0,1,2
23931353,23931520,167,0,0,1,1
23931521,23931555,34,1,0,0,1
23931522,23931556,34,1,0,0,2
23931556,23931687,131,0,0,1,1
23931557,23931687,130,0,0,1,2
24006501,24006854,353,0,0,1,1
24006501,24006855,354,0,0,1,2
24006855,24006925,70,1,0,0,1
24006856,24006940,84,1,0,0,2
24006926,24007013,87,0,0,1,1
24006941,24007014,73,0,0,1,2
24007014,24007050,36,1,0,0,1
24007015,24007051,36,1,0,0,2
24007051,24007190,139,0,0,1,1
24007052,24007194,142,0,0,1,2
24007191,24007222,31,1,0,0,1
24007195,24007221,26,1,0,0,2
24007222,24007377,155,0,0,1,2
24007223,24007375,152,0,0,1,1
24007376,24007388,12,1,0,0,1
24007378,24007387,9,1,0,0,2
24007388,24007561,173,0,0,1,2
24007389,24007560,171,0,0,1,1
24007561,24007570,9,1,0,0,1
24007562,24007574,12,1,0,0,2
24007571,24008504,933,0,0,1,1
24007575,24008510,935,0,0,1,2
24008505,24008664,159,1,0,0,1
24008511,24008643,132,1,0,0,2
24008644,24009044,400,0,0,1,2
24008665,24009040,375,0,0,1,1
24009041,24009280,239,1,0,0,1
24009045,24009286,241,1,0,0,2
24009078,24009184,106,0,1,0,1
24009080,24009178,98,0,1,0,2
24009281,24009316,35,0,0,1,1
24009287,24009316,29,0,0,1,2
24009317,24009338,21,1,0,0,1
24009317,24009338,21,1,0,0,2
24009339,24009487,148,0,0,1,2
24009339,24010550,1211,0,0,1,1
24009488,24009502,14,1,0,0,2
24009503,24009935,432,0,0,1,2
24009936,24009941,5,1,0,0,2
24009942,24010552,610,0,0,1,2
24010551,24010616,65,1,0,0,1
24010553,24010612,59,1,0,0,2
24010613,24010756,143,0,0,1,2
24010617,24010757,140,0,0,1,1
24010757,24010805,48,1,0,0,2
24010758,24010819,61,1,0,0,1
24010806,24010918,112,0,0,1,2
24010820,24010917,97,0,0,1,1
24010918,24010936,18,1,0,0,1
24010919,24010938,19,1,0,0,2
24010937,24011390,453,0,0,1,1
24010939,24012448,1509,0,0,1,2
24011391,24011400,9,1,0,0,1
24011401,24012446,1045,0,0,1,1
24012447,24012491,44,1,0,0,1
24012449,24012485,36,1,0,0,2
24012486,24012611,125,0,0,1,2
24012492,24012613,121,0,0,1,1
24012612,24012616,4,1,0,0,2
24012614,24012619,5,1,0,0,1
24012617,24012829,212,0,0,1,2
24012620,24012777,157,0,0,1,1
24012778,24012796,18,1,0,0,1
24012797,24013943,1146,0,0,1,1
24012830,24012847,17,1,0,0,2
24012848,24013074,226,0,0,1,2
24013075,24013157,82,1,0,0,2
24013158,24013287,129,0,0,1,2
24013288,24013323,35,1,0,0,2
24013324,24013517,193,0,0,1,2
24013518,24013580,62,1,0,0,2
24013581,24013944,363,0,0,1,2
24013944,24014034,90,1,0,0,1
24013945,24014018,73,1,0,0,2
24014019,24014116,97,0,0,1,2
24014035,24014110,75,0,0,1,1
24014111,24014156,45,1,0,0,1
24014117,24014146,29,1,0,0,2
24014147,24014314,167,0,0,1,2
24014157,24014313,156,0,0,1,1
24014314,24014336,22,1,0,0,1
24014315,24014338,23,1,0,0,2
24014337,24014711,374,0,0,1,1
24014339,24014478,139,0,0,1,2
24014479,24014489,10,1,0,0,2
24014490,24014712,222,0,0,1,2
24014712,24015340,628,1,0,0,1
24014713,24015072,359,1,0,0,2
24014738,24014975,237,0,1,0,1
24014743,24014950,207,0,1,0,2
24015010,24015025,15,0,1,0,1
24015073,24015230,157,0,0,1,2
24015231,24015243,12,1,0,0,2
24015244,24015423,179,0,0,1,2
24015341,24016105,764,0,0,1,1
24015424,24015442,18,1,0,0,2
24015443,24016202,759,0,0,1,2
24016106,24016165,59,1,0,0,1
24016166,24016202,36,0,0,1,1
24016203,24016249,46,1,0,0,1
24016203,24016250,47,1,0,0,2
24016250,24016507,257,0,0,1,1
24016251,24016507,256,0,0,1,2
24016508,24016544,36,1,0,0,1
24016508,24016544,36,1,0,0,2
24016545,24016683,138,0,0,1,1
24016545,24016689,144,0,0,1,2
24016684,24016701,17,1,0,0,1
24016690,24016701,11,1,0,0,2
24016702,24018236,1534,0,0,1,1
24016702,24018236,1534,0,0,1,2
24018237,24018315,78,1,0,0,1
24018237,24018315,78,1,0,0,2
24018316,24018398,82,0,0,1,2
24018316,24018400,84,0,0,1,1
24018399,24018431,32,1,0,0,2
24018401,24018444,43,1,0,0,1
24018432,24018547,115,0,0,1,2
24018445,24018546,101,0,0,1,1
24018547,24018570,23,1,0,0,1
24018548,24018578,30,1,0,0,2
24018571,24019169,598,0,0,1,1
24018579,24018753,174,0,0,1,2
24018754,24018764,10,1,0,0,2
24018765,24019171,406,0,0,1,2
24019170,24019179,9,1,0,0,1
24019172,24019189,17,1,0,0,2
24019180,24020208,1028,0,0,1,1
24019190,24020210,1020,0,0,1,2
24020209,24020277,68,1,0,0,1
24020211,24020288,77,1,0,0,2
24020278,24020406,128,0,0,1,1
24020289,24020393,104,0,0,1,2
24020394,24020752,358,1,0,0,2
24020407,24020621,214,1,0,0,1
24020425,24020603,178,0,1,0,2
24020431,24020541,110,0,1,0,1
24020622,24020716,94,0,0,1,1
24020717,24020735,18,1,0,0,1
24020736,24020962,226,0,0,1,1
24020753,24020958,205,0,0,1,2
24020959,24020977,18,1,0,0,2
24020963,24020977,14,1,0,0,1
24020978,24021571,593,0,0,1,2
24020978,24022279,1301,0,0,1,1
24021572,24021576,4,1,0,0,2
24021577,24022280,703,0,0,1,2
24022280,24022367,87,1,0,0,1
24022281,24022361,80,1,0,0,2
24022362,24022449,87,0,0,1,2
24022368,24022448,80,0,0,1,1
24022449,24022500,51,1,0,0,1
24022450,24022486,36,1,0,0,2
24022487,24022603,116,0,0,1,2
24022501,24022605,104,0,0,1,1
24022604,24022622,18,1,0,0,2
24022606,24022621,15,1,0,0,1
24022622,24023994,1372,0,0,1,1
24022623,24023992,1369,0,0,1,2
24023993,24024122,129,1,0,0,2
24023995,24024137,142,1,0,0,1
24024123,24024172,49,0,0,1,2
24024138,24024171,33,0,0,1,1
24024172,24024209,37,1,0,0,1
24024173,24024208,35,1,0,0,2
24024209,24024320,111,0,0,1,2
24024210,24024316,106,0,0,1,1
24024317,24024340,23,1,0,0,1
24024321,24024341,20,1,0,0,2
24024341,24025891,1550,0,0,1,1
24024342,24025891,1549,0,0,1,2
24025892,24025995,103,1,0,0,1
24025892,24025996,104,1,0,0,2
24025996,24026062,66,0,0,1,1
24025997,24026062,65,0,0,1,2
24026063,24026087,24,1,0,0,2
24026063,24026088,25,1,0,0,1
24026088,24026257,169,0,0,1,2
24026089,24027461,1372,0,0,1,1
24026258,24026267,9,1,0,0,2
24026268,24027460,1192,0,0,1,2
24027461,24027537,76,1,0,0,2
24027462,24027535,73,1,0,0,1
24027536,24027862,326,0,0,1,1
24027538,24027862,324,0,0,1,2
24027863,24027966,103,1,0,0,2
24027863,24028277,414,1,0,0,1
24027967,24028085,118,0,0,1,2
24028086,24028128,42,1,0,0,2
24028129,24029325,1196,0,0,1,2
24028278,24028384,106,0,0,1,1
24028385,24028644,259,1,0,0,1
24028645,24028900,255,0,0,1,1
24028901,24028944,43,1,0,0,1
24028945,24028997,52,0,0,1,1
24028998,24029058,60,1,0,0,1
24029059,24029122,63,0,0,1,1
24029123,24029193,70,1,0,0,1
24029194,24029317,123,0,0,1,1
24029318,24029399,81,1,0,0,1
24029326,24029380,54,1,0,0,2
24029381,24029592,211,0,0,1,2
24029400,24029590,190,0,0,1,1
24029591,24029637,46,1,0,0,1
24029593,24029637,44,1,0,0,2
24029638,24029807,169,0,0,1,2
24029638,24029808,170,0,0,1,1
24029808,24029912,104,1,0,0,2
24029809,24029873,64,1,0,0,1
24029874,24030022,148,0,0,1,1
24029913,24030018,105,0,0,1,2
24030019,24030035,16,1,0,0,2
24030023,24030055,32,1,0,0,1
24030036,24031074,1038,0,0,1,2
24030056,24030229,173,0,0,1,1
24030230,24030239,9,1,0,0,1
24030240,24031073,833,0,0,1,1
24031074,24031113,39,1,0,0,1
24031075,24031116,41,1,0,0,2
24031114,24031230,116,0,0,1,1
24031117,24031229,112,0,0,1,2
24031230,24031284,54,1,0,0,2
24031231,24031283,52,1,0,0,1
24031284,24031557,273,0,0,1,1
24031285,24031559,274,0,0,1,2
24031558,24031663,105,1,0,0,1
24031560,24031691,131,1,0,0,2
24031664,24032439,775,0,0,1,1
24031692,24031863,171,0,0,1,2
24031864,24031879,15,1,0,0,2
24031880,24031963,83,0,0,1,2
24031964,24032135,171,1,0,0,2
24032136,24032166,30,0,0,1,2
24032167,24032204,37,1,0,0,2
24032205,24032240,35,0,0,1,2
24032241,24032446,205,1,0,0,2
24032440,24032444,4,1,0,0,1
24032445,24032892,447,0,0,1,1
24032447,24032496,49,0,0,1,2
24032497,24032562,65,1,0,0,2
24032563,24032918,355,0,0,1,2
24032893,24032925,32,1,0,0,1
24032919,24032930,11,1,0,0,2
24032926,24033203,277,0,0,1,1
24032931,24033196,265,0,0,1,2
24033197,24033546,349,1,0,0,2
24033204,24033507,303,1,0,0,1
24033226,24033452,226,0,1,0,2
24033241,24033441,200,0,1,0,1
24033508,24033585,77,0,0,1,1
24033547,24033584,37,0,0,1,2
24033585,24033620,35,1,0,0,2
24033586,24033617,31,1,0,0,1
24033618,24033750,132,0,0,1,1
24033621,24033749,128,0,0,1,2
24033750,24033768,18,1,0,0,2
24033751,24033766,15,1,0,0,1
24033767,24035002,1235,0,0,1,1
24033769,24034253,484,0,0,1,2
24034254,24034263,9,1,0,0,2
24034264,24035004,740,0,0,1,2
24035003,24035130,127,1,0,0,1
24035005,24035129,124,1,0,0,2
24035130,24035393,263,0,0,1,2
24035131,24035392,261,0,0,1,1
24035393,24035451,58,1,0,0,1
24035394,24035465,71,1,0,0,2
24035452,24035592,140,0,0,1,1
24035466,24035592,126,0,0,1,2
24035593,24035609,16,1,0,0,2
24035593,24035611,18,1,0,0,1
24035610,24036989,1379,0,0,1,2
24035612,24035777,165,0,0,1,1
24035778,24035787,9,1,0,0,1
24035788,24036990,1202,0,0,1,1
24036990,24037031,41,1,0,0,2
24036991,24037032,41,1,0,0,1
24037032,24037449,417,0,0,1,2
24037033,24037449,416,0,0,1,1
24037450,24037519,69,1,0,0,1
24037450,24037522,72,1,0,0,2
24037520,24037765,245,0,0,1,1
24037523,24037757,234,0,0,1,2
24037758,24037775,17,1,0,0,2
24037766,24037773,7,1,0,0,1
24037774,24038780,1006,0,0,1,1
24037776,24038780,1004,0,0,1,2
24038781,24038860,79,1,0,0,1
24038781,24038861,80,1,0,0,2
24038861,24039301,440,0,0,1,1
24038862,24039303,441,0,0,1,2
24039302,24039375,73,1,0,0,1
24039304,24039365,61,1,0,0,2
24039366,24039472,106,0,0,1,2
24039376,24039474,98,0,0,1,1
24039473,24039496,23,1,0,0,2
24039475,24039497,22,1,0,0,1
24039497,24040618,1121,0,0,1,2
24039498,24040619,1121,0,0,1,1
24040619,24040687,68,1,0,0,2
24040620,24040686,66,1,0,0,1
24040687,24041078,391,0,0,1,1
24040688,24041078,390,0,0,1,2
24041079,24041156,77,1,0,0,1
24041079,24041160,81,1,0,0,2
24041157,24041231,74,0,0,1,1
24041161,24041234,73,0,0,1,2
24041232,24041278,46,1,0,0,1
24041235,24041379,144,1,0,0,2
24041279,24041438,159,0,0,1,1
24041380,24041427,47,0,0,1,2
24041428,24041531,103,1,0,0,2
24041439,24041448,9,1,0,0,1
24041449,24042248,799,0,0,1,1
24041532,24041690,158,0,0,1,2
24041691,24041791,100,1,0,0,2
24041792,24041986,194,0,0,1,2
24041987,24042012,25,1,0,0,2
24042013,24042079,66,0,0,1,2
24042080,24042115,35,1,0,0,2
24042116,24042171,55,0,0,1,2
24042172,24042367,195,1,0,0,2
24042249,24042313,64,1,0,0,1
24042263,24042269,6,0,1,0,2
24042314,24042653,339,0,0,1,1
24042368,24042654,286,0,0,1,2
24042654,24042706,52,1,0,0,1
24042655,24042705,50,1,0,0,2
24042706,24043068,362,0,0,1,2
24042707,24043069,362,0,0,1,1
24043069,24044457,1388,1,0,0,2
24043070,24043249,179,1,0,0,1
24043193,24044440,1247,0,1,0,2
24043250,24043307,57,0,0,1,1
24043308,24043420,112,1,0,0,1
24043421,24043479,58,0,0,1,1
24043480,24043504,24,1,0,0,1
24043505,24043696,191,0,0,1,1
24043697,24043779,82,1,0,0,1
24043780,24043827,47,0,0,1,1
24043828,24043889,61,1,0,0,1
24043890,24043910,20,0,0,1,1
24043911,24044100,189,1,0,0,1
24044101,24044294,193,0,0,1,1
24044295,24044461,166,1,0,0,1
24044458,24045004,546,0,0,1,2
24044462,24045002,540,0,0,1,1
24045003,24045174,171,1,0,0,1
24045005,24046248,1243,1,0,0,2
24045175,24045222,47,0,0,1,1
24045223,24045250,27,1,0,0,1
24045251,24046162,911,0,0,1,1
24046163,24046221,58,1,0,0,1
24046222,24046777,555,0,0,1,1
24046249,24046777,528,0,0,1,2
24046778,24046876,98,1,0,0,1
24046778,24046880,102,1,0,0,2
24046877,24047060,183,0,0,1,1
24046881,24047063,182,0,0,1,2
24047061,24047079,18,1,0,0,1
24047064,24047080,16,1,0,0,2
24047080,24048117,1037,0,0,1,1
24047081,24048118,1037,0,0,1,2
24048118,24048208,90,1,0,0,1
24048119,24048210,91,1,0,0,2
24048209,24048723,514,0,0,1,1
24048211,24048723,512,0,0,1,2
24048724,24048823,99,1,0,0,1
24048724,24048957,233,1,0,0,2
24048824,24048930,106,0,0,1,1
24048931,24048951,20,1,0,0,1
24048952,24049114,162,0,0,1,1
24048958,24049115,157,0,0,1,2
24049115,24049127,12,1,0,0,1
24049116,24049145,29,1,0,0,2
24049128,24050089,961,0,0,1,1
24049146,24049582,436,0,0,1,2
24049583,24049594,11,1,0,0,2
24049595,24050089,494,0,0,1,2
24050090,24050166,76,1,0,0,1
24050090,24050170,80,1,0,0,2
24050167,24050592,425,0,0,1,1
24050171,24050592,421,0,0,1,2
24050593,24050669,76,1,0,0,1
24050593,24050671,78,1,0,0,2
24050670,24050796,126,0,0,1,1
24050672,24050797,125,0,0,1,2
24050797,24050821,24,1,0,0,1
24050798,24050816,18,1,0,0,2
24050817,24052593,1776,0,0,1,2
24050822,24052594,1772,0,0,1,1
24052594,24052689,95,1,0,0,2
24052595,24052678,83,1,0,0,1
24052679,24052796,117,0,0,1,1
24052690,24052795,105,0,0,1,2
24052796,24052827,31,1,0,0,2
24052797,24052821,24,1,0,0,1
24052822,24054103,1281,0,0,1,1
24052828,24054100,1272,0,0,1,2
24054101,24054228,127,1,0,0,2
24054104,24054224,120,1,0,0,1
24054225,24054591,366,0,0,1,1
24054229,24054593,364,0,0,1,2
24054592,24054669,77,1,0,0,1
24054594,24054667,73,1,0,0,2
24054668,24054753,85,0,0,1,2
24054670,24054752,82,0,0,1,1
24054753,24054793,40,1,0,0,1
24054754,24054778,24,1,0,0,2
24054779,24056300,1521,0,0,1,2
24054794,24056302,1508,0,0,1,1
24056301,24056491,190,1,0,0,2
24056303,24056430,127,1,0,0,1
24056328,24056331,3,0,1,0,2
24056360,24056368,8,0,1,0,2
24056389,24056404,15,0,1,0,2
24056431,24056830,399,0,0,1,1
24056492,24056830,338,0,0,1,2
24056831,24056884,53,1,0,0,2
24056831,24056889,58,1,0,0,1
24056885,24056993,108,0,0,1,2
24056890,24056992,102,0,0,1,1
24056993,24057014,21,1,0,0,1
24056994,24057015,21,1,0,0,2
24057015,24057560,545,0,0,1,1
24057016,24057540,524,0,0,1,2
24057541,24057882,341,1,0,0,2
24057561,24057717,156,1,0,0,1
24057586,24057648,62,0,1,0,2
24057586,24057674,88,0,1,0,1
24057711,24057840,129,0,1,0,2
24057718,24058101,383,0,0,1,1
24057883,24057977,94,0,0,1,2
24057978,24058189,211,1,0,0,2
24058102,24058173,71,1,0,0,1
24058174,24058525,351,0,0,1,1
24058190,24058527,337,0,0,1,2
24058526,24058611,85,1,0,0,1
24058528,24058606,78,1,0,0,2
24058607,24058741,134,0,0,1,2
24058612,24058742,130,0,0,1,1
24058742,24058756,14,1,0,0,2
24058743,24058765,22,1,0,0,1
24058757,24059764,1007,0,0,1,2
24058766,24060813,2047,0,0,1,1
24059765,24059776,11,1,0,0,2
24059777,24060813,1036,0,0,1,2
24060814,24060904,90,1,0,0,2
24060814,24060906,92,1,0,0,1
24060905,24061014,109,0,0,1,2
24060907,24061017,110,0,0,1,1
24061015,24061034,19,1,0,0,2
24061018,24061036,18,1,0,0,1
24061035,24061083,48,0,0,1,2
24061037,24061087,50,0,0,1,1
24061084,24061376,292,1,0,0,2
24061088,24061458,370,1,0,0,1
24061112,24061303,191,0,1,0,2
24061115,24061277,162,0,1,0,1
24061377,24061438,61,0,0,1,2
24061439,24061452,13,1,0,0,2
24061453,24063582,2129,0,0,1,2
24061459,24063580,2121,0,0,1,1
24063581,24063615,34,1,0,0,1
24063583,24063613,30,1,0,0,2
24063614,24063963,349,0,0,1,2
24063616,24063961,345,0,0,1,1
24063962,24064048,86,1,0,0,1
24063964,24064047,83,1,0,0,2
24064048,24064183,135,0,0,1,2
24064049,24064179,130,0,0,1,1
24064180,24064229,49,1,0,0,1
24064184,24064228,44,1,0,0,2
24064229,24065246,1017,0,0,1,2
24064230,24064688,458,0,0,1,1
24064689,24064708,19,1,0,0,1
24064709,24065101,392,0,0,1,1
24065102,24065109,7,1,0,0,1
24065110,24065314,204,0,0,1,1
24065247,24065847,600,1,0,0,2
24065315,24065372,57,1,0,0,1
24065373,24065414,41,0,0,1,1
24065415,24065636,221,1,0,0,1
24065637,24065679,42,0,0,1,1
24065680,24065750,70,1,0,0,1
24065692,24065741,49,0,1,0,2
24065751,24066115,364,0,0,1,1
24065848,24065877,29,0,0,1,2
24065878,24066411,533,1,0,0,2
24066116,24066252,136,1,0,0,1
24066253,24066600,347,0,0,1,1
24066265,24066358,93,0,1,0,2
24066382,24066401,19,0,1,0,2
24066412,24066602,190,0,0,1,2
24066601,24066703,102,1,0,0,1
24066603,24066704,101,1,0,0,2
24066704,24066775,71,0,0,1,1
24066705,24066777,72,0,0,1,2
24066776,24066825,49,1,0,0,1
24066778,24066808,30,1,0,0,2
24066809,24066990,181,0,0,1,2
24066826,24066855,29,0,0,1,1
24066856,24066875,19,1,0,0,1
24066876,24068760,1884,0,0,1,1
24066991,24066996,5,1,0,0,2
24066997,24068761,1764,0,0,1,2
24068761,24068816,55,1,0,0,1
24068762,24068812,50,1,0,0,2
24068813,24068935,122,0,0,1,2
24068817,24068933,116,0,0,1,1
24068934,24068956,22,1,0,0,1
24068936,24068957,21,1,0,0,2
24068957,24070692,1735,0,0,1,1
24068958,24070692,1734,0,0,1,2
24070693,24070752,59,1,0,0,1
24070693,24070752,59,1,0,0,2
24070753,24070936,183,0,0,1,2
24070753,24070950,197,0,0,1,1
24070937,24071072,135,1,0,0,2
24070951,24071036,85,1,0,0,1
24071037,24071469,432,0,0,1,1
24071073,24072634,1561,0,0,1,2
24071470,24071475,5,1,0,0,1
24071476,24072633,1157,0,0,1,1
24072634,24072717,83,1,0,0,1
24072635,24072713,78,1,0,0,2
24072714,24072807,93,0,0,1,2
24072718,24072805,87,0,0,1,1
24072806,24072844,38,1,0,0,1
24072808,24072828,20,1,0,0,2
24072829,24073446,617,0,0,1,2
24072845,24074158,1313,0,0,1,1
24073447,24073493,46,1,0,0,2
24073494,24073694,200,0,0,1,2
24073695,24073709,14,1,0,0,2
24073710,24074159,449,0,0,1,2
24074159,24074179,20,1,0,0,1
24074160,24074178,18,1,0,0,2
24074179,24074581,402,0,0,1,2
24074180,24074579,399,0,0,1,1
24074580,24074700,120,1,0,0,1
24074582,24074688,106,1,0,0,2
24074689,24076545,1856,0,0,1,2
24074701,24076546,1845,0,0,1,1
24076546,24076635,89,1,0,0,2
24076547,24076665,118,1,0,0,1
24076636,24076782,146,0,0,1,2
24076666,24076780,114,0,0,1,1
24076781,24076876,95,1,0,0,1
24076783,24076800,17,1,0,0,2
24076801,24077088,287,0,0,1,2
24076877,24077030,153,0,0,1,1
24077031,24077118,87,1,0,0,1
24077089,24077107,18,1,0,0,2
24077108,24078039,931,0,0,1,2
24077119,24077176,57,0,0,1,1
24077177,24077212,35,1,0,0,1
24077213,24077277,64,0,0,1,1
24077278,24077312,34,1,0,0,1
24077313,24077451,138,0,0,1,1
24077452,24077504,52,1,0,0,1
24077505,24077945,440,0,0,1,1
24077946,24078094,148,1,0,0,1
24078040,24078091,51,1,0,0,2
24078092,24079844,1752,0,0,1,2
24078095,24078277,182,0,0,1,1
24078278,24078282,4,1,0,0,1
24078283,24079844,1561,0,0,1,1
24079845,24079922,77,1,0,0,1
24079845,24079928,83,1,0,0,2
24079923,24080039,116,0,0,1,1
24079929,24080039,110,0,0,1,2
24080040,24080060,20,1,0,0,2
24080040,24080065,25,1,0,0,1
24080061,24081709,1648,0,0,1,2
24080066,24081711,1645,0,0,1,1
24081710,24081796,86,1,0,0,2
24081712,24081793,81,1,0,0,1
24081794,24081879,85,0,0,1,1
24081797,24081880,83,0,0,1,2
24081880,24081904,24,1,0,0,1
24081881,24081906,25,1,0,0,2
24081905,24083045,1140,0,0,1,1
24081907,24083047,1140,0,0,1,2
24083046,24083107,61,1,0,0,1
24083048,24083109,61,1,0,0,2
24083108,24083666,558,0,0,1,1
24083110,24083667,557,0,0,1,2
24083667,24083724,57,1,0,0,1
24083668,24083729,61,1,0,0,2
24083725,24083816,91,0,0,1,1
24083730,24083815,85,0,0,1,2
24083816,24083845,29,1,0,0,2
24083817,24083844,27,1,0,0,1
24083845,24084087,242,0,0,1,1
24083846,24085125,1279,0,0,1,2
24084088,24084097,9,1,0,0,1
24084098,24085123,1025,0,0,1,1
24085124,24085189,65,1,0,0,1
24085126,24085188,62,1,0,0,2
24085189,24085574,385,0,0,1,2
24085190,24085576,386,0,0,1,1
24085575,24085615,40,1,0,0,2
24085577,24085615,38,1,0,0,1
24085616,24085719,103,0,0,1,1
24085616,24085719,103,0,0,1,2
24085720,24085735,15,1,0,0,2
24085720,24085737,17,1,0,0,1
24085736,24087309,1573,0,0,1,2
24085738,24087309,1571,0,0,1,1
24087310,24087469,159,1,0,0,2
24087310,24088052,742,1,0,0,1
24087470,24087513,43,0,0,1,2
24087514,24087521,7,1,0,0,2
24087522,24087580,58,0,0,1,2
24087581,24087619,38,1,0,0,2
24087620,24088196,576,0,0,1,2
24088053,24088121,68,0,0,1,1
24088122,24088313,191,1,0,0,1
24088197,24088220,23,1,0,0,2
24088221,24088399,178,0,0,1,2
24088314,24088363,49,0,0,1,1
24088364,24088440,76,1,0,0,1
24088400,24088425,25,1,0,0,2
24088426,24088729,303,0,0,1,2
24088441,24088534,93,0,0,1,1
24088535,24088766,231,1,0,0,1
24088730,24088835,105,1,0,0,2
24088767,24088796,29,0,0,1,1
24088797,24088842,45,1,0,0,1
24088836,24088874,38,0,0,1,2
24088843,24088912,69,0,0,1,1
24088875,24088884,9,1,0,0,2
24088885,24088995,110,0,0,1,2
24088913,24089161,248,1,0,0,1
24088996,24089073,77,1,0,0,2
24089074,24089316,242,0,0,1,2
24089162,24089237,75,0,0,1,1
24089238,24089251,13,1,0,0,1
24089252,24089296,44,0,0,1,1
24089297,24089326,29,1,0,0,1
24089317,24089422,105,1,0,0,2
24089327,24089449,122,0,0,1,1
24089423,24089679,256,0,0,1,2
24089450,24089503,53,1,0,0,1
24089504,24089586,82,0,0,1,1
24089587,24089591,4,1,0,0,1
24089592,24089692,100,0,0,1,1
24089680,24089803,123,1,0,0,2
24089693,24089806,113,1,0,0,1
24089804,24089938,134,0,0,1,2
24089807,24089937,130,0,0,1,1
24089938,24089963,25,1,0,0,1
24089939,24089962,23,1,0,0,2
24089963,24090153,190,0,0,1,2
24089964,24090336,372,0,0,1,1
24090154,24090162,8,1,0,0,2
24090163,24090329,166,0,0,1,2
24090330,24090343,13,1,0,0,2
24090337,24090350,13,1,0,0,1
24090344,24091064,720,0,0,1,2
24090351,24091063,712,0,0,1,1
24091064,24091082,18,1,0,0,1
24091065,24091082,17,1,0,0,2
24091083,24091572,489,0,0,1,1
24091083,24091575,492,0,0,1,2
24091573,24091735,162,1,0,0,1
24091576,24091706,130,1,0,0,2
24091707,24091805,98,0,0,1,2
24091736,24091845,109,0,0,1,1
24091816,24091916,100,0,1,0,2
24091846,24091880,34,1,0,0,1
24091881,24091931,50,0,0,1,1
24091926,24091944,18,1,0,0,2
24091932,24091989,57,1,0,0,1
24091945,24091973,28,0,0,1,2
24091984,24092029,45,0,1,0,2
24091990,24092481,491,0,0,1,1
24092039,24092041,2,1,0,0,2
24092042,24092112,70,0,0,1,2
24092123,24092130,7,0,1,0,2
24092140,24092336,196,1,0,0,2
24092160,24092327,167,0,1,0,2
24092337,24092370,33,0,0,1,2
24092381,24092428,47,0,1,0,2
24092438,24093144,706,1,0,0,2
24092466,24092881,415,0,1,0,2
24092482,24092522,40,1,0,0,1
24092523,24092696,173,0,0,1,1
24092697,24092970,273,1,0,0,1
24092906,24092908,2,0,1,0,2
24092971,24093048,77,0,0,1,1
24093049,24093123,74,1,0,0,1
24093124,24093618,494,0,0,1,1
24093145,24093622,477,0,0,1,2
24093619,24093721,102,1,0,0,1
24093623,24095129,1506,1,0,0,2
24093701,24095100,1399,0,1,0,2
24093722,24093870,148,0,0,1,1
24093871,24093946,75,1,0,0,1
24093947,24094388,441,0,0,1,1
24094389,24094424,35,1,0,0,1
24094425,24094614,189,0,0,1,1
24094615,24094657,42,1,0,0,1
24094658,24094723,65,0,0,1,1
24094724,24094840,116,1,0,0,1
24094841,24095020,179,0,0,1,1
24095021,24095104,83,1,0,0,1
24095105,24095532,427,0,0,1,1
24095130,24095531,401,0,0,1,2
24095532,24095625,93,1,0,0,2
24095533,24095630,97,1,0,0,1
24095626,24095811,185,0,0,1,2
24095631,24095810,179,0,0,1,1
24095811,24095829,18,1,0,0,1
24095812,24095833,21,1,0,0,2
24095830,24097134,1304,0,0,1,1
24095834,24097132,1298,0,0,1,2
24097133,24097185,52,1,0,0,2
24097135,24097184,49,1,0,0,1
24097185,24097448,263,0,0,1,1
24097186,24097450,264,0,0,1,2
24097449,24097510,61,1,0,0,1
24097451,24097512,61,1,0,0,2
24097511,24097630,119,0,0,1,1
24097513,24097630,117,0,0,1,2
24097631,24097650,19,1,0,0,2
24097631,24097651,20,1,0,0,1
24097651,24098544,893,0,0,1,2
24097652,24097814,162,0,0,1,1
24097815,24097825,10,1,0,0,1
24097826,24098540,714,0,0,1,1
24098541,24098551,10,1,0,0,1
24098545,24098549,4,1,0,0,2
24098550,24099610,1060,0,0,1,2
24098552,24099610,1058,0,0,1,1
24099611,24099693,82,1,0,0,2
24099611,24099704,93,1,0,0,1
24099694,24099838,144,0,0,1,2
24099705,24099836,131,0,0,1,1
24099837,24099856,19,1,0,0,1
24099839,24099856,17,1,0,0,2
24099857,24101092,1235,0,0,1,1
24099857,24101092,1235,0,0,1,2
24101093,24101138,45,1,0,0,1
24101093,24101138,45,1,0,0,2
24101139,24101529,390,0,0,1,1
24101139,24101530,391,0,0,1,2
24101530,24101645,115,1,0,0,1
24101531,24101665,134,1,0,0,2
24101646,24101721,75,0,0,1,1
24101666,24101715,49,0,0,1,2
24101716,24101983,267,1,0,0,2
24101722,24101924,202,1,0,0,1
24101750,24101915,165,0,1,0,2
24101925,24102729,804,0,0,1,1
24101984,24102060,76,0,0,1,2
24102061,24102583,522,1,0,0,2
24102086,24102095,9,0,1,0,2
24102116,24102153,37,0,1,0,2
24102310,24102311,1,0,1,0,2
24102584,24102679,95,0,0,1,2
24102680,24102944,264,1,0,0,2
24102730,24102734,4,1,0,0,1
24102735,24102862,127,0,0,1,1
24102863,24102879,16,1,0,0,1
24102880,24102957,77,0,0,1,1
24102945,24102980,35,0,0,1,2
24102958,24102978,20,1,0,0,1
24102979,24103131,152,0,0,1,1
24102981,24103475,494,1,0,0,2
24103033,24103034,1,0,1,0,2
24103132,24103148,16,1,0,0,1
24103149,24103208,59,0,0,1,1
24103209,24103247,38,1,0,0,1
24103248,24103352,104,0,0,1,1
24103353,24103425,72,1,0,0,1
24103369,24103394,25,0,1,0,2
24103426,24103995,569,0,0,1,1
24103476,24103585,109,0,0,1,2
24103586,24103590,4,1,0,0,2
24103591,24103965,374,0,0,1,2
24103966,24105787,1821,1,0,0,2
24103996,24104143,147,1,0,0,1
24104108,24104109,1,0,1,0,2
24104144,24104179,35,0,0,1,1
24104180,24104392,212,1,0,0,1
24104204,24105668,1464,0,1,0,2
24104393,24105017,624,0,0,1,1
24105018,24105162,144,1,0,0,1
24105163,24105282,119,0,0,1,1
24105283,24105459,176,1,0,0,1
24105460,24105517,57,0,0,1,1
24105518,24105714,196,1,0,0,1
24105715,24106288,573,0,0,1,1
24105788,24106289,501,0,0,1,2
24106289,24106340,51,1,0,0,1
24106290,24106339,49,1,0,0,2
24106340,24106456,116,0,0,1,2
24106341,24106457,116,0,0,1,1
24106457,24106485,28,1,0,0,2
24106458,24106477,19,1,0,0,1
24106478,24108037,1559,0,0,1,1
24106486,24107770,1284,0,0,1,2
24107771,24108000,229,1,0,0,2
24108001,24108037,36,0,0,1,2
24108038,24108104,66,1,0,0,2
24108038,24108107,69,1,0,0,1
24108105,24110158,2053,0,0,1,2
24108108,24110156,2048,0,0,1,1
24110157,24110241,84,1,0,0,1
24110159,24110251,92,1,0,0,2
24110242,24110775,533,0,0,1,1
24110252,24110775,523,0,0,1,2
24110776,24110815,39,1,0,0,1
24110776,24110815,39,1,0,0,2
24110816,24111257,441,0,0,1,1
24110816,24111259,443,0,0,1,2
24111258,24111291,33,1,0,0,1
24111260,24111297,37,1,0,0,2
24111292,24112817,1525,0,0,1,1
24111298,24112816,1518,0,0,1,2
24112817,24112828,11,1,0,0,2
24112818,24112829,11,1,0,0,1
24112829,24113453,624,0,0,1,2
24112830,24113453,623,0,0,1,1
24113454,24113460,6,1,0,0,2
24113454,24113463,9,1,0,0,1
24113461,24114745,1284,0,0,1,2
24113464,24114746,1282,0,0,1,1
24114746,24114806,60,1,0,0,2
24114747,24114786,39,1,0,0,1
24114787,24116109,1322,0,0,1,1
24114807,24115184,377,0,0,1,2
24115185,24115269,84,1,0,0,2
24115270,24116122,852,0,0,1,2
24116110,24116136,26,1,0,0,1
24116123,24116135,12,1,0,0,2
24116136,24116866,730,0,0,1,2
24116137,24116867,730,0,0,1,1
24116867,24116933,66,1,0,0,2
24116868,24116923,55,1,0,0,1
24116924,24117496,572,0,0,1,1
24116934,24117496,562,0,0,1,2
24117497,24117537,40,1,0,0,1
24117497,24117537,40,1,0,0,2
24117538,24117764,226,0,0,1,1
24117538,24117764,226,0,0,1,2
24117765,24117823,58,1,0,0,1
24117765,24117823,58,1,0,0,2
24117824,24118051,227,0,0,1,2
24117824,24118052,228,0,0,1,1
24118052,24118120,68,1,0,0,2
24118053,24118101,48,1,0,0,1
24118102,24118213,111,0,0,1,1
24118121,24118214,93,0,0,1,2
24118214,24118248,34,1,0,0,1
24118215,24118241,26,1,0,0,2
24118242,24118727,485,0,0,1,2
24118249,24120540,2291,0,0,1,1
24118728,24118732,4,1,0,0,2
24118733,24120540,1807,0,0,1,2
24120541,24120586,45,1,0,0,1
24120541,24120586,45,1,0,0,2
24120587,24120947,360,0,0,1,2
24120587,24120956,369,0,0,1,1
24120948,24121235,287,1,0,0,2
24120957,24121199,242,1,0,0,1
24120979,24121157,178,0,1,0,2
24120993,24121110,117,0,1,0,1
24121200,24121952,752,0,0,1,1
24121236,24121952,716,0,0,1,2
24121953,24121976,23,1,0,0,1
24121953,24121986,33,1,0,0,2
24121977,24122688,711,0,0,1,1
24121987,24122692,705,0,0,1,2
24122689,24122962,273,1,0,0,1
24122693,24123012,319,1,0,0,2
24122725,24122916,191,0,1,0,2
24122738,24122898,160,0,1,0,1
24122963,24124406,1443,0,0,1,1
24123013,24124408,1395,0,0,1,2
24124407,24124466,59,1,0,0,1
24124409,24124480,71,1,0,0,2
24124467,24124587,120,0,0,1,1
24124481,24124574,93,0,0,1,2
24124575,24124986,411,1,0,0,2
24124588,24124931,343,1,0,0,1
24124613,24124857,244,0,1,0,2
24124616,24124842,226,0,1,0,1
24124932,24126107,1175,0,0,1,1
24124987,24126391,1404,0,0,1,2
24126108,24126118,10,1,0,0,1
24126119,24126392,273,0,0,1,1
24126392,24126462,70,1,0,0,2
24126393,24126459,66,1,0,0,1
24126460,24128395,1935,0,0,1,1
24126463,24128387,1924,0,0,1,2
24128388,24128809,421,1,0,0,2
24128396,24128721,325,1,0,0,1
24128430,24128662,232,0,1,0,2
24128440,24128667,227,0,1,0,1
24128722,24129451,729,0,0,1,1
24128810,24129450,640,0,0,1,2
24129451,24129491,40,1,0,0,2
24129452,24129490,38,1,0,0,1
24129491,24129603,112,0,0,1,1
24129492,24129603,111,0,0,1,2
24129604,24129656,52,1,0,0,2
24129604,24129670,66,1,0,0,1
24129657,24129761,104,0,0,1,2
24129671,24129759,88,0,0,1,1
24129760,24129787,27,1,0,0,1
24129762,24129785,23,1,0,0,2
24129786,24131569,1783,0,0,1,2
24129788,24130966,1178,0,0,1,1
24130967,24130975,8,1,0,0,1
24130976,24131573,597,0,0,1,1
24131570,24131587,17,1,0,0,2
24131574,24131585,11,1,0,0,1
24131586,24133445,1859,0,0,1,1
24131588,24133447,1859,0,0,1,2
24133446,24133488,42,1,0,0,1
24133448,24133487,39,1,0,0,2
24133488,24133621,133,0,0,1,2
24133489,24133625,136,0,0,1,1
24133622,24133939,317,1,0,0,2
24133626,24133903,277,1,0,0,1
24133651,24133818,167,0,1,0,2
24133655,24133799,144,0,1,0,1
24133904,24135730,1826,0,0,1,1
24133940,24135728,1788,0,0,1,2
24135729,24135776,47,1,0,0,2
24135731,24135774,43,1,0,0,1
24135775,24136883,1108,0,0,1,1
24135777,24136885,1108,0,0,1,2
24136884,24136924,40,1,0,0,1
24136886,24136923,37,1,0,0,2
24136924,24137121,197,0,0,1,2
24136925,24137120,195,0,0,1,1
24137121,24137226,105,1,0,0,1
24137122,24137239,117,1,0,0,2
24137227,24137313,86,0,0,1,1
24137240,24137314,74,0,0,1,2
24137314,24137334,20,1,0,0,1
24137315,24137390,75,1,0,0,2
24137335,24137504,169,0,0,1,1
24137391,24137440,49,0,0,1,2
24137441,24137706,265,1,0,0,2
24137505,24137533,28,1,0,0,1
24137534,24138478,944,0,0,1,1
24137707,24137815,108,0,0,1,2
24137816,24137833,17,1,0,0,2
24137834,24138171,337,0,0,1,2
24138172,24138237,65,1,0,0,2
24138238,24138315,77,0,0,1,2
24138316,24139028,712,1,0,0,2
24138479,24138492,13,1,0,0,1
24138493,24138891,398,0,0,1,1
24138892,24138918,26,1,0,0,1
24138919,24138958,39,0,0,1,1
24138959,24139013,54,1,0,0,1
24139014,24141149,2135,0,0,1,1
24139029,24141149,2120,0,0,1,2
24141150,24141455,305,1,0,0,1
24141150,24141517,367,1,0,0,2
24141202,24141362,160,0,1,0,2
24141210,24141323,113,0,1,0,1
24141456,24141922,466,0,0,1,1
24141518,24141922,404,0,0,1,2
24141923,24141972,49,1,0,0,1
24141923,24141978,55,1,0,0,2
24141973,24142249,276,0,0,1,1
24141979,24142247,268,0,0,1,2
24142248,24142299,51,1,0,0,2
24142250,24142298,48,1,0,0,1
24142299,24142587,288,0,0,1,1
24142300,24142585,285,0,0,1,2
24142586,24142633,47,1,0,0,2
24142588,24142638,50,1,0,0,1
24142634,24142762,128,0,0,1,2
24142639,24142763,124,0,0,1,1
24142763,24142785,22,1,0,0,2
24142764,24142788,24,1,0,0,1
24142786,24144241,1455,0,0,1,2
24142789,24144242,1453,0,0,1,1
24144242,24144291,49,1,0,0,2
24144243,24144311,68,1,0,0,1
24144292,24145851,1559,0,0,1,2
24144312,24146195,1883,0,0,1,1
24145852,24146122,270,1,0,0,2
24146123,24146148,25,0,0,1,2
24146149,24146261,112,1,0,0,2
24146196,24146261,65,1,0,0,1
24146262,24146696,434,0,0,1,1
24146262,24146696,434,0,0,1,2
24146697,24146755,58,1,0,0,1
24146697,24146773,76,1,0,0,2
24146756,24147663,907,0,0,1,1
24146774,24147660,886,0,0,1,2
24147661,24147735,74,1,0,0,2
24147664,24147741,77,1,0,0,1
24147736,24147856,120,0,0,1,2
24147742,24147860,118,0,0,1,1
24147857,24147877,20,1,0,0,2
24147861,24147890,29,1,0,0,1
24147878,24148027,149,0,0,1,2
24147891,24148441,550,0,0,1,1
24148028,24148037,9,1,0,0,2
24148038,24148448,410,0,0,1,2
24148442,24148459,17,1,0,0,1
24148449,24148459,10,1,0,0,2
24148460,24148798,338,0,0,1,2
24148460,24150098,1638,0,0,1,1
24148799,24148808,9,1,0,0,2
24148809,24150097,1288,0,0,1,2
24150098,24150144,46,1,0,0,2
24150099,24150140,41,1,0,0,1
24150141,24150308,167,0,0,1,1
24150145,24150309,164,0,0,1,2
24150309,24150326,17,1,0,0,1
24150310,24150326,16,1,0,0,2
24150327,24150619,292,0,0,1,1
24150327,24150620,293,0,0,1,2
24150620,24150649,29,1,0,0,1
24150621,24150642,21,1,0,0,2
24150643,24152061,1418,0,0,1,2
24150650,24152070,1420,0,0,1,1
24152062,24152317,255,1,0,0,2
24152071,24152255,184,1,0,0,1
24152117,24152185,68,0,1,0,2
24152146,24152160,14,0,1,0,1
24152256,24153372,1116,0,0,1,1
24152318,24153373,1055,0,0,1,2
24153373,24153426,53,1,0,0,1
24153374,24153428,54,1,0,0,2
24153427,24153879,452,0,0,1,1
24153429,24153879,450,0,0,1,2
24153880,24153943,63,1,0,0,1
24153880,24153944,64,1,0,0,2
24153944,24154041,97,0,0,1,1
24153945,24154041,96,0,0,1,2
24154042,24154070,28,1,0,0,1
24154042,24154081,39,1,0,0,2
24154071,24154238,167,0,0,1,1
24154082,24154235,153,0,0,1,2
24154236,24154250,14,1,0,0,2
24154239,24154244,5,1,0,0,1
24154245,24155124,879,0,0,1,1
24154251,24155124,873,0,0,1,2
24155125,24155133,8,1,0,0,1
24155125,24155133,8,1,0,0,2
24155134,24156577,1443,0,0,1,1
24155134,24156579,1445,0,0,1,2
24156578,24156618,40,1,0,0,1
24156580,24156626,46,1,0,0,2
24156619,24157147,528,0,0,1,1
24156627,24157146,519,0,0,1,2
24157147,24157167,20,1,0,0,2
24157148,24157165,17,1,0,0,1
24157166,24158578,1412,0,0,1,1
24157168,24158580,1412,0,0,1,2
24158579,24158666,87,1,0,0,1
24158581,24158669,88,1,0,0,2
24158667,24159388,721,0,0,1,1
24158670,24159389,719,0,0,1,2
24159389,24159423,34,1,0,0,1
24159390,24159424,34,1,0,0,2
24159424,24160307,883,0,0,1,1
24159425,24160306,881,0,0,1,2
24160307,24160405,98,1,0,0,2
24160308,24160408,100,1,0,0,1
24160406,24160509,103,0,0,1,2
24160409,24160511,102,0,0,1,1
24160510,24160556,46,1,0,0,2
24160512,24160550,38,1,0,0,1
24160551,24160685,134,0,0,1,1
24160557,24160683,126,0,0,1,2
24160684,24160711,27,1,0,0,2
24160686,24160711,25,1,0,0,1
24160712,24160853,141,0,0,1,1
24160712,24161818,1106,0,0,1,2
24160854,24160872,18,1,0,0,1
24160873,24161813,940,0,0,1,1
24161814,24161830,16,1,0,0,1
24161819,24161830,11,1,0,0,2
24161831,24162003,172,0,0,1,1
24161831,24162008,177,0,0,1,2
24162004,24162021,17,1,0,0,1
24162009,24162014,5,1,0,0,2
24162015,24162509,494,0,0,1,2
24162022,24162420,398,0,0,1,1
24162421,24162563,142,1,0,0,1
24162510,24162567,57,1,0,0,2
24162564,24164669,2105,0,0,1,1
24162568,24163526,958,0,0,1,2
24163527,24163534,7,1,0,0,2
24163535,24164673,1138,0,0,1,2
24164670,24164686,16,1,0,0,1
24164674,24164709,35,1,0,0,2
24164687,24164840,153,0,0,1,1
24164710,24164841,131,0,0,1,2
24164841,24164896,55,1,0,0,1
24164842,24164910,68,1,0,0,2
24164897,24165125,228,0,0,1,1
24164911,24165126,215,0,0,1,2
24165126,24165192,66,1,0,0,1
24165127,24165173,46,1,0,0,2
24165174,24166595,1421,0,0,1,2
24165193,24166595,1402,0,0,1,1
24166596,24166649,53,1,0,0,1
24166596,24166678,82,1,0,0,2
24166650,24166952,302,0,0,1,1
24166679,24166786,107,0,0,1,2
24166787,24166796,9,1,0,0,2
24166797,24168873,2076,0,0,1,2
24166953,24166970,17,1,0,0,1
24166971,24167741,770,0,0,1,1
24167742,24167746,4,1,0,0,1
24167747,24168874,1127,0,0,1,1
24168874,24168911,37,1,0,0,2
24168875,24168910,35,1,0,0,1
24168911,24170829,1918,0,0,1,1
24168912,24170830,1918,0,0,1,2
24170830,24170885,55,1,0,0,1
24170831,24170888,57,1,0,0,2
24170886,24172236,1350,0,0,1,1
24170889,24172236,1347,0,0,1,2
24172237,24172331,94,1,0,0,1
24172237,24172642,405,1,0,0,2
24172332,24172475,143,0,0,1,1
24172476,24172499,23,1,0,0,1
24172500,24172857,357,0,0,1,1
24172643,24172686,43,0,0,1,2
24172687,24172739,52,1,0,0,2
24172740,24173075,335,0,0,1,2
24172858,24173119,261,1,0,0,1
24173076,24173084,8,1,0,0,2
24173085,24173842,757,0,0,1,2
24173120,24173279,159,0,0,1,1
24173280,24173296,16,1,0,0,1
24173297,24173350,53,0,0,1,1
24173351,24173459,108,1,0,0,1
24173460,24173842,382,0,0,1,1
24173843,24173893,50,1,0,0,1
24173843,24173927,84,1,0,0,2
24173894,24174262,368,0,0,1,1
24173928,24174264,336,0,0,1,2
24174263,24174301,38,1,0,0,1
24174265,24174287,22,1,0,0,2
24174288,24175815,1527,0,0,1,2
24174302,24175828,1526,0,0,1,1
24175816,24176133,317,1,0,0,2
24175829,24176098,269,1,0,0,1
24175903,24176010,107,0,1,0,2
24175923,24176030,107,0,1,0,1
24176041,24176050,9,0,1,0,2
24176099,24177407,1308,0,0,1,1
24176134,24177405,1271,0,0,1,2
24177406,24177453,47,1,0,0,2
24177408,24177461,53,1,0,0,1
24177454,24177577,123,0,0,1,2
24177462,24177577,115,0,0,1,1
24177578,24177604,26,1,0,0,1
24177578,24177607,29,1,0,0,2
24177605,24178470,865,0,0,1,1
24177608,24177757,149,0,0,1,2
24177758,24177783,25,1,0,0,2
24177784,24178145,361,0,0,1,2
24178146,24178161,15,1,0,0,2
24178162,24178998,836,0,0,1,2
24178471,24178481,10,1,0,0,1
24178482,24179000,518,0,0,1,1
24178999,24179057,58,1,0,0,2
24179001,24179061,60,1,0,0,1
24179058,24181622,2564,0,0,1,2
24179062,24181618,2556,0,0,1,1
24181619,24181676,57,1,0,0,1
24181623,24181676,53,1,0,0,2
24181677,24182487,810,0,0,1,2
24181677,24182488,811,0,0,1,1
24182488,24182553,65,1,0,0,2
24182489,24182535,46,1,0,0,1
24182536,24182651,115,0,0,1,1
24182554,24182653,99,0,0,1,2
24182652,24182678,26,1,0,0,1
24182654,24182676,22,1,0,0,2
24182677,24182936,259,0,0,1,2
24182679,24182844,165,0,0,1,1
24182845,24182849,4,1,0,0,1
24182850,24182949,99,0,0,1,1
24182937,24183150,213,1,0,0,2
24182950,24183111,161,1,0,0,1
24182974,24183050,76,0,1,0,2
24182985,24182987,2,0,1,0,1
24183112,24183247,135,0,0,1,1
24183151,24183248,97,0,0,1,2
24183248,24183258,10,1,0,0,1
24183249,24183259,10,1,0,0,2
24183259,24184461,1202,0,0,1,1
24183260,24184461,1201,0,0,1,2
24184462,24184507,45,1,0,0,1
24184462,24184507,45,1,0,0,2
24184508,24186514,2006,0,0,1,1
24184508,24186514,2006,0,0,1,2
24186515,24186650,135,1,0,0,1
24186515,24186679,164,1,0,0,2
24186651,24187263,612,0,0,1,1
24186680,24187264,584,0,0,1,2
24187264,24187310,46,1,0,0,1
24187265,24187310,45,1,0,0,2
24187311,24188479,1168,0,0,1,1
24187311,24188481,1170,0,0,1,2
24188480,24188641,161,1,0,0,1
24188482,24188745,263,1,0,0,2
24188623,24188636,13,0,1,0,2
24188642,24188862,220,0,0,1,1
24188746,24189030,284,0,0,1,2
24188863,24188885,22,1,0,0,1
24188886,24190409,1523,0,0,1,1
24189031,24189045,14,1,0,0,2
24189046,24189212,166,0,0,1,2
24189213,24190491,1278,1,0,0,2
24189603,24189652,49,0,1,0,2
24189763,24190422,659,0,1,0,2
24190410,24190465,55,1,0,0,1
24190466,24190767,301,0,0,1,1
24190492,24190534,42,0,0,1,2
24190535,24190726,191,1,0,0,2
24190727,24190772,45,0,0,1,2
24190768,24190777,9,1,0,0,1
24190773,24190846,73,1,0,0,2
24190778,24192000,1222,0,0,1,1
24190847,24191225,378,0,0,1,2
24191226,24191240,14,1,0,0,2
24191241,24191353,112,0,0,1,2
24191354,24191387,33,1,0,0,2
24191388,24191874,486,0,0,1,2
24191875,24191904,29,1,0,0,2
24191905,24192031,126,0,0,1,2
24192001,24192015,14,1,0,0,1
24192016,24192446,430,0,0,1,1
24192032,24192137,105,1,0,0,2
24192138,24192423,285,0,0,1,2
24192424,24193006,582,1,0,0,2
24192447,24192464,17,1,0,0,1
24192465,24192566,101,0,0,1,1
24192567,24192571,4,1,0,0,1
24192572,24192646,74,0,0,1,1
24192647,24192981,334,1,0,0,1
24192674,24192903,229,0,1,0,2
24192684,24192892,208,0,1,0,1
24192982,24193469,487,0,0,1,1
24193007,24193469,462,0,0,1,2
24193470,24193524,54,1,0,0,2
24193470,24193543,73,1,0,0,1
24193525,24194091,566,0,0,1,2
24193544,24194092,548,0,0,1,1
24194092,24194132,40,1,0,0,2
24194093,24194133,40,1,0,0,1
24194133,24194442,309,0,0,1,2
24194134,24194442,308,0,0,1,1
24194443,24194523,80,1,0,0,1
24194443,24194525,82,1,0,0,2
24194524,24194614,90,0,0,1,1
24194526,24194616,90,0,0,1,2
24194615,24194663,48,1,0,0,1
24194617,24196073,1456,1,0,0,2
24194664,24194827,163,0,0,1,1
24194828,24194844,16,1,0,0,1
24194845,24195180,335,0,0,1,1
24195016,24195041,25,0,1,0,2
24195089,24195100,11,0,1,0,2
24195181,24195485,304,1,0,0,1
24195486,24195518,32,0,0,1,1
24195519,24195593,74,1,0,0,1
24195588,24195605,17,0,1,0,2
24195594,24195615,21,0,0,1,1
24195616,24195676,60,1,0,0,1
24195642,24195642,0,0,1,0,2
24195665,24195668,3,0,1,0,2
24195677,24195812,135,0,0,1,1
24195702,24195725,23,0,1,0,2
24195813,24195880,67,1,0,0,1
24195826,24195827,1,0,1,0,2
24195881,24196172,291,0,0,1,1
24196074,24196174,100,0,0,1,2
24196173,24196215,42,1,0,0,1
24196175,24196196,21,1,0,0,2
24196197,24196269,72,0,0,1,2
24196216,24196285,69,0,0,1,1
24196270,24196649,379,1,0,0,2
24196286,24196834,548,1,0,0,1
24196301,24196462,161,0,1,0,2
24196314,24196420,106,0,1,0,1
24196650,24196712,62,0,0,1,2
24196713,24196794,81,1,0,0,2
24196795,24196881,86,0,0,1,2
24196835,24196982,147,0,0,1,1
24196882,24196909,27,1,0,0,2
24196910,24197846,936,0,0,1,2
24196983,24197195,212,1,0,0,1
24197196,24197879,683,0,0,1,1
24197847,24198000,153,1,0,0,2
24197880,24197960,80,1,0,0,1
24197961,24198082,121,0,0,1,1
24198001,24198082,81,0,0,1,2
24198083,24198138,55,1,0,0,2
24198083,24198140,57,1,0,0,1
24198139,24198640,501,0,0,1,2
24198141,24198640,499,0,0,1,1
24198641,24198682,41,1,0,0,1
24198641,24198685,44,1,0,0,2
24198683,24199156,473,0,0,1,1
24198686,24199155,469,0,0,1,2
24199156,24199228,72,1,0,0,2
24199157,24199207,50,1,0,0,1
24199208,24199361,153,0,0,1,1
24199229,24199361,132,0,0,1,2
24199362,24199383,21,1,0,0,2
24199362,24199384,22,1,0,0,1
24199384,24199612,228,0,0,1,2
24199385,24199617,232,0,0,1,1
24199613,24199921,308,1,0,0,2
24199618,24199868,250,1,0,0,1
24199640,24199804,164,0,1,0,2
24199644,24199772,128,0,1,0,1
24199869,24199896,27,0,0,1,1
24199897,24199939,42,1,0,0,1
24199922,24201015,1093,0,0,1,2
24199940,24200217,277,0,0,1,1
24200218,24200255,37,1,0,0,1
24200256,24200324,68,0,0,1,1
24200325,24200378,53,1,0,0,1
24200379,24201016,637,0,0,1,1
24201016,24201067,51,1,0,0,2
24201017,24201073,56,1,0,0,1
24201068,24201311,243,0,0,1,2
24201074,24201306,232,0,0,1,1
24201307,24201331,24,1,0,0,1
24201312,24201321,9,1,0,0,2
24201322,24203097,1775,0,0,1,2
24201332,24201876,544,0,0,1,1
24201877,24201905,28,1,0,0,1
24201906,24203098,1192,0,0,1,1
24203098,24203164,66,1,0,0,2
24203099,24203163,64,1,0,0,1
24203164,24203734,570,0,0,1,1
24203165,24203734,569,0,0,1,2
24203735,24203782,47,1,0,0,1
24203735,24203782,47,1,0,0,2
24203783,24204762,979,0,0,1,1
24203783,24204764,981,0,0,1,2
24204763,24204839,76,1,0,0,1
24204765,24204832,67,1,0,0,2
24204833,24204928,95,0,0,1,2
24204840,24204928,88,0,0,1,1
24204929,24204958,29,1,0,0,2
24204929,24204974,45,1,0,0,1
24204959,24205109,150,0,0,1,2
24204975,24205469,494,0,0,1,1
24205110,24205124,14,1,0,0,2
24205125,24206363,1238,0,0,1,2
24205470,24205486,16,1,0,0,1
24205487,24206096,609,0,0,1,1
24206097,24206107,10,1,0,0,1
24206108,24206364,256,0,0,1,1
24206364,24206409,45,1,0,0,2
24206365,24206413,48,1,0,0,1
24206410,24208560,2150,0,0,1,2
24206414,24208561,2147,0,0,1,1
24208561,24208944,383,1,0,0,2
24208562,24208833,271,1,0,0,1
24208610,24208755,145,0,1,0,2
24208626,24208708,82,0,1,0,1
24208834,24209460,626,0,0,1,1
24208945,24209462,517,0,0,1,2
24209461,24209515,54,1,0,0,1
24209463,24209515,52,1,0,0,2
24209516,24209914,398,0,0,1,1
24209516,24209916,400,0,0,1,2
24209915,24209988,73,1,0,0,1
24209917,24209983,66,1,0,0,2
24209984,24210107,123,0,0,1,2
24209989,24210106,117,0,0,1,1
24210107,24210195,88,1,0,0,1
24210108,24210147,39,1,0,0,2
24210148,24210280,132,0,0,1,2
24210196,24210277,81,0,0,1,1
24210278,24210299,21,1,0,0,1
24210281,24210300,19,1,0,0,2
24210300,24210508,208,0,0,1,1
24210301,24210492,191,0,0,1,2
24210493,24210737,244,1,0,0,2
24210509,24210714,205,1,0,0,1
24210526,24210603,77,0,1,0,2
24210541,24210577,36,0,1,0,1
24210715,24210792,77,0,0,1,1
24210738,24210785,47,0,0,1,2
24210786,24210801,15,1,0,0,2
24210793,24210800,7,1,0,0,1
24210801,24211306,505,0,0,1,1
24210802,24211387,585,0,0,1,2
24211307,24211339,32,1,0,0,1
24211340,24211756,416,0,0,1,1
24211388,24211400,12,1,0,0,2
24211401,24211757,356,0,0,1,2
24211757,24211804,47,1,0,0,1
24211758,24211805,47,1,0,0,2
24211805,24212160,355,0,0,1,1
24211806,24212163,357,0,0,1,2
24212161,24212188,27,1,0,0,1
24212164,24212184,20,1,0,0,2
24212185,24212582,397,0,0,1,2
24212189,24212584,395,0,0,1,1
24212583,24212616,33,1,0,0,2
24212585,24212612,27,1,0,0,1
24212613,24213578,965,0,0,1,1
24212617,24213578,961,0,0,1,2
24213579,24213598,19,1,0,0,1
24213579,24213600,21,1,0,0,2
24213599,24214085,486,0,0,1,1
24213601,24214085,484,0,0,1,2
24214086,24214163,77,1,0,0,1
24214086,24214163,77,1,0,0,2
24214164,24214998,834,0,0,1,1
24214164,24214998,834,0,0,1,2
24214999,24215048,49,1,0,0,1
24214999,24215055,56,1,0,0,2
24215049,24215456,407,0,0,1,1
24215056,24215456,400,0,0,1,2
24215457,24215512,55,1,0,0,1
24215457,24215530,73,1,0,0,2
24215513,24215628,115,0,0,1,1
24215531,24215631,100,0,0,1,2
24215629,24215663,34,1,0,0,1
24215632,24215663,31,1,0,0,2
24215664,24215800,136,0,0,1,1
24215664,24215801,137,0,0,1,2
24215801,24215811,10,1,0,0,1
24215802,24215812,10,1,0,0,2
24215812,24217418,1606,0,0,1,1
24215813,24217419,1606,0,0,1,2
24217419,24217471,52,1,0,0,1
24217420,24217473,53,1,0,0,2
24217472,24219592,2120,0,0,1,1
24217474,24219576,2102,0,0,1,2
24219577,24219932,355,1,0,0,2
24219593,24219887,294,1,0,0,1
24219607,24219840,233,0,1,0,2
24219617,24219778,161,0,1,0,1
24219888,24220251,363,0,0,1,1
24219933,24220250,317,0,0,1,2
24220251,24220297,46,1,0,0,2
24220252,24220296,44,1,0,0,1
24220297,24221294,997,0,0,1,1
24220298,24220852,554,0,0,1,2
24220853,24220936,83,1,0,0,2
24220937,24221297,360,0,0,1,2
24221295,24221328,33,1,0,0,1
24221298,24221345,47,1,0,0,2
24221329,24221710,381,0,0,1,1
24221346,24221535,189,0,0,1,2
24221536,24221551,15,1,0,0,2
24221552,24221675,123,0,0,1,2
24221676,24221936,260,1,0,0,2
24221711,24221846,135,1,0,0,1
24221724,24221867,143,0,1,0,2
24221731,24221781,50,0,1,0,1
24221847,24223177,1330,0,0,1,1
24221937,24222727,790,0,0,1,2
24222728,24222732,4,1,0,0,2
24222733,24223177,444,0,0,1,2
24223178,24223218,40,1,0,0,1
24223178,24223218,40,1,0,0,2
24223219,24225309,2090,0,0,1,2
24223219,24225332,2113,0,0,1,1
24225310,24225831,521,1,0,0,2
24225333,24225654,321,1,0,0,1
24225352,24225644,292,0,1,0,2
24225363,24225585,222,0,1,0,1
24225655,24226002,347,0,0,1,1
24225674,24225697,23,0,1,0,2
24225832,24226003,171,0,0,1,2
24226003,24226057,54,1,0,0,1
24226004,24226068,64,1,0,0,2
24226058,24226828,770,0,0,1,1
24226069,24226828,759,0,0,1,2
24226829,24226885,56,1,0,0,2
24226829,24226893,64,1,0,0,1
24226886,24227235,349,0,0,1,2
24226894,24227237,343,0,0,1,1
24227236,24227556,320,1,0,0,2
24227238,24227387,149,1,0,0,1
24227388,24227457,69,0,0,1,1
24227458,24227499,41,1,0,0,1
24227500,24227652,152,0,0,1,1
24227557,24227608,51,0,0,1,2
24227609,24228739,1130,1,0,0,2
24227653,24227878,225,1,0,0,1
24227879,24227926,47,0,0,1,1
24227927,24227944,17,1,0,0,1
24227945,24228389,444,0,0,1,1
24228390,24228612,222,1,0,0,1
24228613,24229051,438,0,0,1,1
24228740,24228954,214,0,0,1,2
24228955,24228959,4,1,0,0,2
24228960,24229040,80,0,0,1,2
24229041,24229129,88,1,0,0,2
24229052,24229096,44,0,1,0,2
24229052,24229103,51,1,0,0,1
24229104,24229517,413,0,0,1,1
24229130,24229194,64,0,0,1,2
24229195,24229280,85,1,0,0,2
24229281,24229334,53,0,0,1,2
24229335,24229395,60,1,0,0,2
24229396,24229434,38,0,0,1,2
24229435,24229558,123,1,0,0,2
24229518,24229542,24,1,0,0,1
24229543,24229719,176,0,0,1,1
24229559,24230012,453,0,0,1,2
24229720,24229774,54,1,0,0,1
24229775,24230054,279,0,0,1,1
24230013,24230438,425,1,0,0,2
24230055,24230072,17,1,0,0,1
24230073,24230574,501,0,0,1,1
24230439,24230553,114,0,0,1,2
24230564,24230566,2,0,1,0,2
24230575,24230868,293,1,0,0,1
24230576,24230946,370,1,0,0,2
24230606,24230834,228,0,1,0,2
24230613,24230809,196,0,1,0,1
24230869,24231682,813,0,0,1,1
24230947,24231681,734,0,0,1,2
24231682,24231734,52,1,0,0,2
24231683,24231751,68,1,0,0,1
24231735,24231858,123,0,0,1,2
24231752,24231856,104,0,0,1,1
24231857,24231882,25,1,0,0,1
24231859,24231883,24,1,0,0,2
24231883,24232019,136,0,0,1,1
24231884,24232023,139,0,0,1,2
24232020,24232307,287,1,0,0,1
24232024,24232282,258,1,0,0,2
24232053,24232176,123,0,1,0,2
24232058,24232219,161,0,1,0,1
24232283,24232385,102,0,0,1,2
24232308,24232388,80,0,0,1,1
24232386,24232400,14,1,0,0,2
24232389,24232408,19,1,0,0,1
24232401,24232912,511,0,0,1,2
24232409,24232914,505,0,0,1,1
24232913,24233011,98,1,0,0,2
24232915,24232977,62,1,0,0,1
24232978,24234430,1452,0,0,1,1
24233012,24234430,1418,0,0,1,2
24234431,24234452,21,1,0,0,1
24234431,24234485,54,1,0,0,2
24234453,24234863,410,0,0,1,1
24234486,24234866,380,0,0,1,2
24234864,24234926,62,1,0,0,1
24234867,24234926,59,1,0,0,2
24234927,24235378,451,0,0,1,2
24234927,24235379,452,0,0,1,1
24235379,24235437,58,1,0,0,2
24235380,24235435,55,1,0,0,1
24235436,24236168,732,0,0,1,1
24235438,24236166,728,0,0,1,2
24236167,24236277,110,1,0,0,2
24236169,24236290,121,1,0,0,1
24236278,24236383,105,0,0,1,2
24236291,24236471,180,0,0,1,1
24236384,24237270,886,1,0,0,2
24236472,24236545,73,1,0,0,1
24236546,24237388,842,0,0,1,1
24237271,24237310,39,0,0,1,2
24237311,24237451,140,1,0,0,2
24237389,24237563,174,1,0,0,1
24237452,24238166,714,0,0,1,2
24237564,24237626,62,0,0,1,1
24237627,24237819,192,1,0,0,1
24237820,24237897,77,0,0,1,1
24237898,24237927,29,1,0,0,1
24237928,24238052,124,0,0,1,1
24238053,24238067,14,1,0,0,1
24238068,24238109,41,0,0,1,1
24238110,24238120,10,1,0,0,1
24238121,24238188,67,0,0,1,1
24238167,24238188,21,1,0,0,2
24238189,24238267,78,1,0,0,1
24238189,24238398,209,0,0,1,2
24238268,24238375,107,0,0,1,1
24238376,24238396,20,1,0,0,1
24238397,24238499,102,0,0,1,1
24238399,24238479,80,1,0,0,2
24238480,24238529,49,0,0,1,2
24238500,24238515,15,1,0,0,1
24238516,24238996,480,0,0,1,1
24238530,24238977,447,1,0,0,2
24238978,24239054,76,0,0,1,2
24238997,24239016,19,1,0,0,1
24239017,24239060,43,0,0,1,1
24239055,24239122,67,1,0,0,2
24239061,24239161,100,1,0,0,1
24239123,24239162,39,0,0,1,2
24239162,24239275,113,0,0,1,1
24239163,24239288,125,1,0,0,2
24239276,24239280,4,1,0,0,1
24239281,24239417,136,0,0,1,1
24239289,24239310,21,0,0,1,2
24239311,24239489,178,1,0,0,2
24239418,24239488,70,1,0,0,1
24239489,24240545,1056,0,0,1,1
24239490,24240544,1054,0,0,1,2
24240545,24240619,74,1,0,0,2
24240546,24240621,75,1,0,0,1
24240620,24240713,93,0,0,1,2
24240622,24240711,89,0,0,1,1
24240712,24240739,27,1,0,0,1
24240714,24240754,40,1,0,0,2
24240740,24240909,169,0,0,1,1
24240755,24240903,148,0,0,1,2
24240904,24240914,10,1,0,0,2
24240910,24240914,4,1,0,0,1
24240915,24241451,536,0,0,1,1
24240915,24241452,537,0,0,1,2
24241452,24241470,18,1,0,0,1
24241453,24241463,10,1,0,0,2
24241464,24242205,741,0,0,1,2
24241471,24242205,734,0,0,1,1
24242206,24242260,54,1,0,0,1
24242206,24242260,54,1,0,0,2
24242261,24243214,953,0,0,1,1
24242261,24243215,954,0,0,1,2
24243215,24243224,9,1,0,0,1
24243216,24243220,4,1,0,0,2
24243221,24244363,1142,0,0,1,2
24243225,24244367,1142,0,0,1,1
24244364,24244680,316,1,0,0,2
24244368,24244647,279,1,0,0,1
24244391,24244596,205,0,1,0,2
24244398,24244578,180,0,1,0,1
24244648,24245542,894,0,0,1,1
24244681,24245544,863,0,0,1,2
24245543,24245590,47,1,0,0,1
24245545,24245590,45,1,0,0,2
24245591,24246001,410,0,0,1,2
24245591,24246002,411,0,0,1,1
24246002,24246078,76,1,0,0,2
24246003,24246067,64,1,0,0,1
24246068,24246182,114,0,0,1,1
24246079,24246183,104,0,0,1,2
24246183,24246201,18,1,0,0,1
24246184,24246201,17,1,0,0,2
24246202,24246362,160,0,0,1,2
24246202,24246364,162,0,0,1,1
24246363,24246372,9,1,0,0,2
24246365,24246371,6,1,0,0,1
24246372,24246432,60,0,0,1,1
24246373,24246420,47,0,0,1,2
24246421,24246715,294,1,0,0,2
24246433,24246599,166,1,0,0,1
24246451,24246569,118,0,1,0,2
24246460,24246535,75,0,1,0,1
24246600,24247497,897,0,0,1,1
24246716,24246741,25,0,0,1,2
24246742,24246771,29,1,0,0,2
24246772,24246863,91,0,0,1,2
24246864,24246870,6,1,0,0,2
24246871,24247496,625,0,0,1,2
24247497,24249809,2312,1,0,0,2
24247498,24247564,66,1,0,0,1
24247565,24247809,244,0,0,1,1
24247810,24247848,38,1,0,0,1
24247849,24248254,405,0,0,1,1
24248255,24248277,22,1,0,0,1
24248278,24248586,308,0,0,1,1
24248587,24248597,10,1,0,0,1
24248598,24248624,26,0,0,1,1
24248625,24248700,75,1,0,0,1
24248701,24248760,59,0,0,1,1
24248761,24248801,40,1,0,0,1
24248802,24248834,32,0,0,1,1
24248835,24248877,42,1,0,0,1
24248878,24249010,132,0,0,1,1
24249011,24249041,30,1,0,0,1
24249042,24249205,163,0,0,1,1
24249206,24249752,546,1,0,0,1
24249663,24249706,43,0,1,0,2
24249731,24249733,2,0,1,0,2
24249753,24250445,692,0,0,1,1
24249810,24250443,633,0,0,1,2
24250444,24250482,38,1,0,0,2
24250446,24250483,37,1,0,0,1
24250483,24251076,593,0,0,1,2
24250484,24251074,590,0,0,1,1
24251075,24251106,31,1,0,0,1
24251077,24251105,28,1,0,0,2
24251106,24252834,1728,0,0,1,2
24251107,24251289,182,0,0,1,1
24251290,24251302,12,1,0,0,1
24251303,24252836,1533,0,0,1,1
24252835,24252908,73,1,0,0,2
24252837,24252901,64,1,0,0,1
24252902,24252984,82,0,0,1,1
24252909,24252985,76,0,0,1,2
24252985,24253024,39,1,0,0,1
24252986,24253018,32,1,0,0,2
24253019,24253400,381,0,0,1,2
24253025,24253403,378,0,0,1,1
24253401,24253500,99,1,0,0,2
24253404,24253436,32,1,0,0,1
24253437,24253524,87,0,0,1,1
24253501,24253677,176,0,0,1,2
24253525,24253529,4,1,0,0,1
24253530,24254989,1459,0,0,1,1
24253678,24253785,107,1,0,0,2
24253786,24253841,55,0,0,1,2
24253842,24253879,37,1,0,0,2
24253880,24253926,46,0,0,1,2
24253927,24254464,537,1,0,0,2
24254465,24254485,20,0,0,1,2
24254486,24254606,120,1,0,0,2
24254607,24254674,67,0,0,1,2
24254675,24254682,7,1,0,0,2
24254683,24254882,199,0,0,1,2
24254883,24255246,363,1,0,0,2
24254895,24254972,77,0,1,0,2
24254990,24255100,110,1,0,0,1
24255011,24255085,74,0,1,0,2
24255101,24255465,364,0,0,1,1
24255247,24255467,220,0,0,1,2
24255466,24255513,47,1,0,0,1
24255468,24255510,42,1,0,0,2
24255511,24256939,1428,0,0,1,2
24255514,24256939,1425,0,0,1,1
24256940,24256994,54,1,0,0,1
24256940,24256994,54,1,0,0,2
24256995,24257165,170,0,0,1,2
24256995,24257170,175,0,0,1,1
24257166,24257175,9,1,0,0,2
24257171,24257175,4,1,0,0,1
24257176,24257315,139,0,0,1,1
24257176,24257317,141,0,0,1,2
24257316,24257622,306,1,0,0,1
24257318,24257531,213,1,0,0,2
24257373,24257423,50,0,1,0,2
24257376,24257438,62,0,1,0,1
24257475,24257477,2,0,1,0,2
24257532,24257552,20,0,0,1,2
24257553,24257613,60,1,0,0,2
24257614,24258567,953,0,0,1,2
24257623,24258569,946,0,0,1,1
24258568,24258669,101,1,0,0,2
24258570,24258627,57,1,0,0,1
24258628,24259565,937,0,0,1,1
24258670,24258994,324,0,0,1,2
24258995,24259011,16,1,0,0,2
24259012,24259556,544,0,0,1,2
24259557,24259608,51,1,0,0,2
24259566,24259584,18,1,0,0,1
24259585,24260742,1157,0,0,1,1
24259609,24259651,42,0,0,1,2
24259652,24259734,82,1,0,0,2
24259735,24259773,38,0,0,1,2
24259774,24259797,23,1,0,0,2
24259798,24260742,944,0,0,1,2
24260743,24260776,33,1,0,0,1
24260743,24260778,35,1,0,0,2
24260777,24262172,1395,0,0,1,1
24260779,24261435,656,0,0,1,2
24261436,24261482,46,1,0,0,2
24261483,24262171,688,0,0,1,2
24262172,24262202,30,1,0,0,2
24262173,24262199,26,1,0,0,1
24262200,24262342,142,0,0,1,1
24262203,24262343,140,0,0,1,2
24262343,24262373,30,1,0,0,1
24262344,24262373,29,1,0,0,2
24262374,24262542,168,0,0,1,2
24262374,24262543,169,0,0,1,1
24262543,24262586,43,1,0,0,2
24262544,24262577,33,1,0,0,1
24262578,24262837,259,0,0,1,1
24262587,24262835,248,0,0,1,2
24262836,24262879,43,1,0,0,2
24262838,24262880,42,1,0,0,1
24262880,24262932,52,0,0,1,2
24262881,24262952,71,0,0,1,1
24262933,24277788,14855,1,0,0,2
24262953,24278970,16017,1,0,0,1
24262976,24277709,14733,0,1,0,2
24262980,24263311,331,0,1,0,1
24263335,24278956,15621,0,1,0,1
24277789,24277870,81,0,0,1,2
24277871,24279175,1304,1,0,0,2
24277901,24279011,1110,0,1,0,2
24278971,24279052,81,0,0,1,1
24279053,24282409,3356,1,0,0,1
24279086,24282377,3291,0,1,0,1
24279176,24279226,50,0,0,1,2
24279227,24279910,683,1,0,0,2
24279325,24279809,484,0,1,0,2
24279911,24279944,33,0,0,1,2
24279945,24282094,2149,1,0,0,2
24279969,24281965,1996,0,1,0,2
24282095,24282166,71,0,0,1,2
24282167,24282414,247,1,0,0,2
24282194,24282369,175,0,1,0,2
24282410,24282585,175,0,0,1,1
24282415,24282585,170,0,0,1,2
24282586,24282606,20,1,0,0,1
24282586,24282607,21,1,0,0,2
24282607,24282760,153,0,0,1,1
24282608,24282756,148,0,0,1,2
24282757,24284051,1294,1,0,0,2
24282761,24284017,1256,1,0,0,1
24282782,24284040,1258,0,1,0,2
24282785,24284006,1221,0,1,0,1
24284018,24284444,426,0,0,1,1
24284052,24284444,392,0,0,1,2
24284445,24284464,19,1,0,0,1
24284445,24284464,19,1,0,0,2
24284465,24284538,73,0,0,1,2
24284465,24284540,75,0,0,1,1
24284539,24284730,191,1,0,0,2
24284541,24284738,197,1,0,0,1
24284564,24284666,102,0,1,0,1
24284565,24284661,96,0,1,0,2
24284731,24284905,174,0,0,1,2
24284739,24284904,165,0,0,1,1
24284905,24285150,245,1,0,0,1
24284906,24285177,271,1,0,0,2
24284930,24285095,165,0,1,0,1
24284942,24285039,97,0,1,0,2
24285151,24285341,190,0,0,1,1
24285178,24285343,165,0,0,1,2
24285342,24285375,33,1,0,0,1
24285344,24285375,31,1,0,0,2
24285376,24285641,265,0,0,1,1
24285376,24285641,265,0,0,1,2
24285642,24285686,44,1,0,0,1
24285642,24285686,44,1,0,0,2
24285687,24285923,236,0,0,1,1
24285687,24285923,236,0,0,1,2
24285924,24285960,36,1,0,0,1
24285924,24285962,38,1,0,0,2
24285961,24286180,219,0,0,1,1
24285963,24286180,217,0,0,1,2
24337995,24338197,202,0,0,1,1
24337995,24338198,203,0,0,1,2
24338198,24338258,60,1,0,0,1
24338199,24338257,58,1,0,0,2
24338258,24338414,156,0,0,1,2
24338259,24338413,154,0,0,1,1
24338414,24338478,64,1,0,0,1
24338415,24338480,65,1,0,0,2
24338479,24338619,140,0,0,1,1
24338481,24338628,147,0,0,1,2
24338620,24338636,16,1,0,0,1
24338629,24338638,9,1,0,0,2
24338637,24338864,227,0,0,1,1
24338639,24338861,222,0,0,1,2
24338862,24341440,2578,1,0,0,2
24338865,24339383,518,1,0,0,1
24338892,24339072,180,0,1,0,2
24338892,24339359,467,0,1,0,1
24339168,24339234,66,0,1,0,2
24339258,24339287,29,0,1,0,2
24339384,24339821,437,0,0,1,1
24339822,24340305,483,1,0,0,1
24339857,24340086,229,0,1,0,2
24339861,24340294,433,0,1,0,1
24340306,24340452,146,0,0,1,1
24340355,24340357,2,0,1,0,2
24340453,24340926,473,1,0,0,1
24340501,24340879,378,0,1,0,1
24340927,24341060,133,0,0,1,1
24341061,24341085,24,1,0,0,1
24341086,24341115,29,0,0,1,1
24341116,24341164,48,1,0,0,1
24341165,24342499,1334,0,0,1,1
24341441,24341464,23,0,0,1,2
24341465,24341496,31,1,0,0,2
24341497,24341545,48,0,0,1,2
24341546,24341640,94,1,0,0,2
24341641,24341776,135,0,0,1,2
24341777,24341864,87,1,0,0,2
24341865,24341948,83,0,0,1,2
24341949,24342069,120,1,0,0,2
24342070,24342149,79,0,0,1,2
24342150,24342177,27,1,0,0,2
24342178,24342240,62,0,0,1,2
24342241,24342276,35,1,0,0,2
24342277,24342356,79,0,0,1,2
24342357,24342361,4,1,0,0,2
24342362,24342498,136,0,0,1,2
24342499,24342595,96,1,0,0,2
24342500,24342593,93,1,0,0,1
24342594,24342922,328,0,0,1,1
24342596,24342923,327,0,0,1,2
24342923,24343014,91,1,0,0,1
24342924,24342996,72,1,0,0,2
24342997,24343102,105,0,0,1,2
24343015,24343101,86,0,0,1,1
24343102,24343120,18,1,0,0,1
24343103,24343132,29,1,0,0,2
24343121,24343272,151,0,0,1,1
24343133,24344703,1570,0,0,1,2
24343273,24343300,27,1,0,0,1
24343301,24343345,44,0,0,1,1
24343346,24343363,17,1,0,0,1
24343364,24343790,426,0,0,1,1
24343791,24343846,55,1,0,0,1
24343847,24344084,237,0,0,1,1
24344085,24344147,62,1,0,0,1
24344148,24344705,557,0,0,1,1
24344704,24344819,115,1,0,0,2
24344706,24344817,111,1,0,0,1
24344818,24345137,319,0,0,1,1
24344820,24345138,318,0,0,1,2
24345138,24345207,69,1,0,0,1
24345139,24345208,69,1,0,0,2
24345208,24345307,99,0,0,1,1
24345209,24345306,97,0,0,1,2
24345307,24345330,23,1,0,0,2
24345308,24345334,26,1,0,0,1
24345331,24345493,162,0,0,1,2
24345335,24345490,155,0,0,1,1
24345491,24345508,17,1,0,0,1
24345494,24345517,23,1,0,0,2
24345509,24346076,567,0,0,1,1
24345518,24346073,555,0,0,1,2
24346074,24346088,14,1,0,0,2
24346077,24346087,10,1,0,0,1
24346088,24346501,413,0,0,1,1
24346089,24346507,418,0,0,1,2
24346502,24346517,15,1,0,0,1
24346508,24346517,9,1,0,0,2
24346518,24347218,700,0,0,1,1
24346518,24347224,706,0,0,1,2
24347219,24347428,209,1,0,0,1
24347225,24347410,185,1,0,0,2
24347267,24347337,70,0,1,0,2
24347268,24347336,68,0,1,0,1
24347411,24347698,287,0,0,1,2
24347429,24347698,269,0,0,1,1
24347699,24347795,96,1,0,0,2
24347699,24347811,112,1,0,0,1
24347796,24347932,136,0,0,1,2
24347812,24347930,118,0,0,1,1
24347931,24347975,44,1,0,0,1
24347933,24347992,59,1,0,0,2
24347976,24348096,120,0,0,1,1
24347993,24349478,1485,0,0,1,2
24348097,24349151,1054,1,0,0,1
24349152,24349194,42,0,0,1,1
24349195,24349553,358,1,0,0,1
24349479,24349563,84,1,0,0,2
24349554,24349839,285,0,0,1,1
24349564,24349840,276,0,0,1,2
24349840,24349888,48,1,0,0,1
24349841,24349896,55,1,0,0,2
24349889,24350040,151,0,0,1,1
24349897,24350042,145,0,0,1,2
24350041,24350108,67,1,0,0,1
24350043,24350111,68,1,0,0,2
24350109,24351572,1463,0,0,1,1
24350112,24350316,204,0,0,1,2
24350317,24350334,17,1,0,0,2
24350335,24350803,468,0,0,1,2
24350804,24350812,8,1,0,0,2
24350813,24351570,757,0,0,1,2
24351571,24351581,10,1,0,0,2
24351573,24351577,4,1,0,0,1
24351578,24351797,219,0,0,1,1
24351582,24351795,213,0,0,1,2
24351796,24351908,112,1,0,0,2
24351798,24351894,96,1,0,0,1
24351895,24352031,136,0,0,1,1
24351909,24352032,123,0,0,1,2
24352032,24352142,110,1,0,0,1
24352033,24352118,85,1,0,0,2
24352119,24352292,173,0,0,1,2
24352143,24352243,100,0,0,1,1
24352244,24352551,307,1,0,0,1
24352293,24352324,31,1,0,0,2
24352325,24352484,159,0,0,1,2
24352485,24352525,40,1,0,0,2
24352526,24353385,859,0,0,1,2
24352552,24352589,37,0,0,1,1
24352590,24352668,78,1,0,0,1
24352669,24352755,86,0,0,1,1
24352756,24352774,18,1,0,0,1
24352775,24352814,39,0,0,1,1
24352815,24352851,36,1,0,0,1
24352852,24353237,385,0,0,1,1
24353238,24353271,33,1,0,0,1
24353272,24353334,62,0,0,1,1
24353335,24353349,14,1,0,0,1
24353350,24353376,26,0,0,1,1
24353377,24353878,501,1,0,0,1
24353386,24353466,80,1,0,0,2
24353467,24353795,328,0,0,1,2
24353796,24353879,83,1,0,0,2
24353879,24353942,63,0,0,1,1
24353880,24353941,61,0,0,1,2
24353942,24353987,45,1,0,0,2
24353943,24353988,45,1,0,0,1
24353988,24354111,123,0,0,1,2
24353989,24354112,123,0,0,1,1
24354112,24354129,17,1,0,0,2
24354113,24354130,17,1,0,0,1
24354130,24355935,1805,0,0,1,2
24354131,24355934,1803,0,0,1,1
24355935,24356011,76,1,0,0,1
24355936,24356003,67,1,0,0,2
24356004,24356117,113,0,0,1,2
24356012,24356122,110,0,0,1,1
24356118,24356144,26,1,0,0,2
24356123,24356144,21,1,0,0,1
24356145,24356311,166,0,0,1,1
24356145,24356316,171,0,0,1,2
24356312,24356501,189,1,0,0,1
24356317,24356508,191,1,0,0,2
24356345,24356425,80,0,1,0,2
24356350,24356426,76,0,1,0,1
24356502,24356606,104,0,0,1,1
24356509,24356601,92,0,0,1,2
24356602,24356619,17,1,0,0,2
24356607,24356616,9,1,0,0,1
24356617,24357896,1279,0,0,1,1
24356620,24357894,1274,0,0,1,2
24357895,24357972,77,1,0,0,2
24357897,24357973,76,1,0,0,1
24357973,24358115,142,0,0,1,2
24357974,24358114,140,0,0,1,1
24358115,24358178,63,1,0,0,1
24358116,24358175,59,1,0,0,2
24358176,24358265,89,0,0,1,2
24358179,24358265,86,0,0,1,1
24358266,24358286,20,1,0,0,2
24358266,24358287,21,1,0,0,1
24358287,24359941,1654,0,0,1,2
24358288,24359939,1651,0,0,1,1
24359940,24360018,78,1,0,0,1
24359942,24359997,55,1,0,0,2
24359998,24360115,117,0,0,1,2
24360019,24360117,98,0,0,1,1
24360116,24360137,21,1,0,0,2
24360118,24360154,36,1,0,0,1
24360138,24361222,1084,0,0,1,2
24360155,24361223,1068,0,0,1,1
24361223,24361277,54,1,0,0,2
24361224,24361276,52,1,0,0,1
24361277,24361691,414,0,0,1,1
24361278,24361691,413,0,0,1,2
24361692,24361789,97,1,0,0,2
24361692,24361801,109,1,0,0,1
24361790,24361878,88,0,0,1,2
24361802,24361877,75,0,0,1,1
24361878,24361912,34,1,0,0,1
24361879,24361908,29,1,0,0,2
24361909,24363002,1093,0,0,1,2
24361913,24363002,1089,0,0,1,1
24363003,24363120,117,1,0,0,1
24363003,24363121,118,1,0,0,2
24363121,24363468,347,0,0,1,1
24363122,24363468,346,0,0,1,2
24363469,24363550,81,1,0,0,2
24363469,24363573,104,1,0,0,1
24363551,24363680,129,0,0,1,2
24363574,24363677,103,0,0,1,1
24363678,24363717,39,1,0,0,1
24363681,24363704,23,1,0,0,2
24363705,24364469,764,0,0,1,2
24363718,24364468,750,0,0,1,1
24364469,24364532,63,1,0,0,1
24364470,24364533,63,1,0,0,2
24364533,24364922,389,0,0,1,1
24364534,24364925,391,0,0,1,2
24364923,24364978,55,1,0,0,1
24364926,24364978,52,1,0,0,2
24364979,24365087,108,0,0,1,1
24364979,24365089,110,0,0,1,2
24365088,24365113,25,1,0,0,1
24365090,24365114,24,1,0,0,2
24365114,24365939,825,0,0,1,1
24365115,24365941,826,0,0,1,2
24365940,24365948,8,1,0,0,1
24365942,24365947,5,1,0,0,2
24365948,24366287,339,0,0,1,2
24365949,24366288,339,0,0,1,1
24366288,24366362,74,1,0,0,2
24366289,24366364,75,1,0,0,1
24366363,24366790,427,0,0,1,2
24366365,24366791,426,0,0,1,1
24366791,24366897,106,1,0,0,2
24366792,24366916,124,1,0,0,1
24366898,24367024,126,0,0,1,2
24366917,24367023,106,0,0,1,1
24367024,24367049,25,1,0,0,1
24367025,24367076,51,1,0,0,2
24367050,24367242,192,0,0,1,1
24367077,24367830,753,0,0,1,2
24367243,24367249,6,1,0,0,1
24367250,24368366,1116,0,0,1,1
24367831,24367939,108,1,0,0,2
24367940,24368053,113,0,0,1,2
24368054,24368557,503,1,0,0,2
24368367,24368378,11,1,0,0,1
24368379,24368645,266,0,0,1,1
24368558,24368600,42,0,0,1,2
24368601,24368691,90,1,0,0,2
24368646,24368731,85,1,0,0,1
24368692,24368920,228,0,0,1,2
24368732,24369040,308,0,0,1,1
24368921,24368948,27,1,0,0,2
24368949,24369003,54,0,0,1,2
24369004,24369092,88,1,0,0,2
24369041,24369197,156,1,0,0,1
24369093,24370519,1426,0,0,1,2
24369198,24369261,63,0,0,1,1
24369262,24369388,126,1,0,0,1
24369389,24369454,65,0,0,1,1
24369455,24369497,42,1,0,0,1
24369498,24370026,528,0,0,1,1
24370027,24370041,14,1,0,0,1
24370042,24370981,939,0,0,1,1
24370520,24371075,555,1,0,0,2
24370982,24371071,89,1,0,0,1
24371072,24371166,94,0,0,1,1
24371076,24371166,90,0,0,1,2
24371167,24371202,35,1,0,0,2
24371167,24371203,36,1,0,0,1
24371203,24371880,677,0,0,1,2
24371204,24371879,675,0,0,1,1
24371880,24371895,15,1,0,0,1
24371881,24371900,19,1,0,0,2
24371896,24373099,1203,0,0,1,1
24371901,24372182,281,0,0,1,2
24372183,24372191,8,1,0,0,2
24372192,24373100,908,0,0,1,2
24373100,24373423,323,1,0,0,1
24373101,24373268,167,1,0,0,2
24373217,24373256,39,0,1,0,1
24373269,24373381,112,0,0,1,2
24373296,24373412,116,0,1,0,1
24373382,24373414,32,1,0,0,2
24373415,24373554,139,0,0,1,2
24373424,24373458,34,0,0,1,1
24373459,24374861,1402,1,0,0,1
24373555,24373932,377,1,0,0,2
24373933,24373983,50,0,0,1,2
24373984,24374917,933,1,0,0,2
24374303,24374310,7,0,1,0,1
24374333,24374337,4,0,1,0,1
24374391,24374808,417,0,1,0,1
24374862,24375260,398,0,0,1,1
24374918,24375261,343,0,0,1,2
24375261,24375348,87,1,0,0,1
24375262,24375344,82,1,0,0,2
24375345,24375429,84,0,0,1,2
24375349,24375429,80,0,0,1,1
24375430,24375468,38,1,0,0,2
24375430,24375470,40,1,0,0,1
24375469,24376098,629,0,0,1,2
24375471,24376099,628,0,0,1,1
24376099,24376110,11,1,0,0,2
24376100,24376109,9,1,0,0,1
24376110,24376340,230,0,0,1,1
24376111,24376332,221,0,0,1,2
24376333,24376344,11,1,0,0,2
24376341,24376345,4,1,0,0,1
24376345,24376825,480,0,0,1,2
24376346,24376825,479,0,0,1,1
24376826,24376923,97,1,0,0,1
24376826,24376925,99,1,0,0,2
24376924,24377194,270,0,0,1,1
24376926,24377196,270,0,0,1,2
24377195,24377254,59,1,0,0,1
24377197,24377256,59,1,0,0,2
24377255,24377353,98,0,0,1,1
24377257,24377349,92,0,0,1,2
24377350,24377376,26,1,0,0,2
24377354,24377373,19,1,0,0,1
24377374,24377536,162,0,0,1,1
24377377,24378965,1588,0,0,1,2
24377537,24377550,13,1,0,0,1
24377551,24378966,1415,0,0,1,1
24378966,24379287,321,1,0,0,2
24378967,24379282,315,1,0,0,1
24379001,24379186,185,0,1,0,2
24379003,24379178,175,0,1,0,1
24379283,24379596,313,0,0,1,1
24379288,24379598,310,0,0,1,2
24379597,24379677,80,1,0,0,1
24379599,24379680,81,1,0,0,2
24379678,24379752,74,0,0,1,1
24379681,24379753,72,0,0,1,2
24379753,24379802,49,1,0,0,1
24379754,24381235,1481,1,0,0,2
24379776,24381226,1450,0,1,0,2
24379803,24379891,88,0,0,1,1
24379892,24379913,21,1,0,0,1
24379914,24380073,159,0,0,1,1
24380074,24380088,14,1,0,0,1
24380089,24381500,1411,0,0,1,1
24381236,24381365,129,0,0,1,2
24381376,24381389,13,0,1,0,2
24381399,24381596,197,1,0,0,2
24381426,24381438,12,0,1,0,2
24381463,24381488,25,0,1,0,2
24381501,24381592,91,1,0,0,1
24381521,24381522,1,0,1,0,2
24381593,24381967,374,0,0,1,1
24381597,24381969,372,0,0,1,2
24381968,24382042,74,1,0,0,1
24381970,24382046,76,1,0,0,2
24382043,24382142,99,0,0,1,1
24382047,24382144,97,0,0,1,2
24382143,24382190,47,1,0,0,1
24382145,24382171,26,1,0,0,2
24382172,24382323,151,0,0,1,2
24382191,24382326,135,0,0,1,1
24382324,24382347,23,1,0,0,2
24382327,24382356,29,1,0,0,1
24382348,24384154,1806,0,0,1,2
24382357,24384866,2509,0,0,1,1
24384155,24384164,9,1,0,0,2
24384165,24384868,703,0,0,1,2
24384867,24384928,61,1,0,0,1
24384869,24384926,57,1,0,0,2
24384927,24385274,347,0,0,1,2
24384929,24385275,346,0,0,1,1
24385275,24385361,86,1,0,0,2
24385276,24385348,72,1,0,0,1
24385349,24385434,85,0,0,1,1
24385362,24385433,71,0,0,1,2
24385434,24385466,32,1,0,0,2
24385435,24385467,32,1,0,0,1
24385467,24385585,118,0,0,1,2
24385468,24385587,119,0,0,1,1
24385586,24385609,23,1,0,0,2
24385588,24385613,25,1,0,0,1
24385610,24386651,1041,0,0,1,2
24385614,24385873,259,0,0,1,1
24385874,24385894,20,1,0,0,1
24385895,24386062,167,0,0,1,1
24386063,24386068,5,1,0,0,1
24386069,24386662,593,0,0,1,1
24386652,24386668,16,1,0,0,2
24386663,24386668,5,1,0,0,1
24386669,24387235,566,0,0,1,2
24386669,24387427,758,0,0,1,1
24387236,24387319,83,1,0,0,2
24387320,24387426,106,0,0,1,2
24387427,24387481,54,1,0,0,2
24387428,24387480,52,1,0,0,1
24387481,24387603,122,0,0,1,1
24387482,24387608,126,0,0,1,2
24387604,24387657,53,1,0,0,1
24387609,24387659,50,1,0,0,2
24387658,24387958,300,0,0,1,1
24387660,24387958,298,0,0,1,2
24387959,24388036,77,1,0,0,2
24387959,24388039,80,1,0,0,1
24388037,24388143,106,0,0,1,2
24388040,24388144,104,0,0,1,1
24388144,24388168,24,1,0,0,2
24388145,24388169,24,1,0,0,1
24388169,24389976,1807,0,0,1,2
24388170,24389977,1807,0,0,1,1
24389977,24390047,70,1,0,0,2
24389978,24390045,67,1,0,0,1
24390046,24390477,431,0,0,1,1
24390048,24390476,428,0,0,1,2
24390477,24390568,91,1,0,0,2
24390478,24390551,73,1,0,0,1
24390552,24390681,129,0,0,1,1
24390569,24390681,112,0,0,1,2
24390682,24390696,14,1,0,0,1
24390682,24390698,16,1,0,0,2
24390697,24393187,2490,0,0,1,1
24390699,24393188,2489,0,0,1,2
24393188,24393280,92,1,0,0,1
24393189,24393294,105,1,0,0,2
24393281,24393411,130,0,0,1,1
24393295,24393412,117,0,0,1,2
24393412,24393441,29,1,0,0,1
24393413,24393437,24,1,0,0,2
24393438,24395586,2148,0,0,1,2
24393442,24395591,2149,0,0,1,1
24395587,24395781,194,1,0,0,2
24395592,24395742,150,1,0,0,1
24395620,24395672,52,0,1,0,1
24395621,24395691,70,0,1,0,2
24395743,24396035,292,0,0,1,1
24395782,24396035,253,0,0,1,2
24396036,24396082,46,1,0,0,1
24396036,24396085,49,1,0,0,2
24396083,24396207,124,0,0,1,1
24396086,24396206,120,0,0,1,2
24396207,24396233,26,1,0,0,2
24396208,24396230,22,1,0,0,1
24396231,24398692,2461,0,0,1,1
24396234,24396671,437,0,0,1,2
24396672,24396792,120,1,0,0,2
24396793,24398692,1899,0,0,1,2
24398693,24398731,38,1,0,0,1
24398693,24398732,39,1,0,0,2
24398732,24399123,391,0,0,1,1
24398733,24399125,392,0,0,1,2
24399124,24399203,79,1,0,0,1
24399126,24399199,73,1,0,0,2
24399200,24399764,564,0,0,1,2
24399204,24399759,555,0,0,1,1
24399760,24399778,18,1,0,0,1
24399765,24399771,6,1,0,0,2
24399772,24401377,1605,0,0,1,2
24399779,24400768,989,0,0,1,1
24400769,24400781,12,1,0,0,1
24400782,24401388,606,0,0,1,1
24401378,24401469,91,1,0,0,2
24401389,24401470,81,1,0,0,1
24401470,24401828,358,0,0,1,2
24401471,24401829,358,0,0,1,1
24401829,24401874,45,1,0,0,2
24401830,24401873,43,1,0,0,1
24401874,24402185,311,0,0,1,1
24401875,24402187,312,0,0,1,2
24402186,24402245,59,1,0,0,1
24402188,24402244,56,1,0,0,2
24402245,24402371,126,0,0,1,2
24402246,24402372,126,0,0,1,1
24402372,24402395,23,1,0,0,2
24402373,24402397,24,1,0,0,1
24402396,24404261,1865,0,0,1,2
24402398,24402767,369,0,0,1,1
24402768,24402773,5,1,0,0,1
24402774,24404264,1490,0,0,1,1
24404262,24404279,17,1,0,0,2
24404265,24404286,21,1,0,0,1
24404280,24404515,235,0,0,1,2
24404287,24404515,228,0,0,1,1
24404516,24404558,42,1,0,0,1
24404516,24404559,43,1,0,0,2
24404559,24404799,240,0,0,1,1
24404560,24404799,239,0,0,1,2
24404800,24404841,41,1,0,0,2
24404800,24404842,42,1,0,0,1
24404842,24404900,58,0,0,1,2
24404843,24404898,55,0,0,1,1
24404899,24404929,30,1,0,0,1
24404901,24404925,24,1,0,0,2
24404926,24404978,52,0,0,1,2
24404930,24404979,49,0,0,1,1
24404979,24405003,24,1,0,0,2
24404980,24405003,23,1,0,0,1
24405004,24405116,112,0,0,1,2
24405004,24405118,114,0,0,1,1
24405117,24405137,20,1,0,0,2
24405119,24405136,17,1,0,0,1
24405137,24405297,160,0,0,1,1
24405138,24405298,160,0,0,1,2
24405298,24405308,10,1,0,0,1
24405299,24405306,7,1,0,0,2
24405307,24406931,1624,0,0,1,2
24405309,24406930,1621,0,0,1,1
24406931,24406950,19,1,0,0,1
24406932,24406950,18,1,0,0,2
24406951,24407099,148,0,0,1,2
24406951,24407376,425,0,0,1,1
24407100,24407114,14,1,0,0,2
24407115,24407377,262,0,0,1,2
24407377,24407382,5,1,0,0,1
24407378,24407387,9,1,0,0,2
24407383,24407589,206,0,0,1,1
24407388,24407591,203,0,0,1,2
24407590,24407609,19,1,0,0,1
24407592,24407608,16,1,0,0,2
24407609,24408040,431,0,0,1,2
24407610,24408040,430,0,0,1,1
24408041,24408110,69,1,0,0,1
24408041,24408110,69,1,0,0,2
24408111,24408219,108,0,0,1,1
24408111,24408224,113,0,0,1,2
24408220,24408240,20,1,0,0,1
24408225,24408241,16,1,0,0,2
24408241,24409352,1111,0,0,1,1
24408242,24409350,1108,0,0,1,2
24409351,24409365,14,1,0,0,2
24409353,24409367,14,1,0,0,1
24409366,24410113,747,0,0,1,2
24409368,24410137,769,0,0,1,1
24410114,24410598,484,1,0,0,2
24410138,24410554,416,1,0,0,1
24410173,24410414,241,0,1,0,1
24410180,24410407,227,0,1,0,2
24410555,24410722,167,0,0,1,1
24410599,24410725,126,0,0,1,2
24410723,24410736,13,1,0,0,1
24410726,24410738,12,1,0,0,2
24410737,24411465,728,0,0,1,1
24410739,24411458,719,0,0,1,2
24411459,24411819,360,1,0,0,2
24411466,24411556,90,1,0,0,1
24411557,24411778,221,0,0,1,1
24411779,24411839,60,1,0,0,1
24411820,24411863,43,0,0,1,2
24411840,24411966,126,0,0,1,1
24411864,24411919,55,1,0,0,2
24411920,24411965,45,0,0,1,2
24411966,24412275,309,1,0,0,2
24411967,24412021,54,1,0,0,1
24412022,24412273,251,0,0,1,1
24412274,24412289,15,1,0,0,1
24412276,24412368,92,0,0,1,2
24412290,24412427,137,0,0,1,1
24412369,24412453,84,1,0,0,2
24412428,24412642,214,1,0,0,1
24412454,24412587,133,0,0,1,2
24412588,24412609,21,1,0,0,2
24412610,24412886,276,0,0,1,2
24412643,24412970,327,0,0,1,1
24412887,24412907,20,1,0,0,2
24412908,24413601,693,0,0,1,2
24412971,24413007,36,1,0,0,1
24413008,24413066,58,0,0,1,1
24413067,24413130,63,1,0,0,1
24413131,24413374,243,0,0,1,1
24413375,24413390,15,1,0,0,1
24413391,24413412,21,0,0,1,1
24413413,24413483,70,1,0,0,1
24413484,24413566,82,0,0,1,1
24413567,24413639,72,1,0,0,1
24413602,24413623,21,1,0,0,2
24413624,24413884,260,0,0,1,2
24413640,24413684,44,0,0,1,1
24413685,24413768,83,1,0,0,1
24413769,24413820,51,0,0,1,1
24413821,24413866,45,1,0,0,1
24413867,24413905,38,0,0,1,1
24413885,24413930,45,1,0,0,2
24413906,24413910,4,1,0,0,1
24413911,24414051,140,0,0,1,1
24413931,24414047,116,0,0,1,2
24414048,24414167,119,1,0,0,2
24414052,24414105,53,1,0,0,1
24414106,24414288,182,0,0,1,1
24414168,24414293,125,0,0,1,2
24414289,24414311,22,1,0,0,1
24414294,24414312,18,1,0,0,2
24414312,24415149,837,0,0,1,1
24414313,24414475,162,0,0,1,2
24414476,24414486,10,1,0,0,2
24414487,24416931,2444,0,0,1,2
24415150,24415163,13,1,0,0,1
24415164,24415797,633,0,0,1,1
24415798,24415808,10,1,0,0,1
24415809,24416931,1122,0,0,1,1
24416932,24417022,90,1,0,0,1
24416932,24417025,93,1,0,0,2
24417023,24417173,150,0,0,1,1
24417026,24417174,148,0,0,1,2
24417174,24417190,16,1,0,0,1
24417175,24417193,18,1,0,0,2
24417191,24419422,2231,0,0,1,1
24417194,24419418,2224,0,0,1,2
24419419,24419476,57,1,0,0,2
24419423,24419475,52,1,0,0,1
24419476,24419794,318,0,0,1,1
24419477,24419793,316,0,0,1,2
24419794,24419861,67,1,0,0,2
24419795,24419864,69,1,0,0,1
24419862,24419975,113,0,0,1,2
24419865,24419974,109,0,0,1,1
24419975,24420006,31,1,0,0,1
24419976,24420004,28,1,0,0,2
24420005,24420167,162,0,0,1,2
24420007,24420168,161,0,0,1,1
24420168,24420182,14,1,0,0,2
24420169,24420179,10,1,0,0,1
24420180,24420317,137,0,0,1,1
24420183,24420298,115,0,0,1,2
24420299,24420614,315,1,0,0,2
24420318,24420546,228,1,0,0,1
24420340,24420485,145,0,1,0,2
24420345,24420465,120,0,1,0,1
24420547,24420628,81,0,0,1,1
24420615,24422185,1570,0,0,1,2
24420629,24420639,10,1,0,0,1
24420640,24422184,1544,0,0,1,1
24422185,24422262,77,1,0,0,1
24422186,24422256,70,1,0,0,2
24422257,24422300,43,0,0,1,2
24422263,24422314,51,0,0,1,1
24422301,24422741,440,1,0,0,2
24422315,24422718,403,1,0,0,1
24422338,24422552,214,0,1,0,2
24422340,24422596,256,0,1,0,1
24422719,24422758,39,0,0,1,1
24422742,24422862,120,0,0,1,2
24422759,24422804,45,1,0,0,1
24422805,24422861,56,0,0,1,1
24422862,24422873,11,1,0,0,1
24422863,24422871,8,1,0,0,2
24422872,24423903,1031,0,0,1,2
24422874,24423057,183,0,0,1,1
24423058,24423066,8,1,0,0,1
24423067,24424399,1332,0,0,1,1
24423904,24423911,7,1,0,0,2
24423912,24424400,488,0,0,1,2
24424400,24424492,92,1,0,0,1
24424401,24424485,84,1,0,0,2
24424486,24424617,131,0,0,1,2
24424493,24424617,124,0,0,1,1
24424618,24424645,27,1,0,0,1
24424618,24424645,27,1,0,0,2
24424646,24425313,667,0,0,1,2
24424646,24425314,668,0,0,1,1
24425314,24425332,18,1,0,0,2
24425315,24425325,10,1,0,0,1
24425326,24425929,603,0,0,1,1
24425333,24425929,596,0,0,1,2
24425930,24426042,112,1,0,0,1
24425930,24426044,114,1,0,0,2
24426043,24426428,385,0,0,1,1
24426045,24426428,383,0,0,1,2
24426429,24426494,65,1,0,0,2
24426429,24426508,79,1,0,0,1
24426495,24426607,112,0,0,1,2
24426509,24426605,96,0,0,1,1
24426606,24426634,28,1,0,0,1
24426608,24426642,34,1,0,0,2
24426635,24428283,1648,0,0,1,1
24426643,24427347,704,0,0,1,2
24427348,24427358,10,1,0,0,2
24427359,24427796,437,0,0,1,2
24427797,24427801,4,1,0,0,2
24427802,24428285,483,0,0,1,2
24428284,24428328,44,1,0,0,1
24428286,24428323,37,1,0,0,2
24428324,24428544,220,0,0,1,2
24428329,24428543,214,0,0,1,1
24428544,24428617,73,1,0,0,1
24428545,24428619,74,1,0,0,2
24428618,24428751,133,0,0,1,1
24428620,24428752,132,0,0,1,2
24428752,24428765,13,1,0,0,1
24428753,24428763,10,1,0,0,2
24428764,24430751,1987,0,0,1,2
24428766,24430751,1985,0,0,1,1
24430752,24430834,82,1,0,0,2
24430752,24430837,85,1,0,0,1
24430835,24430951,116,0,0,1,2
24430838,24430952,114,0,0,1,1
24430952,24431043,91,1,0,0,2
24430953,24431049,96,1,0,0,1
24431044,24431129,85,0,0,1,2
24431050,24431127,77,0,0,1,1
24431128,24431169,41,1,0,0,1
24431130,24431181,51,1,0,0,2
24431170,24431941,771,0,0,1,1
24431182,24431762,580,0,0,1,2
24431763,24431772,9,1,0,0,2
24431773,24431941,168,0,0,1,2
24431942,24431957,15,1,0,0,1
24431942,24431966,24,1,0,0,2
24431958,24432776,818,0,0,1,1
24431967,24432125,158,0,0,1,2
24432126,24432139,13,1,0,0,2
24432140,24432775,635,0,0,1,2
24432776,24432836,60,1,0,0,2
24432777,24432835,58,1,0,0,1
24432836,24432997,161,0,0,1,1
24432837,24432998,161,0,0,1,2
24432998,24433058,60,1,0,0,1
24432999,24433068,69,1,0,0,2
24433059,24433218,159,0,0,1,1
24433069,24433217,148,0,0,1,2
24433218,24433319,101,1,0,0,2
24433219,24433352,133,1,0,0,1
24433320,24433449,129,0,0,1,2
24433353,24433447,94,0,0,1,1
24433448,24433468,20,1,0,0,1
24433450,24433468,18,1,0,0,2
24433469,24436525,3056,0,0,1,1
24433469,24436526,3057,0,0,1,2
24436526,24436626,100,1,0,0,1
24436527,24436618,91,1,0,0,2
24436619,24436712,93,0,0,1,2
24436627,24436711,84,0,0,1,1
24436712,24436765,53,1,0,0,1
24436713,24436738,25,1,0,0,2
24436739,24436935,196,0,0,1,2
24436766,24436940,174,0,0,1,1
24436936,24436951,15,1,0,0,2
24436941,24436961,20,1,0,0,1
24436952,24438417,1465,0,0,1,2
24436962,24438417,1455,0,0,1,1
24438418,24438513,95,1,0,0,2
24438418,24438514,96,1,0,0,1
24438514,24438925,411,0,0,1,2
24438515,24438924,409,0,0,1,1
24438925,24439006,81,1,0,0,1
24438926,24438998,72,1,0,0,2
24438999,24439127,128,0,0,1,2
24439007,24439127,120,0,0,1,1
24439128,24439145,17,1,0,0,2
24439128,24439153,25,1,0,0,1
24439146,24439556,410,0,0,1,2
24439154,24440359,1205,0,0,1,1
24439557,24439570,13,1,0,0,2
24439571,24440358,787,0,0,1,2
24440359,24440412,53,1,0,0,2
24440360,24440411,51,1,0,0,1
24440412,24440899,487,0,0,1,1
24440413,24440900,487,0,0,1,2
24440900,24440955,55,1,0,0,1
24440901,24440950,49,1,0,0,2
24440951,24441055,104,0,0,1,2
24440956,24441055,99,0,0,1,1
24441056,24441081,25,1,0,0,1
24441056,24441083,27,1,0,0,2
24441082,24441239,157,0,0,1,1
24441084,24441241,157,0,0,1,2
24441240,24441250,10,1,0,0,1
24441242,24441252,10,1,0,0,2
24441251,24441808,557,0,0,1,1
24441253,24441816,563,0,0,1,2
24441809,24441865,56,1,0,0,1
24441817,24441873,56,1,0,0,2
24441866,24442267,401,0,0,1,1
24441874,24442269,395,0,0,1,2
24442268,24442277,9,1,0,0,1
24442270,24442275,5,1,0,0,2
24442276,24442490,214,0,0,1,2
24442278,24442490,212,0,0,1,1
24442491,24442559,68,1,0,0,1
24442491,24442559,68,1,0,0,2
24442560,24442825,265,0,0,1,1
24442560,24442827,267,0,0,1,2
24442826,24443001,175,1,0,0,1
24442828,24442989,161,1,0,0,2
24442990,24443056,66,0,0,1,2
24443002,24443056,54,0,0,1,1
24443057,24443097,40,1,0,0,1
24443057,24443099,42,1,0,0,2
24443098,24443263,165,0,0,1,1
24443100,24443260,160,0,0,1,2
24443261,24443280,19,1,0,0,2
24443264,24443278,14,1,0,0,1
24443279,24445278,1999,0,0,1,1
24443281,24444320,1039,0,0,1,2
24444321,24444333,12,1,0,0,2
24444334,24445279,945,0,0,1,2
24445279,24445315,36,1,0,0,1
24445280,24445313,33,1,0,0,2
24445314,24445613,299,0,0,1,2
24445316,24445614,298,0,0,1,1
24445614,24445683,69,1,0,0,2
24445615,24445676,61,1,0,0,1
24445677,24445796,119,0,0,1,1
24445684,24445798,114,0,0,1,2
24445797,24445816,19,1,0,0,1
24445799,24445817,18,1,0,0,2
24445817,24445976,159,0,0,1,1
24445818,24447993,2175,0,0,1,2
24445977,24445991,14,1,0,0,1
24445992,24447993,2001,0,0,1,1
24447994,24448023,29,1,0,0,2
24447994,24448028,34,1,0,0,1
24448024,24448394,370,0,0,1,2
24448029,24448396,367,0,0,1,1
24448395,24448459,64,1,0,0,2
24448397,24448460,63,1,0,0,1
24448460,24448588,128,0,0,1,2
24448461,24448588,127,0,0,1,1
24448589,24448610,21,1,0,0,1
24448589,24448611,22,1,0,0,2
24448611,24450043,1432,0,0,1,1
24448612,24448786,174,0,0,1,2
24448787,24448796,9,1,0,0,2
24448797,24450038,1241,0,0,1,2
24450039,24450053,14,1,0,0,2
24450044,24450053,9,1,0,0,1
24450054,24451316,1262,0,0,1,2
24450054,24451317,1263,0,0,1,1
24451317,24451379,62,1,0,0,2
24451318,24451373,55,1,0,0,1
24451374,24451593,219,0,0,1,1
24451380,24451595,215,0,0,1,2
24451594,24451632,38,1,0,0,1
24451596,24451631,35,1,0,0,2
24451632,24451714,82,0,0,1,2
24451633,24451714,81,0,0,1,1
24451715,24451756,41,1,0,0,1
24451715,24451757,42,1,0,0,2
24451757,24454083,2326,0,0,1,1
24451758,24454087,2329,0,0,1,2
24454084,24454100,16,1,0,0,1
24454088,24454094,6,1,0,0,2
24454095,24454561,466,0,0,1,2
24454101,24454562,461,0,0,1,1
24454562,24454694,132,1,0,0,2
24454563,24454776,213,1,0,0,1
24454695,24454816,121,0,0,1,2
24454777,24454817,40,0,0,1,1
24454817,24454832,15,1,0,0,2
24454818,24454835,17,1,0,0,1
24454833,24454998,165,0,0,1,2
24454836,24454998,162,0,0,1,1
24454999,24455016,17,1,0,0,2
24454999,24455024,25,1,0,0,1
24455017,24455940,923,0,0,1,2
24455025,24457050,2025,0,0,1,1
24455941,24455956,15,1,0,0,2
24455957,24457048,1091,0,0,1,2
24457049,24457056,7,1,0,0,2
24457051,24457065,14,1,0,0,1
24457057,24457197,140,0,0,1,2
24457066,24457198,132,0,0,1,1
24457198,24457268,70,1,0,0,2
24457199,24457251,52,1,0,0,1
24457252,24457578,326,0,0,1,1
24457269,24457580,311,0,0,1,2
24457579,24457626,47,1,0,0,1
24457581,24457628,47,1,0,0,2
24457627,24457788,161,0,0,1,1
24457629,24457786,157,0,0,1,2
24457787,24457804,17,1,0,0,2
24457789,24457803,14,1,0,0,1
24457804,24459753,1949,0,0,1,1
24457805,24459755,1950,0,0,1,2
24459754,24459832,78,1,0,0,1
24459756,24459834,78,1,0,0,2
24459833,24460229,396,0,0,1,1
24459835,24460225,390,0,0,1,2
24460226,24460283,57,1,0,0,2
24460230,24460281,51,1,0,0,1
24460282,24460394,112,0,0,1,1
24460284,24460396,112,0,0,1,2
24460395,24460425,30,1,0,0,1
24460397,24460418,21,1,0,0,2
24460419,24462291,1872,0,0,1,2
24460426,24460637,211,0,0,1,1
24460638,24460648,10,1,0,0,1
24460649,24461290,641,0,0,1,1
24461291,24461342,51,1,0,0,1
24461343,24462162,819,0,0,1,1
24462163,24462168,5,1,0,0,1
24462169,24462298,129,0,0,1,1
24462292,24463360,1068,1,0,0,2
24462299,24463390,1091,1,0,0,1
24462316,24463349,1033,0,1,0,2
24462322,24463379,1057,0,1,0,1
24463361,24463456,95,0,0,1,2
24463391,24463462,71,0,0,1,1
24463457,24463629,172,1,0,0,2
24463463,24463621,158,1,0,0,1
24463479,24463581,102,0,1,0,2
24463481,24463589,108,0,1,0,1
24463622,24463741,119,0,0,1,1
24463630,24463741,111,0,0,1,2
24463742,24463759,17,1,0,0,1
24463742,24463761,19,1,0,0,2
24463760,24464917,1157,0,0,1,1
24463762,24464667,905,0,0,1,2
24464668,24464676,8,1,0,0,2
24464677,24465118,441,0,0,1,2
24464918,24464926,8,1,0,0,1
24464927,24465119,192,0,0,1,1
24465119,24465168,49,1,0,0,2
24465120,24465168,48,1,0,0,1
24465169,24465316,147,0,0,1,1
24465169,24465317,148,0,0,1,2
24465317,24465342,25,1,0,0,1
24465318,24465343,25,1,0,0,2
24465343,24467325,1982,0,0,1,1
24465344,24467327,1983,0,0,1,2
24467326,24467387,61,1,0,0,1
24467328,24467388,60,1,0,0,2
24467388,24467711,323,0,0,1,1
24467389,24467701,312,0,0,1,2
24467702,24467922,220,1,0,0,2
24467712,24467908,196,1,0,0,1
24467722,24467862,140,0,1,0,2
24467733,24467847,114,0,1,0,1
24467909,24468613,704,0,0,1,1
24467923,24468614,691,0,0,1,2
24468614,24468649,35,1,0,0,1
24468615,24468647,32,1,0,0,2
24468648,24468791,143,0,0,1,2
24468650,24468791,141,0,0,1,1
24468792,24468807,15,1,0,0,1
24468792,24468810,18,1,0,0,2
24468808,24469019,211,0,0,1,1
24468811,24469023,212,0,0,1,2
24469020,24469219,199,1,0,0,1
24469024,24469237,213,1,0,0,2
24469054,24469169,115,0,1,0,2
24469055,24469168,113,0,1,0,1
24469220,24469376,156,0,0,1,1
24469238,24469372,134,0,0,1,2
24469373,24469388,15,1,0,0,2
24469377,24469388,11,1,0,0,1
24469389,24470058,669,0,0,1,2
24469389,24470060,671,0,0,1,1
24470059,24470127,68,1,0,0,2
24470061,24470127,66,1,0,0,1
24470128,24470604,476,0,0,1,1
24470128,24470605,477,0,0,1,2
24470605,24470622,17,1,0,0,1
24470606,24470621,15,1,0,0,2
24470622,24472413,1791,0,0,1,2
24470623,24472412,1789,0,0,1,1
24472413,24472462,49,1,0,0,1
24472414,24472462,48,1,0,0,2
24472463,24473481,1018,0,0,1,1
24472463,24473484,1021,0,0,1,2
24473482,24474006,524,1,0,0,1
24473485,24473983,498,1,0,0,2
24473538,24473880,342,0,1,0,2
24473538,24473903,365,0,1,0,1
24473984,24475028,1044,0,0,1,2
24474007,24475024,1017,0,0,1,1
24475025,24475088,63,1,0,0,1
24475029,24475088,59,1,0,0,2
24475089,24475246,157,0,0,1,1
24475089,24475247,158,0,0,1,2
24475247,24475275,28,1,0,0,1
24475248,24475271,23,1,0,0,2
24475272,24477054,1782,0,0,1,2
24475276,24477046,1770,0,0,1,1
24477047,24477508,461,1,0,0,1
24477055,24477431,376,1,0,0,2
24477079,24477444,365,0,1,0,1
24477086,24477415,329,0,1,0,2
24477432,24478223,791,0,0,1,2
24477509,24478223,714,0,0,1,1
24478224,24478264,40,1,0,0,1
24478224,24478264,40,1,0,0,2
24478265,24478501,236,0,0,1,2
24478265,24478503,238,0,0,1,1
24478502,24478551,49,1,0,0,2
24478504,24478546,42,1,0,0,1
24478547,24478872,325,0,0,1,1
24478552,24478879,327,0,0,1,2
24478873,24479101,228,1,0,0,1
24478880,24479110,230,1,0,0,2
24478902,24479019,117,0,1,0,2
24478905,24479046,141,0,1,0,1
24479102,24479133,31,0,0,1,1
24479111,24480675,1564,0,0,1,2
24479134,24479175,41,1,0,0,1
24479176,24480672,1496,0,0,1,1
24480673,24480740,67,1,0,0,1
24480676,24480742,66,1,0,0,2
24480741,24480869,128,0,0,1,1
24480743,24480878,135,0,0,1,2
24480870,24480919,49,1,0,0,1
24480879,24480903,24,1,0,0,2
24480904,24482703,1799,0,0,1,2
24480920,24482703,1783,0,0,1,1
24482704,24482790,86,1,0,0,1
24482704,24482798,94,1,0,0,2
24482791,24483245,454,0,0,1,1
24482799,24483245,446,0,0,1,2
24483246,24483297,51,1,0,0,1
24483246,24483300,54,1,0,0,2
24483298,24483984,686,0,0,1,1
24483301,24483984,683,0,0,1,2
24483985,24484105,120,1,0,0,2
24483985,24484126,141,1,0,0,1
24484106,24484177,71,0,0,1,2
24484127,24484178,51,0,0,1,1
24484178,24484213,35,1,0,0,2
24484179,24484227,48,1,0,0,1
24484214,24484313,99,0,0,1,2
24484228,24484308,80,0,0,1,1
24484309,24484341,32,1,0,0,1
24484314,24484348,34,1,0,0,2
24484342,24484460,118,0,0,1,1
24484349,24484476,127,0,0,1,2
24484461,24485614,1153,1,0,0,1
24484477,24484959,482,1,0,0,2
24484488,24485023,535,0,1,0,1
24484504,24484816,312,0,1,0,2
24484960,24485362,402,0,0,1,2
24485363,24485401,38,1,0,0,2
24485402,24485776,374,0,0,1,2
24485615,24485642,27,0,0,1,1
24485643,24485692,49,1,0,0,1
24485693,24485713,20,0,0,1,1
24485714,24488331,2617,1,0,0,1
24485777,24487002,1225,1,0,0,2
24486126,24486127,1,0,1,0,1
24486153,24486176,23,0,1,0,1
24486208,24486227,19,0,1,0,2
24486261,24486262,1,0,1,0,2
24486300,24486992,692,0,1,0,2
24486323,24487860,1537,0,1,0,1
24487003,24487107,104,0,0,1,2
24487108,24487138,30,1,0,0,2
24487139,24487218,79,0,0,1,2
24487219,24487235,16,1,0,0,2
24487236,24487284,48,0,0,1,2
24487285,24487301,16,1,0,0,2
24487302,24487584,282,0,0,1,2
24487585,24487600,15,1,0,0,2
24487601,24487705,104,0,0,1,2
24487706,24487722,16,1,0,0,2
24487723,24487942,219,0,0,1,2
24487921,24488098,177,0,1,0,1
24487943,24488053,110,1,0,0,2
24488054,24488168,114,0,0,1,2
24488127,24488186,59,0,1,0,1
24488169,24488334,165,1,0,0,2
24488181,24488267,86,0,1,0,2
24488254,24488275,21,0,1,0,1
24488332,24490102,1770,0,0,1,1
24488335,24490103,1768,0,0,1,2
24490103,24490162,59,1,0,0,1
24490104,24490162,58,1,0,0,2
24490163,24490288,125,0,0,1,1
24490163,24490290,127,0,0,1,2
24490289,24490384,95,1,0,0,1
24490291,24490406,115,1,0,0,2
24490385,24490498,113,0,0,1,1
24490407,24490498,91,0,0,1,2
24490499,24490520,21,1,0,0,1
24490499,24490543,44,1,0,0,2
24490521,24492154,1633,0,0,1,1
24490544,24491866,1322,0,0,1,2
24491867,24491929,62,1,0,0,2
24491930,24492067,137,0,0,1,2
24492068,24492250,182,1,0,0,2
24492155,24494858,2703,1,0,0,1
24492199,24494574,2375,0,1,0,1
24492251,24492325,74,0,0,1,2
24492326,24492343,17,1,0,0,2
24492344,24492371,27,0,0,1,2
24492372,24493073,701,1,0,0,2
24493074,24493153,79,0,0,1,2
24493154,24493165,11,1,0,0,2
24493166,24493913,747,0,0,1,2
24493914,24493963,49,1,0,0,2
24493964,24494048,84,0,0,1,2
24494049,24494697,648,1,0,0,2
24494061,24494591,530,0,1,0,2
24494698,24495186,488,0,0,1,2
24494859,24495186,327,0,0,1,1
24495187,24495236,49,1,0,0,2
24495187,24495266,79,1,0,0,1
24495237,24495615,378,0,0,1,2
24495267,24495505,238,0,0,1,1
24495506,24495683,177,1,0,0,1
24495616,24495687,71,1,0,0,2
24495684,24495795,111,0,0,1,1
24495688,24495795,107,0,0,1,2
24495796,24495822,26,1,0,0,2
24495796,24495823,27,1,0,0,1
24495823,24497328,1505,0,0,1,2
24495824,24497330,1506,0,0,1,1
24497329,24497365,36,1,0,0,2
24497331,24497368,37,1,0,0,1
24497366,24497985,619,0,0,1,2
24497369,24497986,617,0,0,1,1
24497986,24498010,24,1,0,0,2
24497987,24498022,35,1,0,0,1
24498011,24499421,1410,0,0,1,2
24498023,24499426,1403,0,0,1,1
24499422,24499794,372,1,0,0,2
24499427,24499746,319,1,0,0,1
24499447,24499683,236,0,1,0,2
24499450,24499665,215,0,1,0,1
24499747,24500357,610,0,0,1,1
24499795,24500358,563,0,0,1,2
24500358,24500401,43,1,0,0,1
24500359,24500398,39,1,0,0,2
24500399,24500901,502,0,0,1,2
24500402,24500899,497,0,0,1,1
24500900,24500947,47,1,0,0,1
24500902,24500950,48,1,0,0,2
24500948,24501062,114,0,0,1,1
24500951,24501064,113,0,0,1,2
24501063,24501088,25,1,0,0,1
24501065,24501090,25,1,0,0,2
24501089,24501406,317,0,0,1,1
24501091,24501401,310,0,0,1,2
24501402,24501633,231,1,0,0,2
24501407,24501602,195,1,0,0,1
24501429,24501520,91,0,1,0,1
24501430,24501545,115,0,1,0,2
24501603,24503251,1648,0,0,1,1
24501634,24503253,1619,0,0,1,2
24503252,24503313,61,1,0,0,1
24503254,24503314,60,1,0,0,2
24503314,24503677,363,0,0,1,1
24503315,24503672,357,0,0,1,2
24503673,24503690,17,1,0,0,2
24503678,24503690,12,1,0,0,1
24503691,24505434,1743,0,0,1,2
24503691,24505436,1745,0,0,1,1
24505435,24505750,315,1,0,0,2
24505437,24505711,274,1,0,0,1
24505482,24505617,135,0,1,0,1
24505482,24505650,168,0,1,0,2
24505712,24506550,838,0,0,1,1
24505751,24506550,799,0,0,1,2
24506551,24506590,39,1,0,0,1
24506551,24506590,39,1,0,0,2
24506591,24507015,424,0,0,1,1
24506591,24507018,427,0,0,1,2
24507016,24507054,38,1,0,0,1
24507019,24507052,33,1,0,0,2
24507053,24507175,122,0,0,1,2
24507055,24507173,118,0,0,1,1
24507174,24507199,25,1,0,0,1
24507176,24507199,23,1,0,0,2
24507200,24507444,244,0,0,1,2
24507200,24507448,248,0,0,1,1
24507445,24507791,346,1,0,0,2
24507449,24507799,350,1,0,0,1
24507468,24507648,180,0,1,0,2
24507471,24507618,147,0,1,0,1
24507792,24508467,675,0,0,1,2
24507800,24508466,666,0,0,1,1
24508467,24508505,38,1,0,0,1
24508468,24508507,39,1,0,0,2
24508506,24509742,1236,0,0,1,1
24508508,24509742,1234,0,0,1,2
24509743,24509761,18,1,0,0,1
24509743,24509761,18,1,0,0,2
24509762,24510468,706,0,0,1,2
24509762,24510472,710,0,0,1,1
24510469,24510846,377,1,0,0,2
24510473,24510815,342,1,0,0,1
24510503,24510692,189,0,1,0,1
24510505,24510711,206,0,1,0,2
24510816,24510867,51,0,0,1,1
24510847,24511737,890,0,0,1,2
24510868,24510878,10,1,0,0,1
24510879,24511738,859,0,0,1,1
24511738,24511780,42,1,0,0,2
24511739,24511778,39,1,0,0,1
24511779,24512121,342,0,0,1,1
24511781,24512119,338,0,0,1,2
24512120,24512194,74,1,0,0,2
24512122,24512185,63,1,0,0,1
24512186,24512351,165,0,0,1,1
24512195,24512354,159,0,0,1,2
24512352,24512388,36,1,0,0,1
24512355,24512407,52,1,0,0,2
24512389,24512478,89,0,0,1,1
24512408,24512539,131,0,0,1,2
24512479,24512494,15,1,0,0,1
24512495,24512548,53,0,0,1,1
24512540,24512564,24,1,0,0,2
24512549,24512564,15,1,0,0,1
24512565,24513404,839,0,0,1,1
24512565,24513678,1113,0,0,1,2
24513405,24513415,10,1,0,0,1
24513416,24513989,573,0,0,1,1
24513679,24513784,105,1,0,0,2
24513785,24513825,40,0,0,1,2
24513826,24513883,57,1,0,0,2
24513884,24513919,35,0,0,1,2
24513920,24514252,332,1,0,0,2
24513990,24514147,157,1,0,0,1
24514148,24514181,33,0,0,1,1
24514182,24515224,1042,1,0,0,1
24514253,24514294,41,0,0,1,2
24514295,24514359,64,1,0,0,2
24514360,24514477,117,0,0,1,2
24514478,24514487,9,1,0,0,2
24514488,24514549,61,0,0,1,2
24514550,24514685,135,1,0,0,2
24514686,24514732,46,0,0,1,2
24514733,24514749,16,1,0,0,2
24514750,24515783,1033,0,0,1,2
24515225,24515349,124,0,0,1,1
24515350,24515452,102,1,0,0,1
24515453,24515534,81,0,0,1,1
24515535,24515627,92,1,0,0,1
24515628,24515681,53,0,0,1,1
24515682,24515724,42,1,0,0,1
24515725,24515755,30,0,0,1,1
24515756,24516667,911,1,0,0,1
24515784,24515843,59,1,0,0,2
24515844,24516113,269,0,0,1,2
24516114,24516153,39,1,0,0,2
24516154,24516338,184,0,0,1,2
24516339,24516367,28,1,0,0,2
24516368,24516606,238,0,0,1,2
24516607,24516695,88,1,0,0,2
24516668,24516849,181,0,0,1,1
24516696,24516851,155,0,0,1,2
24516850,24516911,61,1,0,0,1
24516852,24516923,71,1,0,0,2
24516912,24517092,180,0,0,1,1
24516924,24517093,169,0,0,1,2
24517093,24517153,60,1,0,0,1
24517094,24517113,19,1,0,0,2
24517114,24517471,357,0,0,1,2
24517154,24517244,90,0,0,1,1
24517245,24517264,19,1,0,0,1
24517265,24517294,29,0,0,1,1
24517295,24517368,73,1,0,0,1
24517369,24517469,100,0,0,1,1
24517470,24517517,47,1,0,0,1
24517472,24517518,46,1,0,0,2
24517518,24517683,165,0,0,1,1
24517519,24517680,161,0,0,1,2
24517681,24517751,70,1,0,0,2
24517684,24517751,67,1,0,0,1
24517752,24517878,126,0,0,1,2
24517752,24517884,132,0,0,1,1
24517879,24517896,17,1,0,0,2
24517885,24517900,15,1,0,0,1
24517897,24518838,941,0,0,1,2
24517901,24518839,938,0,0,1,1
24518839,24518859,20,1,0,0,2
24518840,24518852,12,1,0,0,1
24518853,24519734,881,0,0,1,1
24518860,24519732,872,0,0,1,2
24519733,24519841,108,1,0,0,2
24519735,24519843,108,1,0,0,1
24519842,24520061,219,0,0,1,2
24519844,24520060,216,0,0,1,1
24520061,24520081,20,1,0,0,1
24520062,24520088,26,1,0,0,2
24520082,24521793,1711,0,0,1,1
24520089,24521793,1704,0,0,1,2
24521794,24522250,456,1,0,0,2
24521794,24522265,471,1,0,0,1
24521844,24522209,365,0,1,0,1
24521848,24522148,300,0,1,0,2
24522251,24523408,1157,0,0,1,2
24522266,24523404,1138,0,0,1,1
24523405,24523439,34,1,0,0,1
24523409,24523433,24,1,0,0,2
24523434,24523770,336,0,0,1,2
24523440,24523769,329,0,0,1,1
24523770,24524099,329,1,0,0,1
24523771,24523859,88,1,0,0,2
24523860,24523972,112,0,0,1,2
24523973,24523999,26,1,0,0,2
24524000,24524157,157,0,0,1,2
24524100,24524157,57,0,0,1,1
24524158,24524167,9,1,0,0,1
24524158,24524167,9,1,0,0,2
24524168,24524327,159,0,0,1,1
24524168,24524328,160,0,0,1,2
24524328,24524342,14,1,0,0,1
24524329,24524339,10,1,0,0,2
24524340,24525286,946,0,0,1,2
24524343,24525362,1019,0,0,1,1
24525287,24525327,40,1,0,0,2
24525328,24525353,25,0,0,1,2
24525354,24525368,14,1,0,0,2
24525363,24525377,14,1,0,0,1
24525369,24525598,229,0,0,1,2
24525378,24525526,148,0,0,1,1
24525527,24525545,18,1,0,0,1
24525546,24525614,68,0,0,1,1
24525599,24525664,65,1,0,0,2
24525615,24525752,137,1,0,0,1
24525665,24526682,1017,0,0,1,2
24525753,24526009,256,0,0,1,1
24526010,24526052,42,1,0,0,1
24526053,24526129,76,0,0,1,1
24526130,24526140,10,1,0,0,1
24526141,24526550,409,0,0,1,1
24526551,24526653,102,1,0,0,1
24526654,24526758,104,0,0,1,1
24526683,24526751,68,1,0,0,2
24526752,24526872,120,0,0,1,2
24526759,24526891,132,1,0,0,1
24526873,24527502,629,1,0,0,2
24526892,24526945,53,0,0,1,1
24526946,24527022,76,1,0,0,1
24527023,24527075,52,0,0,1,1
24527076,24527261,185,1,0,0,1
24527262,24527306,44,0,0,1,1
24527307,24528216,909,1,0,0,1
24527503,24527528,25,0,0,1,2
24527529,24528233,704,1,0,0,2
24527719,24528129,410,0,1,0,1
24527733,24528080,347,0,1,0,2
24528217,24528402,185,0,0,1,1
24528234,24528308,74,0,0,1,2
24528309,24528329,20,1,0,0,2
24528330,24528401,71,0,0,1,2
24528402,24528462,60,1,0,0,2
24528403,24528457,54,1,0,0,1
24528458,24529612,1154,0,0,1,1
24528463,24529611,1148,0,0,1,2
24529612,24529700,88,1,0,0,2
24529613,24529684,71,1,0,0,1
24529685,24529753,68,0,0,1,1
24529701,24529814,113,0,0,1,2
24529754,24530921,1167,1,0,0,1
24529815,24529865,50,1,0,0,2
24529866,24530222,356,0,0,1,2
24530223,24530260,37,1,0,0,2
24530261,24530630,369,0,0,1,2
24530631,24530642,11,1,0,0,2
24530643,24531862,1219,0,0,1,2
24530922,24531049,127,0,0,1,1
24531050,24531054,4,1,0,0,1
24531055,24531150,95,0,0,1,1
24531151,24531207,56,1,0,0,1
24531208,24531284,76,0,0,1,1
24531285,24532532,1247,1,0,0,1
24531863,24531867,4,1,0,0,2
24531868,24532323,455,0,0,1,2
24532324,24532427,103,1,0,0,2
24532428,24534400,1972,0,0,1,2
24532533,24532590,57,0,0,1,1
24532591,24532639,48,1,0,0,1
24532640,24532721,81,0,0,1,1
24532722,24532817,95,1,0,0,1
24532818,24533121,303,0,0,1,1
24533122,24533270,148,1,0,0,1
24533271,24533301,30,0,0,1,1
24533302,24533374,72,1,0,0,1
24533375,24533470,95,0,0,1,1
24533471,24533485,14,1,0,0,1
24533486,24533520,34,0,0,1,1
24533521,24533665,144,1,0,0,1
24533666,24533903,237,0,0,1,1
24533904,24533919,15,1,0,0,1
24533920,24533955,35,0,0,1,1
24533956,24534020,64,1,0,0,1
24534021,24534252,231,0,0,1,1
24534253,24534258,5,1,0,0,1
24534259,24534381,122,0,0,1,1
24534382,24534438,56,1,0,0,1
24534401,24534418,17,1,0,0,2
24534419,24534639,220,0,0,1,2
24534439,24534636,197,0,0,1,1
24534637,24534699,62,1,0,0,1
24534640,24534691,51,1,0,0,2
24534692,24534805,113,0,0,1,2
24534700,24534809,109,0,0,1,1
24534806,24534851,45,1,0,0,2
24534810,24534839,29,1,0,0,1
24534840,24535279,439,0,0,1,1
24534852,24535277,425,0,0,1,2
24535278,24535302,24,1,0,0,2
24535280,24535304,24,1,0,0,1
24535303,24536139,836,0,0,1,2
24535305,24536137,832,0,0,1,1
24536138,24536201,63,1,0,0,1
24536140,24536204,64,1,0,0,2
24536202,24537761,1559,0,0,1,1
24536205,24536348,143,0,0,1,2
24536349,24536362,13,1,0,0,2
24536363,24537757,1394,0,0,1,2
24537758,24537887,129,1,0,0,2
24537762,24537957,195,1,0,0,1
24537888,24538899,1011,0,0,1,2
24537958,24538001,43,0,0,1,1
24538002,24538111,109,1,0,0,1
24538112,24538136,24,0,0,1,1
24538137,24538258,121,1,0,0,1
24538259,24538283,24,0,0,1,1
24538284,24538994,710,1,0,0,1
24538900,24539015,115,1,0,0,2
24538995,24539317,322,0,0,1,1
24539016,24539108,92,0,0,1,2
24539109,24539130,21,1,0,0,2
24539131,24539259,128,0,0,1,2
24539260,24539289,29,1,0,0,2
24539290,24539317,27,0,0,1,2
24539318,24539393,75,1,0,0,1
24539318,24539398,80,1,0,0,2
24539394,24539508,114,0,0,1,1
24539399,24539507,108,0,0,1,2
24539508,24539574,66,1,0,0,2
24539509,24539557,48,1,0,0,1
24539558,24540536,978,0,0,1,1
24539575,24540537,962,0,0,1,2
24540537,24540576,39,1,0,0,1
24540538,24540575,37,1,0,0,2
24540576,24540717,141,0,0,1,2
24540577,24540715,138,0,0,1,1
24540716,24540734,18,1,0,0,1
24540718,24540733,15,1,0,0,2
24540734,24543274,2540,0,0,1,2
24540735,24541682,947,0,0,1,1
24541683,24541692,9,1,0,0,1
24541693,24543273,1580,0,0,1,1
24543274,24543326,52,1,0,0,1
24543275,24543325,50,1,0,0,2
24543326,24543695,369,0,0,1,2
24543327,24543697,370,0,0,1,1
24543696,24543700,4,1,0,0,2
24543698,24543714,16,1,0,0,1
24543701,24544208,507,0,0,1,2
24543715,24544201,486,0,0,1,1
24544202,24544220,18,1,0,0,1
24544209,24544222,13,1,0,0,2
24544221,24544632,411,0,0,1,1
24544223,24544638,415,0,0,1,2
24544633,24544653,20,1,0,0,1
24544639,24544649,10,1,0,0,2
24544650,24545448,798,0,0,1,2
24544654,24545443,789,0,0,1,1
24545444,24545459,15,1,0,0,1
24545449,24545462,13,1,0,0,2
24545460,24547266,1806,0,0,1,1
24545463,24547266,1803,0,0,1,2
24547267,24547360,93,1,0,0,2
24547267,24547371,104,1,0,0,1
24547361,24547455,94,0,0,1,2
24547372,24547455,83,0,0,1,1
24547456,24547481,25,1,0,0,2
24547456,24547494,38,1,0,0,1
24547482,24549085,1603,0,0,1,2
24547495,24547932,437,0,0,1,1
24547933,24547944,11,1,0,0,1
24547945,24549270,1325,0,0,1,1
24549086,24549096,10,1,0,0,2
24549097,24549271,174,0,0,1,2
24549271,24549281,10,1,0,0,1
24549272,24549282,10,1,0,0,2
24549282,24550211,929,0,0,1,1
24549283,24550211,928,0,0,1,2
24550212,24550280,68,1,0,0,1
24550212,24550321,109,1,0,0,2
24550281,24550714,433,0,0,1,1
24550322,24550713,391,0,0,1,2
24550714,24550728,14,1,0,0,2
24550715,24550727,12,1,0,0,1
24550728,24551126,398,0,0,1,1
24550729,24551128,399,0,0,1,2
24551127,24551158,31,1,0,0,1
24551129,24551169,40,1,0,0,2
24551159,24551750,591,0,0,1,1
24551170,24551748,578,0,0,1,2
24551749,24551768,19,1,0,0,2
24551751,24551768,17,1,0,0,1
24551769,24552209,440,0,0,1,1
24551769,24552209,440,0,0,1,2
24552210,24552418,208,1,0,0,2
24552210,24552466,256,1,0,0,1
24552419,24552889,470,0,0,1,2
24552467,24552889,422,0,0,1,1
24552890,24552931,41,1,0,0,1
24552890,24552932,42,1,0,0,2
24552932,24553890,958,0,0,1,1
24552933,24553891,958,0,0,1,2
24553891,24553965,74,1,0,0,1
24553892,24553954,62,1,0,0,2
24553955,24554066,111,0,0,1,2
24553966,24554065,99,0,0,1,1
24554066,24554094,28,1,0,0,1
24554067,24554093,26,1,0,0,2
24554094,24554235,141,0,0,1,2
24554095,24555806,1711,0,0,1,1
24554236,24554254,18,1,0,0,2
24554255,24555581,1326,0,0,1,2
24555582,24555673,91,1,0,0,2
24555674,24555808,134,0,0,1,2
24555807,24555912,105,1,0,0,1
24555809,24555863,54,1,0,0,2
24555864,24557607,1743,0,0,1,2
24555913,24557610,1697,0,0,1,1
24557608,24557667,59,1,0,0,2
24557611,24557655,44,1,0,0,1
24557656,24558236,580,0,0,1,1
24557668,24558265,597,0,0,1,2
24558237,24558376,139,1,0,0,1
24558266,24558292,26,1,0,0,2
24558293,24558635,342,0,0,1,2
24558377,24558526,149,0,0,1,1
24558527,24558592,65,1,0,0,1
24558593,24558633,40,0,0,1,1
24558634,24558680,46,1,0,0,1
24558636,24558671,35,1,0,0,2
24558672,24558936,264,0,0,1,2
24558681,24558728,47,0,0,1,1
24558729,24558761,32,1,0,0,1
24558762,24558917,155,0,0,1,1
24558918,24559322,404,1,0,0,1
24558937,24559363,426,1,0,0,2
24558963,24559228,265,0,1,0,2
24558966,24559171,205,0,1,0,1
24559323,24559531,208,0,0,1,1
24559364,24559533,169,0,0,1,2
24559532,24559611,79,1,0,0,1
24559534,24559602,68,1,0,0,2
24559603,24559719,116,0,0,1,2
24559612,24559715,103,0,0,1,1
24559716,24559762,46,1,0,0,1
24559720,24559734,14,1,0,0,2
24559735,24560048,313,0,0,1,2
24559763,24559865,102,0,0,1,1
24559866,24559920,54,1,0,0,1
24559921,24559992,71,0,0,1,1
24559993,24560020,27,1,0,0,1
24560021,24560073,52,0,0,1,1
24560049,24560053,4,1,0,0,2
24560054,24560101,47,0,0,1,2
24560074,24560287,213,1,0,0,1
24560102,24560208,106,1,0,0,2
24560209,24560242,33,0,0,1,2
24560243,24560265,22,1,0,0,2
24560266,24560319,53,0,0,1,2
24560288,24560308,20,0,0,1,1
24560309,24560338,29,1,0,0,1
24560320,24560672,352,1,0,0,2
24560339,24560396,57,0,0,1,1
24560397,24563140,2743,1,0,0,1
24560673,24560738,65,0,0,1,2
24560739,24560778,39,1,0,0,2
24560779,24560884,105,0,0,1,2
24560885,24560948,63,1,0,0,2
24560949,24561063,114,0,0,1,2
24561064,24561091,27,1,0,0,2
24561092,24561126,34,0,0,1,2
24561127,24561260,133,1,0,0,2
24561199,24561200,1,0,1,0,1
24561261,24562021,760,0,0,1,2
24562022,24562075,53,1,0,0,2
24562076,24562743,667,0,0,1,2
24562744,24562768,24,1,0,0,2
24562769,24562855,86,0,0,1,2
24562856,24562861,5,1,0,0,2
24562862,24562913,51,0,0,1,2
24562914,24563060,146,1,0,0,2
24563061,24563312,251,0,0,1,2
24563141,24563161,20,0,0,1,1
24563162,24563466,304,1,0,0,1
24563313,24563402,89,1,0,0,2
24563403,24563463,60,0,0,1,2
24563464,24563525,61,1,0,0,2
24563467,24563612,145,0,0,1,1
24563526,24563707,181,0,0,1,2
24563613,24563663,50,1,0,0,1
24563664,24563716,52,0,0,1,1
24563708,24564552,844,1,0,0,2
24563717,24564740,1023,1,0,0,1
24563792,24564239,447,0,1,0,1
24563798,24564193,395,0,1,0,2
24564553,24564795,242,0,0,1,2
24564741,24564794,53,0,0,1,1
24564795,24568231,3436,1,0,0,1
24564796,24564880,84,1,0,0,2
24564881,24564971,90,0,0,1,2
24564972,24564998,26,1,0,0,2
24564999,24566131,1132,0,0,1,2
24566132,24566136,4,1,0,0,2
24566137,24566595,458,0,0,1,2
24566596,24566609,13,1,0,0,2
24566610,24566871,261,0,0,1,2
24566872,24566994,122,1,0,0,2
24566995,24567250,255,0,0,1,2
24567251,24567262,11,1,0,0,2
24567263,24567342,79,0,0,1,2
24567343,24567407,64,1,0,0,2
24567408,24567500,92,0,0,1,2
24567501,24567577,76,1,0,0,2
24567578,24567662,84,0,0,1,2
24567663,24567683,20,1,0,0,2
24567684,24567766,82,0,0,1,2
24567767,24567856,89,1,0,0,2
24567857,24567898,41,0,0,1,2
24567899,24568385,486,1,0,0,2
24568232,24568268,36,0,0,1,1
24568269,24568344,75,1,0,0,1
24568345,24568396,51,0,0,1,1
24568386,24568407,21,0,0,1,2
24568397,24568481,84,1,0,0,1
24568408,24568452,44,1,0,0,2
24568453,24568579,126,0,0,1,2
24568482,24568854,372,0,0,1,1
24568580,24568639,59,1,0,0,2
24568640,24568716,76,0,0,1,2
24568717,24568754,37,1,0,0,2
24568755,24568795,40,0,0,1,2
24568796,24569059,263,1,0,0,2
24568855,24568876,21,1,0,0,1
24568877,24568961,84,0,0,1,1
24568962,24569025,63,1,0,0,1
24569026,24569141,115,0,0,1,1
24569060,24569177,117,0,0,1,2
24569142,24569214,72,1,0,0,1
24569178,24569489,311,1,0,0,2
24569215,24569444,229,0,0,1,1
24569445,24569464,19,1,0,0,1
24569465,24569603,138,0,0,1,1
24569490,24569535,45,0,0,1,2
24569536,24569665,129,1,0,0,2
24569604,24569704,100,1,0,0,1
24569666,24569718,52,0,0,1,2
24569705,24570032,327,0,0,1,1
24569719,24570166,447,1,0,0,2
24570033,24570199,166,1,0,0,1
24570053,24570103,50,0,1,0,2
24570167,24571451,1284,0,0,1,2
24570200,24571451,1251,0,0,1,1
24571452,24571475,23,1,0,0,2
24571452,24571487,35,1,0,0,1
24571476,24571860,384,0,0,1,2
24571488,24571857,369,0,0,1,1
24571858,24571937,79,1,0,0,1
24571861,24571934,73,1,0,0,2
24571935,24572056,121,0,0,1,2
24571938,24572057,119,0,0,1,1
24572057,24572087,30,1,0,0,2
24572058,24572077,19,1,0,0,1
24572078,24573088,1010,0,0,1,1
24572088,24572281,193,0,0,1,2
24572282,24572290,8,1,0,0,2
24572291,24572742,451,0,0,1,2
24572743,24572747,4,1,0,0,2
24572748,24573081,333,0,0,1,2
24573082,24573109,27,1,0,0,2
24573089,24573099,10,1,0,0,1
24573100,24573305,205,0,0,1,1
24573110,24573298,188,0,0,1,2
24573299,24573310,11,1,0,0,2
24573306,24573310,4,1,0,0,1
24573311,24574546,1235,0,0,1,1
24573311,24574548,1237,0,0,1,2
24574547,24574620,73,1,0,0,1
24574549,24574604,55,1,0,0,2
24574605,24576745,2140,0,0,1,2
24574621,24576743,2122,0,0,1,1
24576744,24576806,62,1,0,0,1
24576746,24576812,66,1,0,0,2
24576807,24578086,1279,0,0,1,1
24576813,24578088,1275,0,0,1,2
24578087,24578137,50,1,0,0,1
24578089,24578133,44,1,0,0,2
24578134,24578407,273,0,0,1,2
24578138,24578407,269,0,0,1,1
24578408,24578453,45,1,0,0,2
24578408,24578458,50,1,0,0,1
24578454,24578570,116,0,0,1,2
24578459,24578569,110,0,0,1,1
24578570,24578598,28,1,0,0,1
24578571,24578607,36,1,0,0,2
24578599,24579016,417,0,0,1,1
24578608,24580625,2017,0,0,1,2
24579017,24579030,13,1,0,0,1
24579031,24579266,235,0,0,1,1
24579267,24579280,13,1,0,0,1
24579281,24579426,145,0,0,1,1
24579427,24580074,647,1,0,0,1
24580075,24580113,38,0,0,1,1
24580114,24580289,175,1,0,0,1
24580290,24580409,119,0,0,1,1
24580410,24580457,47,1,0,0,1
24580458,24580569,111,0,0,1,1
24580570,24580646,76,1,0,0,1
24580626,24580631,5,1,0,0,2
24580632,24580841,209,0,0,1,2
24580647,24580700,53,0,0,1,1
24580701,24580891,190,1,0,0,1
24580842,24580918,76,1,0,0,2
24580892,24583096,2204,0,0,1,1
24580919,24583098,2179,0,0,1,2
24583097,24583168,71,1,0,0,1
24583099,24583165,66,1,0,0,2
24583166,24583270,104,0,0,1,2
24583169,24583269,100,0,0,1,1
24583270,24583669,399,1,0,0,1
24583271,24583639,368,1,0,0,2
24583305,24583526,221,0,1,0,2
24583306,24583506,200,0,1,0,1
24583640,24584724,1084,0,0,1,2
24583670,24584727,1057,0,0,1,1
24584725,24584749,24,1,0,0,2
24584728,24584750,22,1,0,0,1
24584750,24586143,1393,0,0,1,2
24584751,24586144,1393,0,0,1,1
24586144,24586200,56,1,0,0,2
24586145,24586200,55,1,0,0,1
24586201,24586788,587,0,0,1,2
24586201,24586789,588,0,0,1,1
24586789,24586826,37,1,0,0,2
24586790,24586827,37,1,0,0,1
24586827,24587687,860,0,0,1,2
24586828,24587686,858,0,0,1,1
24587687,24587712,25,1,0,0,1
24587688,24587710,22,1,0,0,2
24587711,24589535,1824,0,0,1,2
24587713,24589535,1822,0,0,1,1
24589536,24589617,81,1,0,0,1
24589536,24589627,91,1,0,0,2
24589618,24589745,127,0,0,1,1
24589628,24589744,116,0,0,1,2
24589745,24589792,47,1,0,0,2
24589746,24589794,48,1,0,0,1
24589793,24589936,143,0,0,1,2
24589795,24589925,130,0,0,1,1
24589926,24589960,34,1,0,0,1
24589937,24589949,12,1,0,0,2
24589950,24590484,534,0,0,1,2
24589961,24590126,165,0,0,1,1
24590127,24590131,4,1,0,0,1
24590132,24590251,119,0,0,1,1
24590252,24590278,26,1,0,0,1
24590279,24591184,905,0,0,1,1
24590485,24590490,5,1,0,0,2
24590491,24591179,688,0,0,1,2
24591180,24591234,54,1,0,0,2
24591185,24591240,55,1,0,0,1
24591235,24591483,248,0,0,1,2
24591241,24591941,700,0,0,1,1
24591484,24592098,614,1,0,0,2
24591942,24592118,176,1,0,0,1
24592099,24592181,82,0,0,1,2
24592119,24592214,95,0,0,1,1
24592182,24593368,1186,1,0,0,2
24592215,24592520,305,1,0,0,1
24592521,24592542,21,0,0,1,1
24592543,24593371,828,1,0,0,1
24592590,24592590,0,0,1,0,2
24592612,24592621,9,0,1,0,2
24592728,24592728,0,0,1,0,2
24592936,24592936,0,0,1,0,2
24593338,24593340,2,0,1,0,1
24593369,24593571,202,0,0,1,2
24593372,24593571,199,0,0,1,1
24593572,24593625,53,1,0,0,1
24593572,24593626,54,1,0,0,2
24593626,24594335,709,0,0,1,1
24593627,24594337,710,0,0,1,2
24594336,24594448,112,1,0,0,1
24594338,24594419,81,1,0,0,2
24594420,24594537,117,0,0,1,2
24594449,24594538,89,0,0,1,1
24594538,24594566,28,1,0,0,2
24594539,24594569,30,1,0,0,1
24594567,24595842,1275,0,0,1,2
24594570,24594718,148,0,0,1,1
24594719,24594740,21,1,0,0,1
24594741,24596311,1570,0,0,1,1
24595843,24595885,42,1,0,0,2
24595886,24596373,487,0,0,1,2
24596312,24596318,6,1,0,0,1
24596319,24597495,1176,0,0,1,1
24596374,24596877,503,1,0,0,2
24596878,24597005,127,0,0,1,2
24597006,24597010,4,1,0,0,2
24597011,24597137,126,0,0,1,2
24597138,24597153,15,1,0,0,2
24597154,24597267,113,0,0,1,2
24597268,24597287,19,1,0,0,2
24597288,24597327,39,0,0,1,2
24597328,24597438,110,1,0,0,2
24597439,24597496,57,0,0,1,2
24597496,24597552,56,1,0,0,1
24597497,24597571,74,1,0,0,2
24597553,24599592,2039,0,0,1,1
24597572,24599592,2020,0,0,1,2
24599593,24599708,115,1,0,0,1
24599593,24599725,132,1,0,0,2
24599709,24599740,31,0,0,1,1
24599726,24601139,1413,0,0,1,2
24599741,24599775,34,1,0,0,1
24599776,24601135,1359,0,0,1,1
24601136,24601184,48,1,0,0,1
24601140,24601191,51,1,0,0,2
24601185,24601520,335,0,0,1,1
24601192,24601530,338,0,0,1,2
24601521,24601944,423,1,0,0,1
24601531,24601833,302,1,0,0,2
24601554,24601783,229,0,1,0,1
24601556,24601770,214,0,1,0,2
24601834,24601876,42,0,0,1,2
24601877,24601891,14,1,0,0,2
24601892,24602451,559,0,0,1,2
24601945,24603489,1544,0,0,1,1
24602452,24602461,9,1,0,0,2
24602462,24603490,1028,0,0,1,2
24603490,24603542,52,1,0,0,1
24603491,24603543,52,1,0,0,2
24603543,24603779,236,0,0,1,1
24603544,24603785,241,0,0,1,2
24603780,24603798,18,1,0,0,1
24603786,24603791,5,1,0,0,2
24603792,24604448,656,0,0,1,2
24603799,24604448,649,0,0,1,1
24604449,24604467,18,1,0,0,1
24604449,24604470,21,1,0,0,2
24604468,24605730,1262,0,0,1,1
24604471,24605730,1259,0,0,1,2
24605731,24605840,109,1,0,0,2
24605731,24605858,127,1,0,0,1
24605841,24607004,1163,0,0,1,2
24605859,24607004,1145,0,0,1,1
24607005,24607049,44,1,0,0,2
24607005,24607050,45,1,0,0,1
24607050,24607169,119,0,0,1,2
24607051,24607174,123,0,0,1,1
24607170,24607194,24,1,0,0,2
24607175,24607190,15,1,0,0,1
24607191,24607336,145,0,0,1,1
24607195,24607333,138,0,0,1,2
24607334,24607348,14,1,0,0,2
24607337,24607348,11,1,0,0,1
24607349,24608322,973,0,0,1,2
24607349,24608670,1321,0,0,1,1
24608323,24608330,7,1,0,0,2
24608331,24608670,339,0,0,1,2
24608671,24608715,44,1,0,0,2
24608671,24608717,46,1,0,0,1
24608716,24611675,2959,0,0,1,2
24608718,24611674,2956,0,0,1,1
24611675,24611736,61,1,0,0,1
24611676,24611735,59,1,0,0,2
24611736,24612159,423,0,0,1,2
24611737,24612158,421,0,0,1,1
24612159,24612233,74,1,0,0,1
24612160,24612236,76,1,0,0,2
24612234,24612333,99,0,0,1,1
24612237,24612404,167,0,0,1,2
24612334,24612506,172,1,0,0,1
24612405,24612448,43,1,0,0,2
24612449,24612607,158,0,0,1,2
24612507,24612552,45,0,0,1,1
24612553,24612813,260,1,0,0,1
24612608,24612618,10,1,0,0,2
24612619,24613640,1021,0,0,1,2
24612814,24612848,34,0,0,1,1
24612849,24612862,13,1,0,0,1
24612863,24613014,151,0,0,1,1
24613015,24613200,185,1,0,0,1
24613201,24613236,35,0,0,1,1
24613237,24613559,322,1,0,0,1
24613560,24613599,39,0,0,1,1
24613600,24613885,285,1,0,0,1
24613641,24613688,47,1,0,0,2
24613689,24614062,373,0,0,1,2
24613886,24613957,71,0,0,1,1
24613958,24614231,273,1,0,0,1
24614063,24614094,31,1,0,0,2
24614095,24614139,44,0,0,1,2
24614140,24616642,2502,1,0,0,2
24614232,24614445,213,0,0,1,1
24614446,24614473,27,1,0,0,1
24614474,24614864,390,0,0,1,1
24614865,24614895,30,1,0,0,1
24614896,24615062,166,0,0,1,1
24615063,24615093,30,1,0,0,1
24615094,24615251,157,0,0,1,1
24615252,24615286,34,1,0,0,1
24615287,24615672,385,0,0,1,1
24615673,24615697,24,1,0,0,1
24615698,24615889,191,0,0,1,1
24615890,24615895,5,1,0,0,1
24615896,24615975,79,0,0,1,1
24615976,24616028,52,1,0,0,1
24616029,24616146,117,0,0,1,1
24616147,24616808,661,1,0,0,1
24616182,24616581,399,0,1,0,1
24616184,24616530,346,0,1,0,2
24616643,24616808,165,0,0,1,2
24616809,24616831,22,1,0,0,2
24616809,24617563,754,0,0,1,1
24616832,24618214,1382,0,0,1,2
24617564,24617579,15,1,0,0,1
24617580,24618213,633,0,0,1,1
24618214,24618277,63,1,0,0,1
24618215,24618278,63,1,0,0,2
24618278,24618393,115,0,0,1,1
24618279,24618393,114,0,0,1,2
24618394,24618418,24,1,0,0,1
24618394,24618422,28,1,0,0,2
24618419,24618574,155,0,0,1,1
24618423,24618574,151,0,0,1,2
24618575,24618586,11,1,0,0,1
24618575,24618586,11,1,0,0,2
24618587,24618758,171,0,0,1,2
24618587,24619599,1012,0,0,1,1
24618759,24618766,7,1,0,0,2
24618767,24619349,582,0,0,1,2
24619350,24619365,15,1,0,0,2
24619366,24619596,230,0,0,1,2
24619597,24619657,60,1,0,0,2
24619600,24619651,51,1,0,0,1
24619652,24619810,158,0,0,1,1
24619658,24619810,152,0,0,1,2
24619811,24619831,20,1,0,0,1
24619811,24619832,21,1,0,0,2
24619832,24620299,467,0,0,1,1
24619833,24620294,461,0,0,1,2
24620295,24620304,9,1,0,0,2
24620300,24620304,4,1,0,0,1
24620305,24621654,1349,0,0,1,2
24620305,24621655,1350,0,0,1,1
24621655,24621696,41,1,0,0,2
24621656,24621694,38,1,0,0,1
24621695,24622597,902,0,0,1,1
24621697,24622597,900,0,0,1,2
