start,end,duration,saccade,blink,fixation,eye
1263454,1263821,367,0,0,1,1
1263454,1263825,371,0,0,1,2
1263822,1263950,128,1,0,0,1
1263826,1263945,119,1,0,0,2
1263946,1264136,190,0,0,1,2
1263951,1264136,185,0,0,1,1
1264137,1264171,34,1,0,0,2
1264137,1264172,35,1,0,0,1
1264172,1264466,294,0,0,1,2
1264173,1264467,294,0,0,1,1
1264467,1264494,27,1,0,0,2
1264468,1264495,27,1,0,0,1
1264495,1267007,2512,0,0,1,2
1264496,1266989,2493,0,0,1,1
1266990,1267477,487,1,0,0,1
1267008,1267342,334,1,0,0,2
1267018,1267467,449,0,1,0,1
1267056,1267252,196,0,1,0,2
1267343,1267749,406,0,0,1,2
1267478,1267749,271,0,0,1,1
1267750,1267772,22,1,0,0,2
1267750,1267779,29,1,0,0,1
1267773,1267933,160,0,0,1,2
1267780,1267934,154,0,0,1,1
1267934,1267955,21,1,0,0,2
1267935,1267966,31,1,0,0,1
1267956,1269928,1972,0,0,1,2
1267967,1269929,1962,0,0,1,1
1269929,1269980,51,1,0,0,2
1269930,1269993,63,1,0,0,1
1269981,1270201,220,0,0,1,2
1269994,1270202,208,0,0,1,1
1270202,1270275,73,1,0,0,2
1270203,1270278,75,1,0,0,1
1270276,1270359,83,0,0,1,2
1270279,1270360,81,0,0,1,1
1270360,1270398,38,1,0,0,2
1270361,1270404,43,1,0,0,1
1270399,1272974,2575,0,0,1,2
1270405,1270662,257,0,0,1,1
1270663,1270675,12,1,0,0,1
1270676,1270840,164,0,0,1,1
1270841,1270861,20,1,0,0,1
1270862,1272971,2109,0,0,1,1
1272972,1273011,39,1,0,0,1
1272975,1273012,37,1,0,0,2
1273012,1273362,350,0,0,1,1
1273013,1273362,349,0,0,1,2
1273363,1273488,125,1,0,0,2
1273363,1273528,165,1,0,0,1
1273489,1273580,91,0,0,1,2
1273529,1273580,51,0,0,1,1
1273581,1273622,41,1,0,0,2
1273581,1273627,46,1,0,0,1
1273623,1274234,611,0,0,1,2
1273628,1274232,604,0,0,1,1
1274233,1274253,20,1,0,0,1
1274235,1274255,20,1,0,0,2
1274254,1276212,1958,0,0,1,1
1274256,1276212,1956,0,0,1,2
1276213,1276313,100,1,0,0,1
1276213,1276320,107,1,0,0,2
1276314,1276462,148,0,0,1,1
1276321,1276461,140,0,0,1,2
1276462,1276531,69,1,0,0,2
1276463,1276516,53,1,0,0,1
1276517,1276706,189,0,0,1,1
1276532,1276709,177,0,0,1,2
1276707,1276767,60,1,0,0,1
1276710,1276769,59,1,0,0,2
1276768,1276956,188,0,0,1,1
1276770,1276800,30,0,0,1,2
1276801,1276820,19,1,0,0,2
1276821,1276955,134,0,0,1,2
1276956,1276994,38,1,0,0,2
1276957,1276986,29,1,0,0,1
1276987,1278769,1782,0,0,1,1
1276995,1278771,1776,0,0,1,2
1278770,1278843,73,1,0,0,1
1278772,1278839,67,1,0,0,2
1278840,1278979,139,0,0,1,2
1278844,1278982,138,0,0,1,1
1278980,1279041,61,1,0,0,2
1278983,1279038,55,1,0,0,1
1279039,1279140,101,0,0,1,1
1279042,1279140,98,0,0,1,2
1279141,1279164,23,1,0,0,2
1279141,1279172,31,1,0,0,1
1279165,1279441,276,0,0,1,2
1279173,1279440,267,0,0,1,1
1279441,1279472,31,1,0,0,1
1279442,1279472,30,1,0,0,2
1279473,1279699,226,0,0,1,1
1279473,1279703,230,0,0,1,2
1279700,1279718,18,1,0,0,1
1279704,1279716,12,1,0,0,2
1279717,1280411,694,0,0,1,2
1279719,1280404,685,0,0,1,1
1280405,1280518,113,1,0,0,1
1280412,1280479,67,1,0,0,2
1280445,1280476,31,0,1,0,1
1280480,1281287,807,0,0,1,2
1280519,1281286,767,0,0,1,1
1281287,1281395,108,1,0,0,1
1281288,1281395,107,1,0,0,2
1281396,1281563,167,0,0,1,1
1281396,1281563,167,0,0,1,2
1281564,1281620,56,1,0,0,1
1281564,1281622,58,1,0,0,2
1281621,1281749,128,0,0,1,1
1281623,1281749,126,0,0,1,2
1281750,1281780,30,1,0,0,1
1281750,1281780,30,1,0,0,2
1281781,1281836,55,0,0,1,1
1281781,1281842,61,0,0,1,2
1281837,1282078,241,1,0,0,1
1281843,1282043,200,1,0,0,2
1281875,1282009,134,0,1,0,1
1281904,1281955,51,0,1,0,2
1282044,1282229,185,0,0,1,2
1282079,1282230,151,0,0,1,1
1282230,1282251,21,1,0,0,2
1282231,1282253,22,1,0,0,1
1282252,1283696,1444,0,0,1,2
1282254,1283693,1439,0,0,1,1
1283694,1283797,103,1,0,0,1
1283697,1283793,96,1,0,0,2
1283794,1284176,382,0,0,1,2
1283798,1284175,377,0,0,1,1
1284176,1284251,75,1,0,0,1
1284177,1284241,64,1,0,0,2
1284242,1284737,495,0,0,1,2
1284252,1284599,347,0,0,1,1
1284600,1284604,4,1,0,0,1
1284605,1284636,31,0,0,1,1
1284637,1284647,10,1,0,0,1
1284648,1284736,88,0,0,1,1
1284737,1284786,49,1,0,0,1
1284738,1284765,27,1,0,0,2
1284766,1284953,187,0,0,1,2
1284787,1284871,84,0,0,1,1
1284872,1284980,108,1,0,0,1
1284954,1284980,26,1,0,0,2
1284981,1285144,163,0,0,1,1
1284981,1286158,1177,0,0,1,2
1285145,1285249,104,1,0,0,1
1285250,1285335,85,0,0,1,1
1285336,1285356,20,1,0,0,1
1285357,1285438,81,0,0,1,1
1285439,1285474,35,1,0,0,1
1285475,1285656,181,0,0,1,1
1285657,1285713,56,1,0,0,1
1285714,1285794,80,0,0,1,1
1285795,1285822,27,1,0,0,1
1285823,1286158,335,0,0,1,1
1286159,1286233,74,1,0,0,2
1286159,1286237,78,1,0,0,1
1286234,1286351,117,0,0,1,2
1286238,1286350,112,0,0,1,1
1286351,1286409,58,1,0,0,1
1286352,1286417,65,1,0,0,2
1286410,1286561,151,0,0,1,1
1286418,1286560,142,0,0,1,2
1286561,1286583,22,1,0,0,2
1286562,1286584,22,1,0,0,1
1286584,1288514,1930,0,0,1,2
1286585,1288513,1928,0,0,1,1
1288514,1288561,47,1,0,0,1
1288515,1288571,56,1,0,0,2
1288562,1288690,128,0,0,1,1
1288572,1288690,118,0,0,1,2
1288691,1288721,30,1,0,0,1
1288691,1288723,32,1,0,0,2
1288722,1288938,216,0,0,1,1
1288724,1288937,213,0,0,1,2
1288938,1288970,32,1,0,0,2
1288939,1288960,21,1,0,0,1
1288961,1289654,693,0,0,1,1
1288971,1289653,682,0,0,1,2
1289654,1289674,20,1,0,0,2
1289655,1289672,17,1,0,0,1
1289673,1289854,181,0,0,1,1
1289675,1289853,178,0,0,1,2
1289854,1289875,21,1,0,0,2
1289855,1289877,22,1,0,0,1
1289876,1290254,378,0,0,1,2
1289878,1290258,380,0,0,1,1
1290255,1290274,19,1,0,0,2
1290259,1290275,16,1,0,0,1
1290275,1290494,219,0,0,1,2
1290276,1290496,220,0,0,1,1
1290495,1290513,18,1,0,0,2
1290497,1290513,16,1,0,0,1
1290514,1290738,224,0,0,1,2
1290514,1290744,230,0,0,1,1
1290739,1290821,82,1,0,0,2
1290745,1290866,121,1,0,0,1
1290776,1290813,37,0,1,0,1
1290822,1291050,228,0,0,1,2
1290867,1291049,182,0,0,1,1
1291050,1291267,217,1,0,0,1
1291051,1291265,214,1,0,0,2
1291107,1291236,129,0,1,0,1
1291127,1291178,51,0,1,0,2
1291266,1291364,98,0,0,1,2
1291268,1291364,96,0,0,1,1
1291365,1291396,31,1,0,0,2
1291365,1291397,32,1,0,0,1
1291397,1291568,171,0,0,1,2
1291398,1291567,169,0,0,1,1
1291568,1291874,306,1,0,0,1
1291569,1291911,342,1,0,0,2
1291587,1291855,268,0,1,0,1
1291611,1291768,157,0,1,0,2
1291875,1293229,1354,0,0,1,1
1291912,1293230,1318,0,0,1,2
1293230,1293273,43,1,0,0,1
1293231,1293273,42,1,0,0,2
1293274,1293373,99,0,0,1,1
1293274,1293373,99,0,0,1,2
1293374,1293447,73,1,0,0,2
1293374,1293450,76,1,0,0,1
1293448,1293535,87,0,0,1,2
1293451,1293538,87,0,0,1,1
1293536,1293569,33,1,0,0,2
1293539,1293569,30,1,0,0,1
1293570,1293889,319,0,0,1,2
1293570,1293890,320,0,0,1,1
1293890,1293918,28,1,0,0,2
1293891,1293916,25,1,0,0,1
1293917,1294126,209,0,0,1,1
1293919,1294121,202,0,0,1,2
1294122,1294148,26,1,0,0,2
1294127,1294139,12,1,0,0,1
1294140,1295091,951,0,0,1,1
1294149,1295091,942,0,0,1,2
1295092,1295129,37,1,0,0,1
1295092,1295129,37,1,0,0,2
1295130,1295448,318,0,0,1,1
1295130,1295448,318,0,0,1,2
1295449,1295499,50,1,0,0,1
1295449,1295499,50,1,0,0,2
1295500,1295688,188,0,0,1,2
1295500,1295693,193,0,0,1,1
1295689,1295717,28,1,0,0,2
1295694,1295716,22,1,0,0,1
1295717,1296253,536,0,0,1,1
1295718,1296252,534,0,0,1,2
1296253,1296284,31,1,0,0,2
1296254,1296285,31,1,0,0,1
1296285,1296465,180,0,0,1,2
1296286,1296465,179,0,0,1,1
1296466,1296495,29,1,0,0,1
1296466,1296496,30,1,0,0,2
1296496,1297339,843,0,0,1,1
1296497,1297337,840,0,0,1,2
1297338,1297381,43,1,0,0,2
1297340,1297376,36,1,0,0,1
1297377,1297579,202,0,0,1,1
1297382,1297580,198,0,0,1,2
1297580,1297612,32,1,0,0,1
1297581,1297610,29,1,0,0,2
1297611,1297709,98,0,0,1,2
1297613,1297711,98,0,0,1,1
1297710,1297772,62,1,0,0,2
1297712,1297773,61,1,0,0,1
1297773,1297874,101,0,0,1,2
1297774,1297877,103,0,0,1,1
1297875,1297915,40,1,0,0,2
1297878,1297924,46,1,0,0,1
1297916,1298142,226,0,0,1,2
1297925,1298143,218,0,0,1,1
1298143,1298172,29,1,0,0,2
1298144,1298173,29,1,0,0,1
1298173,1298586,413,0,0,1,2
1298174,1298516,342,0,0,1,1
1298517,1298611,94,1,0,0,1
1298587,1298606,19,1,0,0,2
1298607,1298764,157,0,0,1,2
1298612,1298765,153,0,0,1,1
1298765,1298800,35,1,0,0,2
1298766,1298798,32,1,0,0,1
1298799,1298828,29,0,0,1,1
1298801,1298830,29,0,0,1,2
1298829,1298858,29,1,0,0,1
1298831,1298859,28,1,0,0,2
1298859,1299452,593,0,0,1,1
1298860,1299454,594,0,0,1,2
1299453,1299594,141,1,0,0,1
1299455,1299554,99,1,0,0,2
1299555,1299918,363,0,0,1,2
1299595,1299916,321,0,0,1,1
1299917,1299994,77,1,0,0,1
1299919,1299979,60,1,0,0,2
1299980,1300083,103,0,0,1,2
1299995,1300082,87,0,0,1,1
1300083,1300115,32,1,0,0,1
1300084,1300113,29,1,0,0,2
1300114,1300319,205,0,0,1,2
1300116,1300312,196,0,0,1,1
1300313,1300331,18,1,0,0,1
1300320,1300330,10,1,0,0,2
1300331,1301834,1503,0,0,1,2
1300332,1301830,1498,0,0,1,1
1301831,1301919,88,1,0,0,1
1301835,1301920,85,1,0,0,2
1301920,1302259,339,0,0,1,1
1301921,1302141,220,0,0,1,2
1302142,1302187,45,1,0,0,2
1302188,1302259,71,0,0,1,2
1302260,1302323,63,1,0,0,2
1302260,1302326,66,1,0,0,1
1302324,1302590,266,0,0,1,2
1302327,1302585,258,0,0,1,1
1302586,1302601,15,1,0,0,1
1302591,1302600,9,1,0,0,2
1302601,1304004,1403,0,0,1,2
1302602,1304003,1401,0,0,1,1
1304004,1304057,53,1,0,0,1
1304005,1304060,55,1,0,0,2
1304058,1304447,389,0,0,1,1
1304061,1304445,384,0,0,1,2
1304446,1304499,53,1,0,0,2
1304448,1304496,48,1,0,0,1
1304497,1304646,149,0,0,1,1
1304500,1304647,147,0,0,1,2
1304647,1304675,28,1,0,0,1
1304648,1304680,32,1,0,0,2
1304676,1306089,1413,0,0,1,1
1304681,1306125,1444,0,0,1,2
1306090,1306553,463,1,0,0,1
1306126,1306209,83,1,0,0,2
1306131,1306237,106,0,1,0,1
1306210,1306289,79,0,0,1,2
1306290,1306537,247,1,0,0,2
1306294,1306527,233,0,1,0,1
1306317,1306483,166,0,1,0,2
1306538,1306658,120,0,0,1,2
1306554,1306658,104,0,0,1,1
1306659,1306736,77,1,0,0,2
1306659,1306762,103,1,0,0,1
1306737,1306876,139,0,0,1,2
1306763,1306853,90,0,0,1,1
1306854,1307377,523,1,0,0,1
1306875,1307248,373,0,1,0,1
1306877,1307079,202,1,0,0,2
1306893,1307037,144,0,1,0,2
1307080,1307225,145,0,0,1,2
1307226,1307255,29,1,0,0,2
1307256,1308411,1155,0,0,1,2
1307378,1307548,170,0,0,1,1
1307549,1308019,470,1,0,0,1
1308020,1308248,228,0,0,1,1
1308249,1308474,225,1,0,0,1
1308412,1308474,62,1,0,0,2
1308475,1308675,200,0,0,1,2
1308475,1308676,201,0,0,1,1
1308676,1308712,36,1,0,0,2
1308677,1308731,54,1,0,0,1
1308713,1308859,146,0,0,1,2
1308732,1308858,126,0,0,1,1
1308859,1309081,222,1,0,0,1
1308860,1308936,76,1,0,0,2
1308937,1309017,80,0,0,1,2
1309018,1309055,37,1,0,0,2
1309056,1309388,332,0,0,1,2
1309082,1309163,81,0,0,1,1
1309164,1309419,255,1,0,0,1
1309389,1309416,27,1,0,0,2
1309417,1310603,1186,0,0,1,2
1309420,1309494,74,0,0,1,1
1309495,1309510,15,1,0,0,1
1309511,1309536,25,0,0,1,1
1309537,1309712,175,1,0,0,1
1309713,1309870,157,0,0,1,1
1309871,1309907,36,1,0,0,1
1309908,1310057,149,0,0,1,1
1310058,1310080,22,1,0,0,1
1310081,1310192,111,0,0,1,1
1310193,1310285,92,1,0,0,1
1310286,1310457,171,0,0,1,1
1310458,1310480,22,1,0,0,1
1310481,1310601,120,0,0,1,1
1310602,1310664,62,1,0,0,1
1310604,1310654,50,1,0,0,2
1310655,1310830,175,0,0,1,2
1310665,1310831,166,0,0,1,1
1310831,1310945,114,1,0,0,2
1310832,1310907,75,1,0,0,1
1310908,1311059,151,0,0,1,1
1310946,1311059,113,0,0,1,2
1311060,1311134,74,1,0,0,2
1311060,1311138,78,1,0,0,1
1311135,1311297,162,0,0,1,2
1311139,1311297,158,0,0,1,1
1311298,1311326,28,1,0,0,1
1311298,1311327,29,1,0,0,2
1311327,1312875,1548,0,0,1,1
1311328,1312877,1549,0,0,1,2
1312876,1312977,101,1,0,0,1
1312878,1312977,99,1,0,0,2
1312978,1313293,315,0,0,1,1
1312978,1313293,315,0,0,1,2
1313294,1313364,70,1,0,0,2
1313294,1313372,78,1,0,0,1
1313365,1313459,94,0,0,1,2
1313373,1313459,86,0,0,1,1
1313460,1313493,33,1,0,0,2
1313460,1313498,38,1,0,0,1
1313494,1314237,743,0,0,1,2
1313499,1314236,737,0,0,1,1
1314237,1314261,24,1,0,0,1
1314238,1314259,21,1,0,0,2
1314260,1314854,594,0,0,1,2
1314262,1314855,593,0,0,1,1
1314855,1314911,56,1,0,0,2
1314856,1314924,68,1,0,0,1
1314912,1315151,239,0,0,1,2
1314925,1315151,226,0,0,1,1
1315152,1315211,59,1,0,0,2
1315152,1315224,72,1,0,0,1
1315212,1315425,213,0,0,1,2
1315225,1315424,199,0,0,1,1
1315425,1315500,75,1,0,0,1
1315426,1315502,76,1,0,0,2
1315501,1315624,123,0,0,1,1
1315503,1315625,122,0,0,1,2
1315625,1315662,37,1,0,0,1
1315626,1315663,37,1,0,0,2
1315663,1315978,315,0,0,1,1
1315664,1315980,316,0,0,1,2
1315979,1316006,27,1,0,0,1
1315981,1316006,25,1,0,0,2
1316007,1316699,692,0,0,1,1
1316007,1316714,707,0,0,1,2
1316700,1316821,121,1,0,0,1
1316715,1316740,25,1,0,0,2
1316741,1317139,398,0,0,1,2
1316822,1317140,318,0,0,1,1
1317140,1317215,75,1,0,0,2
1317141,1317219,78,1,0,0,1
1317216,1317512,296,0,0,1,2
1317220,1317512,292,0,0,1,1
1317513,1317585,72,1,0,0,2
1317513,1317590,77,1,0,0,1
1317586,1317708,122,0,0,1,2
1317591,1317709,118,0,0,1,1
1317709,1317739,30,1,0,0,2
1317710,1317743,33,1,0,0,1
1317740,1319385,1645,0,0,1,2
1317744,1319383,1639,0,0,1,1
1319384,1319490,106,1,0,0,1
1319386,1319498,112,1,0,0,2
1319491,1319832,341,0,0,1,1
1319499,1319625,126,0,0,1,2
1319626,1319630,4,1,0,0,2
1319631,1319832,201,0,0,1,2
1319833,1319909,76,1,0,0,1
1319833,1319910,77,1,0,0,2
1319910,1320102,192,0,0,1,1
1319911,1320100,189,0,0,1,2
1320101,1320129,28,1,0,0,2
1320103,1320128,25,1,0,0,1
1320129,1320715,586,0,0,1,1
1320130,1320735,605,0,0,1,2
1320716,1320799,83,1,0,0,1
1320736,1320837,101,1,0,0,2
1320800,1321474,674,0,0,1,1
1320838,1321472,634,0,0,1,2
1321473,1321596,123,1,0,0,2
1321475,1321596,121,1,0,0,1
1321597,1321763,166,0,0,1,1
1321597,1321767,170,0,0,1,2
1321764,1321987,223,1,0,0,1
1321768,1321966,198,1,0,0,2
1321791,1321919,128,0,1,0,1
1321967,1322073,106,0,0,1,2
1321988,1322074,86,0,0,1,1
1322074,1322149,75,1,0,0,2
1322075,1322147,72,1,0,0,1
1322148,1322253,105,0,0,1,1
1322150,1322254,104,0,0,1,2
1322254,1322287,33,1,0,0,1
1322255,1322346,91,1,0,0,2
1322288,1324074,1786,0,0,1,1
1322347,1322879,532,0,0,1,2
1322880,1322884,4,1,0,0,2
1322885,1323356,471,0,0,1,2
1323357,1323623,266,1,0,0,2
1323624,1323660,36,0,0,1,2
1323661,1324359,698,1,0,0,2
1324075,1324125,50,1,0,0,1
1324126,1324288,162,0,0,1,1
1324289,1324334,45,1,0,0,1
1324335,1324549,214,0,0,1,1
1324360,1326088,1728,0,0,1,2
1324550,1324554,4,1,0,0,1
1324555,1326087,1532,0,0,1,1
1326088,1326138,50,1,0,0,1
1326089,1326140,51,1,0,0,2
1326139,1326441,302,0,0,1,1
1326141,1326441,300,0,0,1,2
1326442,1326543,101,1,0,0,1
1326442,1326545,103,1,0,0,2
1326544,1326718,174,0,0,1,1
1326546,1326717,171,0,0,1,2
1326718,1326769,51,1,0,0,2
1326719,1326759,40,1,0,0,1
1326760,1328042,1282,0,0,1,1
1326770,1328059,1289,0,0,1,2
1328043,1328142,99,1,0,0,1
1328060,1328111,51,1,0,0,2
1328071,1328109,38,0,1,0,1
1328112,1328445,333,0,0,1,2
1328143,1328446,303,0,0,1,1
1328446,1328548,102,1,0,0,2
1328447,1328548,101,1,0,0,1
1328549,1328848,299,0,0,1,1
1328549,1328849,300,0,0,1,2
1328849,1328912,63,1,0,0,1
1328850,1328906,56,1,0,0,2
1328907,1329039,132,0,0,1,2
1328913,1329038,125,0,0,1,1
1329039,1329072,33,1,0,0,1
1329040,1329070,30,1,0,0,2
1329071,1329745,674,0,0,1,2
1329073,1329722,649,0,0,1,1
1329723,1329908,185,1,0,0,1
1329746,1329849,103,1,0,0,2
1329761,1329836,75,0,1,0,1
1329850,1330066,216,0,0,1,2
1329909,1330067,158,0,0,1,1
1330067,1330088,21,1,0,0,2
1330068,1330088,20,1,0,0,1
1330089,1330340,251,0,0,1,2
1330089,1330341,252,0,0,1,1
1330341,1330386,45,1,0,0,2
1330342,1330382,40,1,0,0,1
1330383,1330830,447,0,0,1,1
1330387,1330830,443,0,0,1,2
1330831,1330911,80,1,0,0,2
1330831,1330914,83,1,0,0,1
1330912,1331060,148,0,0,1,2
1330915,1331061,146,0,0,1,1
1331061,1331093,32,1,0,0,2
1331062,1331106,44,1,0,0,1
1331094,1331603,509,0,0,1,2
1331107,1331597,490,0,0,1,1
1331598,1331626,28,1,0,0,1
1331604,1331623,19,1,0,0,2
1331624,1332281,657,0,0,1,2
1331627,1332280,653,0,0,1,1
1332281,1332351,70,1,0,0,1
1332282,1332338,56,1,0,0,2
1332339,1332589,250,0,0,1,2
1332352,1332587,235,0,0,1,1
1332588,1332662,74,1,0,0,1
1332590,1332662,72,1,0,0,2
1332663,1332908,245,0,0,1,1
1332663,1332909,246,0,0,1,2
1332909,1332962,53,1,0,0,1
1332910,1332957,47,1,0,0,2
1332958,1333115,157,0,0,1,2
1332963,1333118,155,0,0,1,1
1333116,1333136,20,1,0,0,2
1333119,1333136,17,1,0,0,1
1333137,1334921,1784,0,0,1,2
1333137,1334922,1785,0,0,1,1
1334922,1334979,57,1,0,0,2
1334923,1334978,55,1,0,0,1
1334979,1335176,197,0,0,1,1
1334980,1335175,195,0,0,1,2
1335176,1335272,96,1,0,0,2
1335177,1335262,85,1,0,0,1
1335263,1335352,89,0,0,1,1
1335273,1335350,77,0,0,1,2
1335351,1335433,82,1,0,0,2
1335353,1335395,42,1,0,0,1
1335396,1335810,414,0,0,1,1
1335434,1335668,234,0,0,1,2
1335669,1335678,9,1,0,0,2
1335679,1336007,328,0,0,1,2
1335811,1335826,15,1,0,0,1
1335827,1336827,1000,0,0,1,1
1336008,1336025,17,1,0,0,2
1336026,1336109,83,0,0,1,2
1336110,1336152,42,1,0,0,2
1336153,1336221,68,0,0,1,2
1336222,1336238,16,1,0,0,2
1336239,1336400,161,0,0,1,2
1336401,1336464,63,1,0,0,2
1336465,1336505,40,0,0,1,2
1336506,1336564,58,1,0,0,2
1336565,1336760,195,0,0,1,2
1336761,1336776,15,1,0,0,2
1336777,1336824,47,0,0,1,2
1336825,1336884,59,1,0,0,2
1336828,1336889,61,1,0,0,1
1336885,1337075,190,0,0,1,2
1336890,1337076,186,0,0,1,1
1337076,1337153,77,1,0,0,2
1337077,1337144,67,1,0,0,1
1337145,1337400,255,0,0,1,1
1337154,1337402,248,0,0,1,2
1337401,1337492,91,1,0,0,1
1337403,1337476,73,1,0,0,2
1337477,1337599,122,0,0,1,2
1337493,1337598,105,0,0,1,1
1337599,1337665,66,1,0,0,1
1337600,1337643,43,1,0,0,2
1337644,1337855,211,0,0,1,2
1337666,1337851,185,0,0,1,1
1337852,1337883,31,1,0,0,1
1337856,1337883,27,1,0,0,2
1337884,1338168,284,0,0,1,1
1337884,1338169,285,0,0,1,2
1338169,1338219,50,1,0,0,1
1338170,1338196,26,1,0,0,2
1338197,1339212,1015,0,0,1,2
1338220,1339212,992,0,0,1,1
1339213,1339306,93,1,0,0,1
1339213,1339312,99,1,0,0,2
1339307,1339569,262,0,0,1,1
1339313,1339568,255,0,0,1,2
1339569,1339666,97,1,0,0,2
1339570,1339667,97,1,0,0,1
1339667,1339760,93,0,0,1,2
1339668,1339761,93,0,0,1,1
1339761,1339800,39,1,0,0,2
1339762,1339828,66,1,0,0,1
1339801,1339926,125,0,0,1,2
1339829,1339925,96,0,0,1,1
1339926,1339954,28,1,0,0,1
1339927,1339955,28,1,0,0,2
1339955,1340283,328,0,0,1,1
1339956,1341307,1351,0,0,1,2
1340284,1340331,47,1,0,0,1
1340332,1341305,973,0,0,1,1
1341306,1341417,111,1,0,0,1
1341308,1341414,106,1,0,0,2
1341415,1341753,338,0,0,1,2
1341418,1341755,337,0,0,1,1
1341754,1341830,76,1,0,0,2
1341756,1341844,88,1,0,0,1
1341831,1341972,141,0,0,1,2
1341845,1341973,128,0,0,1,1
1341973,1342015,42,1,0,0,2
1341974,1342017,43,1,0,0,1
1342016,1342218,202,0,0,1,2
1342018,1342219,201,0,0,1,1
1342219,1342245,26,1,0,0,2
1342220,1342247,27,1,0,0,1
1342246,1343349,1103,0,0,1,2
1342248,1343348,1100,0,0,1,1
1343349,1343446,97,1,0,0,1
1343350,1343466,116,1,0,0,2
1343447,1343827,380,0,0,1,1
1343467,1343827,360,0,0,1,2
1343828,1343897,69,1,0,0,2
1343828,1343899,71,1,0,0,1
1343898,1344028,130,0,0,1,2
1343900,1344024,124,0,0,1,1
1344025,1344064,39,1,0,0,1
1344029,1344064,35,1,0,0,2
1344065,1345083,1018,0,0,1,2
1344065,1345101,1036,0,0,1,1
1345084,1345121,37,1,0,0,2
1345102,1345122,20,1,0,0,1
1345122,1345495,373,0,0,1,2
1345123,1345496,373,0,0,1,1
1345496,1345561,65,1,0,0,2
1345497,1345565,68,1,0,0,1
1345562,1345859,297,0,0,1,2
1345566,1345859,293,0,0,1,1
1345860,1345938,78,1,0,0,2
1345860,1345942,82,1,0,0,1
1345939,1346101,162,0,0,1,2
1345943,1346101,158,0,0,1,1
1346102,1346132,30,1,0,0,2
1346102,1346141,39,1,0,0,1
1346133,1346355,222,0,0,1,2
1346142,1346348,206,0,0,1,1
1346349,1346428,79,1,0,0,1
1346356,1346386,30,1,0,0,2
1346387,1347112,725,0,0,1,2
1346429,1347093,664,0,0,1,1
1347094,1347168,74,1,0,0,1
1347113,1347134,21,1,0,0,2
1347135,1347559,424,0,0,1,2
1347169,1347557,388,0,0,1,1
1347558,1347656,98,1,0,0,1
1347560,1347672,112,1,0,0,2
1347657,1347927,270,0,0,1,1
1347673,1347926,253,0,0,1,2
1347927,1348025,98,1,0,0,2
1347928,1348023,95,1,0,0,1
1348024,1348149,125,0,0,1,1
1348026,1348150,124,0,0,1,2
1348150,1348191,41,1,0,0,1
1348151,1348202,51,1,0,0,2
1348192,1348401,209,0,0,1,1
1348203,1348401,198,0,0,1,2
1348402,1348433,31,1,0,0,1
1348402,1348434,32,1,0,0,2
1348434,1349686,1252,0,0,1,1
1348435,1349698,1263,0,0,1,2
1349687,1349744,57,1,0,0,1
1349699,1349733,34,1,0,0,2
1349734,1349952,218,0,0,1,2
1349745,1349951,206,0,0,1,1
1349952,1350001,49,1,0,0,1
1349953,1349999,46,1,0,0,2
1350000,1350106,106,0,0,1,2
1350002,1350107,105,0,0,1,1
1350107,1350335,228,1,0,0,2
1350108,1350431,323,1,0,0,1
1350177,1350337,160,0,1,0,1
1350336,1350363,27,0,0,1,2
1350364,1350422,58,1,0,0,2
1350423,1350483,60,0,0,1,2
1350432,1350479,47,0,0,1,1
1350480,1350866,386,1,0,0,1
1350484,1350853,369,1,0,0,2
1350499,1350789,290,0,1,0,1
1350513,1350744,231,0,1,0,2
1350854,1350926,72,0,0,1,2
1350867,1351135,268,0,0,1,1
1350927,1350944,17,1,0,0,2
1350945,1351129,184,0,0,1,2
1351130,1351165,35,1,0,0,2
1351136,1351167,31,1,0,0,1
1351166,1351283,117,0,0,1,2
1351168,1351283,115,0,0,1,1
1351284,1351315,31,1,0,0,1
1351284,1351317,33,1,0,0,2
1351316,1351989,673,0,0,1,1
1351318,1351991,673,0,0,1,2
1351990,1352127,137,1,0,0,1
1351992,1352092,100,1,0,0,2
1352093,1352516,423,0,0,1,2
1352128,1352516,388,0,0,1,1
1352517,1352603,86,1,0,0,2
1352517,1352614,97,1,0,0,1
1352604,1352796,192,0,0,1,2
1352615,1352794,179,0,0,1,1
1352795,1352836,41,1,0,0,1
1352797,1352828,31,1,0,0,2
1352829,1354040,1211,0,0,1,2
1352837,1354037,1200,0,0,1,1
1354038,1354166,128,1,0,0,1
1354041,1354165,124,1,0,0,2
1354166,1354367,201,0,0,1,2
1354167,1354476,309,0,0,1,1
1354368,1354373,5,1,0,0,2
1354374,1354476,102,0,0,1,2
1354477,1354519,42,1,0,0,2
1354477,1354523,46,1,0,0,1
1354520,1354673,153,0,0,1,2
1354524,1355349,825,0,0,1,1
1354674,1354689,15,1,0,0,2
1354690,1354921,231,0,0,1,2
1354922,1354941,19,1,0,0,2
1354942,1355348,406,0,0,1,2
1355349,1355453,104,1,0,0,2
1355350,1355435,85,1,0,0,1
1355436,1356152,716,0,0,1,1
1355454,1355669,215,0,0,1,2
1355670,1355674,4,1,0,0,2
1355675,1355761,86,0,0,1,2
1355762,1355789,27,1,0,0,2
1355790,1356150,360,0,0,1,2
1356151,1356223,72,1,0,0,2
1356153,1356182,29,1,0,0,1
1356183,1356549,366,0,0,1,1
1356224,1356550,326,0,0,1,2
1356550,1356630,80,1,0,0,1
1356551,1356622,71,1,0,0,2
1356623,1356723,100,0,0,1,2
1356631,1356722,91,0,0,1,1
1356723,1356768,45,1,0,0,1
1356724,1356767,43,1,0,0,2
1356768,1357103,335,0,0,1,2
1356769,1357099,330,0,0,1,1
1357100,1357133,33,1,0,0,1
1357104,1357132,28,1,0,0,2
1357133,1357293,160,0,0,1,2
1357134,1357291,157,0,0,1,1
1357292,1357322,30,1,0,0,1
1357294,1357320,26,1,0,0,2
1357321,1358139,818,0,0,1,2
1357323,1358137,814,0,0,1,1
1358138,1358220,82,1,0,0,1
1358140,1358220,80,1,0,0,2
1358221,1358596,375,0,0,1,1
1358221,1358596,375,0,0,1,2
1358597,1358662,65,1,0,0,1
1358597,1358691,94,1,0,0,2
1358663,1358768,105,0,0,1,1
1358692,1358768,76,0,0,1,2
1358769,1358798,29,1,0,0,1
1358769,1358824,55,1,0,0,2
1358799,1360216,1417,0,0,1,1
1358825,1358861,36,0,0,1,2
1358862,1358886,24,1,0,0,2
1358887,1359096,209,0,0,1,2
1359097,1359149,52,1,0,0,2
1359150,1359294,144,0,0,1,2
1359295,1359360,65,1,0,0,2
1359361,1359912,551,0,0,1,2
1359913,1359920,7,1,0,0,2
1359921,1359990,69,0,0,1,2
1359991,1360021,30,1,0,0,2
1360022,1360210,188,0,0,1,2
1360211,1360257,46,1,0,0,2
1360217,1360242,25,1,0,0,1
1360243,1360375,132,0,0,1,1
1360258,1360366,108,0,0,1,2
1360367,1360644,277,1,0,0,2
1360376,1360677,301,1,0,0,1
1360412,1360638,226,0,1,0,1
1360433,1360536,103,0,1,0,2
1360645,1360840,195,0,0,1,2
1360678,1360839,161,0,0,1,1
1360840,1360946,106,1,0,0,1
1360841,1360931,90,1,0,0,2
1360932,1361072,140,0,0,1,2
1360947,1361060,113,0,0,1,1
1361061,1361108,47,1,0,0,1
1361073,1361108,35,1,0,0,2
1361109,1361221,112,0,0,1,1
1361109,1361227,118,0,0,1,2
1361222,1361256,34,1,0,0,1
1361228,1361258,30,1,0,0,2
1361257,1361517,260,0,0,1,1
1361259,1361519,260,0,0,1,2
1361518,1361550,32,1,0,0,1
1361520,1361550,30,1,0,0,2
1361551,1361778,227,0,0,1,1
1361551,1361784,233,0,0,1,2
1361779,1361795,16,1,0,0,1
1361785,1361795,10,1,0,0,2
1361796,1362444,648,0,0,1,1
1361796,1362449,653,0,0,1,2
1362445,1362764,319,1,0,0,1
1362450,1362473,23,1,0,0,2
1362474,1362505,31,0,0,1,2
1362506,1362736,230,1,0,0,2
1362553,1362682,129,0,1,0,1
1362737,1362834,97,0,0,1,2
1362765,1362831,66,0,0,1,1
1362832,1364680,1848,1,0,0,1
1362835,1363602,767,1,0,0,2
1362853,1364617,1764,0,1,0,1
1362869,1363591,722,0,1,0,2
1363603,1363658,55,0,0,1,2
1363659,1363692,33,1,0,0,2
1363693,1363926,233,0,0,1,2
1363927,1363937,10,1,0,0,2
1363938,1364562,624,0,0,1,2
1364563,1364635,72,1,0,0,2
1364636,1364864,228,0,0,1,2
1364681,1364794,113,0,0,1,1
1364795,1364803,8,1,0,0,1
1364804,1364866,62,0,0,1,1
1364865,1364936,71,1,0,0,2
1364867,1364936,69,1,0,0,1
1364937,1365164,227,0,0,1,1
1364937,1365165,228,0,0,1,2
1365165,1365235,70,1,0,0,1
1365166,1365227,61,1,0,0,2
1365228,1365345,117,0,0,1,2
1365236,1365346,110,0,0,1,1
1365346,1365390,44,1,0,0,2
1365347,1365394,47,1,0,0,1
1365391,1365619,228,0,0,1,2
1365395,1365620,225,0,0,1,1
1365620,1365640,20,1,0,0,2
1365621,1365648,27,1,0,0,1
1365641,1366992,1351,0,0,1,2
1365649,1366992,1343,0,0,1,1
1366993,1367093,100,1,0,0,1
1366993,1367096,103,1,0,0,2
1367094,1367360,266,0,0,1,1
1367097,1367358,261,0,0,1,2
1367359,1367417,58,1,0,0,2
1367361,1367426,65,1,0,0,1
1367418,1367510,92,0,0,1,2
1367427,1367511,84,0,0,1,1
1367511,1367547,36,1,0,0,2
1367512,1367546,34,1,0,0,1
1367547,1367771,224,0,0,1,1
1367548,1367771,223,0,0,1,2
1367772,1367794,22,1,0,0,1
1367772,1367796,24,1,0,0,2
1367795,1367818,23,0,0,1,1
1367797,1367821,24,0,0,1,2
1367819,1367826,7,1,0,0,1
1367822,1367827,5,1,0,0,2
1367827,1368241,414,0,0,1,1
1367828,1368243,415,0,0,1,2
1368242,1368269,27,1,0,0,1
1368244,1368260,16,1,0,0,2
1368261,1369376,1115,0,0,1,2
1368270,1369374,1104,0,0,1,1
1369375,1369424,49,1,0,0,1
1369377,1369429,52,1,0,0,2
1369425,1369731,306,0,0,1,1
1369430,1369731,301,0,0,1,2
1369732,1369795,63,1,0,0,2
1369732,1369801,69,1,0,0,1
1369796,1369928,132,0,0,1,2
1369802,1369929,127,0,0,1,1
1369929,1369962,33,1,0,0,2
1369930,1369960,30,1,0,0,1
1369961,1371301,1340,0,0,1,1
1369963,1371300,1337,0,0,1,2
1371301,1371365,64,1,0,0,2
1371302,1371358,56,1,0,0,1
1371359,1371529,170,0,0,1,1
1371366,1371529,163,0,0,1,2
1371530,1371607,77,1,0,0,2
1371530,1371608,78,1,0,0,1
1371608,1371883,275,0,0,1,2
1371609,1371883,274,0,0,1,1
1371884,1371965,81,1,0,0,1
1371884,1371983,99,1,0,0,2
1371966,1372065,99,0,0,1,1
1371984,1372064,80,0,0,1,2
1372065,1372095,30,1,0,0,2
1372066,1372098,32,1,0,0,1
1372096,1372357,261,0,0,1,2
1372099,1372350,251,0,0,1,1
1372351,1372386,35,1,0,0,1
1372358,1372377,19,1,0,0,2
1372378,1373136,758,0,0,1,2
1372387,1373136,749,0,0,1,1
1373137,1373167,30,1,0,0,2
1373137,1373172,35,1,0,0,1
1373168,1373468,300,0,0,1,2
1373173,1373462,289,0,0,1,1
1373463,1373733,270,1,0,0,1
1373469,1373707,238,1,0,0,2
1373527,1373699,172,0,1,0,1
1373708,1373867,159,0,0,1,2
1373734,1373851,117,0,0,1,1
1373852,1374043,191,1,0,0,1
1373868,1374019,151,1,0,0,2
1373887,1373957,70,0,1,0,1
1374020,1374134,114,0,0,1,2
1374044,1374137,93,0,0,1,1
1374135,1374183,48,1,0,0,2
1374138,1374168,30,1,0,0,1
1374169,1375587,1418,0,0,1,1
1374184,1374243,59,0,0,1,2
1374244,1374259,15,1,0,0,2
1374260,1374387,127,0,0,1,2
1374388,1374410,22,1,0,0,2
1374411,1375493,1082,0,0,1,2
1375494,1375535,41,1,0,0,2
1375536,1375608,72,0,0,1,2
1375588,1375873,285,1,0,0,1
1375609,1375901,292,1,0,0,2
1375624,1375809,185,0,1,0,1
1375669,1375671,2,0,1,0,2
1375874,1376044,170,0,0,1,1
1375902,1376045,143,0,0,1,2
1376045,1376139,94,1,0,0,1
1376046,1376139,93,1,0,0,2
1376140,1376237,97,0,0,1,2
1376140,1376239,99,0,0,1,1
1376238,1376287,49,1,0,0,2
1376240,1376324,84,1,0,0,1
1376288,1376477,189,0,0,1,2
1376325,1376476,151,0,0,1,1
1376477,1376532,55,1,0,0,1
1376478,1376509,31,1,0,0,2
1376510,1376615,105,0,0,1,2
1376533,1376614,81,0,0,1,1
1376615,1376636,21,1,0,0,1
1376616,1376635,19,1,0,0,2
1376636,1376896,260,0,0,1,2
1376637,1376894,257,0,0,1,1
1376895,1377013,118,1,0,0,1
1376897,1376918,21,1,0,0,2
1376919,1377263,344,0,0,1,2
1377014,1377079,65,0,0,1,1
1377080,1377152,72,1,0,0,1
1377153,1377261,108,0,0,1,1
1377262,1377296,34,1,0,0,1
1377264,1377282,18,1,0,0,2
1377283,1377495,212,0,0,1,2
1377297,1377351,54,0,0,1,1
1377352,1377434,82,1,0,0,1
1377435,1377479,44,0,0,1,1
1377480,1377915,435,1,0,0,1
1377495,1377906,411,0,1,0,1
1377496,1377711,215,1,0,0,2
1377522,1377662,140,0,1,0,2
1377712,1377741,29,0,0,1,2
1377742,1377762,20,1,0,0,2
1377763,1377830,67,0,0,1,2
1377831,1377955,124,1,0,0,2
1377916,1377946,30,0,0,1,1
1377947,1377956,9,1,0,0,1
1377956,1378524,568,0,0,1,2
1377957,1378516,559,0,0,1,1
1378517,1378725,208,1,0,0,1
1378525,1378693,168,1,0,0,2
1378540,1378691,151,0,1,0,1
1378557,1378640,83,0,1,0,2
1378694,1379278,584,0,0,1,2
1378726,1379030,304,0,0,1,1
1379031,1379101,70,1,0,0,1
1379102,1379260,158,0,0,1,1
1379261,1379556,295,1,0,0,1
1379279,1379533,254,1,0,0,2
1379289,1379533,244,0,1,0,1
1379319,1379454,135,0,1,0,2
1379534,1379932,398,0,0,1,2
1379557,1379922,365,0,0,1,1
1379923,1380193,270,1,0,0,1
1379933,1380159,226,1,0,0,2
1379945,1380164,219,0,1,0,1
1379967,1380088,121,0,1,0,2
1380160,1380444,284,0,0,1,2
1380194,1380443,249,0,0,1,1
1380444,1380497,53,1,0,0,1
1380445,1380497,52,1,0,0,2
1380498,1380718,220,0,0,1,1
1380498,1380731,233,0,0,1,2
1380719,1381088,369,1,0,0,1
1380732,1381049,317,1,0,0,2
1380743,1381078,335,0,1,0,1
1380761,1380957,196,0,1,0,2
1381050,1381445,395,0,0,1,2
1381089,1381446,357,0,0,1,1
1381446,1381558,112,1,0,0,2
1381447,1381516,69,1,0,0,1
1381517,1381760,243,0,0,1,1
1381559,1381761,202,0,0,1,2
1381761,1382099,338,1,0,0,1
1381762,1382124,362,1,0,0,2
1381781,1382068,287,0,1,0,1
1381797,1382003,206,0,1,0,2
1382100,1382250,150,0,0,1,1
1382125,1382250,125,0,0,1,2
1382251,1382312,61,1,0,0,1
1382251,1382314,63,1,0,0,2
1382313,1382473,160,0,0,1,1
1382315,1382489,174,0,0,1,2
1382474,1382929,455,1,0,0,1
1382490,1382949,459,1,0,0,2
1382505,1382916,411,0,1,0,1
1382532,1382808,276,0,1,0,2
1382930,1383087,157,0,0,1,1
1382950,1383086,136,0,0,1,2
1383087,1383281,194,1,0,0,2
1383088,1383177,89,1,0,0,1
1383178,1383488,310,0,0,1,1
1383282,1383322,40,0,0,1,2
1383323,1383755,432,1,0,0,2
1383489,1383772,283,1,0,0,1
1383513,1383731,218,0,1,0,1
1383538,1383638,100,0,1,0,2
1383756,1383977,221,0,0,1,2
1383773,1383977,204,0,0,1,1
1383978,1384038,60,1,0,0,2
1383978,1384039,61,1,0,0,1
1384039,1384162,123,0,0,1,2
1384040,1384146,106,0,0,1,1
1384147,1384603,456,1,0,0,1
1384163,1384597,434,1,0,0,2
1384179,1384590,411,0,1,0,1
1384211,1384455,244,0,1,0,2
1384598,1384830,232,0,0,1,2
1384604,1384832,228,0,0,1,1
1384831,1384894,63,1,0,0,2
1384833,1384887,54,1,0,0,1
1384888,1385053,165,0,0,1,1
1384895,1385072,177,0,0,1,2
1385054,1385410,356,1,0,0,1
1385073,1385405,332,1,0,0,2
1385090,1385361,271,0,1,0,1
1385117,1385280,163,0,1,0,2
1385406,1385625,219,0,0,1,2
1385411,1385626,215,0,0,1,1
1385626,1385769,143,1,0,0,2
1385627,1385723,96,1,0,0,1
1385724,1385938,214,0,0,1,1
1385770,1385847,77,0,0,1,2
1385848,1385859,11,1,0,0,2
1385860,1385939,79,0,0,1,2
1385939,1385992,53,1,0,0,1
1385940,1385993,53,1,0,0,2
1385993,1386200,207,0,0,1,1
1385994,1386100,106,0,0,1,2
1386101,1386119,18,1,0,0,2
1386120,1386169,49,0,0,1,2
1386170,1386502,332,1,0,0,2
1386201,1386497,296,1,0,0,1
1386230,1386426,196,0,1,0,1
1386248,1386345,97,0,1,0,2
1386498,1386599,101,0,0,1,1
1386503,1386600,97,0,0,1,2
1386600,1386667,67,1,0,0,1
1386601,1386664,63,1,0,0,2
1386665,1386929,264,0,0,1,2
1386668,1386928,260,0,0,1,1
1386929,1387017,88,1,0,0,1
1386930,1387008,78,1,0,0,2
1387009,1387196,187,0,0,1,2
1387018,1387195,177,0,0,1,1
1387196,1387360,164,1,0,0,1
1387197,1387330,133,1,0,0,2
1387240,1387314,74,0,1,0,1
1387331,1387423,92,0,0,1,2
1387361,1387396,35,0,0,1,1
1387397,1387919,522,1,0,0,1
1387424,1387786,362,1,0,0,2
1387432,1387881,449,0,1,0,1
1387460,1387722,262,0,1,0,2
1387787,1387866,79,0,0,1,2
1387867,1387891,24,1,0,0,2
1387892,1388111,219,0,0,1,2
1387920,1387951,31,0,0,1,1
1387952,1387975,23,1,0,0,1
1387976,1388112,136,0,0,1,1
1388112,1388181,69,1,0,0,2
1388113,1388193,80,1,0,0,1
1388182,1388514,332,0,0,1,2
1388194,1388515,321,0,0,1,1
1388515,1388601,86,1,0,0,2
1388516,1388598,82,1,0,0,1
1388599,1389013,414,0,0,1,1
1388602,1389013,411,0,0,1,2
1389014,1389052,38,1,0,0,1
1389014,1389054,40,1,0,0,2
1389053,1389221,168,0,0,1,1
1389055,1389231,176,0,0,1,2
1389222,1389588,366,1,0,0,1
1389232,1389564,332,1,0,0,2
1389250,1389525,275,0,1,0,1
1389267,1389449,182,0,1,0,2
1389565,1389594,29,0,0,1,2
1389589,1389652,63,0,0,1,1
1389595,1389712,117,1,0,0,2
1389653,1389709,56,1,0,0,1
1389710,1390196,486,0,0,1,1
1389713,1390196,483,0,0,1,2
1390197,1390273,76,1,0,0,1
1390197,1390291,94,1,0,0,2
1390274,1390463,189,0,0,1,1
1390292,1390472,180,0,0,1,2
1390464,1390967,503,1,0,0,1
1390473,1390963,490,1,0,0,2
1390500,1390835,335,0,1,0,1
1390523,1390719,196,0,1,0,2
1390964,1391489,525,0,0,1,2
1390968,1391490,522,0,0,1,1
1391490,1391530,40,1,0,0,2
1391491,1391543,52,1,0,0,1
1391531,1391991,460,0,0,1,2
1391544,1391978,434,0,0,1,1
1391979,1392471,492,1,0,0,1
1391992,1392312,320,1,0,0,2
1392014,1392443,429,0,1,0,1
1392038,1392232,194,0,1,0,2
1392313,1392383,70,0,0,1,2
1392384,1392492,108,1,0,0,2
1392472,1392676,204,0,0,1,1
1392493,1392676,183,0,0,1,2
1392677,1392727,50,1,0,0,2
1392677,1392740,63,1,0,0,1
1392728,1392877,149,0,0,1,2
1392741,1392868,127,0,0,1,1
1392869,1393397,528,1,0,0,1
1392878,1393231,353,1,0,0,2
1392885,1393334,449,0,1,0,1
1392910,1393171,261,0,1,0,2
1393232,1393491,259,0,0,1,2
1393398,1393490,92,0,0,1,1
1393491,1393552,61,1,0,0,1
1393492,1393555,63,1,0,0,2
1393553,1393778,225,0,0,1,1
1393556,1393798,242,0,0,1,2
1393779,1394136,357,1,0,0,1
1393799,1394166,367,1,0,0,2
1393814,1394094,280,0,1,0,1
1393837,1393997,160,0,1,0,2
1394137,1394758,621,0,0,1,1
1394167,1394772,605,0,0,1,2
1394759,1399421,4662,1,0,0,1
1394773,1396002,1229,1,0,0,2
1394792,1395203,411,0,1,0,1
1394823,1395091,268,0,1,0,2
1395263,1395998,735,0,1,0,1
1395290,1395949,659,0,1,0,2
1396003,1396191,188,0,0,1,2
1396127,1399400,3273,0,1,0,1
1396192,1399384,3192,1,0,0,2
1396228,1397604,1376,0,1,0,2
1397763,1398010,247,0,1,0,2
1398078,1399350,1272,0,1,0,2
1399385,1399448,63,0,0,1,2
1399422,1399820,398,0,0,1,1
1399449,1399468,19,1,0,0,2
1399469,1399834,365,0,0,1,2
1399821,1400136,315,1,0,0,1
1399835,1400128,293,1,0,0,2
1399864,1400062,198,0,1,0,1
1399878,1400012,134,0,1,0,2
1400129,1400609,480,0,0,1,2
1400137,1400608,471,0,0,1,1
1400609,1400673,64,1,0,0,1
1400610,1400672,62,1,0,0,2
1400673,1401010,337,0,0,1,2
1400674,1401009,335,0,0,1,1
1401010,1401077,67,1,0,0,1
1401011,1401068,57,1,0,0,2
1401069,1401252,183,0,0,1,2
1401078,1401251,173,0,0,1,1
1401252,1401353,101,1,0,0,1
1401253,1401285,32,1,0,0,2
1401286,1404244,2958,0,0,1,2
1401354,1401620,266,0,0,1,1
1401621,1401665,44,1,0,0,1
1401666,1401705,39,0,0,1,1
1401706,1401716,10,1,0,0,1
1401717,1401748,31,0,0,1,1
1401749,1401778,29,1,0,0,1
1401779,1402160,381,0,0,1,1
1402161,1402179,18,1,0,0,1
1402180,1402844,664,0,0,1,1
1402845,1402867,22,1,0,0,1
1402868,1402911,43,0,0,1,1
1402912,1402916,4,1,0,0,1
1402917,1403112,195,0,0,1,1
1403113,1403143,30,1,0,0,1
1403144,1403375,231,0,0,1,1
1403376,1403421,45,1,0,0,1
1403422,1403909,487,0,0,1,1
1403910,1403973,63,1,0,0,1
1403974,1404118,144,0,0,1,1
1404119,1404144,25,1,0,0,1
1404145,1404244,99,0,0,1,1
1404245,1404309,64,1,0,0,1
1404245,1404310,65,1,0,0,2
1404310,1404557,247,0,0,1,1
1404311,1404556,245,0,0,1,2
1404557,1404590,33,1,0,0,2
1404558,1404592,34,1,0,0,1
1404591,1404797,206,0,0,1,2
1404593,1404788,195,0,0,1,1
1404789,1404991,202,1,0,0,1
1404798,1404968,170,1,0,0,2
1404811,1404943,132,0,1,0,1
1404816,1404921,105,0,1,0,2
1404969,1407025,2056,0,0,1,2
1404992,1407027,2035,0,0,1,1
1407026,1407062,36,1,0,0,2
1407028,1407071,43,1,0,0,1
1407063,1407547,484,0,0,1,2
1407072,1407547,475,0,0,1,1
1407548,1407571,23,1,0,0,2
1407548,1407579,31,1,0,0,1
1407572,1407975,403,0,0,1,2
1407580,1407975,395,0,0,1,1
1407976,1408003,27,1,0,0,1
1407976,1408006,30,1,0,0,2
1408004,1408267,263,0,0,1,1
1408007,1408268,261,0,0,1,2
1408268,1408344,76,1,0,0,1
1408269,1408339,70,1,0,0,2
1408340,1408470,130,0,0,1,2
1408345,1408470,125,0,0,1,1
1408471,1408500,29,1,0,0,1
1408471,1408500,29,1,0,0,2
1408501,1408865,364,0,0,1,1
1408501,1408865,364,0,0,1,2
1408866,1408892,26,1,0,0,2
1408866,1408893,27,1,0,0,1
1408893,1411087,2194,0,0,1,2
1408894,1411085,2191,0,0,1,1
1411086,1411134,48,1,0,0,1
1411088,1411138,50,1,0,0,2
1411135,1411279,144,0,0,1,1
1411139,1411277,138,0,0,1,2
1411278,1411298,20,1,0,0,2
1411280,1411305,25,1,0,0,1
1411299,1411503,204,0,0,1,2
1411306,1411497,191,0,0,1,1
1411498,1411755,257,1,0,0,1
1411504,1411724,220,1,0,0,2
1411515,1411709,194,0,1,0,1
1411530,1411661,131,0,1,0,2
1411725,1411855,130,0,0,1,2
1411756,1411855,99,0,0,1,1
1411856,1411885,29,1,0,0,1
1411856,1411886,30,1,0,0,2
1411886,1412653,767,0,0,1,1
1411887,1412645,758,0,0,1,2
1412646,1412667,21,1,0,0,2
1412654,1412675,21,1,0,0,1
1412668,1413537,869,0,0,1,2
1412676,1413537,861,0,0,1,1
1413538,1413579,41,1,0,0,1
1413538,1413581,43,1,0,0,2
1413580,1413899,319,0,0,1,1
1413582,1413899,317,0,0,1,2
1413900,1413938,38,1,0,0,2
1413900,1413943,43,1,0,0,1
1413939,1414851,912,0,0,1,2
1413944,1414851,907,0,0,1,1
1414852,1414904,52,1,0,0,2
1414852,1414913,61,1,0,0,1
1414905,1415122,217,0,0,1,2
1414914,1415117,203,0,0,1,1
1415118,1415146,28,1,0,0,1
1415123,1415135,12,1,0,0,2
1415136,1415888,752,0,0,1,2
1415147,1415888,741,0,0,1,1
1415889,1415916,27,1,0,0,2
1415889,1415923,34,1,0,0,1
1415917,1417245,1328,0,0,1,2
1415924,1417244,1320,0,0,1,1
1417245,1417276,31,1,0,0,1
1417246,1417276,30,1,0,0,2
1417277,1418164,887,0,0,1,1
1417277,1418164,887,0,0,1,2
1418165,1418212,47,1,0,0,1
1418165,1418213,48,1,0,0,2
1418213,1418364,151,0,0,1,1
1418214,1418368,154,0,0,1,2
1418365,1418658,293,1,0,0,1
1418369,1418635,266,1,0,0,2
1418395,1418632,237,0,1,0,1
1418404,1418559,155,0,1,0,2
1418636,1420289,1653,0,0,1,2
1418659,1420288,1629,0,0,1,1
1420289,1420345,56,1,0,0,1
1420290,1420346,56,1,0,0,2
1420346,1421054,708,0,0,1,1
1420347,1421056,709,0,0,1,2
1421055,1421110,55,1,0,0,1
1421057,1421099,42,1,0,0,2
1421100,1421893,793,0,0,1,2
1421111,1421894,783,0,0,1,1
1421894,1421919,25,1,0,0,2
1421895,1421919,24,1,0,0,1
1421920,1422064,144,0,0,1,2
1421920,1422065,145,0,0,1,1
1422065,1422120,55,1,0,0,2
1422066,1422127,61,1,0,0,1
1422121,1422470,349,0,0,1,2
1422128,1422471,343,0,0,1,1
1422471,1422498,27,1,0,0,2
1422472,1422498,26,1,0,0,1
1422499,1424137,1638,0,0,1,2
1422499,1424143,1644,0,0,1,1
1424138,1424166,28,1,0,0,2
1424144,1424174,30,1,0,0,1
1424167,1424877,710,0,0,1,2
1424175,1424876,701,0,0,1,1
1424877,1425187,310,1,0,0,1
1424878,1425034,156,1,0,0,2
1424901,1425102,201,0,1,0,1
1424935,1424996,61,0,1,0,2
1425035,1425435,400,0,0,1,2
1425188,1425436,248,0,0,1,1
1425436,1425459,23,1,0,0,2
1425437,1425467,30,1,0,0,1
1425460,1426803,1343,0,0,1,2
1425468,1426803,1335,0,0,1,1
1426804,1426837,33,1,0,0,2
1426804,1426842,38,1,0,0,1
1426838,1427958,1120,0,0,1,2
1426843,1427942,1099,0,0,1,1
1427943,1428047,104,1,0,0,1
1427959,1428006,47,1,0,0,2
1427978,1428012,34,0,1,0,1
1428007,1428279,272,0,0,1,2
1428048,1428280,232,0,0,1,1
1428280,1428339,59,1,0,0,2
1428281,1428339,58,1,0,0,1
1428340,1428445,105,0,0,1,2
1428340,1428446,106,0,0,1,1
1428446,1428468,22,1,0,0,2
1428447,1428477,30,1,0,0,1
1428469,1428813,344,0,0,1,2
1428478,1428805,327,0,0,1,1
1428806,1429031,225,1,0,0,1
1428814,1428971,157,1,0,0,2
1428827,1429000,173,0,1,0,1
1428972,1429327,355,0,0,1,2
1429032,1429328,296,0,0,1,1
1429328,1429359,31,1,0,0,2
1429329,1429360,31,1,0,0,1
1429360,1429538,178,0,0,1,2
1429361,1429537,176,0,0,1,1
1429538,1429568,30,1,0,0,1
1429539,1429564,25,1,0,0,2
1429565,1430193,628,0,0,1,2
1429569,1430195,626,0,0,1,1
1430194,1430221,27,1,0,0,2
1430196,1430224,28,1,0,0,1
1430222,1431136,914,0,0,1,2
1430225,1431137,912,0,0,1,1
1431137,1431186,49,1,0,0,2
1431138,1431179,41,1,0,0,1
1431180,1431377,197,0,0,1,1
1431187,1431397,210,0,0,1,2
1431378,1431682,304,1,0,0,1
1431398,1431626,228,1,0,0,2
1431404,1431642,238,0,1,0,1
1431438,1431534,96,0,1,0,2
1431627,1431982,355,0,0,1,2
1431683,1431982,299,0,0,1,1
1431983,1432017,34,1,0,0,1
1431983,1432017,34,1,0,0,2
1432018,1433128,1110,0,0,1,1
1432018,1433140,1122,0,0,1,2
1433129,1433429,300,1,0,0,1
1433141,1433372,231,1,0,0,2
1433156,1433378,222,0,1,0,1
1433188,1433280,92,0,1,0,2
1433373,1435118,1745,0,0,1,2
1433430,1435117,1687,0,0,1,1
1435118,1435194,76,1,0,0,1
1435119,1435190,71,1,0,0,2
1435191,1436011,820,0,0,1,2
1435195,1436010,815,0,0,1,1
1436011,1436042,31,1,0,0,1
1436012,1436041,29,1,0,0,2
1436042,1437347,1305,0,0,1,2
1436043,1437347,1304,0,0,1,1
1437348,1437400,52,1,0,0,1
1437348,1437402,54,1,0,0,2
1437401,1438044,643,0,0,1,1
1437403,1438044,641,0,0,1,2
1438045,1438079,34,1,0,0,2
1438045,1438080,35,1,0,0,1
1438080,1439016,936,0,0,1,2
1438081,1439010,929,0,0,1,1
1439011,1439202,191,1,0,0,1
1439017,1439175,158,1,0,0,2
1439040,1439155,115,0,1,0,1
1439176,1439379,203,0,0,1,2
1439203,1439379,176,0,0,1,1
1439380,1439431,51,1,0,0,1
1439380,1439432,52,1,0,0,2
1439432,1439824,392,0,0,1,1
1439433,1439823,390,0,0,1,2
1439824,1439869,45,1,0,0,2
1439825,1439868,43,1,0,0,1
1439869,1440125,256,0,0,1,1
1439870,1440124,254,0,0,1,2
1440125,1440162,37,1,0,0,2
1440126,1440171,45,1,0,0,1
1440163,1440291,128,0,0,1,2
1440172,1440290,118,0,0,1,1
1440291,1440319,28,1,0,0,1
1440292,1440321,29,1,0,0,2
1440320,1441850,1530,0,0,1,1
1440322,1441850,1528,0,0,1,2
1441851,1441882,31,1,0,0,2
1441851,1441883,32,1,0,0,1
1441883,1442460,577,0,0,1,2
1441884,1442461,577,0,0,1,1
1442461,1442530,69,1,0,0,2
1442462,1442522,60,1,0,0,1
1442523,1442603,80,0,0,1,1
1442531,1442647,116,0,0,1,2
1442604,1442942,338,1,0,0,1
1442648,1442764,116,1,0,0,2
1442650,1442902,252,0,1,0,1
1442765,1442977,212,0,0,1,2
1442943,1442967,24,0,0,1,1
1442968,1443373,405,1,0,0,1
1442978,1443301,323,1,0,0,2
1442984,1443357,373,0,1,0,1
1443003,1443269,266,0,1,0,2
1443302,1443885,583,0,0,1,2
1443374,1443884,510,0,0,1,1
1443885,1443926,41,1,0,0,1
1443886,1443922,36,1,0,0,2
1443923,1444635,712,0,0,1,2
1443927,1444634,707,0,0,1,1
1444635,1444713,78,1,0,0,1
1444636,1444713,77,1,0,0,2
1444714,1444954,240,0,0,1,1
1444714,1444956,242,0,0,1,2
1444955,1445039,84,1,0,0,1
1444957,1445031,74,1,0,0,2
1445032,1445353,321,0,0,1,2
1445040,1445351,311,0,0,1,1
1445352,1445420,68,1,0,0,1
1445354,1445420,66,1,0,0,2
1445421,1445874,453,0,0,1,1
1445421,1445877,456,0,0,1,2
1445875,1445965,90,1,0,0,1
1445878,1445963,85,1,0,0,2
1445964,1446187,223,0,0,1,2
1445966,1446188,222,0,0,1,1
1446188,1446227,39,1,0,0,2
1446189,1446231,42,1,0,0,1
1446228,1446361,133,0,0,1,2
1446232,1446362,130,0,0,1,1
1446362,1446385,23,1,0,0,2
1446363,1446386,23,1,0,0,1
1446386,1448357,1971,0,0,1,2
1446387,1448357,1970,0,0,1,1
1448358,1448392,34,1,0,0,2
1448358,1448400,42,1,0,0,1
1448393,1448549,156,0,0,1,2
1448401,1448549,148,0,0,1,1
1448550,1448583,33,1,0,0,1
1448550,1448584,34,1,0,0,2
1448584,1448895,311,0,0,1,1
1448585,1448892,307,0,0,1,2
1448893,1448941,48,1,0,0,2
1448896,1448942,46,1,0,0,1
1448942,1450443,1501,0,0,1,2
1448943,1450442,1499,0,0,1,1
1450443,1450475,32,1,0,0,1
1450444,1450474,30,1,0,0,2
1450475,1450865,390,0,0,1,2
1450476,1450854,378,0,0,1,1
1450855,1450967,112,1,0,0,1
1450866,1450979,113,1,0,0,2
1450968,1451195,227,0,0,1,1
1450980,1451196,216,0,0,1,2
1451196,1451243,47,1,0,0,1
1451197,1451244,47,1,0,0,2
1451244,1451628,384,0,0,1,1
1451245,1451630,385,0,0,1,2
1451629,1451651,22,1,0,0,1
1451631,1451650,19,1,0,0,2
1451651,1452524,873,0,0,1,2
1451652,1452525,873,0,0,1,1
1452525,1452604,79,1,0,0,2
1452526,1452607,81,1,0,0,1
1452605,1452704,99,0,0,1,2
1452608,1452705,97,0,0,1,1
1452705,1452739,34,1,0,0,2
1452706,1452748,42,1,0,0,1
1452740,1452979,239,0,0,1,2
1452749,1452998,249,0,0,1,1
1452980,1453217,237,1,0,0,2
1452999,1453237,238,1,0,0,1
1453015,1453195,180,0,1,0,1
1453027,1453155,128,0,1,0,2
1453218,1453488,270,0,0,1,2
1453238,1453486,248,0,0,1,1
1453487,1453515,28,1,0,0,1
1453489,1453517,28,1,0,0,2
1453516,1454526,1010,0,0,1,1
1453518,1454525,1007,0,0,1,2
1454526,1454552,26,1,0,0,2
1454527,1454555,28,1,0,0,1
1454553,1454740,187,0,0,1,2
1454556,1454739,183,0,0,1,1
1454740,1454791,51,1,0,0,1
1454741,1454791,50,1,0,0,2
1454792,1455019,227,0,0,1,1
1454792,1455023,231,0,0,1,2
1455020,1455046,26,1,0,0,1
1455024,1455039,15,1,0,0,2
1455040,1456750,1710,0,0,1,2
1455047,1456723,1676,0,0,1,1
1456724,1457021,297,1,0,0,1
1456751,1456954,203,1,0,0,2
1456757,1456995,238,0,1,0,1
1456791,1456887,96,0,1,0,2
1456955,1457313,358,0,0,1,2
1457022,1457311,289,0,0,1,1
1457312,1457333,21,1,0,0,1
1457314,1457332,18,1,0,0,2
1457333,1457919,586,0,0,1,2
1457334,1457920,586,0,0,1,1
1457920,1457971,51,1,0,0,2
1457921,1457980,59,1,0,0,1
1457972,1458104,132,0,0,1,2
1457981,1458104,123,0,0,1,1
1458105,1458129,24,1,0,0,2
1458105,1458137,32,1,0,0,1
1458130,1459811,1681,0,0,1,2
1458138,1459809,1671,0,0,1,1
1459810,1459873,63,1,0,0,1
1459812,1459831,19,1,0,0,2
1459832,1460220,388,0,0,1,2
1459874,1460219,345,0,0,1,1
1460220,1460261,41,1,0,0,1
1460221,1460280,59,1,0,0,2
1460262,1460813,551,0,0,1,1
1460281,1460825,544,0,0,1,2
1460814,1460891,77,1,0,0,1
1460826,1460881,55,1,0,0,2
1460835,1460862,27,0,1,0,1
1460882,1462051,1169,0,0,1,2
1460892,1462034,1142,0,0,1,1
1462035,1462243,208,1,0,0,1
1462052,1462189,137,1,0,0,2
1462065,1462182,117,0,1,0,1
1462190,1462823,633,0,0,1,2
1462244,1462821,577,0,0,1,1
1462822,1462864,42,1,0,0,1
1462824,1462849,25,1,0,0,2
1462850,1463317,467,0,0,1,2
1462865,1463317,452,0,0,1,1
1463318,1463404,86,1,0,0,2
1463318,1463405,87,1,0,0,1
1463405,1463540,135,0,0,1,2
1463406,1463539,133,0,0,1,1
1463540,1463571,31,1,0,0,1
1463541,1463570,29,1,0,0,2
1463571,1464895,1324,0,0,1,2
1463572,1464891,1319,0,0,1,1
1464892,1464918,26,1,0,0,1
1464896,1464916,20,1,0,0,2
1464917,1465155,238,0,0,1,2
1464919,1465156,237,0,0,1,1
1465156,1465193,37,1,0,0,2
1465157,1465206,49,1,0,0,1
1465194,1465607,413,0,0,1,2
1465207,1465598,391,0,0,1,1
1465599,1465734,135,1,0,0,1
1465608,1465693,85,1,0,0,2
1465631,1465686,55,0,1,0,1
1465694,1465879,185,0,0,1,2
1465735,1465878,143,0,0,1,1
1465879,1465914,35,1,0,0,1
1465880,1465911,31,1,0,0,2
1465912,1465967,55,0,0,1,2
1465915,1465958,43,0,0,1,1
1465959,1466245,286,1,0,0,1
1465968,1466189,221,1,0,0,2
1465982,1466199,217,0,1,0,1
1466004,1466106,102,0,1,0,2
1466190,1466211,21,0,0,1,2
1466212,1466233,21,1,0,0,2
1466234,1466277,43,0,0,1,2
1466246,1466275,29,0,0,1,1
1466276,1466310,34,1,0,0,1
1466278,1466307,29,1,0,0,2
1466308,1466392,84,0,0,1,2
1466311,1466386,75,0,0,1,1
1466387,1466664,277,1,0,0,1
1466393,1466665,272,1,0,0,2
1466406,1466614,208,0,1,0,1
1466419,1466568,149,0,1,0,2
1466665,1467259,594,0,0,1,1
1466666,1467268,602,0,0,1,2
1467260,1467464,204,1,0,0,1
1467269,1467468,199,1,0,0,2
1467280,1467415,135,0,1,0,1
1467318,1467319,1,0,1,0,2
1467465,1468139,674,0,0,1,1
1467469,1468138,669,0,0,1,2
1468139,1468195,56,1,0,0,2
1468140,1468195,55,1,0,0,1
1468196,1468476,280,0,0,1,1
1468196,1468476,280,0,0,1,2
1468477,1468534,57,1,0,0,2
1468477,1468544,67,1,0,0,1
1468535,1468640,105,0,0,1,2
1468545,1468641,96,0,0,1,1
1468641,1468677,36,1,0,0,2
1468642,1468678,36,1,0,0,1
1468678,1470925,2247,0,0,1,2
1468679,1470925,2246,0,0,1,1
1470926,1470975,49,1,0,0,2
1470926,1470979,53,1,0,0,1
1470976,1472713,1737,0,0,1,2
1470980,1472715,1735,0,0,1,1
1472714,1472740,26,1,0,0,2
1472716,1472744,28,1,0,0,1
1472741,1472994,253,0,0,1,2
1472745,1472997,252,0,0,1,1
1472995,1473193,198,1,0,0,2
1472998,1473228,230,1,0,0,1
1473047,1473167,120,0,1,0,1
1473194,1473214,20,0,0,1,2
1473215,1473258,43,1,0,0,2
1473229,1473365,136,0,0,1,1
1473259,1473363,104,0,0,1,2
1473364,1473583,219,1,0,0,2
1473366,1473575,209,1,0,0,1
1473392,1473525,133,0,1,0,1
1473404,1473480,76,0,1,0,2
1473576,1474569,993,0,0,1,1
1473584,1474569,985,0,0,1,2
1474570,1474661,91,1,0,0,2
1474570,1474670,100,1,0,0,1
1474662,1474841,179,0,0,1,2
1474671,1474838,167,0,0,1,1
1474839,1474880,41,1,0,0,1
1474842,1474873,31,1,0,0,2
1474874,1476160,1286,0,0,1,2
1474881,1476160,1279,0,0,1,1
1476161,1476190,29,1,0,0,2
1476161,1476213,52,1,0,0,1
1476191,1476766,575,0,0,1,2
1476214,1476766,552,0,0,1,1
1476767,1476828,61,1,0,0,1
1476767,1476828,61,1,0,0,2
1476829,1477063,234,0,0,1,1
1476829,1477063,234,0,0,1,2
1477064,1477092,28,1,0,0,2
1477064,1477094,30,1,0,0,1
1477093,1477463,370,0,0,1,2
1477095,1477410,315,0,0,1,1
1477411,1477589,178,1,0,0,1
1477464,1477468,4,1,0,0,2
1477469,1480408,2939,0,0,1,2
1477590,1479015,1425,0,0,1,1
1479016,1479032,16,1,0,0,1
1479033,1480408,1375,0,0,1,1
1480409,1480472,63,1,0,0,2
1480409,1480528,119,1,0,0,1
1480473,1480609,136,0,0,1,2
1480529,1480606,77,0,0,1,1
1480607,1480650,43,1,0,0,1
1480610,1480642,32,1,0,0,2
1480643,1481504,861,0,0,1,2
1480651,1481506,855,0,0,1,1
1481505,1481535,30,1,0,0,2
1481507,1481536,29,1,0,0,1
1481536,1481714,178,0,0,1,2
1481537,1481714,177,0,0,1,1
1481715,1481747,32,1,0,0,2
1481715,1481763,48,1,0,0,1
1481748,1482126,378,0,0,1,2
1481764,1482125,361,0,0,1,1
1482126,1482157,31,1,0,0,1
1482127,1482154,27,1,0,0,2
1482155,1482832,677,0,0,1,2
1482158,1482831,673,0,0,1,1
1482832,1482904,72,1,0,0,1
1482833,1482899,66,1,0,0,2
1482900,1483392,492,0,0,1,2
1482905,1483360,455,0,0,1,1
1483361,1483502,141,1,0,0,1
1483393,1483438,45,1,0,0,2
1483402,1483449,47,0,1,0,1
1483439,1483471,32,0,0,1,2
1483472,1483488,16,1,0,0,2
1483489,1484442,953,0,0,1,2
1483503,1484425,922,0,0,1,1
1484426,1484669,243,1,0,0,1
1484443,1484618,175,1,0,0,2
1484460,1484600,140,0,1,0,1
1484619,1484648,29,0,0,1,2
1484649,1484668,19,1,0,0,2
1484669,1485034,365,0,0,1,2
1484670,1485021,351,0,0,1,1
1485022,1485369,347,1,0,0,1
1485035,1485371,336,1,0,0,2
1485050,1485314,264,0,1,0,1
1485069,1485244,175,0,1,0,2
1485370,1485859,489,0,0,1,1
1485372,1485860,488,0,0,1,2
1485860,1485892,32,1,0,0,1
1485861,1485899,38,1,0,0,2
1485893,1486379,486,0,0,1,1
1485900,1486379,479,0,0,1,2
1486380,1486401,21,1,0,0,1
1486380,1486401,21,1,0,0,2
1486402,1486526,124,0,0,1,1
1486402,1486527,125,0,0,1,2
1486527,1486591,64,1,0,0,1
1486528,1486589,61,1,0,0,2
1486590,1486740,150,0,0,1,2
1486592,1486741,149,0,0,1,1
1486741,1486772,31,1,0,0,2
1486742,1486771,29,1,0,0,1
1486772,1488245,1473,0,0,1,1
1486773,1488246,1473,0,0,1,2
1488246,1488276,30,1,0,0,1
1488247,1488273,26,1,0,0,2
1488274,1488430,156,0,0,1,2
1488277,1488430,153,0,0,1,1
1488431,1488487,56,1,0,0,2
1488431,1488488,57,1,0,0,1
1488488,1488609,121,0,0,1,2
1488489,1488607,118,0,0,1,1
1488608,1488638,30,1,0,0,1
1488610,1488630,20,1,0,0,2
1488631,1490216,1585,0,0,1,2
1488639,1490217,1578,0,0,1,1
1490217,1490248,31,1,0,0,2
1490218,1490250,32,1,0,0,1
1490249,1490477,228,0,0,1,2
1490251,1490446,195,0,0,1,1
1490447,1490731,284,1,0,0,1
1490478,1490694,216,1,0,0,2
1490486,1490679,193,0,1,0,1
1490532,1490563,31,0,1,0,2
1490695,1491086,391,0,0,1,2
1490732,1491086,354,0,0,1,1
1491087,1491133,46,1,0,0,1
1491087,1491133,46,1,0,0,2
1491134,1491600,466,0,0,1,2
1491134,1491601,467,0,0,1,1
1491601,1491697,96,1,0,0,2
1491602,1491701,99,1,0,0,1
1491698,1491827,129,0,0,1,2
1491702,1491826,124,0,0,1,1
1491827,1491866,39,1,0,0,1
1491828,1491857,29,1,0,0,2
1491858,1493346,1488,0,0,1,2
1491867,1493319,1452,0,0,1,1
1493320,1493378,58,1,0,0,1
1493347,1493376,29,1,0,0,2
1493377,1494218,841,0,0,1,2
1493379,1494216,837,0,0,1,1
1494217,1494270,53,1,0,0,1
1494219,1494270,51,1,0,0,2
1494271,1494716,445,0,0,1,1
1494271,1494718,447,0,0,1,2
1494717,1494757,40,1,0,0,1
1494719,1494755,36,1,0,0,2
1494756,1495692,936,0,0,1,2
1494758,1495692,934,0,0,1,1
1495693,1495724,31,1,0,0,2
1495693,1495728,35,1,0,0,1
1495725,1496015,290,0,0,1,2
1495729,1495999,270,0,0,1,1
1496000,1496107,107,1,0,0,1
1496016,1496029,13,1,0,0,2
1496030,1496062,32,0,0,1,2
1496030,1496088,58,0,1,0,1
1496063,1496097,34,1,0,0,2
1496098,1496598,500,0,0,1,2
1496108,1496598,490,0,0,1,1
1496599,1496646,47,1,0,0,2
1496599,1496657,58,1,0,0,1
1496647,1497180,533,0,0,1,2
1496658,1497181,523,0,0,1,1
1497181,1497219,38,1,0,0,2
1497182,1497221,39,1,0,0,1
1497220,1497589,369,0,0,1,2
1497222,1497589,367,0,0,1,1
1497590,1497647,57,1,0,0,2
1497590,1497696,106,1,0,0,1
1497648,1498059,411,0,0,1,2
1497697,1498058,361,0,0,1,1
1498059,1498121,62,1,0,0,1
1498060,1498120,60,1,0,0,2
1498121,1498293,172,0,0,1,2
1498122,1498292,170,0,0,1,1
1498293,1498368,75,1,0,0,1
1498294,1498355,61,1,0,0,2
1498356,1498506,150,0,0,1,2
1498369,1498504,135,0,0,1,1
1498505,1498543,38,1,0,0,1
1498507,1498542,35,1,0,0,2
1498543,1499867,1324,0,0,1,2
1498544,1499866,1322,0,0,1,1
1499867,1499920,53,1,0,0,1
1499868,1499901,33,1,0,0,2
1499902,1500202,300,0,0,1,2
1499921,1500118,197,0,0,1,1
1500119,1500565,446,1,0,0,1
1500203,1500244,41,1,0,0,2
1500245,1500289,44,0,0,1,2
1500290,1500511,221,1,0,0,2
1500316,1500511,195,0,1,0,1
1500360,1500427,67,0,1,0,2
1500512,1500661,149,0,0,1,2
1500566,1500661,95,0,0,1,1
1500662,1500694,32,1,0,0,2
1500662,1500695,33,1,0,0,1
1500695,1500953,258,0,0,1,2
1500696,1500942,246,0,0,1,1
1500943,1501238,295,1,0,0,1
1500954,1501131,177,1,0,0,2
1500967,1501128,161,0,1,0,1
1501007,1501036,29,0,1,0,2
1501132,1502091,959,0,0,1,2
1501239,1501305,66,0,0,1,1
1501306,1501321,15,1,0,0,1
1501322,1502065,743,0,0,1,1
1502066,1502460,394,1,0,0,1
1502092,1502383,291,1,0,0,2
1502099,1502377,278,0,1,0,1
1502147,1502253,106,0,1,0,2
1502384,1502744,360,0,0,1,2
1502461,1502499,38,0,0,1,1
1502500,1502515,15,1,0,0,1
1502516,1502742,226,0,0,1,1
1502743,1502769,26,1,0,0,1
1502745,1502768,23,1,0,0,2
1502769,1503202,433,0,0,1,2
1502770,1502973,203,0,0,1,1
1502974,1502983,9,1,0,0,1
1502984,1503202,218,0,0,1,1
1503203,1503224,21,1,0,0,2
1503203,1503226,23,1,0,0,1
1503225,1503520,295,0,0,1,2
1503227,1503519,292,0,0,1,1
1503520,1503585,65,1,0,0,1
1503521,1503587,66,1,0,0,2
1503586,1503702,116,0,0,1,1
1503588,1503703,115,0,0,1,2
1503703,1503733,30,1,0,0,1
1503704,1503730,26,1,0,0,2
1503731,1503953,222,0,0,1,2
1503734,1503952,218,0,0,1,1
1503953,1503984,31,1,0,0,1
1503954,1503982,28,1,0,0,2
1503983,1504109,126,0,0,1,2
1503985,1504110,125,0,0,1,1
1504110,1504140,30,1,0,0,2
1504111,1504139,28,1,0,0,1
1504140,1505197,1057,0,0,1,1
1504141,1505195,1054,0,0,1,2
1505196,1505213,17,1,0,0,2
1505198,1505221,23,1,0,0,1
1505214,1505625,411,0,0,1,2
1505222,1505627,405,0,0,1,1
1505626,1505690,64,1,0,0,2
1505628,1505702,74,1,0,0,1
1505691,1505764,73,0,0,1,2
1505703,1505757,54,0,0,1,1
1505758,1505781,23,1,0,0,1
1505765,1505776,11,1,0,0,2
1505777,1505984,207,0,0,1,2
1505782,1505978,196,0,0,1,1
1505979,1505998,19,1,0,0,1
1505985,1505997,12,1,0,0,2
1505998,1506954,956,0,0,1,2
1505999,1506953,954,0,0,1,1
1506954,1506987,33,1,0,0,1
1506955,1506978,23,1,0,0,2
1506979,1507165,186,0,0,1,2
1506988,1507163,175,0,0,1,1
1507164,1507200,36,1,0,0,1
1507166,1507189,23,1,0,0,2
1507190,1507340,150,0,0,1,2
1507201,1507338,137,0,0,1,1
1507339,1507368,29,1,0,0,1
1507341,1507360,19,1,0,0,2
1507361,1507514,153,0,0,1,2
1507369,1507511,142,0,0,1,1
1507512,1508036,524,1,0,0,1
1507515,1507965,450,1,0,0,2
1507558,1508003,445,0,1,0,1
1507582,1507951,369,0,1,0,2
1507966,1508071,105,0,0,1,2
1508037,1508070,33,0,0,1,1
1508071,1508097,26,1,0,0,1
1508072,1508095,23,1,0,0,2
1508096,1508172,76,0,0,1,2
1508098,1508170,72,0,0,1,1
1508171,1508195,24,1,0,0,1
1508173,1508192,19,1,0,0,2
1508193,1508271,78,0,0,1,2
1508196,1508271,75,0,0,1,1
1508272,1508296,24,1,0,0,1
1508272,1508296,24,1,0,0,2
1508297,1508406,109,0,0,1,1
1508297,1508407,110,0,0,1,2
1508407,1508419,12,1,0,0,1
1508408,1508414,6,1,0,0,2
1508415,1508982,567,0,0,1,2
1508420,1508982,562,0,0,1,1
1508983,1509070,87,1,0,0,2
1508983,1509082,99,1,0,0,1
1509071,1509281,210,0,0,1,2
1509083,1509280,197,0,0,1,1
1509281,1509312,31,1,0,0,1
1509282,1509310,28,1,0,0,2
1509311,1511063,1752,0,0,1,2
1509313,1511062,1749,0,0,1,1
1511063,1511091,28,1,0,0,1
1511064,1511091,27,1,0,0,2
1511092,1511590,498,0,0,1,2
1511092,1511591,499,0,0,1,1
1511591,1511641,50,1,0,0,2
1511592,1511646,54,1,0,0,1
1511642,1511841,199,0,0,1,2
1511647,1511839,192,0,0,1,1
1511840,1511873,33,1,0,0,1
1511842,1511873,31,1,0,0,2
1511874,1511965,91,0,0,1,2
1511874,1511967,93,0,0,1,1
1511966,1511991,25,1,0,0,2
1511968,1511991,23,1,0,0,1
1511992,1512025,33,0,0,1,2
1511992,1512162,170,0,0,1,1
1512026,1512041,15,1,0,0,2
1512042,1512159,117,0,0,1,2
1512160,1512165,5,1,0,0,2
1512163,1512173,10,1,0,0,1
1512166,1512503,337,0,0,1,2
1512174,1512469,295,0,0,1,1
1512470,1512900,430,1,0,0,1
1512504,1512652,148,1,0,0,2
1512505,1512651,146,0,1,0,1
1512653,1512707,54,0,0,1,2
1512708,1512736,28,1,0,0,2
1512737,1512860,123,0,0,1,2
1512861,1512876,15,1,0,0,2
1512877,1513005,128,0,0,1,2
1512901,1513003,102,0,0,1,1
1513004,1513025,21,1,0,0,1
1513006,1513023,17,1,0,0,2
1513024,1513175,151,0,0,1,2
1513026,1513156,130,0,0,1,1
1513157,1513488,331,1,0,0,1
1513176,1513478,302,1,0,0,2
1513186,1513394,208,0,1,0,1
1513198,1513317,119,0,1,0,2
1513479,1513723,244,0,0,1,2
1513489,1513531,42,0,0,1,1
1513532,1513621,89,1,0,0,1
1513622,1513717,95,0,0,1,1
1513718,1513793,75,1,0,0,1
1513724,1513796,72,1,0,0,2
1513794,1513905,111,0,0,1,1
1513797,1513908,111,0,0,1,2
1513906,1513930,24,1,0,0,1
1513909,1513927,18,1,0,0,2
1513928,1514274,346,0,0,1,2
1513931,1514269,338,0,0,1,1
1514270,1514647,377,1,0,0,1
1514275,1514311,36,1,0,0,2
1514312,1514351,39,0,0,1,2
1514352,1514551,199,1,0,0,2
1514358,1514518,160,0,1,0,1
1514389,1514476,87,0,1,0,2
1514552,1514902,350,0,0,1,2
1514648,1514899,251,0,0,1,1
1514900,1514938,38,1,0,0,1
1514903,1514927,24,1,0,0,2
1514928,1515287,359,0,0,1,2
1514939,1515285,346,0,0,1,1
1515286,1515397,111,1,0,0,1
1515288,1515386,98,1,0,0,2
1515387,1515473,86,0,0,1,2
1515398,1515472,74,0,0,1,1
1515473,1515533,60,1,0,0,1
1515474,1515534,60,1,0,0,2
1515534,1515598,64,0,0,1,1
1515535,1515601,66,0,0,1,2
1515599,1515627,28,1,0,0,1
1515602,1515627,25,1,0,0,2
1515628,1515788,160,0,0,1,1
1515628,1515788,160,0,0,1,2
1515789,1515808,19,1,0,0,2
1515789,1515818,29,1,0,0,1
1515809,1515984,175,0,0,1,2
1515819,1515985,166,0,0,1,1
1515985,1516007,22,1,0,0,2
1515986,1516020,34,1,0,0,1
1516008,1517376,1368,0,0,1,2
1516021,1516234,213,0,0,1,1
1516235,1516248,13,1,0,0,1
1516249,1517374,1125,0,0,1,1
1517375,1517404,29,1,0,0,1
1517377,1517394,17,1,0,0,2
1517395,1517725,330,0,0,1,2
1517405,1517724,319,0,0,1,1
1517725,1517782,57,1,0,0,1
1517726,1517783,57,1,0,0,2
1517783,1518092,309,0,0,1,1
1517784,1518089,305,0,0,1,2
1518090,1518505,415,1,0,0,2
1518093,1519230,1137,1,0,0,1
1518104,1518625,521,0,1,0,1
1518125,1518495,370,0,1,0,2
1518506,1518677,171,0,0,1,2
1518678,1519088,410,1,0,0,2
1518682,1519203,521,0,1,0,1
1518708,1519077,369,0,1,0,2
1519089,1519121,32,0,0,1,2
1519122,1519136,14,1,0,0,2
1519137,1519432,295,0,0,1,2
1519231,1519291,60,0,0,1,1
1519292,1519510,218,1,0,0,1
1519433,1519448,15,1,0,0,2
1519449,1519571,122,0,0,1,2
1519511,1519538,27,0,0,1,1
1519539,1520098,559,1,0,0,1
1519572,1519588,16,1,0,0,2
1519589,1519627,38,0,0,1,2
1519628,1520063,435,1,0,0,2
1519640,1520087,447,0,1,0,1
1519678,1520049,371,0,1,0,2
1520064,1520167,103,0,0,1,2
1520099,1520165,66,0,0,1,1
1520166,1520188,22,1,0,0,1
1520168,1520214,46,1,0,0,2
1520189,1520393,204,0,0,1,1
1520215,1520394,179,0,0,1,2
1520394,1520440,46,1,0,0,1
1520395,1520429,34,1,0,0,2
1520430,1520973,543,0,0,1,2
1520441,1520968,527,0,0,1,1
1520969,1520992,23,1,0,0,1
1520974,1520990,16,1,0,0,2
1520991,1521189,198,0,0,1,2
1520993,1521185,192,0,0,1,1
1521186,1521211,25,1,0,0,1
1521190,1521210,20,1,0,0,2
1521211,1521281,70,0,0,1,2
1521212,1521277,65,0,0,1,1
1521278,1521319,41,1,0,0,1
1521282,1521306,24,1,0,0,2
1521307,1521463,156,0,0,1,2
1521320,1521463,143,0,0,1,1
1521464,1521535,71,1,0,0,2
1521464,1521542,78,1,0,0,1
1521536,1521625,89,0,0,1,2
1521543,1521624,81,0,0,1,1
1521625,1521656,31,1,0,0,1
1521626,1521645,19,1,0,0,2
1521646,1522666,1020,0,0,1,2
1521657,1522077,420,0,0,1,1
1522078,1522084,6,1,0,0,1
1522085,1522666,581,0,0,1,1
1522667,1522686,19,1,0,0,2
1522667,1522687,20,1,0,0,1
1522687,1522899,212,0,0,1,2
1522688,1522898,210,0,0,1,1
1522899,1522925,26,1,0,0,1
1522900,1522919,19,1,0,0,2
1522920,1523979,1059,0,0,1,2
1522926,1523008,82,0,0,1,1
1523009,1523027,18,1,0,0,1
1523028,1523977,949,0,0,1,1
1523978,1524001,23,1,0,0,1
1523980,1523996,16,1,0,0,2
1523997,1524700,703,0,0,1,2
1524002,1524700,698,0,0,1,1
1524701,1524761,60,1,0,0,2
1524701,1524763,62,1,0,0,1
1524762,1525174,412,0,0,1,2
1524764,1525165,401,0,0,1,1
1525166,1525597,431,1,0,0,1
1525175,1525533,358,1,0,0,2
1525191,1525564,373,0,1,0,1
1525205,1525463,258,0,1,0,2
1525534,1525655,121,0,0,1,2
1525598,1525657,59,0,0,1,1
1525656,1525688,32,1,0,0,2
1525658,1525707,49,1,0,0,1
1525689,1526674,985,0,0,1,2
1525708,1526672,964,0,0,1,1
1526673,1527230,557,1,0,0,1
1526675,1527125,450,1,0,0,2
1526689,1527170,481,0,1,0,1
1526708,1527114,406,0,1,0,2
1527126,1527152,26,0,0,1,2
1527153,1527163,10,1,0,0,2
1527164,1527288,124,0,0,1,2
1527231,1527386,155,0,0,1,1
1527289,1527309,20,1,0,0,2
1527310,1527389,79,0,0,1,2
1527387,1527415,28,1,0,0,1
1527390,1527408,18,1,0,0,2
1527409,1527867,458,0,0,1,2
1527416,1527867,451,0,0,1,1
1527868,1527893,25,1,0,0,2
1527868,1527914,46,1,0,0,1
1527894,1528011,117,0,0,1,2
1527915,1528015,100,0,0,1,1
1528012,1528721,709,1,0,0,2
1528016,1529529,1513,1,0,0,1
1528029,1529116,1087,0,1,0,1
1528042,1528556,514,0,1,0,2
1528668,1528674,6,0,1,0,2
1528695,1528712,17,0,1,0,2
1528722,1528812,90,0,0,1,2
1528813,1528840,27,1,0,0,2
1528841,1529179,338,0,0,1,2
1529180,1529184,4,1,0,0,2
1529185,1530477,1292,0,0,1,2
1529530,1529558,28,0,0,1,1
1529559,1529827,268,1,0,0,1
1529828,1529882,54,0,0,1,1
1529883,1530174,291,1,0,0,1
1530175,1530207,32,0,0,1,1
1530208,1531138,930,1,0,0,1
1530478,1530495,17,1,0,0,2
1530496,1530865,369,0,0,1,2
1530866,1531052,186,1,0,0,2
1530907,1531052,145,0,1,0,1
1531053,1531658,605,0,0,1,2
1531139,1531223,84,0,0,1,1
1531224,1531228,4,1,0,0,1
1531229,1531345,116,0,0,1,1
1531346,1531400,54,1,0,0,1
1531401,1531638,237,0,0,1,1
1531639,1532373,734,1,0,0,1
1531659,1532072,413,1,0,0,2
1531665,1532190,525,0,1,0,1
1531694,1531913,219,0,1,0,2
1532073,1532098,25,0,0,1,2
1532099,1532105,6,1,0,0,2
1532106,1532318,212,0,0,1,2
1532319,1532323,4,1,0,0,2
1532324,1532436,112,0,0,1,2
1532374,1532399,25,0,0,1,1
1532400,1532983,583,1,0,0,1
1532437,1532781,344,1,0,0,2
1532462,1532873,411,0,1,0,1
1532493,1532701,208,0,1,0,2
1532782,1533111,329,0,0,1,2
1532984,1533108,124,0,0,1,1
1533109,1533133,24,1,0,0,1
1533112,1533126,14,1,0,0,2
1533127,1533455,328,0,0,1,2
1533134,1533453,319,0,0,1,1
1533454,1533522,68,1,0,0,1
1533456,1533479,23,1,0,0,2
1533480,1533716,236,0,0,1,2
1533523,1533715,192,0,0,1,1
1533716,1533753,37,1,0,0,1
1533717,1533754,37,1,0,0,2
1533754,1533991,237,0,0,1,1
1533755,1534119,364,0,0,1,2
1533992,1534019,27,1,0,0,1
1534020,1534116,96,0,0,1,1
1534117,1534177,60,1,0,0,1
1534120,1534156,36,1,0,0,2
1534157,1534307,150,0,0,1,2
1534178,1534305,127,0,0,1,1
1534306,1534337,31,1,0,0,1
1534308,1534336,28,1,0,0,2
1534337,1534562,225,0,0,1,2
1534338,1534576,238,0,0,1,1
1534563,1534576,13,1,0,0,2
1534577,1534581,4,1,0,0,1
1534577,1536062,1485,0,0,1,2
1534582,1536062,1480,0,0,1,1
1536063,1536086,23,1,0,0,2
1536063,1536095,32,1,0,0,1
1536087,1536481,394,0,0,1,2
1536096,1536480,384,0,0,1,1
1536481,1536498,17,1,0,0,1
1536482,1536496,14,1,0,0,2
1536497,1536735,238,0,0,1,2
1536499,1536735,236,0,0,1,1
1536736,1536807,71,1,0,0,2
1536736,1536815,79,1,0,0,1
1536808,1536950,142,0,0,1,2
1536816,1536950,134,0,0,1,1
1536951,1537443,492,1,0,0,2
1536951,1538419,1468,1,0,0,1
1536993,1538302,1309,0,1,0,1
1537022,1537428,406,0,1,0,2
1537444,1537471,27,0,0,1,2
1537472,1537506,34,1,0,0,2
1537507,1537590,83,0,0,1,2
1537591,1537610,19,1,0,0,2
1537611,1537669,58,0,0,1,2
1537670,1538177,507,1,0,0,2
1537725,1538166,441,0,1,0,2
1538178,1538204,26,0,0,1,2
1538205,1538209,4,1,0,0,2
1538210,1538244,34,0,0,1,2
1538245,1538260,15,1,0,0,2
1538261,1538523,262,0,0,1,2
1538420,1538443,23,0,0,1,1
1538444,1538474,30,1,0,0,1
1538475,1538509,34,0,0,1,1
1538510,1539163,653,1,0,0,1
1538524,1538928,404,1,0,0,2
1538527,1538972,445,0,1,0,1
1538548,1538918,370,0,1,0,2
1538929,1539139,210,0,0,1,2
1539140,1539150,10,1,0,0,2
1539151,1539273,122,0,0,1,2
1539164,1539224,60,0,0,1,1
1539225,1539749,524,1,0,0,1
1539274,1539285,11,1,0,0,2
1539286,1539351,65,0,0,1,2
1539352,1539670,318,1,0,0,2
1539361,1539696,335,0,1,0,1
1539376,1539608,232,0,1,0,2
1539671,1540052,381,0,0,1,2
1539750,1540057,307,0,0,1,1
1540053,1540070,17,1,0,0,2
1540058,1540078,20,1,0,0,1
1540071,1540237,166,0,0,1,2
1540079,1540253,174,0,0,1,1
1540238,1540245,7,1,0,0,2
1540246,1540432,186,0,0,1,2
1540254,1540269,15,1,0,0,1
1540270,1540431,161,0,0,1,1
1540432,1540511,79,1,0,0,1
1540433,1540507,74,1,0,0,2
1540508,1540670,162,0,0,1,2
1540512,1540668,156,0,0,1,1
1540669,1540708,39,1,0,0,1
1540671,1540706,35,1,0,0,2
1540707,1540878,171,0,0,1,2
1540709,1540878,169,0,0,1,1
1540879,1540904,25,1,0,0,2
1540879,1540913,34,1,0,0,1
1540905,1541121,216,0,0,1,2
1540914,1541119,205,0,0,1,1
1541120,1541152,32,1,0,0,1
1541122,1541144,22,1,0,0,2
1541145,1541330,185,0,0,1,2
1541153,1541327,174,0,0,1,1
1541328,1541347,19,1,0,0,1
1541331,1541348,17,1,0,0,2
1541348,1542846,1498,0,0,1,1
1541349,1542846,1497,0,0,1,2
1542847,1542893,46,1,0,0,2
1542847,1542901,54,1,0,0,1
1542894,1543201,307,0,0,1,2
1542902,1543196,294,0,0,1,1
1543197,1543657,460,1,0,0,1
1543202,1543603,401,1,0,0,2
1543220,1543631,411,0,1,0,1
1543236,1543484,248,0,1,0,2
1543604,1543988,384,0,0,1,2
1543658,1543985,327,0,0,1,1
1543986,1544010,24,1,0,0,1
1543989,1544010,21,1,0,0,2
1544011,1544202,191,0,0,1,1
1544011,1544209,198,0,0,1,2
1544203,1546914,2711,1,0,0,1
1544210,1545595,1385,1,0,0,2
1544221,1545644,1423,0,1,0,1
1544241,1545496,1255,0,1,0,2
1545596,1545741,145,0,0,1,2
1545742,1546094,352,1,0,0,2
1545772,1546677,905,0,1,0,1
1545812,1546024,212,0,1,0,2
1546095,1546205,110,0,0,1,2
1546206,1546589,383,1,0,0,2
1546251,1546510,259,0,1,0,2
1546590,1546874,284,0,0,1,2
1546875,1546915,40,1,0,0,2
1546915,1547044,129,0,0,1,1
1546916,1547043,127,0,0,1,2
1547044,1547079,35,1,0,0,2
1547045,1547073,28,1,0,0,1
1547074,1547321,247,0,0,1,1
1547080,1547320,240,0,0,1,2
1547321,1547344,23,1,0,0,2
1547322,1547355,33,1,0,0,1
1547345,1547569,224,0,0,1,2
1547356,1547569,213,0,0,1,1
1547570,1547594,24,1,0,0,2
1547570,1547604,34,1,0,0,1
1547595,1549216,1621,0,0,1,2
1547605,1549215,1610,0,0,1,1
1549216,1549239,23,1,0,0,1
1549217,1549239,22,1,0,0,2
1549240,1549427,187,0,0,1,1
1549240,1549428,188,0,0,1,2
1549428,1549461,33,1,0,0,1
1549429,1549451,22,1,0,0,2
1549452,1549650,198,0,0,1,2
1549462,1549648,186,0,0,1,1
1549649,1549715,66,1,0,0,1
1549651,1549705,54,1,0,0,2
1549706,1550399,693,0,0,1,2
1549716,1550381,665,0,0,1,1
1550382,1550663,281,1,0,0,1
1550400,1550603,203,1,0,0,2
1550412,1550619,207,0,1,0,1
1550429,1550564,135,0,1,0,2
1550604,1550714,110,0,0,1,2
1550664,1551025,361,0,0,1,1
1550715,1550736,21,1,0,0,2
1550737,1551026,289,0,0,1,2
1551026,1551057,31,1,0,0,1
1551027,1551056,29,1,0,0,2
1551057,1551232,175,0,0,1,2
1551058,1551234,176,0,0,1,1
1551233,1551252,19,1,0,0,2
1551235,1551253,18,1,0,0,1
1551253,1551342,89,0,0,1,2
1551254,1551340,86,0,0,1,1
1551341,1551365,24,1,0,0,1
1551343,1551365,22,1,0,0,2
1551366,1551407,41,0,0,1,1
1551366,1551408,42,0,0,1,2
1551408,1551432,24,1,0,0,1
1551409,1551864,455,1,0,0,2
1551433,1551551,118,0,0,1,1
1551552,1552445,893,1,0,0,1
1551566,1552353,787,0,1,0,1
1551588,1551843,255,0,1,0,2
1551865,1551885,20,0,0,1,2
1551886,1552294,408,1,0,0,2
1551914,1552283,369,0,1,0,2
1552295,1552381,86,0,0,1,2
1552382,1552408,26,1,0,0,2
1552409,1552828,419,0,0,1,2
1552446,1552814,368,0,0,1,1
1552815,1553212,397,1,0,0,1
1552829,1553162,333,1,0,0,2
1552847,1553182,335,0,1,0,1
1552883,1553115,232,0,1,0,2
1553163,1553460,297,0,0,1,2
1553213,1553460,247,0,0,1,1
1553461,1553558,97,1,0,0,1
1553461,1553558,97,1,0,0,2
1553559,1553651,92,0,0,1,1
1553559,1553651,92,0,0,1,2
1553652,1553694,42,1,0,0,2
1553652,1553698,46,1,0,0,1
1553695,1554001,306,0,0,1,2
1553699,1553999,300,0,0,1,1
1554000,1554033,33,1,0,0,1
1554002,1554029,27,1,0,0,2
1554030,1555756,1726,0,0,1,2
1554034,1555755,1721,0,0,1,1
1555756,1555815,59,1,0,0,1
1555757,1555815,58,1,0,0,2
1555816,1556197,381,0,0,1,1
1555816,1556197,381,0,0,1,2
1556198,1556224,26,1,0,0,2
1556198,1556231,33,1,0,0,1
1556225,1556411,186,0,0,1,2
1556232,1556402,170,0,0,1,1
1556403,1556676,273,1,0,0,1
1556412,1556671,259,1,0,0,2
1556447,1556608,161,0,1,0,1
1556488,1556563,75,0,1,0,2
1556672,1556723,51,0,0,1,2
1556677,1556937,260,0,0,1,1
1556724,1556746,22,1,0,0,2
1556747,1556939,192,0,0,1,2
1556938,1556975,37,1,0,0,1
1556940,1556972,32,1,0,0,2
1556973,1558054,1081,0,0,1,2
1556976,1558055,1079,0,0,1,1
1558055,1558092,37,1,0,0,2
1558056,1558092,36,1,0,0,1
1558093,1558555,462,0,0,1,1
1558093,1558555,462,0,0,1,2
1558556,1558590,34,1,0,0,2
1558556,1558603,47,1,0,0,1
1558591,1559191,600,0,0,1,2
1558604,1559191,587,0,0,1,1
1559192,1559270,78,1,0,0,2
1559192,1559278,86,1,0,0,1
1559271,1559386,115,0,0,1,2
1559279,1559386,107,0,0,1,1
1559387,1559416,29,1,0,0,2
1559387,1559419,32,1,0,0,1
1559417,1561188,1771,0,0,1,2
1559420,1561188,1768,0,0,1,1
1561189,1561256,67,1,0,0,2
1561189,1561257,68,1,0,0,1
1561257,1561467,210,0,0,1,2
1561258,1561465,207,0,0,1,1
1561466,1561499,33,1,0,0,1
1561468,1561498,30,1,0,0,2
1561499,1561704,205,0,0,1,2
1561500,1561702,202,0,0,1,1
1561703,1561732,29,1,0,0,1
1561705,1561728,23,1,0,0,2
1561729,1561767,38,0,0,1,2
1561733,1561765,32,0,0,1,1
1561766,1561793,27,1,0,0,1
1561768,1561793,25,1,0,0,2
1561794,1561936,142,0,0,1,2
1561794,1561937,143,0,0,1,1
1561937,1561959,22,1,0,0,2
1561938,1561960,22,1,0,0,1
1561960,1562274,314,0,0,1,2
1561961,1562272,311,0,0,1,1
1562273,1562298,25,1,0,0,1
1562275,1562299,24,1,0,0,2
1562299,1562389,90,0,0,1,1
1562300,1562389,89,0,0,1,2
1562390,1562414,24,1,0,0,2
1562390,1562417,27,1,0,0,1
1562415,1562448,33,0,0,1,2
1562418,1562632,214,0,0,1,1
1562449,1562456,7,1,0,0,2
1562457,1562635,178,0,0,1,2
1562633,1562891,258,1,0,0,1
1562636,1562865,229,1,0,0,2
1562658,1562851,193,0,1,0,1
1562673,1562770,97,0,1,0,2
1562866,1563214,348,0,0,1,2
1562892,1563212,320,0,0,1,1
1563213,1563497,284,1,0,0,1
1563215,1563450,235,1,0,0,2
1563235,1563450,215,0,1,0,1
1563247,1563359,112,0,1,0,2
1563451,1564708,1257,0,0,1,2
1563498,1564709,1211,0,0,1,1
1564709,1564768,59,1,0,0,2
1564710,1564784,74,1,0,0,1
1564769,1564884,115,0,0,1,2
1564785,1564883,98,0,0,1,1
1564884,1564916,32,1,0,0,1
1564885,1564905,20,1,0,0,2
1564906,1565117,211,0,0,1,2
1564917,1565118,201,0,0,1,1
1565118,1565145,27,1,0,0,2
1565119,1565147,28,1,0,0,1
1565146,1565391,245,0,0,1,2
1565148,1565391,243,0,0,1,1
1565392,1565409,17,1,0,0,2
1565392,1565419,27,1,0,0,1
1565410,1567135,1725,0,0,1,2
1565420,1567134,1714,0,0,1,1
1567135,1567209,74,1,0,0,1
1567136,1567206,70,1,0,0,2
1567207,1567703,496,0,0,1,2
1567210,1567699,489,0,0,1,1
1567700,1567977,277,1,0,0,1
1567704,1567915,211,1,0,0,2
1567727,1567906,179,0,1,0,1
1567772,1567802,30,0,1,0,2
1567916,1568023,107,0,0,1,2
1567978,1568023,45,0,0,1,1
1568024,1568049,25,1,0,0,2
1568024,1568058,34,1,0,0,1
1568050,1568220,170,0,0,1,2
1568059,1568220,161,0,0,1,1
1568221,1568236,15,1,0,0,2
1568221,1568674,453,1,0,0,1
1568237,1568272,35,0,0,1,2
1568273,1568514,241,1,0,0,2
1568289,1568534,245,0,1,0,1
1568302,1568399,97,0,1,0,2
1568515,1568588,73,0,0,1,2
1568589,1568605,16,1,0,0,2
1568606,1568786,180,0,0,1,2
1568675,1568778,103,0,0,1,1
1568779,1568961,182,1,0,0,1
1568787,1568798,11,1,0,0,2
1568799,1569016,217,0,0,1,2
1568962,1568996,34,0,0,1,1
1568997,1569075,78,1,0,0,1
1569017,1569047,30,1,0,0,2
1569048,1569510,462,0,0,1,2
1569076,1569510,434,0,0,1,1
1569511,1569798,287,1,0,0,2
1569511,1569901,390,1,0,0,1
1569539,1569811,272,0,1,0,1
1569557,1569725,168,0,1,0,2
1569799,1569824,25,0,0,1,2
1569825,1569829,4,1,0,0,2
1569830,1569979,149,0,0,1,2
1569902,1569972,70,0,0,1,1
1569973,1570244,271,1,0,0,1
1569980,1570002,22,1,0,0,2
1570003,1570206,203,0,0,1,2
1570207,1570229,22,1,0,0,2
1570230,1570575,345,0,0,1,2
1570245,1570360,115,0,0,1,1
1570361,1570659,298,1,0,0,1
1570576,1570593,17,1,0,0,2
1570594,1571100,506,0,0,1,2
1570660,1571102,442,0,0,1,1
1571101,1571154,53,1,0,0,2
1571103,1571155,52,1,0,0,1
1571155,1571697,542,0,0,1,2
1571156,1571697,541,0,0,1,1
1571698,1571733,35,1,0,0,1
1571698,1571740,42,1,0,0,2
1571734,1572495,761,0,0,1,1
1571741,1572494,753,0,0,1,2
1572495,1572530,35,1,0,0,2
1572496,1572539,43,1,0,0,1
1572531,1572678,147,0,0,1,2
1572540,1572664,124,0,0,1,1
1572665,1572983,318,1,0,0,1
1572679,1572976,297,1,0,0,2
1572693,1572941,248,0,1,0,1
1572705,1572856,151,0,1,0,2
1572977,1573493,516,0,0,1,2
1572984,1573493,509,0,0,1,1
1836645,1837250,605,0,1,0,2
1836645,1837316,671,0,1,0,1
1836645,1837342,697,1,0,0,2
1836645,1844228,7583,1,0,0,1
1837343,1837515,172,0,0,1,2
1837516,1837539,23,1,0,0,2
1837540,1838095,555,0,0,1,2
1838096,1843270,5174,1,0,0,2
1838158,1843276,5118,0,1,0,1
1838174,1838187,13,0,1,0,2
1838211,1843221,5010,0,1,0,2
1843271,1843615,344,0,0,1,2
1843616,1843871,255,1,0,0,2
1843622,1843995,373,0,1,0,1
1843642,1843816,174,0,1,0,2
1843838,1843842,4,0,1,0,2
1843872,1843977,105,0,0,1,2
1843978,1843996,18,1,0,0,2
1843997,1845084,1087,0,0,1,2
1844229,1844371,142,0,0,1,1
1844372,1853431,9059,1,0,0,1
1845085,1845303,218,1,0,0,2
1845092,1845334,242,0,1,0,1
1845106,1845232,126,0,1,0,2
1845304,1845923,619,0,0,1,2
1845924,1845936,12,1,0,0,2
1845937,1846849,912,0,0,1,2
1846850,1847025,175,1,0,0,2
1846920,1848966,2046,0,1,0,1
1846939,1846952,13,0,1,0,2
1846986,1847005,19,0,1,0,2
1847026,1847284,258,0,0,1,2
1847285,1847334,49,1,0,0,2
1847335,1848564,1229,0,0,1,2
1848565,1849135,570,1,0,0,2
1848606,1848918,312,0,1,0,2
1849045,1852603,3558,0,1,0,1
1849062,1849079,17,0,1,0,2
1849112,1849125,13,0,1,0,2
1849136,1849694,558,0,0,1,2
1849695,1850975,1280,1,0,0,2
1849714,1850770,1056,0,1,0,2
1850806,1850891,85,0,1,0,2
1850976,1851022,46,0,0,1,2
1851023,1851123,100,1,0,0,2
1851124,1851411,287,0,0,1,2
1851412,1852717,1305,1,0,0,2
1851464,1852197,733,0,1,0,2
1852275,1852489,214,0,1,0,2
1852718,1852820,102,0,0,1,2
1852821,1853411,590,1,0,0,2
1852863,1853409,546,0,1,0,1
1852887,1853261,374,0,1,0,2
1853412,1854114,702,0,0,1,2
1853432,1853487,55,0,0,1,1
1853488,1853516,28,1,0,0,1
1853517,1853591,74,0,0,1,1
1853592,1853712,120,1,0,0,1
1853713,1853821,108,0,0,1,1
1853822,1853998,176,1,0,0,1
1853999,1854075,76,0,0,1,1
1854076,1854155,79,1,0,0,1
1854115,1854135,20,1,0,0,2
1854136,1856065,1929,0,0,1,2
1854156,1854231,75,0,0,1,1
1854232,1854303,71,1,0,0,1
1854304,1854339,35,0,0,1,1
1854340,1856152,1812,1,0,0,1
1856066,1856152,86,1,0,0,2
1856153,1856260,107,0,0,1,1
1856153,1856261,108,0,0,1,2
1856261,1856290,29,1,0,0,1
1856262,1856293,31,1,0,0,2
1856291,1856485,194,0,0,1,1
1856294,1856487,193,0,0,1,2
1856486,1856501,15,1,0,0,1
1856488,1856501,13,1,0,0,2
1856502,1857743,1241,0,0,1,1
1856502,1857746,1244,0,0,1,2
1857744,1857815,71,1,0,0,1
1857747,1857815,68,1,0,0,2
1857816,1858080,264,0,0,1,2
1857816,1858081,265,0,0,1,1
1858081,1858150,69,1,0,0,2
1858082,1858152,70,1,0,0,1
1858151,1858284,133,0,0,1,2
1858153,1858284,131,0,0,1,1
1858285,1858321,36,1,0,0,2
1858285,1858322,37,1,0,0,1
1858322,1859838,1516,0,0,1,2
1858323,1859837,1514,0,0,1,1
1859838,1859918,80,1,0,0,1
1859839,1859910,71,1,0,0,2
1859911,1860188,277,0,0,1,2
1859919,1860188,269,0,0,1,1
1860189,1860250,61,1,0,0,1
1860189,1860251,62,1,0,0,2
1860251,1860363,112,0,0,1,1
1860252,1860364,112,0,0,1,2
1860364,1860390,26,1,0,0,1
1860365,1860383,18,1,0,0,2
1860384,1862331,1947,0,0,1,2
1860391,1862330,1939,0,0,1,1
1862331,1862409,78,1,0,0,1
1862332,1862400,68,1,0,0,2
1862401,1862490,89,0,0,1,2
1862410,1862490,80,0,0,1,1
1862491,1862528,37,1,0,0,1
1862491,1862531,40,1,0,0,2
1862529,1862703,174,0,0,1,1
1862532,1862702,170,0,0,1,2
1862703,1862718,15,1,0,0,2
1862704,1862719,15,1,0,0,1
1862719,1864491,1772,0,0,1,2
1862720,1864490,1770,0,0,1,1
1864491,1864536,45,1,0,0,1
1864492,1864544,52,1,0,0,2
1864537,1864652,115,0,0,1,1
1864545,1864653,108,0,0,1,2
1864653,1864733,80,1,0,0,1
1864654,1864724,70,1,0,0,2
1864725,1864866,141,0,0,1,2
1864734,1864863,129,0,0,1,1
1864864,1864887,23,1,0,0,1
1864867,1864895,28,1,0,0,2
1864888,1866480,1592,0,0,1,1
1864896,1866480,1584,0,0,1,2
1866481,1866558,77,1,0,0,2
1866481,1866559,78,1,0,0,1
1866559,1866878,319,0,0,1,2
1866560,1866877,317,0,0,1,1
1866878,1866938,60,1,0,0,1
1866879,1866949,70,1,0,0,2
1866939,1867122,183,0,0,1,1
1866950,1867123,173,0,0,1,2
1867123,1867531,408,1,0,0,1
1867124,1867361,237,1,0,0,2
1867150,1867353,203,0,1,0,1
1867162,1867307,145,0,1,0,2
1867362,1868523,1161,0,0,1,2
1867532,1868525,993,0,0,1,1
1868524,1868602,78,1,0,0,2
1868526,1868662,136,1,0,0,1
1868603,1869003,400,0,0,1,2
1868663,1869003,340,0,0,1,1
1869004,1869075,71,1,0,0,1
1869004,1869075,71,1,0,0,2
1869076,1869236,160,0,0,1,1
1869076,1869240,164,0,0,1,2
1869237,1869262,25,1,0,0,1
1869241,1869252,11,1,0,0,2
1869253,1870635,1382,0,0,1,2
1869263,1870635,1372,0,0,1,1
1870636,1870722,86,1,0,0,1
1870636,1870722,86,1,0,0,2
1870723,1871038,315,0,0,1,1
1870723,1871038,315,0,0,1,2
1871039,1871103,64,1,0,0,2
1871039,1871110,71,1,0,0,1
1871104,1871210,106,0,0,1,2
1871111,1871211,100,0,0,1,1
1871211,1871244,33,1,0,0,2
1871212,1871244,32,1,0,0,1
1871245,1872583,1338,0,0,1,1
1871245,1872586,1341,0,0,1,2
1872584,1872700,116,1,0,0,1
1872587,1872699,112,1,0,0,2
1872700,1872977,277,0,0,1,2
1872701,1872978,277,0,0,1,1
1872978,1873061,83,1,0,0,2
1872979,1873064,85,1,0,0,1
1873062,1873184,122,0,0,1,2
1873065,1873184,119,0,0,1,1
1873185,1873215,30,1,0,0,1
1873185,1873221,36,1,0,0,2
1873216,1874866,1650,0,0,1,1
1873222,1874868,1646,0,0,1,2
1874867,1874954,87,1,0,0,1
1874869,1874952,83,1,0,0,2
1874953,1875189,236,0,0,1,2
1874955,1875188,233,0,0,1,1
1875189,1875273,84,1,0,0,1
1875190,1875272,82,1,0,0,2
1875273,1875354,81,0,0,1,2
1875274,1875352,78,0,0,1,1
1875353,1875388,35,1,0,0,1
1875355,1875387,32,1,0,0,2
1875388,1876993,1605,0,0,1,2
1875389,1876992,1603,0,0,1,1
1876993,1877064,71,1,0,0,1
1876994,1877062,68,1,0,0,2
1877063,1877327,264,0,0,1,2
1877065,1877326,261,0,0,1,1
1877327,1877393,66,1,0,0,1
1877328,1877382,54,1,0,0,2
1877383,1877464,81,0,0,1,2
1877394,1877462,68,0,0,1,1
1877463,1877500,37,1,0,0,1
1877465,1877496,31,1,0,0,2
1877497,1879107,1610,0,0,1,2
1877501,1879108,1607,0,0,1,1
1879108,1879161,53,1,0,0,2
1879109,1879162,53,1,0,0,1
1879162,1879388,226,0,0,1,2
1879163,1879389,226,0,0,1,1
1879389,1879457,68,1,0,0,2
1879390,1879448,58,1,0,0,1
1879449,1879544,95,0,0,1,1
1879458,1879544,86,0,0,1,2
1879545,1879579,34,1,0,0,2
1879545,1879580,35,1,0,0,1
1879580,1880687,1107,0,0,1,2
1879581,1880687,1106,0,0,1,1
1880688,1880709,21,1,0,0,1
1880688,1880711,23,1,0,0,2
1880710,1880903,193,0,0,1,1
1880712,1880901,189,0,0,1,2
1880902,1880938,36,1,0,0,2
1880904,1880938,34,1,0,0,1
1880939,1881071,132,0,0,1,2
1880939,1881073,134,0,0,1,1
1881072,1881148,76,1,0,0,2
1881074,1881139,65,1,0,0,1
1881140,1881238,98,0,0,1,1
1881149,1881240,91,0,0,1,2
1881239,1881306,67,1,0,0,1
1881241,1881305,64,1,0,0,2
1881306,1881403,97,0,0,1,2
1881307,1881402,95,0,0,1,1
1881403,1881438,35,1,0,0,1
1881404,1881438,34,1,0,0,2
1881439,1881700,261,0,0,1,2
1881439,1881702,263,0,0,1,1
1881701,1881730,29,1,0,0,2
1881703,1881730,27,1,0,0,1
1881731,1883004,1273,0,0,1,2
1881731,1883005,1274,0,0,1,1
1883005,1883055,50,1,0,0,2
1883006,1883050,44,1,0,0,1
1883051,1883158,107,0,0,1,1
1883056,1883166,110,0,0,1,2
1883159,1883865,706,1,0,0,1
1883167,1883607,440,1,0,0,2
1883194,1883280,86,0,1,0,1
1883374,1883582,208,0,1,0,1
1883384,1883561,177,0,1,0,2
1883608,1884855,1247,0,0,1,2
1883866,1884855,989,0,0,1,1
1884856,1884882,26,1,0,0,1
1884856,1884882,26,1,0,0,2
1884883,1885282,399,0,0,1,1
1884883,1885282,399,0,0,1,2
1885283,1885425,142,1,0,0,2
1885283,1885427,144,1,0,0,1
1885426,1885520,94,0,0,1,2
1885428,1885519,91,0,0,1,1
1885520,1885546,26,1,0,0,1
1885521,1885548,27,1,0,0,2
1885547,1886979,1432,0,0,1,1
1885549,1886979,1430,0,0,1,2
1886980,1887072,92,1,0,0,1
1886980,1887074,94,1,0,0,2
1887073,1887241,168,0,0,1,1
1887075,1887242,167,0,0,1,2
1887242,1887278,36,1,0,0,1
1887243,1887275,32,1,0,0,2
1887276,1887410,134,0,0,1,2
1887279,1887411,132,0,0,1,1
1887411,1887478,67,1,0,0,2
1887412,1887477,65,1,0,0,1
1887478,1887594,116,0,0,1,1
1887479,1887595,116,0,0,1,2
1887595,1887624,29,1,0,0,1
1887596,1887624,28,1,0,0,2
1887625,1888691,1066,0,0,1,1
1887625,1888693,1068,0,0,1,2
1888692,1888713,21,1,0,0,1
1888694,1888714,20,1,0,0,2
1888714,1888936,222,0,0,1,1
1888715,1888938,223,0,0,1,2
1888937,1888957,20,1,0,0,1
1888939,1888957,18,1,0,0,2
1888958,1889200,242,0,0,1,1
1888958,1889201,243,0,0,1,2
1889201,1889222,21,1,0,0,1
1889202,1889224,22,1,0,0,2
1889223,1889437,214,0,0,1,1
1889225,1889436,211,0,0,1,2
1889437,1889515,78,1,0,0,2
1889438,1889513,75,1,0,0,1
1889514,1889605,91,0,0,1,1
1889516,1889606,90,0,0,1,2
1889606,1889630,24,1,0,0,1
1889607,1889623,16,1,0,0,2
1889624,1889685,61,0,0,1,2
1889631,1889686,55,0,0,1,1
1889686,1889752,66,1,0,0,2
1889687,1889750,63,1,0,0,1
1889751,1889855,104,0,0,1,1
1889753,1889854,101,0,0,1,2
1889855,1889906,51,1,0,0,2
1889856,1889904,48,1,0,0,1
1889905,1890011,106,0,0,1,1
1889907,1890008,101,0,0,1,2
1890009,1890284,275,1,0,0,2
1890012,1890082,70,1,0,0,1
1890083,1890166,83,0,0,1,1
1890092,1890152,60,0,1,0,2
1890167,1890183,16,1,0,0,1
1890184,1890333,149,0,0,1,1
1890285,1890317,32,0,0,1,2
1890318,1890563,245,1,0,0,2
1890334,1890364,30,1,0,0,1
1890365,1890497,132,0,0,1,1
1890498,1890520,22,1,0,0,1
1890521,1890926,405,0,0,1,1
1890564,1890929,365,0,0,1,2
1890927,1890948,21,1,0,0,1
1890930,1890947,17,1,0,0,2
1890948,1891141,193,0,0,1,2
1890949,1891142,193,0,0,1,1
1891142,1891151,9,1,0,0,2
1891143,1891159,16,1,0,0,1
1891152,1891266,114,0,0,1,2
1891160,1891307,147,0,0,1,1
1891267,1891275,8,1,0,0,2
1891276,1891313,37,0,0,1,2
1891308,1891394,86,1,0,0,1
1891314,1891391,77,1,0,0,2
1891392,1891680,288,0,0,1,2
1891395,1891679,284,0,0,1,1
1891680,1891712,32,1,0,0,1
1891681,1891708,27,1,0,0,2
1891709,1891827,118,0,0,1,2
1891713,1891828,115,0,0,1,1
1891828,1891844,16,1,0,0,2
1891829,1891845,16,1,0,0,1
1891845,1892499,654,0,0,1,2
1891846,1892011,165,0,0,1,1
1892012,1892022,10,1,0,0,1
1892023,1892500,477,0,0,1,1
1892500,1892523,23,1,0,0,2
1892501,1892522,21,1,0,0,1
1892523,1892655,132,0,0,1,1
1892524,1892654,130,0,0,1,2
1892655,1892678,23,1,0,0,2
1892656,1892677,21,1,0,0,1
1892678,1892731,53,0,0,1,1
1892679,1892735,56,0,0,1,2
1892732,1892741,9,1,0,0,1
1892736,1892742,6,1,0,0,2
1892742,1893137,395,0,0,1,1
1892743,1893136,393,0,0,1,2
1893137,1893164,27,1,0,0,2
1893138,1893159,21,1,0,0,1
1893160,1893275,115,0,0,1,1
1893165,1893276,111,0,0,1,2
1893276,1893288,12,1,0,0,1
1893277,1893292,15,1,0,0,2
1893289,1893360,71,0,0,1,1
1893293,1893363,70,0,0,1,2
1893361,1893377,16,1,0,0,1
1893364,1893376,12,1,0,0,2
1893377,1893513,136,0,0,1,2
1893378,1893521,143,0,0,1,1
1893514,1893698,184,1,0,0,2
1893522,1893726,204,1,0,0,1
1893557,1893620,63,0,1,0,2
1893558,1893629,71,0,1,0,1
1893699,1893840,141,0,0,1,2
1893727,1893849,122,0,0,1,1
1893841,1893857,16,1,0,0,2
1893850,1893864,14,1,0,0,1
1893858,1893890,32,0,0,1,2
1893865,1893902,37,0,0,1,1
1893891,1894049,158,1,0,0,2
1893903,1894049,146,1,0,0,1
1894050,1894112,62,0,0,1,2
1894050,1894129,79,0,0,1,1
1894113,1894136,23,1,0,0,2
1894130,1894149,19,1,0,0,1
1894137,1894310,173,0,0,1,2
1894150,1894308,158,0,0,1,1
1894309,1894333,24,1,0,0,1
1894311,1894407,96,1,0,0,2
1894334,1894533,199,0,0,1,1
1894408,1894529,121,0,0,1,2
1894530,1894600,70,1,0,0,2
1894534,1894555,21,1,0,0,1
1894556,1895047,491,0,0,1,1
1894601,1895061,460,0,0,1,2
1895048,1895065,17,1,0,0,1
1895062,1895070,8,1,0,0,2
1895066,1895644,578,0,0,1,1
1895071,1895131,60,0,0,1,2
1895132,1895174,42,1,0,0,2
1895175,1895334,159,0,0,1,2
1895335,1895771,436,1,0,0,2
1895645,1895776,131,1,0,0,1
1895772,1896089,317,0,0,1,2
1895777,1896088,311,0,0,1,1
1896089,1896133,44,1,0,0,1
1896090,1896131,41,1,0,0,2
1896132,1897065,933,0,0,1,2
1896134,1897065,931,0,0,1,1
1897066,1897089,23,1,0,0,1
1897066,1897089,23,1,0,0,2
1897090,1897134,44,0,0,1,1
1897090,1897134,44,0,0,1,2
1897135,1897160,25,1,0,0,1
1897135,1897161,26,1,0,0,2
1897161,1897455,294,0,0,1,1
1897162,1897454,292,0,0,1,2
1897455,1897477,22,1,0,0,2
1897456,1897479,23,1,0,0,1
1897478,1897777,299,0,0,1,2
1897480,1897774,294,0,0,1,1
1897775,1897794,19,1,0,0,1
1897778,1897793,15,1,0,0,2
1897794,1897944,150,0,0,1,2
1897795,1897940,145,0,0,1,1
1897941,1897946,5,1,0,0,1
1897945,1897955,10,1,0,0,2
1897947,1898077,130,0,0,1,1
1897956,1898079,123,0,0,1,2
1898078,1898122,44,1,0,0,1
1898080,1898114,34,1,0,0,2
1898115,1898439,324,0,0,1,2
1898123,1898214,91,0,0,1,1
1898215,1898223,8,1,0,0,1
1898224,1898442,218,0,0,1,1
1898440,1898459,19,1,0,0,2
1898443,1898459,16,1,0,0,1
1898460,1898612,152,0,0,1,2
1898460,1898614,154,0,0,1,1
1898613,1898635,22,1,0,0,2
1898615,1898634,19,1,0,0,1
1898635,1898897,262,0,0,1,1
1898636,1898663,27,0,0,1,2
1898664,1898675,11,1,0,0,2
1898676,1898896,220,0,0,1,2
1898897,1898910,13,1,0,0,2
1898898,1898911,13,1,0,0,1
1898911,1899108,197,0,0,1,2
1898912,1899103,191,0,0,1,1
1899104,1899290,186,1,0,0,1
1899109,1899255,146,1,0,0,2
1899153,1899177,24,0,1,0,1
1899256,1899388,132,0,0,1,2
1899291,1899386,95,0,0,1,1
1899387,1899670,283,1,0,0,1
1899389,1899641,252,1,0,0,2
1899420,1899569,149,0,1,0,1
1899428,1899528,100,0,1,0,2
1899642,1900057,415,0,0,1,2
1899671,1900058,387,0,0,1,1
1900058,1900140,82,1,0,0,2
1900059,1900140,81,1,0,0,1
1900141,1900263,122,0,0,1,1
1900141,1900263,122,0,0,1,2
1900264,1900297,33,1,0,0,2
1900264,1900308,44,1,0,0,1
1900298,1900510,212,0,0,1,2
1900309,1900513,204,0,0,1,1
1900511,1900533,22,1,0,0,2
1900514,1900533,19,1,0,0,1
1900534,1901584,1050,0,0,1,1
1900534,1901584,1050,0,0,1,2
1901585,1901607,22,1,0,0,2
1901585,1901608,23,1,0,0,1
1901608,1901775,167,0,0,1,2
1901609,1901763,154,0,0,1,1
1901764,1901976,212,1,0,0,1
1901776,1902040,264,1,0,0,2
1901818,1901901,83,0,1,0,2
1901825,1901908,83,0,1,0,1
1901977,1902129,152,0,0,1,1
1902041,1902105,64,0,0,1,2
1902106,1902217,111,1,0,0,2
1902130,1902221,91,1,0,0,1
1902218,1902399,181,0,0,1,2
1902222,1902398,176,0,0,1,1
1902399,1902464,65,1,0,0,1
1902400,1902465,65,1,0,0,2
1902465,1902561,96,0,0,1,1
1902466,1902560,94,0,0,1,2
1902561,1902583,22,1,0,0,2
1902562,1902583,21,1,0,0,1
1902584,1903909,1325,0,0,1,2
1902584,1903910,1326,0,0,1,1
1903910,1903993,83,1,0,0,2
1903911,1903993,82,1,0,0,1
1903994,1904236,242,0,0,1,1
1903994,1904236,242,0,0,1,2
1904237,1904317,80,1,0,0,2
1904237,1904325,88,1,0,0,1
1904318,1904427,109,0,0,1,2
1904326,1904428,102,0,0,1,1
1904428,1904477,49,1,0,0,2
1904429,1904478,49,1,0,0,1
1904478,1904672,194,0,0,1,2
1904479,1904668,189,0,0,1,1
1904669,1904685,16,1,0,0,1
1904673,1904685,12,1,0,0,2
1904686,1905630,944,0,0,1,2
1904686,1905631,945,0,0,1,1
1905631,1905918,287,1,0,0,2
1905632,1905905,273,1,0,0,1
1905698,1905832,134,0,1,0,1
1905733,1905809,76,0,1,0,2
1905906,1906060,154,0,0,1,1
1905919,1906059,140,0,0,1,2
1906060,1906162,102,1,0,0,2
1906061,1906154,93,1,0,0,1
1906155,1906258,103,0,0,1,1
1906163,1906224,61,0,0,1,2
1906225,1906303,78,1,0,0,2
1906259,1906310,51,1,0,0,1
1906304,1906359,55,0,0,1,2
1906311,1907501,1190,0,0,1,1
1906360,1906382,22,1,0,0,2
1906383,1907023,640,0,0,1,2
1907024,1907101,77,1,0,0,2
1907102,1907483,381,0,0,1,2
1907484,1907818,334,1,0,0,2
1907502,1907834,332,1,0,0,1
1907503,1907708,205,0,1,0,2
1907528,1907740,212,0,1,0,1
1907819,1908009,190,0,0,1,2
1907835,1908010,175,0,0,1,1
1908010,1908086,76,1,0,0,2
1908011,1908086,75,1,0,0,1
1908087,1908229,142,0,0,1,1
1908087,1908230,143,0,0,1,2
1908230,1908258,28,1,0,0,1
1908231,1908262,31,1,0,0,2
1908259,1908418,159,0,0,1,1
1908263,1908421,158,0,0,1,2
1908419,1908434,15,1,0,0,1
1908422,1908440,18,1,0,0,2
1908435,1909787,1352,0,0,1,1
1908441,1909788,1347,0,0,1,2
1909788,1909850,62,1,0,0,1
1909789,1909858,69,1,0,0,2
1909851,1910087,236,0,0,1,1
1909859,1910087,228,0,0,1,2
1910088,1910149,61,1,0,0,2
1910088,1910150,62,1,0,0,1
1910150,1910234,84,0,0,1,2
1910151,1910234,83,0,0,1,1
1910235,1910271,36,1,0,0,1
1910235,1910279,44,1,0,0,2
1910272,1910383,111,0,0,1,1
1910280,1910384,104,0,0,1,2
1910384,1910415,31,1,0,0,1
1910385,1910406,21,1,0,0,2
1910407,1911906,1499,0,0,1,2
1910416,1911905,1489,0,0,1,1
1911906,1911979,73,1,0,0,1
1911907,1911978,71,1,0,0,2
1911979,1912292,313,0,0,1,2
1911980,1912291,311,0,0,1,1
1912292,1912344,52,1,0,0,1
1912293,1912344,51,1,0,0,2
1912345,1912402,57,0,0,1,2
1912345,1912404,59,0,0,1,1
1912403,1912502,99,1,0,0,2
1912405,1912500,95,1,0,0,1
1912501,1912554,53,0,0,1,1
1912503,1912554,51,0,0,1,2
1912555,1912587,32,1,0,0,2
1912555,1912595,40,1,0,0,1
1912588,1913024,436,0,0,1,2
1912596,1913021,425,0,0,1,1
1913022,1913030,8,1,0,0,1
1913025,1913035,10,1,0,0,2
1913031,1914158,1127,0,0,1,1
1913036,1914161,1125,0,0,1,2
1914159,1914258,99,1,0,0,1
1914162,1914256,94,1,0,0,2
1914257,1914516,259,0,0,1,2
1914259,1914514,255,0,0,1,1
1914515,1914619,104,1,0,0,1
1914517,1914613,96,1,0,0,2
1914614,1914735,121,0,0,1,2
1914620,1914710,90,0,0,1,1
1914711,1916189,1478,1,0,0,1
1914736,1914777,41,1,0,0,2
1914778,1916061,1283,0,0,1,2
1916062,1916189,127,1,0,0,2
1916190,1916500,310,0,0,1,2
1916190,1916501,311,0,0,1,1
1916501,1916568,67,1,0,0,2
1916502,1916578,76,1,0,0,1
1916569,1916698,129,0,0,1,2
1916579,1916699,120,0,0,1,1
1916699,1916745,46,1,0,0,2
1916700,1916743,43,1,0,0,1
1916744,1917934,1190,0,0,1,1
1916746,1917933,1187,0,0,1,2
1917934,1918034,100,1,0,0,2
1917935,1918035,100,1,0,0,1
1918035,1918292,257,0,0,1,2
1918036,1918290,254,0,0,1,1
1918291,1918336,45,1,0,0,1
1918293,1918335,42,1,0,0,2
1918336,1918428,92,0,0,1,2
1918337,1918427,90,0,0,1,1
1918428,1918500,72,1,0,0,1
1918429,1918500,71,1,0,0,2
1918501,1918590,89,0,0,1,1
1918501,1918590,89,0,0,1,2
1918591,1918625,34,1,0,0,1
1918591,1918625,34,1,0,0,2
1918626,1919899,1273,0,0,1,1
1918626,1919900,1274,0,0,1,2
1919900,1919947,47,1,0,0,1
1919901,1919947,46,1,0,0,2
1919948,1920124,176,0,0,1,2
1919948,1920125,177,0,0,1,1
1920125,1920203,78,1,0,0,2
1920126,1920204,78,1,0,0,1
1920204,1920342,138,0,0,1,2
1920205,1920342,137,0,0,1,1
1920343,1920423,80,1,0,0,1
1920343,1920425,82,1,0,0,2
1920424,1920526,102,0,0,1,1
1920426,1920527,101,0,0,1,2
1920527,1920560,33,1,0,0,1
1920528,1920559,31,1,0,0,2
1920560,1921634,1074,0,0,1,2
1920561,1921635,1074,0,0,1,1
1921635,1921679,44,1,0,0,2
1921636,1921676,40,1,0,0,1
1921677,1921979,302,0,0,1,1
1921680,1921978,298,0,0,1,2
1921979,1922043,64,1,0,0,2
1921980,1922044,64,1,0,0,1
1922044,1922146,102,0,0,1,2
1922045,1922147,102,0,0,1,1
1922147,1922231,84,1,0,0,2
1922148,1922219,71,1,0,0,1
1922220,1923529,1309,0,0,1,1
1922232,1923528,1296,0,0,1,2
1923529,1923621,92,1,0,0,2
1923530,1923621,91,1,0,0,1
1923622,1923965,343,0,0,1,1
1923622,1923965,343,0,0,1,2
1923966,1924035,69,1,0,0,1
1923966,1924035,69,1,0,0,2
1924036,1924174,138,0,0,1,2
1924036,1924175,139,0,0,1,1
1924175,1924212,37,1,0,0,2
1924176,1924211,35,1,0,0,1
1924212,1925368,1156,0,0,1,1
1924213,1925369,1156,0,0,1,2
1925369,1925467,98,1,0,0,1
1925370,1925469,99,1,0,0,2
1925468,1925815,347,0,0,1,1
1925470,1925816,346,0,0,1,2
1925816,1925880,64,1,0,0,1
1925817,1925881,64,1,0,0,2
1925881,1925983,102,0,0,1,1
1925882,1925985,103,0,0,1,2
1925984,1926029,45,1,0,0,1
1925986,1926028,42,1,0,0,2
1926029,1927199,1170,0,0,1,2
1926030,1927200,1170,0,0,1,1
1927200,1927288,88,1,0,0,2
1927201,1927292,91,1,0,0,1
1927289,1927648,359,0,0,1,2
1927293,1927322,29,0,0,1,1
1927323,1927327,4,1,0,0,1
1927328,1927648,320,0,0,1,1
1927649,1927694,45,1,0,0,2
1927649,1927698,49,1,0,0,1
1927695,1929203,1508,0,0,1,2
1927699,1929203,1504,0,0,1,1
1929204,1929274,70,1,0,0,2
1929204,1929276,72,1,0,0,1
1929275,1929426,151,0,0,1,2
1929277,1929425,148,0,0,1,1
1929426,1929503,77,1,0,0,1
1929427,1929505,78,1,0,0,2
1929504,1929620,116,0,0,1,1
1929506,1929622,116,0,0,1,2
1929621,1929654,33,1,0,0,1
1929623,1929653,30,1,0,0,2
1929654,1931003,1349,0,0,1,2
1929655,1931000,1345,0,0,1,1
1931001,1931075,74,1,0,0,1
1931004,1931073,69,1,0,0,2
1931074,1931309,235,0,0,1,2
1931076,1931311,235,0,0,1,1
1931310,1931486,176,1,0,0,2
1931312,1931486,174,1,0,0,1
1931487,1931603,116,0,0,1,1
1931487,1931603,116,0,0,1,2
1931604,1931659,55,1,0,0,1
1931604,1931661,57,1,0,0,2
1931660,1932334,674,0,0,1,1
1931662,1932332,670,0,0,1,2
1932333,1932355,22,1,0,0,2
1932335,1932361,26,1,0,0,1
1932356,1933201,845,0,0,1,2
1932362,1933200,838,0,0,1,1
1933201,1933258,57,1,0,0,1
1933202,1933257,55,1,0,0,2
1933258,1933363,105,0,0,1,2
1933259,1933362,103,0,0,1,1
1933363,1933437,74,1,0,0,1
1933364,1933431,67,1,0,0,2
1933432,1933613,181,0,0,1,2
1933438,1933612,174,0,0,1,1
1933613,1933633,20,1,0,0,1
1933614,1933631,17,1,0,0,2
1933632,1934758,1126,0,0,1,2
1933634,1934759,1125,0,0,1,1
1934759,1934864,105,1,0,0,2
1934760,1934863,103,1,0,0,1
1934864,1935221,357,0,0,1,1
1934865,1935221,356,0,0,1,2
1935222,1935291,69,1,0,0,2
1935222,1935293,71,1,0,0,1
1935292,1935387,95,0,0,1,2
1935294,1935386,92,0,0,1,1
1935387,1935419,32,1,0,0,1
1935388,1935412,24,1,0,0,2
1935413,1936815,1402,0,0,1,2
1935420,1936814,1394,0,0,1,1
1936815,1936894,79,1,0,0,1
1936816,1936894,78,1,0,0,2
1936895,1937131,236,0,0,1,1
1936895,1937131,236,0,0,1,2
1937132,1937195,63,1,0,0,2
1937132,1937197,65,1,0,0,1
1937196,1937334,138,0,0,1,2
1937198,1937333,135,0,0,1,1
1937334,1937375,41,1,0,0,1
1937335,1937373,38,1,0,0,2
1937374,1938456,1082,0,0,1,2
1937376,1938454,1078,0,0,1,1
1938455,1938470,15,1,0,0,1
1938457,1938471,14,1,0,0,2
1938471,1938925,454,0,0,1,1
1938472,1938925,453,0,0,1,2
1938926,1938986,60,1,0,0,1
1938926,1938986,60,1,0,0,2
1938987,1939129,142,0,0,1,1
1938987,1939130,143,0,0,1,2
1939130,1939162,32,1,0,0,1
1939131,1939162,31,1,0,0,2
1939163,1940320,1157,0,0,1,1
1939163,1940322,1159,0,0,1,2
1940321,1940415,94,1,0,0,1
1940323,1940416,93,1,0,0,2
1940416,1940763,347,0,0,1,1
1940417,1940762,345,0,0,1,2
1940763,1940821,58,1,0,0,2
1940764,1940831,67,1,0,0,1
1940822,1940967,145,0,0,1,2
1940832,1940969,137,0,0,1,1
1940968,1941008,40,1,0,0,2
1940970,1941017,47,1,0,0,1
1941009,1942351,1342,0,0,1,2
1941018,1942350,1332,0,0,1,1
1942351,1942365,14,1,0,0,1
1942352,1942361,9,1,0,0,2
1942362,1942521,159,0,0,1,2
1942366,1942520,154,0,0,1,1
1942521,1942618,97,1,0,0,1
1942522,1942618,96,1,0,0,2
1942619,1942794,175,0,0,1,1
1942619,1942796,177,0,0,1,2
1942795,1942857,62,1,0,0,1
1942797,1942859,62,1,0,0,2
1942858,1943262,404,0,0,1,1
1942860,1943264,404,0,0,1,2
1943263,1943281,18,1,0,0,1
1943265,1943284,19,1,0,0,2
1943282,1944109,827,0,0,1,1
1943285,1944132,847,0,0,1,2
1944110,1944509,399,1,0,0,1
1944133,1944431,298,1,0,0,2
1944151,1944410,259,0,1,0,1
1944164,1944371,207,0,1,0,2
1944432,1944661,229,0,0,1,2
1944510,1944661,151,0,0,1,1
1944662,1944741,79,1,0,0,2
1944662,1944747,85,1,0,0,1
1944742,1944836,94,0,0,1,2
1944748,1944836,88,0,0,1,1
1944837,1944868,31,1,0,0,1
1944837,1944868,31,1,0,0,2
1944869,1945102,233,0,0,1,1
1944869,1945103,234,0,0,1,2
1945103,1945128,25,1,0,0,1
1945104,1945116,12,1,0,0,2
1945117,1945951,834,0,0,1,2
1945129,1945964,835,0,0,1,1
1945952,1946269,317,1,0,0,2
1945965,1946226,261,1,0,0,1
1946009,1946152,143,0,1,0,1
1946021,1946153,132,0,1,0,2
1946227,1946312,85,0,0,1,1
1946270,1946310,40,0,0,1,2
1946311,1946424,113,1,0,0,2
1946313,1946433,120,1,0,0,1
1946425,1946575,150,0,0,1,2
1946434,1946575,141,0,0,1,1
1946576,1946627,51,1,0,0,2
1946576,1946628,52,1,0,0,1
1946628,1946729,101,0,0,1,2
1946629,1946727,98,0,0,1,1
1946728,1946751,23,1,0,0,1
1946730,1946751,21,1,0,0,2
1946752,1947792,1040,0,0,1,1
1946752,1947795,1043,0,0,1,2
1947793,1947815,22,1,0,0,1
1947796,1947814,18,1,0,0,2
1947815,1947983,168,0,0,1,2
1947816,1947979,163,0,0,1,1
1947980,1947999,19,1,0,0,1
1947984,1947997,13,1,0,0,2
1947998,1948197,199,0,0,1,2
1948000,1948200,200,0,0,1,1
1948198,1948203,5,1,0,0,2
1948201,1948227,26,1,0,0,1
1948204,1948307,103,0,0,1,2
1948228,1948303,75,0,0,1,1
1948304,1948319,15,1,0,0,1
1948308,1948315,7,1,0,0,2
1948316,1948407,91,0,0,1,2
1948320,1948401,81,0,0,1,1
1948402,1948550,148,1,0,0,1
1948408,1948547,139,1,0,0,2
1948548,1948734,186,0,0,1,2
1948551,1948733,182,0,0,1,1
1948734,1948763,29,1,0,0,1
1948735,1948762,27,1,0,0,2
1948763,1948976,213,0,0,1,2
1948764,1948970,206,0,0,1,1
1948971,1948999,28,1,0,0,1
1948977,1948989,12,1,0,0,2
1948990,1949195,205,0,0,1,2
1949000,1949194,194,0,0,1,1
1949195,1949218,23,1,0,0,1
1949196,1949217,21,1,0,0,2
1949218,1949308,90,0,0,1,2
1949219,1949308,89,0,0,1,1
1949309,1949331,22,1,0,0,1
1949309,1949332,23,1,0,0,2
1949332,1949555,223,0,0,1,1
1949333,1949556,223,0,0,1,2
1949556,1949578,22,1,0,0,1
1949557,1949577,20,1,0,0,2
1949578,1949754,176,0,0,1,2
1949579,1949753,174,0,0,1,1
1949754,1949778,24,1,0,0,1
1949755,1949778,23,1,0,0,2
1949779,1950042,263,0,0,1,1
1949779,1950043,264,0,0,1,2
1950043,1950052,9,1,0,0,1
1950044,1950048,4,1,0,0,2
1950049,1950254,205,0,0,1,2
1950053,1950254,201,0,0,1,1
1950255,1950281,26,1,0,0,1
1950255,1950283,28,1,0,0,2
1950282,1950689,407,0,0,1,1
1950284,1950690,406,0,0,1,2
1950690,1950745,55,1,0,0,1
1950691,1950748,57,1,0,0,2
1950746,1950999,253,0,0,1,1
1950749,1950998,249,0,0,1,2
1950999,1951021,22,1,0,0,2
1951000,1951020,20,1,0,0,1
1951021,1951204,183,0,0,1,1
1951022,1951205,183,0,0,1,2
1951205,1951224,19,1,0,0,1
1951206,1951225,19,1,0,0,2
1951225,1951722,497,0,0,1,1
1951226,1951718,492,0,0,1,2
1951719,1951748,29,1,0,0,2
1951723,1951739,16,1,0,0,1
1951740,1951843,103,0,0,1,1
1951749,1951846,97,0,0,1,2
1951844,1951862,18,1,0,0,1
1951847,1951864,17,1,0,0,2
1951863,1951932,69,0,0,1,1
1951865,1951932,67,0,0,1,2
1951933,1951946,13,1,0,0,1
1951933,1951953,20,1,0,0,2
1951947,1952086,139,0,0,1,1
1951954,1952085,131,0,0,1,2
1952086,1952097,11,1,0,0,2
1952087,1952094,7,1,0,0,1
1952095,1952143,48,0,0,1,1
1952098,1952145,47,0,0,1,2
1952144,1952156,12,1,0,0,1
1952146,1952161,15,1,0,0,2
1952157,1952234,77,0,0,1,1
1952162,1952261,99,0,0,1,2
1952235,1952277,42,1,0,0,1
1952262,1952321,59,1,0,0,2
1952278,1952312,34,0,0,1,1
1952313,1952318,5,1,0,0,1
1952319,1952416,97,0,0,1,1
1952322,1952411,89,0,0,1,2
1952412,1952435,23,1,0,0,2
1952417,1952429,12,1,0,0,1
1952430,1952829,399,0,0,1,1
1952436,1952828,392,0,0,1,2
1952829,1952891,62,1,0,0,2
1952830,1952889,59,1,0,0,1
1952890,1953018,128,0,0,1,1
1952892,1953017,125,0,0,1,2
1953018,1953053,35,1,0,0,2
1953019,1953046,27,1,0,0,1
1953047,1953410,363,0,0,1,1
1953054,1953409,355,0,0,1,2
1953410,1953430,20,1,0,0,2
1953411,1953430,19,1,0,0,1
1953431,1953618,187,0,0,1,2
1953431,1953628,197,0,0,1,1
1953619,1953770,151,1,0,0,2
1953629,1953772,143,1,0,0,1
1953678,1953705,27,0,1,0,2
1953678,1953716,38,0,1,0,1
1953771,1954010,239,0,0,1,2
1953773,1954013,240,0,0,1,1
1954011,1954030,19,1,0,0,2
1954014,1954030,16,1,0,0,1
1954031,1955343,1312,0,0,1,2
1954031,1955344,1313,0,0,1,1
1955344,1955388,44,1,0,0,2
1955345,1955388,43,1,0,0,1
1955389,1957537,2148,0,0,1,1
1955389,1957538,2149,0,0,1,2
1957538,1957591,53,1,0,0,1
1957539,1957591,52,1,0,0,2
1957592,1957850,258,0,0,1,2
1957592,1957851,259,0,0,1,1
1957851,1957888,37,1,0,0,2
1957852,1957878,26,1,0,0,1
1957879,1958244,365,0,0,1,1
1957889,1958245,356,0,0,1,2
1958245,1958296,51,1,0,0,1
1958246,1958287,41,1,0,0,2
1958288,1958530,242,0,0,1,2
1958297,1958531,234,0,0,1,1
1958531,1958590,59,1,0,0,2
1958532,1958599,67,1,0,0,1
1958591,1958712,121,0,0,1,2
1958600,1958712,112,0,0,1,1
1958713,1958736,23,1,0,0,2
1958713,1958743,30,1,0,0,1
1958737,1960696,1959,0,0,1,2
1958744,1960696,1952,0,0,1,1
1960697,1960727,30,1,0,0,1
1960697,1960727,30,1,0,0,2
1960728,1961242,514,0,0,1,1
1960728,1961243,515,0,0,1,2
1961243,1961301,58,1,0,0,1
1961244,1961297,53,1,0,0,2
1961298,1961424,126,0,0,1,2
1961302,1961424,122,0,0,1,1
1961425,1961451,26,1,0,0,2
1961425,1961461,36,1,0,0,1
1961452,1963431,1979,0,0,1,2
1961462,1963431,1969,0,0,1,1
1963432,1963590,158,1,0,0,2
1963432,1963596,164,1,0,0,1
1963591,1963617,26,0,0,1,2
1963597,1963877,280,0,0,1,1
1963618,1963627,9,1,0,0,2
1963628,1963878,250,0,0,1,2
1963878,1963933,55,1,0,0,1
1963879,1963920,41,1,0,0,2
1963921,1964322,401,0,0,1,2
1963934,1964323,389,0,0,1,1
1964323,1964364,41,1,0,0,2
1964324,1964362,38,1,0,0,1
1964363,1964730,367,0,0,1,1
1964365,1964731,366,0,0,1,2
1964731,1964788,57,1,0,0,1
1964732,1964785,53,1,0,0,2
1964786,1965052,266,0,0,1,2
1964789,1965051,262,0,0,1,1
1965052,1965132,80,1,0,0,1
1965053,1965120,67,1,0,0,2
1965121,1965228,107,0,0,1,2
1965133,1965229,96,0,0,1,1
1965229,1965248,19,1,0,0,2
1965230,1965250,20,1,0,0,1
1965249,1967352,2103,0,0,1,2
1965251,1967352,2101,0,0,1,1
1967353,1967404,51,1,0,0,1
1967353,1967405,52,1,0,0,2
1967405,1967783,378,0,0,1,1
1967406,1967782,376,0,0,1,2
1967783,1967805,22,1,0,0,2
1967784,1967804,20,1,0,0,1
1967805,1968201,396,0,0,1,1
1967806,1968392,586,0,0,1,2
1968202,1968207,5,1,0,0,1
1968208,1968397,189,0,0,1,1
1968393,1968410,17,1,0,0,2
1968398,1968409,11,1,0,0,1
1968410,1968573,163,0,0,1,1
1968411,1968572,161,0,0,1,2
1968573,1968597,24,1,0,0,2
1968574,1968597,23,1,0,0,1
1968598,1968811,213,0,0,1,2
1968598,1968814,216,0,0,1,1
1968812,1968837,25,1,0,0,2
1968815,1968837,22,1,0,0,1
1968838,1969115,277,0,0,1,2
1968838,1969117,279,0,0,1,1
1969116,1969139,23,1,0,0,2
1969118,1969137,19,1,0,0,1
1969138,1969388,250,0,0,1,1
1969140,1969387,247,0,0,1,2
1969388,1969608,220,1,0,0,2
1969389,1969444,55,1,0,0,1
1969445,1969472,27,0,0,1,1
1969473,1969521,48,1,0,0,1
1969522,1969739,217,0,0,1,1
1969609,1969740,131,0,0,1,2
1969740,1969763,23,1,0,0,1
1969741,1969764,23,1,0,0,2
1969764,1969942,178,0,0,1,1
1969765,1969942,177,0,0,1,2
1969943,1969963,20,1,0,0,1
1969943,1969963,20,1,0,0,2
1969964,1970875,911,0,0,1,2
1969964,1970876,912,0,0,1,1
1970876,1970942,66,1,0,0,2
1970877,1970950,73,1,0,0,1
1970943,1971062,119,0,0,1,2
1970951,1971063,112,0,0,1,1
1971063,1971097,34,1,0,0,2
1971064,1971094,30,1,0,0,1
1971095,1971314,219,0,0,1,1
1971098,1971318,220,0,0,1,2
1971315,1971342,27,1,0,0,1
1971319,1971335,16,1,0,0,2
1971336,1973773,2437,0,0,1,2
1971343,1973772,2429,0,0,1,1
1973773,1973820,47,1,0,0,1
1973774,1973811,37,1,0,0,2
1973812,1974068,256,0,0,1,2
1973821,1974070,249,0,0,1,1
1974069,1974093,24,1,0,0,2
1974071,1974093,22,1,0,0,1
1974094,1974211,117,0,0,1,2
1974094,1974213,119,0,0,1,1
1974212,1974232,20,1,0,0,2
1974214,1974233,19,1,0,0,1
1974233,1974293,60,0,0,1,2
1974234,1974296,62,0,0,1,1
1974294,1974318,24,1,0,0,2
1974297,1974318,21,1,0,0,1
1974319,1974430,111,0,0,1,1
1974319,1974433,114,0,0,1,2
1974431,1974441,10,1,0,0,1
1974434,1975338,904,1,0,0,2
1974442,1974466,24,0,0,1,1
1974467,1974689,222,1,0,0,1
1974496,1974716,220,0,1,0,2
1974498,1974636,138,0,1,0,1
1974665,1974671,6,0,1,0,1
1974690,1974764,74,0,0,1,1
1974765,1974781,16,1,0,0,1
1974782,1974893,111,0,0,1,1
1974894,1975151,257,1,0,0,1
1974916,1975167,251,0,1,0,2
1974923,1975131,208,0,1,0,1
1975152,1975195,43,0,0,1,1
1975196,1975205,9,1,0,0,1
1975206,1975802,596,0,0,1,1
1975339,1975464,125,0,0,1,2
1975465,1975469,4,1,0,0,2
1975470,1975790,320,0,0,1,2
1975791,1976065,274,1,0,0,2
1975803,1976038,235,1,0,0,1
1975826,1976021,195,0,1,0,2
1975833,1975991,158,0,1,0,1
1976039,1976176,137,0,0,1,1
1976066,1976108,42,0,0,1,2
1976109,1976218,109,1,0,0,2
1976177,1976201,24,1,0,0,1
1976202,1977392,1190,0,0,1,1
1976219,1977389,1170,0,0,1,2
1977390,1977677,287,1,0,0,2
1977393,1977636,243,1,0,0,1
1977423,1977602,179,0,1,0,2
1977429,1977590,161,0,1,0,1
1977637,1977843,206,0,0,1,1
1977678,1977843,165,0,0,1,2
1977844,1977883,39,1,0,0,1
1977844,1977892,48,1,0,0,2
1977884,1978001,117,0,0,1,1
1977893,1978003,110,0,0,1,2
1978002,1978028,26,1,0,0,1
1978004,1978037,33,1,0,0,2
1978029,1979372,1343,0,0,1,1
1978038,1979374,1336,0,0,1,2
1979373,1979402,29,1,0,0,1
1979375,1979395,20,1,0,0,2
1979396,1979806,410,0,0,1,2
1979403,1979806,403,0,0,1,1
1979807,1979852,45,1,0,0,1
1979807,1979859,52,1,0,0,2
1979853,1981082,1229,0,0,1,1
1979860,1981083,1223,0,0,1,2
1981083,1981108,25,1,0,0,1
1981084,1981107,23,1,0,0,2
1981108,1981810,702,0,0,1,2
1981109,1981783,674,0,0,1,1
1981784,1982062,278,1,0,0,1
1981811,1982019,208,1,0,0,2
1981838,1981959,121,0,1,0,1
1981862,1981929,67,0,1,0,2
1982020,1982413,393,0,0,1,2
1982063,1982413,350,0,0,1,1
1982414,1982436,22,1,0,0,2
1982414,1982444,30,1,0,0,1
1982437,1983232,795,0,0,1,2
1982445,1983231,786,0,0,1,1
1983232,1983304,72,1,0,0,1
1983233,1983305,72,1,0,0,2
1983305,1983394,89,0,0,1,1
1983306,1983394,88,0,0,1,2
1983395,1983463,68,1,0,0,2
1983395,1983465,70,1,0,0,1
1983464,1983513,49,0,0,1,2
1983466,1983514,48,0,0,1,1
1983514,1983542,28,1,0,0,2
1983515,1983545,30,1,0,0,1
1983543,1983899,356,0,0,1,2
1983546,1983899,353,0,0,1,1
1983900,1983920,20,1,0,0,1
1983900,1983926,26,1,0,0,2
1983921,1985065,1144,0,0,1,1
1983927,1985064,1137,0,0,1,2
1985065,1985129,64,1,0,0,2
1985066,1985130,64,1,0,0,1
1985130,1985468,338,0,0,1,2
1985131,1985463,332,0,0,1,1
1985464,1985665,201,1,0,0,1
1985469,1985640,171,1,0,0,2
1985500,1985600,100,0,1,0,1
1985513,1985585,72,0,1,0,2
1985641,1987086,1445,0,0,1,2
1985666,1987079,1413,0,0,1,1
1987080,1987440,360,1,0,0,1
1987087,1987358,271,1,0,0,2
1987115,1987308,193,0,1,0,1
1987122,1987268,146,0,1,0,2
1987359,1987386,27,0,0,1,2
1987387,1987391,4,1,0,0,2
1987392,1987786,394,0,0,1,2
1987441,1987786,345,0,0,1,1
1987787,1987836,49,1,0,0,1
1987787,1987836,49,1,0,0,2
1987837,1988249,412,0,0,1,1
1987837,1988250,413,0,0,1,2
1988250,1988314,64,1,0,0,1
1988251,1988315,64,1,0,0,2
1988315,1988447,132,0,0,1,1
1988316,1988448,132,0,0,1,2
1988448,1988478,30,1,0,0,1
1988449,1988477,28,1,0,0,2
1988478,1989689,1211,0,0,1,2
1988479,1989689,1210,0,0,1,1
1989690,1989716,26,1,0,0,2
1989690,1989717,27,1,0,0,1
1989717,1990227,510,0,0,1,2
1989718,1990228,510,0,0,1,1
1990228,1990278,50,1,0,0,2
1990229,1990277,48,1,0,0,1
1990278,1990363,85,0,0,1,1
1990279,1991686,1407,0,0,1,2
1990364,1990379,15,1,0,0,1
1990380,1991690,1310,0,0,1,1
1991687,1991707,20,1,0,0,2
1991691,1991707,16,1,0,0,1
1991708,1992416,708,0,0,1,1
1991708,1992418,710,0,0,1,2
1992417,1992450,33,1,0,0,1
1992419,1992440,21,1,0,0,2
1992441,1992659,218,0,0,1,2
1992451,1992652,201,0,0,1,1
1992653,1993059,406,1,0,0,1
1992660,1992905,245,1,0,0,2
1992688,1992875,187,0,1,0,1
1992707,1992806,99,0,1,0,2
1992906,1993278,372,0,0,1,2
1993060,1993279,219,0,0,1,1
1993279,1993331,52,1,0,0,2
1993280,1993332,52,1,0,0,1
1993332,1993831,499,0,0,1,2
1993333,1993831,498,0,0,1,1
1993832,1993897,65,1,0,0,2
1993832,1993912,80,1,0,0,1
1993898,1994044,146,0,0,1,2
1993913,1994043,130,0,0,1,1
1994044,1994062,18,1,0,0,1
1994045,1994064,19,1,0,0,2
1994063,1995907,1844,0,0,1,1
1994065,1995907,1842,0,0,1,2
1995908,1995956,48,1,0,0,1
1995908,1995956,48,1,0,0,2
1995957,1998152,2195,0,0,1,2
1995957,1998153,2196,0,0,1,1
1998153,1998210,57,1,0,0,2
1998154,1998212,58,1,0,0,1
1998211,1998578,367,0,0,1,2
1998213,1998579,366,0,0,1,1
1998579,1998626,47,1,0,0,2
1998580,1998626,46,1,0,0,1
1998627,1998733,106,0,0,1,2
1998627,1998734,107,0,0,1,1
1998734,1998939,205,1,0,0,2
1998735,1999460,725,1,0,0,1
1998774,1998887,113,0,1,0,1
1998790,1998845,55,0,1,0,2
1998940,1999027,87,0,0,1,2
1999028,1999285,257,1,0,0,2
1999050,1999241,191,0,1,0,1
1999056,1999180,124,0,1,0,2
1999286,1999659,373,0,0,1,2
1999461,1999658,197,0,0,1,1
1999659,1999726,67,1,0,0,1
1999660,1999726,66,1,0,0,2
1999727,1999900,173,0,0,1,1
1999727,1999900,173,0,0,1,2
1999901,1999919,18,1,0,0,2
1999901,1999921,20,1,0,0,1
1999920,2001116,1196,0,0,1,2
1999922,2001118,1196,0,0,1,1
2001117,2001143,26,1,0,0,2
2001119,2001143,24,1,0,0,1
2001144,2001887,743,0,0,1,1
2001144,2001887,743,0,0,1,2
2001888,2001934,46,1,0,0,2
2001888,2001935,47,1,0,0,1
2001935,2004010,2075,0,0,1,2
2001936,2004009,2073,0,0,1,1
2004010,2004073,63,1,0,0,1
2004011,2004053,42,1,0,0,2
2004054,2004306,252,0,0,1,2
2004074,2004306,232,0,0,1,1
2004307,2004351,44,1,0,0,1
2004307,2004360,53,1,0,0,2
2004352,2004937,585,0,0,1,1
2004361,2004938,577,0,0,1,2
2004938,2004968,30,1,0,0,1
2004939,2004970,31,1,0,0,2
2004969,2005731,762,0,0,1,1
2004971,2005731,760,0,0,1,2
2005732,2005809,77,1,0,0,2
2005732,2005812,80,1,0,0,1
2005810,2005910,100,0,0,1,2
2005813,2005911,98,0,0,1,1
2005911,2005943,32,1,0,0,2
2005912,2005950,38,1,0,0,1
2005944,2006333,389,0,0,1,2
2005951,2006330,379,0,0,1,1
2006331,2006353,22,1,0,0,1
2006334,2006346,12,1,0,0,2
2006347,2007675,1328,0,0,1,2
2006354,2007675,1321,0,0,1,1
2007676,2007728,52,1,0,0,1
2007676,2007728,52,1,0,0,2
2007729,2009500,1771,0,0,1,1
2007729,2009502,1773,0,0,1,2
2009501,2009617,116,1,0,0,1
2009503,2009612,109,1,0,0,2
2009542,2009583,41,0,1,0,1
2009613,2009807,194,0,0,1,2
2009618,2009809,191,0,0,1,1
2009808,2010107,299,1,0,0,2
2009810,2010145,335,1,0,0,1
2009836,2010082,246,0,1,0,1
2009852,2010034,182,0,1,0,2
2010108,2010675,567,0,0,1,2
2010146,2010675,529,0,0,1,1
2010676,2010713,37,1,0,0,1
2010676,2010715,39,1,0,0,2
2010714,2010990,276,0,0,1,1
2010716,2010989,273,0,0,1,2
2010990,2011052,62,1,0,0,2
2010991,2011054,63,1,0,0,1
2011053,2011173,120,0,0,1,2
2011055,2011173,118,0,0,1,1
2011174,2011195,21,1,0,0,2
2011174,2011203,29,1,0,0,1
2011196,2012595,1399,0,0,1,2
2011204,2012591,1387,0,0,1,1
2012592,2012611,19,1,0,0,1
2012596,2012611,15,1,0,0,2
2012612,2013055,443,0,0,1,1
2012612,2013056,444,0,0,1,2
2013056,2013117,61,1,0,0,1
2013057,2013116,59,1,0,0,2
2013117,2015238,2121,0,0,1,2
2013118,2015237,2119,0,0,1,1
2015238,2015255,17,1,0,0,1
2015239,2015256,17,1,0,0,2
2015256,2015794,538,0,0,1,1
2015257,2015795,538,0,0,1,2
2015795,2015817,22,1,0,0,1
2015796,2015817,21,1,0,0,2
2015818,2016138,320,0,0,1,1
2015818,2016138,320,0,0,1,2
2016139,2016184,45,1,0,0,1
2016139,2016188,49,1,0,0,2
2016185,2016384,199,0,0,1,1
2016189,2016384,195,0,0,1,2
2016385,2016412,27,1,0,0,2
2016385,2016413,28,1,0,0,1
2016413,2016695,282,0,0,1,2
2016414,2016695,281,0,0,1,1
2016696,2016763,67,1,0,0,1
2016696,2016765,69,1,0,0,2
2016764,2016879,115,0,0,1,1
2016766,2016881,115,0,0,1,2
2016880,2016904,24,1,0,0,1
2016882,2016903,21,1,0,0,2
2016904,2018555,1651,0,0,1,2
2016905,2018555,1650,0,0,1,1
2018556,2018604,48,1,0,0,2
2018556,2018606,50,1,0,0,1
2018605,2018828,223,0,0,1,2
2018607,2018826,219,0,0,1,1
2018827,2018847,20,1,0,0,1
2018829,2018847,18,1,0,0,2
2018848,2019956,1108,0,0,1,1
2018848,2019958,1110,0,0,1,2
2019957,2019991,34,1,0,0,1
2019959,2019982,23,1,0,0,2
2019983,2020603,620,0,0,1,2
2019992,2020596,604,0,0,1,1
2020597,2020973,376,1,0,0,1
2020604,2020883,279,1,0,0,2
2020651,2020824,173,0,1,0,1
2020658,2020805,147,0,1,0,2
2020884,2021078,194,0,0,1,2
2020974,2021080,106,0,0,1,1
2021079,2021130,51,1,0,0,2
2021081,2021118,37,1,0,0,1
2021119,2021449,330,0,0,1,1
2021131,2021448,317,0,0,1,2
2021449,2021479,30,1,0,0,2
2021450,2021493,43,1,0,0,1
2021480,2021585,105,0,0,1,2
2021494,2021584,90,0,0,1,1
2021585,2021627,42,1,0,0,1
2021586,2021628,42,1,0,0,2
2021628,2021810,182,0,0,1,1
2021629,2021812,183,0,0,1,2
2021811,2021849,38,1,0,0,1
2021813,2021872,59,1,0,0,2
2021850,2021984,134,0,0,1,1
2021873,2021986,113,0,0,1,2
2021985,2022013,28,1,0,0,1
2021987,2022012,25,1,0,0,2
2022013,2022242,229,0,0,1,2
2022014,2022243,229,0,0,1,1
2022243,2022272,29,1,0,0,2
2022244,2022273,29,1,0,0,1
2022273,2022449,176,0,0,1,2
2022274,2022450,176,0,0,1,1
2022450,2022477,27,1,0,0,2
2022451,2022479,28,1,0,0,1
2022478,2022667,189,0,0,1,2
2022480,2022665,185,0,0,1,1
2022666,2022695,29,1,0,0,1
2022668,2022695,27,1,0,0,2
2022696,2023307,611,0,0,1,2
2022696,2023308,612,0,0,1,1
2023308,2023329,21,1,0,0,2
2023309,2023328,19,1,0,0,1
2023329,2023677,348,0,0,1,1
2023330,2023680,350,0,0,1,2
2023678,2023701,23,1,0,0,1
2023681,2023697,16,1,0,0,2
2023698,2023880,182,0,0,1,2
2023702,2023879,177,0,0,1,1
2023880,2023901,21,1,0,0,1
2023881,2023910,29,1,0,0,2
2023902,2024102,200,0,0,1,1
2023911,2024103,192,0,0,1,2
2024103,2024167,64,1,0,0,1
2024104,2024162,58,1,0,0,2
2024163,2024290,127,0,0,1,2
2024168,2024288,120,0,0,1,1
2024289,2024334,45,1,0,0,1
2024291,2024325,34,1,0,0,2
2024326,2024524,198,0,0,1,2
2024335,2024726,391,0,0,1,1
2024525,2024534,9,1,0,0,2
2024535,2024722,187,0,0,1,2
2024723,2024749,26,1,0,0,2
2024727,2024743,16,1,0,0,1
2024744,2024926,182,0,0,1,1
2024750,2024926,176,0,0,1,2
2024927,2024955,28,1,0,0,1
2024927,2024955,28,1,0,0,2
2024956,2026157,1201,0,0,1,1
2024956,2026177,1221,0,0,1,2
2026158,2026560,402,1,0,0,1
2026178,2026561,383,1,0,0,2
2026203,2026537,334,0,1,0,1
2026216,2026550,334,0,1,0,2
2026561,2026789,228,0,0,1,1
2026562,2026789,227,0,0,1,2
2026790,2026866,76,1,0,0,2
2026790,2026867,77,1,0,0,1
2026867,2027362,495,0,0,1,2
2026868,2027308,440,0,0,1,1
2027309,2027320,11,1,0,0,1
2027321,2027383,62,0,0,1,1
2027363,2029956,2593,1,0,0,2
2027394,2029448,2054,0,1,0,1
2027397,2029945,2548,0,1,0,2
2029458,2029498,40,1,0,0,1
2029499,2030380,881,0,0,1,1
2029957,2030379,422,0,0,1,2
2030380,2030409,29,1,0,0,2
2030381,2030410,29,1,0,0,1
2030410,2032023,1613,0,0,1,2
2030411,2032023,1612,0,0,1,1
2032024,2032092,68,1,0,0,2
2032024,2032099,75,1,0,0,1
2032093,2032608,515,0,0,1,2
2032100,2032608,508,0,0,1,1
2032609,2032632,23,1,0,0,1
2032609,2032634,25,1,0,0,2
2032633,2032869,236,0,0,1,1
2032635,2032883,248,0,0,1,2
2032870,2033114,244,1,0,0,1
2032884,2033106,222,1,0,0,2
2032915,2033031,116,0,1,0,1
2032929,2033019,90,0,1,0,2
2033107,2033441,334,0,0,1,2
2033115,2033442,327,0,0,1,1
2033442,2033475,33,1,0,0,2
2033443,2033475,32,1,0,0,1
2033476,2034218,742,0,0,1,1
2033476,2034218,742,0,0,1,2
2034219,2034238,19,1,0,0,1
2034219,2034240,21,1,0,0,2
2034239,2034499,260,0,0,1,1
2034241,2034500,259,0,0,1,2
2034500,2034550,50,1,0,0,1
2034501,2034535,34,1,0,0,2
2034536,2034858,322,0,0,1,2
2034551,2034857,306,0,0,1,1
2034858,2034908,50,1,0,0,1
2034859,2034901,42,1,0,0,2
2034902,2035273,371,0,0,1,2
2034909,2035274,365,0,0,1,1
2035274,2035301,27,1,0,0,2
2035275,2035317,42,1,0,0,1
2035302,2035491,189,0,0,1,2
2035318,2035492,174,0,0,1,1
2035492,2035562,70,1,0,0,2
2035493,2035570,77,1,0,0,1
2035563,2035664,101,0,0,1,2
2035571,2035663,92,0,0,1,1
2035664,2035700,36,1,0,0,1
2035665,2035698,33,1,0,0,2
2035699,2037191,1492,0,0,1,2
2035701,2037192,1491,0,0,1,1
2037192,2037253,61,1,0,0,2
2037193,2037255,62,1,0,0,1
2037254,2038038,784,0,0,1,2
2037256,2038039,783,0,0,1,1
2038039,2038075,36,1,0,0,2
2038040,2038084,44,1,0,0,1
2038076,2038539,463,0,0,1,2
2038085,2038541,456,0,0,1,1
2038540,2038578,38,1,0,0,2
2038542,2038579,37,1,0,0,1
2038579,2039117,538,0,0,1,2
2038580,2039107,527,0,0,1,1
2039108,2039246,138,1,0,0,1
2039118,2039262,144,1,0,0,2
2039247,2039517,270,0,0,1,1
2039263,2039518,255,0,0,1,2
2039518,2039569,51,1,0,0,1
2039519,2039559,40,1,0,0,2
2039560,2039963,403,0,0,1,2
2039570,2039965,395,0,0,1,1
2039964,2040026,62,1,0,0,2
2039966,2040003,37,1,0,0,1
2040004,2040530,526,0,0,1,1
2040027,2040530,503,0,0,1,2
2040531,2040604,73,1,0,0,1
2040531,2040605,74,1,0,0,2
2040605,2040709,104,0,0,1,1
2040606,2040709,103,0,0,1,2
2040710,2040743,33,1,0,0,1
2040710,2040744,34,1,0,0,2
2040744,2042847,2103,0,0,1,1
2040745,2042847,2102,0,0,1,2
2042848,2042904,56,1,0,0,2
2042848,2042906,58,1,0,0,1
2042905,2043722,817,0,0,1,2
2042907,2043722,815,0,0,1,1
2043723,2043756,33,1,0,0,1
2043723,2043757,34,1,0,0,2
2043757,2044422,665,0,0,1,1
2043758,2044421,663,0,0,1,2
2044422,2044447,25,1,0,0,2
2044423,2044448,25,1,0,0,1
2044448,2044715,267,0,0,1,2
2044449,2044715,266,0,0,1,1
2044716,2044741,25,1,0,0,2
2044716,2044748,32,1,0,0,1
2044742,2044941,199,0,0,1,2
2044749,2044941,192,0,0,1,1
2044942,2045129,187,1,0,0,2
2044942,2045200,258,1,0,0,1
2044986,2045138,152,0,1,0,1
2045130,2045152,22,0,0,1,2
2045153,2045171,18,1,0,0,2
2045172,2045654,482,0,0,1,2
2045201,2045234,33,0,0,1,1
2045235,2045261,26,1,0,0,1
2045262,2045654,392,0,0,1,1
2045655,2045689,34,1,0,0,1
2045655,2045689,34,1,0,0,2
2045690,2046874,1184,0,0,1,1
2045690,2046875,1185,0,0,1,2
2046875,2046962,87,1,0,0,1
2046876,2046961,85,1,0,0,2
2046962,2047106,144,0,0,1,2
2046963,2047106,143,0,0,1,1
2047107,2047131,24,1,0,0,1
2047107,2047131,24,1,0,0,2
2047132,2047784,652,0,0,1,2
2047132,2047785,653,0,0,1,1
2047785,2047819,34,1,0,0,2
2047786,2047819,33,1,0,0,1
2047820,2047896,76,0,0,1,1
2047820,2047896,76,0,0,1,2
2047897,2047930,33,1,0,0,1
2047897,2047930,33,1,0,0,2
2047931,2048289,358,0,0,1,1
2047931,2048291,360,0,0,1,2
2048290,2048320,30,1,0,0,1
2048292,2048319,27,1,0,0,2
2048320,2049214,894,0,0,1,2
2048321,2049213,892,0,0,1,1
2049214,2049281,67,1,0,0,1
2049215,2049270,55,1,0,0,2
2049271,2049869,598,0,0,1,2
2049282,2049866,584,0,0,1,1
2049867,2049920,53,1,0,0,1
2049870,2049881,11,1,0,0,2
2049882,2050113,231,0,0,1,2
2049921,2050112,191,0,0,1,1
2050113,2050137,24,1,0,0,1
2050114,2050138,24,1,0,0,2
2050138,2050219,81,0,0,1,1
2050139,2050220,81,0,0,1,2
2050220,2050308,88,1,0,0,1
2050221,2050256,35,1,0,0,2
2050257,2050771,514,0,0,1,2
2050309,2050768,459,0,0,1,1
2050769,2050815,46,1,0,0,1
2050772,2050792,20,1,0,0,2
2050793,2051252,459,0,0,1,2
2050816,2050876,60,0,0,1,1
2050877,2050917,40,1,0,0,1
2050918,2051073,155,0,0,1,1
2051074,2051110,36,1,0,0,1
2051111,2051252,141,0,0,1,1
2051253,2051278,25,1,0,0,2
2051253,2051292,39,1,0,0,1
2051279,2051324,45,0,0,1,2
2051293,2051323,30,0,0,1,1
2051324,2051646,322,1,0,0,1
2051325,2051548,223,1,0,0,2
2051391,2051568,177,0,1,0,1
2051445,2051470,25,0,1,0,2
2051549,2051808,259,0,0,1,2
2051647,2051770,123,0,0,1,1
2051771,2051996,225,1,0,0,1
2051809,2051842,33,1,0,0,2
2051843,2052572,729,0,0,1,2
2051997,2052073,76,0,0,1,1
2052074,2052343,269,1,0,0,1
2052344,2052372,28,0,0,1,1
2052373,2052414,41,1,0,0,1
2052415,2052543,128,0,0,1,1
2052544,2052611,67,1,0,0,1
2052573,2052600,27,1,0,0,2
2052601,2052963,362,0,0,1,2
2052612,2052714,102,0,0,1,1
2052715,2052745,30,1,0,0,1
2052746,2052788,42,0,0,1,1
2052789,2052888,99,1,0,0,1
2052889,2052911,22,0,0,1,1
2052912,2053061,149,1,0,0,1
2052964,2053051,87,1,0,0,2
2053052,2053158,106,0,0,1,2
2053062,2053158,96,0,0,1,1
2053159,2053181,22,1,0,0,2
2053159,2053182,23,1,0,0,1
2053182,2053402,220,0,0,1,2
2053183,2053403,220,0,0,1,1
2053403,2053420,17,1,0,0,2
2053404,2053429,25,1,0,0,1
2053421,2054511,1090,0,0,1,2
2053430,2054511,1081,0,0,1,1
2054512,2054542,30,1,0,0,2
2054512,2054543,31,1,0,0,1
2054543,2054919,376,0,0,1,2
2054544,2054917,373,0,0,1,1
2054918,2054981,63,1,0,0,1
2054920,2054971,51,1,0,0,2
2054972,2055378,406,0,0,1,2
2054982,2055377,395,0,0,1,1
2055378,2055400,22,1,0,0,1
2055379,2055402,23,1,0,0,2
2055401,2055801,400,0,0,1,1
2055403,2055793,390,0,0,1,2
2055794,2056113,319,1,0,0,2
2055802,2056125,323,1,0,0,1
2055835,2056020,185,0,1,0,1
2055852,2055951,99,0,1,0,2
2055972,2055976,4,0,1,0,2
2056114,2056927,813,0,0,1,2
2056126,2056408,282,0,0,1,1
2056409,2056418,9,1,0,0,1
2056419,2056934,515,0,0,1,1
2056928,2057231,303,1,0,0,2
2056935,2057267,332,1,0,0,1
2056958,2057187,229,0,1,0,1
2056960,2057127,167,0,1,0,2
2057232,2057361,129,0,0,1,2
2057268,2057523,255,0,0,1,1
2057362,2057381,19,1,0,0,2
2057382,2057531,149,0,0,1,2
2057524,2058101,577,1,0,0,1
2057532,2057955,423,1,0,0,2
2057596,2057968,372,0,1,0,1
2057601,2057866,265,0,1,0,2
2057956,2058037,81,0,0,1,2
2058038,2058065,27,1,0,0,2
2058066,2058400,334,0,0,1,2
2058102,2058400,298,0,0,1,1
2058401,2058466,65,1,0,0,1
2058401,2058469,68,1,0,0,2
2058467,2058570,103,0,0,1,1
2058470,2058570,100,0,0,1,2
2058571,2058595,24,1,0,0,2
2058571,2058604,33,1,0,0,1
2058596,2058860,264,0,0,1,2
2058605,2058858,253,0,0,1,1
2058859,2058888,29,1,0,0,1
2058861,2058889,28,1,0,0,2
2058889,2059899,1010,0,0,1,1
2058890,2059901,1011,0,0,1,2
2059900,2059933,33,1,0,0,1
2059902,2059932,30,1,0,0,2
2059933,2060210,277,0,0,1,2
2059934,2060212,278,0,0,1,1
2060211,2060271,60,1,0,0,2
2060213,2060278,65,1,0,0,1
2060272,2060422,150,0,0,1,2
2060279,2060424,145,0,0,1,1
2060423,2060457,34,1,0,0,2
2060425,2060456,31,1,0,0,1
2060457,2060750,293,0,0,1,1
2060458,2060750,292,0,0,1,2
2060751,2060774,23,1,0,0,2
2060751,2060775,24,1,0,0,1
2060775,2061013,238,0,0,1,2
2060776,2061016,240,0,0,1,1
2061014,2061038,24,1,0,0,2
2061017,2061038,21,1,0,0,1
2061039,2061243,204,0,0,1,2
2061039,2061244,205,0,0,1,1
2061244,2061269,25,1,0,0,2
2061245,2061265,20,1,0,0,1
2061266,2061523,257,0,0,1,1
2061270,2061521,251,0,0,1,2
2061522,2061545,23,1,0,0,2
2061524,2061546,22,1,0,0,1
2061546,2061656,110,0,0,1,2
2061547,2061657,110,0,0,1,1
2061657,2061683,26,1,0,0,2
2061658,2061679,21,1,0,0,1
2061680,2061736,56,0,0,1,1
2061684,2061729,45,0,0,1,2
2061730,2061750,20,1,0,0,2
2061737,2061752,15,1,0,0,1
2061751,2061836,85,0,0,1,2
2061753,2061836,83,0,0,1,1
2061837,2061846,9,1,0,0,1
2061837,2061852,15,1,0,0,2
2061847,2061970,123,0,0,1,1
2061853,2061968,115,0,0,1,2
2061969,2062295,326,1,0,0,2
2061971,2062231,260,1,0,0,1
2062008,2062181,173,0,1,0,1
2062016,2062185,169,0,1,0,2
2062232,2062574,342,0,0,1,1
2062296,2062575,279,0,0,1,2
2062575,2062645,70,1,0,0,1
2062576,2062637,61,1,0,0,2
2062638,2062754,116,0,0,1,2
2062646,2062765,119,0,0,1,1
2062755,2063075,320,1,0,0,2
2062766,2063049,283,1,0,0,1
2062781,2063013,232,0,1,0,2
2062787,2062992,205,0,1,0,1
2063050,2063551,501,0,0,1,1
2063076,2063551,475,0,0,1,2
2063552,2063635,83,1,0,0,2
2063552,2063641,89,1,0,0,1
2063636,2063729,93,0,0,1,2
2063642,2063728,86,0,0,1,1
2063729,2063767,38,1,0,0,1
2063730,2063762,32,1,0,0,2
2063763,2064265,502,0,0,1,2
2063768,2064258,490,0,0,1,1
2064259,2064285,26,1,0,0,1
2064266,2064280,14,1,0,0,2
2064281,2065119,838,0,0,1,2
2064286,2065121,835,0,0,1,1
2065120,2065141,21,1,0,0,2
2065122,2065147,25,1,0,0,1
2065142,2065433,291,0,0,1,2
2065148,2065433,285,0,0,1,1
2065434,2065481,47,1,0,0,2
2065434,2065483,49,1,0,0,1
2065482,2065971,489,0,0,1,2
2065484,2065957,473,0,0,1,1
2065958,2066206,248,1,0,0,1
2065972,2066140,168,1,0,0,2
2066013,2066037,24,0,1,0,1
2066141,2066389,248,0,0,1,2
2066207,2066388,181,0,0,1,1
2066389,2066417,28,1,0,0,1
2066390,2066410,20,1,0,0,2
2066411,2067687,1276,0,0,1,2
2066418,2067688,1270,0,0,1,1
2067688,2067733,45,1,0,0,2
2067689,2067732,43,1,0,0,1
2067733,2068066,333,0,0,1,1
2067734,2068067,333,0,0,1,2
2068067,2068104,37,1,0,0,1
2068068,2068093,25,1,0,0,2
2068094,2068378,284,0,0,1,2
2068105,2068377,272,0,0,1,1
2068378,2068401,23,1,0,0,1
2068379,2068398,19,1,0,0,2
2068399,2068845,446,0,0,1,2
2068402,2068844,442,0,0,1,1
2068845,2068947,102,1,0,0,1
2068846,2068949,103,1,0,0,2
2068948,2069077,129,0,0,1,1
2068950,2069077,127,0,0,1,2
2069078,2069106,28,1,0,0,2
2069078,2069107,29,1,0,0,1
2069107,2070959,1852,0,0,1,2
2069108,2070958,1850,0,0,1,1
2070959,2071026,67,1,0,0,1
2070960,2071023,63,1,0,0,2
2071024,2071979,955,0,0,1,2
2071027,2071979,952,0,0,1,1
2071980,2072002,22,1,0,0,1
2071980,2072003,23,1,0,0,2
2072003,2072319,316,0,0,1,1
2072004,2072319,315,0,0,1,2
2072320,2072351,31,1,0,0,2
2072320,2072354,34,1,0,0,1
2072352,2072894,542,0,0,1,2
2072355,2072886,531,0,0,1,1
2072887,2072917,30,1,0,0,1
2072895,2072916,21,1,0,0,2
2072917,2072963,46,0,0,1,2
2072918,2073270,352,0,0,1,1
2072964,2072975,11,1,0,0,2
2072976,2073268,292,0,0,1,2
2073269,2073300,31,1,0,0,2
2073271,2073303,32,1,0,0,1
2073301,2073654,353,0,0,1,2
2073304,2073655,351,0,0,1,1
2073655,2073704,49,1,0,0,2
2073656,2073693,37,1,0,0,1
2073694,2073807,113,0,0,1,1
2073705,2073807,102,0,0,1,2
2073808,2073833,25,1,0,0,2
2073808,2073834,26,1,0,0,1
2073834,2073965,131,0,0,1,2
2073835,2073972,137,0,0,1,1
2073966,2074265,299,1,0,0,2
2073973,2073978,5,1,0,0,1
2073979,2074008,29,0,0,1,1
2074009,2074269,260,1,0,0,1
2074032,2074208,176,0,1,0,1
2074048,2074100,52,0,1,0,2
2074131,2074131,0,0,1,0,2
2074266,2074636,370,0,0,1,2
2074270,2074635,365,0,0,1,1
2074636,2074667,31,1,0,0,1
2074637,2074669,32,1,0,0,2
2074668,2074906,238,0,0,1,1
2074670,2074904,234,0,0,1,2
2074905,2074962,57,1,0,0,2
2074907,2074972,65,1,0,0,1
2074963,2075179,216,0,0,1,2
2074973,2075179,206,0,0,1,1
2075180,2075198,18,1,0,0,2
2075180,2075199,19,1,0,0,1
2075199,2075359,160,0,0,1,2
2075200,2075362,162,0,0,1,1
2075360,2075377,17,1,0,0,2
2075363,2075376,13,1,0,0,1
2075377,2076277,900,0,0,1,1
2075378,2076275,897,0,0,1,2
2076276,2076296,20,1,0,0,2
2076278,2076299,21,1,0,0,1
2076297,2077142,845,0,0,1,2
2076300,2077142,842,0,0,1,1
2077143,2077200,57,1,0,0,1
2077143,2077201,58,1,0,0,2
2077201,2077355,154,0,0,1,1
2077202,2077354,152,0,0,1,2
2077355,2077377,22,1,0,0,2
2077356,2077378,22,1,0,0,1
2077378,2077609,231,0,0,1,2
2077379,2077609,230,0,0,1,1
2077610,2077632,22,1,0,0,1
2077610,2077633,23,1,0,0,2
2077633,2078061,428,0,0,1,1
2077634,2078057,423,0,0,1,2
2078058,2078081,23,1,0,0,2
2078062,2078082,20,1,0,0,1
2078082,2078445,363,0,0,1,2
2078083,2078445,362,0,0,1,1
2078446,2078462,16,1,0,0,2
2078446,2078463,17,1,0,0,1
2078463,2078646,183,0,0,1,2
2078464,2078641,177,0,0,1,1
2078642,2078663,21,1,0,0,1
2078647,2078660,13,1,0,0,2
2078661,2078773,112,0,0,1,2
2078664,2078772,108,0,0,1,1
2078773,2078794,21,1,0,0,1
2078774,2078794,20,1,0,0,2
2078795,2078945,150,0,0,1,2
2078795,2078946,151,0,0,1,1
2078946,2078966,20,1,0,0,2
2078947,2078969,22,1,0,0,1
2078967,2079145,178,0,0,1,2
2078970,2079138,168,0,0,1,1
2079139,2079154,15,1,0,0,1
2079146,2079150,4,1,0,0,2
2079151,2079278,127,0,0,1,2
2079155,2079277,122,0,0,1,1
2079278,2079580,302,1,0,0,1
2079279,2079547,268,1,0,0,2
2079322,2079454,132,0,1,0,1
2079326,2079430,104,0,1,0,2
2079548,2079873,325,0,0,1,2
2079581,2079874,293,0,0,1,1
2079874,2079911,37,1,0,0,2
2079875,2079903,28,1,0,0,1
2079904,2080104,200,0,0,1,1
2079912,2080103,191,0,0,1,2
2080104,2080170,66,1,0,0,2
2080105,2080167,62,1,0,0,1
2080168,2080692,524,0,0,1,1
2080171,2080693,522,0,0,1,2
2080693,2080732,39,1,0,0,1
2080694,2080752,58,1,0,0,2
2080733,2081133,400,0,0,1,1
2080753,2081132,379,0,0,1,2
2081133,2081209,76,1,0,0,2
2081134,2081208,74,1,0,0,1
2081209,2081323,114,0,0,1,1
2081210,2081324,114,0,0,1,2
2081324,2081355,31,1,0,0,1
2081325,2081353,28,1,0,0,2
2081354,2081534,180,0,0,1,2
2081356,2081533,177,0,0,1,1
2081534,2081557,23,1,0,0,1
2081535,2081565,30,1,0,0,2
2081558,2081677,119,0,0,1,1
2081566,2081675,109,0,0,1,2
2081676,2081696,20,1,0,0,2
2081678,2081700,22,1,0,0,1
2081697,2081872,175,0,0,1,2
2081701,2081873,172,0,0,1,1
2081873,2081890,17,1,0,0,2
2081874,2081890,16,1,0,0,1
2081891,2082092,201,0,0,1,1
2081891,2082092,201,0,0,1,2
2082093,2082114,21,1,0,0,2
2082093,2082115,22,1,0,0,1
2082115,2082313,198,0,0,1,2
2082116,2082313,197,0,0,1,1
2082314,2082335,21,1,0,0,2
2082314,2082336,22,1,0,0,1
2082336,2082589,253,0,0,1,2
2082337,2082590,253,0,0,1,1
2082590,2082603,13,1,0,0,2
2082591,2082604,13,1,0,0,1
2082604,2082962,358,0,0,1,2
2082605,2082961,356,0,0,1,1
2082962,2083004,42,1,0,0,1
2082963,2082999,36,1,0,0,2
2083000,2083196,196,0,0,1,2
2083005,2083193,188,0,0,1,1
2083194,2083212,18,1,0,0,1
2083197,2083209,12,1,0,0,2
2083210,2083461,251,0,0,1,2
2083213,2083461,248,0,0,1,1
2083462,2083485,23,1,0,0,1
2083462,2083486,24,1,0,0,2
2083486,2083662,176,0,0,1,1
2083487,2083661,174,0,0,1,2
2083662,2083676,14,1,0,0,2
2083663,2083667,4,1,0,0,1
2083668,2084031,363,0,0,1,1
2083677,2084033,356,0,0,1,2
2084032,2084054,22,1,0,0,1
2084034,2084054,20,1,0,0,2
2084055,2084133,78,0,0,1,1
2084055,2084136,81,0,0,1,2
2084134,2084156,22,1,0,0,1
2084137,2084151,14,1,0,0,2
2084152,2084344,192,0,0,1,2
2084157,2084261,104,0,0,1,1
2084262,2084271,9,1,0,0,1
2084272,2084398,126,0,0,1,1
2084345,2084722,377,1,0,0,2
2084399,2084420,21,1,0,0,1
2084421,2084450,29,0,0,1,1
2084451,2084491,40,1,0,0,1
2084492,2084663,171,0,0,1,1
2084664,2084671,7,1,0,0,1
2084672,2084850,178,0,0,1,1
2084723,2084798,75,0,0,1,2
2084799,2084813,14,1,0,0,2
2084814,2084881,67,0,0,1,2
2084851,2085236,385,1,0,0,1
2084882,2085207,325,1,0,0,2
2084916,2085188,272,0,1,0,1
2084928,2085104,176,0,1,0,2
2085208,2085335,127,0,0,1,2
2085237,2085271,34,0,0,1,1
2085272,2085297,25,1,0,0,1
2085298,2085328,30,0,0,1,1
2085329,2085913,584,1,0,0,1
2085336,2085342,6,1,0,0,2
2085343,2085407,64,0,0,1,2
2085408,2085733,325,1,0,0,2
2085425,2085760,335,0,1,0,1
2085436,2085668,232,0,1,0,2
2085734,2086003,269,0,0,1,2
2085914,2086011,97,0,0,1,1
2086004,2086021,17,1,0,0,2
2086012,2086040,28,1,0,0,1
2086022,2086383,361,0,0,1,2
2086041,2086383,342,0,0,1,1
2086384,2086453,69,1,0,0,1
2086384,2086458,74,1,0,0,2
2086454,2086542,88,0,0,1,1
2086459,2086541,82,0,0,1,2
2086542,2086577,35,1,0,0,2
2086543,2086577,34,1,0,0,1
2086578,2087557,979,0,0,1,1
2086578,2087609,1031,0,0,1,2
2087558,2087565,7,1,0,0,1
2087566,2087614,48,0,0,1,1
2087610,2087620,10,1,0,0,2
2087615,2088431,816,1,0,0,1
2087621,2088374,753,0,0,1,2
2088375,2088425,50,1,0,0,2
2088426,2088709,283,0,0,1,2
2088432,2088709,277,0,0,1,1
2088710,2088756,46,1,0,0,1
2088710,2088756,46,1,0,0,2
2088757,2088905,148,0,0,1,1
2088757,2088909,152,0,0,1,2
2088906,2088938,32,1,0,0,1
2088910,2088938,28,1,0,0,2
2088939,2088987,48,0,0,1,1
2088939,2089017,78,0,0,1,2
2088988,2089270,282,1,0,0,1
2089018,2089235,217,1,0,0,2
2089055,2089193,138,0,1,0,1
2089062,2089176,114,0,1,0,2
2089236,2089409,173,0,0,1,2
2089271,2089406,135,0,0,1,1
2089407,2089432,25,1,0,0,1
2089410,2089433,23,1,0,0,2
2089433,2089539,106,0,0,1,1
2089434,2089538,104,0,0,1,2
2089539,2089563,24,1,0,0,2
2089540,2089566,26,1,0,0,1
2089564,2089667,103,0,0,1,2
2089567,2089667,100,0,0,1,1
2089668,2089686,18,1,0,0,2
2089668,2089687,19,1,0,0,1
2089687,2090094,407,0,0,1,2
2089688,2090089,401,0,0,1,1
2090090,2090108,18,1,0,0,1
2090095,2090103,8,1,0,0,2
2090104,2090421,317,0,0,1,2
2090109,2090243,134,0,0,1,1
2090244,2090260,16,1,0,0,1
2090261,2090420,159,0,0,1,1
2090421,2090431,10,1,0,0,1
2090422,2090434,12,1,0,0,2
2090432,2090469,37,0,0,1,1
2090435,2090504,69,0,0,1,2
2090470,2090813,343,1,0,0,1
2090505,2090749,244,1,0,0,2
2090524,2090687,163,0,1,0,1
2090533,2090661,128,0,1,0,2
2090750,2091087,337,0,0,1,2
2090814,2090874,60,0,0,1,1
2090875,2090896,21,1,0,0,1
2090897,2090932,35,0,0,1,1
2090933,2090950,17,1,0,0,1
2090951,2091084,133,0,0,1,1
2091085,2091137,52,1,0,0,1
2091088,2091135,47,1,0,0,2
2091136,2091292,156,0,0,1,2
2091138,2091288,150,0,0,1,1
2091289,2091780,491,1,0,0,1
2091293,2091587,294,1,0,0,2
2091346,2091583,237,0,1,0,1
2091352,2091536,184,0,1,0,2
2091588,2091716,128,0,0,1,2
2091717,2091742,25,1,0,0,2
2091743,2092196,453,0,0,1,2
2091781,2092195,414,0,0,1,1
2092196,2092293,97,1,0,0,1
2092197,2092302,105,1,0,0,2
2092294,2092353,59,0,0,1,1
2092303,2092346,43,0,0,1,2
2092347,2092393,46,1,0,0,2
2092354,2092403,49,1,0,0,1
2092394,2092505,111,0,0,1,2
2092404,2092506,102,0,0,1,1
2092506,2092532,26,1,0,0,2
2092507,2092532,25,1,0,0,1
2092533,2092699,166,0,0,1,1
2092533,2092701,168,0,0,1,2
2092700,2092731,31,1,0,0,1
2092702,2092724,22,1,0,0,2
2092725,2093136,411,0,0,1,2
2092732,2093136,404,0,0,1,1
2093137,2093163,26,1,0,0,1
2093137,2093164,27,1,0,0,2
2093164,2094724,1560,0,0,1,1
2093165,2094725,1560,0,0,1,2
2094725,2094777,52,1,0,0,1
2094726,2094774,48,1,0,0,2
2094775,2095180,405,0,0,1,2
2094778,2095178,400,0,0,1,1
2095179,2095210,31,1,0,0,1
2095181,2095208,27,1,0,0,2
2095209,2096869,1660,0,0,1,2
2095211,2096866,1655,0,0,1,1
2096867,2097145,278,1,0,0,1
2096870,2097159,289,1,0,0,2
2096905,2097082,177,0,1,0,1
2096934,2097026,92,0,1,0,2
2097146,2097175,29,0,0,1,1
2097160,2097487,327,0,0,1,2
2097176,2097182,6,1,0,0,1
2097183,2097489,306,0,0,1,1
2097488,2097538,50,1,0,0,2
2097490,2097537,47,1,0,0,1
2097538,2098194,656,0,0,1,1
2097539,2098194,655,0,0,1,2
2098195,2098244,49,1,0,0,1
2098195,2098244,49,1,0,0,2
2098245,2098469,224,0,0,1,1
2098245,2098471,226,0,0,1,2
2098470,2098539,69,1,0,0,1
2098472,2098538,66,1,0,0,2
2098539,2098680,141,0,0,1,2
2098540,2098679,139,0,0,1,1
2098680,2098706,26,1,0,0,1
2098681,2098707,26,1,0,0,2
2098707,2099900,1193,0,0,1,1
2098708,2099901,1193,0,0,1,2
2099901,2099935,34,1,0,0,1
2099902,2099934,32,1,0,0,2
2099935,2100054,119,0,0,1,2
2099936,2100054,118,0,0,1,1
2100055,2100085,30,1,0,0,1
2100055,2100085,30,1,0,0,2
2100086,2100587,501,0,0,1,2
2100086,2100588,502,0,0,1,1
2100588,2100660,72,1,0,0,2
2100589,2100660,71,1,0,0,1
2100661,2100761,100,0,0,1,2
2100661,2100763,102,0,0,1,1
2100762,2100793,31,1,0,0,2
2100764,2100817,53,1,0,0,1
2100794,2101081,287,0,0,1,2
2100818,2100936,118,0,0,1,1
2100937,2100982,45,1,0,0,1
2100983,2101080,97,0,0,1,1
2101081,2101160,79,1,0,0,1
2101082,2101101,19,1,0,0,2
2101102,2101274,172,0,0,1,2
2101161,2101220,59,0,0,1,1
2101221,2101407,186,1,0,0,1
2101275,2101296,21,1,0,0,2
2101297,2101484,187,0,0,1,2
2101408,2101482,74,0,0,1,1
2101483,2101517,34,1,0,0,1
2101485,2101506,21,1,0,0,2
2101507,2101645,138,0,0,1,2
2101518,2101584,66,0,0,1,1
2101585,2101666,81,1,0,0,1
2101646,2101666,20,1,0,0,2
2101667,2101795,128,0,0,1,1
2101667,2101981,314,0,0,1,2
2101796,2101811,15,1,0,0,1
2101812,2101978,166,0,0,1,1
2101979,2101995,16,1,0,0,1
2101982,2101995,13,1,0,0,2
2101996,2102594,598,0,0,1,1
2101996,2102618,622,0,0,1,2
2102595,2104365,1770,1,0,0,1
2102619,2103478,859,1,0,0,2
2102629,2103715,1086,0,1,0,1
2102656,2102908,252,0,1,0,2
2102956,2102971,15,0,1,0,2
2103120,2103403,283,0,1,0,2
2103479,2103508,29,0,0,1,2
2103509,2103530,21,1,0,0,2
2103531,2103655,124,0,0,1,2
2103656,2103669,13,1,0,0,2
2103670,2103845,175,0,0,1,2
2103846,2103868,22,1,0,0,2
2103869,2104305,436,0,0,1,2
2104306,2104316,10,1,0,0,2
2104317,2104450,133,0,0,1,2
2104366,2104390,24,0,0,1,1
2104391,2104510,119,1,0,0,1
2104451,2104509,58,1,0,0,2
2104510,2104647,137,0,0,1,2
2104511,2104649,138,0,0,1,1
2104648,2104678,30,1,0,0,2
2104650,2104678,28,1,0,0,1
2104679,2104893,214,0,0,1,1
2104679,2104898,219,0,0,1,2
2104894,2104923,29,1,0,0,1
2104899,2104921,22,1,0,0,2
2104922,2106256,1334,0,0,1,2
2104924,2106266,1342,0,0,1,1
2106257,2106274,17,1,0,0,2
2106267,2106271,4,1,0,0,1
2106272,2106518,246,0,0,1,1
2106275,2106518,243,0,0,1,2
2106519,2106568,49,1,0,0,1
2106519,2106569,50,1,0,0,2
2106569,2106751,182,0,0,1,1
2106570,2106755,185,0,0,1,2
2106752,2106773,21,1,0,0,1
2106756,2106771,15,1,0,0,2
2106772,2107912,1140,0,0,1,2
2106774,2107912,1138,0,0,1,1
2107913,2107925,12,1,0,0,2
2107913,2107934,21,1,0,0,1
2107926,2108497,571,0,0,1,2
2107935,2108474,539,0,0,1,1
2108475,2109087,612,1,0,0,1
2108498,2108924,426,1,0,0,2
2108519,2108928,409,0,1,0,1
2108540,2108812,272,0,1,0,2
2108925,2108985,60,0,0,1,2
2108986,2109046,60,1,0,0,2
2109047,2109666,619,0,0,1,2
2109088,2109655,567,0,0,1,1
2109656,2109973,317,1,0,0,1
2109667,2109930,263,1,0,0,2
2109692,2109866,174,0,1,0,1
2109708,2109842,134,0,1,0,2
2109931,2110139,208,0,0,1,2
2109974,2110140,166,0,0,1,1
2110140,2110210,70,1,0,0,2
2110141,2110215,74,1,0,0,1
2110211,2110342,131,0,0,1,2
2110216,2110342,126,0,0,1,1
2110343,2110374,31,1,0,0,1
2110343,2110374,31,1,0,0,2
2110375,2112093,1718,0,0,1,2
2110375,2112094,1719,0,0,1,1
2112094,2112161,67,1,0,0,2
2112095,2112164,69,1,0,0,1
2112162,2112255,93,0,0,1,2
2112165,2112254,89,0,0,1,1
2112255,2112287,32,1,0,0,1
2112256,2112286,30,1,0,0,2
2112287,2112521,234,0,0,1,2
2112288,2112520,232,0,0,1,1
2112521,2112552,31,1,0,0,1
2112522,2112543,21,1,0,0,2
2112544,2114440,1896,0,0,1,2
2112553,2114224,1671,0,0,1,1
2114225,2114246,21,1,0,0,1
2114247,2114438,191,0,0,1,1
2114439,2114660,221,1,0,0,1
2114441,2114709,268,1,0,0,2
2114474,2114558,84,0,1,0,1
2114510,2114510,0,0,1,0,2
2114661,2115012,351,0,0,1,1
2114710,2115011,301,0,0,1,2
2115012,2115038,26,1,0,0,2
2115013,2115036,23,1,0,0,1
2115037,2115499,462,0,0,1,1
2115039,2115499,460,0,0,1,2
2115500,2115548,48,1,0,0,2
2115500,2115550,50,1,0,0,1
2115549,2115653,104,0,0,1,2
2115551,2115652,101,0,0,1,1
2115653,2115724,71,1,0,0,1
2115654,2115721,67,1,0,0,2
2115722,2115853,131,0,0,1,2
2115725,2115852,127,0,0,1,1
2115853,2115893,40,1,0,0,1
2115854,2115893,39,1,0,0,2
2115894,2116437,543,0,0,1,2
2115894,2116438,544,0,0,1,1
2116438,2116463,25,1,0,0,2
2116439,2116462,23,1,0,0,1
2116463,2116812,349,0,0,1,1
2116464,2116813,349,0,0,1,2
2116813,2116849,36,1,0,0,1
2116814,2116847,33,1,0,0,2
2116848,2117198,350,0,0,1,2
2116850,2117198,348,0,0,1,1
2117199,2117233,34,1,0,0,2
2117199,2117236,37,1,0,0,1
2117234,2117337,103,0,0,1,2
2117237,2117321,84,0,0,1,1
2117322,2117672,350,1,0,0,1
2117338,2117612,274,1,0,0,2
2117356,2117608,252,0,1,0,1
2117383,2117545,162,0,1,0,2
2117613,2117651,38,0,0,1,2
2117652,2117672,20,1,0,0,2
2165477,2165734,257,0,0,1,1
2165477,2165734,257,0,0,1,2
2165735,2165804,69,1,0,0,2
2165735,2165807,72,1,0,0,1
2165805,2165953,148,0,0,1,2
2165808,2165955,147,0,0,1,1
2165954,2165991,37,1,0,0,2
2165956,2165996,40,1,0,0,1
2165992,2166242,250,0,0,1,2
2165997,2166241,244,0,0,1,1
2166242,2166270,28,1,0,0,1
2166243,2166262,19,1,0,0,2
2166263,2168101,1838,0,0,1,2
2166271,2168100,1829,0,0,1,1
2168101,2168150,49,1,0,0,1
2168102,2168151,49,1,0,0,2
2168151,2168332,181,0,0,1,1
2168152,2168332,180,0,0,1,2
2168333,2168411,78,1,0,0,1
2168333,2168423,90,1,0,0,2
2168412,2168504,92,0,0,1,1
2168424,2168504,80,0,0,1,2
2168505,2168548,43,1,0,0,1
2168505,2168557,52,1,0,0,2
2168549,2168670,121,0,0,1,1
2168558,2168670,112,0,0,1,2
2168671,2168698,27,1,0,0,1
2168671,2168700,29,1,0,0,2
2168699,2169648,949,0,0,1,1
2168701,2169647,946,0,0,1,2
2169648,2169670,22,1,0,0,2
2169649,2169670,21,1,0,0,1
2169671,2170553,882,0,0,1,1
2169671,2170555,884,0,0,1,2
2170554,2170634,80,1,0,0,1
2170556,2170644,88,1,0,0,2
2170635,2170974,339,0,0,1,1
2170645,2170974,329,0,0,1,2
2170975,2171047,72,1,0,0,1
2170975,2171047,72,1,0,0,2
2171048,2171284,236,0,0,1,2
2171048,2171287,239,0,0,1,1
2171285,2171303,18,1,0,0,2
2171288,2171301,13,1,0,0,1
2171302,2172784,1482,0,0,1,1
2171304,2172785,1481,0,0,1,2
2172785,2172893,108,1,0,0,1
2172786,2172894,108,1,0,0,2
2172894,2173186,292,0,0,1,1
2172895,2173187,292,0,0,1,2
2173187,2173258,71,1,0,0,1
2173188,2173261,73,1,0,0,2
2173259,2173369,110,0,0,1,1
2173262,2173369,107,0,0,1,2
2173370,2173402,32,1,0,0,1
2173370,2173402,32,1,0,0,2
2173403,2174985,1582,0,0,1,1
2173403,2174988,1585,0,0,1,2
2174986,2175145,159,1,0,0,1
2174989,2175044,55,1,0,0,2
2175045,2175075,30,0,0,1,2
2175076,2175117,41,1,0,0,2
2175118,2175345,227,0,0,1,2
2175146,2175347,201,0,0,1,1
2175346,2175372,26,1,0,0,2
2175348,2175375,27,1,0,0,1
2175373,2175482,109,0,0,1,2
2175376,2175481,105,0,0,1,1
2175482,2175546,64,1,0,0,1
2175483,2175553,70,1,0,0,2
2175547,2175662,115,0,0,1,1
2175554,2175663,109,0,0,1,2
2175663,2175696,33,1,0,0,1
2175664,2175696,32,1,0,0,2
2175697,2177007,1310,0,0,1,1
2175697,2177009,1312,0,0,1,2
2177008,2177032,24,1,0,0,1
2177010,2177035,25,1,0,0,2
2177033,2177142,109,0,0,1,1
2177036,2177142,106,0,0,1,2
2177143,2177165,22,1,0,0,1
2177143,2177165,22,1,0,0,2
2177166,2177233,67,0,0,1,1
2177166,2177241,75,0,0,1,2
2177234,2177448,214,1,0,0,1
2177242,2177386,144,1,0,0,2
2177279,2177369,90,0,1,0,1
2177387,2177620,233,0,0,1,2
2177449,2177620,171,0,0,1,1
2177621,2177705,84,1,0,0,2
2177621,2177707,86,1,0,0,1
2177706,2177778,72,0,0,1,2
2177708,2177777,69,0,0,1,1
2177778,2177805,27,1,0,0,1
2177779,2177812,33,1,0,0,2
2177806,2177908,102,0,0,1,1
2177813,2177910,97,0,0,1,2
2177909,2177933,24,1,0,0,1
2177911,2177930,19,1,0,0,2
2177931,2179634,1703,0,0,1,2
2177934,2178110,176,0,0,1,1
2178111,2178130,19,1,0,0,1
2178131,2179633,1502,0,0,1,1
2179634,2179712,78,1,0,0,1
2179635,2179703,68,1,0,0,2
2179704,2179962,258,0,0,1,2
2179713,2179960,247,0,0,1,1
2179961,2180027,66,1,0,0,1
2179963,2180034,71,1,0,0,2
2180028,2180125,97,0,0,1,1
2180035,2180126,91,0,0,1,2
2180126,2180161,35,1,0,0,1
2180127,2180154,27,1,0,0,2
2180155,2180366,211,0,0,1,2
2180162,2180368,206,0,0,1,1
2180367,2180397,30,1,0,0,2
2180369,2180397,28,1,0,0,1
2180398,2180645,247,0,0,1,2
2180398,2180646,248,0,0,1,1
2180646,2180656,10,1,0,0,2
2180647,2180658,11,1,0,0,1
2180657,2181837,1180,0,0,1,2
2180659,2181838,1179,0,0,1,1
2181838,2181901,63,1,0,0,2
2181839,2181903,64,1,0,0,1
2181902,2182225,323,0,0,1,2
2181904,2182225,321,0,0,1,1
2182226,2182288,62,1,0,0,2
2182226,2182296,70,1,0,0,1
2182289,2182425,136,0,0,1,2
2182297,2182424,127,0,0,1,1
2182425,2182455,30,1,0,0,1
2182426,2182455,29,1,0,0,2
2182456,2183314,858,0,0,1,2
2182456,2183315,859,0,0,1,1
2183315,2183335,20,1,0,0,2
2183316,2183341,25,1,0,0,1
2183336,2184430,1094,0,0,1,2
2183342,2184429,1087,0,0,1,1
2184430,2184558,128,1,0,0,1
2184431,2184547,116,1,0,0,2
2184548,2184781,233,0,0,1,2
2184559,2184781,222,0,0,1,1
2184782,2184850,68,1,0,0,2
2184782,2184852,70,1,0,0,1
2184851,2185052,201,0,0,1,2
2184853,2185052,199,0,0,1,1
2185053,2185136,83,1,0,0,2
2185053,2185145,92,1,0,0,1
2185137,2185233,96,0,0,1,2
2185146,2185233,87,0,0,1,1
2185234,2185263,29,1,0,0,2
2185234,2185266,32,1,0,0,1
2185264,2186480,1216,0,0,1,2
2185267,2186468,1201,0,0,1,1
2186469,2186543,74,1,0,0,1
2186481,2186523,42,1,0,0,2
2186524,2187036,512,0,0,1,2
2186544,2187036,492,0,0,1,1
2187037,2187145,108,1,0,0,2
2187037,2187157,120,1,0,0,1
2187146,2187551,405,0,0,1,2
2187158,2187550,392,0,0,1,1
2187551,2187634,83,1,0,0,1
2187552,2187633,81,1,0,0,2
2187634,2187820,186,0,0,1,2
2187635,2187819,184,0,0,1,1
2187820,2187848,28,1,0,0,1
2187821,2187850,29,1,0,0,2
2187849,2189167,1318,0,0,1,1
2187851,2189168,1317,0,0,1,2
2189168,2189259,91,1,0,0,1
2189169,2189270,101,1,0,0,2
2189260,2189448,188,0,0,1,1
2189271,2189448,177,0,0,1,2
2189449,2189518,69,1,0,0,2
2189449,2189520,71,1,0,0,1
2189519,2189617,98,0,0,1,2
2189521,2189617,96,0,0,1,1
2189618,2189687,69,1,0,0,1
2189618,2189687,69,1,0,0,2
2189688,2189779,91,0,0,1,1
2189688,2189781,93,0,0,1,2
2189780,2189832,52,1,0,0,1
2189782,2189825,43,1,0,0,2
2189826,2191321,1495,0,0,1,2
2189833,2191320,1487,0,0,1,1
2191321,2191411,90,1,0,0,1
2191322,2191411,89,1,0,0,2
2191412,2191677,265,0,0,1,1
2191412,2191678,266,0,0,1,2
2191678,2191768,90,1,0,0,1
2191679,2191764,85,1,0,0,2
2191765,2191843,78,0,0,1,2
2191769,2191843,74,0,0,1,1
2191844,2191886,42,1,0,0,2
2191844,2191892,48,1,0,0,1
2191887,2192385,498,0,0,1,2
2191893,2192364,471,0,0,1,1
2192365,2192414,49,1,0,0,1
2192386,2192418,32,1,0,0,2
2192415,2193569,1154,0,0,1,1
2192419,2193569,1150,0,0,1,2
2193570,2193665,95,1,0,0,1
2193570,2193665,95,1,0,0,2
2193666,2193974,308,0,0,1,2
2193666,2193975,309,0,0,1,1
2193975,2194070,95,1,0,0,2
2193976,2194063,87,1,0,0,1
2194064,2194142,78,0,0,1,1
2194071,2194143,72,0,0,1,2
2194143,2194191,48,1,0,0,1
2194144,2194181,37,1,0,0,2
2194182,2194514,332,0,0,1,2
2194192,2194514,322,0,0,1,1
2194515,2194544,29,1,0,0,2
2194515,2194548,33,1,0,0,1
2194545,2195682,1137,0,0,1,2
2194549,2195681,1132,0,0,1,1
2195682,2195772,90,1,0,0,1
2195683,2195772,89,1,0,0,2
2195773,2196024,251,0,0,1,1
2195773,2196025,252,0,0,1,2
2196025,2196097,72,1,0,0,1
2196026,2196098,72,1,0,0,2
2196098,2196187,89,0,0,1,1
2196099,2196189,90,0,0,1,2
2196188,2196224,36,1,0,0,1
2196190,2196224,34,1,0,0,2
2196225,2196458,233,0,0,1,1
2196225,2196458,233,0,0,1,2
2196459,2196480,21,1,0,0,1
2196459,2196480,21,1,0,0,2
2196481,2197284,803,0,0,1,1
2196481,2197286,805,0,0,1,2
2197285,2197301,16,1,0,0,1
2197287,2197301,14,1,0,0,2
2197302,2197693,391,0,0,1,2
2197302,2197695,393,0,0,1,1
2197694,2197790,96,1,0,0,2
2197696,2197790,94,1,0,0,1
2197791,2198118,327,0,0,1,1
2197791,2198118,327,0,0,1,2
2198119,2198178,59,1,0,0,2
2198119,2198191,72,1,0,0,1
2198179,2198269,90,0,0,1,2
2198192,2198266,74,0,0,1,1
2198267,2198298,31,1,0,0,1
2198270,2198294,24,1,0,0,2
2198295,2198643,348,0,0,1,2
2198299,2198642,343,0,0,1,1
2198643,2198675,32,1,0,0,1
2198644,2198675,31,1,0,0,2
2198676,2198814,138,0,0,1,2
2198676,2198818,142,0,0,1,1
2198815,2198830,15,1,0,0,2
2198819,2198828,9,1,0,0,1
2198829,2198896,67,0,0,1,1
2198831,2198895,64,0,0,1,2
2198896,2198913,17,1,0,0,2
2198897,2198911,14,1,0,0,1
2198912,2199316,404,0,0,1,1
2198914,2199088,174,0,0,1,2
2199089,2199099,10,1,0,0,2
2199100,2199316,216,0,0,1,2
2199317,2199335,18,1,0,0,1
2199317,2199336,19,1,0,0,2
2199336,2199749,413,0,0,1,1
2199337,2199743,406,0,0,1,2
2199744,2199792,48,1,0,0,2
2199750,2199780,30,1,0,0,1
2199781,2199828,47,0,0,1,1
2199793,2199829,36,0,0,1,2
2199829,2199836,7,1,0,0,1
2199830,2199835,5,1,0,0,2
2199836,2199877,41,0,0,1,2
2199837,2199865,28,0,0,1,1
2199866,2200144,278,1,0,0,1
2199878,2200197,319,1,0,0,2
2199909,2200111,202,0,1,0,1
2199926,2200065,139,0,1,0,2
2200145,2200254,109,0,0,1,1
2200198,2200253,55,0,0,1,2
2200254,2200314,60,1,0,0,2
2200255,2200306,51,1,0,0,1
2200307,2200418,111,0,0,1,1
2200315,2200418,103,0,0,1,2
2200419,2200451,32,1,0,0,2
2200419,2200452,33,1,0,0,1
2200452,2200593,141,0,0,1,2
2200453,2200589,136,0,0,1,1
2200590,2200610,20,1,0,0,1
2200594,2200647,53,1,0,0,2
2200611,2200792,181,0,0,1,1
2200648,2200789,141,0,0,1,2
2200790,2200812,22,1,0,0,2
2200793,2200814,21,1,0,0,1
2200813,2200869,56,0,0,1,2
2200815,2200869,54,0,0,1,1
2200870,2200893,23,1,0,0,1
2200870,2200936,66,1,0,0,2
2200894,2201029,135,0,0,1,1
2200937,2201031,94,0,0,1,2
2201030,2201052,22,1,0,0,1
2201032,2201053,21,1,0,0,2
2201053,2201323,270,0,0,1,1
2201054,2201327,273,0,0,1,2
2201324,2201342,18,1,0,0,1
2201328,2201341,13,1,0,0,2
2201342,2201666,324,0,0,1,2
2201343,2201664,321,0,0,1,1
2201665,2201693,28,1,0,0,1
2201667,2201691,24,1,0,0,2
2201692,2201850,158,0,0,1,2
2201694,2201849,155,0,0,1,1
2201850,2202221,371,1,0,0,1
2201851,2202127,276,1,0,0,2
2201895,2202141,246,0,1,0,1
2201900,2202035,135,0,1,0,2
2202057,2202057,0,0,1,0,2
2202128,2202187,59,0,0,1,2
2202188,2202195,7,1,0,0,2
2202196,2202343,147,0,0,1,2
2202222,2202345,123,0,0,1,1
2202344,2202413,69,1,0,0,2
2202346,2202389,43,1,0,0,1
2202390,2202410,20,0,0,1,1
2202411,2202418,7,1,0,0,1
2202414,2202490,76,0,0,1,2
2202419,2202489,70,0,0,1,1
2202490,2202518,28,1,0,0,1
2202491,2202518,27,1,0,0,2
2202519,2202712,193,0,0,1,1
2202519,2202712,193,0,0,1,2
2202713,2202723,10,1,0,0,1
2202713,2202724,11,1,0,0,2
2202724,2203499,775,0,0,1,1
2202725,2203498,773,0,0,1,2
2203499,2203520,21,1,0,0,2
2203500,2203521,21,1,0,0,1
2203521,2203760,239,0,0,1,2
2203522,2203758,236,0,0,1,1
2203759,2203803,44,1,0,0,1
2203761,2203789,28,1,0,0,2
2203790,2203810,20,0,0,1,2
2203804,2203945,141,0,0,1,1
2203811,2203815,4,1,0,0,2
2203816,2203945,129,0,0,1,2
2203946,2203963,17,1,0,0,1
2203946,2203965,19,1,0,0,2
2203964,2204170,206,0,0,1,1
2203966,2204164,198,0,0,1,2
2204165,2204171,6,1,0,0,2
2204171,2204177,6,1,0,0,1
2204172,2204293,121,0,0,1,2
2204178,2204275,97,0,0,1,1
2204276,2204556,280,1,0,0,1
2204294,2204418,124,1,0,0,2
2204321,2204391,70,0,1,0,1
2204328,2204362,34,0,1,0,2
2204415,2204425,10,0,1,0,1
2204419,2204550,131,0,0,1,2
2204551,2204565,14,1,0,0,2
2204557,2204584,27,0,0,1,1
2204566,2204823,257,0,0,1,2
2204585,2204590,5,1,0,0,1
2204591,2204826,235,0,0,1,1
2204824,2204836,12,1,0,0,2
2204827,2204832,5,1,0,0,1
2204833,2204895,62,0,0,1,1
2204837,2204893,56,0,0,1,2
2204894,2204912,18,1,0,0,2
2204896,2204908,12,1,0,0,1
2204909,2205090,181,0,0,1,1
2204913,2205093,180,0,0,1,2
2205091,2205097,6,1,0,0,1
2205094,2205102,8,1,0,0,2
2205098,2206264,1166,0,0,1,1
2205103,2206265,1162,0,0,1,2
2206265,2206314,49,1,0,0,1
2206266,2206313,47,1,0,0,2
2206314,2206691,377,0,0,1,2
2206315,2206693,378,0,0,1,1
2206692,2206768,76,1,0,0,2
2206694,2206768,74,1,0,0,1
2206769,2206868,99,0,0,1,1
2206769,2206870,101,0,0,1,2
2206869,2206904,35,1,0,0,1
2206871,2206909,38,1,0,0,2
2206905,2207413,508,0,0,1,1
2206910,2207417,507,0,0,1,2
2207414,2207445,31,1,0,0,1
2207418,2207436,18,1,0,0,2
2207437,2208394,957,0,0,1,2
2207446,2208395,949,0,0,1,1
2208395,2208475,80,1,0,0,2
2208396,2208477,81,1,0,0,1
2208476,2208813,337,0,0,1,2
2208478,2208813,335,0,0,1,1
2208814,2208906,92,1,0,0,2
2208814,2208914,100,1,0,0,1
2208907,2208991,84,0,0,1,2
2208915,2208986,71,0,0,1,1
2208987,2209028,41,1,0,0,1
2208992,2209026,34,1,0,0,2
2209027,2209275,248,0,0,1,2
2209029,2209276,247,0,0,1,1
2209276,2209312,36,1,0,0,2
2209277,2209313,36,1,0,0,1
2209313,2209457,144,0,0,1,2
2209314,2209456,142,0,0,1,1
2209457,2209477,20,1,0,0,1
2209458,2209476,18,1,0,0,2
2209477,2209901,424,0,0,1,2
2209478,2209899,421,0,0,1,1
2209900,2209924,24,1,0,0,1
2209902,2209923,21,1,0,0,2
2209924,2210082,158,0,0,1,2
2209925,2210081,156,0,0,1,1
2210082,2210103,21,1,0,0,1
2210083,2210101,18,1,0,0,2
2210102,2210513,411,0,0,1,2
2210104,2210511,407,0,0,1,1
2210512,2210612,100,1,0,0,1
2210514,2210614,100,1,0,0,2
2210613,2210860,247,0,0,1,1
2210615,2210860,245,0,0,1,2
2210861,2210919,58,1,0,0,2
2210861,2210932,71,1,0,0,1
2210920,2211013,93,0,0,1,2
2210933,2211012,79,0,0,1,1
2211013,2211052,39,1,0,0,1
2211014,2211053,39,1,0,0,2
2211053,2212223,1170,0,0,1,1
2211054,2212224,1170,0,0,1,2
2212224,2212268,44,1,0,0,1
2212225,2212271,46,1,0,0,2
2212269,2212467,198,0,0,1,1
2212272,2212468,196,0,0,1,2
2212468,2212547,79,1,0,0,1
2212469,2212540,71,1,0,0,2
2212541,2212835,294,0,0,1,2
2212548,2212835,287,0,0,1,1
2212836,2212904,68,1,0,0,1
2212836,2212904,68,1,0,0,2
2212905,2213030,125,0,0,1,1
2212905,2213030,125,0,0,1,2
2213031,2213063,32,1,0,0,2
2213031,2213064,33,1,0,0,1
2213064,2213903,839,0,0,1,2
2213065,2213903,838,0,0,1,1
2213904,2213937,33,1,0,0,1
2213904,2213938,34,1,0,0,2
2213938,2214075,137,0,0,1,1
2213939,2214071,132,0,0,1,2
2214072,2214102,30,1,0,0,2
2214076,2214102,26,1,0,0,1
2214103,2214233,130,0,0,1,1
2214103,2214234,131,0,0,1,2
2214234,2214269,35,1,0,0,1
2214235,2214261,26,1,0,0,2
2214262,2214302,40,0,0,1,2
2214270,2214312,42,0,0,1,1
2214303,2214318,15,1,0,0,2
2214313,2214329,16,1,0,0,1
2214319,2214357,38,0,0,1,2
2214330,2214354,24,0,0,1,1
2214355,2214371,16,1,0,0,1
2214358,2214379,21,1,0,0,2
2214372,2214396,24,0,0,1,1
2214380,2214561,181,0,0,1,2
2214397,2214401,4,1,0,0,1
2214402,2214561,159,0,0,1,1
2214562,2214655,93,1,0,0,2
2214562,2214660,98,1,0,0,1
2214656,2214697,41,0,0,1,2
2214661,2214697,36,0,0,1,1
2214698,2214777,79,1,0,0,1
2214698,2214781,83,1,0,0,2
2214778,2214807,29,0,0,1,1
2214782,2214966,184,0,0,1,2
2214808,2214813,5,1,0,0,1
2214814,2214967,153,0,0,1,1
2214967,2214996,29,1,0,0,2
2214968,2214995,27,1,0,0,1
2214996,2215220,224,0,0,1,1
2214997,2215221,224,0,0,1,2
2215221,2215244,23,1,0,0,1
2215222,2215243,21,1,0,0,2
2215244,2215420,176,0,0,1,2
2215245,2215418,173,0,0,1,1
2215419,2215434,15,1,0,0,1
2215421,2215436,15,1,0,0,2
2215435,2216001,566,0,0,1,1
2215437,2216003,566,0,0,1,2
2216002,2216012,10,1,0,0,1
2216004,2216009,5,1,0,0,2
2216010,2216106,96,0,0,1,2
2216013,2216668,655,0,0,1,1
2216107,2216116,9,1,0,0,2
2216117,2216666,549,0,0,1,2
2216667,2216924,257,1,0,0,2
2216669,2217036,367,1,0,0,1
2216762,2216770,8,0,1,0,1
2216791,2216864,73,0,1,0,1
2216891,2216949,58,0,1,0,1
2216925,2216957,32,0,0,1,2
2216958,2217532,574,1,0,0,2
2217037,2217161,124,0,0,1,1
2217162,2217204,42,1,0,0,1
2217205,2217509,304,0,0,1,1
2217510,2217524,14,1,0,0,1
2217525,2218162,637,0,0,1,1
2217533,2218137,604,0,0,1,2
2218138,2218574,436,1,0,0,2
2218163,2218675,512,1,0,0,1
2218179,2218568,389,0,1,0,1
2218191,2218459,268,0,1,0,2
2218575,2218871,296,0,0,1,2
2218676,2218871,195,0,0,1,1
2218872,2218947,75,1,0,0,2
2218872,2218962,90,1,0,0,1
2218948,2219192,244,0,0,1,2
2218963,2219195,232,0,0,1,1
2219193,2219485,292,1,0,0,2
2219196,2219465,269,1,0,0,1
2219220,2219423,203,0,1,0,1
2219228,2219420,192,0,1,0,2
2219466,2220112,646,0,0,1,1
2219486,2220111,625,0,0,1,2
2220112,2220134,22,1,0,0,2
2220113,2220145,32,1,0,0,1
2220135,2220337,202,0,0,1,2
2220146,2220335,189,0,0,1,1
2220336,2220561,225,1,0,0,1
2220338,2220525,187,1,0,0,2
2220377,2220505,128,0,1,0,1
2220409,2220442,33,0,1,0,2
2220526,2220766,240,0,0,1,2
2220562,2220766,204,0,0,1,1
2220767,2220832,65,1,0,0,1
2220767,2220832,65,1,0,0,2
2220833,2220940,107,0,0,1,2
2220833,2220942,109,0,0,1,1
2220941,2220972,31,1,0,0,2
2220943,2220974,31,1,0,0,1
2220973,2222205,1232,0,0,1,2
2220975,2222194,1219,0,0,1,1
2222195,2222416,221,1,0,0,1
2222206,2222388,182,1,0,0,2
2222263,2222302,39,0,1,0,1
2222389,2222521,132,0,0,1,2
2222417,2222520,103,0,0,1,1
2222521,2222583,62,1,0,0,1
2222522,2222581,59,1,0,0,2
2222582,2222776,194,0,0,1,2
2222584,2222777,193,0,0,1,1
2222777,2222846,69,1,0,0,2
2222778,2222856,78,1,0,0,1
2222847,2222989,142,0,0,1,2
2222857,2222988,131,0,0,1,1
2222989,2223021,32,1,0,0,1
2222990,2223019,29,1,0,0,2
2223020,2224565,1545,0,0,1,2
2223022,2224566,1544,0,0,1,1
2224566,2224633,67,1,0,0,2
2224567,2224639,72,1,0,0,1
2224634,2224814,180,0,0,1,2
2224640,2224812,172,0,0,1,1
2224813,2224883,70,1,0,0,1
2224815,2224886,71,1,0,0,2
2224884,2225054,170,0,0,1,1
2224887,2225053,166,0,0,1,2
2225054,2225082,28,1,0,0,2
2225055,2225085,30,1,0,0,1
2225083,2226407,1324,0,0,1,2
2225086,2226407,1321,0,0,1,1
2226408,2226460,52,1,0,0,2
2226408,2226472,64,1,0,0,1
2226461,2226699,238,0,0,1,2
2226473,2226697,224,0,0,1,1
2226698,2226760,62,1,0,0,1
2226700,2226758,58,1,0,0,2
2226759,2226897,138,0,0,1,2
2226761,2226897,136,0,0,1,1
2226898,2226955,57,1,0,0,2
2226898,2226960,62,1,0,0,1
2226956,2227113,157,0,0,1,2
2226961,2227111,150,0,0,1,1
2227112,2227140,28,1,0,0,1
2227114,2227133,19,1,0,0,2
2227134,2228540,1406,0,0,1,2
2227141,2228540,1399,0,0,1,1
2228541,2228586,45,1,0,0,1
2228541,2228596,55,1,0,0,2
2228587,2228913,326,0,0,1,1
2228597,2228914,317,0,0,1,2
2228914,2229006,92,1,0,0,1
2228915,2229000,85,1,0,0,2
2229001,2229123,122,0,0,1,2
2229007,2229123,116,0,0,1,1
2229124,2229168,44,1,0,0,1
2229124,2229169,45,1,0,0,2
2229169,2230502,1333,0,0,1,1
2229170,2230503,1333,0,0,1,2
2230503,2230613,110,1,0,0,1
2230504,2230611,107,1,0,0,2
2230612,2230940,328,0,0,1,2
2230614,2230941,327,0,0,1,1
2230941,2231020,79,1,0,0,2
2230942,2231031,89,1,0,0,1
2231021,2231134,113,0,0,1,2
2231032,2231138,106,0,0,1,1
2231135,2231170,35,1,0,0,2
2231139,2231170,31,1,0,0,1
2231171,2232573,1402,0,0,1,2
2231171,2232575,1404,0,0,1,1
2232574,2232647,73,1,0,0,2
2232576,2232647,71,1,0,0,1
2232648,2233013,365,0,0,1,1
2232648,2233014,366,0,0,1,2
2233014,2233094,80,1,0,0,1
2233015,2233102,87,1,0,0,2
2233095,2233196,101,0,0,1,1
2233103,2233195,92,0,0,1,2
2233196,2233227,31,1,0,0,2
2233197,2233236,39,1,0,0,1
2233228,2234645,1417,0,0,1,2
2233237,2234646,1409,0,0,1,1
2234646,2234739,93,1,0,0,2
2234647,2234743,96,1,0,0,1
2234740,2235064,324,0,0,1,2
2234744,2235064,320,0,0,1,1
2235065,2235143,78,1,0,0,1
2235065,2235150,85,1,0,0,2
2235144,2235287,143,0,0,1,1
2235151,2235285,134,0,0,1,2
2235286,2235328,42,1,0,0,2
2235288,2235319,31,1,0,0,1
2235320,2235376,56,0,0,1,1
2235329,2235379,50,0,0,1,2
2235377,2236240,863,1,0,0,1
2235380,2235720,340,1,0,0,2
2235406,2236227,821,0,1,0,1
2235412,2235602,190,0,1,0,2
2235721,2235810,89,0,0,1,2
2235811,2235836,25,1,0,0,2
2235837,2236132,295,0,0,1,2
2236133,2236155,22,1,0,0,2
2236156,2236801,645,0,0,1,2
2236241,2236801,560,0,0,1,1
2236802,2236921,119,1,0,0,1
2236802,2236922,120,1,0,0,2
2236922,2237036,114,0,0,1,1
2236923,2237033,110,0,0,1,2
2237034,2237078,44,1,0,0,2
2237037,2237066,29,1,0,0,1
2237067,2237318,251,0,0,1,1
2237079,2237317,238,0,0,1,2
2237318,2237368,50,1,0,0,2
2237319,2237368,49,1,0,0,1
2237369,2237568,199,0,0,1,1
2237369,2237571,202,0,0,1,2
2237569,2237583,14,1,0,0,1
2237572,2237585,13,1,0,0,2
2237584,2238784,1200,0,0,1,1
2237586,2238785,1199,0,0,1,2
2238785,2238880,95,1,0,0,1
2238786,2238878,92,1,0,0,2
2238879,2239299,420,0,0,1,2
2238881,2239299,418,0,0,1,1
2239300,2239384,84,1,0,0,2
2239300,2239393,93,1,0,0,1
2239385,2239554,169,0,0,1,2
2239394,2239553,159,0,0,1,1
2239554,2239581,27,1,0,0,1
2239555,2239584,29,1,0,0,2
2239582,2240731,1149,0,0,1,1
2239585,2240730,1145,0,0,1,2
2240731,2240823,92,1,0,0,2
2240732,2240866,134,1,0,0,1
2240824,2241217,393,0,0,1,2
2240867,2241216,349,0,0,1,1
2241217,2241304,87,1,0,0,1
2241218,2241291,73,1,0,0,2
2241292,2241389,97,0,0,1,2
2241305,2241391,86,0,0,1,1
2241390,2241427,37,1,0,0,2
2241392,2241430,38,1,0,0,1
2241428,2241656,228,0,0,1,2
2241431,2241654,223,0,0,1,1
2241655,2241688,33,1,0,0,1
2241657,2241676,19,1,0,0,2
2241677,2242863,1186,0,0,1,2
2241689,2242859,1170,0,0,1,1
2242860,2242969,109,1,0,0,1
2242864,2242967,103,1,0,0,2
2242968,2243392,424,0,0,1,2
2242970,2243393,423,0,0,1,1
2243393,2243505,112,1,0,0,2
2243394,2243517,123,1,0,0,1
2243506,2243677,171,0,0,1,2
2243518,2243678,160,0,0,1,1
2243678,2243710,32,1,0,0,2
2243679,2243710,31,1,0,0,1
2243711,2245074,1363,0,0,1,1
2243711,2245075,1364,0,0,1,2
2245075,2245172,97,1,0,0,1
2245076,2245170,94,1,0,0,2
2245171,2245377,206,0,0,1,2
2245173,2245375,202,0,0,1,1
2245376,2245445,69,1,0,0,1
2245378,2245444,66,1,0,0,2
2245445,2245551,106,0,0,1,2
2245446,2245550,104,0,0,1,1
2245551,2245585,34,1,0,0,1
2245552,2245585,33,1,0,0,2
2245586,2246806,1220,0,0,1,2
2245586,2246808,1222,0,0,1,1
2246807,2246872,65,1,0,0,2
2246809,2246870,61,1,0,0,1
2246871,2247077,206,0,0,1,1
2246873,2247075,202,0,0,1,2
2247076,2247112,36,1,0,0,2
2247078,2247114,36,1,0,0,1
2247113,2247234,121,0,0,1,2
2247115,2247234,119,0,0,1,1
2247235,2247294,59,1,0,0,2
2247235,2247297,62,1,0,0,1
2247295,2247483,188,0,0,1,2
2247298,2247480,182,0,0,1,1
2247481,2247510,29,1,0,0,1
2247484,2247499,15,1,0,0,2
2247500,2248435,935,0,0,1,2
2247511,2248433,922,0,0,1,1
2248434,2248498,64,1,0,0,1
2248436,2248484,48,1,0,0,2
2248485,2248584,99,0,0,1,2
2248499,2248584,85,0,0,1,1
2248585,2248611,26,1,0,0,2
2248585,2248640,55,1,0,0,1
2248612,2248709,97,0,0,1,2
2248641,2248708,67,0,0,1,1
2248709,2248741,32,1,0,0,1
2248710,2248724,14,1,0,0,2
2248725,2248983,258,0,0,1,2
2248742,2248983,241,0,0,1,1
2248984,2249038,54,1,0,0,2
2248984,2249046,62,1,0,0,1
2249039,2250215,1176,0,0,1,2
2249047,2249199,152,0,0,1,1
2249200,2249205,5,1,0,0,1
2249206,2249765,559,0,0,1,1
2249766,2249783,17,1,0,0,1
2249784,2250215,431,0,0,1,1
2250216,2250246,30,1,0,0,2
2250216,2250261,45,1,0,0,1
2250247,2250389,142,0,0,1,2
2250262,2250393,131,0,0,1,1
2250390,2250407,17,1,0,0,2
2250394,2250408,14,1,0,0,1
2250408,2250945,537,0,0,1,2
2250409,2250945,536,0,0,1,1
2250946,2251025,79,1,0,0,2
2250946,2251036,90,1,0,0,1
2251026,2251176,150,0,0,1,2
2251037,2251176,139,0,0,1,1
2251177,2251220,43,1,0,0,2
2251177,2251257,80,1,0,0,1
2251221,2252175,954,0,0,1,2
2251258,2251932,674,0,0,1,1
2251933,2252053,120,1,0,0,1
2252054,2252170,116,0,0,1,1
2252171,2252471,300,1,0,0,1
2252176,2252432,256,1,0,0,2
2252243,2252404,161,0,1,0,1
2252433,2252722,289,0,0,1,2
2252472,2252721,249,0,0,1,1
2252722,2252775,53,1,0,0,1
2252723,2252777,54,1,0,0,2
2252776,2252908,132,0,0,1,1
2252778,2252907,129,0,0,1,2
2252908,2252937,29,1,0,0,2
2252909,2252931,22,1,0,0,1
2252932,2253739,807,0,0,1,1
2252938,2253735,797,0,0,1,2
2253736,2253760,24,1,0,0,2
2253740,2253762,22,1,0,0,1
2253761,2253930,169,0,0,1,2
2253763,2253930,167,0,0,1,1
2253931,2253959,28,1,0,0,2
2253931,2253960,29,1,0,0,1
2253960,2254066,106,0,0,1,2
2253961,2254069,108,0,0,1,1
2254067,2254087,20,1,0,0,2
2254070,2254113,43,1,0,0,1
2254088,2254137,49,0,0,1,2
2254114,2254134,20,0,0,1,1
2254135,2254187,52,1,0,0,1
2254138,2254156,18,1,0,0,2
2254157,2254543,386,0,0,1,2
2254188,2254541,353,0,0,1,1
2254542,2254608,66,1,0,0,1
2254544,2254600,56,1,0,0,2
2254601,2254712,111,0,0,1,2
2254609,2254712,103,0,0,1,1
2254713,2254748,35,1,0,0,1
2254713,2254750,37,1,0,0,2
2254749,2254926,177,0,0,1,1
2254751,2254926,175,0,0,1,2
2254927,2254949,22,1,0,0,1
2254927,2254949,22,1,0,0,2
2254950,2255083,133,0,0,1,2
2254950,2255084,134,0,0,1,1
2255084,2255105,21,1,0,0,2
2255085,2255103,18,1,0,0,1
2255104,2255293,189,0,0,1,1
2255106,2255297,191,0,0,1,2
2255294,2255316,22,1,0,0,1
2255298,2255315,17,1,0,0,2
2255316,2255429,113,0,0,1,2
2255317,2255429,112,0,0,1,1
2255430,2255451,21,1,0,0,2
2255430,2255452,22,1,0,0,1
2255452,2255491,39,0,0,1,2
2255453,2255495,42,0,0,1,1
2255492,2255510,18,1,0,0,2
2255496,2255511,15,1,0,0,1
2255511,2255827,316,0,0,1,2
2255512,2255898,386,0,0,1,1
2255828,2255835,7,1,0,0,2
2255836,2256332,496,0,0,1,2
2255899,2255905,6,1,0,0,1
2255906,2256331,425,0,0,1,1
2256332,2256380,48,1,0,0,1
2256333,2256383,50,1,0,0,2
2256381,2256497,116,0,0,1,1
2256384,2256495,111,0,0,1,2
2256496,2256532,36,1,0,0,2
2256498,2256532,34,1,0,0,1
2256533,2256766,233,0,0,1,1
2256533,2256773,240,0,0,1,2
2256767,2256797,30,1,0,0,1
2256774,2256794,20,1,0,0,2
2256795,2257047,252,0,0,1,2
2256798,2257048,250,0,0,1,1
2257048,2257066,18,1,0,0,2
2257049,2257069,20,1,0,0,1
2257067,2257174,107,0,0,1,2
2257070,2257173,103,0,0,1,1
2257174,2257194,20,1,0,0,1
2257175,2257196,21,1,0,0,2
2257195,2257394,199,0,0,1,1
2257197,2257391,194,0,0,1,2
2257392,2257422,30,1,0,0,2
2257395,2257421,26,1,0,0,1
2257422,2257649,227,0,0,1,1
2257423,2257652,229,0,0,1,2
2257650,2257953,303,1,0,0,1
2257653,2257917,264,1,0,0,2
2257727,2257856,129,0,1,0,1
2257732,2257817,85,0,1,0,2
2257918,2258172,254,0,0,1,2
2257954,2258285,331,0,0,1,1
2258173,2258208,35,1,0,0,2
2258209,2258284,75,0,0,1,2
2258285,2258411,126,1,0,0,2
2258286,2258404,118,1,0,0,1
2258405,2258524,119,0,0,1,1
2258412,2258522,110,0,0,1,2
2258523,2258558,35,1,0,0,2
2258525,2258559,34,1,0,0,1
2258559,2258738,179,0,0,1,2
2258560,2258738,178,0,0,1,1
2258739,2258766,27,1,0,0,2
2258739,2258769,30,1,0,0,1
2258767,2258960,193,0,0,1,2
2258770,2258960,190,0,0,1,1
2258961,2258975,14,1,0,0,2
2258961,2258976,15,1,0,0,1
2258976,2259628,652,0,0,1,2
2258977,2259628,651,0,0,1,1
2259629,2259677,48,1,0,0,1
2259629,2259677,48,1,0,0,2
2259678,2259749,71,0,0,1,1
2259678,2259750,72,0,0,1,2
2259750,2260109,359,1,0,0,1
2259751,2259768,17,1,0,0,2
2259769,2259790,21,0,0,1,2
2259791,2260011,220,1,0,0,2
2259886,2259951,65,0,1,0,1
2260012,2260067,55,0,0,1,2
2260068,2260097,29,1,0,0,2
2260098,2260230,132,0,0,1,2
2260110,2260231,121,0,0,1,1
2260231,2260278,47,1,0,0,2
2260232,2260282,50,1,0,0,1
2260279,2260448,169,0,0,1,2
2260283,2260446,163,0,0,1,1
2260447,2260478,31,1,0,0,1
2260449,2260470,21,1,0,0,2
2260471,2260715,244,0,0,1,2
2260479,2260715,236,0,0,1,1
2260716,2260735,19,1,0,0,2
2260716,2260736,20,1,0,0,1
2260736,2261261,525,0,0,1,2
2260737,2260948,211,0,0,1,1
2260949,2260959,10,1,0,0,1
2260960,2261204,244,0,0,1,1
2261205,2261213,8,1,0,0,1
2261214,2261253,39,0,0,1,1
2261254,2261299,45,1,0,0,1
2261262,2261267,5,1,0,0,2
2261268,2261352,84,0,0,1,2
2261300,2261350,50,0,0,1,1
2261351,2261361,10,1,0,0,1
2261353,2261363,10,1,0,0,2
2261362,2261565,203,0,0,1,1
2261364,2261935,571,0,0,1,2
2261566,2261578,12,1,0,0,1
2261579,2261936,357,0,0,1,1
2261936,2262006,70,1,0,0,2
2261937,2262005,68,1,0,0,1
2262006,2262145,139,0,0,1,1
2262007,2262144,137,0,0,1,2
2262145,2262226,81,1,0,0,2
2262146,2262235,89,1,0,0,1
2262227,2262393,166,0,0,1,2
2262236,2262393,157,0,0,1,1
2262394,2262424,30,1,0,0,2
2262394,2262428,34,1,0,0,1
2262425,2263413,988,0,0,1,2
2262429,2263412,983,0,0,1,1
2263413,2263549,136,1,0,0,1
2263414,2263549,135,1,0,0,2
2263550,2263916,366,0,0,1,1
2263550,2263918,368,0,0,1,2
2263917,2264001,84,1,0,0,1
2263919,2263994,75,1,0,0,2
2263995,2264067,72,0,0,1,2
2264002,2264067,65,0,0,1,1
2264068,2264101,33,1,0,0,2
2264068,2264106,38,1,0,0,1
2264102,2264882,780,0,0,1,2
2264107,2264877,770,0,0,1,1
2264878,2264938,60,1,0,0,1
2264883,2264912,29,1,0,0,2
2264913,2265445,532,0,0,1,2
2264939,2265446,507,0,0,1,1
2265446,2265484,38,1,0,0,2
2265447,2265485,38,1,0,0,1
2265485,2265606,121,0,0,1,2
2265486,2265606,120,0,0,1,1
2265607,2265695,88,1,0,0,2
2265607,2265696,89,1,0,0,1
2265696,2265814,118,0,0,1,2
2265697,2265813,116,0,0,1,1
2265814,2265853,39,1,0,0,1
2265815,2265854,39,1,0,0,2
2265854,2266664,810,0,0,1,1
2265855,2266664,809,0,0,1,2
2266665,2266719,54,1,0,0,1
2266665,2266721,56,1,0,0,2
2266720,2266932,212,0,0,1,1
2266722,2266932,210,0,0,1,2
2266933,2266986,53,1,0,0,1
2266933,2266988,55,1,0,0,2
2266987,2267512,525,0,0,1,1
2266989,2267511,522,0,0,1,2
2267512,2267551,39,1,0,0,2
2267513,2267564,51,1,0,0,1
2267552,2269781,2229,0,0,1,2
2267565,2269784,2219,0,0,1,1
2269782,2269811,29,1,0,0,2
2269785,2269812,27,1,0,0,1
2269812,2270220,408,0,0,1,2
2269813,2270219,406,0,0,1,1
2270220,2270287,67,1,0,0,1
2270221,2270283,62,1,0,0,2
2270284,2270673,389,0,0,1,2
2270288,2270655,367,0,0,1,1
2270656,2271048,392,1,0,0,1
2270674,2270902,228,1,0,0,2
2270695,2270930,235,0,1,0,1
2270724,2270852,128,0,1,0,2
2270903,2272399,1496,0,0,1,2
2271049,2272400,1351,0,0,1,1
2272400,2272467,67,1,0,0,2
2272401,2272468,67,1,0,0,1
2272468,2273232,764,0,0,1,2
2272469,2273232,763,0,0,1,1
2273233,2273304,71,1,0,0,1
2273233,2273304,71,1,0,0,2
2273305,2273784,479,0,0,1,1
2273305,2273784,479,0,0,1,2
2273785,2273837,52,1,0,0,1
2273785,2273844,59,1,0,0,2
2273838,2274261,423,0,0,1,1
2273845,2274260,415,0,0,1,2
2274261,2274328,67,1,0,0,2
2274262,2274333,71,1,0,0,1
2274329,2274429,100,0,0,1,2
2274334,2274430,96,0,0,1,1
2274430,2274462,32,1,0,0,2
2274431,2274465,34,1,0,0,1
2274463,2276055,1592,0,0,1,2
2274466,2276055,1589,0,0,1,1
2276056,2276107,51,1,0,0,2
2276056,2276108,52,1,0,0,1
2276108,2276582,474,0,0,1,2
2276109,2276583,474,0,0,1,1
2276583,2276608,25,1,0,0,2
2276584,2276617,33,1,0,0,1
2276609,2277186,577,0,0,1,2
2276618,2277185,567,0,0,1,1
2277186,2277211,25,1,0,0,1
2277187,2277211,24,1,0,0,2
2277212,2277381,169,0,0,1,2
2277212,2277383,171,0,0,1,1
2277382,2277404,22,1,0,0,2
2277384,2277408,24,1,0,0,1
2277405,2277568,163,0,0,1,2
2277409,2277545,136,0,0,1,1
2277546,2277555,9,1,0,0,1
2277556,2277581,25,0,0,1,1
2277569,2277731,162,1,0,0,2
2277582,2277711,129,1,0,0,1
2277712,2278040,328,0,0,1,1
2277732,2278028,296,0,0,1,2
2278029,2278270,241,1,0,0,2
2278041,2278275,234,1,0,0,1
2278062,2278197,135,0,1,0,1
2278066,2278185,119,0,1,0,2
2278218,2278225,7,0,1,0,1
2278271,2278500,229,0,0,1,2
2278276,2278500,224,0,0,1,1
2278501,2278539,38,1,0,0,2
2278501,2278545,44,1,0,0,1
2278540,2278918,378,0,0,1,2
2278546,2278918,372,0,0,1,1
2278919,2278971,52,1,0,0,2
2278919,2278983,64,1,0,0,1
2278972,2279425,453,0,0,1,2
2278984,2279424,440,0,0,1,1
2279425,2279503,78,1,0,0,1
2279426,2279501,75,1,0,0,2
2279502,2279590,88,0,0,1,2
2279504,2279589,85,0,0,1,1
2279590,2279623,33,1,0,0,1
2279591,2279613,22,1,0,0,2
2279614,2280857,1243,0,0,1,2
2279624,2280857,1233,0,0,1,1
2280858,2280878,20,1,0,0,2
2280858,2280888,30,1,0,0,1
2280879,2281089,210,0,0,1,2
2280889,2281088,199,0,0,1,1
2281089,2281155,66,1,0,0,1
2281090,2281149,59,1,0,0,2
2281150,2282906,1756,0,0,1,2
2281156,2282894,1738,0,0,1,1
2282895,2283191,296,1,0,0,1
2282907,2283122,215,1,0,0,2
2282938,2282941,3,0,1,0,1
2282963,2282994,31,0,1,0,1
2283030,2283046,16,0,1,0,1
2283123,2283344,221,0,0,1,2
2283192,2283343,151,0,0,1,1
2283344,2283371,27,1,0,0,1
2283345,2283373,28,1,0,0,2
2283372,2283506,134,0,0,1,1
2283374,2283499,125,0,0,1,2
2283500,2283785,285,1,0,0,2
2283507,2283831,324,1,0,0,1
2283530,2283700,170,0,1,0,2
2283531,2283776,245,0,1,0,1
2283786,2283810,24,0,0,1,2
2283811,2283828,17,1,0,0,2
2283829,2284121,292,0,0,1,2
2283832,2284121,289,0,0,1,1
2284122,2284171,49,1,0,0,2
2284122,2284172,50,1,0,0,1
2284172,2284473,301,0,0,1,2
2284173,2284473,300,0,0,1,1
2284474,2284541,67,1,0,0,2
2284474,2284552,78,1,0,0,1
2284542,2284639,97,0,0,1,2
2284553,2284640,87,0,0,1,1
2284640,2284675,35,1,0,0,2
2284641,2284676,35,1,0,0,1
2284676,2285944,1268,0,0,1,2
2284677,2285946,1269,0,0,1,1
2285945,2285967,22,1,0,0,2
2285947,2285977,30,1,0,0,1
2285968,2286239,271,0,0,1,2
2285978,2286238,260,0,0,1,1
2286239,2286290,51,1,0,0,1
2286240,2286290,50,1,0,0,2
2286291,2286537,246,0,0,1,1
2286291,2286539,248,0,0,1,2
2286538,2286557,19,1,0,0,1
2286540,2286558,18,1,0,0,2
2286558,2287075,517,0,0,1,1
2286559,2287075,516,0,0,1,2
2287076,2287097,21,1,0,0,2
2287076,2287104,28,1,0,0,1
2287098,2287363,265,0,0,1,2
2287105,2287362,257,0,0,1,1
2287363,2287395,32,1,0,0,1
2287364,2287390,26,1,0,0,2
2287391,2287799,408,0,0,1,2
2287396,2287801,405,0,0,1,1
2287800,2287824,24,1,0,0,2
2287802,2287833,31,1,0,0,1
2287825,2287964,139,0,0,1,2
2287834,2287955,121,0,0,1,1
2287956,2288109,153,1,0,0,1
2287965,2288144,179,1,0,0,2
2288110,2288344,234,0,0,1,1
2288145,2288338,193,0,0,1,2
2288339,2288659,320,1,0,0,2
2288345,2288616,271,1,0,0,1
2288373,2288566,193,0,1,0,1
2288377,2288521,144,0,1,0,2
2288617,2288741,124,0,0,1,1
2288660,2288741,81,0,0,1,2
2288742,2288766,24,1,0,0,2
2288742,2288767,25,1,0,0,1
2288767,2289013,246,0,0,1,2
2288768,2289014,246,0,0,1,1
2289014,2289054,40,1,0,0,2
2289015,2289054,39,1,0,0,1
2289055,2289241,186,0,0,1,1
2289055,2289244,189,0,0,1,2
2289242,2289256,14,1,0,0,1
2289245,2289255,10,1,0,0,2
2289256,2289559,303,0,0,1,2
2289257,2289558,301,0,0,1,1
2289559,2289620,61,1,0,0,1
2289560,2289623,63,1,0,0,2
2289621,2289802,181,0,0,1,1
2289624,2289803,179,0,0,1,2
2289803,2289874,71,1,0,0,1
2289804,2289874,70,1,0,0,2
2289875,2289983,108,0,0,1,2
2289875,2289984,109,0,0,1,1
2289984,2290014,30,1,0,0,2
2289985,2290013,28,1,0,0,1
2290014,2290653,639,0,0,1,1
2290015,2290653,638,0,0,1,2
2290654,2290675,21,1,0,0,2
2290654,2290682,28,1,0,0,1
2290676,2290726,50,0,0,1,2
2290683,2290724,41,0,0,1,1
2290725,2290759,34,1,0,0,1
2290727,2290760,33,1,0,0,2
2290760,2291958,1198,0,0,1,1
2290761,2291956,1195,0,0,1,2
2291957,2291999,42,1,0,0,2
2291959,2292009,50,1,0,0,1
2292000,2292775,775,0,0,1,2
2292010,2292774,764,0,0,1,1
2292775,2292810,35,1,0,0,1
2292776,2292799,23,1,0,0,2
2292800,2293001,201,0,0,1,2
2292811,2293006,195,0,0,1,1
2293002,2294332,1330,1,0,0,2
2293007,2293422,415,1,0,0,1
2293036,2293397,361,0,1,0,1
2293042,2293289,247,0,1,0,2
2293423,2293474,51,0,0,1,1
2293475,2294189,714,1,0,0,1
2293553,2294173,620,0,1,0,1
2293602,2293850,248,0,1,0,2
2294190,2294246,56,0,0,1,1
2294247,2294286,39,1,0,0,1
2294287,2294378,91,0,0,1,1
2294333,2294379,46,0,0,1,2
2294379,2294823,444,1,0,0,1
2294380,2294828,448,1,0,0,2
2294461,2294756,295,0,1,0,1
2294498,2294669,171,0,1,0,2
2294824,2295208,384,0,0,1,1
2294829,2295206,377,0,0,1,2
2295207,2295249,42,1,0,0,2
2295209,2295248,39,1,0,0,1
2295249,2295503,254,0,0,1,1
2295250,2295503,253,0,0,1,2
2295504,2295547,43,1,0,0,1
2295504,2295548,44,1,0,0,2
2295548,2295823,275,0,0,1,1
2295549,2295823,274,0,0,1,2
2295824,2295888,64,1,0,0,2
2295824,2295889,65,1,0,0,1
2295889,2296808,919,0,0,1,2
2295890,2296252,362,0,0,1,1
2296253,2296270,17,1,0,0,1
2296271,2296808,537,0,0,1,1
2296809,2296826,17,1,0,0,2
2296809,2296829,20,1,0,0,1
2296827,2297469,642,0,0,1,2
2296830,2297467,637,0,0,1,1
2297468,2297483,15,1,0,0,1
2297470,2297483,13,1,0,0,2
2297484,2298145,661,0,0,1,2
2297484,2298146,662,0,0,1,1
2298146,2298215,69,1,0,0,2
2298147,2298214,67,1,0,0,1
2298215,2298366,151,0,0,1,1
2298216,2298368,152,0,0,1,2
2298367,2298386,19,1,0,0,1
2298369,2298386,17,1,0,0,2
2298387,2298582,195,0,0,1,1
2298387,2298587,200,0,0,1,2
2298583,2298600,17,1,0,0,1
2298588,2298600,12,1,0,0,2
2298601,2298802,201,0,0,1,2
2298601,2298803,202,0,0,1,1
2298803,2298822,19,1,0,0,2
2298804,2298825,21,1,0,0,1
2298823,2299653,830,0,0,1,2
2298826,2299253,427,0,0,1,1
2299254,2299267,13,1,0,0,1
2299268,2299652,384,0,0,1,1
2299653,2299673,20,1,0,0,1
2299654,2299674,20,1,0,0,2
2299674,2299788,114,0,0,1,1
2299675,2299792,117,0,0,1,2
2299789,2299804,15,1,0,0,1
2299793,2299810,17,1,0,0,2
2299805,2300260,455,0,0,1,1
2299811,2300258,447,0,0,1,2
2300259,2300585,326,1,0,0,2
2300261,2300589,328,1,0,0,1
2300292,2300443,151,0,1,0,2
2300293,2300522,229,0,1,0,1
2300586,2300727,141,0,0,1,2
2300590,2300727,137,0,0,1,1
2300728,2300766,38,1,0,0,2
2300728,2300767,39,1,0,0,1
2300767,2300956,189,0,0,1,2
2300768,2300959,191,0,0,1,1
2300957,2300999,42,1,0,0,2
2300960,2300999,39,1,0,0,1
2301000,2301566,566,0,0,1,1
2301000,2301566,566,0,0,1,2
2301567,2301599,32,1,0,0,2
2301567,2301608,41,1,0,0,1
2301600,2301917,317,0,0,1,2
2301609,2301918,309,0,0,1,1
2301918,2301980,62,1,0,0,2
2301919,2301990,71,1,0,0,1
2301981,2302104,123,0,0,1,2
2301991,2302102,111,0,0,1,1
2302103,2302132,29,1,0,0,1
2302105,2302125,20,1,0,0,2
2302126,2304131,2005,0,0,1,2
2302133,2303352,1219,0,0,1,1
2303353,2303363,10,1,0,0,1
2303364,2304131,767,0,0,1,1
2304132,2304184,52,1,0,0,1
2304132,2304184,52,1,0,0,2
2304185,2304413,228,0,0,1,1
2304185,2304416,231,0,0,1,2
2304414,2304441,27,1,0,0,1
2304417,2304432,15,1,0,0,2
2304433,2305973,1540,0,0,1,2
2304442,2305983,1541,0,0,1,1
2305974,2306271,297,1,0,0,2
2305984,2306244,260,1,0,0,1
2306013,2306198,185,0,1,0,1
2306033,2306145,112,0,1,0,2
2306245,2306355,110,0,0,1,1
2306272,2306346,74,0,0,1,2
2306347,2306377,30,1,0,0,2
2306356,2306368,12,1,0,0,1
2306369,2306537,168,0,0,1,1
2306378,2306538,160,0,0,1,2
2306538,2306564,26,1,0,0,1
2306539,2306566,27,1,0,0,2
2306565,2306731,166,0,0,1,1
2306567,2306730,163,0,0,1,2
2306731,2307128,397,1,0,0,2
2306732,2307030,298,1,0,0,1
2306762,2306978,216,0,1,0,1
2306763,2306927,164,0,1,0,2
2307031,2307086,55,0,0,1,1
2307087,2307108,21,1,0,0,1
2307109,2307424,315,0,0,1,1
2307129,2307270,141,0,0,1,2
2307271,2307280,9,1,0,0,2
2307281,2307424,143,0,0,1,2
2307425,2307470,45,1,0,0,1
2307425,2307472,47,1,0,0,2
2307471,2307624,153,0,0,1,1
2307473,2307623,150,0,0,1,2
2307624,2307629,5,1,0,0,2
2307625,2307630,5,1,0,0,1
2307630,2308018,388,0,0,1,2
2307631,2308019,388,0,0,1,1
2308019,2308080,61,1,0,0,2
2308020,2308085,65,1,0,0,1
2308081,2308191,110,0,0,1,2
2308086,2308194,108,0,0,1,1
2308192,2308239,47,1,0,0,2
2308195,2308246,51,1,0,0,1
2308240,2308363,123,0,0,1,2
2308247,2308361,114,0,0,1,1
2308362,2308392,30,1,0,0,1
2308364,2308383,19,1,0,0,2
2308384,2308577,193,0,0,1,2
2308393,2308578,185,0,0,1,1
2308578,2308599,21,1,0,0,2
2308579,2308612,33,1,0,0,1
2308600,2309803,1203,0,0,1,2
2308613,2309803,1190,0,0,1,1
2309804,2309861,57,1,0,0,2
2309804,2309867,63,1,0,0,1
2309862,2310068,206,0,0,1,2
2309868,2310068,200,0,0,1,1
2310069,2310094,25,1,0,0,2
2310069,2310111,42,1,0,0,1
2310095,2310259,164,0,0,1,2
2310112,2310271,159,0,0,1,1
2310260,2310541,281,1,0,0,2
2310272,2310526,254,1,0,0,1
2310292,2310482,190,0,1,0,1
2310295,2310433,138,0,1,0,2
2310527,2310915,388,0,0,1,1
2310542,2310916,374,0,0,1,2
2310916,2310947,31,1,0,0,1
2310917,2310947,30,1,0,0,2
2310948,2311135,187,0,0,1,1
2310948,2311136,188,0,0,1,2
2311136,2311177,41,1,0,0,1
2311137,2311175,38,1,0,0,2
2311176,2311856,680,0,0,1,2
2311178,2311861,683,0,0,1,1
2311857,2312444,587,1,0,0,2
2311862,2312319,457,1,0,0,1
2311888,2312293,405,0,1,0,1
2311894,2312107,213,0,1,0,2
2312320,2312344,24,0,0,1,1
2312345,2312360,15,1,0,0,1
2312361,2312573,212,0,0,1,1
2312445,2312575,130,0,0,1,2
2312574,2312598,24,1,0,0,1
2312576,2312597,21,1,0,0,2
2312598,2312825,227,0,0,1,2
2312599,2312854,255,0,0,1,1
2312826,2313431,605,1,0,0,2
2312855,2313430,575,1,0,0,1
2312882,2313289,407,0,1,0,1
2312894,2313103,209,0,1,0,2
2313431,2313477,46,0,0,1,1
2313432,2313477,45,0,0,1,2
2313478,2313509,31,1,0,0,2
2313478,2313511,33,1,0,0,1
2313510,2313736,226,0,0,1,2
2313512,2313734,222,0,0,1,1
2313735,2313766,31,1,0,0,1
2313737,2313775,38,1,0,0,2
2313767,2314797,1030,0,0,1,1
2313776,2314801,1025,0,0,1,2
2314798,2314824,26,1,0,0,1
2314802,2314813,11,1,0,0,2
2314814,2315573,759,0,0,1,2
2314825,2315574,749,0,0,1,1
2315574,2315621,47,1,0,0,2
2315575,2315623,48,1,0,0,1
2315622,2316273,651,0,0,1,2
2315624,2316283,659,0,0,1,1
2316274,2316593,319,1,0,0,2
2316284,2316547,263,1,0,0,1
2316329,2316484,155,0,1,0,1
2316344,2316461,117,0,1,0,2
2316548,2317380,832,0,0,1,1
2316594,2317378,784,0,0,1,2
2317379,2317399,20,1,0,0,2
2317381,2317399,18,1,0,0,1
2317400,2317768,368,0,0,1,1
2317400,2317770,370,0,0,1,2
2317769,2317799,30,1,0,0,1
2317771,2317790,19,1,0,0,2
2317791,2317885,94,0,0,1,2
2317800,2317886,86,0,0,1,1
2317886,2318269,383,1,0,0,2
2317887,2318166,279,1,0,0,1
2317924,2318103,179,0,1,0,1
2317928,2318082,154,0,1,0,2
2318167,2318296,129,0,0,1,1
2318270,2318292,22,0,0,1,2
2318293,2318320,27,1,0,0,2
2318297,2318320,23,1,0,0,1
2318321,2318527,206,0,0,1,1
2318321,2318528,207,0,0,1,2
2318528,2318603,75,1,0,0,1
2318529,2318594,65,1,0,0,2
2318595,2318727,132,0,0,1,2
2318604,2318724,120,0,0,1,1
2318725,2318753,28,1,0,0,1
2318728,2318754,26,1,0,0,2
2318754,2318888,134,0,0,1,1
2318755,2318887,132,0,0,1,2
2318888,2318916,28,1,0,0,2
2318889,2318915,26,1,0,0,1
2318916,2319422,506,0,0,1,1
2318917,2319420,503,0,0,1,2
2319421,2319473,52,1,0,0,2
2319423,2319474,51,1,0,0,1
2319474,2319604,130,0,0,1,2
2319475,2319602,127,0,0,1,1
2319603,2319634,31,1,0,0,1
2319605,2319626,21,1,0,0,2
2319627,2320875,1248,0,0,1,2
2319635,2320879,1244,0,0,1,1
2320876,2320904,28,1,0,0,2
2320880,2320906,26,1,0,0,1
2320905,2321510,605,0,0,1,2
2320907,2321511,604,0,0,1,1
2321511,2321565,54,1,0,0,2
2321512,2321566,54,1,0,0,1
2321566,2321791,225,0,0,1,2
2321567,2321786,219,0,0,1,1
2321787,2321813,26,1,0,0,1
2321792,2321804,12,1,0,0,2
2321805,2322001,196,0,0,1,2
2321814,2322000,186,0,0,1,1
2322001,2322030,29,1,0,0,1
2322002,2322022,20,1,0,0,2
2322023,2322164,141,0,0,1,2
2322031,2322163,132,0,0,1,1
2322164,2322193,29,1,0,0,1
2322165,2322182,17,1,0,0,2
2322183,2323187,1004,0,0,1,2
2322194,2323199,1005,0,0,1,1
2323188,2324044,856,1,0,0,2
2323200,2323439,239,1,0,0,1
2323221,2323408,187,0,1,0,1
2323239,2323368,129,0,1,0,2
2323440,2323527,87,0,0,1,1
2323528,2324005,477,1,0,0,1
2323555,2323911,356,0,1,0,1
2323567,2323817,250,0,1,0,2
2324006,2324249,243,0,0,1,1
2324045,2324250,205,0,0,1,2
2324250,2324277,27,1,0,0,1
2324251,2324279,28,1,0,0,2
2324278,2324460,182,0,0,1,1
2324280,2324457,177,0,0,1,2
2324458,2324475,17,1,0,0,2
2324461,2324475,14,1,0,0,1
2324476,2324812,336,0,0,1,2
2324476,2324813,337,0,0,1,1
2324813,2324851,38,1,0,0,2
2324814,2324852,38,1,0,0,1
2324852,2325037,185,0,0,1,2
2324853,2325039,186,0,0,1,1
2325038,2325069,31,1,0,0,2
2325040,2325070,30,1,0,0,1
2325070,2325262,192,0,0,1,2
2325071,2325260,189,0,0,1,1
2325261,2325293,32,1,0,0,1
2325263,2325298,35,1,0,0,2
2325294,2325430,136,0,0,1,1
2325299,2325429,130,0,0,1,2
2325430,2325452,22,1,0,0,2
2325431,2325460,29,1,0,0,1
2325453,2326383,930,0,0,1,2
2325461,2325979,518,0,0,1,1
2325980,2325994,14,1,0,0,1
2325995,2326209,214,0,0,1,1
2326210,2326228,18,1,0,0,1
2326229,2326380,151,0,0,1,1
2326381,2326397,16,1,0,0,1
2326384,2326396,12,1,0,0,2
2326397,2327592,1195,0,0,1,2
2326398,2327592,1194,0,0,1,1
2327593,2327610,17,1,0,0,1
2327593,2327612,19,1,0,0,2
2327611,2327768,157,0,0,1,1
2327613,2327768,155,0,0,1,2
2327769,2327820,51,1,0,0,2
2327769,2327823,54,1,0,0,1
2327821,2327991,170,0,0,1,2
2327824,2327989,165,0,0,1,1
2327990,2328018,28,1,0,0,1
2327992,2328010,18,1,0,0,2
2328011,2328422,411,0,0,1,2
2328019,2328418,399,0,0,1,1
2328419,2328444,25,1,0,0,1
2328423,2328444,21,1,0,0,2
2328445,2328670,225,0,0,1,1
2328445,2328685,240,0,0,1,2
2328671,2329067,396,1,0,0,1
2328686,2328969,283,1,0,0,2
2328711,2328964,253,0,1,0,1
2328744,2328900,156,0,1,0,2
2328970,2329373,403,0,0,1,2
2329068,2329373,305,0,0,1,1
2329374,2329406,32,1,0,0,1
2329374,2329406,32,1,0,0,2
2329407,2329577,170,0,0,1,1
2329407,2329578,171,0,0,1,2
2329578,2329608,30,1,0,0,1
2329579,2329600,21,1,0,0,2
2329601,2330044,443,0,0,1,2
2329609,2330026,417,0,0,1,1
2330027,2330590,563,1,0,0,1
2330045,2330444,399,1,0,0,2
2330064,2330437,373,0,1,0,1
2330084,2330331,247,0,1,0,2
2330445,2330512,67,0,0,1,2
2330513,2330532,19,1,0,0,2
2330533,2330953,420,0,0,1,2
2330591,2330853,262,0,0,1,1
2330854,2330858,4,1,0,0,1
2330859,2330957,98,0,0,1,1
2330954,2331058,104,1,0,0,2
2330958,2331055,97,1,0,0,1
2331056,2331091,35,0,0,1,1
2331059,2331088,29,0,0,1,2
2331089,2331130,41,1,0,0,2
2331092,2331132,40,1,0,0,1
2331131,2331533,402,0,0,1,2
2331133,2331533,400,0,0,1,1
2331534,2331591,57,1,0,0,1
2331534,2331593,59,1,0,0,2
2331592,2331715,123,0,0,1,1
2331594,2331714,120,0,0,1,2
2331715,2331765,50,1,0,0,2
2331716,2331761,45,1,0,0,1
2331762,2331883,121,0,0,1,1
2331766,2331883,117,0,0,1,2
2331884,2331916,32,1,0,0,1
2331884,2331916,32,1,0,0,2
2331917,2333066,1149,0,0,1,1
2331917,2333067,1150,0,0,1,2
2333067,2333082,15,1,0,0,1
2333068,2333081,13,1,0,0,2
2333082,2333730,648,0,0,1,2
2333083,2333728,645,0,0,1,1
2333729,2333790,61,1,0,0,1
2333731,2333774,43,1,0,0,2
2333775,2335787,2012,0,0,1,2
2333791,2335781,1990,0,0,1,1
2335782,2336296,514,1,0,0,1
2335788,2336106,318,1,0,0,2
2335815,2336120,305,0,1,0,1
2335842,2336048,206,0,1,0,2
2336107,2336225,118,0,0,1,2
2336226,2336254,28,1,0,0,2
2336255,2336618,363,0,0,1,2
2336297,2336619,322,0,0,1,1
2336619,2336642,23,1,0,0,2
2336620,2336646,26,1,0,0,1
2336643,2336926,283,0,0,1,2
2336647,2336926,279,0,0,1,1
2336927,2336984,57,1,0,0,1
2336927,2336984,57,1,0,0,2
2336985,2337495,510,0,0,1,2
2336985,2337496,511,0,0,1,1
2337496,2337581,85,1,0,0,2
2337497,2337579,82,1,0,0,1
2337580,2337687,107,0,0,1,1
2337582,2337684,102,0,0,1,2
2337685,2337710,25,1,0,0,2
2337688,2337720,32,1,0,0,1
2337711,2339516,1805,0,0,1,2
2337721,2339513,1792,0,0,1,1
2339514,2339546,32,1,0,0,1
2339517,2339545,28,1,0,0,2
2339546,2339721,175,0,0,1,2
2339547,2339720,173,0,0,1,1
2339721,2339776,55,1,0,0,1
2339722,2339770,48,1,0,0,2
2339771,2340198,427,0,0,1,2
2339777,2340201,424,0,0,1,1
2340199,2340435,236,1,0,0,2
2340202,2340464,262,1,0,0,1
2340245,2340368,123,0,1,0,1
2340250,2340328,78,0,1,0,2
2340436,2340777,341,0,0,1,2
2340465,2340778,313,0,0,1,1
2340778,2340806,28,1,0,0,2
2340779,2340807,28,1,0,0,1
2340807,2341459,652,0,0,1,2
2340808,2341440,632,0,0,1,1
2341441,2341805,364,1,0,0,1
2341460,2341785,325,1,0,0,2
2341486,2341713,227,0,1,0,1
2341509,2341635,126,0,1,0,2
2341786,2342307,521,0,0,1,2
2341806,2342306,500,0,0,1,1
2342307,2342359,52,1,0,0,1
2342308,2342360,52,1,0,0,2
2342360,2342772,412,0,0,1,1
2342361,2342782,421,0,0,1,2
2342773,2343127,354,1,0,0,1
2342783,2343092,309,1,0,0,2
2342818,2343032,214,0,1,0,1
2342824,2342981,157,0,1,0,2
2343093,2343660,567,0,0,1,2
2343128,2343657,529,0,0,1,1
2343658,2344075,417,1,0,0,1
2343661,2343912,251,1,0,0,2
2343696,2343935,239,0,1,0,1
2343704,2343866,162,0,1,0,2
2343913,2344150,237,0,0,1,2
2344076,2345042,966,0,0,1,1
2344151,2344163,12,1,0,0,2
2344164,2345059,895,0,0,1,2
2345043,2345752,709,1,0,0,1
2345060,2345332,272,1,0,0,2
2345075,2345449,374,0,1,0,1
2345095,2345289,194,0,1,0,2
2345333,2345672,339,0,0,1,2
2345673,2345709,36,1,0,0,2
2345710,2346641,931,0,0,1,2
2345753,2345788,35,0,0,1,1
2345789,2345806,17,1,0,0,1
2345807,2346628,821,0,0,1,1
2346629,2347499,870,1,0,0,1
2346642,2347172,530,1,0,0,2
2346657,2347199,542,0,1,0,1
2346686,2346946,260,0,1,0,2
2346991,2346993,2,0,1,0,2
2347173,2347208,35,0,0,1,2
2347209,2347254,45,1,0,0,2
2347255,2348034,779,0,0,1,2
2347500,2348026,526,0,0,1,1
2348027,2348933,906,1,0,0,1
2348035,2348473,438,1,0,0,2
2348049,2348588,539,0,1,0,1
2348073,2348374,301,0,1,0,2
2348474,2348734,260,0,0,1,2
2348735,2348767,32,1,0,0,2
2348768,2349248,480,0,0,1,2
2348934,2348992,58,0,0,1,1
2348993,2349081,88,1,0,0,1
2349082,2349163,81,0,0,1,1
2349164,2349195,31,1,0,0,1
2349196,2349249,53,0,0,1,1
2349249,2349350,101,1,0,0,2
2349250,2349358,108,1,0,0,1
2349351,2349471,120,0,0,1,2
2349359,2349469,110,0,0,1,1
2349470,2349506,36,1,0,0,1
2349472,2349506,34,1,0,0,2
2349507,2351231,1724,0,0,1,1
2349507,2351231,1724,0,0,1,2
2351232,2351275,43,1,0,0,2
2351232,2351285,53,1,0,0,1
2351276,2351635,359,0,0,1,2
2351286,2351630,344,0,0,1,1
2351631,2351652,21,1,0,0,1
2351636,2351649,13,1,0,0,2
2351650,2351876,226,0,0,1,2
2351653,2351870,217,0,0,1,1
2351871,2351899,28,1,0,0,1
2351877,2351898,21,1,0,0,2
2351899,2352095,196,0,0,1,2
2351900,2352093,193,0,0,1,1
2352094,2352118,24,1,0,0,1
2352096,2352540,444,1,0,0,2
2352119,2352150,31,0,0,1,1
2352151,2352450,299,1,0,0,1
2352183,2352374,191,0,1,0,1
2352195,2352351,156,0,1,0,2
2352451,2352519,68,0,0,1,1
2352520,2352543,23,1,0,0,1
2352541,2352767,226,0,0,1,2
2352544,2352760,216,0,0,1,1
2352761,2352778,17,1,0,0,1
2352768,2352777,9,1,0,0,2
2352778,2353029,251,0,0,1,2
2352779,2353031,252,0,0,1,1
2353030,2353053,23,1,0,0,2
2353032,2353052,20,1,0,0,1
2353053,2353350,297,0,0,1,1
2353054,2353348,294,0,0,1,2
2353349,2353387,38,1,0,0,2
2353351,2353375,24,1,0,0,1
2353376,2353494,118,0,0,1,1
2353388,2353494,106,0,0,1,2
2353495,2353845,350,1,0,0,2
2353495,2353872,377,1,0,0,1
2353550,2353795,245,0,1,0,1
2353557,2353753,196,0,1,0,2
2353846,2354049,203,0,0,1,2
2353873,2354049,176,0,0,1,1
2354050,2354108,58,1,0,0,2
2354050,2354110,60,1,0,0,1
2354109,2354758,649,0,0,1,2
2354111,2354756,645,0,0,1,1
2354757,2354832,75,1,0,0,1
2354759,2354830,71,1,0,0,2
2354831,2356715,1884,0,0,1,2
2354833,2356715,1882,0,0,1,1
2356716,2356784,68,1,0,0,2
2356716,2356787,71,1,0,0,1
2356785,2356982,197,0,0,1,2
2356788,2356982,194,0,0,1,1
2356983,2357017,34,1,0,0,2
2356983,2357018,35,1,0,0,1
2357018,2358366,1348,0,0,1,2
2357019,2358363,1344,0,0,1,1
2358364,2358650,286,1,0,0,1
2358367,2358665,298,1,0,0,2
2358419,2358554,135,0,1,0,1
2358433,2358517,84,0,1,0,2
2358651,2358879,228,0,0,1,1
2358666,2358882,216,0,0,1,2
2358880,2358950,70,1,0,0,1
2358883,2358948,65,1,0,0,2
2358949,2359134,185,0,0,1,2
2358951,2359125,174,0,0,1,1
2359126,2359520,394,1,0,0,1
2359135,2359448,313,1,0,0,2
2359170,2359362,192,0,1,0,1
2359181,2359314,133,0,1,0,2
2359449,2359569,120,0,0,1,2
2359521,2359557,36,0,0,1,1
2359558,2359562,4,1,0,0,1
2359563,2359742,179,0,0,1,1
2359570,2359580,10,1,0,0,2
2359581,2359742,161,0,0,1,2
2359743,2359770,27,1,0,0,1
2359743,2359771,28,1,0,0,2
2359771,2359946,175,0,0,1,1
2359772,2359945,173,0,0,1,2
2359946,2359980,34,1,0,0,2
2359947,2359980,33,1,0,0,1
2359981,2360131,150,0,0,1,1
2359981,2360132,151,0,0,1,2
2360132,2360157,25,1,0,0,1
2360133,2360157,24,1,0,0,2
2360158,2360280,122,0,0,1,2
2360158,2360281,123,0,0,1,1
2360281,2360364,83,1,0,0,2
2360282,2360375,93,1,0,0,1
2360365,2360636,271,0,0,1,2
2360376,2360635,259,0,0,1,1
2360636,2360664,28,1,0,0,1
2360637,2360664,27,1,0,0,2
2360665,2360778,113,0,0,1,1
2360665,2360779,114,0,0,1,2
2360779,2360874,95,1,0,0,1
2360780,2360871,91,1,0,0,2
2360872,2360966,94,0,0,1,2
2360875,2360968,93,0,0,1,1
2360967,2361001,34,1,0,0,2
2360969,2360997,28,1,0,0,1
2360998,2361179,181,0,0,1,1
2361002,2361176,174,0,0,1,2
2361177,2361200,23,1,0,0,2
2361180,2361205,25,1,0,0,1
2361201,2361729,528,0,0,1,2
2361206,2361728,522,0,0,1,1
2361729,2361751,22,1,0,0,1
2361730,2361743,13,1,0,0,2
2361744,2362212,468,0,0,1,2
2361752,2362213,461,0,0,1,1
2362213,2362229,16,1,0,0,2
2362214,2362238,24,1,0,0,1
2362230,2362380,150,0,0,1,2
2362239,2362380,141,0,0,1,1
2362381,2362438,57,1,0,0,1
2362381,2362443,62,1,0,0,2
2362439,2362556,117,0,0,1,1
2362444,2362551,107,0,0,1,2
2362552,2362574,22,1,0,0,2
2362557,2362574,17,1,0,0,1
2362575,2362765,190,0,0,1,1
2362575,2362765,190,0,0,1,2
2362766,2362785,19,1,0,0,1
2362766,2362786,20,1,0,0,2
2362786,2363238,452,0,0,1,1
2362787,2363242,455,0,0,1,2
2363239,2363251,12,1,0,0,1
2363243,2363247,4,1,0,0,2
2363248,2363894,646,0,0,1,2
2363252,2363890,638,0,0,1,1
2363891,2364202,311,1,0,0,1
2363895,2364173,278,1,0,0,2
2363926,2364065,139,0,1,0,2
2363927,2364090,163,0,1,0,1
2364174,2364425,251,0,0,1,2
2364203,2364417,214,0,0,1,1
2364418,2364986,568,1,0,0,1
2364426,2364573,147,1,0,0,2
2364574,2364631,57,0,0,1,2
2364632,2364903,271,1,0,0,2
2364655,2364833,178,0,1,0,1
2364659,2364793,134,0,1,0,2
2364904,2365169,265,0,0,1,2
2364987,2365175,188,0,0,1,1
2365170,2365379,209,1,0,0,2
2365176,2365328,152,1,0,0,1
2365329,2365356,27,0,0,1,1
2365357,2365386,29,1,0,0,1
2365380,2365407,27,0,0,1,2
2365387,2365418,31,0,0,1,1
2365408,2365430,22,1,0,0,2
2365419,2365432,13,1,0,0,1
2365431,2365478,47,0,0,1,2
2365433,2365519,86,0,0,1,1
2365479,2365543,64,1,0,0,2
2365520,2366024,504,1,0,0,1
2365544,2365569,25,0,0,1,2
2365570,2366022,452,1,0,0,2
2365757,2365866,109,0,1,0,1
2366023,2366229,206,0,0,1,2
2366025,2366227,202,0,0,1,1
2366228,2366297,69,1,0,0,1
2366230,2366296,66,1,0,0,2
2366297,2366399,102,0,0,1,2
2366298,2366399,101,0,0,1,1
2366400,2366455,55,1,0,0,2
2366400,2366456,56,1,0,0,1
2366456,2366567,111,0,0,1,2
2366457,2366568,111,0,0,1,1
2366568,2366591,23,1,0,0,2
2366569,2366599,30,1,0,0,1
2366592,2366760,168,0,0,1,2
2366600,2366758,158,0,0,1,1
2366759,2366792,33,1,0,0,1
2366761,2366792,31,1,0,0,2
2366793,2366985,192,0,0,1,1
2366793,2366986,193,0,0,1,2
2366986,2366999,13,1,0,0,1
2366987,2366998,11,1,0,0,2
2366999,2367151,152,0,0,1,2
2367000,2367148,148,0,0,1,1
2367149,2367169,20,1,0,0,1
2367152,2367169,17,1,0,0,2
2367170,2367654,484,0,0,1,1
2367170,2367655,485,0,0,1,2
2367655,2367674,19,1,0,0,1
2367656,2367675,19,1,0,0,2
2367675,2368280,605,0,0,1,1
2367676,2368280,604,0,0,1,2
2368281,2368346,65,1,0,0,2
2368281,2368370,89,1,0,0,1
2368347,2368491,144,0,0,1,2
2368371,2368489,118,0,0,1,1
2368490,2368525,35,1,0,0,1
2368492,2368514,22,1,0,0,2
2368515,2368726,211,0,0,1,2
2368526,2368721,195,0,0,1,1
2368722,2370787,2065,1,0,0,1
2368727,2369179,452,1,0,0,2
2368771,2369222,451,0,1,0,1
2368777,2369147,370,0,1,0,2
2369180,2369459,279,0,0,1,2
2369460,2369768,308,1,0,0,2
2369471,2370652,1181,0,1,0,1
2369505,2369745,240,0,1,0,2
2369769,2370023,254,0,0,1,2
2370024,2370029,5,1,0,0,2
2370030,2370194,164,0,0,1,2
2370195,2370628,433,1,0,0,2
2370236,2370488,252,0,1,0,2
2370629,2371626,997,0,0,1,2
2370788,2371624,836,0,0,1,1
2371625,2371692,67,1,0,0,1
2371627,2371679,52,1,0,0,2
2371680,2372052,372,0,0,1,2
2371693,2372051,358,0,0,1,1
2372052,2372132,80,1,0,0,1
2372053,2372131,78,1,0,0,2
2372132,2372232,100,0,0,1,2
2372133,2372231,98,0,0,1,1
2372232,2372283,51,1,0,0,1
2372233,2372281,48,1,0,0,2
2372282,2372366,84,0,0,1,2
2372284,2372336,52,0,0,1,1
2372337,2373183,846,1,0,0,1
2372367,2372747,380,1,0,0,2
2372381,2373173,792,0,1,0,1
2372402,2372736,334,0,1,0,2
2372748,2372846,98,0,0,1,2
2372847,2372882,35,1,0,0,2
2372883,2374186,1303,0,0,1,2
2373184,2373376,192,0,0,1,1
2373377,2373381,4,1,0,0,1
2373382,2373713,331,0,0,1,1
2373714,2373733,19,1,0,0,1
2373734,2373977,243,0,0,1,1
2373978,2374007,29,1,0,0,1
2374008,2374187,179,0,0,1,1
2374187,2374206,19,1,0,0,2
2374188,2374250,62,1,0,0,1
2374207,2374456,249,0,0,1,2
2374251,2374455,204,0,0,1,1
2374456,2374527,71,1,0,0,1
2374457,2374517,60,1,0,0,2
2374518,2374985,467,0,0,1,2
2374528,2374976,448,0,0,1,1
2374977,2375349,372,1,0,0,1
2374986,2375323,337,1,0,0,2
2375019,2375249,230,0,1,0,1
2375034,2375230,196,0,1,0,2
2375324,2375572,248,0,0,1,2
2375350,2375592,242,0,0,1,1
2375573,2375958,385,1,0,0,2
2375593,2376376,783,1,0,0,1
2375622,2375915,293,0,1,0,1
2375629,2375890,261,0,1,0,2
2375959,2375979,20,0,0,1,2
2375980,2376389,409,1,0,0,2
2376030,2376312,282,0,1,0,1
2376038,2376301,263,0,1,0,2
2376377,2376604,227,0,0,1,1
2376390,2376604,214,0,0,1,2
2376605,2376938,333,1,0,0,2
2376605,2376949,344,1,0,0,1
2376632,2376861,229,0,1,0,1
2376640,2376850,210,0,1,0,2
2376939,2377037,98,0,0,1,2
2376950,2377038,88,0,0,1,1
2377038,2377091,53,1,0,0,2
2377039,2377093,54,1,0,0,1
2377092,2377384,292,0,0,1,2
2377094,2377385,291,0,0,1,1
2377385,2377444,59,1,0,0,2
2377386,2377443,57,1,0,0,1
2377444,2377916,472,0,0,1,1
2377445,2377915,470,0,0,1,2
2377916,2377983,67,1,0,0,2
2377917,2377982,65,1,0,0,1
2377983,2378614,631,0,0,1,1
2377984,2378613,629,0,0,1,2
2378614,2378642,28,1,0,0,2
2378615,2378642,27,1,0,0,1
2378643,2379302,659,0,0,1,2
2378643,2379303,660,0,0,1,1
2379303,2379333,30,1,0,0,2
2379304,2379334,30,1,0,0,1
2379334,2379929,595,0,0,1,2
2379335,2379927,592,0,0,1,1
2379928,2379999,71,1,0,0,1
2379930,2379989,59,1,0,0,2
2379990,2380122,132,0,0,1,2
2380000,2380122,122,0,0,1,1
2380123,2380153,30,1,0,0,1
2380123,2380153,30,1,0,0,2
2380154,2380533,379,0,0,1,1
2380154,2380548,394,0,0,1,2
2380534,2380789,255,1,0,0,1
2380549,2380770,221,1,0,0,2
2380572,2380709,137,0,1,0,1
2380587,2380665,78,0,1,0,2
2380771,2381047,276,0,0,1,2
2380790,2381046,256,0,0,1,1
2381047,2381077,30,1,0,0,1
2381048,2381078,30,1,0,0,2
2381078,2381808,730,0,0,1,1
2381079,2381808,729,0,0,1,2
2381809,2381822,13,1,0,0,1
2381809,2381823,14,1,0,0,2
2381823,2382229,406,0,0,1,1
2381824,2382228,404,0,0,1,2
2382229,2382254,25,1,0,0,2
2382230,2382254,24,1,0,0,1
2382255,2382582,327,0,0,1,1
2382255,2382584,329,0,0,1,2
2382583,2382621,38,1,0,0,1
2382585,2382620,35,1,0,0,2
2382621,2382923,302,0,0,1,2
2382622,2382922,300,0,0,1,1
2382923,2382981,58,1,0,0,1
2382924,2382982,58,1,0,0,2
2382982,2383764,782,0,0,1,1
2382983,2383764,781,0,0,1,2
2383765,2383810,45,1,0,0,1
2383765,2383814,49,1,0,0,2
2383811,2385100,1289,0,0,1,1
2383815,2385101,1286,0,0,1,2
2385101,2385146,45,1,0,0,1
2385102,2385146,44,1,0,0,2
2385147,2385352,205,0,0,1,1
2385147,2385352,205,0,0,1,2
2385353,2385382,29,1,0,0,1
2385353,2385383,30,1,0,0,2
2385383,2386246,863,0,0,1,1
2385384,2386246,862,0,0,1,2
2386247,2386279,32,1,0,0,1
2386247,2386279,32,1,0,0,2
2386280,2386436,156,0,0,1,2
2386280,2386439,159,0,0,1,1
2386437,2386470,33,1,0,0,2
2386440,2386469,29,1,0,0,1
2386470,2386765,295,0,0,1,1
2386471,2386765,294,0,0,1,2
2386766,2386800,34,1,0,0,1
2386766,2386800,34,1,0,0,2
2386801,2387078,277,0,0,1,1
2386801,2387100,299,0,0,1,2
2387079,2387373,294,1,0,0,1
2387101,2387354,253,1,0,0,2
2387126,2387260,134,0,1,0,1
2387154,2387211,57,0,1,0,2
2387281,2387287,6,0,1,0,1
2387355,2387647,292,0,0,1,2
2387374,2387440,66,0,0,1,1
2387441,2387452,11,1,0,0,1
2387453,2387477,24,0,0,1,1
2387478,2387504,26,1,0,0,1
2387505,2387645,140,0,0,1,1
2387646,2387679,33,1,0,0,1
2387648,2387679,31,1,0,0,2
2387680,2387937,257,0,0,1,1
2387680,2387938,258,0,0,1,2
2387938,2387983,45,1,0,0,1
2387939,2387979,40,1,0,0,2
2387980,2388374,394,0,0,1,2
2387984,2388375,391,0,0,1,1
2388375,2388456,81,1,0,0,2
2388376,2388458,82,1,0,0,1
2388457,2388546,89,0,0,1,2
2388459,2388544,85,0,0,1,1
2388545,2388575,30,1,0,0,1
2388547,2388566,19,1,0,0,2
2388567,2389683,1116,0,0,1,2
2388576,2389683,1107,0,0,1,1
2389684,2389702,18,1,0,0,2
2389684,2389704,20,1,0,0,1
2389703,2390391,688,0,0,1,2
2389705,2390391,686,0,0,1,1
2390392,2390439,47,1,0,0,2
2390392,2390443,51,1,0,0,1
2390440,2390603,163,0,0,1,2
2390444,2390601,157,0,0,1,1
2390602,2390629,27,1,0,0,1
2390604,2390628,24,1,0,0,2
2390629,2390840,211,0,0,1,2
2390630,2390841,211,0,0,1,1
2390841,2391143,302,1,0,0,2
2390842,2391129,287,1,0,0,1
2390869,2391095,226,0,1,0,1
2390879,2391044,165,0,1,0,2
2391130,2392189,1059,0,0,1,1
2391144,2392194,1050,0,0,1,2
2392190,2393540,1350,1,0,0,1
2392195,2392644,449,1,0,0,2
2392222,2392630,408,0,1,0,1
2392230,2392563,333,0,1,0,2
2392645,2392682,37,0,0,1,2
2392683,2393492,809,1,0,0,2
2392746,2393453,707,0,1,0,1
2392756,2393460,704,0,1,0,2
2393493,2394182,689,0,0,1,2
2393541,2394183,642,0,0,1,1
2394183,2394260,77,1,0,0,2
2394184,2394259,75,1,0,0,1
2394260,2394362,102,0,0,1,1
2394261,2394362,101,0,0,1,2
2394363,2394387,24,1,0,0,2
2394363,2394396,33,1,0,0,1
2394388,2395478,1090,0,0,1,2
2394397,2395478,1081,0,0,1,1
2395479,2395497,18,1,0,0,1
2395479,2395497,18,1,0,0,2
2395498,2395882,384,0,0,1,1
2395498,2395883,385,0,0,1,2
2395883,2395939,56,1,0,0,1
2395884,2395937,53,1,0,0,2
2395938,2397595,1657,0,0,1,2
2395940,2397595,1655,0,0,1,1
2397596,2397613,17,1,0,0,2
2397596,2397614,18,1,0,0,1
2397614,2397824,210,0,0,1,2
2397615,2397827,212,0,0,1,1
2397825,2397850,25,1,0,0,2
2397828,2397859,31,1,0,0,1
2397851,2398002,151,0,0,1,2
2397860,2398002,142,0,0,1,1
2398003,2398119,116,1,0,0,2
2398003,2398154,151,1,0,0,1
2398120,2398146,26,0,0,1,2
2398147,2398173,26,1,0,0,2
2398155,2398400,245,0,0,1,1
2398174,2398400,226,0,0,1,2
2398401,2398444,43,1,0,0,2
2398401,2398446,45,1,0,0,1
2398445,2398620,175,0,0,1,2
2398447,2398620,173,0,0,1,1
2398621,2398647,26,1,0,0,1
2398621,2398652,31,1,0,0,2
2398648,2398831,183,0,0,1,1
2398653,2398831,178,0,0,1,2
2398832,2398858,26,1,0,0,1
2398832,2398860,28,1,0,0,2
2398859,2399406,547,0,0,1,1
2398861,2399406,545,0,0,1,2
2399407,2399470,63,1,0,0,1
2399407,2399480,73,1,0,0,2
2399471,2399573,102,0,0,1,1
2399481,2399573,92,0,0,1,2
2399574,2399603,29,1,0,0,2
2399574,2399605,31,1,0,0,1
2399604,2400678,1074,0,0,1,2
2399606,2400674,1068,0,0,1,1
2400675,2400689,14,1,0,0,1
2400679,2400692,13,1,0,0,2
2400690,2401097,407,0,0,1,1
2400693,2401098,405,0,0,1,2
2401098,2401143,45,1,0,0,1
2401099,2401134,35,1,0,0,2
2401135,2401599,464,0,0,1,2
2401144,2401591,447,0,0,1,1
2401592,2401920,328,1,0,0,1
2401600,2401841,241,1,0,0,2
2401625,2401856,231,0,1,0,1
2401636,2401756,120,0,1,0,2
2401842,2402179,337,0,0,1,2
2401921,2402179,258,0,0,1,1
2402180,2402201,21,1,0,0,1
2402180,2402202,22,1,0,0,2
2402202,2402349,147,0,0,1,1
2402203,2402344,141,0,0,1,2
2402345,2402366,21,1,0,0,2
2402350,2402362,12,1,0,0,1
2402363,2402886,523,0,0,1,1
2402367,2402667,300,0,0,1,2
2402668,2402676,8,1,0,0,2
2402677,2402885,208,0,0,1,2
2402886,2402907,21,1,0,0,2
2402887,2402907,20,1,0,0,1
2402908,2403140,232,0,0,1,1
2402908,2403140,232,0,0,1,2
2403141,2403470,329,1,0,0,2
2403141,2403515,374,1,0,0,1
2403170,2403436,266,0,1,0,1
2403178,2403352,174,0,1,0,2
2403471,2404096,625,0,0,1,2
2403516,2404096,580,0,0,1,1
2404097,2404145,48,1,0,0,1
2404097,2404146,49,1,0,0,2
2404146,2404711,565,0,0,1,1
2404147,2404710,563,0,0,1,2
2404711,2404789,78,1,0,0,2
2404712,2404788,76,1,0,0,1
2404789,2404857,68,0,0,1,1
2404790,2404850,60,0,0,1,2
2404851,2404880,29,1,0,0,2
2404858,2404902,44,1,0,0,1
2404881,2404990,109,0,0,1,2
2404903,2404987,84,0,0,1,1
2404988,2405556,568,1,0,0,1
2404991,2405018,27,1,0,0,2
2405019,2406784,1765,0,0,1,2
2405557,2405629,72,0,0,1,1
2405630,2405754,124,1,0,0,1
2405755,2405827,72,0,0,1,1
2405828,2406145,317,1,0,0,1
2406146,2406213,67,0,0,1,1
2406214,2406350,136,1,0,0,1
2406351,2406413,62,0,0,1,1
2406414,2406553,139,1,0,0,1
2406554,2406577,23,0,0,1,1
2406578,2406628,50,1,0,0,1
2406629,2406769,140,0,0,1,1
2406770,2406850,80,1,0,0,1
2406785,2406849,64,1,0,0,2
2406850,2407271,421,0,0,1,2
2406851,2407274,423,0,0,1,1
2407272,2407296,24,1,0,0,2
2407275,2407296,21,1,0,0,1
2407297,2407325,28,0,0,1,2
2407297,2407379,82,0,0,1,1
2407326,2409171,1845,1,0,0,2
2407380,2407403,23,1,0,0,1
2407404,2407453,49,0,0,1,1
2407454,2409526,2072,1,0,0,1
2407465,2409220,1755,0,1,0,1
2407484,2407625,141,0,1,0,2
2408074,2408361,287,0,1,0,2
2408843,2409064,221,0,1,0,2
2409172,2409545,373,0,0,1,2
2409527,2409574,47,0,0,1,1
2409546,2409559,13,1,0,0,2
2409560,2409984,424,0,0,1,2
2409575,2409631,56,1,0,0,1
2409632,2409660,28,0,0,1,1
2409661,2409675,14,1,0,0,1
2409676,2409701,25,0,0,1,1
2409702,2409765,63,1,0,0,1
2409766,2410121,355,0,0,1,1
2409985,2410004,19,1,0,0,2
2410005,2410035,30,0,0,1,2
2410036,2410177,141,1,0,0,2
2410122,2410140,18,1,0,0,1
2410141,2410258,117,0,0,1,1
2410178,2410257,79,0,0,1,2
2410258,2410321,63,1,0,0,2
2410259,2410324,65,1,0,0,1
2410322,2410745,423,0,0,1,2
2410325,2410746,421,0,0,1,1
2410746,2410815,69,1,0,0,2
2410747,2410812,65,1,0,0,1
2410813,2410932,119,0,0,1,1
2410816,2410931,115,0,0,1,2
2410932,2410978,46,1,0,0,2
2410933,2410978,45,1,0,0,1
2410979,2411085,106,0,0,1,1
2410979,2411087,108,0,0,1,2
2411086,2411112,26,1,0,0,1
2411088,2411113,25,1,0,0,2
2411113,2411286,173,0,0,1,1
2411114,2411285,171,0,0,1,2
2411286,2411308,22,1,0,0,2
2411287,2411310,23,1,0,0,1
2411309,2411852,543,0,0,1,2
2411311,2411908,597,0,0,1,1
2411853,2411937,84,1,0,0,2
2411909,2411922,13,1,0,0,1
2411923,2412412,489,0,0,1,1
2411938,2412188,250,0,0,1,2
2412189,2412215,26,1,0,0,2
2412216,2412393,177,0,0,1,2
2412394,2412694,300,1,0,0,2
2412413,2413432,1019,1,0,0,1
2412429,2413354,925,0,1,0,1
2412451,2412624,173,0,1,0,2
2412695,2412784,89,0,0,1,2
2412785,2413230,445,1,0,0,2
2412818,2413019,201,0,1,0,2
2413231,2413269,38,0,0,1,2
2413270,2413387,117,1,0,0,2
2413388,2413642,254,0,0,1,2
2413433,2413769,336,0,0,1,1
2413643,2414908,1265,1,0,0,2
2413770,2414740,970,1,0,0,1
2413810,2414119,309,0,1,0,2
2413818,2414082,264,0,1,0,1
2414228,2414708,480,0,1,0,2
2414233,2414679,446,0,1,0,1
2414741,2415236,495,0,0,1,1
2414909,2415216,307,0,0,1,2
2415217,2415609,392,1,0,0,2
2415237,2415494,257,1,0,0,1
2415256,2415447,191,0,1,0,2
2415260,2415452,192,0,1,0,1
2415495,2415823,328,0,0,1,1
2415610,2415823,213,0,0,1,2
2415824,2415882,58,1,0,0,2
2415824,2415883,59,1,0,0,1
2415883,2416081,198,0,0,1,2
2415884,2416089,205,0,0,1,1
2416082,2416559,477,1,0,0,2
2416090,2416470,380,1,0,0,1
2416112,2416456,344,0,1,0,1
2416115,2416357,242,0,1,0,2
2416471,2416691,220,0,0,1,1
2416560,2416689,129,0,0,1,2
2416690,2416746,56,1,0,0,2
2416692,2416745,53,1,0,0,1
2416746,2417188,442,0,0,1,1
2416747,2417188,441,0,0,1,2
2417189,2417268,79,1,0,0,2
2417189,2417277,88,1,0,0,1
2417269,2417467,198,0,0,1,2
2417278,2417468,190,0,0,1,1
2417468,2417485,17,1,0,0,2
2417469,2417483,14,1,0,0,1
2417484,2418658,1174,0,0,1,1
2417486,2418660,1174,0,0,1,2
2418659,2418671,12,1,0,0,1
2418661,2418670,9,1,0,0,2
2418671,2419008,337,0,0,1,2
2418672,2419008,336,0,0,1,1
2419009,2419055,46,1,0,0,2
2419009,2419057,48,1,0,0,1
2419056,2419259,203,0,0,1,2
2419058,2419257,199,0,0,1,1
2419258,2419285,27,1,0,0,1
2419260,2419279,19,1,0,0,2
2419280,2419748,468,0,0,1,2
2419286,2419739,453,0,0,1,1
2419740,2420053,313,1,0,0,1
2419749,2420123,374,1,0,0,2
2419777,2419988,211,0,1,0,1
2419792,2419947,155,0,1,0,2
2420054,2421279,1225,0,0,1,1
2420124,2420203,79,0,0,1,2
2420204,2420219,15,1,0,0,2
2420220,2421279,1059,0,0,1,2
2421280,2421308,28,1,0,0,2
2421280,2421320,40,1,0,0,1
2421309,2421902,593,0,0,1,2
2421321,2421900,579,0,0,1,1
2421901,2421922,21,1,0,0,1
2421903,2421922,19,1,0,0,2
2421923,2422085,162,0,0,1,1
2421923,2422086,163,0,0,1,2
2422086,2422154,68,1,0,0,1
2422087,2422144,57,1,0,0,2
2422145,2422628,483,0,0,1,2
2422155,2422627,472,0,0,1,1
2422628,2422677,49,1,0,0,1
2422629,2422686,57,1,0,0,2
2422678,2423621,943,0,0,1,1
2422687,2423628,941,0,0,1,2
2423622,2423641,19,1,0,0,1
2423629,2423639,10,1,0,0,2
2423640,2424029,389,0,0,1,2
2423642,2424025,383,0,0,1,1
2424026,2424040,14,1,0,0,1
2424030,2424042,12,1,0,0,2
2424041,2424355,314,0,0,1,1
2424043,2424365,322,0,0,1,2
2424356,2424383,27,1,0,0,1
2424366,2424373,7,1,0,0,2
2424374,2424614,240,0,0,1,2
2424384,2424611,227,0,0,1,1
2424612,2424676,64,1,0,0,1
2424615,2424674,59,1,0,0,2
2424675,2424823,148,0,0,1,2
2424677,2424821,144,0,0,1,1
2424822,2424858,36,1,0,0,1
2424824,2424849,25,1,0,0,2
2424850,2425029,179,0,0,1,2
2424859,2425027,168,0,0,1,1
2425028,2425350,322,1,0,0,1
2425030,2425351,321,1,0,0,2
2425096,2425248,152,0,1,0,1
2425105,2425225,120,0,1,0,2
2425351,2425405,54,0,0,1,1
2425352,2425400,48,0,0,1,2
2425401,2425425,24,1,0,0,2
2425406,2425428,22,1,0,0,1
2425426,2425835,409,0,0,1,2
2425429,2425483,54,0,0,1,1
2425484,2425503,19,1,0,0,1
2425504,2425700,196,0,0,1,1
2425701,2425710,9,1,0,0,1
2425711,2425835,124,0,0,1,1
2425836,2425857,21,1,0,0,2
2425836,2425858,22,1,0,0,1
2425858,2425929,71,0,0,1,2
2425859,2425936,77,0,0,1,1
2425930,2425941,11,1,0,0,2
2425937,2425948,11,1,0,0,1
2425942,2426331,389,0,0,1,2
2425949,2426306,357,0,0,1,1
2426307,2426776,469,1,0,0,1
2426332,2426723,391,1,0,0,2
2426364,2426556,192,0,1,0,1
2426378,2426490,112,0,1,0,2
2426724,2426747,23,0,0,1,2
2426748,2426767,19,1,0,0,2
2426768,2426859,91,0,0,1,2
2426777,2426958,181,0,0,1,1
2426860,2426877,17,1,0,0,2
2426878,2426958,80,0,0,1,2
2426959,2427339,380,1,0,0,2
2426959,2427688,729,1,0,0,1
2427011,2427291,280,0,1,0,1
2427020,2427246,226,0,1,0,2
2427340,2427505,165,0,0,1,2
2427506,2427522,16,1,0,0,2
2427523,2427648,125,0,0,1,2
2427649,2427665,16,1,0,0,2
2427666,2427900,234,0,0,1,2
2427689,2427899,210,0,0,1,1
2427900,2427982,82,1,0,0,1
2427901,2427979,78,1,0,0,2
2427980,2428148,168,0,0,1,2
2427983,2428146,163,0,0,1,1
2428147,2428207,60,1,0,0,1
2428149,2428213,64,1,0,0,2
2428208,2428353,145,0,0,1,1
2428214,2428353,139,0,0,1,2
2428354,2428407,53,1,0,0,1
2428354,2428407,53,1,0,0,2
2428408,2428592,184,0,0,1,2
2428408,2428594,186,0,0,1,1
2428593,2428635,42,1,0,0,2
2428595,2428637,42,1,0,0,1
2428636,2428988,352,0,0,1,2
2428638,2428977,339,0,0,1,1
2428978,2438458,9480,1,0,0,1
2428989,2438491,9502,1,0,0,2
2429007,2429199,192,0,1,0,1
2429014,2429163,149,0,1,0,2
2429247,2438442,9195,0,1,0,1
2429257,2438124,8867,0,1,0,2
2438172,2438441,269,0,1,0,2
2438459,2438589,130,0,0,1,1
2438492,2438552,60,0,0,1,2
2438553,2438629,76,1,0,0,2
2438590,2438629,39,1,0,0,1
2438630,2439124,494,0,0,1,1
2438630,2439124,494,0,0,1,2
2439125,2439160,35,1,0,0,2
2439125,2439167,42,1,0,0,1
2439161,2439396,235,0,0,1,2
2439168,2439396,228,0,0,1,1
2487870,2488126,256,0,0,1,1
2487870,2488126,256,0,0,1,2
2488127,2488194,67,1,0,0,1
2488127,2488200,73,1,0,0,2
2488195,2488409,214,0,0,1,1
2488201,2488413,212,0,0,1,2
2488410,2488426,16,1,0,0,1
2488414,2488427,13,1,0,0,2
2488427,2489252,825,0,0,1,1
2488428,2489252,824,0,0,1,2
2489253,2489285,32,1,0,0,1
2489253,2489285,32,1,0,0,2
2489286,2490102,816,0,0,1,1
2489286,2490103,817,0,0,1,2
2490103,2490195,92,1,0,0,1
2490104,2490196,92,1,0,0,2
2490196,2490471,275,0,0,1,1
2490197,2490470,273,0,0,1,2
2490471,2490557,86,1,0,0,2
2490472,2490567,95,1,0,0,1
2490558,2490706,148,0,0,1,2
2490568,2490707,139,0,0,1,1
2490707,2490747,40,1,0,0,2
2490708,2490748,40,1,0,0,1
2490748,2491601,853,0,0,1,2
2490749,2491600,851,0,0,1,1
2491601,2491631,30,1,0,0,1
2491602,2491624,22,1,0,0,2
2491625,2491783,158,0,0,1,2
2491632,2491786,154,0,0,1,1
2491784,2491806,22,1,0,0,2
2491787,2491807,20,1,0,0,1
2491807,2492433,626,0,0,1,2
2491808,2492432,624,0,0,1,1
2492433,2492563,130,1,0,0,1
2492434,2492564,130,1,0,0,2
2492564,2492869,305,0,0,1,1
2492565,2492870,305,0,0,1,2
2492870,2492943,73,1,0,0,1
2492871,2492933,62,1,0,0,2
2492934,2493142,208,0,0,1,2
2492944,2493141,197,0,0,1,1
2493142,2493162,20,1,0,0,1
2493143,2493161,18,1,0,0,2
2493162,2493368,206,0,0,1,2
2493163,2493367,204,0,0,1,1
2493368,2493398,30,1,0,0,1
2493369,2493396,27,1,0,0,2
2493397,2494733,1336,0,0,1,2
2493399,2494732,1333,0,0,1,1
2494733,2494780,47,1,0,0,1
2494734,2494783,49,1,0,0,2
2494781,2494866,85,0,0,1,1
2494784,2494866,82,0,0,1,2
2494867,2494907,40,1,0,0,2
2494867,2494909,42,1,0,0,1
2494908,2495094,186,0,0,1,2
2494910,2495093,183,0,0,1,1
2495094,2495200,106,1,0,0,1
2495095,2495197,102,1,0,0,2
2495198,2495231,33,0,0,1,2
2495201,2495230,29,0,0,1,1
2495231,2495284,53,1,0,0,1
2495232,2495288,56,1,0,0,2
2495285,2495364,79,0,0,1,1
2495289,2495365,76,0,0,1,2
2495365,2495402,37,1,0,0,1
2495366,2495402,36,1,0,0,2
2495403,2495724,321,0,0,1,2
2495403,2495725,322,0,0,1,1
2495725,2495737,12,1,0,0,2
2495726,2495740,14,1,0,0,1
2495738,2497053,1315,0,0,1,2
2495741,2497052,1311,0,0,1,1
2497053,2497196,143,1,0,0,1
2497054,2497167,113,1,0,0,2
2497168,2497414,246,0,0,1,2
2497197,2497413,216,0,0,1,1
2497414,2497479,65,1,0,0,1
2497415,2497472,57,1,0,0,2
2497473,2497577,104,0,0,1,2
2497480,2497578,98,0,0,1,1
2497578,2497623,45,1,0,0,2
2497579,2497617,38,1,0,0,1
2497618,2497818,200,0,0,1,1
2497624,2497817,193,0,0,1,2
2497818,2497849,31,1,0,0,2
2497819,2497848,29,1,0,0,1
2497849,2498341,492,0,0,1,1
2497850,2498342,492,0,0,1,2
2498342,2498362,20,1,0,0,1
2498343,2498363,20,1,0,0,2
2498363,2498523,160,0,0,1,1
2498364,2498523,159,0,0,1,2
2498524,2498547,23,1,0,0,1
2498524,2498548,24,1,0,0,2
2498548,2498808,260,0,0,1,1
2498549,2498804,255,0,0,1,2
2498805,2498829,24,1,0,0,2
2498809,2498830,21,1,0,0,1
2498830,2498983,153,0,0,1,2
2498831,2498983,152,0,0,1,1
2498984,2498992,8,1,0,0,1
2498984,2499005,21,1,0,0,2
2498993,2499072,79,0,0,1,1
2499006,2499058,52,0,0,1,2
2499059,2499319,260,1,0,0,2
2499073,2499108,35,1,0,0,1
2499109,2499159,50,0,0,1,1
2499160,2499333,173,1,0,0,1
2499320,2499581,261,0,0,1,2
2499334,2499581,247,0,0,1,1
2499582,2499689,107,1,0,0,1
2499582,2499694,112,1,0,0,2
2499690,2499774,84,0,0,1,1
2499695,2499775,80,0,0,1,2
2499775,2499830,55,1,0,0,1
2499776,2499830,54,1,0,0,2
2499831,2499950,119,0,0,1,1
2499831,2499950,119,0,0,1,2
2499951,2499974,23,1,0,0,2
2499951,2500023,72,1,0,0,1
2499975,2500204,229,0,0,1,2
2500024,2500202,178,0,0,1,1
2500203,2500238,35,1,0,0,1
2500205,2500228,23,1,0,0,2
2500229,2500360,131,0,0,1,2
2500239,2500358,119,0,0,1,1
2500359,2500419,60,1,0,0,1
2500361,2500389,28,1,0,0,2
2500390,2500587,197,0,0,1,2
2500420,2500596,176,0,0,1,1
2500588,2500603,15,1,0,0,2
2500597,2500609,12,1,0,0,1
2500604,2500791,187,0,0,1,2
2500610,2500788,178,0,0,1,1
2500789,2500833,44,1,0,0,1
2500792,2500809,17,1,0,0,2
2500810,2501010,200,0,0,1,2
2500834,2501003,169,0,0,1,1
2501004,2501027,23,1,0,0,1
2501011,2501027,16,1,0,0,2
2501028,2501112,84,0,0,1,1
2501028,2501179,151,0,0,1,2
2501113,2501123,10,1,0,0,1
2501124,2501176,52,0,0,1,1
2501177,2501527,350,1,0,0,1
2501180,2501529,349,1,0,0,2
2501218,2501473,255,0,1,0,1
2501246,2501426,180,0,1,0,2
2501528,2501646,118,0,0,1,1
2501530,2501650,120,0,0,1,2
2501647,2501702,55,1,0,0,1
2501651,2501700,49,1,0,0,2
2501701,2501876,175,0,0,1,2
2501703,2501776,73,0,0,1,1
2501777,2501790,13,1,0,0,1
2501791,2501879,88,0,0,1,1
2501877,2501900,23,1,0,0,2
2501880,2501900,20,1,0,0,1
2501901,2501995,94,0,0,1,1
2501901,2501997,96,0,0,1,2
2501996,2502013,17,1,0,0,1
2501998,2502016,18,1,0,0,2
2502014,2502137,123,0,0,1,1
2502017,2502137,120,0,0,1,2
2502138,2502159,21,1,0,0,1
2502138,2502161,23,1,0,0,2
2502160,2502304,144,0,0,1,1
2502162,2502302,140,0,0,1,2
2502303,2502325,22,1,0,0,2
2502305,2502325,20,1,0,0,1
2502326,2502856,530,0,0,1,1
2502326,2502856,530,0,0,1,2
2502857,2502865,8,1,0,0,1
2502857,2502873,16,1,0,0,2
2502866,2503327,461,0,0,1,1
2502874,2503323,449,0,0,1,2
2503324,2503342,18,1,0,0,2
2503328,2503344,16,1,0,0,1
2503343,2503531,188,0,0,1,2
2503345,2503548,203,0,0,1,1
2503532,2503568,36,1,0,0,2
2503549,2503572,23,1,0,0,1
2503569,2503613,44,0,0,1,2
2503573,2503609,36,0,0,1,1
2503610,2503641,31,1,0,0,1
2503614,2503641,27,1,0,0,2
2503642,2503752,110,0,0,1,2
2503642,2503753,111,0,0,1,1
2503753,2503765,12,1,0,0,2
2503754,2503766,12,1,0,0,1
2503766,2503954,188,0,0,1,2
2503767,2503956,189,0,0,1,1
2503955,2504046,91,1,0,0,2
2503957,2504051,94,1,0,0,1
2504047,2504113,66,0,0,1,2
2504052,2504116,64,0,0,1,1
2504114,2504153,39,1,0,0,2
2504117,2504148,31,1,0,0,1
2504149,2504206,57,0,0,1,1
2504154,2504206,52,0,0,1,2
2504207,2504241,34,1,0,0,1
2504207,2504241,34,1,0,0,2
2504242,2504397,155,0,0,1,1
2504242,2504397,155,0,0,1,2
2504398,2504424,26,1,0,0,2
2504398,2504426,28,1,0,0,1
2504425,2504511,86,0,0,1,2
2504427,2504511,84,0,0,1,1
2504512,2504535,23,1,0,0,1
2504512,2504537,25,1,0,0,2
2504536,2504924,388,0,0,1,1
2504538,2504918,380,0,0,1,2
2504919,2504934,15,1,0,0,2
2504925,2504931,6,1,0,0,1
2504932,2505088,156,0,0,1,1
2504935,2505087,152,0,0,1,2
2505088,2505097,9,1,0,0,2
2505089,2505095,6,1,0,0,1
2505096,2505301,205,0,0,1,1
2505098,2505462,364,0,0,1,2
2505302,2505322,20,1,0,0,1
2505323,2505451,128,0,0,1,1
2505452,2505467,15,1,0,0,1
2505463,2505584,121,1,0,0,2
2505468,2505494,26,0,0,1,1
2505495,2505545,50,1,0,0,1
2505546,2505648,102,0,0,1,1
2505585,2505645,60,0,0,1,2
2505646,2505660,14,1,0,0,2
2505649,2505659,10,1,0,0,1
2505660,2506278,618,0,0,1,1
2505661,2505939,278,0,0,1,2
2505940,2505947,7,1,0,0,2
2505948,2506315,367,0,0,1,2
2506279,2506285,6,1,0,0,1
2506286,2506327,41,0,0,1,1
2506316,2507926,1610,1,0,0,2
2506328,2507936,1608,1,0,0,1
2506397,2506435,38,0,1,0,1
2506475,2507921,1446,0,1,0,1
2506883,2507883,1000,0,1,0,2
2507927,2508304,377,0,0,1,2
2507937,2508304,367,0,0,1,1
2508305,2508317,12,1,0,0,1
2508305,2508321,16,1,0,0,2
2508318,2508485,167,0,0,1,1
2508322,2508486,164,0,0,1,2
2508486,2508747,261,1,0,0,1
2508487,2508758,271,1,0,0,2
2508542,2508660,118,0,1,0,1
2508543,2508645,102,0,1,0,2
2508748,2508938,190,0,0,1,1
2508759,2508939,180,0,0,1,2
2508939,2509034,95,1,0,0,1
2508940,2509043,103,1,0,0,2
2509035,2509224,189,0,0,1,1
2509044,2509223,179,0,0,1,2
2509224,2509269,45,1,0,0,2
2509225,2509268,43,1,0,0,1
2509269,2509487,218,0,0,1,1
2509270,2509488,218,0,0,1,2
2509488,2509523,35,1,0,0,1
2509489,2509523,34,1,0,0,2
2509524,2510350,826,0,0,1,1
2509524,2510351,827,0,0,1,2
2510351,2510494,143,1,0,0,1
2510352,2510483,131,1,0,0,2
2510484,2510992,508,0,0,1,2
2510495,2510991,496,0,0,1,1
2510992,2511076,84,1,0,0,1
2510993,2511075,82,1,0,0,2
2511076,2511134,58,0,0,1,2
2511077,2511132,55,0,0,1,1
2511133,2511165,32,1,0,0,1
2511135,2511160,25,1,0,0,2
2511161,2512305,1144,0,0,1,2
2511166,2511701,535,0,0,1,1
2511702,2511719,17,1,0,0,1
2511720,2512171,451,0,0,1,1
2512172,2512224,52,1,0,0,1
2512225,2512265,40,0,0,1,1
2512266,2512526,260,1,0,0,1
2512278,2512413,135,0,1,0,1
2512306,2512494,188,1,0,0,2
2512495,2512886,391,0,0,1,2
2512527,2512886,359,0,0,1,1
2512887,2512928,41,1,0,0,2
2512887,2512936,49,1,0,0,1
2512929,2513558,629,0,0,1,2
2512937,2513559,622,0,0,1,1
2513559,2513579,20,1,0,0,2
2513560,2513580,20,1,0,0,1
2513580,2514245,665,0,0,1,2
2513581,2514245,664,0,0,1,1
2514246,2514340,94,1,0,0,2
2514246,2514362,116,1,0,0,1
2514341,2514459,118,0,0,1,2
2514363,2514458,95,0,0,1,1
2514459,2514475,16,1,0,0,1
2514460,2514471,11,1,0,0,2
2514472,2514714,242,0,0,1,2
2514476,2514714,238,0,0,1,1
2514715,2514815,100,1,0,0,2
2514715,2514817,102,1,0,0,1
2514816,2514926,110,0,0,1,2
2514818,2514927,109,0,0,1,1
2514927,2514977,50,1,0,0,2
2514928,2514977,49,1,0,0,1
2514978,2515153,175,0,0,1,2
2514978,2515155,177,0,0,1,1
2515154,2515185,31,1,0,0,2
2515156,2515175,19,1,0,0,1
2515176,2515350,174,0,0,1,1
2515186,2515350,164,0,0,1,2
2515351,2515386,35,1,0,0,1
2515351,2515428,77,1,0,0,2
2515387,2515527,140,0,0,1,1
2515429,2515509,80,0,0,1,2
2515510,2515711,201,1,0,0,2
2515528,2515544,16,1,0,0,1
2515545,2515809,264,0,0,1,1
2515712,2515732,20,0,0,1,2
2515733,2516188,455,1,0,0,2
2515810,2515831,21,1,0,0,1
2515832,2515953,121,0,0,1,1
2515954,2516174,220,1,0,0,1
2516175,2516401,226,0,0,1,1
2516189,2516382,193,0,0,1,2
2516383,2516406,23,1,0,0,2
2516402,2516409,7,1,0,0,1
2516407,2516533,126,0,0,1,2
2516410,2516531,121,0,0,1,1
2516532,2516550,18,1,0,0,1
2516534,2516592,58,1,0,0,2
2516551,2516576,25,0,0,1,1
2516577,2516591,14,1,0,0,1
2516592,2516711,119,0,0,1,1
2516593,2516708,115,0,0,1,2
2516709,2516729,20,1,0,0,2
2516712,2516726,14,1,0,0,1
2516727,2516881,154,0,0,1,1
2516730,2516879,149,0,0,1,2
2516880,2516903,23,1,0,0,2
2516882,2516911,29,1,0,0,1
2516904,2517284,380,0,0,1,2
2516912,2517283,371,0,0,1,1
2517284,2517302,18,1,0,0,1
2517285,2517300,15,1,0,0,2
2517301,2517525,224,0,0,1,2
2517303,2517528,225,0,0,1,1
2517526,2517541,15,1,0,0,2
2517529,2517540,11,1,0,0,1
2517541,2518196,655,0,0,1,1
2517542,2518506,964,0,0,1,2
2518197,2518203,6,1,0,0,1
2518204,2518508,304,0,0,1,1
2518507,2518642,135,1,0,0,2
2518509,2518668,159,1,0,0,1
2518643,2518762,119,0,0,1,2
2518669,2518762,93,0,0,1,1
2518763,2518797,34,1,0,0,2
2518763,2518801,38,1,0,0,1
2518798,2518987,189,0,0,1,2
2518802,2518982,180,0,0,1,1
2518983,2519262,279,1,0,0,1
2518988,2519012,24,1,0,0,2
2519013,2519105,92,0,0,1,2
2519106,2519122,16,1,0,0,2
2519123,2519336,213,0,0,1,2
2519263,2519331,68,0,0,1,1
2519332,2520546,1214,1,0,0,1
2519337,2519355,18,1,0,0,2
2519356,2519417,61,0,0,1,2
2519418,2519722,304,1,0,0,2
2519442,2519676,234,0,1,0,1
2519458,2519577,119,0,1,0,2
2519701,2519722,21,0,1,0,1
2519723,2519810,87,0,0,1,2
2519811,2520119,308,1,0,0,2
2519821,2520085,264,0,1,0,1
2519845,2520026,181,0,1,0,2
2520120,2520316,196,0,0,1,2
2520317,2520489,172,1,0,0,2
2520490,2521051,561,0,0,1,2
2520547,2521052,505,0,0,1,1
2521052,2521082,30,1,0,0,2
2521053,2521079,26,1,0,0,1
2521080,2521358,278,0,0,1,1
2521083,2521343,260,0,0,1,2
2521344,2521836,492,1,0,0,2
2521359,2521802,443,1,0,0,1
2521386,2521642,256,0,1,0,1
2521387,2521607,220,0,1,0,2
2521803,2522144,341,0,0,1,1
2521837,2522137,300,0,0,1,2
2522138,2522464,326,1,0,0,2
2522145,2522440,295,1,0,0,1
2522172,2522361,189,0,1,0,1
2522176,2522327,151,0,1,0,2
2522441,2522572,131,0,0,1,1
2522465,2522572,107,0,0,1,2
2522573,2522587,14,1,0,0,1
2522573,2522587,14,1,0,0,2
2522588,2522878,290,0,0,1,1
2522588,2522880,292,0,0,1,2
2522879,2523220,341,1,0,0,1
2522881,2523191,310,1,0,0,2
2522918,2523137,219,0,1,0,1
2522932,2523091,159,0,1,0,2
2523192,2523335,143,0,0,1,2
2523221,2523335,114,0,0,1,1
2523336,2523416,80,1,0,0,2
2523336,2523420,84,1,0,0,1
2523417,2523963,546,0,0,1,2
2523421,2523962,541,0,0,1,1
2523963,2523995,32,1,0,0,1
2523964,2523991,27,1,0,0,2
2523992,2524879,887,0,0,1,2
2523996,2524879,883,0,0,1,1
2524880,2524927,47,1,0,0,1
2524880,2524927,47,1,0,0,2
2524928,2525220,292,0,0,1,2
2524928,2525221,293,0,0,1,1
2525221,2525282,61,1,0,0,2
2525222,2525292,70,1,0,0,1
2525283,2526158,875,0,0,1,2
2525293,2526161,868,0,0,1,1
2526159,2526174,15,1,0,0,2
2526162,2526172,10,1,0,0,1
2526173,2526734,561,0,0,1,1
2526175,2526734,559,0,0,1,2
2526735,2526813,78,1,0,0,1
2526735,2526813,78,1,0,0,2
2526814,2527177,363,0,0,1,2
2526814,2527178,364,0,0,1,1
2527178,2527248,70,1,0,0,2
2527179,2527233,54,1,0,0,1
2527234,2527336,102,0,0,1,1
2527249,2527337,88,0,0,1,2
2527337,2527372,35,1,0,0,1
2527338,2527371,33,1,0,0,2
2527372,2528748,1376,0,0,1,2
2527373,2528748,1375,0,0,1,1
2528749,2528835,86,1,0,0,1
2528749,2528835,86,1,0,0,2
2528836,2529174,338,0,0,1,1
2528836,2529174,338,0,0,1,2
2529175,2529253,78,1,0,0,2
2529175,2529255,80,1,0,0,1
2529254,2529410,156,0,0,1,2
2529256,2529406,150,0,0,1,1
2529407,2529432,25,1,0,0,1
2529411,2529434,23,1,0,0,2
2529433,2530573,1140,0,0,1,1
2529435,2530573,1138,0,0,1,2
2530574,2530628,54,1,0,0,2
2530574,2530629,55,1,0,0,1
2530629,2530804,175,0,0,1,2
2530630,2530803,173,0,0,1,1
2530804,2530865,61,1,0,0,1
2530805,2530859,54,1,0,0,2
2530860,2531060,200,0,0,1,2
2530866,2531060,194,0,0,1,1
2531061,2531118,57,1,0,0,2
2531061,2531120,59,1,0,0,1
2531119,2531226,107,0,0,1,2
2531121,2531226,105,0,0,1,1
2531227,2531288,61,1,0,0,1
2531227,2531291,64,1,0,0,2
2531289,2531457,168,0,0,1,1
2531292,2531459,167,0,0,1,2
2531458,2531490,32,1,0,0,1
2531460,2531490,30,1,0,0,2
2531491,2532657,1166,0,0,1,1
2531491,2532657,1166,0,0,1,2
2532658,2532756,98,1,0,0,2
2532658,2532757,99,1,0,0,1
2532757,2533135,378,0,0,1,2
2532758,2533135,377,0,0,1,1
2533136,2533219,83,1,0,0,2
2533136,2533222,86,1,0,0,1
2533220,2533309,89,0,0,1,2
2533223,2533310,87,0,0,1,1
2533310,2533346,36,1,0,0,2
2533311,2533345,34,1,0,0,1
2533346,2534362,1016,0,0,1,1
2533347,2534363,1016,0,0,1,2
2534363,2534387,24,1,0,0,1
2534364,2534387,23,1,0,0,2
2534388,2534620,232,0,0,1,2
2534388,2534627,239,0,0,1,1
2534621,2534764,143,1,0,0,2
2534628,2534748,120,1,0,0,1
2534749,2535097,348,0,0,1,1
2534765,2535097,332,0,0,1,2
2535098,2535153,55,1,0,0,1
2535098,2535156,58,1,0,0,2
2535154,2535319,165,0,0,1,1
2535157,2535319,162,0,0,1,2
2535320,2535350,30,1,0,0,1
2535320,2535350,30,1,0,0,2
2535351,2536109,758,0,0,1,1
2535351,2536109,758,0,0,1,2
2536110,2536203,93,1,0,0,2
2536110,2536263,153,1,0,0,1
2536204,2536690,486,0,0,1,2
2536264,2536963,699,0,0,1,1
2536691,2536697,6,1,0,0,2
2536698,2536962,264,0,0,1,2
2536963,2536989,26,1,0,0,2
2536964,2536990,26,1,0,0,1
2536990,2537593,603,0,0,1,2
2536991,2537590,599,0,0,1,1
2537591,2537614,23,1,0,0,1
2537594,2537615,21,1,0,0,2
2537615,2538287,672,0,0,1,1
2537616,2538288,672,0,0,1,2
2538288,2538321,33,1,0,0,1
2538289,2538325,36,1,0,0,2
2538322,2538390,68,0,0,1,1
2538326,2538389,63,0,0,1,2
2538390,2538416,26,1,0,0,2
2538391,2538416,25,1,0,0,1
2538417,2538744,327,0,0,1,2
2538417,2538745,328,0,0,1,1
2538745,2538815,70,1,0,0,2
2538746,2538809,63,1,0,0,1
2538810,2538888,78,0,0,1,1
2538816,2538888,72,0,0,1,2
2538889,2538927,38,1,0,0,2
2538889,2538929,40,1,0,0,1
2538928,2539448,520,0,0,1,2
2538930,2539447,517,0,0,1,1
2539448,2539467,19,1,0,0,1
2539449,2539467,18,1,0,0,2
2539468,2540007,539,0,0,1,2
2539468,2540012,544,0,0,1,1
2540008,2540027,19,1,0,0,2
2540013,2540024,11,1,0,0,1
2540025,2540242,217,0,0,1,1
2540028,2540245,217,0,0,1,2
2540243,2540420,177,1,0,0,1
2540246,2540292,46,1,0,0,2
2540293,2540315,22,0,0,1,2
2540316,2540418,102,1,0,0,2
2540419,2540455,36,0,0,1,2
2540421,2540456,35,0,0,1,1
2540456,2540463,7,1,0,0,2
2540457,2540462,5,1,0,0,1
2540463,2540664,201,0,0,1,1
2540464,2540664,200,0,0,1,2
2540665,2540729,64,1,0,0,1
2540665,2540740,75,1,0,0,2
2540730,2540839,109,0,0,1,1
2540741,2540836,95,0,0,1,2
2540837,2540864,27,1,0,0,2
2540840,2540863,23,1,0,0,1
2540864,2541094,230,0,0,1,1
2540865,2541094,229,0,0,1,2
2541095,2541108,13,1,0,0,1
2541095,2541108,13,1,0,0,2
2541109,2541317,208,0,0,1,2
2541109,2541318,209,0,0,1,1
2541318,2541341,23,1,0,0,2
2541319,2541352,33,1,0,0,1
2541342,2542197,855,0,0,1,2
2541353,2542201,848,0,0,1,1
2542198,2542296,98,1,0,0,2
2542202,2542289,87,1,0,0,1
2542290,2542628,338,0,0,1,1
2542297,2542628,331,0,0,1,2
2542629,2542705,76,1,0,0,2
2542629,2542721,92,1,0,0,1
2542706,2542853,147,0,0,1,2
2542722,2542855,133,0,0,1,1
2542854,2542879,25,1,0,0,2
2542856,2542889,33,1,0,0,1
2542880,2543210,330,0,0,1,2
2542890,2543210,320,0,0,1,1
2543211,2543233,22,1,0,0,2
2543211,2543234,23,1,0,0,1
2543234,2543383,149,0,0,1,2
2543235,2543378,143,0,0,1,1
2543379,2543398,19,1,0,0,1
2543384,2543397,13,1,0,0,2
2543398,2543941,543,0,0,1,2
2543399,2543947,548,0,0,1,1
2543942,2544067,125,1,0,0,2
2543948,2543970,22,1,0,0,1
2543971,2544037,66,0,0,1,1
2544038,2544107,69,1,0,0,1
2544068,2544566,498,0,0,1,2
2544108,2544270,162,0,0,1,1
2544271,2544275,4,1,0,0,1
2544276,2544567,291,0,0,1,1
2544567,2544637,70,1,0,0,2
2544568,2544627,59,1,0,0,1
2544628,2544758,130,0,0,1,1
2544638,2544757,119,0,0,1,2
2544758,2544781,23,1,0,0,2
2544759,2544781,22,1,0,0,1
2544782,2545008,226,0,0,1,1
2544782,2545013,231,0,0,1,2
2545009,2545030,21,1,0,0,1
2545014,2545029,15,1,0,0,2
2545030,2545146,116,0,0,1,2
2545031,2545144,113,0,0,1,1
2545145,2545163,18,1,0,0,1
2545147,2545161,14,1,0,0,2
2545162,2545656,494,0,0,1,2
2545164,2545656,492,0,0,1,1
2545657,2545759,102,1,0,0,1
2545657,2545785,128,1,0,0,2
2545760,2545801,41,0,0,1,1
2545786,2545831,45,0,0,1,2
2545802,2545807,5,1,0,0,1
2545808,2545829,21,0,0,1,1
2545830,2545839,9,1,0,0,1
2545832,2545836,4,1,0,0,2
2545837,2546015,178,0,0,1,2
2545840,2546025,185,0,0,1,1
2546016,2546035,19,1,0,0,2
2546026,2546037,11,1,0,0,1
2546036,2546281,245,0,0,1,2
2546038,2546262,224,0,0,1,1
2546263,2546567,304,1,0,0,1
2546282,2546535,253,1,0,0,2
2546297,2546505,208,0,1,0,1
2546312,2546449,137,0,1,0,2
2546536,2546634,98,0,0,1,2
2546568,2546592,24,0,0,1,1
2546593,2546738,145,1,0,0,1
2546635,2546704,69,1,0,0,2
2546705,2546788,83,0,0,1,2
2546739,2546788,49,0,0,1,1
2546789,2546811,22,1,0,0,2
2546789,2546813,24,1,0,0,1
2546812,2547368,556,0,0,1,2
2546814,2546834,20,0,0,1,1
2546835,2546861,26,1,0,0,1
2546862,2546927,65,0,0,1,1
2546928,2547036,108,1,0,0,1
2547037,2547158,121,0,0,1,1
2547159,2547210,51,1,0,0,1
2547211,2547366,155,0,0,1,1
2547367,2547373,6,1,0,0,1
2547369,2547381,12,1,0,0,2
2547374,2547521,147,0,0,1,1
2547382,2547525,143,0,0,1,2
2547522,2547540,18,1,0,0,1
2547526,2547542,16,1,0,0,2
2547541,2547727,186,0,0,1,1
2547543,2547727,184,0,0,1,2
2547728,2547839,111,1,0,0,1
2547728,2547847,119,1,0,0,2
2547840,2547953,113,0,0,1,1
2547848,2548310,462,0,0,1,2
2547954,2547967,13,1,0,0,1
2547968,2548211,243,0,0,1,1
2548212,2548219,7,1,0,0,1
2548220,2548309,89,0,0,1,1
2548310,2548338,28,1,0,0,1
2548311,2548332,21,1,0,0,2
2548333,2548498,165,0,0,1,2
2548339,2548507,168,0,0,1,1
2548499,2550171,1672,1,0,0,2
2548508,2550198,1690,1,0,0,1
2548530,2550124,1594,0,1,0,1
2548532,2550124,1592,0,1,0,2
2550172,2550514,342,0,0,1,2
2550199,2550254,55,0,0,1,1
2550255,2550266,11,1,0,0,1
2550267,2550515,248,0,0,1,1
2550515,2550599,84,1,0,0,2
2550516,2550599,83,1,0,0,1
2550600,2550727,127,0,0,1,1
2550600,2550727,127,0,0,1,2
2550728,2550788,60,1,0,0,1
2550728,2550790,62,1,0,0,2
2550789,2550905,116,0,0,1,1
2550791,2550905,114,0,0,1,2
2550906,2550937,31,1,0,0,1
2550906,2550941,35,1,0,0,2
2550938,2551234,296,0,0,1,1
2550942,2551239,297,0,0,1,2
2551235,2551257,22,1,0,0,1
2551240,2551255,15,1,0,0,2
2551256,2551434,178,0,0,1,2
2551258,2551437,179,0,0,1,1
2551435,2551456,21,1,0,0,2
2551438,2551458,20,1,0,0,1
2551457,2551496,39,0,0,1,2
2551459,2551496,37,0,0,1,1
2551497,2551510,13,1,0,0,1
2551497,2551510,13,1,0,0,2
2551511,2551703,192,0,0,1,1
2551511,2551705,194,0,0,1,2
2551704,2552004,300,1,0,0,1
2551706,2551972,266,1,0,0,2
2551766,2551892,126,0,1,0,1
2551775,2551860,85,0,1,0,2
2551973,2552234,261,0,0,1,2
2552005,2552055,50,0,0,1,1
2552056,2552260,204,1,0,0,1
2552235,2552239,4,1,0,0,2
2552240,2552363,123,0,0,1,2
2552261,2552359,98,0,0,1,1
2552360,2552375,15,1,0,0,1
2552364,2552374,10,1,0,0,2
2552375,2552651,276,0,0,1,2
2552376,2552651,275,0,0,1,1
2552652,2552684,32,1,0,0,1
2552652,2552684,32,1,0,0,2
2552685,2552838,153,0,0,1,1
2552685,2552843,158,0,0,1,2
2552839,2552865,26,1,0,0,1
2552844,2552863,19,1,0,0,2
2552864,2554352,1488,0,0,1,2
2552866,2553232,366,0,0,1,1
2553233,2553240,7,1,0,0,1
2553241,2553449,208,0,0,1,1
2553450,2553462,12,1,0,0,1
2553463,2553534,71,0,0,1,1
2553535,2553541,6,1,0,0,1
2553542,2553623,81,0,0,1,1
2553624,2553637,13,1,0,0,1
2553638,2554353,715,0,0,1,1
2554353,2554418,65,1,0,0,2
2554354,2554418,64,1,0,0,1
2554419,2554742,323,0,0,1,1
2554419,2554742,323,0,0,1,2
2554743,2554830,87,1,0,0,1
2554743,2554833,90,1,0,0,2
2554831,2554914,83,0,0,1,1
2554834,2554913,79,0,0,1,2
2554914,2554949,35,1,0,0,2
2554915,2554950,35,1,0,0,1
2554950,2556092,1142,0,0,1,2
2554951,2556092,1141,0,0,1,1
2556093,2556295,202,1,0,0,1
2556093,2556317,224,1,0,0,2
2556296,2556351,55,0,0,1,1
2556318,2556713,395,0,0,1,2
2556352,2556359,7,1,0,0,1
2556360,2556713,353,0,0,1,1
2556714,2556774,60,1,0,0,2
2556714,2556783,69,1,0,0,1
2556775,2556896,121,0,0,1,2
2556784,2556898,114,0,0,1,1
2556897,2556919,22,1,0,0,2
2556899,2556920,21,1,0,0,1
2556920,2557577,657,0,0,1,2
2556921,2557547,626,0,0,1,1
2557548,2557620,72,1,0,0,1
2557578,2557612,34,1,0,0,2
2557613,2558031,418,0,0,1,2
2557621,2558033,412,0,0,1,1
2558032,2558078,46,1,0,0,2
2558034,2558082,48,1,0,0,1
2558079,2558477,398,0,0,1,2
2558083,2558477,394,0,0,1,1
2558478,2558510,32,1,0,0,1
2558478,2558511,33,1,0,0,2
2558511,2558606,95,0,0,1,1
2558512,2558604,92,0,0,1,2
2558605,2558671,66,1,0,0,2
2558607,2558679,72,1,0,0,1
2558672,2558771,99,0,0,1,2
2558680,2558772,92,0,0,1,1
2558772,2558802,30,1,0,0,2
2558773,2558817,44,1,0,0,1
2558803,2558922,119,0,0,1,2
2558818,2558921,103,0,0,1,1
2558922,2558947,25,1,0,0,1
2558923,2558946,23,1,0,0,2
2558947,2559103,156,0,0,1,2
2558948,2559101,153,0,0,1,1
2559102,2559116,14,1,0,0,1
2559104,2559116,12,1,0,0,2
2559117,2559339,222,0,0,1,1
2559117,2559339,222,0,0,1,2
2559340,2559361,21,1,0,0,1
2559340,2559362,22,1,0,0,2
2559362,2559607,245,0,0,1,1
2559363,2559917,554,0,0,1,2
2559608,2559620,12,1,0,0,1
2559621,2559918,297,0,0,1,1
2559918,2559936,18,1,0,0,2
2559919,2559937,18,1,0,0,1
2559937,2560174,237,0,0,1,2
2559938,2560173,235,0,0,1,1
2560174,2560434,260,1,0,0,1
2560175,2560401,226,1,0,0,2
2560402,2560426,24,0,0,1,2
2560427,2560434,7,1,0,0,2
2560435,2560495,60,0,0,1,1
2560435,2560495,60,0,0,1,2
2560496,2560531,35,1,0,0,2
2560496,2560534,38,1,0,0,1
2560532,2560795,263,0,0,1,2
2560535,2560796,261,0,0,1,1
2560796,2560902,106,1,0,0,2
2560797,2560906,109,1,0,0,1
2560903,2560964,61,0,0,1,2
2560907,2560962,55,0,0,1,1
2560963,2560980,17,1,0,0,1
2560965,2560974,9,1,0,0,2
2560975,2561154,179,0,0,1,2
2560981,2561152,171,0,0,1,1
2561153,2561175,22,1,0,0,1
2561155,2561174,19,1,0,0,2
2561175,2561341,166,0,0,1,2
2561176,2561344,168,0,0,1,1
2561342,2561356,14,1,0,0,2
2561345,2561356,11,1,0,0,1
2561357,2561696,339,0,0,1,1
2561357,2561700,343,0,0,1,2
2561697,2561716,19,1,0,0,1
2561701,2561717,16,1,0,0,2
2561717,2561931,214,0,0,1,1
2561718,2561931,213,0,0,1,2
2561932,2561949,17,1,0,0,2
2561932,2562057,125,1,0,0,1
2561950,2561972,22,0,0,1,2
2561973,2562056,83,1,0,0,2
2562057,2562505,448,0,0,1,2
2562058,2562149,91,0,0,1,1
2562150,2562157,7,1,0,0,1
2562158,2562505,347,0,0,1,1
2562506,2562548,42,1,0,0,2
2562506,2562553,47,1,0,0,1
2562549,2562932,383,0,0,1,2
2562554,2562932,378,0,0,1,1
2562933,2562992,59,1,0,0,1
2562933,2562992,59,1,0,0,2
2562993,2563084,91,0,0,1,2
2562993,2563085,92,0,0,1,1
2563085,2563125,40,1,0,0,2
2563086,2563139,53,1,0,0,1
2563126,2563316,190,0,0,1,2
2563140,2563314,174,0,0,1,1
2563315,2563338,23,1,0,0,1
2563317,2563336,19,1,0,0,2
2563337,2564016,679,0,0,1,2
2563339,2563542,203,0,0,1,1
2563543,2563553,10,1,0,0,1
2563554,2564016,462,0,0,1,1
2564017,2564047,30,1,0,0,2
2564017,2564185,168,1,0,0,1
2564048,2564073,25,0,0,1,2
2564074,2564141,67,1,0,0,2
2564142,2564421,279,0,0,1,2
2564186,2564389,203,0,0,1,1
2564390,2564836,446,1,0,0,1
2564422,2564648,226,1,0,0,2
2564442,2564573,131,0,1,0,1
2564484,2564486,2,0,1,0,2
2564649,2564675,26,0,0,1,2
2564676,2564681,5,1,0,0,2
2564682,2564713,31,0,0,1,2
2564714,2564723,9,1,0,0,2
2564724,2564942,218,0,0,1,2
2564837,2564912,75,0,0,1,1
2564913,2565069,156,1,0,0,1
2564943,2565072,129,1,0,0,2
2565070,2565178,108,0,0,1,1
2565073,2565176,103,0,0,1,2
2565177,2565242,65,1,0,0,2
2565179,2565229,50,1,0,0,1
2565230,2565367,137,0,0,1,1
2565243,2565368,125,0,0,1,2
2565368,2565402,34,1,0,0,1
2565369,2565399,30,1,0,0,2
2565400,2566091,691,0,0,1,2
2565403,2566071,668,0,0,1,1
2566072,2566279,207,1,0,0,1
2566092,2566323,231,1,0,0,2
2566141,2566189,48,0,1,0,1
2566145,2566186,41,0,1,0,2
2566280,2566492,212,0,0,1,1
2566324,2566492,168,0,0,1,2
2566493,2566592,99,1,0,0,2
2566493,2566595,102,1,0,0,1
2566593,2566759,166,0,0,1,2
2566596,2566758,162,0,0,1,1
2566759,2566855,96,1,0,0,1
2566760,2566848,88,1,0,0,2
2566849,2566967,118,0,0,1,2
2566856,2566968,112,0,0,1,1
2566968,2567016,48,1,0,0,2
2566969,2567067,98,1,0,0,1
2567017,2567358,341,0,0,1,2
2567068,2567168,100,0,0,1,1
2567169,2567206,37,1,0,0,1
2567207,2567278,71,0,0,1,1
2567279,2567387,108,1,0,0,1
2567359,2567377,18,1,0,0,2
2567378,2568215,837,0,0,1,2
2567388,2567515,127,0,0,1,1
2567516,2567641,125,1,0,0,1
2567642,2567669,27,0,0,1,1
2567670,2567699,29,1,0,0,1
2567700,2567759,59,0,0,1,1
2567760,2567836,76,1,0,0,1
2567837,2567892,55,0,0,1,1
2567893,2568104,211,1,0,0,1
2568105,2568211,106,0,0,1,1
2568212,2568324,112,1,0,0,1
2568216,2568325,109,1,0,0,2
2568325,2568643,318,0,0,1,1
2568326,2568643,317,0,0,1,2
2568644,2568704,60,1,0,0,2
2568644,2568719,75,1,0,0,1
2568705,2568826,121,0,0,1,2
2568720,2568828,108,0,0,1,1
2568827,2568848,21,1,0,0,2
2568829,2568858,29,1,0,0,1
2568849,2570104,1255,0,0,1,2
2568859,2570104,1245,0,0,1,1
2570105,2570196,91,1,0,0,2
2570105,2570197,92,1,0,0,1
2570197,2570557,360,0,0,1,2
2570198,2570558,360,0,0,1,1
2570558,2570638,80,1,0,0,2
2570559,2570650,91,1,0,0,1
2570639,2570735,96,0,0,1,2
2570651,2570735,84,0,0,1,1
2570736,2570768,32,1,0,0,2
2570736,2570770,34,1,0,0,1
2570769,2572122,1353,0,0,1,2
2570771,2572121,1350,0,0,1,1
2572122,2572251,129,1,0,0,1
2572123,2572252,129,1,0,0,2
2572252,2572557,305,0,0,1,1
2572253,2572557,304,0,0,1,2
2572558,2572616,58,1,0,0,2
2572558,2572617,59,1,0,0,1
2572617,2574131,1514,0,0,1,2
2572618,2574128,1510,0,0,1,1
2574129,2574199,70,1,0,0,1
2574132,2574200,68,1,0,0,2
2574200,2574357,157,0,0,1,1
2574201,2574359,158,0,0,1,2
2574358,2574417,59,1,0,0,1
2574360,2574416,56,1,0,0,2
2574417,2574552,135,0,0,1,2
2574418,2574551,133,0,0,1,1
2574552,2574694,142,1,0,0,1
2574553,2574629,76,1,0,0,2
2574630,2574791,161,0,0,1,2
2574695,2574794,99,0,0,1,1
2574792,2574809,17,1,0,0,2
2574795,2574812,17,1,0,0,1
2574810,2576047,1237,0,0,1,2
2574813,2574870,57,0,0,1,1
2574871,2574889,18,1,0,0,1
2574890,2575386,496,0,0,1,1
2575387,2575482,95,1,0,0,1
2575483,2575565,82,0,0,1,1
2575566,2575590,24,1,0,0,1
2575591,2575941,350,0,0,1,1
2575942,2575989,47,1,0,0,1
2575990,2576044,54,0,0,1,1
2576045,2576343,298,1,0,0,1
2576048,2576289,241,1,0,0,2
2576143,2576250,107,0,1,0,1
2576290,2576594,304,0,0,1,2
2576344,2576593,249,0,0,1,1
2576594,2576660,66,1,0,0,1
2576595,2576669,74,1,0,0,2
2576661,2576752,91,0,0,1,1
2576670,2576752,82,0,0,1,2
2576753,2576784,31,1,0,0,2
2576753,2576793,40,1,0,0,1
2576785,2576942,157,0,0,1,2
2576794,2576942,148,0,0,1,1
2576943,2576972,29,1,0,0,2
2576943,2576975,32,1,0,0,1
2576973,2578020,1047,0,0,1,2
2576976,2578019,1043,0,0,1,1
2578020,2578124,104,1,0,0,1
2578021,2578125,104,1,0,0,2
2578125,2578200,75,0,0,1,1
2578126,2578197,71,0,0,1,2
2578198,2578231,33,1,0,0,2
2578201,2578223,22,1,0,0,1
2578224,2578325,101,0,0,1,1
2578232,2578541,309,0,0,1,2
2578326,2578360,34,1,0,0,1
2578361,2578540,179,0,0,1,1
2578541,2578623,82,1,0,0,1
2578542,2578616,74,1,0,0,2
2578617,2578751,134,0,0,1,2
2578624,2578749,125,0,0,1,1
2578750,2578791,41,1,0,0,1
2578752,2578782,30,1,0,0,2
2578783,2579005,222,0,0,1,2
2578792,2579004,212,0,0,1,1
2579005,2579025,20,1,0,0,1
2579006,2579025,19,1,0,0,2
2579026,2579211,185,0,0,1,1
2579026,2579212,186,0,0,1,2
2579212,2579231,19,1,0,0,1
2579213,2579231,18,1,0,0,2
2579232,2579796,564,0,0,1,1
2579232,2579801,569,0,0,1,2
2579797,2579887,90,1,0,0,1
2579802,2579888,86,1,0,0,2
2579888,2579908,20,0,0,1,1
2579889,2580538,649,0,0,1,2
2579909,2579932,23,1,0,0,1
2579933,2580106,173,0,0,1,1
2580107,2580116,9,1,0,0,1
2580117,2580540,423,0,0,1,1
2580539,2580640,101,1,0,0,2
2580541,2580643,102,1,0,0,1
2580641,2580807,166,0,0,1,2
2580644,2580801,157,0,0,1,1
2580802,2580822,20,1,0,0,1
2580808,2580814,6,1,0,0,2
2580815,2581074,259,0,0,1,2
2580823,2581076,253,0,0,1,1
2581075,2581097,22,1,0,0,2
2581077,2581102,25,1,0,0,1
2581098,2581313,215,0,0,1,2
2581103,2581310,207,0,0,1,1
2581311,2581323,12,1,0,0,1
2581314,2581325,11,1,0,0,2
2581324,2581488,164,0,0,1,1
2581326,2581482,156,0,0,1,2
2581483,2581494,11,1,0,0,2
2581489,2581493,4,1,0,0,1
2581494,2582182,688,0,0,1,1
2581495,2582134,639,0,0,1,2
2582135,2582143,8,1,0,0,2
2582144,2582180,36,0,0,1,2
2582181,2582329,148,1,0,0,2
2582183,2582360,177,1,0,0,1
2582233,2582280,47,0,1,0,1
2582330,2582403,73,0,0,1,2
2582361,2582405,44,0,0,1,1
2582404,2582408,4,1,0,0,2
2582406,2582417,11,1,0,0,1
2582409,2582607,198,0,0,1,2
2582418,2582608,190,0,0,1,1
2582608,2582715,107,1,0,0,2
2582609,2582713,104,1,0,0,1
2582714,2582775,61,0,0,1,1
2582716,2582771,55,0,0,1,2
2582772,2582807,35,1,0,0,2
2582776,2582788,12,1,0,0,1
2582789,2582835,46,0,0,1,1
2582808,2582832,24,0,0,1,2
2582833,2582856,23,1,0,0,2
2582836,2582873,37,1,0,0,1
2582857,2582953,96,0,0,1,2
2582874,2582952,78,0,0,1,1
2582953,2582982,29,1,0,0,1
2582954,2582977,23,1,0,0,2
2582978,2583149,171,0,0,1,2
2582983,2583304,321,0,0,1,1
2583150,2583213,63,1,0,0,2
2583214,2583307,93,0,0,1,2
2583305,2583325,20,1,0,0,1
2583308,2583552,244,1,0,0,2
2583326,2583898,572,0,0,1,1
2583553,2583633,80,0,0,1,2
2583634,2584152,518,1,0,0,2
2583899,2584232,333,1,0,0,1
2583922,2584122,200,0,1,0,1
2583923,2584091,168,0,1,0,2
2584153,2584745,592,0,0,1,2
2584233,2584898,665,0,0,1,1
2584746,2584752,6,1,0,0,2
2584753,2585007,254,0,0,1,2
2584899,2584984,85,1,0,0,1
2584985,2585008,23,0,0,1,1
2585008,2585123,115,1,0,0,2
2585009,2585124,115,1,0,0,1
2585124,2585293,169,0,0,1,2
2585125,2585281,156,0,0,1,1
2585282,2585307,25,1,0,0,1
2585294,2585305,11,1,0,0,2
2585306,2585591,285,0,0,1,2
2585308,2585384,76,0,0,1,1
2585385,2585401,16,1,0,0,1
2585402,2585585,183,0,0,1,1
2585586,2585600,14,1,0,0,1
2585592,2585600,8,1,0,0,2
2585601,2586178,577,0,0,1,1
2585601,2586364,763,0,0,1,2
2586179,2586184,5,1,0,0,1
2586185,2586365,180,0,0,1,1
2586365,2586389,24,1,0,0,2
2586366,2586391,25,1,0,0,1
2586390,2586630,240,0,0,1,2
2586392,2586622,230,0,0,1,1
2586623,2586642,19,1,0,0,1
2586631,2586642,11,1,0,0,2
2586643,2586814,171,0,0,1,1
2586643,2586817,174,0,0,1,2
2586815,2586894,79,1,0,0,1
2586818,2586874,56,1,0,0,2
2586875,2586962,87,0,0,1,2
2586895,2586958,63,0,0,1,1
2586959,2586966,7,1,0,0,1
2586963,2586983,20,1,0,0,2
2586967,2587069,102,0,0,1,1
2586984,2587071,87,0,0,1,2
2587070,2587097,27,1,0,0,1
2587072,2587091,19,1,0,0,2
2587092,2587325,233,0,0,1,2
2587098,2587525,427,0,0,1,1
2587326,2587331,5,1,0,0,2
2587332,2587526,194,0,0,1,2
2587526,2587607,81,1,0,0,1
2587527,2587593,66,1,0,0,2
2587594,2587832,238,0,0,1,2
2587608,2587831,223,0,0,1,1
2587832,2587868,36,1,0,0,1
2587833,2587867,34,1,0,0,2
2587868,2588032,164,0,0,1,2
2587869,2588030,161,0,0,1,1
2588031,2588055,24,1,0,0,1
2588033,2588055,22,1,0,0,2
2588056,2588306,250,0,0,1,1
2588056,2588309,253,0,0,1,2
2588307,2588325,18,1,0,0,1
2588310,2588321,11,1,0,0,2
2588322,2588481,159,0,0,1,2
2588326,2588479,153,0,0,1,1
2588480,2588497,17,1,0,0,1
2588482,2588497,15,1,0,0,2
2588498,2588581,83,0,0,1,2
2588498,2588583,85,0,0,1,1
2588582,2588590,8,1,0,0,2
2588584,2588596,12,1,0,0,1
2588591,2589141,550,0,0,1,2
2588597,2589035,438,0,0,1,1
2589036,2589040,4,1,0,0,1
2589041,2589145,104,0,0,1,1
2589142,2589276,134,1,0,0,2
2589146,2589162,16,1,0,0,1
2589163,2589208,45,0,0,1,1
2589209,2589277,68,1,0,0,1
2589277,2589318,41,0,0,1,2
2589278,2589742,464,0,0,1,1
2589319,2589323,4,1,0,0,2
2589324,2589743,419,0,0,1,2
2589743,2589797,54,1,0,0,1
2589744,2589798,54,1,0,0,2
2589798,2590031,233,0,0,1,1
2589799,2590032,233,0,0,1,2
2590032,2590067,35,1,0,0,1
2590033,2590058,25,1,0,0,2
2590059,2590292,233,0,0,1,2
2590068,2590285,217,0,0,1,1
2590286,2590491,205,1,0,0,1
2590293,2590507,214,1,0,0,2
2590315,2590459,144,0,1,0,1
2590318,2590446,128,0,1,0,2
2590492,2591874,1382,0,0,1,1
2590508,2591876,1368,0,0,1,2
2591875,2591898,23,1,0,0,1
2591877,2591896,19,1,0,0,2
2591897,2592178,281,0,0,1,2
2591899,2592176,277,0,0,1,1
2592177,2592248,71,1,0,0,1
2592179,2592246,67,1,0,0,2
2592247,2592738,491,0,0,1,2
2592249,2592739,490,0,0,1,1
2592739,2592766,27,1,0,0,2
2592740,2592822,82,1,0,0,1
2592767,2594318,1551,0,0,1,2
2592823,2593780,957,0,0,1,1
2593781,2593795,14,1,0,0,1
2593796,2593949,153,0,0,1,1
2593950,2593957,7,1,0,0,1
2593958,2594318,360,0,0,1,1
2594319,2594369,50,1,0,0,2
2594319,2594528,209,1,0,0,1
2594370,2594392,22,0,0,1,2
2594393,2594453,60,1,0,0,2
2594454,2594642,188,0,0,1,2
2594529,2594643,114,0,0,1,1
2594643,2594965,322,1,0,0,2
2594644,2594977,333,1,0,0,1
2594670,2594894,224,0,1,0,1
2594676,2594818,142,0,1,0,2
2594966,2595014,48,0,0,1,2
2594978,2595017,39,0,0,1,1
2595015,2595044,29,1,0,0,2
2595018,2595039,21,1,0,0,1
2595040,2595236,196,0,0,1,1
2595045,2595237,192,0,0,1,2
2595237,2595282,45,1,0,0,1
2595238,2595281,43,1,0,0,2
2595282,2595448,166,0,0,1,2
2595283,2595449,166,0,0,1,1
2595449,2595486,37,1,0,0,2
2595450,2595475,25,1,0,0,1
2595476,2595751,275,0,0,1,1
2595487,2595754,267,0,0,1,2
2595752,2595945,193,1,0,0,1
2595755,2595834,79,1,0,0,2
2595835,2595915,80,0,0,1,2
2595916,2595929,13,1,0,0,2
2595930,2596086,156,0,0,1,2
2595946,2596086,140,0,0,1,1
2596087,2596112,25,1,0,0,2
2596087,2596388,301,1,0,0,1
2596113,2597454,1341,0,0,1,2
2596389,2596446,57,0,0,1,1
2596447,2596619,172,1,0,0,1
2596620,2596830,210,0,0,1,1
2596831,2596882,51,1,0,0,1
2596883,2597093,210,0,0,1,1
2597094,2597235,141,1,0,0,1
2597236,2597326,90,0,0,1,1
2597327,2597349,22,1,0,0,1
2597350,2597454,104,0,0,1,1
2597455,2597475,20,1,0,0,2
2597455,2597516,61,1,0,0,1
2597476,2597599,123,0,0,1,2
2597517,2597598,81,0,0,1,1
2597599,2597841,242,1,0,0,1
2597600,2597623,23,1,0,0,2
2597624,2597749,125,0,0,1,2
2597728,2597754,26,0,1,0,1
2597750,2597834,84,1,0,0,2
2597835,2598159,324,0,0,1,2
2597842,2598161,319,0,0,1,1
2598160,2598171,11,1,0,0,2
2598162,2598167,5,1,0,0,1
2598168,2598509,341,0,0,1,1
2598172,2598512,340,0,0,1,2
2598510,2598793,283,1,0,0,1
2598513,2598727,214,1,0,0,2
2598542,2598644,102,0,1,0,1
2598565,2598613,48,0,1,0,2
2598679,2598692,13,0,1,0,1
2598728,2599034,306,0,0,1,2
2598794,2599032,238,0,0,1,1
2599033,2599060,27,1,0,0,1
2599035,2599051,16,1,0,0,2
2599052,2599587,535,0,0,1,2
2599061,2599108,47,0,0,1,1
2599109,2599185,76,1,0,0,1
2599186,2599585,399,0,0,1,1
2599586,2599601,15,1,0,0,1
2599588,2599594,6,1,0,0,2
2599595,2599620,25,0,0,1,2
2599602,2599736,134,0,0,1,1
2599621,2599625,4,1,0,0,2
2599626,2599737,111,0,0,1,2
2599737,2600335,598,1,0,0,1
2599738,2599777,39,1,0,0,2
2599778,2599810,32,0,0,1,2
2599811,2600096,285,1,0,0,2
2599865,2600083,218,0,1,0,1
2599878,2599986,108,0,1,0,2
2600097,2600226,129,0,0,1,2
2600227,2600232,5,1,0,0,2
2600233,2600448,215,0,0,1,2
2600336,2600433,97,0,0,1,1
2600434,2600486,52,1,0,0,1
2600449,2600465,16,1,0,0,2
2600466,2601052,586,0,0,1,2
2600487,2600525,38,0,0,1,1
2600526,2600530,4,1,0,0,1
2600531,2600661,130,0,0,1,1
2600662,2600677,15,1,0,0,1
2600678,2600787,109,0,0,1,1
2600788,2600806,18,1,0,0,1
2600807,2600830,23,0,0,1,1
2600831,2600837,6,1,0,0,1
2600838,2600998,160,0,0,1,1
2600999,2601155,156,1,0,0,1
2601053,2601092,39,1,0,0,2
2601093,2601235,142,0,0,1,2
2601156,2601238,82,0,0,1,1
2601236,2601257,21,1,0,0,2
2601239,2601291,52,1,0,0,1
2601258,2601443,185,0,0,1,2
2601292,2601444,152,0,0,1,1
2601444,2601468,24,1,0,0,2
2601445,2601469,24,1,0,0,1
2601469,2601605,136,0,0,1,2
2601470,2601605,135,0,0,1,1
2601606,2601632,26,1,0,0,1
2601606,2601632,26,1,0,0,2
2601633,2602003,370,0,0,1,2
2601633,2602006,373,0,0,1,1
2602004,2602019,15,1,0,0,2
2602007,2602020,13,1,0,0,1
2602020,2602868,848,0,0,1,2
2602021,2602870,849,0,0,1,1
2602869,2602887,18,1,0,0,2
2602871,2602897,26,1,0,0,1
2602888,2603499,611,0,0,1,2
2602898,2603499,601,0,0,1,1
2603500,2603562,62,1,0,0,2
2603500,2603572,72,1,0,0,1
2603563,2603743,180,0,0,1,2
2603573,2603743,170,0,0,1,1
2603744,2603763,19,1,0,0,2
2603744,2603764,20,1,0,0,1
2603764,2605285,1521,0,0,1,2
2603765,2605284,1519,0,0,1,1
2605285,2605311,26,1,0,0,1
2605286,2605302,16,1,0,0,2
2605303,2605569,266,0,0,1,2
2605312,2605565,253,0,0,1,1
2605566,2605981,415,1,0,0,1
2605570,2605982,412,1,0,0,2
2605600,2605892,292,0,1,0,1
2605609,2605807,198,0,1,0,2
2605982,2606064,82,0,0,1,1
2605983,2606066,83,0,0,1,2
2606065,2606086,21,1,0,0,1
2606067,2606085,18,1,0,0,2
2606086,2606455,369,0,0,1,2
2606087,2606453,366,0,0,1,1
2606454,2606496,42,1,0,0,1
2606456,2606500,44,1,0,0,2
2606497,2607306,809,0,0,1,1
2606501,2607305,804,0,0,1,2
2607306,2607366,60,1,0,0,2
2607307,2607365,58,1,0,0,1
2607366,2607493,127,0,0,1,1
2607367,2607496,129,0,0,1,2
2607494,2607517,23,1,0,0,1
2607497,2607515,18,1,0,0,2
2607516,2609704,2188,0,0,1,2
2607518,2609707,2189,0,0,1,1
2609705,2609765,60,1,0,0,2
2609708,2609772,64,1,0,0,1
2609766,2609967,201,0,0,1,2
2609773,2609966,193,0,0,1,1
2609967,2609995,28,1,0,0,1
2609968,2609996,28,1,0,0,2
2609996,2610808,812,0,0,1,1
2609997,2610789,792,0,0,1,2
2610790,2610931,141,1,0,0,2
2610809,2610902,93,1,0,0,1
2610903,2611353,450,0,0,1,1
2610932,2611354,422,0,0,1,2
2611354,2611374,20,1,0,0,1
2611355,2611376,21,1,0,0,2
2611375,2612022,647,0,0,1,1
2611377,2612023,646,0,0,1,2
2612023,2612084,61,1,0,0,1
2612024,2612074,50,1,0,0,2
2612075,2612352,277,0,0,1,2
2612085,2612352,267,0,0,1,1
2612353,2612397,44,1,0,0,2
2612353,2612405,52,1,0,0,1
2612398,2613326,928,0,0,1,2
2612406,2613327,921,0,0,1,1
2613327,2613351,24,1,0,0,2
2613328,2613359,31,1,0,0,1
2613352,2613595,243,0,0,1,2
2613360,2613594,234,0,0,1,1
2613595,2613672,77,1,0,0,1
2613596,2613666,70,1,0,0,2
2613667,2613844,177,0,0,1,2
2613673,2613844,171,0,0,1,1
2613845,2613877,32,1,0,0,2
2613845,2613880,35,1,0,0,1
2613878,2615728,1850,0,0,1,2
2613881,2615729,1848,0,0,1,1
2615729,2615766,37,1,0,0,2
2615730,2615779,49,1,0,0,1
2615767,2616690,923,0,0,1,2
2615780,2616229,449,0,0,1,1
2616230,2616234,4,1,0,0,1
2616235,2616690,455,0,0,1,1
2616691,2616724,33,1,0,0,2
2616691,2616888,197,1,0,0,1
2616725,2616771,46,0,0,1,2
2616772,2616839,67,1,0,0,2
2616840,2617239,399,0,0,1,2
2616889,2617238,349,0,0,1,1
2617239,2617268,29,1,0,0,1
2617240,2617260,20,1,0,0,2
2617261,2617409,148,0,0,1,2
2617269,2617404,135,0,0,1,1
2617405,2617466,61,1,0,0,1
2617410,2617423,13,1,0,0,2
2617424,2617516,92,0,0,1,2
2617467,2617514,47,0,0,1,1
2617515,2617519,4,1,0,0,1
2617517,2617521,4,1,0,0,2
2617520,2617787,267,0,0,1,1
2617522,2617789,267,0,0,1,2
2617788,2618071,283,1,0,0,1
2617790,2618048,258,1,0,0,2
2617819,2618007,188,0,1,0,1
2617830,2617958,128,0,1,0,2
2618049,2618193,144,0,0,1,2
2618072,2618194,122,0,0,1,1
2618194,2618216,22,1,0,0,2
2618195,2618219,24,1,0,0,1
2618217,2618388,171,0,0,1,2
2618220,2618385,165,0,0,1,1
2618386,2618470,84,1,0,0,1
2618389,2618458,69,1,0,0,2
2618459,2618743,284,0,0,1,2
2618471,2618743,272,0,0,1,1
2618744,2618797,53,1,0,0,1
2618744,2618798,54,1,0,0,2
2618798,2619290,492,0,0,1,1
2618799,2619290,491,0,0,1,2
2619291,2619366,75,1,0,0,2
2619291,2619369,78,1,0,0,1
2619367,2619488,121,0,0,1,2
2619370,2619485,115,0,0,1,1
2619486,2619513,27,1,0,0,1
2619489,2619503,14,1,0,0,2
2619504,2619787,283,0,0,1,2
2619514,2619781,267,0,0,1,1
2619782,2619808,26,1,0,0,1
2619788,2619809,21,1,0,0,2
2619809,2620837,1028,0,0,1,1
2619810,2620836,1026,0,0,1,2
2620837,2620861,24,1,0,0,2
2620838,2620862,24,1,0,0,1
2620862,2621323,461,0,0,1,2
2620863,2621325,462,0,0,1,1
2621324,2621390,66,1,0,0,2
2621326,2621385,59,1,0,0,1
2621386,2621524,138,0,0,1,1
2621391,2621526,135,0,0,1,2
2621525,2621543,18,1,0,0,1
2621527,2621548,21,1,0,0,2
2621544,2621728,184,0,0,1,1
2621549,2621793,244,0,0,1,2
2621729,2621745,16,1,0,0,1
2621746,2621799,53,0,0,1,1
2621794,2622236,442,1,0,0,2
2621800,2622147,347,1,0,0,1
2621830,2622052,222,0,1,0,2
2621830,2622080,250,0,1,0,1
2622148,2622381,233,0,0,1,1
2622237,2622293,56,0,0,1,2
2622294,2622457,163,1,0,0,2
2622382,2622414,32,1,0,0,1
2622415,2622580,165,0,0,1,1
2622458,2622537,79,0,0,1,2
2622538,2623614,1076,1,0,0,2
2622581,2622599,18,1,0,0,1
2622600,2622734,134,0,0,1,1
2622735,2622750,15,1,0,0,1
2622751,2622950,199,0,0,1,1
2622951,2622967,16,1,0,0,1
2622968,2623261,293,0,0,1,1
2623262,2623664,402,1,0,0,1
2623303,2623512,209,0,1,0,2
2623306,2623587,281,0,1,0,1
2623615,2623829,214,0,0,1,2
2623665,2623815,150,0,0,1,1
2623816,2624134,318,1,0,0,1
2623830,2624080,250,1,0,0,2
2623863,2624072,209,0,1,0,1
2623875,2624004,129,0,1,0,2
2624081,2624344,263,0,0,1,2
2624135,2624343,208,0,0,1,1
2624344,2624398,54,1,0,0,1
2624345,2624397,52,1,0,0,2
2624398,2624714,316,0,0,1,2
2624399,2624714,315,0,0,1,1
2624715,2624766,51,1,0,0,1
2624715,2624767,52,1,0,0,2
2624767,2624969,202,0,0,1,1
2624768,2624968,200,0,0,1,2
2624969,2625020,51,1,0,0,2
2624970,2625015,45,1,0,0,1
2625016,2625197,181,0,0,1,1
2625021,2625197,176,0,0,1,2
2625198,2625220,22,1,0,0,1
2625198,2625225,27,1,0,0,2
2625221,2625870,649,0,0,1,1
2625226,2625869,643,0,0,1,2
2625870,2625879,9,1,0,0,2
2625871,2625875,4,1,0,0,1
2625876,2626517,641,0,0,1,1
2625880,2626511,631,0,0,1,2
2626512,2626538,26,1,0,0,2
2626518,2626539,21,1,0,0,1
2626539,2626635,96,0,0,1,2
2626540,2626635,95,0,0,1,1
2626636,2626701,65,1,0,0,2
2626636,2626704,68,1,0,0,1
2626702,2627283,581,0,0,1,2
2626705,2627271,566,0,0,1,1
2627272,2627970,698,1,0,0,1
2627284,2627570,286,1,0,0,2
2627303,2627555,252,0,1,0,1
2627311,2627444,133,0,1,0,2
2627571,2627789,218,0,0,1,2
2627790,2627806,16,1,0,0,2
2627807,2628701,894,0,0,1,2
2627971,2628699,728,0,0,1,1
2628700,2628759,59,1,0,0,1
2628702,2628760,58,1,0,0,2
2628760,2629315,555,0,0,1,1
2628761,2629316,555,0,0,1,2
2629316,2629365,49,1,0,0,1
2629317,2629364,47,1,0,0,2
2629365,2629871,506,0,0,1,2
2629366,2629870,504,0,0,1,1
2629871,2629951,80,1,0,0,1
2629872,2629942,70,1,0,0,2
2629943,2630054,111,0,0,1,2
2629952,2630055,103,0,0,1,1
2630055,2630085,30,1,0,0,2
2630056,2630084,28,1,0,0,1
2630085,2631512,1427,0,0,1,1
2630086,2631512,1426,0,0,1,2
2631513,2631565,52,1,0,0,1
2631513,2631566,53,1,0,0,2
2631566,2632441,875,0,0,1,1
2631567,2632444,877,0,0,1,2
2632442,2632464,22,1,0,0,1
2632445,2632464,19,1,0,0,2
2632465,2632741,276,0,0,1,2
2632465,2632742,277,0,0,1,1
2632742,2632761,19,1,0,0,2
2632743,2632762,19,1,0,0,1
2632762,2633249,487,0,0,1,2
2632763,2633248,485,0,0,1,1
2633249,2633392,143,1,0,0,1
2633250,2633412,162,1,0,0,2
2633393,2633484,91,0,0,1,1
2633413,2633569,156,0,0,1,2
2633485,2633489,4,1,0,0,1
2633490,2633569,79,0,0,1,1
2633570,2633927,357,1,0,0,2
2633570,2633943,373,1,0,0,1
2633641,2633820,179,0,1,0,1
2633646,2633783,137,0,1,0,2
2633928,2634007,79,0,0,1,2
2633944,2634003,59,0,0,1,1
2634004,2634080,76,1,0,0,1
2634008,2634047,39,1,0,0,2
2634048,2634075,27,0,0,1,2
2634076,2634081,5,1,0,0,2
2634081,2634115,34,0,0,1,1
2634082,2634110,28,0,0,1,2
2634111,2634133,22,1,0,0,2
2634116,2634120,4,1,0,0,1
2634121,2634461,340,0,0,1,1
2634134,2634460,326,0,0,1,2
2634461,2634524,63,1,0,0,2
2634462,2634534,72,1,0,0,1
2634525,2634884,359,0,0,1,2
2634535,2634884,349,0,0,1,1
2634885,2634974,89,1,0,0,2
2634885,2636702,1817,1,0,0,1
2634975,2635037,62,0,0,1,2
2635038,2635057,19,1,0,0,2
2635058,2635187,129,0,0,1,2
2635188,2635210,22,1,0,0,2
2635211,2635424,213,0,0,1,2
2635425,2635452,27,1,0,0,2
2635453,2636352,899,0,0,1,2
2636353,2636371,18,1,0,0,2
2636372,2636648,276,0,0,1,2
2636649,2636686,37,1,0,0,2
2636687,2637093,406,0,0,1,2
2636703,2637094,391,0,0,1,1
2637094,2637110,16,1,0,0,2
2637095,2637112,17,1,0,0,1
2637111,2637434,323,0,0,1,2
2637113,2637434,321,0,0,1,1
2637435,2637454,19,1,0,0,2
2637435,2637537,102,1,0,0,1
2637455,2637667,212,0,0,1,2
2637538,2637594,56,0,0,1,1
2637595,2637615,20,1,0,0,1
2637616,2637666,50,0,0,1,1
2637667,2637717,50,1,0,0,1
2637668,2637685,17,1,0,0,2
2637686,2637927,241,0,0,1,2
2637718,2637772,54,0,0,1,1
2637773,2637873,100,1,0,0,1
2637874,2637927,53,0,0,1,1
2637928,2637947,19,1,0,0,2
2637928,2637978,50,1,0,0,1
2637948,2638454,506,0,0,1,2
2637979,2638452,473,0,0,1,1
2638453,2639757,1304,1,0,0,1
2638455,2639501,1046,1,0,0,2
2638471,2639605,1134,0,1,0,1
2638489,2638700,211,0,1,0,2
2639013,2639490,477,0,1,0,2
2639502,2639553,51,0,0,1,2
2639554,2639564,10,1,0,0,2
2639565,2639703,138,0,0,1,2
2639704,2639717,13,1,0,0,2
2639718,2639885,167,0,0,1,2
2639758,2639823,65,0,0,1,1
2639824,2639828,4,1,0,0,1
2639829,2639875,46,0,0,1,1
2639876,2639925,49,1,0,0,1
2639886,2639915,29,1,0,0,2
2639916,2640125,209,0,0,1,2
2639926,2640127,201,0,0,1,1
2640126,2640139,13,1,0,0,2
2640128,2640166,38,1,0,0,1
2640140,2640234,94,0,0,1,2
2640167,2640232,65,0,0,1,1
2640233,2640338,105,1,0,0,1
2640235,2640375,140,1,0,0,2
2640339,2640636,297,0,0,1,1
2640376,2640454,78,0,0,1,2
2640455,2640502,47,1,0,0,2
2640503,2640534,31,0,0,1,2
2640535,2640539,4,1,0,0,2
2640540,2640560,20,0,0,1,2
2640561,2640592,31,1,0,0,2
2640593,2640640,47,0,0,1,2
2640637,2640659,22,1,0,0,1
2640641,2640672,31,1,0,0,2
2640660,2642179,1519,0,0,1,1
2640673,2641078,405,0,0,1,2
2641079,2641083,4,1,0,0,2
2641084,2641189,105,0,0,1,2
2641190,2641199,9,1,0,0,2
2641200,2641374,174,0,0,1,2
2641375,2641752,377,1,0,0,2
2641753,2642094,341,0,0,1,2
2642095,2642106,11,1,0,0,2
2642107,2642497,390,0,0,1,2
2642180,2642195,15,1,0,0,1
2642196,2642494,298,0,0,1,1
2642495,2642552,57,1,0,0,1
2642498,2642574,76,1,0,0,2
2642553,2642625,72,0,0,1,1
2642575,2642629,54,0,0,1,2
2642626,2642657,31,1,0,0,1
2642630,2642657,27,1,0,0,2
2642658,2642990,332,0,0,1,1
2642658,2642992,334,0,0,1,2
2642991,2643014,23,1,0,0,1
2642993,2643012,19,1,0,0,2
2643013,2643329,316,0,0,1,2
2643015,2643340,325,0,0,1,1
2643330,2644644,1314,1,0,0,2
2643341,2643746,405,1,0,0,1
2643361,2643791,430,0,1,0,2
2643365,2643710,345,0,1,0,1
2643747,2643785,38,0,0,1,1
2643786,2643807,21,1,0,0,1
2643808,2643948,140,0,0,1,1
2643949,2644378,429,1,0,0,1
2643972,2643973,1,0,1,0,2
2644000,2644354,354,0,1,0,1
2644002,2644633,631,0,1,0,2
2644379,2644412,33,0,0,1,1
2644413,2644432,19,1,0,0,1
2644433,2644658,225,0,0,1,1
2644645,2644671,26,0,0,1,2
2644659,2645119,460,1,0,0,1
2644672,2644970,298,1,0,0,2
2644775,2644865,90,0,1,0,2
2644778,2644870,92,0,1,0,1
2644971,2645075,104,0,0,1,2
2645076,2645089,13,1,0,0,2
2645090,2645458,368,0,0,1,2
2645120,2645469,349,0,0,1,1
2645459,2645501,42,1,0,0,2
2645470,2645500,30,1,0,0,1
2645501,2645554,53,0,0,1,1
2645502,2645633,131,0,0,1,2
2645555,2646005,450,1,0,0,1
2645634,2645643,9,1,0,0,2
2645644,2645952,308,0,0,1,2
2645953,2645976,23,1,0,0,2
2645977,2646069,92,0,0,1,2
2646006,2646067,61,0,0,1,1
2646068,2646104,36,1,0,0,1
2646070,2646113,43,1,0,0,2
2646105,2646224,119,0,0,1,1
2646114,2646223,109,0,0,1,2
2646224,2646267,43,1,0,0,2
2646225,2646269,44,1,0,0,1
2646268,2646538,270,0,0,1,2
2646270,2646538,268,0,0,1,1
2646539,2646560,21,1,0,0,2
2646539,2646568,29,1,0,0,1
2646561,2647085,524,0,0,1,2
2646569,2647085,516,0,0,1,1
2647086,2647099,13,1,0,0,2
2647086,2647100,14,1,0,0,1
2647100,2647391,291,0,0,1,2
2647101,2647391,290,0,0,1,1
2647392,2647409,17,1,0,0,2
2647392,2647413,21,1,0,0,1
2647410,2647634,224,0,0,1,2
2647414,2647634,220,0,0,1,1
2647635,2647656,21,1,0,0,1
2647635,2647658,23,1,0,0,2
2647657,2647753,96,0,0,1,1
2647659,2647753,94,0,0,1,2
2647754,2647774,20,1,0,0,2
2647754,2647777,23,1,0,0,1
2647775,2648117,342,0,0,1,2
2647778,2648114,336,0,0,1,1
2648115,2648183,68,1,0,0,1
2648118,2648147,29,1,0,0,2
2648148,2648457,309,0,0,1,2
2648184,2648532,348,0,0,1,1
2648458,2648463,5,1,0,0,2
2648464,2648549,85,0,0,1,2
2648533,2649218,685,1,0,0,1
2648550,2649191,641,1,0,0,2
2648572,2649157,585,0,1,0,1
2648581,2648753,172,0,1,0,2
2648864,2649130,266,0,1,0,2
2649192,2649448,256,0,0,1,2
2649219,2649257,38,0,0,1,1
2649258,2649295,37,1,0,0,1
2649296,2649433,137,0,0,1,1
2649434,2649820,386,1,0,0,1
2649449,2649721,272,1,0,0,2
2649473,2649662,189,0,1,0,1
2649479,2649646,167,0,1,0,2
2649722,2649876,154,0,0,1,2
2649821,2649876,55,0,0,1,1
2649877,2649918,41,1,0,0,2
2649877,2649922,45,1,0,0,1
2649919,2650380,461,0,0,1,2
2649923,2650379,456,0,0,1,1
2650380,2650446,66,1,0,0,1
2650381,2650446,65,1,0,0,2
2650447,2650573,126,0,0,1,1
2650447,2650587,140,0,0,1,2
2650574,2650925,351,1,0,0,1
2650588,2650950,362,1,0,0,2
2650610,2650851,241,0,1,0,1
2650618,2650856,238,0,1,0,2
2650926,2651076,150,0,0,1,1
2650951,2651119,168,0,0,1,2
2651077,2651092,15,1,0,0,1
2651093,2651121,28,0,0,1,1
2651120,2651173,53,1,0,0,2
2651122,2651173,51,1,0,0,1
2651174,2651328,154,0,0,1,2
2651174,2651346,172,0,0,1,1
2651329,2651757,428,1,0,0,2
2651347,2651761,414,1,0,0,1
2651401,2651659,258,0,1,0,1
2651409,2651635,226,0,1,0,2
2651758,2651780,22,0,0,1,2
2651762,2651784,22,0,0,1,1
2651781,2651839,58,1,0,0,2
2651785,2651857,72,1,0,0,1
2651840,2651939,99,0,0,1,2
2651858,2651937,79,0,0,1,1
2651938,2651976,38,1,0,0,1
2651940,2651978,38,1,0,0,2
2651977,2653354,1377,0,0,1,1
2651979,2654091,2112,0,0,1,2
2653355,2653369,14,1,0,0,1
2653370,2654091,721,0,0,1,1
2654092,2654150,58,1,0,0,2
2654092,2654160,68,1,0,0,1
2654151,2654931,780,0,0,1,2
2654161,2654929,768,0,0,1,1
2654930,2654960,30,1,0,0,1
2654932,2654960,28,1,0,0,2
2654961,2655451,490,0,0,1,1
2654961,2655467,506,0,0,1,2
2655452,2655793,341,1,0,0,1
2655468,2655732,264,1,0,0,2
2655499,2655689,190,0,1,0,1
2655539,2655587,48,0,1,0,2
2655733,2655884,151,0,0,1,2
2655794,2655885,91,0,0,1,1
2655885,2655938,53,1,0,0,2
2655886,2655953,67,1,0,0,1
2655939,2656163,224,0,0,1,2
2655954,2656164,210,0,0,1,1
2656164,2656227,63,1,0,0,2
2656165,2656230,65,1,0,0,1
2656228,2656434,206,0,0,1,2
2656231,2656423,192,0,0,1,1
2656424,2656852,428,1,0,0,1
2656435,2656826,391,1,0,0,2
2656465,2656766,301,0,1,0,1
2656479,2656698,219,0,1,0,2
2656827,2657012,185,0,0,1,2
2656853,2657047,194,0,0,1,1
2657013,2657018,5,1,0,0,2
2657019,2657048,29,0,0,1,2
2657048,2657107,59,1,0,0,1
2657049,2657107,58,1,0,0,2
2657108,2657737,629,0,0,1,1
2657108,2657737,629,0,0,1,2
2657738,2657786,48,1,0,0,1
2657738,2657786,48,1,0,0,2
2657787,2658035,248,0,0,1,1
2657787,2658035,248,0,0,1,2
2658036,2658107,71,1,0,0,2
2658036,2658111,75,1,0,0,1
2658108,2658204,96,0,0,1,2
2658112,2658203,91,0,0,1,1
2658204,2658237,33,1,0,0,1
2658205,2658229,24,1,0,0,2
2658230,2658411,181,0,0,1,2
2658238,2658409,171,0,0,1,1
2658410,2658438,28,1,0,0,1
2658412,2658432,20,1,0,0,2
2658433,2659932,1499,0,0,1,2
2658439,2659932,1493,0,0,1,1
2659933,2660025,92,1,0,0,2
2659933,2660035,102,1,0,0,1
2660026,2660187,161,0,0,1,2
2660036,2660187,151,0,0,1,1
2660188,2660251,63,1,0,0,2
2660188,2660259,71,1,0,0,1
2660252,2661033,781,0,0,1,2
2660260,2661031,771,0,0,1,1
2661032,2661058,26,1,0,0,1
2661034,2661057,23,1,0,0,2
2661058,2661305,247,0,0,1,2
2661059,2661322,263,0,0,1,1
2661306,2662296,990,1,0,0,2
2661323,2661738,415,1,0,0,1
2661339,2661674,335,0,1,0,1
2661344,2661518,174,0,1,0,2
2661739,2661809,70,0,0,1,1
2661810,2662207,397,1,0,0,1
2661832,2662115,283,0,1,0,1
2661843,2662028,185,0,1,0,2
2662208,2662228,20,0,0,1,1
2662229,2662259,30,1,0,0,1
2662260,2662425,165,0,0,1,1
2662297,2662429,132,0,0,1,2
2662426,2662570,144,1,0,0,1
2662430,2662456,26,1,0,0,2
2662457,2662497,40,0,0,1,2
2662498,2662596,98,1,0,0,2
2662571,2662704,133,0,0,1,1
2662597,2662705,108,0,0,1,2
2662705,2662733,28,1,0,0,1
2662706,2662735,29,1,0,0,2
2662734,2662941,207,0,0,1,1
2662736,2662942,206,0,0,1,2
2662942,2663029,87,1,0,0,1
2662943,2663028,85,1,0,0,2
2663029,2663462,433,0,0,1,2
2663030,2663462,432,0,0,1,1
2663463,2663548,85,1,0,0,1
2663463,2663550,87,1,0,0,2
2663549,2663669,120,0,0,1,1
2663551,2663672,121,0,0,1,2
2663670,2663689,19,1,0,0,1
2663673,2663690,17,1,0,0,2
2663690,2663931,241,0,0,1,1
2663691,2663932,241,0,0,1,2
2663932,2663982,50,1,0,0,1
2663933,2663981,48,1,0,0,2
2663982,2664086,104,0,0,1,2
2663983,2664086,103,0,0,1,1
2664087,2664120,33,1,0,0,2
2664087,2664135,48,1,0,0,1
2664121,2664556,435,0,0,1,2
2664136,2664559,423,0,0,1,1
2664557,2664575,18,1,0,0,2
2664560,2664582,22,1,0,0,1
2664576,2664830,254,0,0,1,2
2664583,2664827,244,0,0,1,1
2664828,2664852,24,1,0,0,1
2664831,2664843,12,1,0,0,2
2664844,2666044,1200,0,0,1,2
2664853,2666044,1191,0,0,1,1
2666045,2666066,21,1,0,0,2
2666045,2666067,22,1,0,0,1
2666067,2666312,245,0,0,1,2
2666068,2666310,242,0,0,1,1
2666311,2666651,340,1,0,0,1
2666313,2666601,288,1,0,0,2
2666340,2666578,238,0,1,0,1
2666350,2666501,151,0,1,0,2
2666602,2666782,180,0,0,1,2
2666652,2666782,130,0,0,1,1
2666783,2666808,25,1,0,0,2
2666783,2666815,32,1,0,0,1
2666809,2667028,219,0,0,1,2
2666816,2667027,211,0,0,1,1
2667028,2667052,24,1,0,0,1
2667029,2667052,23,1,0,0,2
2667053,2667210,157,0,0,1,1
2667053,2667211,158,0,0,1,2
2667211,2667666,455,1,0,0,1
2667212,2667562,350,1,0,0,2
2667247,2667495,248,0,1,0,1
2667259,2667400,141,0,1,0,2
2667563,2667612,49,0,0,1,2
2667613,2667634,21,1,0,0,2
2667635,2668374,739,0,0,1,2
2667667,2668373,706,0,0,1,1
2668374,2669091,717,1,0,0,1
2668375,2668799,424,1,0,0,2
2668398,2668814,416,0,1,0,1
2668402,2668643,241,0,1,0,2
2668800,2668822,22,0,0,1,2
2668823,2668830,7,1,0,0,2
2668831,2668867,36,0,0,1,2
2668868,2668883,15,1,0,0,2
2668884,2668995,111,0,0,1,2
2668996,2669006,10,1,0,0,2
2669007,2669328,321,0,0,1,2
2669092,2669171,79,0,0,1,1
2669172,2669227,55,1,0,0,1
2669228,2669329,101,0,0,1,1
2669329,2669350,21,1,0,0,2
2669330,2669353,23,1,0,0,1
2669351,2669587,236,0,0,1,2
2669354,2669409,55,0,0,1,1
2669410,2669479,69,1,0,0,1
2669480,2669546,66,0,0,1,1
2669547,2669556,9,1,0,0,1
2669557,2669593,36,0,0,1,1
2669588,2669604,16,1,0,0,2
2669594,2669697,103,1,0,0,1
2669605,2669802,197,0,0,1,2
2669698,2669801,103,0,0,1,1
2669802,2669831,29,1,0,0,1
2669803,2669825,22,1,0,0,2
2669826,2669874,48,0,0,1,2
2669832,2669858,26,0,0,1,1
2669859,2670602,743,1,0,0,1
2669875,2670286,411,1,0,0,2
2669896,2670284,388,0,1,0,1
2669905,2670275,370,0,1,0,2
2670287,2670385,98,0,0,1,2
2670386,2670415,29,1,0,0,2
2670416,2670488,72,0,0,1,2
2670489,2670592,103,1,0,0,2
2670593,2670623,30,0,0,1,2
2670603,2670718,115,0,0,1,1
2670624,2670757,133,1,0,0,2
2670719,2670754,35,1,0,0,1
2670755,2670898,143,0,0,1,1
2670758,2670822,64,0,0,1,2
2670823,2670934,111,1,0,0,2
2670899,2670928,29,1,0,0,1
2670929,2671050,121,0,0,1,1
2670935,2671053,118,0,0,1,2
2671051,2671074,23,1,0,0,1
2671054,2671075,21,1,0,0,2
2671075,2671371,296,0,0,1,1
2671076,2671184,108,0,0,1,2
2671185,2671259,74,1,0,0,2
2671260,2671348,88,0,0,1,2
2671349,2671445,96,1,0,0,2
2671372,2671415,43,1,0,0,1
2671416,2671544,128,0,0,1,1
2671446,2671576,130,0,0,1,2
2671555,2671774,219,0,1,0,1
2671577,2671823,246,1,0,0,2
2671784,2671784,0,1,0,0,1
2671785,2672067,282,0,0,1,1
2671824,2671971,147,0,0,1,2
2671972,2672078,106,1,0,0,2
2672068,2672088,20,1,0,0,1
2672079,2672253,174,0,0,1,2
2672089,2672357,268,0,0,1,1
2672254,2672417,163,1,0,0,2
2672358,2672413,55,1,0,0,1
2672414,2673697,1283,0,0,1,1
2672418,2672741,323,0,0,1,2
2672742,2672766,24,1,0,0,2
2672767,2672865,98,0,0,1,2
2672866,2672900,34,1,0,0,2
2672901,2673518,617,0,0,1,2
2673519,2673530,11,1,0,0,2
2673531,2673639,108,0,0,1,2
2673640,2673658,18,1,0,0,2
2673659,2673682,23,0,0,1,2
2673683,2674031,348,1,0,0,2
2673698,2674910,1212,1,0,0,1
2673718,2674795,1077,0,1,0,1
2673734,2673981,247,0,1,0,2
2674032,2674116,84,0,0,1,2
2674117,2674830,713,1,0,0,2
2674514,2674705,191,0,1,0,2
2674831,2675396,565,0,0,1,2
2674911,2675141,230,0,0,1,1
2675142,2675165,23,1,0,0,1
2675166,2675313,147,0,0,1,1
2675314,2675334,20,1,0,0,1
2675335,2675361,26,0,0,1,1
2675362,2675414,52,1,0,0,1
2675397,2675406,9,1,0,0,2
2675407,2675546,139,0,0,1,2
2675415,2675448,33,0,0,1,1
2675449,2675465,16,1,0,0,1
2675466,2675700,234,0,0,1,1
2675547,2675915,368,1,0,0,2
2675701,2675716,15,1,0,0,1
2675717,2675821,104,0,0,1,1
2675822,2678193,2371,1,0,0,1
2675891,2677942,2051,0,1,0,1
2675916,2676003,87,0,0,1,2
2676004,2676103,99,1,0,0,2
2676104,2676177,73,0,0,1,2
2676178,2676262,84,1,0,0,2
2676263,2676308,45,0,0,1,2
2676309,2676345,36,1,0,0,2
2676346,2676391,45,0,0,1,2
2676392,2676409,17,1,0,0,2
2676410,2676521,111,0,0,1,2
2676522,2676563,41,1,0,0,2
2676564,2676665,101,0,0,1,2
2676666,2676683,17,1,0,0,2
2676684,2676898,214,0,0,1,2
2676899,2676909,10,1,0,0,2
2676910,2677543,633,0,0,1,2
2677544,2677576,32,1,0,0,2
2677577,2677775,198,0,0,1,2
2677776,2677818,42,1,0,0,2
2677819,2677886,67,0,0,1,2
2677887,2677923,36,1,0,0,2
2677924,2678122,198,0,0,1,2
2678123,2678174,51,1,0,0,2
2678175,2678307,132,0,0,1,2
2678194,2678305,111,0,0,1,1
2678306,2678345,39,1,0,0,1
2678308,2678339,31,1,0,0,2
2678340,2678764,424,0,0,1,2
2678346,2678761,415,0,0,1,1
2678762,2678786,24,1,0,0,1
2678765,2678785,20,1,0,0,2
2678786,2679030,244,0,0,1,2
2678787,2679029,242,0,0,1,1
2679030,2679071,41,1,0,0,1
2679031,2679050,19,1,0,0,2
2679051,2679206,155,0,0,1,2
2679072,2679200,128,0,0,1,1
2679201,2680015,814,1,0,0,1
2679207,2679518,311,1,0,0,2
2679231,2679593,362,0,1,0,1
2679251,2679401,150,0,1,0,2
2679519,2679592,73,0,0,1,2
2679593,2679642,49,1,0,0,2
2679643,2679917,274,0,0,1,2
2679918,2679942,24,1,0,0,2
2679943,2680161,218,0,0,1,2
2680016,2680078,62,0,0,1,1
2680079,2680476,397,1,0,0,1
2680162,2680175,13,1,0,0,2
2680176,2680196,20,0,0,1,2
2680197,2680843,646,1,0,0,2
2680243,2680420,177,0,1,0,1
2680257,2680384,127,0,1,0,2
2680477,2680597,120,0,0,1,1
2680598,2680626,28,1,0,0,1
2680627,2680764,137,0,0,1,1
2680765,2680794,29,1,0,0,1
2680795,2680833,38,0,0,1,1
2680834,2680874,40,1,0,0,1
2680844,2680941,97,0,0,1,2
2680875,2680947,72,0,0,1,1
2680942,2680972,30,1,0,0,2
2680948,2680969,21,1,0,0,1
2680970,2681078,108,0,0,1,1
2680973,2681335,362,0,0,1,2
2681079,2681099,20,1,0,0,1
2681100,2681121,21,0,0,1,1
2681122,2681164,42,1,0,0,1
2681165,2681209,44,0,0,1,1
2681210,2681288,78,1,0,0,1
2681289,2681322,33,0,0,1,1
2681323,2681428,105,1,0,0,1
2681336,2681362,26,1,0,0,2
2681363,2681742,379,0,0,1,2
2681429,2681740,311,0,0,1,1
2681741,2681800,59,1,0,0,1
2681743,2681773,30,1,0,0,2
2681774,2682054,280,0,0,1,2
2681801,2682054,253,0,0,1,1
2682055,2682131,76,1,0,0,2
2682055,2682144,89,1,0,0,1
2682132,2682260,128,0,0,1,2
2682145,2682261,116,0,0,1,1
2682261,2682293,32,1,0,0,2
2682262,2682293,31,1,0,0,1
2682294,2682588,294,0,0,1,1
2682294,2682588,294,0,0,1,2
2682589,2682593,4,1,0,0,1
2682589,2682604,15,1,0,0,2
2682594,2683432,838,0,0,1,1
2682605,2683436,831,0,0,1,2
2683433,2683575,142,1,0,0,1
2683437,2683515,78,1,0,0,2
2683516,2683539,23,0,0,1,2
2683540,2683548,8,1,0,0,2
2683549,2684073,524,0,0,1,2
2683576,2684073,497,0,0,1,1
2684074,2684143,69,1,0,0,2
2684074,2684154,80,1,0,0,1
2684144,2684293,149,0,0,1,2
2684155,2684292,137,0,0,1,1
2684293,2684330,37,1,0,0,1
2684294,2684328,34,1,0,0,2
2684329,2685127,798,0,0,1,2
2684331,2685127,796,0,0,1,1
2685128,2685151,23,1,0,0,2
2685128,2685158,30,1,0,0,1
2685152,2685507,355,0,0,1,2
2685159,2685505,346,0,0,1,1
2685506,2685538,32,1,0,0,1
2685508,2685528,20,1,0,0,2
2685529,2686144,615,0,0,1,2
2685539,2686144,605,0,0,1,1
2686145,2686348,203,1,0,0,1
2686145,2686350,205,1,0,0,2
2686349,2686543,194,0,0,1,1
2686351,2686543,192,0,0,1,2
2686544,2686594,50,1,0,0,2
2686544,2686604,60,1,0,0,1
2686595,2687391,796,0,0,1,2
2686605,2687391,786,0,0,1,1
2687392,2687439,47,1,0,0,2
2687392,2687440,48,1,0,0,1
2687440,2687840,400,0,0,1,2
2687441,2687840,399,0,0,1,1
2687841,2687896,55,1,0,0,2
2687841,2687907,66,1,0,0,1
2687897,2688225,328,0,0,1,2
2687908,2688223,315,0,0,1,1
2688224,2688254,30,1,0,0,1
2688226,2688253,27,1,0,0,2
2688254,2689549,1295,0,0,1,2
2688255,2689550,1295,0,0,1,1
2689550,2689612,62,1,0,0,2
2689551,2689619,68,1,0,0,1
2689613,2689998,385,0,0,1,2
2689620,2689998,378,0,0,1,1
2689999,2690021,22,1,0,0,1
2689999,2690036,37,1,0,0,2
2690022,2691612,1590,0,0,1,1
2690037,2691624,1587,0,0,1,2
2691613,2691967,354,1,0,0,1
2691625,2691861,236,1,0,0,2
2691657,2691838,181,0,1,0,1
2691707,2691715,8,0,1,0,2
2691862,2691889,27,0,0,1,2
2691890,2691969,79,1,0,0,2
2691968,2692050,82,0,0,1,1
2691970,2692052,82,0,0,1,2
2692051,2692126,75,1,0,0,1
2692053,2692098,45,1,0,0,2
2692099,2692786,687,0,0,1,2
2692127,2692785,658,0,0,1,1
2692786,2692835,49,1,0,0,1
2692787,2692837,50,1,0,0,2
2692836,2693159,323,0,0,1,1
2692838,2693159,321,0,0,1,2
2693160,2693186,26,1,0,0,1
2693160,2693187,27,1,0,0,2
2693187,2694170,983,0,0,1,1
2693188,2694171,983,0,0,1,2
2694171,2694201,30,1,0,0,1
2694172,2694200,28,1,0,0,2
2694201,2694452,251,0,0,1,2
2694202,2694452,250,0,0,1,1
2694453,2694516,63,1,0,0,2
2694453,2694523,70,1,0,0,1
2694517,2694641,124,0,0,1,2
2694524,2694641,117,0,0,1,1
2694642,2694671,29,1,0,0,2
2694642,2694672,30,1,0,0,1
2694672,2695314,642,0,0,1,2
2694673,2695314,641,0,0,1,1
2695315,2695341,26,1,0,0,2
2695315,2695343,28,1,0,0,1
2695342,2695931,589,0,0,1,2
2695344,2695930,586,0,0,1,1
2695931,2695964,33,1,0,0,1
2695932,2695963,31,1,0,0,2
2695964,2696273,309,0,0,1,2
2695965,2696271,306,0,0,1,1
2696272,2696300,28,1,0,0,1
2696274,2696293,19,1,0,0,2
2696294,2696516,222,0,0,1,2
2696301,2696501,200,0,0,1,1
2696502,2696863,361,1,0,0,1
2696517,2696778,261,1,0,0,2
2696538,2696796,258,0,1,0,1
2696562,2696704,142,0,1,0,2
2696779,2697059,280,0,0,1,2
2696864,2697055,191,0,0,1,1
2697056,2697136,80,1,0,0,1
2697060,2697097,37,1,0,0,2
2697098,2697848,750,0,0,1,2
2697137,2697848,711,0,0,1,1
2697849,2697929,80,1,0,0,2
2697849,2697931,82,1,0,0,1
2697930,2699151,1221,0,0,1,2
2697932,2699150,1218,0,0,1,1
2699151,2699181,30,1,0,0,1
2699152,2699173,21,1,0,0,2
2699174,2699929,755,0,0,1,2
2699182,2699928,746,0,0,1,1
2699929,2699987,58,1,0,0,1
2699930,2699995,65,1,0,0,2
2699988,2701251,1263,0,0,1,1
2699996,2701252,1256,0,0,1,2
2701252,2701274,22,1,0,0,1
2701253,2701274,21,1,0,0,2
2701275,2701670,395,0,0,1,1
2701275,2701676,401,0,0,1,2
2701671,2701690,19,1,0,0,1
2701677,2701690,13,1,0,0,2
2701691,2701816,125,0,0,1,1
2701691,2701820,129,0,0,1,2
2701817,2702184,367,1,0,0,1
2701821,2702163,342,1,0,0,2
2701839,2702174,335,0,1,0,1
2701852,2702007,155,0,1,0,2
2702164,2702330,166,0,0,1,2
2702185,2702330,145,0,0,1,1
2702331,2702378,47,1,0,0,1
2702331,2702380,49,1,0,0,2
2702379,2702823,444,0,0,1,1
2702381,2702550,169,0,0,1,2
2702551,2702557,6,1,0,0,2
2702558,2702824,266,0,0,1,2
2702824,2702852,28,1,0,0,1
2702825,2702850,25,1,0,0,2
2702851,2703082,231,0,0,1,2
2702853,2703081,228,0,0,1,1
2703082,2703107,25,1,0,0,1
2703083,2703107,24,1,0,0,2
2703108,2703349,241,0,0,1,1
2703108,2703353,245,0,0,1,2
2703350,2703372,22,1,0,0,1
2703354,2703375,21,1,0,0,2
2703373,2703427,54,0,0,1,1
2703376,2703447,71,0,0,1,2
2703428,2703448,20,1,0,0,1
2703448,2703465,17,1,0,0,2
2703449,2703855,406,0,0,1,1
2703466,2703854,388,0,0,1,2
2703855,2703929,74,1,0,0,2
2703856,2703928,72,1,0,0,1
2703929,2704306,377,0,0,1,1
2703930,2705324,1394,0,0,1,2
2704307,2704322,15,1,0,0,1
2704323,2705320,997,0,0,1,1
2705321,2705340,19,1,0,0,1
2705325,2705341,16,1,0,0,2
2705341,2705858,517,0,0,1,1
2705342,2705857,515,0,0,1,2
2705858,2705913,55,1,0,0,2
2705859,2705911,52,1,0,0,1
2705912,2706168,256,0,0,1,1
2705914,2706167,253,0,0,1,2
2706168,2706240,72,1,0,0,2
2706169,2706245,76,1,0,0,1
2706241,2706446,205,0,0,1,2
2706246,2706442,196,0,0,1,1
2706443,2706468,25,1,0,0,1
2706447,2706466,19,1,0,0,2
2706467,2706691,224,0,0,1,2
2706469,2706689,220,0,0,1,1
2706690,2706968,278,1,0,0,1
2706692,2706986,294,1,0,0,2
2706768,2706901,133,0,1,0,1
2706769,2706876,107,0,1,0,2
2706969,2707076,107,0,0,1,1
2706987,2707076,89,0,0,1,2
2707077,2707090,13,1,0,0,2
2707077,2707091,14,1,0,0,1
2707091,2707851,760,0,0,1,2
2707092,2707852,760,0,0,1,1
2707852,2708455,603,1,0,0,2
2707853,2708363,510,1,0,0,1
2707913,2708286,373,0,1,0,1
2707923,2708190,267,0,1,0,2
2708364,2708412,48,0,0,1,1
2708413,2708418,5,1,0,0,1
2708419,2708796,377,0,0,1,1
2708456,2708489,33,0,0,1,2
2708490,2708495,5,1,0,0,2
2708496,2708566,70,0,0,1,2
2708567,2708613,46,1,0,0,2
2708614,2708796,182,0,0,1,2
2708797,2708923,126,1,0,0,2
2708797,2709010,213,1,0,0,1
2708924,2709682,758,0,0,1,2
2709011,2709680,669,0,0,1,1
2709681,2709734,53,1,0,0,1
2709683,2709732,49,1,0,0,2
2709733,2709908,175,0,0,1,2
2709735,2709906,171,0,0,1,1
2709907,2709918,11,1,0,0,1
2709909,2709932,23,1,0,0,2
2709919,2710037,118,0,0,1,1
2709933,2710038,105,0,0,1,2
2710038,2710101,63,1,0,0,1
2710039,2710100,61,1,0,0,2
2710101,2710226,125,0,0,1,2
2710102,2710227,125,0,0,1,1
2710227,2710266,39,1,0,0,2
2710228,2710263,35,1,0,0,1
2710264,2710426,162,0,0,1,1
2710267,2711106,839,0,0,1,2
2710427,2710438,11,1,0,0,1
2710439,2711105,666,0,0,1,1
2711106,2711124,18,1,0,0,1
2711107,2711124,17,1,0,0,2
2711125,2711534,409,0,0,1,1
2711125,2711757,632,0,0,1,2
2711535,2711540,5,1,0,0,1
2711541,2711755,214,0,0,1,1
2711756,2711811,55,1,0,0,1
2711758,2711809,51,1,0,0,2
2711810,2711853,43,0,0,1,2
2711812,2711852,40,0,0,1,1
2711853,2711910,57,1,0,0,1
2711854,2711933,79,1,0,0,2
2711911,2712493,582,0,0,1,1
2711934,2712241,307,0,0,1,2
2712242,2712248,6,1,0,0,2
2712249,2712503,254,0,0,1,2
2712494,2712704,210,1,0,0,1
2712504,2712568,64,1,0,0,2
2712569,2712796,227,0,0,1,2
2712705,2712791,86,0,0,1,1
2712792,2713246,454,1,0,0,1
2712797,2713120,323,1,0,0,2
2712823,2713071,248,0,1,0,1
2712827,2713037,210,0,1,0,2
2713121,2713701,580,0,0,1,2
2713247,2713412,165,0,0,1,1
2713413,2713447,34,1,0,0,1
2713448,2713687,239,0,0,1,1
2713688,2714322,634,1,0,0,1
2713702,2713970,268,1,0,0,2
2713726,2713924,198,0,1,0,1
2713738,2713852,114,0,1,0,2
2713971,2714178,207,0,0,1,2
2714179,2714304,125,1,0,0,2
2714305,2714518,213,0,0,1,2
2714323,2714431,108,0,0,1,1
2714432,2714497,65,1,0,0,1
2714498,2714527,29,0,0,1,1
2714519,2714523,4,1,0,0,2
2714524,2714901,377,0,0,1,2
2714528,2714558,30,1,0,0,1
2714559,2714902,343,0,0,1,1
2714902,2714993,91,1,0,0,2
2714903,2715015,112,1,0,0,1
2714994,2715452,458,0,0,1,2
2715016,2715454,438,0,0,1,1
2715453,2715520,67,1,0,0,2
2715455,2715521,66,1,0,0,1
2715521,2715623,102,0,0,1,2
2715522,2715613,91,0,0,1,1
2715614,2717421,1807,1,0,0,1
2715624,2715677,53,1,0,0,2
2715678,2715898,220,0,0,1,2
2715899,2715917,18,1,0,0,2
2715918,2716191,273,0,0,1,2
2716192,2716202,10,1,0,0,2
2716203,2716446,243,0,0,1,2
2716447,2716457,10,1,0,0,2
2716458,2716960,502,0,0,1,2
2716958,2717369,411,0,1,0,1
2716961,2717254,293,1,0,0,2
2716993,2717192,199,0,1,0,2
2717255,2717339,84,0,0,1,2
2717340,2717421,81,1,0,0,2
2717422,2717630,208,0,0,1,1
2717422,2717821,399,0,0,1,2
2717631,2717700,69,1,0,0,1
2717701,2717780,79,0,0,1,1
2717781,2718506,725,1,0,0,1
2717822,2718150,328,1,0,0,2
2717837,2718286,449,0,1,0,1
2717849,2718101,252,0,1,0,2
2718151,2718368,217,0,0,1,2
2718369,2718388,19,1,0,0,2
2718389,2718597,208,0,0,1,2
2718507,2718533,26,0,0,1,1
2718534,2719051,517,1,0,0,1
2718598,2718925,327,1,0,0,2
2718611,2718984,373,0,1,0,1
2718634,2718862,228,0,1,0,2
2718926,2719280,354,0,0,1,2
2719052,2719170,118,0,0,1,1
2719171,2719207,36,1,0,0,1
2719208,2719274,66,0,0,1,1
2719275,2719974,699,1,0,0,1
2719281,2719766,485,1,0,0,2
2719301,2719743,442,0,1,0,1
2719308,2719750,442,0,1,0,2
2719767,2719894,127,0,0,1,2
2719895,2719972,77,1,0,0,2
2719973,2720614,641,0,0,1,2
2719975,2720615,640,0,0,1,1
2720615,2720700,85,1,0,0,2
2720616,2720711,95,1,0,0,1
2720701,2720978,277,0,0,1,2
2720712,2720977,265,0,0,1,1
2720978,2721008,30,1,0,0,1
2720979,2721006,27,1,0,0,2
2721007,2722505,1498,0,0,1,2
2721009,2721966,957,0,0,1,1
2721967,2721986,19,1,0,0,1
2721987,2722504,517,0,0,1,1
2722505,2722551,46,1,0,0,1
2722506,2722544,38,1,0,0,2
2722545,2723172,627,0,0,1,2
2722552,2723178,626,0,0,1,1
2723173,2723403,230,1,0,0,2
2723179,2723416,237,1,0,0,1
2723221,2723334,113,0,1,0,1
2723238,2723299,61,0,1,0,2
2723404,2723449,45,0,0,1,2
2723417,2723708,291,0,0,1,1
2723450,2723528,78,1,0,0,2
2723529,2723708,179,0,0,1,2
2723709,2723740,31,1,0,0,2
2723709,2723753,44,1,0,0,1
2723741,2724694,953,0,0,1,2
2723754,2724694,940,0,0,1,1
2724695,2724746,51,1,0,0,1
2724695,2724748,53,1,0,0,2
2724747,2724955,208,0,0,1,1
2724749,2724956,207,0,0,1,2
2724956,2725010,54,1,0,0,1
2724957,2725010,53,1,0,0,2
2725011,2725306,295,0,0,1,1
2725011,2725307,296,0,0,1,2
2725307,2725367,60,1,0,0,1
2725308,2725367,59,1,0,0,2
2725368,2725556,188,0,0,1,1
2725368,2725570,202,0,0,1,2
2725557,2725953,396,1,0,0,1
2725571,2725855,284,1,0,0,2
2725594,2725855,261,0,1,0,1
2725623,2725752,129,0,1,0,2
2725856,2726144,288,0,0,1,2
2725954,2726144,190,0,0,1,1
2726145,2726196,51,1,0,0,2
2726145,2726202,57,1,0,0,1
2726197,2726453,256,0,0,1,2
2726203,2726453,250,0,0,1,1
2726454,2726481,27,1,0,0,2
2726454,2726483,29,1,0,0,1
2726482,2727339,857,0,0,1,2
2726484,2727340,856,0,0,1,1
2727340,2727364,24,1,0,0,2
2727341,2727366,25,1,0,0,1
2727365,2727600,235,0,0,1,2
2727367,2727600,233,0,0,1,1
2727601,2727665,64,1,0,0,1
2727601,2727667,66,1,0,0,2
2727666,2728058,392,0,0,1,1
2727668,2728057,389,0,0,1,2
2728058,2728084,26,1,0,0,2
2728059,2728089,30,1,0,0,1
2728085,2728576,491,0,0,1,2
2728090,2728574,484,0,0,1,1
2728575,2728607,32,1,0,0,1
2728577,2728607,30,1,0,0,2
2728608,2729692,1084,0,0,1,1
2728608,2729693,1085,0,0,1,2
2729693,2729759,66,1,0,0,1
2729694,2729759,65,1,0,0,2
2729760,2729941,181,0,0,1,1
2729760,2729960,200,0,0,1,2
2729942,2730250,308,1,0,0,1
2729961,2730211,250,1,0,0,2
2729979,2730171,192,0,1,0,1
2730013,2730116,103,0,1,0,2
2730212,2730465,253,0,0,1,2
2730251,2730465,214,0,0,1,1
2730466,2730512,46,1,0,0,2
2730466,2730519,53,1,0,0,1
2730513,2730918,405,0,0,1,2
2730520,2730918,398,0,0,1,1
2730919,2730951,32,1,0,0,2
2730919,2730952,33,1,0,0,1
2730952,2731219,267,0,0,1,2
2730953,2731217,264,0,0,1,1
2731218,2731287,69,1,0,0,1
2731220,2731286,66,1,0,0,2
2731287,2731382,95,0,0,1,2
2731288,2731383,95,0,0,1,1
2731383,2731406,23,1,0,0,2
2731384,2731407,23,1,0,0,1
2731407,2731870,463,0,0,1,2
2731408,2732637,1229,0,0,1,1
2731871,2731884,13,1,0,0,2
2731885,2732638,753,0,0,1,2
2732638,2732662,24,1,0,0,1
2732639,2732664,25,1,0,0,2
2732663,2733094,431,0,0,1,1
2732665,2733093,428,0,0,1,2
2733094,2733157,63,1,0,0,2
2733095,2733156,61,1,0,0,1
2733157,2733267,110,0,0,1,1
2733158,2733265,107,0,0,1,2
2733266,2733303,37,1,0,0,2
2733268,2733302,34,1,0,0,1
2733303,2733824,521,0,0,1,1
2733304,2733825,521,0,0,1,2
2733825,2734201,376,1,0,0,1
2733826,2733848,22,1,0,0,2
2733849,2733889,40,0,0,1,2
2733890,2734088,198,1,0,0,2
2733896,2734108,212,0,1,0,1
2734089,2734234,145,0,0,1,2
2734202,2734231,29,0,0,1,1
2734232,2734295,63,1,0,0,1
2734235,2734253,18,1,0,0,2
2734254,2734619,365,0,0,1,2
2734296,2734618,322,0,0,1,1
2734619,2734640,21,1,0,0,1
2734620,2734646,26,1,0,0,2
2734641,2735263,622,0,0,1,1
2734647,2735274,627,0,0,1,2
2735264,2735578,314,1,0,0,1
2735275,2735486,211,1,0,0,2
2735294,2735492,198,0,1,0,1
2735317,2735426,109,0,1,0,2
2735487,2735975,488,0,0,1,2
2735579,2735975,396,0,0,1,1
2735976,2736004,28,1,0,0,2
2735976,2736010,34,1,0,0,1
2736005,2736788,783,0,0,1,2
2736011,2736788,777,0,0,1,1
2736789,2736838,49,1,0,0,1
2736789,2736838,49,1,0,0,2
2736839,2736951,112,0,0,1,1
2736839,2736952,113,0,0,1,2
2736952,2736973,21,1,0,0,1
2736953,2736972,19,1,0,0,2
2736973,2737911,938,0,0,1,2
2736974,2737911,937,0,0,1,1
2737912,2737934,22,1,0,0,2
2737912,2737940,28,1,0,0,1
2737935,2738540,605,0,0,1,2
2737941,2738541,600,0,0,1,1
2738541,2738593,52,1,0,0,2
2738542,2738593,51,1,0,0,1
2738594,2739036,442,0,0,1,1
2738594,2739062,468,0,0,1,2
2739037,2739387,350,1,0,0,1
2739063,2739238,175,1,0,0,2
2739069,2739274,205,0,1,0,1
2739105,2739138,33,0,1,0,2
2739239,2739477,238,0,0,1,2
2739388,2739458,70,0,0,1,1
2739459,2739771,312,1,0,0,1
2739478,2739696,218,1,0,0,2
2739492,2739720,228,0,1,0,1
2739514,2739629,115,0,1,0,2
2739697,2739933,236,0,0,1,2
2739772,2739933,161,0,0,1,1
2739934,2739959,25,1,0,0,1
2739934,2739962,28,1,0,0,2
2739960,2740153,193,0,0,1,1
2739963,2740151,188,0,0,1,2
2740152,2740167,15,1,0,0,2
2740154,2740166,12,1,0,0,1
2740167,2740702,535,0,0,1,1
2740168,2740705,537,0,0,1,2
2740703,2741077,374,1,0,0,1
2740706,2740965,259,1,0,0,2
2740736,2740970,234,0,1,0,1
2740766,2740860,94,0,1,0,2
2740966,2741361,395,0,0,1,2
2741078,2741361,283,0,0,1,1
2741362,2741405,43,1,0,0,2
2741362,2741406,44,1,0,0,1
2741406,2742210,804,0,0,1,2
2741407,2742210,803,0,0,1,1
2742211,2742254,43,1,0,0,2
2742211,2742255,44,1,0,0,1
2742255,2742463,208,0,0,1,2
2742256,2742463,207,0,0,1,1
2742464,2742532,68,1,0,0,1
2742464,2742534,70,1,0,0,2
2742533,2742684,151,0,0,1,1
2742535,2742685,150,0,0,1,2
2742685,2742714,29,1,0,0,1
2742686,2742706,20,1,0,0,2
2742707,2743870,1163,0,0,1,2
2742715,2743870,1155,0,0,1,1
2743871,2743920,49,1,0,0,2
2743871,2743922,51,1,0,0,1
2743921,2744315,394,0,0,1,2
2743923,2744317,394,0,0,1,1
2744316,2744332,16,1,0,0,2
2744318,2744332,14,1,0,0,1
2744333,2744395,62,0,0,1,1
2744333,2744430,97,0,0,1,2
2744396,2744751,355,1,0,0,1
2744431,2744627,196,1,0,0,2
2744441,2744600,159,0,1,0,1
2744624,2744680,56,0,1,0,1
2744628,2744686,58,0,0,1,2
2744687,2744702,15,1,0,0,2
2744703,2745049,346,0,0,1,2
2744752,2745052,300,0,0,1,1
2745050,2745066,16,1,0,0,2
2745053,2745077,24,1,0,0,1
2745067,2745155,88,0,0,1,2
2745078,2745144,66,0,0,1,1
2745145,2745592,447,1,0,0,1
2745156,2745441,285,1,0,0,2
2745169,2745504,335,0,1,0,1
2745185,2745356,171,0,1,0,2
2745442,2745507,65,0,0,1,2
2745508,2745530,22,1,0,0,2
2745531,2745678,147,0,0,1,2
2745593,2745678,85,0,0,1,1
2745679,2745700,21,1,0,0,2
2745679,2745708,29,1,0,0,1
2745701,2745826,125,0,0,1,2
2745709,2745828,119,0,0,1,1
2745827,2745849,22,1,0,0,2
2745829,2745846,17,1,0,0,1
2745847,2745924,77,0,0,1,1
2745850,2745920,70,0,0,1,2
2745921,2746256,335,1,0,0,2
2745925,2746470,545,1,0,0,1
2745957,2746245,288,0,1,0,1
2745975,2746158,183,0,1,0,2
2746257,2746421,164,0,0,1,2
2746422,2746448,26,1,0,0,2
2746449,2746624,175,0,0,1,2
2746471,2746622,151,0,0,1,1
2746623,2746646,23,1,0,0,1
2746625,2746644,19,1,0,0,2
2746645,2747256,611,0,0,1,2
2746647,2747256,609,0,0,1,1
2747257,2747294,37,1,0,0,1
2747257,2747300,43,1,0,0,2
2747295,2747772,477,0,0,1,1
2747301,2747772,471,0,0,1,2
2747773,2747800,27,1,0,0,1
2747773,2747800,27,1,0,0,2
2747801,2747863,62,0,0,1,1
2747801,2747879,78,0,0,1,2
2747864,2759824,11960,1,0,0,1
2747880,2759838,11958,1,0,0,2
2747896,2759795,11899,0,1,0,1
2747918,2759829,11911,0,1,0,2
2759825,2759885,60,0,0,1,1
2759839,2759867,28,0,0,1,2
2759868,2759899,31,1,0,0,2
2759886,2760022,136,1,0,0,1
2759900,2760026,126,0,0,1,2
2760023,2760080,57,0,0,1,1
2760027,2760045,18,1,0,0,2
2760046,2760086,40,0,0,1,2
2760081,2760428,347,1,0,0,1
2760087,2760383,296,1,0,0,2
2760108,2760342,234,0,1,0,1
2760119,2760306,187,0,1,0,2
2760384,2760435,51,0,0,1,2
2760429,2760557,128,0,0,1,1
2760436,2760446,10,1,0,0,2
2760447,2760802,355,0,0,1,2
2760558,2760661,103,1,0,0,1
2760662,2760803,141,0,0,1,1
2760803,2760835,32,1,0,0,2
2760804,2760835,31,1,0,0,1
2760836,2761055,219,0,0,1,1
2760836,2761055,219,0,0,1,2
2803738,2804035,297,0,0,1,1
2803738,2804035,297,0,0,1,2
2804036,2804107,71,1,0,0,2
2804036,2804115,79,1,0,0,1
2804108,2804252,144,0,0,1,2
2804116,2804251,135,0,0,1,1
2804252,2804289,37,1,0,0,1
2804253,2804281,28,1,0,0,2
2804282,2805861,1579,0,0,1,2
2804290,2805859,1569,0,0,1,1
2805860,2805962,102,1,0,0,1
2805862,2805960,98,1,0,0,2
2805961,2806217,256,0,0,1,2
2805963,2806219,256,0,0,1,1
2806218,2806300,82,1,0,0,2
2806220,2806295,75,1,0,0,1
2806296,2806498,202,0,0,1,1
2806301,2806502,201,0,0,1,2
2806499,2806520,21,1,0,0,1
2806503,2806518,15,1,0,0,2
2806519,2807950,1431,0,0,1,2
2806521,2807950,1429,0,0,1,1
2807951,2808040,89,1,0,0,1
2807951,2808043,92,1,0,0,2
2808041,2808342,301,0,0,1,1
2808044,2808344,300,0,0,1,2
2808343,2808394,51,1,0,0,1
2808345,2808395,50,1,0,0,2
2808395,2808543,148,0,0,1,1
2808396,2808544,148,0,0,1,2
2808544,2808571,27,1,0,0,1
2808545,2808572,27,1,0,0,2
2808572,2810056,1484,0,0,1,1
2808573,2810055,1482,0,0,1,2
2810056,2810111,55,1,0,0,2
2810057,2810110,53,1,0,0,1
2810111,2810487,376,0,0,1,1
2810112,2810486,374,0,0,1,2
2810487,2810552,65,1,0,0,2
2810488,2810558,70,1,0,0,1
2810553,2810678,125,0,0,1,2
2810559,2810679,120,0,0,1,1
2810679,2810705,26,1,0,0,2
2810680,2810705,25,1,0,0,1
2810706,2811956,1250,0,0,1,1
2810706,2811958,1252,0,0,1,2
2811957,2812055,98,1,0,0,1
2811959,2812052,93,1,0,0,2
2812053,2812427,374,0,0,1,2
2812056,2812427,371,0,0,1,1
2812428,2812482,54,1,0,0,1
2812428,2812482,54,1,0,0,2
2812483,2812680,197,0,0,1,1
2812483,2812682,199,0,0,1,2
2812681,2812700,19,1,0,0,1
2812683,2812699,16,1,0,0,2
2812700,2813903,1203,0,0,1,2
2812701,2813903,1202,0,0,1,1
2813904,2813941,37,1,0,0,1
2813904,2813945,41,1,0,0,2
2813942,2814222,280,0,0,1,1
2813946,2814222,276,0,0,1,2
2814223,2814274,51,1,0,0,2
2814223,2814276,53,1,0,0,1
2814275,2814333,58,0,0,1,2
2814277,2814332,55,0,0,1,1
2814333,2814414,81,1,0,0,1
2814334,2814405,71,1,0,0,2
2814406,2814472,66,0,0,1,2
2814415,2814472,57,0,0,1,1
2814473,2814502,29,1,0,0,2
2814473,2814514,41,1,0,0,1
2814503,2814687,184,0,0,1,2
2814515,2814686,171,0,0,1,1
2814687,2814715,28,1,0,0,1
2814688,2814709,21,1,0,0,2
2814710,2816178,1468,0,0,1,2
2814716,2816175,1459,0,0,1,1
2816176,2816274,98,1,0,0,1
2816179,2816276,97,1,0,0,2
2816275,2816665,390,0,0,1,1
2816277,2816665,388,0,0,1,2
2816666,2816733,67,1,0,0,1
2816666,2816736,70,1,0,0,2
2816734,2816821,87,0,0,1,1
2816737,2816821,84,0,0,1,2
2816822,2816857,35,1,0,0,1
2816822,2816858,36,1,0,0,2
2816858,2818454,1596,0,0,1,1
2816859,2818453,1594,0,0,1,2
2818454,2818606,152,1,0,0,2
2818455,2818607,152,1,0,0,1
2818607,2818862,255,0,0,1,2
2818608,2818861,253,0,0,1,1
2818862,2818936,74,1,0,0,1
2818863,2818934,71,1,0,0,2
2818935,2819010,75,0,0,1,2
2818937,2819009,72,0,0,1,1
2819010,2819055,45,1,0,0,1
2819011,2819056,45,1,0,0,2
2819056,2819347,291,0,0,1,1
2819057,2819345,288,0,0,1,2
2819346,2819374,28,1,0,0,2
2819348,2819373,25,1,0,0,1
2819374,2820605,1231,0,0,1,1
2819375,2820606,1231,0,0,1,2
2820606,2820774,168,1,0,0,1
2820607,2820745,138,1,0,0,2
2820746,2820769,23,0,0,1,2
2820770,2820794,24,1,0,0,2
2820775,2821076,301,0,0,1,1
2820795,2821077,282,0,0,1,2
2821077,2821153,76,1,0,0,1
2821078,2821154,76,1,0,0,2
2821154,2821294,140,0,0,1,1
2821155,2821304,149,0,0,1,2
2821295,2821323,28,1,0,0,1
2821305,2821326,21,1,0,0,2
2821324,2821554,230,0,0,1,1
2821327,2821556,229,0,0,1,2
2821555,2821586,31,1,0,0,1
2821557,2821585,28,1,0,0,2
2821586,2822793,1207,0,0,1,2
2821587,2822792,1205,0,0,1,1
2822793,2822820,27,1,0,0,1
2822794,2822821,27,1,0,0,2
2822821,2822932,111,0,0,1,1
2822822,2822931,109,0,0,1,2
2822932,2823066,134,1,0,0,2
2822933,2823068,135,1,0,0,1
2823067,2823404,337,0,0,1,2
2823069,2823405,336,0,0,1,1
2823405,2823485,80,1,0,0,2
2823406,2823487,81,1,0,0,1
2823486,2823594,108,0,0,1,2
2823488,2823591,103,0,0,1,1
2823592,2823640,48,1,0,0,1
2823595,2823633,38,1,0,0,2
2823634,2824251,617,0,0,1,2
2823641,2824251,610,0,0,1,1
2824252,2824274,22,1,0,0,1
2824252,2824274,22,1,0,0,2
2824275,2824449,174,0,0,1,1
2824275,2824449,174,0,0,1,2
2824450,2824460,10,1,0,0,1
2824450,2824461,11,1,0,0,2
2824461,2824933,472,0,0,1,1
2824462,2824934,472,0,0,1,2
2824934,2824953,19,1,0,0,1
2824935,2824952,17,1,0,0,2
2824953,2825119,166,0,0,1,2
2824954,2825117,163,0,0,1,1
2825118,2825139,21,1,0,0,1
2825120,2825135,15,1,0,0,2
2825136,2825170,34,0,0,1,2
2825140,2825167,27,0,0,1,1
2825168,2825374,206,1,0,0,1
2825171,2825372,201,1,0,0,2
2825373,2825669,296,0,0,1,2
2825375,2825675,300,0,0,1,1
2825670,2825774,104,1,0,0,2
2825676,2825790,114,1,0,0,1
2825775,2825852,77,0,0,1,2
2825791,2825851,60,0,0,1,1
2825852,2825879,27,1,0,0,1
2825853,2825877,24,1,0,0,2
2825878,2826329,451,0,0,1,2
2825880,2826327,447,0,0,1,1
2826328,2826342,14,1,0,0,1
2826330,2826336,6,1,0,0,2
2826337,2827045,708,0,0,1,2
2826343,2827045,702,0,0,1,1
2827046,2827064,18,1,0,0,2
2827046,2827072,26,1,0,0,1
2827065,2827616,551,0,0,1,2
2827073,2827624,551,0,0,1,1
2827617,2827800,183,1,0,0,2
2827625,2827934,309,1,0,0,1
2827684,2827741,57,0,1,0,1
2827801,2827824,23,0,0,1,2
2827825,2827831,6,1,0,0,2
2827832,2827856,24,0,0,1,2
2827857,2827953,96,1,0,0,2
2827935,2827964,29,0,0,1,1
2827954,2828175,221,0,0,1,2
2827965,2827980,15,1,0,0,1
2827981,2828174,193,0,0,1,1
2828175,2828232,57,1,0,0,1
2828176,2828229,53,1,0,0,2
2828230,2828315,85,0,0,1,2
2828233,2828314,81,0,0,1,1
2828315,2828344,29,1,0,0,1
2828316,2828360,44,1,0,0,2
2828345,2828473,128,0,0,1,1
2828361,2828473,112,0,0,1,2
2828474,2828504,30,1,0,0,1
2828474,2828505,31,1,0,0,2
2828505,2829110,605,0,0,1,1
2828506,2829113,607,0,0,1,2
2829111,2829132,21,1,0,0,1
2829114,2829133,19,1,0,0,2
2829133,2829643,510,0,0,1,1
2829134,2829645,511,0,0,1,2
2829644,2829660,16,1,0,0,1
2829646,2829651,5,1,0,0,2
2829652,2830249,597,0,0,1,2
2829661,2830211,550,0,0,1,1
2830212,2830427,215,1,0,0,1
2830250,2830295,45,1,0,0,2
2830296,2830389,93,0,0,1,2
2830390,2830398,8,1,0,0,2
2830399,2830619,220,0,0,1,2
2830428,2830588,160,0,0,1,1
2830589,2830593,4,1,0,0,1
2830594,2830655,61,0,0,1,1
2830620,2830630,10,1,0,0,2
2830631,2830655,24,0,0,1,2
2830656,2830662,6,1,0,0,2
2830656,2830664,8,1,0,0,1
2830663,2830722,59,0,0,1,2
2830665,2830733,68,0,0,1,1
2830723,2830835,112,1,0,0,2
2830734,2830839,105,1,0,0,1
2830836,2830903,67,0,0,1,2
2830840,2830906,66,0,0,1,1
2830904,2830931,27,1,0,0,2
2830907,2830947,40,1,0,0,1
2830932,2830975,43,0,0,1,2
2830948,2830969,21,0,0,1,1
2830970,2830986,16,1,0,0,1
2830976,2830984,8,1,0,0,2
2830985,2831074,89,0,0,1,2
2830987,2831071,84,0,0,1,1
2831072,2831108,36,1,0,0,1
2831075,2831099,24,1,0,0,2
2831100,2831223,123,0,0,1,2
2831109,2831224,115,0,0,1,1
2831224,2831246,22,1,0,0,2
2831225,2831247,22,1,0,0,1
2831247,2832792,1545,0,0,1,2
2831248,2832783,1535,0,0,1,1
2832784,2833012,228,1,0,0,1
2832793,2833004,211,1,0,0,2
2832834,2832948,114,0,1,0,1
2832838,2832926,88,0,1,0,2
2833005,2833079,74,0,0,1,2
2833013,2833234,221,0,0,1,1
2833080,2833095,15,1,0,0,2
2833096,2833238,142,0,0,1,2
2833235,2833331,96,1,0,0,1
2833239,2833330,91,1,0,0,2
2833331,2833396,65,0,0,1,2
2833332,2833393,61,0,0,1,1
2833394,2833474,80,1,0,0,1
2833397,2833428,31,1,0,0,2
2833429,2833580,151,0,0,1,2
2833475,2833581,106,0,0,1,1
2833581,2833609,28,1,0,0,2
2833582,2833614,32,1,0,0,1
2833610,2833747,137,0,0,1,2
2833615,2833746,131,0,0,1,1
2833747,2833770,23,1,0,0,1
2833748,2833770,22,1,0,0,2
2833771,2833812,41,0,0,1,2
2833771,2834141,370,0,0,1,1
2833813,2833825,12,1,0,0,2
2833826,2834135,309,0,0,1,2
2834136,2834156,20,1,0,0,2
2834142,2834150,8,1,0,0,1
2834151,2834704,553,0,0,1,1
2834157,2834432,275,0,0,1,2
2834433,2834450,17,1,0,0,2
2834451,2834709,258,0,0,1,2
2834705,2835003,298,1,0,0,1
2834710,2834919,209,1,0,0,2
2834732,2834926,194,0,1,0,1
2834746,2834876,130,0,1,0,2
2834920,2835202,282,0,0,1,2
2835004,2835201,197,0,0,1,1
2835202,2835225,23,1,0,0,1
2835203,2835225,22,1,0,0,2
2835226,2835369,143,0,0,1,1
2835226,2835385,159,0,0,1,2
2835370,2835807,437,1,0,0,1
2835386,2835633,247,1,0,0,2
2835390,2835628,238,0,1,0,1
2835409,2835602,193,0,1,0,2
2835634,2835834,200,0,0,1,2
2835808,2835832,24,0,0,1,1
2835833,2835906,73,1,0,0,1
2835835,2835906,71,1,0,0,2
2835907,2836062,155,0,0,1,2
2835907,2836064,157,0,0,1,1
2836063,2836136,73,1,0,0,2
2836065,2836149,84,1,0,0,1
2836137,2836247,110,0,0,1,2
2836150,2836248,98,0,0,1,1
2836248,2836282,34,1,0,0,2
2836249,2836281,32,1,0,0,1
2836282,2837080,798,0,0,1,1
2836283,2837085,802,0,0,1,2
2837081,2837110,29,1,0,0,1
2837086,2837101,15,1,0,0,2
2837102,2837751,649,0,0,1,2
2837111,2837750,639,0,0,1,1
2837751,2837848,97,1,0,0,1
2837752,2837848,96,1,0,0,2
2837849,2838202,353,0,0,1,1
2837849,2838202,353,0,0,1,2
2838203,2838276,73,1,0,0,2
2838203,2838289,86,1,0,0,1
2838277,2838431,154,0,0,1,2
2838290,2838431,141,0,0,1,1
2838432,2838452,20,1,0,0,1
2838432,2838452,20,1,0,0,2
2838453,2839899,1446,0,0,1,2
2838453,2839901,1448,0,0,1,1
2839900,2839976,76,1,0,0,2
2839902,2839977,75,1,0,0,1
2839977,2840228,251,0,0,1,2
2839978,2840228,250,0,0,1,1
2840229,2840279,50,1,0,0,1
2840229,2840281,52,1,0,0,2
2840280,2840406,126,0,0,1,1
2840282,2840405,123,0,0,1,2
2840406,2840468,62,1,0,0,2
2840407,2840479,72,1,0,0,1
2840469,2840787,318,0,0,1,2
2840480,2840787,307,0,0,1,1
2840788,2840803,15,1,0,0,2
2840788,2840808,20,1,0,0,1
2840804,2841894,1090,0,0,1,2
2840809,2841894,1085,0,0,1,1
2841895,2841976,81,1,0,0,1
2841895,2841976,81,1,0,0,2
2841977,2842318,341,0,0,1,2
2841977,2842319,342,0,0,1,1
2842319,2842355,36,1,0,0,2
2842320,2842357,37,1,0,0,1
2842356,2842552,196,0,0,1,2
2842358,2842552,194,0,0,1,1
2842553,2842562,9,1,0,0,2
2842553,2842564,11,1,0,0,1
2842563,2843888,1325,0,0,1,2
2842565,2843887,1322,0,0,1,1
2843888,2843940,52,1,0,0,1
2843889,2843941,52,1,0,0,2
2843941,2844387,446,0,0,1,1
2843942,2844388,446,0,0,1,2
2844388,2844472,84,1,0,0,1
2844389,2844460,71,1,0,0,2
2844461,2844561,100,0,0,1,2
2844473,2844560,87,0,0,1,1
2844561,2844597,36,1,0,0,1
2844562,2844594,32,1,0,0,2
2844595,2845873,1278,0,0,1,2
2844598,2845875,1277,0,0,1,1
2845874,2845932,58,1,0,0,2
2845876,2845932,56,1,0,0,1
2845933,2846316,383,0,0,1,2
2845933,2846317,384,0,0,1,1
2846317,2846448,131,1,0,0,2
2846318,2846452,134,1,0,0,1
2846449,2846527,78,0,0,1,2
2846453,2846485,32,0,0,1,1
2846486,2848077,1591,1,0,0,1
2846528,2846583,55,1,0,0,2
2846584,2846667,83,0,0,1,2
2846668,2846700,32,1,0,0,2
2846701,2847973,1272,0,0,1,2
2847974,2848087,113,1,0,0,2
2848078,2848409,331,0,0,1,1
2848088,2848409,321,0,0,1,2
2848410,2848453,43,1,0,0,2
2848410,2848456,46,1,0,0,1
2848454,2849688,1234,0,0,1,2
2848457,2849687,1230,0,0,1,1
2849688,2849717,29,1,0,0,1
2849689,2849721,32,1,0,0,2
2849718,2849916,198,0,0,1,1
2849722,2849916,194,0,0,1,2
2849917,2849964,47,1,0,0,1
2849917,2849964,47,1,0,0,2
2849965,2850304,339,0,0,1,1
2849965,2850304,339,0,0,1,2
2850305,2850348,43,1,0,0,2
2850305,2850362,57,1,0,0,1
2850349,2851588,1239,0,0,1,2
2850363,2850573,210,0,0,1,1
2850574,2850578,4,1,0,0,1
2850579,2851588,1009,0,0,1,1
2851589,2851628,39,1,0,0,1
2851589,2851628,39,1,0,0,2
2851629,2852166,537,0,0,1,2
2851629,2852167,538,0,0,1,1
2852167,2852213,46,1,0,0,2
2852168,2852222,54,1,0,0,1
2852214,2852316,102,0,0,1,2
2852223,2852314,91,0,0,1,1
2852315,2852346,31,1,0,0,1
2852317,2852345,28,1,0,0,2
2852346,2853679,1333,0,0,1,2
2852347,2853680,1333,0,0,1,1
2853680,2853753,73,1,0,0,2
2853681,2853759,78,1,0,0,1
2853754,2854062,308,0,0,1,2
2853760,2854063,303,0,0,1,1
2854063,2854100,37,1,0,0,2
2854064,2854099,35,1,0,0,1
2854100,2854206,106,0,0,1,1
2854101,2854206,105,0,0,1,2
2854207,2854280,73,1,0,0,2
2854207,2854282,75,1,0,0,1
2854281,2854390,109,0,0,1,2
2854283,2854387,104,0,0,1,1
2854388,2854425,37,1,0,0,1
2854391,2854420,29,1,0,0,2
2854421,2855873,1452,0,0,1,2
2854426,2855877,1451,0,0,1,1
2855874,2855931,57,1,0,0,2
2855878,2855930,52,1,0,0,1
2855931,2856293,362,0,0,1,1
2855932,2856296,364,0,0,1,2
2856294,2856388,94,1,0,0,1
2856297,2856379,82,1,0,0,2
2856380,2856511,131,0,0,1,2
2856389,2856510,121,0,0,1,1
2856511,2856546,35,1,0,0,1
2856512,2856538,26,1,0,0,2
2856539,2857917,1378,0,0,1,2
2856547,2857917,1370,0,0,1,1
2857918,2857993,75,1,0,0,1
2857918,2858002,84,1,0,0,2
2857994,2858426,432,0,0,1,1
2858003,2858428,425,0,0,1,2
2858427,2858502,75,1,0,0,1
2858429,2858494,65,1,0,0,2
2858495,2858718,223,0,0,1,2
2858503,2858718,215,0,0,1,1
2858719,2858730,11,1,0,0,1
2858719,2858731,12,1,0,0,2
2858731,2860179,1448,0,0,1,1
2858732,2860181,1449,0,0,1,2
2860180,2860276,96,1,0,0,1
2860182,2860273,91,1,0,0,2
2860274,2860644,370,0,0,1,2
2860277,2860644,367,0,0,1,1
2860645,2860719,74,1,0,0,1
2860645,2860722,77,1,0,0,2
2860720,2860831,111,0,0,1,1
2860723,2860831,108,0,0,1,2
2860832,2860864,32,1,0,0,1
2860832,2860865,33,1,0,0,2
2860865,2862351,1486,0,0,1,1
2860866,2862352,1486,0,0,1,2
2862352,2862445,93,1,0,0,1
2862353,2862446,93,1,0,0,2
2862446,2862828,382,0,0,1,1
2862447,2862828,381,0,0,1,2
2862829,2862895,66,1,0,0,2
2862829,2862906,77,1,0,0,1
2862896,2863025,129,0,0,1,2
2862907,2863023,116,0,0,1,1
2863024,2863071,47,1,0,0,1
2863026,2863054,28,1,0,0,2
2863055,2863384,329,0,0,1,2
2863072,2863390,318,0,0,1,1
2863385,2863405,20,1,0,0,2
2863391,2863403,12,1,0,0,1
2863404,2864263,859,0,0,1,1
2863406,2864264,858,0,0,1,2
2864264,2864366,102,1,0,0,1
2864265,2864365,100,1,0,0,2
2864366,2864778,412,0,0,1,2
2864367,2864780,413,0,0,1,1
2864779,2864836,57,1,0,0,2
2864781,2864836,55,1,0,0,1
2864837,2864945,108,0,0,1,1
2864837,2864945,108,0,0,1,2
2864946,2864972,26,1,0,0,2
2864946,2864974,28,1,0,0,1
2864973,2865342,369,0,0,1,2
2864975,2865341,366,0,0,1,1
2865342,2865374,32,1,0,0,1
2865343,2865373,30,1,0,0,2
2865374,2866213,839,0,0,1,2
2865375,2866215,840,0,0,1,1
2866214,2866247,33,1,0,0,2
2866216,2866246,30,1,0,0,1
2866247,2866743,496,0,0,1,1
2866248,2866743,495,0,0,1,2
2866744,2866823,79,1,0,0,1
2866744,2866823,79,1,0,0,2
2866824,2866942,118,0,0,1,1
2866824,2866944,120,0,0,1,2
2866943,2866986,43,1,0,0,1
2866945,2866982,37,1,0,0,2
2866983,2868355,1372,0,0,1,2
2866987,2868354,1367,0,0,1,1
2868355,2868448,93,1,0,0,1
2868356,2868450,94,1,0,0,2
2868449,2868715,266,0,0,1,1
2868451,2868717,266,0,0,1,2
2868716,2868783,67,1,0,0,1
2868718,2868775,57,1,0,0,2
2868776,2869214,438,0,0,1,2
2868784,2869207,423,0,0,1,1
2869208,2869286,78,1,0,0,1
2869215,2869234,19,1,0,0,2
2869235,2870265,1030,0,0,1,2
2869287,2869750,463,0,0,1,1
2869751,2869766,15,1,0,0,1
2869767,2870265,498,0,0,1,1
2870266,2870312,46,1,0,0,2
2870266,2870313,47,1,0,0,1
2870313,2870552,239,0,0,1,2
2870314,2870553,239,0,0,1,1
2870553,2870583,30,1,0,0,2
2870554,2870585,31,1,0,0,1
2870584,2870646,62,0,0,1,2
2870586,2870653,67,0,0,1,1
2870647,2870935,288,1,0,0,2
2870654,2870978,324,1,0,0,1
2870700,2870896,196,0,1,0,1
2870702,2870872,170,0,1,0,2
2870936,2871039,103,0,0,1,2
2870979,2871036,57,0,0,1,1
2871037,2871069,32,1,0,0,1
2871040,2871075,35,1,0,0,2
2871070,2871152,82,0,0,1,1
2871076,2871152,76,0,0,1,2
2871153,2871180,27,1,0,0,2
2871153,2871181,28,1,0,0,1
2871181,2871966,785,0,0,1,2
2871182,2871963,781,0,0,1,1
2871964,2871987,23,1,0,0,1
2871967,2871985,18,1,0,0,2
2871986,2872489,503,0,0,1,2
2871988,2872489,501,0,0,1,1
2872490,2872646,156,1,0,0,2
2872490,2872650,160,1,0,0,1
2872647,2872990,343,0,0,1,2
2872651,2872990,339,0,0,1,1
2872991,2873066,75,1,0,0,1
2872991,2873067,76,1,0,0,2
2873067,2873181,114,0,0,1,1
2873068,2873179,111,0,0,1,2
2873180,2873195,15,1,0,0,2
2873182,2873196,14,1,0,0,1
2873196,2873359,163,0,0,1,2
2873197,2873361,164,0,0,1,1
2873360,2873379,19,1,0,0,2
2873362,2873378,16,1,0,0,1
2873379,2873606,227,0,0,1,1
2873380,2873607,227,0,0,1,2
2873607,2873611,4,1,0,0,1
2873608,2873619,11,1,0,0,2
2873612,2873822,210,0,0,1,1
2873620,2873820,200,0,0,1,2
2873821,2873833,12,1,0,0,2
2873823,2873834,11,1,0,0,1
2873834,2874082,248,0,0,1,2
2873835,2874085,250,0,0,1,1
2874083,2874377,294,1,0,0,2
2874086,2874354,268,1,0,0,1
2874121,2874222,101,0,1,0,1
2874123,2874216,93,0,1,0,2
2874355,2874422,67,0,0,1,1
2874378,2874554,176,0,0,1,2
2874423,2874430,7,1,0,0,1
2874431,2874560,129,0,0,1,1
2874555,2874720,165,1,0,0,2
2874561,2874722,161,1,0,0,1
2874721,2874788,67,0,0,1,2
2874723,2874778,55,0,0,1,1
2874779,2874810,31,1,0,0,1
2874789,2874797,8,1,0,0,2
2874798,2874940,142,0,0,1,2
2874811,2874939,128,0,0,1,1
2874940,2874971,31,1,0,0,1
2874941,2874962,21,1,0,0,2
2874963,2875022,59,0,0,1,2
2874972,2875023,51,0,0,1,1
2875023,2875140,117,1,0,0,2
2875024,2875142,118,1,0,0,1
2875141,2875245,104,0,0,1,2
2875143,2875244,101,0,0,1,1
2875245,2875278,33,1,0,0,1
2875246,2875276,30,1,0,0,2
2875277,2875467,190,0,0,1,2
2875279,2875467,188,0,0,1,1
2875468,2875490,22,1,0,0,2
2875468,2875497,29,1,0,0,1
2875491,2875725,234,0,0,1,2
2875498,2875725,227,0,0,1,1
2875726,2875745,19,1,0,0,1
2875726,2875746,20,1,0,0,2
2875746,2876219,473,0,0,1,1
2875747,2876224,477,0,0,1,2
2876220,2876239,19,1,0,0,1
2876225,2876239,14,1,0,0,2
2876240,2876401,161,0,0,1,1
2876240,2876402,162,0,0,1,2
2876402,2876413,11,1,0,0,1
2876403,2876408,5,1,0,0,2
2876409,2876941,532,0,0,1,2
2876414,2876941,527,0,0,1,1
2876942,2877004,62,1,0,0,1
2876942,2877005,63,1,0,0,2
2877005,2877097,92,0,0,1,1
2877006,2877098,92,0,0,1,2
2877098,2877112,14,1,0,0,1
2877099,2877112,13,1,0,0,2
2877113,2877151,38,0,0,1,1
2877113,2877199,86,0,0,1,2
2877152,2877229,77,1,0,0,1
2877200,2877227,27,1,0,0,2
2877228,2877271,43,0,0,1,2
2877230,2877297,67,0,0,1,1
2877272,2877304,32,1,0,0,2
2877298,2877305,7,1,0,0,1
2877305,2877549,244,0,0,1,2
2877306,2877549,243,0,0,1,1
2877550,2877638,88,1,0,0,1
2877550,2877639,89,1,0,0,2
2877639,2877756,117,0,0,1,1
2877640,2877760,120,0,0,1,2
2877757,2877793,36,1,0,0,1
2877761,2877795,34,1,0,0,2
2877794,2877926,132,0,0,1,1
2877796,2877924,128,0,0,1,2
2877925,2877946,21,1,0,0,2
2877927,2877946,19,1,0,0,1
2877947,2878029,82,0,0,1,2
2877947,2878030,83,0,0,1,1
2878030,2878049,19,1,0,0,2
2878031,2878049,18,1,0,0,1
2878050,2878181,131,0,0,1,2
2878050,2878869,819,0,0,1,1
2878182,2878194,12,1,0,0,2
2878195,2878868,673,0,0,1,2
2878869,2878889,20,1,0,0,2
2878870,2878890,20,1,0,0,1
2878890,2879056,166,0,0,1,2
2878891,2879057,166,0,0,1,1
2879057,2879076,19,1,0,0,2
2879058,2879075,17,1,0,0,1
2879076,2879578,502,0,0,1,1
2879077,2879568,491,0,0,1,2
2879569,2879590,21,1,0,0,2
2879579,2879591,12,1,0,0,1
2879591,2879641,50,0,0,1,2
2879592,2879640,48,0,0,1,1
2879641,2879676,35,1,0,0,1
2879642,2879646,4,1,0,0,2
2879647,2879707,60,0,0,1,2
2879677,2879705,28,0,0,1,1
2879706,2879723,17,1,0,0,1
2879708,2879728,20,1,0,0,2
2879724,2880113,389,0,0,1,1
2879729,2880113,384,0,0,1,2
2880114,2880213,99,1,0,0,2
2880114,2880214,100,1,0,0,1
2880214,2880343,129,0,0,1,2
2880215,2880339,124,0,0,1,1
2880340,2880377,37,1,0,0,1
2880344,2880378,34,1,0,0,2
2880378,2880586,208,0,0,1,1
2880379,2880585,206,0,0,1,2
2880586,2880610,24,1,0,0,2
2880587,2880618,31,1,0,0,1
2880611,2881794,1183,0,0,1,2
2880619,2881794,1175,0,0,1,1
2881795,2881816,21,1,0,0,2
2881795,2881818,23,1,0,0,1
2881817,2882224,407,0,0,1,2
2881819,2882225,406,0,0,1,1
2882225,2882278,53,1,0,0,2
2882226,2882306,80,1,0,0,1
2882279,2882299,20,0,0,1,2
2882300,2882307,7,1,0,0,2
2882307,2882334,27,0,0,1,1
2882308,2882333,25,0,0,1,2
2882334,2882415,81,1,0,0,2
2882335,2882417,82,1,0,0,1
2882416,2882609,193,0,0,1,2
2882418,2882609,191,0,0,1,1
2882610,2882661,51,1,0,0,1
2882610,2882661,51,1,0,0,2
2882662,2882770,108,0,0,1,2
2882662,2882772,110,0,0,1,1
2882771,2882809,38,1,0,0,2
2882773,2882803,30,1,0,0,1
2882804,2884208,1404,0,0,1,1
2882810,2884209,1399,0,0,1,2
2884209,2884260,51,1,0,0,1
2884210,2884247,37,1,0,0,2
2884248,2884630,382,0,0,1,2
2884261,2884630,369,0,0,1,1
2884631,2884700,69,1,0,0,2
2884631,2884709,78,1,0,0,1
2884701,2884834,133,0,0,1,2
2884710,2884834,124,0,0,1,1
2884835,2884884,49,1,0,0,1
2884835,2884886,51,1,0,0,2
2884885,2886443,1558,0,0,1,1
2884887,2886445,1558,0,0,1,2
2886444,2886487,43,1,0,0,1
2886446,2886484,38,1,0,0,2
2886485,2886845,360,0,0,1,2
2886488,2886846,358,0,0,1,1
2886846,2886909,63,1,0,0,2
2886847,2886909,62,1,0,0,1
2886910,2887097,187,0,0,1,1
2886910,2887098,188,0,0,1,2
2887098,2887118,20,1,0,0,1
2887099,2887109,10,1,0,0,2
2887110,2888383,1273,0,0,1,2
2887119,2888382,1263,0,0,1,1
2888383,2888466,83,1,0,0,1
2888384,2888470,86,1,0,0,2
2888467,2888803,336,0,0,1,1
2888471,2888803,332,0,0,1,2
2888804,2888880,76,1,0,0,2
2888804,2888890,86,1,0,0,1
2888881,2889092,211,0,0,1,2
2888891,2889093,202,0,0,1,1
2889093,2889110,17,1,0,0,2
2889094,2889114,20,1,0,0,1
2889111,2890204,1093,0,0,1,2
2889115,2890204,1089,0,0,1,1
2890205,2890304,99,1,0,0,1
2890205,2890306,101,1,0,0,2
2890305,2890809,504,0,0,1,1
2890307,2890810,503,0,0,1,2
2890810,2890874,64,1,0,0,1
2890811,2890881,70,1,0,0,2
2890875,2891282,407,0,0,1,1
2890882,2891282,400,0,0,1,2
2891283,2891298,15,1,0,0,1
2891283,2891307,24,1,0,0,2
2891299,2892448,1149,0,0,1,1
2891308,2892448,1140,0,0,1,2
2892449,2892528,79,1,0,0,1
2892449,2892528,79,1,0,0,2
2892529,2892918,389,0,0,1,2
2892529,2892920,391,0,0,1,1
2892919,2892975,56,1,0,0,2
2892921,2892975,54,1,0,0,1
2892976,2894486,1510,0,0,1,1
2892976,2894487,1511,0,0,1,2
2894487,2894618,131,1,0,0,1
2894488,2894617,129,1,0,0,2
2894618,2894990,372,0,0,1,2
2894619,2894992,373,0,0,1,1
2894991,2895084,93,1,0,0,2
2894993,2895079,86,1,0,0,1
2895080,2895164,84,0,0,1,1
2895085,2895165,80,0,0,1,2
2895165,2895207,42,1,0,0,1
2895166,2895203,37,1,0,0,2
2895204,2896777,1573,0,0,1,2
2895208,2896778,1570,0,0,1,1
2896778,2896901,123,1,0,0,2
2896779,2896907,128,1,0,0,1
2896902,2897251,349,0,0,1,2
2896908,2897251,343,0,0,1,1
2897252,2897295,43,1,0,0,1
2897252,2897303,51,1,0,0,2
2897296,2897428,132,0,0,1,1
2897304,2897431,127,0,0,1,2
2897429,2897452,23,1,0,0,1
2897432,2897450,18,1,0,0,2
2897451,2898849,1398,0,0,1,2
2897453,2898851,1398,0,0,1,1
2898850,2898891,41,1,0,0,2
2898852,2898888,36,1,0,0,1
2898889,2899426,537,0,0,1,1
2898892,2899427,535,0,0,1,2
2899427,2899509,82,1,0,0,1
2899428,2899508,80,1,0,0,2
2899509,2899602,93,0,0,1,2
2899510,2899603,93,0,0,1,1
2899603,2899638,35,1,0,0,2
2899604,2899640,36,1,0,0,1
2899639,2899827,188,0,0,1,2
2899641,2899827,186,0,0,1,1
2899828,2899851,23,1,0,0,2
2899828,2899858,30,1,0,0,1
2899852,2900215,363,0,0,1,2
2899859,2900212,353,0,0,1,1
2900213,2900232,19,1,0,0,1
2900216,2900233,17,1,0,0,2
2900233,2900438,205,0,0,1,1
2900234,2900439,205,0,0,1,2
2900439,2900456,17,1,0,0,1
2900440,2900459,19,1,0,0,2
2900457,2900675,218,0,0,1,1
2900460,2900674,214,0,0,1,2
2900675,2900692,17,1,0,0,2
2900676,2900693,17,1,0,0,1
2900693,2900918,225,0,0,1,2
2900694,2900917,223,0,0,1,1
2900918,2900964,46,1,0,0,1
2900919,2900945,26,1,0,0,2
2900946,2901034,88,0,0,1,2
2900965,2901036,71,0,0,1,1
2901035,2901141,106,1,0,0,2
2901037,2901122,85,1,0,0,1
2901123,2901183,60,0,0,1,1
2901142,2901180,38,0,0,1,2
2901181,2901203,22,1,0,0,2
2901184,2901206,22,1,0,0,1
2901204,2901443,239,0,0,1,2
2901207,2901441,234,0,0,1,1
2901442,2901518,76,1,0,0,1
2901444,2901508,64,1,0,0,2
2901509,2901608,99,0,0,1,2
2901519,2901609,90,0,0,1,1
2901609,2901641,32,1,0,0,2
2901610,2901641,31,1,0,0,1
2901642,2901862,220,0,0,1,2
2901642,2901867,225,0,0,1,1
2901863,2901882,19,1,0,0,2
2901868,2901886,18,1,0,0,1
2901883,2902080,197,0,0,1,2
2901887,2902076,189,0,0,1,1
2902077,2902115,38,1,0,0,1
2902081,2902099,18,1,0,0,2
2902100,2902619,519,0,0,1,2
2902116,2902618,502,0,0,1,1
2902619,2902640,21,1,0,0,1
2902620,2902638,18,1,0,0,2
2902639,2903079,440,0,0,1,2
2902641,2903078,437,0,0,1,1
2903079,2903288,209,1,0,0,1
2903080,2903102,22,1,0,0,2
2903103,2903129,26,0,0,1,2
2903130,2903287,157,1,0,0,2
2903161,2903258,97,0,1,0,1
2903288,2903771,483,0,0,1,2
2903289,2903774,485,0,0,1,1
2903772,2903855,83,1,0,0,2
2903775,2903852,77,1,0,0,1
2903853,2903951,98,0,0,1,1
2903856,2903953,97,0,0,1,2
2903952,2903989,37,1,0,0,1
2903954,2903996,42,1,0,0,2
2903990,2904185,195,0,0,1,1
2903997,2904186,189,0,0,1,2
2904186,2904206,20,1,0,0,1
2904187,2904216,29,1,0,0,2
2904207,2904449,242,0,0,1,1
2904217,2904444,227,0,0,1,2
2904445,2904469,24,1,0,0,2
2904450,2904468,18,1,0,0,1
2904469,2904640,171,0,0,1,1
2904470,2904639,169,0,0,1,2
2904640,2904695,55,1,0,0,2
2904641,2904657,16,1,0,0,1
2904658,2904994,336,0,0,1,1
2904696,2904990,294,0,0,1,2
2904991,2905169,178,1,0,0,2
2904995,2905007,12,1,0,0,1
2905008,2905482,474,0,0,1,1
2905170,2905238,68,0,0,1,2
2905239,2905261,22,1,0,0,2
2905262,2905470,208,0,0,1,2
2905471,2905908,437,1,0,0,2
2905483,2905906,423,1,0,0,1
2905498,2905806,308,0,1,0,1
2905519,2905680,161,0,1,0,2
2905725,2905743,18,0,1,0,2
2905907,2906160,253,0,0,1,1
2905909,2906160,251,0,0,1,2
2906161,2906273,112,1,0,0,2
2906161,2906278,117,1,0,0,1
2906274,2906438,164,0,0,1,2
2906279,2906438,159,0,0,1,1
2906439,2906456,17,1,0,0,2
2906439,2906458,19,1,0,0,1
2906457,2906657,200,0,0,1,2
2906459,2906656,197,0,0,1,1
2906657,2906679,22,1,0,0,1
2906658,2906679,21,1,0,0,2
2906680,2906832,152,0,0,1,1
2906680,2906832,152,0,0,1,2
2906833,2906852,19,1,0,0,2
2906833,2906853,20,1,0,0,1
2906853,2907792,939,0,0,1,2
2906854,2907794,940,0,0,1,1
2907793,2907801,8,1,0,0,2
2907795,2907812,17,1,0,0,1
2907802,2908025,223,0,0,1,2
2907813,2908173,360,0,0,1,1
2908026,2908039,13,1,0,0,2
2908040,2908177,137,0,0,1,2
2908174,2908192,18,1,0,0,1
2908178,2908188,10,1,0,0,2
2908189,2908214,25,0,0,1,2
2908193,2908297,104,0,0,1,1
2908215,2908222,7,1,0,0,2
2908223,2908294,71,0,0,1,2
2908295,2908306,11,1,0,0,2
2908298,2908307,9,1,0,0,1
2908307,2908476,169,0,0,1,2
2908308,2908477,169,0,0,1,1
2908477,2908720,243,1,0,0,2
2908478,2908742,264,1,0,0,1
2908507,2908666,159,0,1,0,1
2908509,2908613,104,0,1,0,2
2908721,2908825,104,0,0,1,2
2908743,2908826,83,0,0,1,1
2908826,2908951,125,1,0,0,2
2908827,2908952,125,1,0,0,1
2908952,2909057,105,0,0,1,2
2908953,2909058,105,0,0,1,1
2909058,2909191,133,1,0,0,2
2909059,2909098,39,1,0,0,1
2909099,2910456,1357,0,0,1,1
2909192,2909221,29,0,0,1,2
2909222,2909467,245,1,0,0,2
2909468,2909520,52,0,0,1,2
2909521,2909529,8,1,0,0,2
2909530,2910401,871,0,0,1,2
2910402,2910412,10,1,0,0,2
2910413,2910445,32,0,0,1,2
2910446,2910657,211,1,0,0,2
2910457,2910683,226,1,0,0,1
2910489,2910610,121,0,1,0,1
2910658,2910690,32,0,0,1,2
2910684,2911461,777,0,0,1,1
2910691,2910698,7,1,0,0,2
2910699,2911461,762,0,0,1,2
2911462,2911513,51,1,0,0,1
2911462,2911515,53,1,0,0,2
2911514,2911728,214,0,0,1,1
2911516,2911729,213,0,0,1,2
2911729,2911757,28,1,0,0,1
2911730,2911754,24,1,0,0,2
2911755,2911903,148,0,0,1,2
2911758,2911895,137,0,0,1,1
2911896,2912198,302,1,0,0,1
2911904,2912123,219,1,0,0,2
2911939,2912115,176,0,1,0,1
2911953,2912065,112,0,1,0,2
2912124,2912296,172,0,0,1,2
2912199,2912296,97,0,0,1,1
2912297,2912329,32,1,0,0,1
2912297,2912330,33,1,0,0,2
2912330,2913767,1437,0,0,1,1
2912331,2913768,1437,0,0,1,2
2913768,2913818,50,1,0,0,1
2913769,2913814,45,1,0,0,2
2913815,2914261,446,0,0,1,2
2913819,2914260,441,0,0,1,1
2914261,2914290,29,1,0,0,1
2914262,2914287,25,1,0,0,2
2914288,2915875,1587,0,0,1,2
2914291,2915875,1584,0,0,1,1
2915876,2915916,40,1,0,0,2
2915876,2915926,50,1,0,0,1
2915917,2916002,85,0,0,1,2
2915927,2916012,85,0,0,1,1
2916003,2916154,151,1,0,0,2
2916013,2916181,168,1,0,0,1
2916039,2916088,49,0,1,0,1
2916155,2916422,267,0,0,1,2
2916182,2916421,239,0,0,1,1
2916422,2916468,46,1,0,0,1
2916423,2916459,36,1,0,0,2
2916460,2916840,380,0,0,1,2
2916469,2916840,371,0,0,1,1
2916841,2916890,49,1,0,0,1
2916841,2916890,49,1,0,0,2
2916891,2917075,184,0,0,1,1
2916891,2917075,184,0,0,1,2
2917076,2917138,62,1,0,0,2
2917076,2917139,63,1,0,0,1
2917139,2917409,270,0,0,1,2
2917140,2917408,268,0,0,1,1
2917409,2917436,27,1,0,0,1
2917410,2917437,27,1,0,0,2
2917437,2918858,1421,0,0,1,1
2917438,2918858,1420,0,0,1,2
2918859,2918908,49,1,0,0,1
2918859,2918908,49,1,0,0,2
2918909,2919121,212,0,0,1,1
2918909,2919122,213,0,0,1,2
2919122,2919153,31,1,0,0,1
2919123,2919152,29,1,0,0,2
2919153,2920521,1368,0,0,1,2
2919154,2920522,1368,0,0,1,1
2920522,2920545,23,1,0,0,2
2920523,2920546,23,1,0,0,1
2920546,2920887,341,0,0,1,2
2920547,2920874,327,0,0,1,1
2920875,2921085,210,1,0,0,1
2920888,2921111,223,1,0,0,2
2920930,2921008,78,0,1,0,1
2921086,2921107,21,0,0,1,1
2921108,2921125,17,1,0,0,1
2921112,2921285,173,0,0,1,2
2921126,2921285,159,0,0,1,1
2921286,2921319,33,1,0,0,2
2921286,2921327,41,1,0,0,1
2921320,2922021,701,0,0,1,2
2921328,2922021,693,0,0,1,1
2922022,2922062,40,1,0,0,2
2922022,2922064,42,1,0,0,1
2922063,2922421,358,0,0,1,2
2922065,2922421,356,0,0,1,1
2922422,2922522,100,1,0,0,1
2922422,2922525,103,1,0,0,2
2922523,2922626,103,0,0,1,1
2922526,2922627,101,0,0,1,2
2922627,2922660,33,1,0,0,1
2922628,2922658,30,1,0,0,2
2922659,2924070,1411,0,0,1,2
2922661,2924069,1408,0,0,1,1
2924070,2924102,32,1,0,0,1
2924071,2924101,30,1,0,0,2
2924102,2924911,809,0,0,1,2
2924103,2924910,807,0,0,1,1
2924911,2924959,48,1,0,0,1
2924912,2924957,45,1,0,0,2
2924958,2925129,171,0,0,1,2
2924960,2925129,169,0,0,1,1
2925130,2925149,19,1,0,0,2
2925130,2925156,26,1,0,0,1
2925150,2925604,454,0,0,1,2
2925157,2925603,446,0,0,1,1
2925604,2925636,32,1,0,0,1
2925605,2925627,22,1,0,0,2
2925628,2925789,161,0,0,1,2
2925637,2925790,153,0,0,1,1
2925790,2925817,27,1,0,0,2
2925791,2925817,26,1,0,0,1
2925818,2926037,219,0,0,1,1
2925818,2926038,220,0,0,1,2
2926038,2926321,283,1,0,0,1
2926039,2926239,200,1,0,0,2
2926063,2926273,210,0,1,0,1
2926071,2926113,42,0,1,0,2
2926240,2926275,35,0,0,1,2
2926276,2926317,41,1,0,0,2
2926318,2926393,75,0,0,1,2
2926322,2926483,161,0,0,1,1
2926394,2926414,20,1,0,0,2
2926415,2926465,50,0,0,1,2
2926466,2927005,539,1,0,0,2
2926484,2926923,439,1,0,0,1
2926504,2926912,408,0,1,0,1
2926515,2926805,290,0,1,0,2
2926924,2927146,222,0,0,1,1
2927006,2927144,138,0,0,1,2
2927145,2927196,51,1,0,0,2
2927147,2927198,51,1,0,0,1
2927197,2927355,158,0,0,1,2
2927199,2927355,156,0,0,1,1
2927356,2927380,24,1,0,0,2
2927356,2927385,29,1,0,0,1
2927381,2927571,190,0,0,1,2
2927386,2927572,186,0,0,1,1
2927572,2927598,26,1,0,0,2
2927573,2927600,27,1,0,0,1
2927599,2928210,611,0,0,1,2
2927601,2928209,608,0,0,1,1
2928210,2928271,61,1,0,0,1
2928211,2928267,56,1,0,0,2
2928268,2928823,555,0,0,1,2
2928272,2928824,552,0,0,1,1
2928824,2928881,57,1,0,0,2
2928825,2928881,56,1,0,0,1
2928882,2928981,99,0,0,1,1
2928882,2928981,99,0,0,1,2
2928982,2929058,76,1,0,0,1
2928982,2929061,79,1,0,0,2
2929059,2931201,2142,0,0,1,1
2929062,2931201,2139,0,0,1,2
2931202,2931258,56,1,0,0,1
2931202,2931258,56,1,0,0,2
2931259,2931357,98,0,0,1,1
2931259,2931357,98,0,0,1,2
2931358,2931380,22,1,0,0,2
2931358,2931391,33,1,0,0,1
2931381,2931640,259,0,0,1,2
2931392,2931641,249,0,0,1,1
2931641,2931665,24,1,0,0,2
2931642,2931658,16,1,0,0,1
2931659,2932041,382,0,0,1,1
2931666,2932039,373,0,0,1,2
2932040,2932076,36,1,0,0,2
2932042,2932075,33,1,0,0,1
2932076,2932177,101,0,0,1,1
2932077,2932178,101,0,0,1,2
2932178,2932200,22,1,0,0,1
2932179,2932201,22,1,0,0,2
2932201,2932331,130,0,0,1,1
2932202,2932325,123,0,0,1,2
2932326,2932348,22,1,0,0,2
2932332,2932349,17,1,0,0,1
2932349,2932563,214,0,0,1,2
2932350,2932760,410,0,0,1,1
2932564,2932568,4,1,0,0,2
2932569,2932761,192,0,0,1,2
2932761,2932782,21,1,0,0,1
2932762,2932781,19,1,0,0,2
2932782,2932903,121,0,0,1,2
2932783,2932905,122,0,0,1,1
2932904,2932918,14,1,0,0,2
2932906,2932919,13,1,0,0,1
2932919,2933116,197,0,0,1,2
2932920,2933117,197,0,0,1,1
2933117,2933127,10,1,0,0,2
2933118,2933127,9,1,0,0,1
2933128,2933258,130,0,0,1,1
2933128,2933275,147,0,0,1,2
2933259,2933487,228,1,0,0,1
2933276,2933445,169,1,0,0,2
2933306,2933368,62,0,1,0,1
2933446,2933577,131,0,0,1,2
2933488,2933535,47,0,0,1,1
2933536,2933582,46,1,0,0,1
2933578,2933583,5,1,0,0,2
2933583,2934630,1047,0,0,1,1
2933584,2934629,1045,0,0,1,2
2934630,2934673,43,1,0,0,2
2934631,2934681,50,1,0,0,1
2934674,2935004,330,0,0,1,2
2934682,2935003,321,0,0,1,1
2935004,2935058,54,1,0,0,1
2935005,2935058,53,1,0,0,2
2935059,2935237,178,0,0,1,2
2935059,2935239,180,0,0,1,1
2935238,2935310,72,1,0,0,2
2935240,2935322,82,1,0,0,1
2935311,2935423,112,0,0,1,2
2935323,2935423,100,0,0,1,1
2935424,2935446,22,1,0,0,2
2935424,2935455,31,1,0,0,1
2935447,2936264,817,0,0,1,2
2935456,2936263,807,0,0,1,1
2936264,2936283,19,1,0,0,1
2936265,2936283,18,1,0,0,2
2936284,2936474,190,0,0,1,1
2936284,2936474,190,0,0,1,2
2936475,2936501,26,1,0,0,1
2936475,2936503,28,1,0,0,2
2936502,2936900,398,0,0,1,1
2936504,2936899,395,0,0,1,2
2936900,2936918,18,1,0,0,2
2936901,2936928,27,1,0,0,1
2936919,2937196,277,0,0,1,2
2936929,2937195,266,0,0,1,1
2937196,2937267,71,1,0,0,1
2937197,2937256,59,1,0,0,2
2937257,2937457,200,0,0,1,2
2937268,2937456,188,0,0,1,1
2937457,2937477,20,1,0,0,1
2937458,2937477,19,1,0,0,2
2937478,2937756,278,0,0,1,2
2937478,2937757,279,0,0,1,1
2937757,2938058,301,1,0,0,2
2937758,2938026,268,1,0,0,1
2937791,2937977,186,0,1,0,1
2937814,2937901,87,0,1,0,2
2938027,2938346,319,0,0,1,1
2938059,2938349,290,0,0,1,2
2938347,2938369,22,1,0,0,1
2938350,2938367,17,1,0,0,2
2938368,2938486,118,0,0,1,2
2938370,2938488,118,0,0,1,1
2938487,2938509,22,1,0,0,2
2938489,2938510,21,1,0,0,1
2938510,2938543,33,0,0,1,2
2938511,2939009,498,0,0,1,1
2938544,2938558,14,1,0,0,2
2938559,2939001,442,0,0,1,2
2939002,2939411,409,1,0,0,2
2939010,2939329,319,1,0,0,1
2939033,2939272,239,0,1,0,1
2939042,2939178,136,0,1,0,2
2939330,2939374,44,0,0,1,1
2939375,2939386,11,1,0,0,1
2939387,2939609,222,0,0,1,1
2939412,2939588,176,0,0,1,2
2939589,2939874,285,1,0,0,2
2939610,2939858,248,1,0,0,1
2939635,2939808,173,0,1,0,1
2939638,2939768,130,0,1,0,2
2939859,2940546,687,0,0,1,1
2939875,2940547,672,0,0,1,2
2940547,2940606,59,1,0,0,1
2940548,2940609,61,1,0,0,2
2940607,2940746,139,0,0,1,1
2940610,2940745,135,0,0,1,2
2940746,2940776,30,1,0,0,2
2940747,2940775,28,1,0,0,1
2940776,2941878,1102,0,0,1,1
2940777,2941879,1102,0,0,1,2
2941879,2941909,30,1,0,0,1
2941880,2941901,21,1,0,0,2
2941902,2941996,94,0,0,1,2
2941910,2941996,86,0,0,1,1
2941997,2942019,22,1,0,0,1
2941997,2942019,22,1,0,0,2
2942020,2942059,39,0,0,1,2
2942020,2942060,40,0,0,1,1
2942060,2942081,21,1,0,0,2
2942061,2942084,23,1,0,0,1
2942082,2942424,342,0,0,1,2
2942085,2942423,338,0,0,1,1
2942424,2942493,69,1,0,0,1
2942425,2942492,67,1,0,0,2
2942493,2942571,78,0,0,1,2
2942494,2942566,72,0,0,1,1
2942567,2942599,32,1,0,0,1
2942572,2942600,28,1,0,0,2
2942600,2943200,600,0,0,1,1
2942601,2943198,597,0,0,1,2
2943199,2943221,22,1,0,0,2
2943201,2943221,20,1,0,0,1
2943222,2943348,126,0,0,1,1
2943222,2943348,126,0,0,1,2
2943349,2943370,21,1,0,0,1
2943349,2943370,21,1,0,0,2
2943371,2943440,69,0,0,1,2
2943371,2943444,73,0,0,1,1
2943441,2943463,22,1,0,0,2
2943445,2943464,19,1,0,0,1
2943464,2943615,151,0,0,1,2
2943465,2943620,155,0,0,1,1
2943616,2943668,52,1,0,0,2
2943621,2943630,9,1,0,0,1
2943631,2943729,98,0,0,1,1
2943669,2943728,59,0,0,1,2
2943729,2944476,747,1,0,0,2
2943730,2945190,1460,1,0,0,1
2943749,2945133,1384,0,1,0,1
2943785,2943922,137,0,1,0,2
2944123,2944456,333,0,1,0,2
2944477,2944508,31,0,0,1,2
2944509,2945076,567,1,0,0,2
2944637,2944971,334,0,1,0,2
2945077,2945221,144,0,0,1,2
2945191,2945226,35,0,0,1,1
2945222,2945256,34,1,0,0,2
2945227,2945255,28,1,0,0,1
2945256,2945373,117,0,0,1,1
2945257,2945416,159,0,0,1,2
2945374,2945387,13,1,0,0,1
2945388,2945500,112,0,0,1,1
2945417,2945479,62,1,0,0,2
2945480,2945675,195,0,0,1,2
2945501,2945505,4,1,0,0,1
2945506,2945675,169,0,0,1,1
2945676,2945689,13,1,0,0,2
2945676,2945743,67,1,0,0,1
2945690,2946207,517,0,0,1,2
2945744,2945833,89,0,0,1,1
2945834,2945874,40,1,0,0,1
2945875,2945940,65,0,0,1,1
2945941,2945956,15,1,0,0,1
2945957,2946210,253,0,0,1,1
2946208,2946226,18,1,0,0,2
2946211,2946218,7,1,0,0,1
2946219,2946578,359,0,0,1,1
2946227,2946578,351,0,0,1,2
2946579,2946661,82,1,0,0,2
2946579,2946666,87,1,0,0,1
2946662,2946842,180,0,0,1,2
2946667,2946837,170,0,0,1,1
2946838,2946864,26,1,0,0,1
2946843,2946870,27,1,0,0,2
2946865,2947042,177,0,0,1,1
2946871,2947039,168,0,0,1,2
2947040,2947052,12,1,0,0,2
2947043,2947050,7,1,0,0,1
2947051,2947857,806,0,0,1,1
2947053,2947861,808,0,0,1,2
2947858,2947874,16,1,0,0,1
2947862,2947879,17,1,0,0,2
2947875,2948352,477,0,0,1,1
2947880,2948349,469,0,0,1,2
2948350,2948368,18,1,0,0,2
2948353,2948368,15,1,0,0,1
2948369,2949174,805,0,0,1,2
2948369,2949179,810,0,0,1,1
2949175,2949198,23,1,0,0,2
2949180,2949194,14,1,0,0,1
2949195,2949221,26,0,0,1,1
2949199,2949223,24,0,0,1,2
2949222,2949284,62,1,0,0,1
2949224,2949285,61,1,0,0,2
2949285,2949994,709,0,0,1,1
2949286,2949565,279,0,0,1,2
2949566,2949579,13,1,0,0,2
2949580,2949904,324,0,0,1,2
2949905,2949911,6,1,0,0,2
2949912,2950020,108,0,0,1,2
2949995,2951969,1974,1,0,0,1
2950021,2950286,265,1,0,0,2
2950043,2951600,1557,0,1,0,1
2950064,2950166,102,0,1,0,2
2950287,2950331,44,0,0,1,2
2950332,2951559,1227,1,0,0,2
2950378,2951525,1147,0,1,0,2
2951560,2951693,133,0,0,1,2
2951694,2951862,168,1,0,0,2
2951710,2951873,163,0,1,0,1
2951727,2951808,81,0,1,0,2
2951863,2952154,291,0,0,1,2
2951970,2952139,169,0,0,1,1
2952140,2952448,308,1,0,0,1
2952155,2952390,235,1,0,0,2
2952172,2952374,202,0,1,0,1
2952189,2952307,118,0,1,0,2
2952391,2952785,394,0,0,1,2
2952449,2952481,32,0,0,1,1
2952482,2952499,17,1,0,0,1
2952500,2952785,285,0,0,1,1
2952786,2952844,58,1,0,0,2
2952786,2952846,60,1,0,0,1
2952845,2953210,365,0,0,1,2
2952847,2953211,364,0,0,1,1
2953211,2953292,81,1,0,0,2
2953212,2953291,79,1,0,0,1
2953292,2953387,95,0,0,1,1
2953293,2953388,95,0,0,1,2
2953388,2953444,56,1,0,0,1
2953389,2953432,43,1,0,0,2
2953433,2953610,177,0,0,1,2
2953445,2953609,164,0,0,1,1
2953610,2953641,31,1,0,0,1
2953611,2953640,29,1,0,0,2
2953641,2954846,1205,0,0,1,2
2953642,2954845,1203,0,0,1,1
2954846,2954874,28,1,0,0,1
2954847,2954867,20,1,0,0,2
2954868,2955683,815,0,0,1,2
2954875,2955681,806,0,0,1,1
2955682,2955746,64,1,0,0,1
2955684,2955747,63,1,0,0,2
2955747,2956304,557,0,0,1,1
2955748,2956312,564,0,0,1,2
2956305,2956556,251,1,0,0,1
2956313,2956561,248,1,0,0,2
2956350,2956450,100,0,1,0,1
2956557,2957843,1286,0,0,1,1
2956562,2956587,25,0,0,1,2
2956588,2956606,18,1,0,0,2
2956607,2957841,1234,0,0,1,2
2957842,2958175,333,1,0,0,2
2957844,2958169,325,1,0,0,1
2957882,2958049,167,0,1,0,1
2957904,2957997,93,0,1,0,2
2958170,2958480,310,0,0,1,1
2958176,2958203,27,0,0,1,2
2958204,2958222,18,1,0,0,2
2958223,2958479,256,0,0,1,2
2958480,2958510,30,1,0,0,2
2958481,2958511,30,1,0,0,1
2958511,2958874,363,0,0,1,2
2958512,2958874,362,0,0,1,1
2958875,2958919,44,1,0,0,1
2958875,2958934,59,1,0,0,2
2958920,2959503,583,0,0,1,1
2958935,2959502,567,0,0,1,2
2959503,2959564,61,1,0,0,2
2959504,2959562,58,1,0,0,1
2959563,2959736,173,0,0,1,1
2959565,2959738,173,0,0,1,2
2959737,2959804,67,1,0,0,1
2959739,2959802,63,1,0,0,2
2959803,2960484,681,0,0,1,2
2959805,2960485,680,0,0,1,1
2960485,2960502,17,1,0,0,2
2960486,2960509,23,1,0,0,1
2960503,2961141,638,0,0,1,2
2960510,2961142,632,0,0,1,1
2961142,2961158,16,1,0,0,2
2961143,2961158,15,1,0,0,1
2961159,2961356,197,0,0,1,1
2961159,2961356,197,0,0,1,2
2961357,2961404,47,1,0,0,2
2961357,2961406,49,1,0,0,1
2961405,2961837,432,0,0,1,2
2961407,2961818,411,0,0,1,1
2961819,2962134,315,1,0,0,1
2961838,2962091,253,1,0,0,2
2961857,2962037,180,0,1,0,1
2961881,2961974,93,0,1,0,2
2962092,2962132,40,0,0,1,2
2962133,2962149,16,1,0,0,2
2962135,2962486,351,0,0,1,1
2962150,2962487,337,0,0,1,2
2962487,2962509,22,1,0,0,1
2962488,2962509,21,1,0,0,2
2962510,2963461,951,0,0,1,1
2962510,2963461,951,0,0,1,2
2963462,2963509,47,1,0,0,1
2963462,2963510,48,1,0,0,2
2963510,2963833,323,0,0,1,1
2963511,2963835,324,0,0,1,2
2963834,2963876,42,1,0,0,1
2963836,2963885,49,1,0,0,2
2963877,2964229,352,0,0,1,1
2963886,2964230,344,0,0,1,2
2964230,2964265,35,1,0,0,1
2964231,2964265,34,1,0,0,2
2964266,2964536,270,0,0,1,2
2964266,2964537,271,0,0,1,1
2964537,2964610,73,1,0,0,2
2964538,2964610,72,1,0,0,1
2964611,2964700,89,0,0,1,1
2964611,2964700,89,0,0,1,2
2964701,2964736,35,1,0,0,1
2964701,2964736,35,1,0,0,2
2964737,2965388,651,0,0,1,1
2964737,2965394,657,0,0,1,2
2965389,2965406,17,1,0,0,1
2965395,2965406,11,1,0,0,2
2965407,2965932,525,0,0,1,1
2965407,2965932,525,0,0,1,2
2965933,2965945,12,1,0,0,2
2965933,2965955,22,1,0,0,1
2965946,2966667,721,0,0,1,2
2965956,2966667,711,0,0,1,1
2966668,2966727,59,1,0,0,2
2966668,2966729,61,1,0,0,1
2966728,2967184,456,0,0,1,2
2966730,2967182,452,0,0,1,1
2967183,2967383,200,1,0,0,1
2967185,2967360,175,1,0,0,2
2967221,2967308,87,0,1,0,1
2967361,2968758,1397,0,0,1,2
2967384,2968756,1372,0,0,1,1
2968757,2968818,61,1,0,0,1
2968759,2968819,60,1,0,0,2
2968819,2969050,231,0,0,1,1
2968820,2969055,235,0,0,1,2
2969051,2969331,280,1,0,0,1
2969056,2969324,268,1,0,0,2
2969082,2969279,197,0,1,0,1
2969115,2969207,92,0,1,0,2
2969325,2969606,281,0,0,1,2
2969332,2969604,272,0,0,1,1
2969605,2969645,40,1,0,0,1
2969607,2969635,28,1,0,0,2
2969636,2970073,437,0,0,1,2
2969646,2970071,425,0,0,1,1
2970072,2970135,63,1,0,0,1
2970074,2970135,61,1,0,0,2
2970136,2970463,327,0,0,1,1
2970136,2970464,328,0,0,1,2
2970464,2970518,54,1,0,0,1
2970465,2970509,44,1,0,0,2
2970510,2970612,102,0,0,1,2
2970519,2970610,91,0,0,1,1
2970611,2970685,74,1,0,0,1
2970613,2970685,72,1,0,0,2
2970686,2971028,342,0,0,1,1
2970686,2971028,342,0,0,1,2
2971029,2971047,18,1,0,0,1
2971029,2971047,18,1,0,0,2
2971048,2972053,1005,0,0,1,1
2971048,2972053,1005,0,0,1,2
2972054,2972078,24,1,0,0,2
2972054,2972080,26,1,0,0,1
2972079,2972906,827,0,0,1,2
2972081,2972905,824,0,0,1,1
2972906,2972980,74,1,0,0,1
2972907,2972973,66,1,0,0,2
2972974,2974235,1261,0,0,1,2
2972981,2974218,1237,0,0,1,1
2974219,2974417,198,1,0,0,1
2974236,2974437,201,1,0,0,2
2974276,2974349,73,0,1,0,1
2974418,2975078,660,0,0,1,1
2974438,2975079,641,0,0,1,2
2975079,2975130,51,1,0,0,1
2975080,2975129,49,1,0,0,2
2975130,2975487,357,0,0,1,2
2975131,2975486,355,0,0,1,1
2975487,2975544,57,1,0,0,1
2975488,2975544,56,1,0,0,2
2975545,2975645,100,0,0,1,1
2975545,2976652,1107,0,0,1,2
2975646,2975650,4,1,0,0,1
2975651,2976651,1000,0,0,1,1
2976652,2976710,58,1,0,0,1
2976653,2976711,58,1,0,0,2
2976711,2976929,218,0,0,1,1
2976712,2976931,219,0,0,1,2
2976930,2977008,78,1,0,0,1
2976932,2977009,77,1,0,0,2
2977009,2977103,94,0,0,1,1
2977010,2977105,95,0,0,1,2
2977104,2977137,33,1,0,0,1
2977106,2977128,22,1,0,0,2
2977129,2978844,1715,0,0,1,2
2977138,2978843,1705,0,0,1,1
2978844,2978895,51,1,0,0,1
2978845,2978894,49,1,0,0,2
2978895,2980411,1516,0,0,1,2
2978896,2980388,1492,0,0,1,1
2980389,2980774,385,1,0,0,1
2980412,2980727,315,1,0,0,2
2980420,2980755,335,0,1,0,1
2980448,2980606,158,0,1,0,2
2980728,2981003,275,0,0,1,2
2980775,2981001,226,0,0,1,1
2981002,2981057,55,1,0,0,1
2981004,2981054,50,1,0,0,2
2981055,2982082,1027,0,0,1,2
2981058,2982081,1023,0,0,1,1
2982082,2982107,25,1,0,0,1
2982083,2982114,31,1,0,0,2
2982108,2982432,324,0,0,1,1
2982115,2982444,329,0,0,1,2
2982433,2982903,470,1,0,0,1
2982445,2982545,100,1,0,0,2
2982464,2982629,165,0,1,0,1
2982546,2982866,320,0,0,1,2
2982867,2982880,13,1,0,0,2
2982881,2983837,956,0,0,1,2
2982904,2982946,42,0,0,1,1
2982947,2983133,186,1,0,0,1
2983134,2983183,49,0,0,1,1
2983184,2983255,71,1,0,0,1
2983256,2983277,21,0,0,1,1
2983278,2983794,516,1,0,0,1
2983795,2983829,34,0,0,1,1
2983830,2983962,132,1,0,0,1
2983838,2983859,21,1,0,0,2
2983860,2984743,883,0,0,1,2
2983963,2983997,34,0,0,1,1
2983998,2984153,155,1,0,0,1
2984154,2984177,23,0,0,1,1
2984178,2984587,409,1,0,0,1
2984588,2984731,143,0,0,1,1
2984732,2984815,83,1,0,0,1
2984744,2984808,64,1,0,0,2
2984809,2984892,83,0,0,1,2
2984816,2984891,75,0,0,1,1
2984892,2984928,36,1,0,0,1
2984893,2984914,21,1,0,0,2
2984915,2985216,301,0,0,1,2
2984929,2985204,275,0,0,1,1
2985205,2987174,1969,1,0,0,1
2985217,2985427,210,1,0,0,2
2985224,2987163,1939,0,1,0,1
2985256,2985334,78,0,1,0,2
2985428,2985451,23,0,0,1,2
2985452,2985466,14,1,0,0,2
2985467,2986110,643,0,0,1,2
2986111,2986139,28,1,0,0,2
2986140,2986842,702,0,0,1,2
2986843,2987133,290,1,0,0,2
2986888,2987048,160,0,1,0,2
2987134,2987233,99,0,0,1,2
2987175,2987234,59,0,0,1,1
2987234,2987305,71,1,0,0,2
2987235,2987306,71,1,0,0,1
2987306,2988398,1092,0,0,1,2
2987307,2988399,1092,0,0,1,1
2988399,2988443,44,1,0,0,2
2988400,2988443,43,1,0,0,1
2988444,2988764,320,0,0,1,1
2988444,2988764,320,0,0,1,2
2988765,2988842,77,1,0,0,2
2988765,2988851,86,1,0,0,1
2988843,2988966,123,0,0,1,2
2988852,2988965,113,0,0,1,1
2988966,2988983,17,1,0,0,1
2988967,2988982,15,1,0,0,2
2988983,2990167,1184,0,0,1,2
2988984,2990166,1182,0,0,1,1
2990167,2990193,26,1,0,0,1
2990168,2990185,17,1,0,0,2
2990186,2990560,374,0,0,1,2
2990194,2990560,366,0,0,1,1
2990561,2990609,48,1,0,0,1
2990561,2990610,49,1,0,0,2
2990610,2991088,478,0,0,1,1
2990611,2991104,493,0,0,1,2
2991089,2991339,250,1,0,0,1
2991105,2991284,179,1,0,0,2
2991128,2991271,143,0,1,0,1
2991164,2991190,26,0,1,0,2
2991285,2991546,261,0,0,1,2
2991340,2991548,208,0,0,1,1
2991547,2991729,182,1,0,0,2
2991549,2991779,230,1,0,0,1
2991572,2991723,151,0,1,0,1
2991581,2991663,82,0,1,0,2
2991730,2992637,907,0,0,1,2
2991780,2992633,853,0,0,1,1
2992634,2992863,229,1,0,0,1
2992638,2992841,203,1,0,0,2
2992657,2992809,152,0,1,0,1
2992672,2992763,91,0,1,0,2
2992842,2993490,648,0,0,1,2
2992864,2993489,625,0,0,1,1
2993490,2993551,61,1,0,0,1
2993491,2993545,54,1,0,0,2
2993546,2993862,316,0,0,1,2
2993552,2993863,311,0,0,1,1
2993863,2993923,60,1,0,0,2
2993864,2993924,60,1,0,0,1
2993924,2994065,141,0,0,1,2
2993925,2994065,140,0,0,1,1
2994066,2994138,72,1,0,0,1
2994066,2994139,73,1,0,0,2
2994139,2994227,88,0,0,1,1
2994140,2994228,88,0,0,1,2
2994228,2994262,34,1,0,0,1
2994229,2994261,32,1,0,0,2
2994262,2995753,1491,0,0,1,2
2994263,2995754,1491,0,0,1,1
2995754,2995773,19,1,0,0,2
2995755,2995772,17,1,0,0,1
2995773,2995919,146,0,0,1,1
2995774,2995919,145,0,0,1,2
2995920,2995970,50,1,0,0,1
2995920,2995972,52,1,0,0,2
2995971,2996117,146,0,0,1,1
2995973,2996134,161,0,0,1,2
2996118,2996395,277,1,0,0,1
2996135,2996345,210,1,0,0,2
2996154,2996340,186,0,1,0,1
2996180,2996277,97,0,1,0,2
2996346,2997988,1642,0,0,1,2
2996396,2997970,1574,0,0,1,1
2997971,2998256,285,1,0,0,1
2997989,2998212,223,1,0,0,2
2998005,2998196,191,0,1,0,1
2998024,2998133,109,0,1,0,2
2998213,2998417,204,0,0,1,2
2998257,2998308,51,0,0,1,1
2998309,2998317,8,1,0,0,1
2998318,2998415,97,0,0,1,1
2998416,2998474,58,1,0,0,1
2998418,2998472,54,1,0,0,2
2998473,2998726,253,0,0,1,2
2998475,2998728,253,0,0,1,1
2998727,2998791,64,1,0,0,2
2998729,2998793,64,1,0,0,1
2998792,2999183,391,0,0,1,2
2998794,2999183,389,0,0,1,1
2999184,2999253,69,1,0,0,2
2999184,2999262,78,1,0,0,1
2999254,2999313,59,0,0,1,2
2999263,2999312,49,0,0,1,1
2999313,2999349,36,1,0,0,1
2999314,2999349,35,1,0,0,2
2999350,2999533,183,0,0,1,1
2999350,2999534,184,0,0,1,2
2999534,2999564,30,1,0,0,1
2999535,2999562,27,1,0,0,2
2999563,3001390,1827,0,0,1,2
2999565,3001389,1824,0,0,1,1
3001390,3001442,52,1,0,0,1
3001391,3001441,50,1,0,0,2
3001442,3002390,948,0,0,1,2
3001443,3002389,946,0,0,1,1
3002390,3002411,21,1,0,0,1
3002391,3002410,19,1,0,0,2
3002411,3003391,980,0,0,1,2
3002412,3003358,946,0,0,1,1
3003359,3003810,451,1,0,0,1
3003392,3003659,267,1,0,0,2
3003396,3003768,372,0,1,0,1
3003424,3003570,146,0,1,0,2
3003660,3003840,180,0,0,1,2
3003811,3003839,28,0,0,1,1
3003840,3003925,85,1,0,0,1
3003841,3003872,31,1,0,0,2
3003873,3004159,286,0,0,1,2
3003926,3004023,97,0,0,1,1
3004024,3004066,42,1,0,0,1
3004067,3004159,92,0,0,1,1
3004160,3004213,53,1,0,0,1
3004160,3004213,53,1,0,0,2
3004214,3004464,250,0,0,1,2
3004214,3004466,252,0,0,1,1
3004465,3004517,52,1,0,0,2
3004467,3004516,49,1,0,0,1
3004517,3005015,498,0,0,1,1
3004518,3005014,496,0,0,1,2
3005015,3005091,76,1,0,0,2
3005016,3005095,79,1,0,0,1
3005092,3005287,195,0,0,1,2
3005096,3005287,191,0,0,1,1
3005288,3005375,87,1,0,0,1
3005288,3005378,90,1,0,0,2
3005376,3005473,97,0,0,1,1
3005379,3005475,96,0,0,1,2
3005474,3005507,33,1,0,0,1
3005476,3005508,32,1,0,0,2
3005508,3006809,1301,0,0,1,1
3005509,3006809,1300,0,0,1,2
3006810,3006858,48,1,0,0,2
3006810,3006861,51,1,0,0,1
3006859,3007293,434,0,0,1,2
3006862,3007254,392,0,0,1,1
3007255,3007356,101,1,0,0,1
3007294,3007319,25,1,0,0,2
3007320,3007542,222,0,0,1,2
3007357,3007533,176,0,0,1,1
3007534,3007866,332,1,0,0,1
3007543,3007797,254,1,0,0,2
3007565,3007772,207,0,1,0,1
3007572,3007744,172,0,1,0,2
3007798,3008908,1110,0,0,1,2
3007867,3008900,1033,0,0,1,1
3008901,3009162,261,1,0,0,1
3008909,3009115,206,1,0,0,2
3008937,3009099,162,0,1,0,1
3008967,3009033,66,0,1,0,2
3009116,3009391,275,0,0,1,2
3009163,3009209,46,0,0,1,1
3009210,3009225,15,1,0,0,1
3009226,3009391,165,0,0,1,1
3009392,3009442,50,1,0,0,1
3009392,3009444,52,1,0,0,2
3009443,3009614,171,0,0,1,1
3009445,3009614,169,0,0,1,2
3009615,3009672,57,1,0,0,2
3009615,3009681,66,1,0,0,1
3009673,3010083,410,0,0,1,2
3009682,3010084,402,0,0,1,1
3010084,3010163,79,1,0,0,2
3010085,3010166,81,1,0,0,1
3010164,3010290,126,0,0,1,2
3010167,3010289,122,0,0,1,1
3010290,3010329,39,1,0,0,1
3010291,3010325,34,1,0,0,2
3010326,3011985,1659,0,0,1,2
3010330,3011985,1655,0,0,1,1
3011986,3012034,48,1,0,0,2
3011986,3012040,54,1,0,0,1
3012035,3013354,1319,0,0,1,2
3012041,3013356,1315,0,0,1,1
3013355,3013465,110,1,0,0,2
3013357,3013463,106,1,0,0,1
3013464,3013701,237,0,0,1,1
3013466,3013700,234,0,0,1,2
3013701,3013878,177,1,0,0,2
3013702,3013868,166,1,0,0,1
3013737,3013785,48,0,1,0,1
3013869,3014144,275,0,0,1,1
3013879,3014145,266,0,0,1,2
3014145,3014208,63,1,0,0,1
3014146,3014208,62,1,0,0,2
3014209,3014371,162,0,0,1,1
3014209,3014373,164,0,0,1,2
3014372,3014417,45,1,0,0,1
3014374,3014431,57,1,0,0,2
3014418,3014698,280,0,0,1,1
3014432,3014699,267,0,0,1,2
3014699,3014905,206,1,0,0,1
3014700,3014828,128,1,0,0,2
3014745,3014785,40,0,1,0,1
3014829,3015401,572,0,0,1,2
3014906,3015401,495,0,0,1,1
3015402,3015463,61,1,0,0,1
3015402,3015464,62,1,0,0,2
3015464,3015641,177,0,0,1,1
3015465,3015641,176,0,0,1,2
3015642,3015682,40,1,0,0,2
3015642,3015685,43,1,0,0,1
3015683,3015823,140,0,0,1,2
3015686,3015824,138,0,0,1,1
3015824,3015846,22,1,0,0,2
3015825,3015854,29,1,0,0,1
3015847,3017510,1663,0,0,1,2
3015855,3017509,1654,0,0,1,1
3017510,3017565,55,1,0,0,1
3017511,3017569,58,1,0,0,2
3017566,3017761,195,0,0,1,1
3017570,3017760,190,0,0,1,2
3017761,3017793,32,1,0,0,2
3017762,3017793,31,1,0,0,1
3017794,3019526,1732,0,0,1,1
3017794,3019540,1746,0,0,1,2
3019527,3019857,330,1,0,0,1
3019541,3019781,240,1,0,0,2
3019573,3019743,170,0,1,0,1
3019603,3019687,84,0,1,0,2
3019782,3021000,1218,0,0,1,2
3019858,3021000,1142,0,0,1,1
3021001,3021058,57,1,0,0,2
3021001,3021059,58,1,0,0,1
3021059,3021296,237,0,0,1,2
3021060,3021297,237,0,0,1,1
3021297,3021365,68,1,0,0,2
3021298,3021377,79,1,0,0,1
3021366,3021559,193,0,0,1,2
3021378,3021557,179,0,0,1,1
3021558,3021586,28,1,0,0,1
3021560,3021578,18,1,0,0,2
3021579,3022950,1371,0,0,1,2
3021587,3022949,1362,0,0,1,1
3022950,3023007,57,1,0,0,1
3022951,3023016,65,1,0,0,2
3023008,3023171,163,0,0,1,1
3023017,3023171,154,0,0,1,2
3023172,3023200,28,1,0,0,2
3023172,3023201,29,1,0,0,1
3023201,3024632,1431,0,0,1,2
3023202,3024631,1429,0,0,1,1
3024632,3024683,51,1,0,0,1
3024633,3024682,49,1,0,0,2
3024683,3025067,384,0,0,1,2
3024684,3024773,89,0,0,1,1
3024774,3024790,16,1,0,0,1
3024791,3025069,278,0,0,1,1
3025068,3025144,76,1,0,0,2
3025070,3025144,74,1,0,0,1
3025145,3025399,254,0,0,1,2
3025145,3025403,258,0,0,1,1
3025400,3025547,147,1,0,0,2
3025404,3025568,164,1,0,0,1
3025438,3025491,53,0,1,0,1
3025451,3025457,6,0,1,0,2
3025548,3025671,123,0,0,1,2
3025569,3025671,102,0,0,1,1
3025672,3025845,173,1,0,0,2
3025672,3025874,202,1,0,0,1
3025699,3025823,124,0,1,0,1
3025709,3025764,55,0,1,0,2
3025846,3026025,179,0,0,1,2
3025875,3025912,37,0,0,1,1
3025913,3025929,16,1,0,0,1
3025930,3026024,94,0,0,1,1
3026025,3026075,50,1,0,0,1
3026026,3026076,50,1,0,0,2
3026076,3026537,461,0,0,1,1
3026077,3026536,459,0,0,1,2
3026537,3026603,66,1,0,0,2
3026538,3026614,76,1,0,0,1
3026604,3026712,108,0,0,1,2
3026615,3026712,97,0,0,1,1
3026713,3026735,22,1,0,0,2
3026713,3026740,27,1,0,0,1
3026736,3028695,1959,0,0,1,2
3026741,3027784,1043,0,0,1,1
3027785,3027797,12,1,0,0,1
3027798,3028694,896,0,0,1,1
3028695,3028760,65,1,0,0,1
3028696,3028754,58,1,0,0,2
3028755,3030796,2041,0,0,1,2
3028761,3030791,2030,0,0,1,1
3030792,3031071,279,1,0,0,1
3030797,3031033,236,1,0,0,2
3030826,3031031,205,0,1,0,1
3030851,3030949,98,0,1,0,2
3031034,3031165,131,0,0,1,2
3031072,3031163,91,0,0,1,1
3031164,3031442,278,1,0,0,1
3031166,3031369,203,1,0,0,2
3031191,3031388,197,0,1,0,1
3031196,3031304,108,0,1,0,2
3031370,3031551,181,0,0,1,2
3031443,3031550,107,0,0,1,1
3031551,3031585,34,1,0,0,1
3031552,3031583,31,1,0,0,2
3031584,3032264,680,0,0,1,2
3031586,3032264,678,0,0,1,1
3032265,3032305,40,1,0,0,2
3032265,3032310,45,1,0,0,1
3032306,3032562,256,0,0,1,2
3032311,3032562,251,0,0,1,1
3032563,3032619,56,1,0,0,1
3032563,3032620,57,1,0,0,2
3032620,3032833,213,0,0,1,1
3032621,3032834,213,0,0,1,2
3032834,3032891,57,1,0,0,1
3032835,3032891,56,1,0,0,2
3032892,3034376,1484,0,0,1,1
3032892,3034376,1484,0,0,1,2
3034377,3034405,28,1,0,0,1
3034377,3034405,28,1,0,0,2
3034406,3035206,800,0,0,1,1
3034406,3035206,800,0,0,1,2
3035207,3035256,49,1,0,0,2
3035207,3035267,60,1,0,0,1
3035257,3037345,2088,0,0,1,2
3035268,3037345,2077,0,0,1,1
3037346,3037384,38,1,0,0,2
3037346,3037385,39,1,0,0,1
3037385,3037761,376,0,0,1,2
3037386,3037760,374,0,0,1,1
3037761,3037779,18,1,0,0,1
3037762,3037782,20,1,0,0,2
3037780,3038358,578,0,0,1,1
3037783,3038359,576,0,0,1,2
3038359,3038388,29,1,0,0,1
3038360,3038388,28,1,0,0,2
3038389,3038665,276,0,0,1,1
3038389,3038667,278,0,0,1,2
3038666,3038713,47,1,0,0,1
3038668,3038702,34,1,0,0,2
3038703,3039258,555,0,0,1,2
3038714,3039258,544,0,0,1,1
3039259,3039333,74,1,0,0,2
3039259,3039337,78,1,0,0,1
3039334,3039520,186,0,0,1,2
3039338,3039520,182,0,0,1,1
3039521,3039547,26,1,0,0,2
3039521,3039548,27,1,0,0,1
3039548,3041630,2082,0,0,1,2
3039549,3041630,2081,0,0,1,1
3041631,3041660,29,1,0,0,1
3041631,3041660,29,1,0,0,2
3041661,3041804,143,0,0,1,1
3041661,3041805,144,0,0,1,2
3041805,3041852,47,1,0,0,1
3041806,3041853,47,1,0,0,2
3041853,3042807,954,0,0,1,1
3041854,3042806,952,0,0,1,2
3042807,3042839,32,1,0,0,2
3042808,3042840,32,1,0,0,1
3042840,3043255,415,0,0,1,2
3042841,3043255,414,0,0,1,1
3043256,3043292,36,1,0,0,2
3043256,3043293,37,1,0,0,1
3043293,3044036,743,0,0,1,2
3043294,3044036,742,0,0,1,1
3044037,3044063,26,1,0,0,2
3044037,3044068,31,1,0,0,1
3044064,3044203,139,0,0,1,2
3044069,3044206,137,0,0,1,1
3044204,3044483,279,1,0,0,2
3044207,3044502,295,1,0,0,1
3044242,3044458,216,0,1,0,1
3044250,3044423,173,0,1,0,2
3044484,3045045,561,0,0,1,2
3044503,3045046,543,0,0,1,1
3045046,3045078,32,1,0,0,2
3045047,3045080,33,1,0,0,1
3045079,3045816,737,0,0,1,2
3045081,3045815,734,0,0,1,1
3045816,3045892,76,1,0,0,1
3045817,3045895,78,1,0,0,2
3045893,3045980,87,0,0,1,1
3045896,3045980,84,0,0,1,2
3045981,3046017,36,1,0,0,2
3045981,3046024,43,1,0,0,1
3046018,3046382,364,0,0,1,2
3046025,3046382,357,0,0,1,1
3046383,3046402,19,1,0,0,1
3046383,3046402,19,1,0,0,2
3046403,3047460,1057,0,0,1,1
3046403,3047460,1057,0,0,1,2
3047461,3047480,19,1,0,0,2
3047461,3047481,20,1,0,0,1
3047481,3047591,110,0,0,1,2
3047482,3047591,109,0,0,1,1
3047592,3047658,66,1,0,0,2
3047592,3047659,67,1,0,0,1
3047659,3048394,735,0,0,1,2
3047660,3048394,734,0,0,1,1
3048395,3048426,31,1,0,0,1
3048395,3048428,33,1,0,0,2
3048427,3048659,232,0,0,1,1
3048429,3048659,230,0,0,1,2
3048660,3048701,41,1,0,0,1
3048660,3048702,42,1,0,0,2
3048702,3049664,962,0,0,1,1
3048703,3049664,961,0,0,1,2
3049665,3049706,41,1,0,0,1
3049665,3049715,50,1,0,0,2
3049707,3049786,79,0,0,1,1
3049716,3049796,80,0,0,1,2
3049787,3050084,297,1,0,0,1
3049797,3050072,275,1,0,0,2
3049827,3050025,198,0,1,0,1
3049835,3049990,155,0,1,0,2
3050073,3050327,254,0,0,1,2
3050085,3050161,76,0,0,1,1
3050162,3050169,7,1,0,0,1
3050170,3050330,160,0,0,1,1
3050328,3050372,44,1,0,0,2
3050331,3050370,39,1,0,0,1
3050371,3050598,227,0,0,1,1
3050373,3050598,225,0,0,1,2
3050599,3050657,58,1,0,0,2
3050599,3050658,59,1,0,0,1
3050658,3050843,185,0,0,1,2
3050659,3050843,184,0,0,1,1
3050844,3050915,71,1,0,0,2
3050844,3050918,74,1,0,0,1
3050916,3051093,177,0,0,1,2
3050919,3051088,169,0,0,1,1
3051089,3051115,26,1,0,0,1
3051094,3051107,13,1,0,0,2
3051108,3052570,1462,0,0,1,2
3051116,3052570,1454,0,0,1,1
3052571,3052618,47,1,0,0,2
3052571,3052628,57,1,0,0,1
3052619,3052828,209,0,0,1,2
3052629,3052828,199,0,0,1,1
3052829,3052858,29,1,0,0,1
3052829,3052859,30,1,0,0,2
3052859,3054519,1660,0,0,1,1
3052860,3054521,1661,0,0,1,2
3054520,3054547,27,1,0,0,1
3054522,3054547,25,1,0,0,2
3054548,3054699,151,0,0,1,2
3054548,3054700,152,0,0,1,1
3054700,3054742,42,1,0,0,2
3054701,3054742,41,1,0,0,1
3054743,3055049,306,0,0,1,2
3054743,3055050,307,0,0,1,1
3055050,3055079,29,1,0,0,2
3055051,3055077,26,1,0,0,1
3055078,3055564,486,0,0,1,1
3055080,3055560,480,0,0,1,2
3055561,3055578,17,1,0,0,2
3055565,3055576,11,1,0,0,1
3055577,3056101,524,0,0,1,1
3055579,3056101,522,0,0,1,2
3056102,3056160,58,1,0,0,1
3056102,3056166,64,1,0,0,2
3056161,3056284,123,0,0,1,1
3056167,3056285,118,0,0,1,2
3056285,3056307,22,1,0,0,1
3056286,3056304,18,1,0,0,2
3056305,3057588,1283,0,0,1,2
3056308,3057591,1283,0,0,1,1
3057589,3057606,17,1,0,0,2
3057592,3057613,21,1,0,0,1
3057607,3058436,829,0,0,1,2
3057614,3058436,822,0,0,1,1
3058437,3058492,55,1,0,0,2
3058437,3058493,56,1,0,0,1
3058493,3058647,154,0,0,1,2
3058494,3058649,155,0,0,1,1
3058648,3058681,33,1,0,0,2
3058650,3058682,32,1,0,0,1
3058682,3059181,499,0,0,1,2
3058683,3059181,498,0,0,1,1
3059182,3059211,29,1,0,0,1
3059182,3059212,30,1,0,0,2
3059212,3059375,163,0,0,1,1
3059213,3059376,163,0,0,1,2
3059376,3059406,30,1,0,0,1
3059377,3059405,28,1,0,0,2
3059406,3059547,141,0,0,1,2
3059407,3059547,140,0,0,1,1
3059548,3059698,150,1,0,0,1
3059548,3059713,165,1,0,0,2
3059582,3059659,77,0,1,0,1
3059584,3059652,68,0,1,0,2
3059699,3060075,376,0,0,1,1
3059714,3060072,358,0,0,1,2
3060073,3060291,218,1,0,0,2
3060076,3060277,201,1,0,0,1
3060096,3060256,160,0,1,0,1
3060105,3060207,102,0,1,0,2
3060278,3060596,318,0,0,1,1
3060292,3060595,303,0,0,1,2
3060596,3060664,68,1,0,0,2
3060597,3060667,70,1,0,0,1
3060665,3061041,376,0,0,1,2
3060668,3061042,374,0,0,1,1
3061042,3061079,37,1,0,0,2
3061043,3061086,43,1,0,0,1
3061080,3061388,308,0,0,1,2
3061087,3061387,300,0,0,1,1
3061388,3061422,34,1,0,0,1
3061389,3061421,32,1,0,0,2
3061422,3061918,496,0,0,1,2
3061423,3061918,495,0,0,1,1
3061919,3061954,35,1,0,0,1
3061919,3061954,35,1,0,0,2
3061955,3062497,542,0,0,1,2
3061955,3062498,543,0,0,1,1
3062498,3062578,80,1,0,0,2
3062499,3062581,82,1,0,0,1
3062579,3062720,141,0,0,1,2
3062582,3062720,138,0,0,1,1
3062721,3062741,20,1,0,0,2
3062721,3062744,23,1,0,0,1
3062742,3064568,1826,0,0,1,2
3062745,3064567,1822,0,0,1,1
3064568,3064624,56,1,0,0,1
3064569,3064618,49,1,0,0,2
3064619,3066628,2009,0,0,1,2
3064625,3066628,2003,0,0,1,1
3066629,3066829,200,1,0,0,2
3066629,3066842,213,1,0,0,1
3066674,3066750,76,0,1,0,1
3066686,3066736,50,0,1,0,2
3066830,3067207,377,0,0,1,2
3066843,3067207,364,0,0,1,1
3067208,3067247,39,1,0,0,1
3067208,3067254,46,1,0,0,2
3067248,3067585,337,0,0,1,1
3067255,3067584,329,0,0,1,2
3067585,3067641,56,1,0,0,2
3067586,3067631,45,1,0,0,1
3067632,3067977,345,0,0,1,1
3067642,3067979,337,0,0,1,2
3067978,3068032,54,1,0,0,1
3067980,3068033,53,1,0,0,2
3068033,3068213,180,0,0,1,1
3068034,3068213,179,0,0,1,2
3068214,3068289,75,1,0,0,2
3068214,3068290,76,1,0,0,1
3068290,3068387,97,0,0,1,2
3068291,3068386,95,0,0,1,1
3068387,3068422,35,1,0,0,1
3068388,3068422,34,1,0,0,2
3068423,3068635,212,0,0,1,2
3068423,3068638,215,0,0,1,1
3068636,3068654,18,1,0,0,2
3068639,3068653,14,1,0,0,1
3068654,3070469,1815,0,0,1,1
3068655,3070469,1814,0,0,1,2
3070470,3070523,53,1,0,0,1
3070470,3070523,53,1,0,0,2
3070524,3071031,507,0,0,1,1
3070524,3071032,508,0,0,1,2
3071032,3071065,33,1,0,0,1
3071033,3071068,35,1,0,0,2
3071066,3071259,193,0,0,1,1
3071069,3071262,193,0,0,1,2
3071260,3071482,222,1,0,0,1
3071263,3071452,189,1,0,0,2
3071293,3071420,127,0,1,0,1
3071314,3071387,73,0,1,0,2
3071453,3071846,393,0,0,1,2
3071483,3071845,362,0,0,1,1
3071846,3071900,54,1,0,0,1
3071847,3071895,48,1,0,0,2
3071896,3072107,211,0,0,1,2
3071901,3072107,206,0,0,1,1
3072108,3072143,35,1,0,0,1
3072108,3072145,37,1,0,0,2
3072144,3072575,431,0,0,1,1
3072146,3072576,430,0,0,1,2
3072576,3072637,61,1,0,0,1
3072577,3072632,55,1,0,0,2
3072633,3073055,422,0,0,1,2
3072638,3073055,417,0,0,1,1
3073056,3073094,38,1,0,0,2
3073056,3073095,39,1,0,0,1
3073095,3073491,396,0,0,1,2
3073096,3073491,395,0,0,1,1
3073492,3073540,48,1,0,0,2
3073492,3073542,50,1,0,0,1
3073541,3073881,340,0,0,1,2
3073543,3073881,338,0,0,1,1
3073882,3073934,52,1,0,0,1
3073882,3073935,53,1,0,0,2
3073935,3074141,206,0,0,1,1
3073936,3074143,207,0,0,1,2
3074142,3074217,75,1,0,0,1
3074144,3074217,73,1,0,0,2
