start,end,duration,saccade,blink,fixation,eye
1369641,1369952,311,0,0,1,1
1369641,1369952,311,0,0,1,2
1369953,1370008,55,1,0,0,2
1369953,1370010,57,1,0,0,1
1370009,1370104,95,0,0,1,2
1370011,1370104,93,0,0,1,1
1370105,1370130,25,1,0,0,1
1370105,1370130,25,1,0,0,2
1370131,1371210,1079,0,0,1,2
1370131,1371211,1080,0,0,1,1
1371211,1371449,238,1,0,0,2
1371212,1371419,207,1,0,0,1
1371227,1371393,166,0,1,0,1
1371234,1371379,145,0,1,0,2
1371420,1371606,186,0,0,1,1
1371450,1371606,156,0,0,1,2
1371607,1371628,21,1,0,0,1
1371607,1371634,27,1,0,0,2
1371629,1372011,382,0,0,1,1
1371635,1372013,378,0,0,1,2
1372012,1372650,638,1,0,0,1
1372014,1372126,112,1,0,0,2
1372095,1372592,497,0,1,0,1
1372127,1372553,426,0,0,1,2
1372554,1372644,90,1,0,0,2
1372645,1372842,197,0,0,1,2
1372651,1372839,188,0,0,1,1
1372840,1372864,24,1,0,0,1
1372843,1372881,38,1,0,0,2
1372865,1373098,233,0,0,1,1
1372882,1373110,228,0,0,1,2
1373099,1373331,232,1,0,0,1
1373111,1373326,215,1,0,0,2
1373129,1373295,166,0,1,0,1
1373137,1373251,114,0,1,0,2
1373327,1373504,177,0,0,1,2
1373332,1373503,171,0,0,1,1
1373504,1376949,3445,1,0,0,1
1373505,1376930,3425,1,0,0,2
1373541,1376804,3263,0,1,0,1
1373546,1376816,3270,0,1,0,2
1376931,1377144,213,0,0,1,2
1376950,1377145,195,0,0,1,1
1377145,1377166,21,1,0,0,2
1377146,1377160,14,1,0,0,1
1377161,1377484,323,0,0,1,1
1377167,1377484,317,0,0,1,2
1377485,1378579,1094,1,0,0,1
1377485,1378612,1127,1,0,0,2
1377514,1378568,1054,0,1,0,1
1377521,1378575,1054,0,1,0,2
1378580,1378609,29,0,0,1,1
1378610,1378702,92,1,0,0,1
1378613,1378659,46,0,0,1,2
1378660,1378701,41,1,0,0,2
1378702,1379066,364,0,0,1,2
1378703,1379067,364,0,0,1,1
1379067,1379082,15,1,0,0,2
1379068,1379084,16,1,0,0,1
1379083,1379378,295,0,0,1,2
1379085,1379374,289,0,0,1,1
1379375,1379561,186,1,0,0,1
1379379,1379554,175,1,0,0,2
1379395,1379531,136,0,1,0,1
1379400,1379506,106,0,1,0,2
1379555,1379687,132,0,0,1,2
1379562,1379685,123,0,0,1,1
1379686,1379704,18,1,0,0,1
1379688,1379702,14,1,0,0,2
1379703,1380946,1243,0,0,1,2
1379705,1380948,1243,0,0,1,1
1380947,1381112,165,1,0,0,2
1380949,1381136,187,1,0,0,1
1380966,1381094,128,0,1,0,1
1380973,1381070,97,0,1,0,2
1381113,1381349,236,0,0,1,2
1381137,1384864,3727,0,0,1,1
1381350,1381359,9,1,0,0,2
1381360,1384630,3270,0,0,1,2
1384631,1384640,9,1,0,0,2
1384641,1384866,225,0,0,1,2
1384865,1385051,186,1,0,0,1
1384867,1385066,199,1,0,0,2
1384886,1385035,149,0,1,0,1
1384890,1385014,124,0,1,0,2
1385052,1385296,244,0,0,1,1
1385067,1385291,224,0,0,1,2
1385292,1385308,16,1,0,0,2
1385297,1385307,10,1,0,0,1
1385308,1387983,2675,0,0,1,1
1385309,1387982,2673,0,0,1,2
1387983,1387997,14,1,0,0,2
1387984,1387998,14,1,0,0,1
1387998,1389164,1166,0,0,1,2
1387999,1389163,1164,0,0,1,1
1389164,1390556,1392,1,0,0,1
1389165,1390560,1395,1,0,0,2
1389219,1390533,1314,0,1,0,1
1389233,1390549,1316,0,1,0,2
1390557,1390851,294,0,0,1,1
1390561,1390852,291,0,0,1,2
1390852,1390892,40,1,0,0,1
1390853,1390892,39,1,0,0,2
1390893,1391298,405,0,0,1,1
1390893,1391298,405,0,0,1,2
1391299,1391438,139,1,0,0,2
1391299,1391443,144,1,0,0,1
1391439,1391912,473,0,0,1,2
1391444,1391914,470,0,0,1,1
1391913,1391940,27,1,0,0,2
1391915,1391938,23,1,0,0,1
1391939,1392822,883,0,0,1,1
1391941,1392823,882,0,0,1,2
1392823,1392847,24,1,0,0,1
1392824,1392845,21,1,0,0,2
1392846,1393067,221,0,0,1,2
1392848,1393065,217,0,0,1,1
1393066,1393086,20,1,0,0,1
1393068,1393088,20,1,0,0,2
1393087,1393407,320,0,0,1,1
1393089,1393406,317,0,0,1,2
1393407,1393427,20,1,0,0,2
1393408,1393431,23,1,0,0,1
1393428,1393908,480,0,0,1,2
1393432,1393909,477,0,0,1,1
1393909,1393937,28,1,0,0,2
1393910,1393935,25,1,0,0,1
1393936,1394241,305,0,0,1,1
1393938,1394237,299,0,0,1,2
1394238,1394299,61,1,0,0,2
1394242,1394278,36,1,0,0,1
1394279,1394548,269,0,0,1,1
1394300,1394543,243,0,0,1,2
1394544,1394846,302,1,0,0,2
1394549,1394585,36,1,0,0,1
1394575,1394824,249,0,1,0,2
1394586,1394797,211,0,0,1,1
1394798,1394846,48,1,0,0,1
1394847,1394894,47,0,0,1,2
1394847,1394920,73,0,0,1,1
1394895,1395118,223,1,0,0,2
1394921,1395143,222,1,0,0,1
1394949,1395098,149,0,1,0,1
1394963,1395045,82,0,1,0,2
1395119,1395345,226,0,0,1,2
1395144,1395344,200,0,0,1,1
1395345,1395386,41,1,0,0,1
1395346,1395385,39,1,0,0,2
1395386,1395783,397,0,0,1,2
1395387,1395775,388,0,0,1,1
1395776,1395794,18,1,0,0,1
1395784,1395790,6,1,0,0,2
1395791,1396192,401,0,0,1,2
1395795,1396186,391,0,0,1,1
1396187,1396360,173,1,0,0,1
1396193,1396358,165,1,0,0,2
1396206,1396342,136,0,1,0,1
1396217,1396303,86,0,1,0,2
1396359,1396832,473,0,0,1,2
1396361,1396833,472,0,0,1,1
1396833,1396854,21,1,0,0,2
1396834,1396845,11,1,0,0,1
1396846,1397008,162,0,0,1,1
1396855,1397013,158,0,0,1,2
1397009,1397024,15,1,0,0,1
1397014,1397023,9,1,0,0,2
1397024,1397482,458,0,0,1,2
1397025,1397482,457,0,0,1,1
1397483,1397633,150,1,0,0,1
1397483,1397633,150,1,0,0,2
1397634,1397864,230,0,0,1,1
1397634,1397865,231,0,0,1,2
1397865,1397895,30,1,0,0,1
1397866,1397896,30,1,0,0,2
1397896,1398153,257,0,0,1,1
1397897,1398153,256,0,0,1,2
1398154,1398173,19,1,0,0,1
1398154,1398173,19,1,0,0,2
1398174,1398753,579,0,0,1,2
1398174,1398764,590,0,0,1,1
1398754,1399014,260,1,0,0,2
1398765,1399061,296,1,0,0,1
1398785,1399033,248,0,1,0,1
1398800,1398969,169,0,1,0,2
1399015,1399176,161,0,0,1,2
1399062,1399175,113,0,0,1,1
1399176,1399214,38,1,0,0,1
1399177,1399224,47,1,0,0,2
1399215,1399905,690,0,0,1,1
1399225,1399909,684,0,0,1,2
1399906,1400132,226,1,0,0,1
1399910,1400127,217,1,0,0,2
1399927,1400109,182,0,1,0,1
1399935,1400072,137,0,1,0,2
1400128,1400206,78,0,0,1,2
1400133,1400206,73,0,0,1,1
1400207,1400231,24,1,0,0,2
1400207,1400232,25,1,0,0,1
1400232,1400876,644,0,0,1,2
1400233,1400881,648,0,0,1,1
1400877,1401153,276,1,0,0,2
1400882,1401118,236,1,0,0,1
1400898,1401088,190,0,1,0,1
1400904,1401090,186,0,1,0,2
1401119,1401232,113,0,0,1,1
1401154,1401235,81,0,0,1,2
1401233,1401265,32,1,0,0,1
1401236,1401266,30,1,0,0,2
1401266,1401503,237,0,0,1,1
1401267,1401503,236,0,0,1,2
1401504,1401623,119,1,0,0,1
1401504,1402069,565,1,0,0,2
1401602,1401760,158,0,1,0,2
1401624,1401732,108,0,0,1,1
1401733,1401778,45,1,0,0,1
1401779,1401882,103,0,0,1,1
1401883,1402072,189,1,0,0,1
1401904,1402052,148,0,1,0,1
1401913,1402025,112,0,1,0,2
1402070,1402298,228,0,0,1,2
1402073,1402296,223,0,0,1,1
1402297,1402315,18,1,0,0,1
1402299,1402317,18,1,0,0,2
1402316,1403616,1300,0,0,1,1
1402318,1403619,1301,0,0,1,2
1403617,1403835,218,1,0,0,1
1403620,1403800,180,1,0,0,2
1403641,1403783,142,0,1,0,1
1403647,1403760,113,0,1,0,2
1403801,1403822,21,0,0,1,2
1403823,1403827,4,1,0,0,2
1403828,1404788,960,0,0,1,2
1403836,1403991,155,0,0,1,1
1403992,1404002,10,1,0,0,1
1404003,1404779,776,0,0,1,1
1404780,1405043,263,1,0,0,1
1404789,1405013,224,1,0,0,2
1404806,1404992,186,0,1,0,1
1404813,1404959,146,0,1,0,2
1405014,1405103,89,0,0,1,2
1405044,1405104,60,0,0,1,1
1405104,1405121,17,1,0,0,2
1405105,1405123,18,1,0,0,1
1405122,1405744,622,0,0,1,2
1405124,1405718,594,0,0,1,1
1405719,1406066,347,1,0,0,1
1405745,1406103,358,1,0,0,2
1405763,1406019,256,0,1,0,1
1405771,1406006,235,0,1,0,2
1406067,1406751,684,0,0,1,1
1406104,1406769,665,0,0,1,2
1406752,1407248,496,1,0,0,1
1406770,1407236,466,1,0,0,2
1406788,1407122,334,0,1,0,1
1406796,1407187,391,0,1,0,2
1407152,1407161,9,0,1,0,1
1407237,1407393,156,0,0,1,2
1407249,1407391,142,0,0,1,1
1407392,1407414,22,1,0,0,1
1407394,1407413,19,1,0,0,2
1407414,1407630,216,0,0,1,2
1407415,1407629,214,0,0,1,1
1407630,1408065,435,1,0,0,1
1407631,1408066,435,1,0,0,2
1407682,1408054,372,0,1,0,1
1407688,1408009,321,0,1,0,2
1408066,1408200,134,0,0,1,1
1408067,1408198,131,0,0,1,2
1408199,1408232,33,1,0,0,2
1408201,1408224,23,1,0,0,1
1408225,1408864,639,0,0,1,1
1408233,1408857,624,0,0,1,2
1408858,1409039,181,1,0,0,2
1408865,1409055,190,1,0,0,1
1408879,1409008,129,0,1,0,1
1408888,1408984,96,0,1,0,2
1409040,1409208,168,0,0,1,2
1409056,1409208,152,0,0,1,1
1409209,1409213,4,1,0,0,1
1409209,1409213,4,1,0,0,2
1409214,1409627,413,0,0,1,1
1409214,1409637,423,0,0,1,2
1409628,1409904,276,1,0,0,1
1409638,1409937,299,1,0,0,2
1409658,1409867,209,0,1,0,1
1409666,1409857,191,0,1,0,2
1409905,1410175,270,0,0,1,1
1409938,1410177,239,0,0,1,2
1410176,1410200,24,1,0,0,1
1410178,1410201,23,1,0,0,2
1410201,1410657,456,0,0,1,1
1410202,1410670,468,0,0,1,2
1410658,1410999,341,1,0,0,1
1410671,1411010,339,1,0,0,2
1410690,1410960,270,0,1,0,1
1410695,1410932,237,0,1,0,2
1411000,1411039,39,0,0,1,1
1411011,1411038,27,0,0,1,2
1411039,1411075,36,1,0,0,2
1411040,1411072,32,1,0,0,1
1411073,1412096,1023,0,0,1,1
1411076,1411371,295,0,0,1,2
1411372,1411379,7,1,0,0,2
1411380,1412107,727,0,0,1,2
1412097,1412446,349,1,0,0,1
1412108,1412425,317,1,0,0,2
1412123,1412362,239,0,1,0,1
1412127,1412337,210,0,1,0,2
1412426,1413077,651,0,0,1,2
1412447,1413077,630,0,0,1,1
1413078,1414467,1389,1,0,0,2
1413078,1414491,1413,1,0,0,1
1413126,1414480,1354,0,1,0,1
1413135,1414441,1306,0,1,0,2
1414468,1414644,176,0,0,1,2
1414492,1414643,151,0,0,1,1
1414644,1414671,27,1,0,0,1
1414645,1414681,36,1,0,0,2
1414672,1415365,693,0,0,1,1
1414682,1415366,684,0,0,1,2
1415366,1416567,1201,1,0,0,1
1415367,1416533,1166,1,0,0,2
1415387,1416519,1132,0,1,0,1
1415397,1416500,1103,0,1,0,2
1416534,1416650,116,0,0,1,2
1416568,1416650,82,0,0,1,1
1416651,1416695,44,1,0,0,1
1416651,1416708,57,1,0,0,2
1416696,1416822,126,0,0,1,1
1416709,1416822,113,0,0,1,2
1416823,1416852,29,1,0,0,1
1416823,1416857,34,1,0,0,2
1416853,1417137,284,0,0,1,1
1416858,1417146,288,0,0,1,2
1417138,1417380,242,1,0,0,1
1417147,1417368,221,1,0,0,2
1417165,1417327,162,0,1,0,1
1417174,1417304,130,0,1,0,2
1417369,1417433,64,0,0,1,2
1417381,1417432,51,0,0,1,1
1417433,1417457,24,1,0,0,1
1417434,1417456,22,1,0,0,2
1417457,1418101,644,0,0,1,2
1417458,1418101,643,0,0,1,1
1418102,1419328,1226,1,0,0,2
1418102,1419347,1245,1,0,0,1
1418154,1419316,1162,0,1,0,1
1418164,1419289,1125,0,1,0,2
1419329,1419424,95,0,0,1,2
1419348,1419424,76,0,0,1,1
1419425,1419467,42,1,0,0,1
1419425,1419471,46,1,0,0,2
1419468,1419792,324,0,0,1,1
1419472,1419796,324,0,0,1,2
1419793,1419808,15,1,0,0,1
1419797,1419803,6,1,0,0,2
1419804,1420325,521,0,0,1,2
1419809,1420328,519,0,0,1,1
1420326,1420510,184,1,0,0,2
1420329,1420520,191,1,0,0,1
1420347,1420478,131,0,1,0,1
1420355,1420458,103,0,1,0,2
1420511,1420785,274,0,0,1,2
1420521,1420790,269,0,0,1,1
1420786,1420800,14,1,0,0,2
1420791,1420800,9,1,0,0,1
1420801,1421159,358,0,0,1,1
1420801,1421163,362,0,0,1,2
1421160,1421171,11,1,0,0,1
1421164,1421172,8,1,0,0,2
1421172,1422331,1159,0,0,1,1
1421173,1422331,1158,0,0,1,2
1422332,1422343,11,1,0,0,2
1422332,1422344,12,1,0,0,1
1422344,1423257,913,0,0,1,2
1422345,1424658,2313,0,0,1,1
1423258,1423268,10,1,0,0,2
1423269,1424661,1392,0,0,1,2
1424659,1424914,255,1,0,0,1
1424662,1424873,211,1,0,0,2
1424683,1424858,175,0,1,0,1
1424692,1424824,132,0,1,0,2
1424874,1425078,204,0,0,1,2
1424915,1425083,168,0,0,1,1
1425079,1425097,18,1,0,0,2
1425084,1425091,7,1,0,0,1
1425092,1425979,887,0,0,1,1
1425098,1425979,881,0,0,1,2
1425980,1426436,456,1,0,0,2
1425980,1426466,486,1,0,0,1
1426048,1426455,407,0,1,0,1
1426056,1426425,369,0,1,0,2
1426437,1426549,112,0,0,1,2
1426467,1426546,79,0,0,1,1
1426547,1426569,22,1,0,0,1
1426550,1426570,20,1,0,0,2
1426570,1427147,577,0,0,1,1
1426571,1427151,580,0,0,1,2
1427148,1428946,1798,1,0,0,1
1427152,1428949,1797,1,0,0,2
1427172,1428935,1763,0,1,0,1
1427178,1428891,1713,0,1,0,2
1428947,1429151,204,0,0,1,1
1428950,1429153,203,0,0,1,2
1429152,1429204,52,1,0,0,1
1429154,1429206,52,1,0,0,2
1429205,1429666,461,0,0,1,1
1429207,1429669,462,0,0,1,2
1429667,1430588,921,1,0,0,1
1429670,1429740,70,1,0,0,2
1429737,1429763,26,0,1,0,1
1429741,1429943,202,0,0,1,2
1429935,1430577,642,0,1,0,1
1429944,1430589,645,1,0,0,2
1429989,1430574,585,0,1,0,2
1430589,1430878,289,0,0,1,1
1430590,1430878,288,0,0,1,2
1430879,1430926,47,1,0,0,1
1430879,1430933,54,1,0,0,2
1430927,1431108,181,0,0,1,1
1430934,1431109,175,0,0,1,2
1431109,1436650,5541,1,0,0,1
1431110,1436536,5426,1,0,0,2
1431153,1436515,5362,0,1,0,2
1431154,1436533,5379,0,1,0,1
1436537,1436610,73,0,0,1,2
1436611,1436656,45,1,0,0,2
1436651,1436767,116,0,0,1,1
1436657,1436767,110,0,0,1,2
1436768,1436790,22,1,0,0,1
1436768,1436797,29,1,0,0,2
1436791,1437517,726,0,0,1,1
1436798,1437235,437,0,0,1,2
1437236,1437241,5,1,0,0,2
1437242,1437516,274,0,0,1,2
1437517,1437534,17,1,0,0,2
1437518,1437534,16,1,0,0,1
1437535,1438249,714,0,0,1,2
1437535,1439801,2266,0,0,1,1
1438250,1438260,10,1,0,0,2
1438261,1439797,1536,0,0,1,2
1439798,1439814,16,1,0,0,2
1439802,1439815,13,1,0,0,1
1439815,1439981,166,0,0,1,2
1439816,1439998,182,0,0,1,1
1439982,1440232,250,1,0,0,2
1439999,1440300,301,1,0,0,1
1440016,1440224,208,0,1,0,1
1440036,1440176,140,0,1,0,2
1440233,1440851,618,0,0,1,2
1440301,1440851,550,0,0,1,1
1440852,1442629,1777,1,0,0,1
1440852,1446883,6031,1,0,0,2
1440915,1442618,1703,0,1,0,1
1440920,1446856,5936,0,1,0,2
1442630,1442667,37,0,0,1,1
1442668,1446902,4234,1,0,0,1
1442700,1446850,4150,0,1,0,1
1446884,1447354,470,0,0,1,2
1446903,1447353,450,0,0,1,1
1447354,1447681,327,1,0,0,1
1447355,1447671,316,1,0,0,2
1447417,1447621,204,0,1,0,1
1447420,1447616,196,0,1,0,2
1447672,1447850,178,0,0,1,2
1447682,1447850,168,0,0,1,1
1447851,1447870,19,1,0,0,1
1447851,1447872,21,1,0,0,2
1447871,1448445,574,0,0,1,1
1447873,1448444,571,0,0,1,2
1448445,1449466,1021,1,0,0,2
1448446,1448634,188,1,0,0,1
1448621,1449439,818,0,1,0,2
1448635,1449263,628,0,0,1,1
1449264,1449466,202,1,0,0,1
1449288,1449441,153,0,1,0,1
1449467,1449607,140,0,0,1,1
1449467,1449608,141,0,0,1,2
1449608,1449649,41,1,0,0,1
1449609,1449651,42,1,0,0,2
1449650,1449951,301,0,0,1,1
1449652,1449953,301,0,0,1,2
1449952,1450838,886,1,0,0,1
1449954,1450853,899,1,0,0,2
1450014,1450750,736,0,1,0,1
1450017,1450793,776,0,1,0,2
1450839,1451051,212,0,0,1,1
1450854,1451053,199,0,0,1,2
1451052,1451519,467,1,0,0,1
1451054,1451495,441,1,0,0,2
1451094,1451503,409,0,1,0,1
1451098,1451450,352,0,1,0,2
1451496,1451567,71,0,0,1,2
1451520,1451567,47,0,0,1,1
1451568,1451619,51,1,0,0,2
1451568,1451622,54,1,0,0,1
1451620,1452083,463,0,0,1,2
1451623,1451883,260,0,0,1,1
1451894,1474198,22304,0,1,0,1
1452084,1474089,22005,1,0,0,2
1452122,1474064,21942,0,1,0,2
1474090,1474235,145,0,0,1,2
1474208,1474798,590,1,0,0,1
1474236,1474305,69,1,0,0,2
1474306,1474402,96,0,0,1,2
1474392,1474765,373,0,1,0,1
1474403,1474776,373,1,0,0,2
1474540,1474634,94,0,1,0,2
1474777,1474898,121,0,0,1,2
1474799,1474820,21,0,0,1,1
1474821,1474838,17,1,0,0,1
1474839,1474895,56,0,0,1,1
1474896,1475920,1024,1,0,0,1
1474899,1475873,974,1,0,0,2
1474954,1475903,949,0,1,0,1
1474985,1475846,861,0,1,0,2
1475874,1476233,359,0,0,1,2
1475921,1476231,310,0,0,1,1
1476232,1478827,2595,1,0,0,1
1476234,1478805,2571,1,0,0,2
1476275,1478807,2532,0,1,0,1
1476276,1478796,2520,0,1,0,2
1478806,1478925,119,0,0,1,2
1478828,1478925,97,0,0,1,1
1478926,1478978,52,1,0,0,1
1478926,1478984,58,1,0,0,2
1478979,1479068,89,0,0,1,1
1478985,1479068,83,0,0,1,2
1479069,1479113,44,1,0,0,1
1479069,1479117,48,1,0,0,2
1479114,1479489,375,0,0,1,1
1479118,1479489,371,0,0,1,2
1479490,1483763,4273,1,0,0,2
1479490,1483765,4275,1,0,0,1
1479568,1483754,4186,0,1,0,1
1479584,1483733,4149,0,1,0,2
1483764,1483886,122,0,0,1,2
1483766,1483885,119,0,0,1,1
1483886,1483914,28,1,0,0,1
1483887,1483917,30,1,0,0,2
1483915,1484056,141,0,0,1,1
1483918,1484058,140,0,0,1,2
1484057,1484075,18,1,0,0,1
1484059,1484078,19,1,0,0,2
1484076,1484754,678,0,0,1,1
1484079,1484754,675,0,0,1,2
1484755,1484818,63,1,0,0,1
1484755,1484818,63,1,0,0,2
1484819,1484897,78,0,0,1,1
1484819,1484901,82,0,0,1,2
1484898,1488889,3991,1,0,0,1
1484902,1488877,3975,1,0,0,2
1484934,1488871,3937,0,1,0,1
1484939,1488783,3844,0,1,0,2
1488878,1488911,33,0,0,1,2
1488890,1488916,26,0,0,1,1
1488912,1488970,58,1,0,0,2
1488917,1488967,50,1,0,0,1
1488968,1489338,370,0,0,1,1
1488971,1489338,367,0,0,1,2
1489339,1489447,108,1,0,0,2
1489339,1495598,6259,1,0,0,1
1489394,1495547,6153,0,1,0,1
1489448,1489593,145,0,0,1,2
1489594,1489717,123,1,0,0,2
1489718,1489752,34,0,0,1,2
1489753,1489769,16,1,0,0,2
1489770,1489943,173,0,0,1,2
1489944,1495483,5539,1,0,0,2
1489997,1495455,5458,0,1,0,2
1495484,1495525,41,0,0,1,2
1495526,1495592,66,1,0,0,2
1495593,1495708,115,0,0,1,2
1495599,1495708,109,0,0,1,1
1495709,1495738,29,1,0,0,1
1495709,1495742,33,1,0,0,2
1495739,1496329,590,0,0,1,1
1495743,1496340,597,0,0,1,2
1496330,1497604,1274,1,0,0,1
1496341,1497593,1252,1,0,0,2
1496358,1497593,1235,0,1,0,1
1496366,1497527,1161,0,1,0,2
1497594,1497696,102,0,0,1,2
1497605,1497695,90,0,0,1,1
1497696,1497744,48,1,0,0,1
1497697,1497741,44,1,0,0,2
1497742,1497878,136,0,0,1,2
1497745,1497878,133,0,0,1,1
1497879,1497911,32,1,0,0,1
1497879,1497924,45,1,0,0,2
1497912,1498157,245,0,0,1,1
1497925,1498156,231,0,0,1,2
1498157,1498586,429,1,0,0,2
1498158,1498640,482,1,0,0,1
1498257,1498629,372,0,1,0,1
1498264,1498317,53,0,1,0,2
1498366,1498547,181,0,1,0,2
1498587,1498698,111,0,0,1,2
1498641,1498697,56,0,0,1,1
1498698,1498766,68,1,0,0,1
1498699,1498776,77,1,0,0,2
1498767,1499159,392,0,0,1,1
1498777,1499173,396,0,0,1,2
1499160,1499398,238,1,0,0,1
1499174,1499465,291,1,0,0,2
1499191,1499340,149,0,1,0,1
1499200,1499362,162,0,1,0,2
1499399,1499659,260,0,0,1,1
1499466,1499656,190,0,0,1,2
1499657,1500614,957,1,0,0,2
1499660,1500668,1008,1,0,0,1
1499691,1500646,955,0,1,0,1
1499692,1500566,874,0,1,0,2
1500615,1500745,130,0,0,1,2
1500669,1500745,76,0,0,1,1
1500746,1501651,905,1,0,0,2
1500746,1501656,910,1,0,0,1
1500770,1501645,875,0,1,0,1
1500779,1501617,838,0,1,0,2
1501652,1501717,65,0,0,1,2
1501657,1501714,57,0,0,1,1
1501715,1501762,47,1,0,0,1
1501718,1501762,44,1,0,0,2
1501763,1502253,490,0,0,1,1
1501763,1502253,490,0,0,1,2
1502254,1503157,903,1,0,0,2
1502254,1503185,931,1,0,0,1
1502299,1503174,875,0,1,0,1
1502306,1503144,838,0,1,0,2
1503158,1503244,86,0,0,1,2
1503186,1503243,57,0,0,1,1
1503244,1503291,47,1,0,0,1
1503245,1503303,58,1,0,0,2
1503292,1503525,233,0,0,1,1
1503304,1503529,225,0,0,1,2
1503526,1503542,16,1,0,0,1
1503530,1503547,17,1,0,0,2
1503543,1503864,321,0,0,1,1
1503548,1503873,325,0,0,1,2
1503865,1504067,202,1,0,0,1
1503874,1504059,185,1,0,0,2
1503890,1504026,136,0,1,0,1
1503896,1503992,96,0,1,0,2
1504060,1504220,160,0,0,1,2
1504068,1504224,156,0,0,1,1
1504221,1504238,17,1,0,0,2
1504225,1504238,13,1,0,0,1
1504239,1505202,963,0,0,1,1
1504239,1505202,963,0,0,1,2
1505203,1505254,51,1,0,0,1
1505203,1505260,57,1,0,0,2
1505255,1505491,236,0,0,1,1
1505261,1505492,231,0,0,1,2
1505492,1505522,30,1,0,0,1
1505493,1505530,37,1,0,0,2
1505523,1505701,178,0,0,1,1
1505531,1505703,172,0,0,1,2
1505702,1505760,58,1,0,0,1
1505704,1505763,59,1,0,0,2
1505761,1505886,125,0,0,1,1
1505764,1505885,121,0,0,1,2
1505886,1505911,25,1,0,0,2
1505887,1505910,23,1,0,0,1
1505911,1506211,300,0,0,1,1
1505912,1506224,312,0,0,1,2
1506212,1506824,612,1,0,0,1
1506225,1506608,383,1,0,0,2
1506244,1506803,559,0,1,0,1
1506251,1506557,306,0,1,0,2
1506609,1506723,114,0,0,1,2
1506724,1506796,72,1,0,0,2
1506797,1506863,66,0,0,1,2
1506825,1506863,38,0,0,1,1
1506864,1506918,54,1,0,0,1
1506864,1506921,57,1,0,0,2
1506919,1507446,527,0,0,1,1
1506922,1507445,523,0,0,1,2
1507446,1507462,16,1,0,0,2
1507447,1507464,17,1,0,0,1
1507463,1507822,359,0,0,1,2
1507465,1507822,357,0,0,1,1
1507823,1512584,4761,1,0,0,2
1507823,1512773,4950,1,0,0,1
1507874,1512756,4882,0,1,0,1
1507880,1512461,4581,0,1,0,2
1512585,1513364,779,0,0,1,2
1512774,1513364,590,0,0,1,1
1513365,1513414,49,1,0,0,1
1513365,1513419,54,1,0,0,2
1513415,1513594,179,0,0,1,1
1513420,1513595,175,0,0,1,2
1513595,1513643,48,1,0,0,1
1513596,1513644,48,1,0,0,2
1513644,1514098,454,0,0,1,1
1513645,1514097,452,0,0,1,2
1514098,1514119,21,1,0,0,2
1514099,1514122,23,1,0,0,1
1514120,1514250,130,0,0,1,2
1514123,1514245,122,0,0,1,1
1514246,1514549,303,1,0,0,1
1514251,1514537,286,1,0,0,2
1514268,1514502,234,0,1,0,1
1514273,1514458,185,0,1,0,2
1514538,1514586,48,0,0,1,2
1514550,1514584,34,0,0,1,1
1514585,1514607,22,1,0,0,1
1514587,1514607,20,1,0,0,2
1514608,1515553,945,0,0,1,1
1514608,1515567,959,0,0,1,2
1515554,1515806,252,1,0,0,1
1515568,1515802,234,1,0,0,2
1515588,1515753,165,0,1,0,1
1515589,1515736,147,0,1,0,2
1515803,1515966,163,0,0,1,2
1515807,1515958,151,0,0,1,1
1515959,1515975,16,1,0,0,1
1515967,1515975,8,1,0,0,2
1515976,1516761,785,0,0,1,1
1515976,1516764,788,0,0,1,2
1516762,1516985,223,1,0,0,1
1516765,1516990,225,1,0,0,2
1516782,1516971,189,0,1,0,1
1516789,1516938,149,0,1,0,2
1516986,1518150,1164,0,0,1,1
1516991,1518168,1177,0,0,1,2
1518151,1518409,258,1,0,0,1
1518169,1518410,241,1,0,0,2
1518188,1518365,177,0,1,0,1
1518193,1518330,137,0,1,0,2
1518410,1518523,113,0,0,1,1
1518411,1518525,114,0,0,1,2
1518524,1518549,25,1,0,0,1
1518526,1518544,18,1,0,0,2
1518545,1519182,637,0,0,1,2
1518550,1519183,633,0,0,1,1
1519183,1519403,220,1,0,0,2
1519184,1519294,110,1,0,0,1
1519295,1519441,146,0,0,1,1
1519404,1519441,37,0,0,1,2
1519442,1519539,97,1,0,0,1
1519442,1521391,1949,1,0,0,2
1519471,1521376,1905,0,1,0,2
1519496,1519530,34,0,1,0,1
1519540,1519644,104,0,0,1,1
1519655,1519728,73,0,1,0,1
1519738,1519778,40,1,0,0,1
1519754,1519768,14,0,1,0,1
1519779,1519874,95,0,0,1,1
1519875,1521529,1654,1,0,0,1
1519909,1520014,105,0,1,0,1
1520048,1521488,1440,0,1,0,1
1521392,1521506,114,0,0,1,2
1521507,1521550,43,1,0,0,2
1521530,1521904,374,0,0,1,1
1521551,1521905,354,0,0,1,2
1521905,1521924,19,1,0,0,1
1521906,1521924,18,1,0,0,2
1521925,1522174,249,0,0,1,2
1521925,1523997,2072,0,0,1,1
1522175,1522184,9,1,0,0,2
1522185,1524001,1816,0,0,1,2
1523998,1524252,254,1,0,0,1
1524002,1524601,599,1,0,0,2
1524021,1524241,220,0,1,0,1
1524034,1524306,272,0,1,0,2
1524253,1524517,264,0,0,1,1
1524518,1524601,83,1,0,0,1
1524602,1524871,269,0,0,1,1
1524602,1524871,269,0,0,1,2
1524872,1525001,129,1,0,0,2
1524872,1526028,1156,1,0,0,1
1524926,1525247,321,0,1,0,1
1525002,1525103,101,0,0,1,2
1525104,1525162,58,1,0,0,2
1525163,1525271,108,0,0,1,2
1525272,1526134,862,1,0,0,2
1525310,1526007,697,0,1,0,1
1525339,1525984,645,0,1,0,2
1526029,1526056,27,0,0,1,1
1526057,1602829,76772,1,0,0,1
1526135,1526314,179,0,0,1,2
1526159,1602816,76657,0,1,0,1
1526315,1534269,7954,1,0,0,2
1526328,1534224,7896,0,1,0,2
1534270,1534364,94,0,0,1,2
1534365,1535036,671,1,0,0,2
1534396,1534947,551,0,1,0,2
1535037,1535460,423,0,0,1,2
1535461,1602822,67361,1,0,0,2
1535490,1602784,67294,0,1,0,2
1602823,1603158,335,0,0,1,2
1602830,1603158,328,0,0,1,1
1603159,1603277,118,1,0,0,1
1603159,1603289,130,1,0,0,2
1603278,1603383,105,0,0,1,1
1603290,1603383,93,0,0,1,2
1603384,1603455,71,1,0,0,2
1603384,1603460,76,1,0,0,1
1603456,1603732,276,0,0,1,2
1603461,1603823,362,0,0,1,1
1603733,1605106,1373,1,0,0,2
1603824,1605099,1275,1,0,0,1
1603872,1604962,1090,0,1,0,1
1603874,1604927,1053,0,1,0,2
1605100,1605350,250,0,0,1,1
1605107,1605349,242,0,0,1,2
1605350,1605376,26,1,0,0,2
1605351,1605363,12,1,0,0,1
1605364,1606180,816,0,0,1,1
1605377,1606185,808,0,0,1,2
1606181,1606199,18,1,0,0,1
1606186,1606195,9,1,0,0,2
1606196,1606456,260,0,0,1,2
1606200,1607062,862,0,0,1,1
1606457,1606472,15,1,0,0,2
1606473,1607546,1073,0,0,1,2
1607063,1607083,20,1,0,0,1
1607084,1607274,190,0,0,1,1
1607275,1607390,115,1,0,0,1
1607391,1607456,65,0,0,1,1
1607457,1643593,36136,1,0,0,1
1607547,1642418,34871,1,0,0,2
1607584,1643566,35982,0,1,0,1
1607621,1642408,34787,0,1,0,2
1642419,1642498,79,0,0,1,2
1642499,1643556,1057,1,0,0,2
1642555,1643465,910,0,1,0,2
1643557,1643737,180,0,0,1,2
1643594,1643735,141,0,0,1,1
1643736,1643762,26,1,0,0,1
1643738,1643762,24,1,0,0,2
1643763,1644659,896,0,0,1,1
1643763,1644659,896,0,0,1,2
1644660,1700134,55474,1,0,0,2
1644660,1700228,55568,1,0,0,1
1644702,1700199,55497,0,1,0,1
1644723,1648225,3502,0,1,0,2
1648283,1700125,51842,0,1,0,2
1700135,1700257,122,0,0,1,2
1700229,1700254,25,0,0,1,1
1700255,1700380,125,1,0,0,1
1700258,1700350,92,1,0,0,2
1700351,1700479,128,0,0,1,2
1700381,1700834,453,0,0,1,1
1700480,1700602,122,1,0,0,2
1700603,1700765,162,0,0,1,2
1700766,1700785,19,1,0,0,2
1700786,1700836,50,0,0,1,2
1700835,1700912,77,1,0,0,1
1700837,1700920,83,1,0,0,2
1700913,1701037,124,0,0,1,1
1700921,1701039,118,0,0,1,2
1701038,1701092,54,1,0,0,1
1701040,1701106,66,1,0,0,2
1701093,1701301,208,0,0,1,1
1701107,1701307,200,0,0,1,2
1701302,1701465,163,1,0,0,1
1701308,1701450,142,1,0,0,2
1701321,1701443,122,0,1,0,1
1701327,1701415,88,0,1,0,2
1701451,1701526,75,0,0,1,2
1701466,1701524,58,0,0,1,1
1701525,1702453,928,1,0,0,1
1701527,1702457,930,1,0,0,2
1701566,1702442,876,0,1,0,1
1701572,1702388,816,0,1,0,2
1702454,1702900,446,0,0,1,1
1702458,1702883,425,0,0,1,2
1702884,1704306,1422,1,0,0,2
1702901,1704278,1377,1,0,0,1
1702922,1704265,1343,0,1,0,1
1702928,1704237,1309,0,1,0,2
1704279,1704383,104,0,0,1,1
1704307,1704384,77,0,0,1,2
1704384,1704426,42,1,0,0,1
1704385,1704432,47,1,0,0,2
1704427,1704545,118,0,0,1,1
1704433,1704545,112,0,0,1,2
1704546,1704572,26,1,0,0,2
1704546,1704577,31,1,0,0,1
1704573,1704849,276,0,0,1,2
1704578,1704848,270,0,0,1,1
1704849,1707532,2683,1,0,0,1
1704850,1707554,2704,1,0,0,2
1704913,1707515,2602,0,1,0,2
1704916,1707518,2602,0,1,0,1
1707533,1707653,120,0,0,1,1
1707555,1707652,97,0,0,1,2
1707653,1707718,65,1,0,0,2
1707654,1707701,47,1,0,0,1
1707702,1707852,150,0,0,1,1
1707719,1707852,133,0,0,1,2
1707853,1707893,40,1,0,0,1
1707853,1707916,63,1,0,0,2
1707894,1708133,239,0,0,1,1
1707917,1708132,215,0,0,1,2
1708133,1708349,216,1,0,0,2
1708134,1708227,93,1,0,0,1
1708228,1708712,484,0,0,1,1
1708350,1708708,358,0,0,1,2
1708709,1708793,84,1,0,0,2
1708713,1708793,80,1,0,0,1
1708794,1708951,157,0,0,1,1
1708794,1708952,158,0,0,1,2
1708952,1710102,1150,1,0,0,1
1708953,1710113,1160,1,0,0,2
1708992,1710083,1091,0,1,0,1
1709001,1710055,1054,0,1,0,2
1710103,1710171,68,0,0,1,1
1710114,1710173,59,0,0,1,2
1710172,1710225,53,1,0,0,1
1710174,1710226,52,1,0,0,2
1710226,1710373,147,0,0,1,1
1710227,1710373,146,0,0,1,2
1710374,1710395,21,1,0,0,1
1710374,1710410,36,1,0,0,2
1710396,1710526,130,0,0,1,1
1710411,1710528,117,0,0,1,2
1710527,1710546,19,1,0,0,1
1710529,1710590,61,1,0,0,2
1710547,1710849,302,0,0,1,1
1710591,1710851,260,0,0,1,2
1710850,1711355,505,1,0,0,1
1710852,1711357,505,1,0,0,2
1710908,1711314,406,0,1,0,1
1710913,1711319,406,0,1,0,2
1711356,1711452,96,0,0,1,1
1711358,1711451,93,0,0,1,2
1711452,1711522,70,1,0,0,2
1711453,1711496,43,1,0,0,1
1711497,1711726,229,0,0,1,1
1711523,1711731,208,0,0,1,2
1711727,1711743,16,1,0,0,1
1711732,1711770,38,1,0,0,2
1711744,1712318,574,0,0,1,1
1711771,1714229,2458,0,0,1,2
1712319,1712323,4,1,0,0,1
1712324,1714227,1903,0,0,1,1
1714228,1715581,1353,1,0,0,1
1714230,1715605,1375,1,0,0,2
1714290,1715569,1279,0,1,0,2
1714295,1715565,1270,0,1,0,1
1715582,1715787,205,0,0,1,1
1715606,1715789,183,0,0,1,2
1715788,1715824,36,1,0,0,1
1715790,1715826,36,1,0,0,2
1715825,1716479,654,0,0,1,1
1715827,1716476,649,0,0,1,2
1716477,1716490,13,1,0,0,2
1716480,1716486,6,1,0,0,1
1716487,1717141,654,0,0,1,1
1716491,1717151,660,0,0,1,2
1717142,1796072,78930,1,0,0,1
1717152,1796064,78912,1,0,0,2
1717198,1796061,78863,0,1,0,1
1717209,1793822,76613,0,1,0,2
1794048,1794115,67,0,1,0,2
1794140,1794141,1,0,1,0,2
1794276,1795856,1580,0,1,0,2
1796065,1796238,173,0,0,1,2
1796073,1796235,162,0,0,1,1
1796236,1799360,3124,1,0,0,1
1796239,1799388,3149,1,0,0,2
1796258,1799328,3070,0,1,0,1
1796268,1799359,3091,0,1,0,2
1799361,1799455,94,0,0,1,1
1799389,1799454,65,0,0,1,2
1799455,1799522,67,1,0,0,2
1799456,1799508,52,1,0,0,1
1799509,1799623,114,0,0,1,1
1799523,1799624,101,0,0,1,2
1799624,1799662,38,1,0,0,1
1799625,1799664,39,1,0,0,2
1799663,1800028,365,0,0,1,1
1799665,1800031,366,0,0,1,2
1800029,1804612,4583,1,0,0,1
1800032,1804639,4607,1,0,0,2
1800090,1804602,4512,0,1,0,1
1800094,1804613,4519,0,1,0,2
1804613,1804874,261,0,0,1,1
1804640,1804810,170,0,0,1,2
1804811,1804821,10,1,0,0,2
1804822,1804859,37,0,0,1,2
1804860,1804878,18,1,0,0,2
1804875,2226899,422024,1,0,0,1
1804879,1804908,29,0,0,1,2
1804909,1881765,76856,1,0,0,2
1804909,2226890,421981,0,1,0,1
1804958,1881394,76436,0,1,0,2
1881766,1881828,62,0,0,1,2
1881829,1881982,153,1,0,0,2
1881983,1882040,57,0,0,1,2
1882041,1916003,33962,1,0,0,2
1882069,1915762,33693,0,1,0,2
1916004,1916064,60,0,0,1,2
1916065,1916069,4,1,0,0,2
1916070,1916126,56,0,0,1,2
1916127,1916161,34,1,0,0,2
1916162,1916217,55,0,0,1,2
1916218,1916292,74,1,0,0,2
1916293,1916416,123,0,0,1,2
1916417,1916600,183,1,0,0,2
1916601,1916879,278,0,0,1,2
1916880,1916901,21,1,0,0,2
1916902,1917447,545,0,0,1,2
1917448,1917457,9,1,0,0,2
1917458,1917478,20,0,0,1,2
1917479,1917530,51,1,0,0,2
1917531,1917567,36,0,0,1,2
1917568,2226535,308967,1,0,0,2
1917631,2226487,308856,0,1,0,2
2226536,2226680,144,0,0,1,2
2226681,2226772,91,1,0,0,2
2226773,2226818,45,0,0,1,2
2226819,2226840,21,1,0,0,2
2226841,2227045,204,0,0,1,2
2226900,2227042,142,0,0,1,1
2227043,2307277,80234,1,0,0,1
2227046,2307290,80244,1,0,0,2
2227081,2227081,0,0,1,0,1
2227107,2307268,80161,0,1,0,1
2227118,2307269,80151,0,1,0,2
2307278,2307426,148,0,0,1,1
2307291,2307426,135,0,0,1,2
2307427,2308727,1300,1,0,0,2
2307427,2309858,2431,1,0,0,1
2307488,2308660,1172,0,1,0,2
2307490,2308728,1238,0,1,0,1
2308728,2308748,20,0,0,1,2
2308749,2309853,1104,1,0,0,2
2308773,2309842,1069,0,1,0,2
2308804,2309810,1006,0,1,0,1
2309854,2309976,122,0,0,1,2
2309859,2309981,122,0,0,1,1
2309977,2310140,163,1,0,0,2
2309982,2310131,149,1,0,0,1
2310002,2310108,106,0,1,0,2
2310007,2310110,103,0,1,0,1
2310132,2310268,136,0,0,1,1
2310141,2310274,133,0,0,1,2
2310269,2335092,24823,1,0,0,1
2310275,2334843,24568,1,0,0,2
2310296,2335083,24787,0,1,0,1
2310298,2334789,24491,0,1,0,2
2334844,2334897,53,0,0,1,2
2334898,2334951,53,1,0,0,2
2334952,2335118,166,0,0,1,2
2335093,2335115,22,0,0,1,1
2335116,2335136,20,1,0,0,1
2335119,2335133,14,1,0,0,2
2335134,2335784,650,0,0,1,2
2335137,2335775,638,0,0,1,1
2335776,2335945,169,1,0,0,1
2335785,2335917,132,1,0,0,2
2335801,2335892,91,0,1,0,1
2335814,2335859,45,0,1,0,2
2335918,2336097,179,0,0,1,2
2335946,2336097,151,0,0,1,1
2336098,2336113,15,1,0,0,1
2336098,2336113,15,1,0,0,2
2336114,2336365,251,0,0,1,2
2336114,2337929,1815,0,0,1,1
2336366,2336370,4,1,0,0,2
2336371,2337925,1554,0,0,1,2
2337926,2345893,7967,1,0,0,2
2337930,2345917,7987,1,0,0,1
2337959,2345711,7752,0,1,0,1
2337968,2345720,7752,0,1,0,2
2345749,2345850,101,0,1,0,1
2345753,2345838,85,0,1,0,2
2345894,2346077,183,0,0,1,2
2345918,2345973,55,0,0,1,1
2345974,2345989,15,1,0,0,1
2345990,2346076,86,0,0,1,1
2346077,2346100,23,1,0,0,1
2346078,2346103,25,1,0,0,2
2346101,2346613,512,0,0,1,1
2346104,2346615,511,0,0,1,2
2346614,2346624,10,1,0,0,1
2346616,2346624,8,1,0,0,2
2346625,2346786,161,0,0,1,1
2346625,2346788,163,0,0,1,2
2346787,2346940,153,1,0,0,1
2346789,2346929,140,1,0,0,2
2346809,2346899,90,0,1,0,1
2346816,2346884,68,0,1,0,2
2346930,2347051,121,0,0,1,2
2346941,2347049,108,0,0,1,1
2347050,2347071,21,1,0,0,1
2347052,2347072,20,1,0,0,2
2347072,2347363,291,0,0,1,1
2347073,2347372,299,0,0,1,2
2347364,2347554,190,1,0,0,1
2347373,2347545,172,1,0,0,2
2347391,2347504,113,0,1,0,1
2347396,2347496,100,0,1,0,2
2347546,2348287,741,0,0,1,2
2347555,2348284,729,0,0,1,1
2348285,2348335,50,1,0,0,1
2348288,2348334,46,1,0,0,2
2348335,2348865,530,0,0,1,2
2348336,2348865,529,0,0,1,1
2348866,2348912,46,1,0,0,1
2348866,2348922,56,1,0,0,2
2348913,2349437,524,0,0,1,1
2348923,2349436,513,0,0,1,2
2349437,2349474,37,1,0,0,2
2349438,2349463,25,1,0,0,1
2349464,2349678,214,0,0,1,1
2349475,2349681,206,0,0,1,2
2349679,2349829,150,1,0,0,1
2349682,2349787,105,1,0,0,2
2349770,2349820,50,0,1,0,1
2349788,2349855,67,0,0,1,2
2349830,2349853,23,0,0,1,1
2349854,2387527,37673,1,0,0,1
2349856,2387498,37642,1,0,0,2
2349866,2387518,37652,0,1,0,1
2349892,2387489,37597,0,1,0,2
2387499,2387577,78,0,0,1,2
2387528,2387573,45,0,0,1,1
2387574,2387622,48,1,0,0,1
2387578,2387642,64,1,0,0,2
2387623,2387765,142,0,0,1,1
2387643,2387765,122,0,0,1,2
2387766,2387780,14,1,0,0,1
2387766,2387781,15,1,0,0,2
2387781,2387926,145,0,0,1,1
2387782,2387934,152,0,0,1,2
2387927,2388089,162,1,0,0,1
2387935,2388082,147,1,0,0,2
2387948,2388051,103,0,1,0,1
2387957,2388038,81,0,1,0,2
2388083,2388198,115,0,0,1,2
2388090,2388195,105,0,0,1,1
2388196,2388217,21,1,0,0,1
2388199,2388231,32,1,0,0,2
2388218,2388430,212,0,0,1,1
2388232,2388431,199,0,0,1,2
2388431,2388492,61,1,0,0,1
2388432,2388499,67,1,0,0,2
2388493,2388608,115,0,0,1,1
2388500,2388611,111,0,0,1,2
2388609,2388661,52,1,0,0,1
2388612,2388682,70,1,0,0,2
2388662,2388842,180,0,0,1,1
2388683,2388843,160,0,0,1,2
2388843,2388856,13,1,0,0,1
2388844,2388864,20,1,0,0,2
2388857,2389481,624,0,0,1,1
2388865,2390371,1506,0,0,1,2
2389482,2389488,6,1,0,0,1
2389489,2390372,883,0,0,1,1
2390372,2390377,5,1,0,0,2
2390373,2390386,13,1,0,0,1
2390378,2390651,273,0,0,1,2
2390387,2390654,267,0,0,1,1
2390652,2390797,145,1,0,0,2
2390655,2390810,155,1,0,0,1
2390674,2390772,98,0,1,0,1
2390680,2390753,73,0,1,0,2
2390798,2391473,675,0,0,1,2
2390811,2391457,646,0,0,1,1
2391458,2391636,178,1,0,0,1
2391474,2391631,157,1,0,0,2
2391489,2391598,109,0,1,0,1
2391496,2391589,93,0,1,0,2
2391632,2391782,150,0,0,1,2
2391637,2391782,145,0,0,1,1
2391783,2391799,16,1,0,0,2
2391783,2391802,19,1,0,0,1
2391800,2392829,1029,0,0,1,2
2391803,2392826,1023,0,0,1,1
2392827,2392999,172,1,0,0,1
2392830,2392982,152,1,0,0,2
2392848,2392960,112,0,1,0,1
2392855,2392938,83,0,1,0,2
2392983,2394592,1609,0,0,1,2
2393000,2394596,1596,0,0,1,1
2394593,2394606,13,1,0,0,2
2394597,2394605,8,1,0,0,1
2394606,2396053,1447,0,0,1,1
2394607,2396052,1445,0,0,1,2
2396053,2396131,78,1,0,0,2
2396054,2396118,64,1,0,0,1
2396119,2396320,201,0,0,1,1
2396132,2396320,188,0,0,1,2
2396321,2396399,78,1,0,0,1
2396321,2396414,93,1,0,0,2
2396400,2399564,3164,0,0,1,1
2396415,2399565,3150,0,0,1,2
2399565,2399615,50,1,0,0,1
2399566,2399622,56,1,0,0,2
2399616,2400613,997,0,0,1,1
2399623,2400656,1033,0,0,1,2
2400614,2400623,9,1,0,0,1
2400624,2400653,29,0,0,1,1
2400654,2401210,556,1,0,0,1
2400657,2401239,582,1,0,0,2
2400668,2401182,514,0,1,0,1
2400670,2401228,558,0,1,0,2
2401211,2401593,382,0,0,1,1
2401240,2401393,153,0,0,1,2
2401394,2401428,34,1,0,0,2
2401429,2401517,88,0,0,1,2
2401518,2401541,23,1,0,0,2
2401542,2402510,968,0,0,1,2
2401594,2401833,239,1,0,0,1
2401834,2402132,298,0,0,1,1
2402133,2402137,4,1,0,0,1
2402138,2402923,785,0,0,1,1
2402511,2402543,32,1,0,0,2
2402544,2402926,382,0,0,1,2
2402924,2403121,197,1,0,0,1
2402927,2403095,168,1,0,0,2
2402944,2403058,114,0,1,0,2
2402946,2403073,127,0,1,0,1
2403096,2403237,141,0,0,1,2
2403122,2403236,114,0,0,1,1
2403237,2403267,30,1,0,0,1
2403238,2403264,26,1,0,0,2
2403265,2403430,165,0,0,1,2
2403268,2403434,166,0,0,1,1
2403431,2403442,11,1,0,0,2
2403435,2403449,14,1,0,0,1
2403443,2404601,1158,0,0,1,2
2403450,2404606,1156,0,0,1,1
2404602,2404621,19,1,0,0,2
2404607,2404616,9,1,0,0,1
2404617,2405880,1263,0,0,1,1
2404622,2405878,1256,0,0,1,2
2405879,2405947,68,1,0,0,2
2405881,2405936,55,1,0,0,1
2405937,2405999,62,0,0,1,1
2405948,2406001,53,0,0,1,2
2406000,2406048,48,1,0,0,1
2406002,2406053,51,1,0,0,2
2406049,2406204,155,0,0,1,1
2406054,2406211,157,0,0,1,2
2406205,2406224,19,1,0,0,1
2406212,2406229,17,1,0,0,2
2406225,2406541,316,0,0,1,1
2406230,2406554,324,0,0,1,2
2406542,2406692,150,1,0,0,1
2406555,2406696,141,1,0,0,2
2406568,2406653,85,0,1,0,1
2406576,2406629,53,0,1,0,2
2406693,2407372,679,0,0,1,1
2406697,2407366,669,0,0,1,2
2407367,2407381,14,1,0,0,2
2407373,2407385,12,1,0,0,1
2407382,2409007,1625,0,0,1,2
2407386,2407660,274,0,0,1,1
2407661,2407672,11,1,0,0,1
2407673,2409006,1333,0,0,1,1
2409007,2409090,83,1,0,0,1
2409008,2409090,82,1,0,0,2
2409091,2409132,41,0,0,1,2
2409091,2409244,153,0,0,1,1
2409133,2409325,192,1,0,0,2
2409245,2409318,73,1,0,0,1
2409319,2409434,115,0,0,1,1
2409326,2409436,110,0,0,1,2
2409435,2409469,34,1,0,0,1
2409437,2409469,32,1,0,0,2
2409470,2410264,794,0,0,1,1
2409470,2410265,795,0,0,1,2
2410265,2410449,184,1,0,0,1
2410266,2410462,196,1,0,0,2
2410282,2410412,130,0,1,0,1
2410285,2410404,119,0,1,0,2
2410450,2410603,153,0,0,1,1
2410463,2412504,2041,0,0,1,2
2410604,2410612,8,1,0,0,1
2410613,2412503,1890,0,0,1,1
2412504,2412706,202,1,0,0,1
2412505,2412708,203,1,0,0,2
2412522,2412671,149,0,1,0,1
2412527,2412655,128,0,1,0,2
2412707,2412843,136,0,0,1,1
2412709,2412844,135,0,0,1,2
2412844,2412909,65,1,0,0,1
2412845,2412921,76,1,0,0,2
2412910,2413045,135,0,0,1,1
2412922,2413044,122,0,0,1,2
2413045,2413086,41,1,0,0,2
2413046,2413080,34,1,0,0,1
2413081,2413162,81,0,0,1,1
2413087,2415665,2578,0,0,1,2
2413163,2413167,4,1,0,0,1
2413168,2414196,1028,0,0,1,1
2414197,2414202,5,1,0,0,1
2414203,2415301,1098,0,0,1,1
2415312,2415319,7,0,1,0,1
2415328,2415328,0,1,0,0,1
2415329,2415643,314,0,0,1,1
2415644,2415731,87,1,0,0,1
2415666,2415757,91,1,0,0,2
2415732,2416076,344,0,0,1,1
2415758,2416077,319,0,0,1,2
2416077,2416122,45,1,0,0,1
2416078,2416130,52,1,0,0,2
2416123,2416292,169,0,0,1,1
2416131,2416293,162,0,0,1,2
2416293,2416308,15,1,0,0,1
2416294,2416307,13,1,0,0,2
2416308,2418496,2188,0,0,1,2
2416309,2418499,2190,0,0,1,1
2418497,2418793,296,1,0,0,2
2418500,2418865,365,1,0,0,1
2418521,2418855,334,0,1,0,1
2418530,2418776,246,0,1,0,2
2418794,2418856,62,0,0,1,2
2418857,2418962,105,1,0,0,2
2418866,2418909,43,0,0,1,1
2418910,2418958,48,1,0,0,1
2418959,2419067,108,0,0,1,1
2418963,2419066,103,0,0,1,2
2419067,2419091,24,1,0,0,2
2419068,2419090,22,1,0,0,1
2419091,2421315,2224,0,0,1,1
2419092,2421317,2225,0,0,1,2
2421316,2421361,45,1,0,0,1
2421318,2421361,43,1,0,0,2
2421362,2421546,184,0,0,1,1
2421362,2421547,185,0,0,1,2
2421547,2421575,28,1,0,0,1
2421548,2421575,27,1,0,0,2
2421576,2421752,176,0,0,1,2
2421576,2421753,177,0,0,1,1
2421753,2421760,7,1,0,0,2
2421754,2421758,4,1,0,0,1
2421759,2423432,1673,0,0,1,1
2421761,2423438,1677,0,0,1,2
2423433,2423737,304,1,0,0,1
2423439,2423770,331,1,0,0,2
2423451,2423717,266,0,1,0,1
2423454,2423696,242,0,1,0,2
2423738,2423855,117,0,0,1,1
2423771,2423857,86,0,0,1,2
2423856,2426186,2330,1,0,0,1
2423858,2423927,69,1,0,0,2
2423907,2426168,2261,0,1,0,1
2423928,2424087,159,0,0,1,2
2424088,2424100,12,1,0,0,2
2424101,2426092,1991,0,0,1,2
2426093,2426198,105,1,0,0,2
2426187,2426251,64,0,0,1,1
2426199,2426253,54,0,0,1,2
2426252,2426290,38,1,0,0,1
2426254,2426304,50,1,0,0,2
2426291,2426361,70,0,0,1,1
2426305,2426363,58,0,0,1,2
2426362,2426391,29,1,0,0,1
2426364,2426425,61,1,0,0,2
2426392,2426628,236,0,0,1,1
2426426,2426576,150,0,0,1,2
2426577,2426642,65,1,0,0,2
2426629,2426633,4,1,0,0,1
2426634,2428527,1893,0,0,1,1
2426643,2426768,125,0,0,1,2
2426769,2426786,17,1,0,0,2
2426787,2427421,634,0,0,1,2
2427422,2427451,29,1,0,0,2
2427452,2428529,1077,0,0,1,2
2428528,2430811,2283,1,0,0,1
2428530,2428626,96,1,0,0,2
2428627,2428653,26,0,0,1,2
2428647,2430800,2153,0,1,0,1
2428654,2428679,25,1,0,0,2
2428680,2428743,63,0,0,1,2
2428744,2428817,73,1,0,0,2
2428818,2429070,252,0,0,1,2
2429071,2429091,20,1,0,0,2
2429092,2429348,256,0,0,1,2
2429349,2430873,1524,1,0,0,2
2429380,2430797,1417,0,1,0,2
2430812,2431076,264,0,0,1,1
2430874,2431113,239,0,0,1,2
2431077,2431175,98,1,0,0,1
2431114,2431270,156,1,0,0,2
2431176,2432392,1216,0,0,1,1
2431271,2431350,79,0,0,1,2
2431351,2431800,449,1,0,0,2
2431801,2432178,377,0,0,1,2
2432179,2432204,25,1,0,0,2
2432205,2432293,88,0,0,1,2
2432294,2432413,119,1,0,0,2
2432393,2432405,12,1,0,0,1
2432406,2433767,1361,0,0,1,1
2432414,2433075,661,0,0,1,2
2433076,2433223,147,1,0,0,2
2433224,2433769,545,0,0,1,2
2433768,2433850,82,1,0,0,1
2433770,2433851,81,1,0,0,2
2433851,2433963,112,0,0,1,1
2433852,2433964,112,0,0,1,2
2433964,2434006,42,1,0,0,1
2433965,2434003,38,1,0,0,2
2434004,2434320,316,0,0,1,2
2434007,2435826,1819,0,0,1,1
2434321,2434328,7,1,0,0,2
2434329,2434886,557,0,0,1,2
2434887,2434898,11,1,0,0,2
2434899,2435829,930,0,0,1,2
2435827,2436115,288,1,0,0,1
2435830,2436082,252,1,0,0,2
2435854,2436064,210,0,1,0,1
2435857,2436060,203,0,1,0,2
2436083,2436268,185,0,0,1,2
2436116,2436268,152,0,0,1,1
2436269,2438741,2472,1,0,0,2
2436269,2438796,2527,1,0,0,1
2436320,2438780,2460,0,1,0,1
2436324,2438709,2385,0,1,0,2
2438742,2438843,101,0,0,1,2
2438797,2438839,42,0,0,1,1
2438840,2438870,30,1,0,0,1
2438844,2438870,26,1,0,0,2
2438871,2439138,267,0,0,1,1
2438871,2440972,2101,0,0,1,2
2439139,2439148,9,1,0,0,1
2439149,2440972,1823,0,0,1,1
2440973,2441054,81,1,0,0,1
2440973,2442289,1316,1,0,0,2
2441055,2441197,142,0,0,1,1
2441117,2442259,1142,0,1,0,2
2441198,2441604,406,1,0,0,1
2441221,2441581,360,0,1,0,1
2441605,2441687,82,0,0,1,1
2441698,2443571,1873,0,1,0,1
2442290,2442310,20,0,0,1,2
2442311,2443551,1240,1,0,0,2
2442951,2443484,533,0,1,0,2
2443552,2443632,80,0,0,1,2
2443581,2443581,0,1,0,0,1
2443582,2443632,50,0,0,1,1
2443633,2443664,31,1,0,0,2
2443633,2443666,33,1,0,0,1
2443665,2444230,565,0,0,1,2
2443667,2443862,195,0,0,1,1
2443863,2443873,10,1,0,0,1
2443874,2444235,361,0,0,1,1
2444231,2444247,16,1,0,0,2
2444236,2444240,4,1,0,0,1
2444241,2445512,1271,0,0,1,1
2444248,2445511,1263,0,0,1,2
2445512,2445582,70,1,0,0,2
2445513,2445577,64,1,0,0,1
2445578,2445688,110,0,0,1,1
2445583,2445689,106,0,0,1,2
2445689,2445725,36,1,0,0,1
2445690,2445724,34,1,0,0,2
2445725,2445910,185,0,0,1,2
2445726,2445913,187,0,0,1,1
2445911,2445931,20,1,0,0,2
2445914,2445930,16,1,0,0,1
2445931,2447643,1712,0,0,1,1
2445932,2447642,1710,0,0,1,2
2447643,2447699,56,1,0,0,2
2447644,2447706,62,1,0,0,1
2447700,2447823,123,0,0,1,2
2447707,2447823,116,0,0,1,1
2447824,2447843,19,1,0,0,2
2447824,2447848,24,1,0,0,1
2447844,2449435,1591,0,0,1,2
2447849,2449434,1585,0,0,1,1
2449435,2452053,2618,1,0,0,1
2449436,2452046,2610,1,0,0,2
2449459,2452026,2567,0,1,0,1
2449466,2451996,2530,0,1,0,2
2452047,2452143,96,0,0,1,2
2452054,2452142,88,0,0,1,1
2452143,2452179,36,1,0,0,1
2452144,2452189,45,1,0,0,2
2452180,2452312,132,0,0,1,1
2452190,2452312,122,0,0,1,2
2452313,2452327,14,1,0,0,2
2452313,2452329,16,1,0,0,1
2452328,2454051,1723,0,0,1,2
2452330,2454050,1720,0,0,1,1
2454051,2454100,49,1,0,0,1
2454052,2454100,48,1,0,0,2
2454101,2454181,80,0,0,1,2
2454101,2454182,81,0,0,1,1
2454182,2454204,22,1,0,0,2
2454183,2454206,23,1,0,0,1
2454205,2454764,559,0,0,1,2
2454207,2456122,1915,0,0,1,1
2454765,2454772,7,1,0,0,2
2454773,2456123,1350,0,0,1,2
2456123,2456217,94,1,0,0,1
2456124,2456189,65,1,0,0,2
2456190,2456432,242,0,0,1,2
2456218,2456294,76,0,0,1,1
2456295,2456528,233,1,0,0,1
2456334,2456401,67,0,1,0,1
2456433,2456454,21,1,0,0,2
2456455,2458105,1650,0,0,1,2
2456529,2456550,21,0,0,1,1
2456551,2456669,118,1,0,0,1
2456670,2456904,234,0,0,1,1
2456915,2458166,1251,0,1,0,1
2458106,2458176,70,1,0,0,2
2458176,2458177,1,1,0,0,1
2458177,2458273,96,0,0,1,2
2458178,2458272,94,0,0,1,1
2458273,2458299,26,1,0,0,1
2458274,2458302,28,1,0,0,2
2458300,2460158,1858,0,0,1,1
2458303,2458519,216,0,0,1,2
2458520,2458524,4,1,0,0,2
2458525,2460157,1632,0,0,1,2
2460158,2460226,68,1,0,0,2
2460159,2460217,58,1,0,0,1
2460218,2460425,207,0,0,1,1
2460227,2460419,192,0,0,1,2
2460420,2460812,392,1,0,0,2
2460426,2460732,306,1,0,0,1
2460441,2460690,249,0,1,0,1
2460451,2460712,261,0,1,0,2
2460733,2460773,40,0,0,1,1
2460774,2460783,9,1,0,0,1
2460784,2462186,1402,0,0,1,1
2460813,2462188,1375,0,0,1,2
2462187,2462241,54,1,0,0,1
2462189,2462249,60,1,0,0,2
2462242,2462427,185,0,0,1,1
2462250,2462427,177,0,0,1,2
2462428,2462439,11,1,0,0,2
2462428,2462440,12,1,0,0,1
2462440,2464359,1919,0,0,1,2
2462441,2464357,1916,0,0,1,1
2464358,2464422,64,1,0,0,1
2464360,2464421,61,1,0,0,2
2464422,2464566,144,0,0,1,2
2464423,2464566,143,0,0,1,1
2464567,2464594,27,1,0,0,1
2464567,2464607,40,1,0,0,2
2464595,2464746,151,0,0,1,1
2464608,2464747,139,0,0,1,2
2464747,2464764,17,1,0,0,1
2464748,2464761,13,1,0,0,2
2464762,2465198,436,0,0,1,2
2464765,2465199,434,0,0,1,1
2465199,2465208,9,1,0,0,2
2465200,2465210,10,1,0,0,1
2465209,2466406,1197,0,0,1,2
2465211,2466407,1196,0,0,1,1
2466407,2466479,72,1,0,0,2
2466408,2466477,69,1,0,0,1
2466478,2466686,208,0,0,1,1
2466480,2466693,213,0,0,1,2
2466687,2466704,17,1,0,0,1
2466694,2466698,4,1,0,0,2
2466699,2468726,2027,0,0,1,2
2466705,2468727,2022,0,0,1,1
2468727,2468795,68,1,0,0,2
2468728,2468797,69,1,0,0,1
2468796,2468909,113,0,0,1,2
2468798,2468909,111,0,0,1,1
2468910,2468932,22,1,0,0,1
2468910,2468935,25,1,0,0,2
2468933,2469123,190,0,0,1,1
2468936,2469122,186,0,0,1,2
2469123,2469329,206,1,0,0,2
2469124,2469320,196,1,0,0,1
2469141,2469302,161,0,1,0,1
2469150,2469272,122,0,1,0,2
2469321,2471071,1750,0,0,1,1
2469330,2469511,181,0,0,1,2
2469512,2469519,7,1,0,0,2
2469520,2471071,1551,0,0,1,2
2471072,2471149,77,1,0,0,2
2471072,2471304,232,1,0,0,1
2471139,2471269,130,0,1,0,1
2471150,2471268,118,0,0,1,2
2471269,2471348,79,1,0,0,2
2471305,2472786,1481,0,0,1,1
2471338,2471339,1,0,1,0,2
2471349,2471476,127,0,0,1,2
2471487,2473218,1731,0,1,0,2
2472797,2473298,501,0,1,0,1
2473228,2473232,4,1,0,0,2
2473233,2473337,104,0,0,1,2
2473308,2474004,696,1,0,0,1
2473338,2473448,110,1,0,0,2
2473360,2473993,633,0,1,0,1
2473449,2475106,1657,0,0,1,2
2474005,2474392,387,0,0,1,1
2474403,2474586,183,0,1,0,1
2474596,2475182,586,1,0,0,1
2474612,2475171,559,0,1,0,1
2475107,2475510,403,1,0,0,2
2475183,2475280,97,0,0,1,1
2475281,2475314,33,1,0,0,1
2475315,2475465,150,0,0,1,1
2475466,2475470,4,1,0,0,1
2475471,2476891,1420,0,0,1,1
2475511,2475684,173,0,0,1,2
2475685,2475805,120,1,0,0,2
2475806,2476040,234,0,0,1,2
2476041,2476077,36,1,0,0,2
2476078,2476165,87,0,0,1,2
2476166,2476220,54,1,0,0,2
2476221,2476300,79,0,0,1,2
2476301,2476464,163,1,0,0,2
2476465,2476537,72,0,0,1,2
2476538,2476854,316,1,0,0,2
2476855,2476892,37,0,0,1,2
2476892,2476940,48,1,0,0,1
2476893,2476938,45,1,0,0,2
2476939,2478908,1969,0,0,1,2
2476941,2478907,1966,0,0,1,1
2478908,2479104,196,1,0,0,1
2478909,2479080,171,1,0,0,2
2478942,2479040,98,0,1,0,1
2478961,2479015,54,0,1,0,2
2479081,2479195,114,0,0,1,2
2479105,2479193,88,0,0,1,1
2479194,2479226,32,1,0,0,1
2479196,2479225,29,1,0,0,2
2479226,2479372,146,0,0,1,2
2479227,2479373,146,0,0,1,1
2479373,2479384,11,1,0,0,2
2479374,2479389,15,1,0,0,1
2479385,2479781,396,0,0,1,2
2479390,2480746,1356,0,0,1,1
2479782,2479792,10,1,0,0,2
2479793,2480745,952,0,0,1,2
2480746,2480805,59,1,0,0,2
2480747,2480811,64,1,0,0,1
2480806,2480930,124,0,0,1,2
2480812,2480930,118,0,0,1,1
2480931,2480961,30,1,0,0,1
2480931,2480962,31,1,0,0,2
2480962,2482735,1773,0,0,1,1
2480963,2482737,1774,0,0,1,2
2482736,2482830,94,1,0,0,1
2482738,2482829,91,1,0,0,2
2482830,2482939,109,0,0,1,2
2482831,2482939,108,0,0,1,1
2482940,2482973,33,1,0,0,1
2482940,2482973,33,1,0,0,2
2482974,2483208,234,0,0,1,1
2482974,2484494,1520,0,0,1,2
2483209,2483219,10,1,0,0,1
2483220,2484493,1273,0,0,1,1
2484494,2484601,107,1,0,0,1
2484495,2484609,114,1,0,0,2
2484602,2484717,115,0,0,1,1
2484610,2484647,37,0,0,1,2
2484648,2484675,27,1,0,0,2
2484676,2484716,40,0,0,1,2
2484717,2484763,46,1,0,0,2
2484718,2484740,22,1,0,0,1
2484741,2484973,232,0,0,1,1
2484764,2485309,545,0,0,1,2
2484974,2484983,9,1,0,0,1
2484984,2485312,328,0,0,1,1
2485310,2486430,1120,1,0,0,2
2485313,2485909,596,1,0,0,1
2485337,2485887,550,0,1,0,1
2485338,2486419,1081,0,1,0,2
2485910,2486348,438,0,0,1,1
2486349,2486428,79,1,0,0,1
2486429,2486545,116,0,0,1,1
2486431,2486547,116,0,0,1,2
2486546,2486581,35,1,0,0,1
2486548,2486580,32,1,0,0,2
2486581,2488094,1513,0,0,1,2
2486582,2487063,481,0,0,1,1
2487064,2487072,8,1,0,0,1
2487073,2488094,1021,0,0,1,1
2488095,2488165,70,1,0,0,1
2488095,2488168,73,1,0,0,2
2488166,2488324,158,0,0,1,1
2488169,2488324,155,0,0,1,2
2488325,2488345,20,1,0,0,2
2488325,2488348,23,1,0,0,1
2488346,2489858,1512,0,0,1,2
2488349,2489857,1508,0,0,1,1
2489858,2489942,84,1,0,0,1
2489859,2489956,97,1,0,0,2
2489943,2490068,125,0,0,1,1
2489957,2490067,110,0,0,1,2
2490068,2490093,25,1,0,0,2
2490069,2490093,24,1,0,0,1
2490094,2490747,653,0,0,1,1
2490094,2490748,654,0,0,1,2
2490748,2490790,42,1,0,0,1
2490749,2490788,39,1,0,0,2
2490789,2491554,765,0,0,1,2
2490791,2491553,762,0,0,1,1
2491554,2491617,63,1,0,0,1
2491555,2491625,70,1,0,0,2
2491618,2491724,106,0,0,1,1
2491626,2491726,100,0,0,1,2
2491725,2491765,40,1,0,0,1
2491727,2491815,88,1,0,0,2
2491766,2491819,53,0,0,1,1
2491816,2491903,87,0,0,1,2
2491820,2491848,28,1,0,0,1
2491849,2491881,32,0,0,1,1
2491882,2491900,18,1,0,0,1
2491901,2493461,1560,0,0,1,1
2491904,2491928,24,1,0,0,2
2491929,2492349,420,0,0,1,2
2492350,2492370,20,1,0,0,2
2492371,2493061,690,0,0,1,2
2493062,2493069,7,1,0,0,2
2493070,2493186,116,0,0,1,2
2493187,2493227,40,1,0,0,2
2493228,2493462,234,0,0,1,2
2493462,2493565,103,1,0,0,1
2493463,2493589,126,1,0,0,2
2493566,2493617,51,0,0,1,1
2493590,2493619,29,0,0,1,2
2493618,2493679,61,1,0,0,1
2493620,2493704,84,1,0,0,2
2493680,2493828,148,0,0,1,1
2493705,2493833,128,0,0,1,2
2493829,2493846,17,1,0,0,1
2493834,2493869,35,1,0,0,2
2493847,2494830,983,0,0,1,1
2493870,2494829,959,0,0,1,2
2494830,2494907,77,1,0,0,2
2494831,2494898,67,1,0,0,1
2494899,2495225,326,0,0,1,1
2494908,2495227,319,0,0,1,2
2495226,2495669,443,1,0,0,1
2495228,2495346,118,1,0,0,2
2495324,2495658,334,0,1,0,1
2495347,2495417,70,0,0,1,2
2495418,2495477,59,1,0,0,2
2495478,2495536,58,0,0,1,2
2495537,2496241,704,1,0,0,2
2495670,2495999,329,0,0,1,1
2496000,2496024,24,1,0,0,1
2496025,2496305,280,0,0,1,1
2496242,2496283,41,0,0,1,2
2496284,2496307,23,1,0,0,2
2496306,2496310,4,1,0,0,1
2496308,2496657,349,0,0,1,2
2496311,2496343,32,0,0,1,1
2496344,2497098,754,1,0,0,1
2496379,2497087,708,0,1,0,1
2496658,2496702,44,1,0,0,2
2496703,2496918,215,0,0,1,2
2496919,2496939,20,1,0,0,2
2496940,2497009,69,0,0,1,2
2497010,2497108,98,1,0,0,2
2497099,2497173,74,0,0,1,1
2497109,2497174,65,0,0,1,2
2497174,2497211,37,1,0,0,1
2497175,2497215,40,1,0,0,2
2497212,2497323,111,0,0,1,1
2497216,2497325,109,0,0,1,2
2497324,2497346,22,1,0,0,1
2497326,2497358,32,1,0,0,2
2497347,2497796,449,0,0,1,1
2497359,2497805,446,0,0,1,2
2497797,2497815,18,1,0,0,1
2497806,2497811,5,1,0,0,2
2497812,2498361,549,0,0,1,2
2497816,2498348,532,0,0,1,1
2498349,2499245,896,1,0,0,1
2498362,2499258,896,1,0,0,2
2498389,2499234,845,0,1,0,1
2498393,2499247,854,0,1,0,2
2499246,2499429,183,0,0,1,1
2499259,2499430,171,0,0,1,2
2499430,2499481,51,1,0,0,1
2499431,2499485,54,1,0,0,2
2499482,2499906,424,0,0,1,1
2499486,2499907,421,0,0,1,2
2499907,2499958,51,1,0,0,1
2499908,2499963,55,1,0,0,2
2499959,2500057,98,0,0,1,1
2499964,2500059,95,0,0,1,2
2500058,2500134,76,1,0,0,1
2500060,2500135,75,1,0,0,2
2500135,2500263,128,0,0,1,1
2500136,2500267,131,0,0,1,2
2500264,2500309,45,1,0,0,1
2500268,2500316,48,1,0,0,2
2500310,2500418,108,0,0,1,1
2500317,2500420,103,0,0,1,2
2500419,2500502,83,1,0,0,1
2500421,2500520,99,1,0,0,2
2500503,2500718,215,0,0,1,1
2500521,2500717,196,0,0,1,2
2500718,2500760,42,1,0,0,2
2500719,2500756,37,1,0,0,1
2500757,2501147,390,0,0,1,1
2500761,2501146,385,0,0,1,2
2501147,2501865,718,1,0,0,2
2501148,2501227,79,1,0,0,1
2501228,2501367,139,0,0,1,1
2501368,2501878,510,1,0,0,1
2501393,2501560,167,0,1,0,2
2501397,2501868,471,0,1,0,1
2501585,2501811,226,0,1,0,2
2501866,2502252,386,0,0,1,2
2501879,2502250,371,0,0,1,1
2502251,2502288,37,1,0,0,1
2502253,2502284,31,1,0,0,2
2502285,2502525,240,0,0,1,2
2502289,2502525,236,0,0,1,1
2502526,2502570,44,1,0,0,1
2502526,2502577,51,1,0,0,2
2502571,2503040,469,0,0,1,1
2502578,2503041,463,0,0,1,2
2503041,2503080,39,1,0,0,1
2503042,2503085,43,1,0,0,2
2503081,2503559,478,0,0,1,1
2503086,2503561,475,0,0,1,2
2503560,2503622,62,1,0,0,1
2503562,2503633,71,1,0,0,2
2503623,2503732,109,0,0,1,1
2503634,2503732,98,0,0,1,2
2503733,2503774,41,1,0,0,1
2503733,2503776,43,1,0,0,2
2503775,2503963,188,0,0,1,1
2503777,2503968,191,0,0,1,2
2503964,2503977,13,1,0,0,1
2503969,2503979,10,1,0,0,2
2503978,2504272,294,0,0,1,1
2503980,2504281,301,0,0,1,2
2504273,2504490,217,1,0,0,1
2504282,2504487,205,1,0,0,2
2504298,2504451,153,0,1,0,1
2504303,2504436,133,0,1,0,2
2504488,2504581,93,0,0,1,2
2504491,2504583,92,0,0,1,1
2504582,2504602,20,1,0,0,2
2504584,2504606,22,1,0,0,1
2504603,2505077,474,0,0,1,2
2504607,2505077,470,0,0,1,1
2505078,2505126,48,1,0,0,1
2505078,2505134,56,1,0,0,2
2505127,2505341,214,0,0,1,1
2505135,2505343,208,0,0,1,2
2505342,2505397,55,1,0,0,1
2505344,2505395,51,1,0,0,2
2505396,2505544,148,0,0,1,2
2505398,2505545,147,0,0,1,1
2505545,2505560,15,1,0,0,2
2505546,2505564,18,1,0,0,1
2505561,2505880,319,0,0,1,2
2505565,2505876,311,0,0,1,1
2505877,2505891,14,1,0,0,1
2505881,2505890,9,1,0,0,2
2505891,2506486,595,0,0,1,2
2505892,2506483,591,0,0,1,1
2506484,2506685,201,1,0,0,1
2506487,2506672,185,1,0,0,2
2506504,2506642,138,0,1,0,1
2506510,2506618,108,0,1,0,2
2506673,2506895,222,0,0,1,2
2506686,2506897,211,0,0,1,1
2506896,2506901,5,1,0,0,2
2506898,2506902,4,1,0,0,1
2506902,2507893,991,0,0,1,2
2506903,2507899,996,0,0,1,1
2507894,2507911,17,1,0,0,2
2507900,2507904,4,1,0,0,1
2507905,2508244,339,0,0,1,1
2507912,2508154,242,0,0,1,2
2508155,2508163,8,1,0,0,2
2508164,2508249,85,0,0,1,2
2508245,2508410,165,1,0,0,1
2508250,2508408,158,1,0,0,2
2508278,2508388,110,0,1,0,1
2508286,2508359,73,0,1,0,2
2508409,2509985,1576,0,0,1,2
2508411,2509986,1575,0,0,1,1
2509986,2510042,56,1,0,0,2
2509987,2510035,48,1,0,0,1
2510036,2510180,144,0,0,1,1
2510043,2510180,137,0,0,1,2
2510181,2510200,19,1,0,0,1
2510181,2510202,21,1,0,0,2
2510201,2510979,778,0,0,1,1
2510203,2510978,775,0,0,1,2
2510979,2510989,10,1,0,0,2
2510980,2510989,9,1,0,0,1
2510990,2512700,1710,0,0,1,2
2510990,2512706,1716,0,0,1,1
2512701,2513045,344,1,0,0,2
2512707,2513048,341,1,0,0,1
2512731,2512993,262,0,1,0,1
2512750,2512937,187,0,1,0,2
2513046,2513365,319,0,0,1,2
2513049,2513363,314,0,0,1,1
2513364,2513443,79,1,0,0,1
2513366,2513426,60,1,0,0,2
2513427,2513541,114,0,0,1,2
2513444,2513542,98,0,0,1,1
2513542,2513585,43,1,0,0,2
2513543,2513575,32,1,0,0,1
2513576,2513704,128,0,0,1,1
2513586,2513709,123,0,0,1,2
2513705,2513717,12,1,0,0,1
2513710,2513716,6,1,0,0,2
2513717,2515586,1869,0,0,1,2
2513718,2514891,1173,0,0,1,1
2514902,2514908,6,0,1,0,1
2514917,2514917,0,1,0,0,1
2514918,2515094,176,0,0,1,1
2515095,2515105,10,1,0,0,1
2515106,2515144,38,0,0,1,1
2515145,2515199,54,1,0,0,1
2515200,2515231,31,0,0,1,1
2515232,2515268,36,1,0,0,1
2515269,2515569,300,0,0,1,1
2515570,2515664,94,1,0,0,1
2515587,2515656,69,1,0,0,2
2515657,2515903,246,0,0,1,2
2515665,2517095,1430,0,0,1,1
2515904,2515923,19,1,0,0,2
2515924,2517095,1171,0,0,1,2
2517096,2517113,17,1,0,0,1
2517096,2517123,27,1,0,0,2
2517114,2519068,1954,0,0,1,1
2517124,2519069,1945,0,0,1,2
2519069,2519186,117,1,0,0,1
2519070,2519152,82,1,0,0,2
2519153,2519403,250,0,0,1,2
2519187,2519262,75,0,0,1,1
2519263,2522333,3070,1,0,0,1
2519403,2522322,2919,0,1,0,1
2519404,2519781,377,1,0,0,2
2519453,2519708,255,0,1,0,2
2519782,2520306,524,0,0,1,2
2520307,2520337,30,1,0,0,2
2520338,2521471,1133,0,0,1,2
2521472,2521483,11,1,0,0,2
2521484,2521717,233,0,0,1,2
2521718,2521801,83,1,0,0,2
2521802,2521910,108,0,0,1,2
2521911,2521928,17,1,0,0,2
2521929,2522259,330,0,0,1,2
2522260,2522300,40,1,0,0,2
2522301,2522602,301,0,0,1,2
2522334,2522603,269,0,0,1,1
2522603,2522624,21,1,0,0,2
2522604,2522625,21,1,0,0,1
2522625,2523714,1089,0,0,1,2
2522626,2523708,1082,0,0,1,1
2523709,2523741,32,1,0,0,1
2523715,2523729,14,1,0,0,2
2523730,2525038,1308,0,0,1,2
2523742,2525046,1304,0,0,1,1
2525039,2525059,20,1,0,0,2
2525047,2525054,7,1,0,0,1
2525055,2525285,230,0,0,1,1
2525060,2525299,239,0,0,1,2
2525286,2525897,611,1,0,0,1
2525300,2525726,426,1,0,0,2
2525322,2525886,564,0,1,0,1
2525340,2525717,377,0,1,0,2
2525727,2526123,396,0,0,1,2
2525898,2526123,225,0,0,1,1
2526124,2526193,69,1,0,0,1
2526124,2526202,78,1,0,0,2
2526194,2526307,113,0,0,1,1
2526203,2526309,106,0,0,1,2
2526308,2526345,37,1,0,0,1
2526310,2526344,34,1,0,0,2
2526345,2527992,1647,0,0,1,2
2526346,2527990,1644,0,0,1,1
2527991,2528027,36,1,0,0,1
2527993,2528027,34,1,0,0,2
2528028,2530061,2033,0,0,1,1
2528028,2530061,2033,0,0,1,2
2530062,2530426,364,1,0,0,1
2530062,2530431,369,1,0,0,2
2530081,2530415,334,0,1,0,1
2530088,2530347,259,0,1,0,2
2530427,2531086,659,0,0,1,1
2530432,2530725,293,0,0,1,2
2530726,2530759,33,1,0,0,2
2530760,2531082,322,0,0,1,2
2531083,2531148,65,1,0,0,2
2531087,2531143,56,1,0,0,1
2531144,2531212,68,0,0,1,1
2531149,2531212,63,0,0,1,2
2531213,2531246,33,1,0,0,1
2531213,2531254,41,1,0,0,2
2531247,2531333,86,0,0,1,1
2531255,2531333,78,0,0,1,2
2531334,2531357,23,1,0,0,1
2531334,2531358,24,1,0,0,2
2531358,2531489,131,0,0,1,1
2531359,2531491,132,0,0,1,2
2531490,2531502,12,1,0,0,1
2531492,2531506,14,1,0,0,2
2531503,2533306,1803,0,0,1,1
2531507,2533307,1800,0,0,1,2
2533307,2533346,39,1,0,0,1
2533308,2533345,37,1,0,0,2
2533346,2535887,2541,0,0,1,2
2533347,2535885,2538,0,0,1,1
2535886,2535930,44,1,0,0,1
2535888,2535929,41,1,0,0,2
2535930,2536002,72,0,0,1,2
2535931,2536022,91,0,0,1,1
2536003,2536553,550,1,0,0,2
2536023,2536530,507,1,0,0,1
2536040,2536519,479,0,1,0,1
2536076,2536504,428,0,1,0,2
2536531,2536991,460,0,0,1,1
2536554,2536991,437,0,0,1,2
2536992,2537039,47,1,0,0,1
2536992,2537051,59,1,0,0,2
2537040,2537267,227,0,0,1,1
2537052,2537271,219,0,0,1,2
2537268,2537286,18,1,0,0,1
2537272,2537279,7,1,0,0,2
2537280,2537746,466,0,0,1,2
2537287,2539423,2136,0,0,1,1
2537747,2537757,10,1,0,0,2
2537758,2539326,1568,0,0,1,2
2539327,2539337,10,1,0,0,2
2539338,2539445,107,0,0,1,2
2539424,2540110,686,1,0,0,1
2539446,2539990,544,1,0,0,2
2539460,2540079,619,0,1,0,1
2539476,2539896,420,0,1,0,2
2539991,2540459,468,0,0,1,2
2540111,2540623,512,0,0,1,1
2540460,2540546,86,1,0,0,2
2540547,2540621,74,0,0,1,2
2540622,2540767,145,1,0,0,2
2540624,2541128,504,1,0,0,1
2540641,2540976,335,0,1,0,1
2540768,2541211,443,0,0,1,2
2541000,2541001,1,0,1,0,1
2541071,2541095,24,0,1,0,1
2541129,2541173,44,0,0,1,1
2541184,2541201,17,0,1,0,1
2541211,2541293,82,1,0,0,1
2541212,2541233,21,1,0,0,2
2541234,2541315,81,0,0,1,2
2541294,2541315,21,0,0,1,1
2541316,2541424,108,1,0,0,2
2541316,2542395,1079,1,0,0,1
2541342,2542385,1043,0,1,0,1
2541425,2542294,869,0,0,1,2
2542295,2542425,130,1,0,0,2
2542396,2542457,61,0,0,1,1
2542426,2542475,49,0,0,1,2
2542468,2543653,1185,0,1,0,1
2542476,2542522,46,1,0,0,2
2542523,2542924,401,0,0,1,2
2542925,2542929,4,1,0,0,2
2542930,2543162,232,0,0,1,2
2543163,2543167,4,1,0,0,2
2543168,2543330,162,0,0,1,2
2543331,2543375,44,1,0,0,2
2543376,2543424,48,0,0,1,2
2543425,2543644,219,1,0,0,2
2543645,2543714,69,0,0,1,2
2543663,2544639,976,1,0,0,1
2543715,2543742,27,1,0,0,2
2543723,2543762,39,0,1,0,1
2543743,2543786,43,0,0,1,2
2543787,2544264,477,1,0,0,2
2543865,2544608,743,0,1,0,1
2543885,2544255,370,0,1,0,2
2544265,2544370,105,0,0,1,2
2544371,2544469,98,1,0,0,2
2544470,2544547,77,0,0,1,2
2544548,2544606,58,1,0,0,2
2544607,2544754,147,0,0,1,2
2544640,2544750,110,0,0,1,1
2544751,2544770,19,1,0,0,1
2544755,2544770,15,1,0,0,2
2544771,2545585,814,0,0,1,1
2544771,2546291,1520,0,0,1,2
2545586,2545634,48,1,0,0,1
2545635,2545939,304,0,0,1,1
2545940,2546061,121,1,0,0,1
2546062,2546309,247,0,0,1,1
2546292,2546309,17,1,0,0,2
2546310,2546327,17,1,0,0,1
2546310,2546586,276,0,0,1,2
2546328,2546427,99,0,0,1,1
2546428,2546434,6,1,0,0,1
2546435,2546498,63,0,0,1,1
2546499,2546548,49,1,0,0,1
2546549,2546569,20,0,0,1,1
2546570,2546649,79,1,0,0,1
2546587,2546653,66,1,0,0,2
2546650,2547809,1159,0,0,1,1
2546654,2547809,1155,0,0,1,2
2547810,2547878,68,1,0,0,1
2547810,2547901,91,1,0,0,2
2547879,2548010,131,0,0,1,1
2547902,2548012,110,0,0,1,2
2548011,2548051,40,1,0,0,1
2548013,2548067,54,1,0,0,2
2548052,2548171,119,0,0,1,1
2548068,2548173,105,0,0,1,2
2548172,2548190,18,1,0,0,1
2548174,2548201,27,1,0,0,2
2548191,2550222,2031,0,0,1,1
2548202,2549081,879,0,0,1,2
2549082,2549165,83,1,0,0,2
2549166,2549436,270,0,0,1,2
2549437,2549802,365,1,0,0,2
2549803,2549996,193,0,0,1,2
2549997,2550278,281,1,0,0,2
2550223,2550279,56,1,0,0,1
2550279,2550509,230,0,0,1,2
2550280,2550508,228,0,0,1,1
2550509,2550528,19,1,0,0,1
2550510,2550527,17,1,0,0,2
2550528,2551942,1414,0,0,1,2
2550529,2551937,1408,0,0,1,1
2551938,2551966,28,1,0,0,1
2551943,2551966,23,1,0,0,2
2551967,2552284,317,0,0,1,2
2551967,2552290,323,0,0,1,1
2552285,2552931,646,1,0,0,2
2552291,2552919,628,1,0,0,1
2552333,2552812,479,0,1,0,1
2552342,2552806,464,0,1,0,2
2552920,2552956,36,0,0,1,1
2552932,2553182,250,0,0,1,2
2552957,2552971,14,1,0,0,1
2552972,2553073,101,0,0,1,1
2553074,2553078,4,1,0,0,1
2553079,2553941,862,0,0,1,1
2553183,2553187,4,1,0,0,2
2553188,2553942,754,0,0,1,2
2553942,2553967,25,1,0,0,1
2553943,2553975,32,1,0,0,2
2553968,2554089,121,0,0,1,1
2553976,2554091,115,0,0,1,2
2554090,2554143,53,1,0,0,1
2554092,2554151,59,1,0,0,2
2554144,2554268,124,0,0,1,1
2554152,2555208,1056,0,0,1,2
2554269,2554281,12,1,0,0,1
2554282,2556817,2535,0,0,1,1
2555209,2555219,10,1,0,0,2
2555220,2556671,1451,0,0,1,2
2556672,2556676,4,1,0,0,2
2556677,2556815,138,0,0,1,2
2556816,2556865,49,1,0,0,2
2556818,2556881,63,1,0,0,1
2556866,2557088,222,0,0,1,2
2556882,2557089,207,0,0,1,1
2557089,2557617,528,1,0,0,2
2557090,2557563,473,1,0,0,1
2557110,2557553,443,0,1,0,1
2557117,2557518,401,0,1,0,2
2557564,2559241,1677,0,0,1,1
2557618,2559241,1623,0,0,1,2
2559242,2559262,20,1,0,0,1
2559242,2559263,21,1,0,0,2
2559263,2560778,1515,0,0,1,1
2559264,2559918,654,0,0,1,2
2559919,2559923,4,1,0,0,2
2559924,2560776,852,0,0,1,2
2560777,2563374,2597,1,0,0,2
2560779,2560870,91,1,0,0,1
2560816,2563315,2499,0,1,0,2
2560871,2560953,82,0,0,1,1
2560954,2560978,24,1,0,0,1
2560979,2563250,2271,0,0,1,1
2563251,2563312,61,1,0,0,1
2563274,2563274,0,0,1,0,1
2563313,2563478,165,0,0,1,1
2563375,2563477,102,0,0,1,2
2563478,2563997,519,1,0,0,2
2563479,2563508,29,1,0,0,1
2563509,2563553,44,0,0,1,1
2563554,2563930,376,1,0,0,1
2563561,2563944,383,0,1,0,2
2563578,2563873,295,0,1,0,1
2563931,2565315,1384,0,0,1,1
2563998,2564250,252,0,0,1,2
2564251,2564362,111,1,0,0,2
2564363,2564677,314,0,0,1,2
2564678,2564929,251,1,0,0,2
2564930,2565010,80,0,0,1,2
2565011,2565072,61,1,0,0,2
2565073,2565261,188,0,0,1,2
2565262,2566004,742,1,0,0,2
2565316,2565992,676,1,0,0,1
2565325,2565995,670,0,1,0,2
2565342,2565971,629,0,1,0,1
2565993,2566045,52,0,0,1,1
2566005,2566535,530,0,0,1,2
2566046,2566074,28,1,0,0,1
2566075,2566113,38,0,0,1,1
2566114,2566120,6,1,0,0,1
2566121,2566535,414,0,0,1,1
2566536,2566599,63,1,0,0,1
2566536,2566610,74,1,0,0,2
2566600,2566689,89,0,0,1,1
2566611,2566690,79,0,0,1,2
2566690,2566727,37,1,0,0,1
2566691,2566725,34,1,0,0,2
2566726,2566895,169,0,0,1,2
2566728,2566891,163,0,0,1,1
2566892,2566907,15,1,0,0,1
2566896,2566911,15,1,0,0,2
2566908,2568937,2029,0,0,1,1
2566912,2568938,2026,0,0,1,2
2568938,2568986,48,1,0,0,1
2568939,2568989,50,1,0,0,2
2568987,2572762,3775,0,0,1,1
2568990,2572760,3770,0,0,1,2
2572761,2573349,588,1,0,0,2
2572763,2573329,566,1,0,0,1
2572791,2573257,466,0,1,0,2
2572791,2573290,499,0,1,0,1
2573330,2573375,45,0,0,1,1
2573350,2573383,33,0,0,1,2
2573376,2573389,13,1,0,0,1
2573384,2573415,31,1,0,0,2
2573390,2573571,181,0,0,1,1
2573416,2573600,184,0,0,1,2
2573572,2573579,7,1,0,0,1
2573580,2573602,22,0,0,1,1
2573601,2573949,348,1,0,0,2
2573603,2573965,362,1,0,0,1
2573623,2573905,282,0,1,0,1
2573627,2573926,299,0,1,0,2
2573950,2573982,32,0,0,1,2
2573966,2576023,2057,0,0,1,1
2573983,2573992,9,1,0,0,2
2573993,2574191,198,0,0,1,2
2574192,2574201,9,1,0,0,2
2574202,2576023,1821,0,0,1,2
2576024,2576063,39,1,0,0,1
2576024,2576068,44,1,0,0,2
2576064,2577660,1596,0,0,1,1
2576069,2577646,1577,0,0,1,2
2577647,2578506,859,1,0,0,2
2577661,2578309,648,1,0,0,1
2577676,2578299,623,0,1,0,1
2577679,2578296,617,0,1,0,2
2578310,2579083,773,0,0,1,1
2578507,2579083,576,0,0,1,2
2579084,2579132,48,1,0,0,1
2579084,2579185,101,1,0,0,2
2579133,2579250,117,0,0,1,1
2579186,2579248,62,0,0,1,2
2579249,2579286,37,1,0,0,2
2579251,2579286,35,1,0,0,1
2579287,2579583,296,0,0,1,2
2579287,2579587,300,0,0,1,1
2579584,2579887,303,1,0,0,2
2579588,2579904,316,1,0,0,1
2579613,2579847,234,0,1,0,2
2579613,2579872,259,0,1,0,1
2579888,2580533,645,0,0,1,2
2579905,2579943,38,0,0,1,1
2579944,2579961,17,1,0,0,1
2579962,2580956,994,0,0,1,1
2580534,2580538,4,1,0,0,2
2580539,2580956,417,0,0,1,2
2580957,2581007,50,1,0,0,1
2580957,2581012,55,1,0,0,2
2581008,2581150,142,0,0,1,1
2581013,2581149,136,0,0,1,2
2581150,2581171,21,1,0,0,2
2581151,2581176,25,1,0,0,1
2581172,2582943,1771,0,0,1,2
2581177,2582949,1772,0,0,1,1
2582944,2583391,447,1,0,0,2
2582950,2583426,476,1,0,0,1
2582970,2583378,408,0,1,0,1
2582977,2583308,331,0,1,0,2
2583392,2584308,916,0,0,1,2
2583427,2584310,883,0,0,1,1
2584309,2584380,71,1,0,0,2
2584311,2584366,55,1,0,0,1
2584367,2584477,110,0,0,1,1
2584381,2584477,96,0,0,1,2
2584478,2584513,35,1,0,0,1
2584478,2584532,54,1,0,0,2
2584514,2584671,157,0,0,1,1
2584533,2584644,111,0,0,1,2
2584645,2584701,56,1,0,0,2
2584672,2584687,15,1,0,0,1
2584688,2586512,1824,0,0,1,1
2584702,2584882,180,0,0,1,2
2584883,2584913,30,1,0,0,2
2584914,2585227,313,0,0,1,2
2585228,2585238,10,1,0,0,2
2585239,2585824,585,0,0,1,2
2585825,2585865,40,1,0,0,2
2585866,2586514,648,0,0,1,2
2586513,2586550,37,1,0,0,1
2586515,2586551,36,1,0,0,2
2586551,2588626,2075,0,0,1,1
2586552,2588609,2057,0,0,1,2
2588610,2588934,324,1,0,0,2
2588627,2588950,323,1,0,0,1
2588650,2588896,246,0,1,0,1
2588651,2588886,235,0,1,0,2
2588935,2589268,333,0,0,1,2
2588951,2589268,317,0,0,1,1
2589269,2589323,54,1,0,0,1
2589269,2589325,56,1,0,0,2
2589324,2590484,1160,0,0,1,1
2589326,2590483,1157,0,0,1,2
2590484,2590533,49,1,0,0,2
2590485,2590534,49,1,0,0,1
2590534,2590643,109,0,0,1,2
2590535,2590642,107,0,0,1,1
2590643,2590664,21,1,0,0,1
2590644,2590665,21,1,0,0,2
2590665,2590911,246,0,0,1,1
2590666,2592537,1871,0,0,1,2
2590912,2590921,9,1,0,0,1
2590922,2592537,1615,0,0,1,1
2592538,2592573,35,1,0,0,1
2592538,2592574,36,1,0,0,2
2592574,2595981,3407,0,0,1,1
2592575,2595986,3411,0,0,1,2
2595982,2596432,450,1,0,0,1
2595987,2596412,425,1,0,0,2
2596010,2596419,409,0,1,0,1
2596012,2596315,303,0,1,0,2
2596413,2596436,23,0,0,1,2
2596433,2596678,245,0,0,1,1
2596437,2596533,96,1,0,0,2
2596534,2596678,144,0,0,1,2
2596679,2596748,69,1,0,0,2
2596679,2596753,74,1,0,0,1
2596749,2596884,135,0,0,1,2
2596754,2596882,128,0,0,1,1
2596883,2596912,29,1,0,0,1
2596885,2596914,29,1,0,0,2
2596913,2598828,1915,0,0,1,1
2596915,2598828,1913,0,0,1,2
2598829,2598866,37,1,0,0,2
2598829,2598867,38,1,0,0,1
2598867,2600833,1966,0,0,1,2
2598868,2600836,1968,0,0,1,1
2600834,2601071,237,1,0,0,2
2600837,2601083,246,1,0,0,1
2600852,2601025,173,0,1,0,2
2600853,2601038,185,0,1,0,1
2601072,2601094,22,0,0,1,2
2601084,2602534,1450,0,0,1,1
2601095,2601131,36,1,0,0,2
2601132,2602535,1403,0,0,1,2
2602535,2602598,63,1,0,0,1
2602536,2602628,92,1,0,0,2
2602599,2602826,227,0,0,1,1
2602629,2602825,196,0,0,1,2
2602826,2602843,17,1,0,0,2
2602827,2602840,13,1,0,0,1
2602841,2603328,487,0,0,1,1
2602844,2604726,1882,0,0,1,2
2603329,2603333,4,1,0,0,1
2603334,2604727,1393,0,0,1,1
2604727,2604765,38,1,0,0,2
2604728,2604775,47,1,0,0,1
2604766,2606746,1980,0,0,1,2
2604776,2606737,1961,0,0,1,1
2606738,2607408,670,1,0,0,1
2606747,2607211,464,1,0,0,2
2606766,2607398,632,0,1,0,1
2606767,2607198,431,0,1,0,2
2607212,2607417,205,0,0,1,2
2607409,2608735,1326,0,0,1,1
2607418,2607566,148,1,0,0,2
2607567,2607622,55,0,0,1,2
2607623,2607686,63,1,0,0,2
2607687,2608632,945,0,0,1,2
2608633,2608682,49,1,0,0,2
2608683,2608746,63,0,0,1,2
2608736,2608916,180,1,0,0,1
2608747,2608919,172,1,0,0,2
2608763,2608881,118,0,1,0,1
2608771,2608874,103,0,1,0,2
2608917,2609089,172,0,0,1,1
2608920,2609090,170,0,0,1,2
2609090,2609113,23,1,0,0,1
2609091,2609110,19,1,0,0,2
2609111,2609461,350,0,0,1,2
2609114,2609461,347,0,0,1,1
2609462,2609466,4,1,0,0,2
2609462,2609467,5,1,0,0,1
2609467,2610382,915,0,0,1,2
2609468,2610382,914,0,0,1,1
2610383,2610418,35,1,0,0,1
2610383,2610419,36,1,0,0,2
2610419,2610654,235,0,0,1,1
2610420,2610660,240,0,0,1,2
2610655,2610904,249,1,0,0,1
2610661,2610889,228,1,0,0,2
2610673,2610859,186,0,1,0,1
2610679,2610838,159,0,1,0,2
2610890,2611020,130,0,0,1,2
2610905,2611018,113,0,0,1,1
2611019,2611038,19,1,0,0,1
2611021,2611036,15,1,0,0,2
2611037,2611756,719,0,0,1,2
2611039,2611755,716,0,0,1,1
2611756,2611762,6,1,0,0,1
2611757,2611767,10,1,0,0,2
2611763,2611999,236,0,0,1,1
2611768,2612002,234,0,0,1,2
2612000,2612018,18,1,0,0,1
2612003,2612009,6,1,0,0,2
2612010,2612503,493,0,0,1,2
2612019,2612508,489,0,0,1,1
2612504,2612897,393,1,0,0,2
2612509,2612893,384,1,0,0,1
2612528,2612806,278,0,1,0,1
2612530,2612792,262,0,1,0,2
2612894,2613758,864,0,0,1,1
2612898,2613757,859,0,0,1,2
2613758,2613801,43,1,0,0,2
2613759,2613802,43,1,0,0,1
2613802,2613922,120,0,0,1,2
2613803,2613923,120,0,0,1,1
2613923,2613943,20,1,0,0,2
2613924,2613949,25,1,0,0,1
2613944,2614248,304,0,0,1,2
2613950,2614249,299,0,0,1,1
2614249,2614258,9,1,0,0,2
2614250,2614259,9,1,0,0,1
2614259,2614772,513,0,0,1,2
2614260,2614773,513,0,0,1,1
2614773,2614812,39,1,0,0,2
2614774,2614813,39,1,0,0,1
2614813,2615031,218,0,0,1,2
2614814,2615030,216,0,0,1,1
2615031,2615048,17,1,0,0,1
2615032,2615048,16,1,0,0,2
2615049,2615638,589,0,0,1,2
2615049,2615649,600,0,0,1,1
2615639,2615896,257,1,0,0,2
2615650,2615927,277,1,0,0,1
2615669,2615852,183,0,1,0,1
2615676,2615848,172,0,1,0,2
2615897,2617064,1167,0,0,1,2
2615928,2617062,1134,0,0,1,1
2617063,2617080,17,1,0,0,1
2617065,2617072,7,1,0,0,2
2617073,2617465,392,0,0,1,2
2617081,2617466,385,0,0,1,1
2617466,2617487,21,1,0,0,2
2617467,2617486,19,1,0,0,1
2617487,2617865,378,0,0,1,1
2617488,2617865,377,0,0,1,2
2617866,2617903,37,1,0,0,1
2617866,2617903,37,1,0,0,2
2617904,2618127,223,0,0,1,1
2617904,2618129,225,0,0,1,2
2618128,2618196,68,1,0,0,1
2618130,2618192,62,1,0,0,2
2618193,2618310,117,0,0,1,2
2618197,2618308,111,0,0,1,1
2618309,2618329,20,1,0,0,1
2618311,2618330,19,1,0,0,2
2618330,2619656,1326,0,0,1,1
2618331,2619657,1326,0,0,1,2
2619657,2619704,47,1,0,0,1
2619658,2619710,52,1,0,0,2
2619705,2619916,211,0,0,1,1
2619711,2619918,207,0,0,1,2
2619917,2619941,24,1,0,0,1
2619919,2619942,23,1,0,0,2
2619942,2620272,330,0,0,1,1
2619943,2620278,335,0,0,1,2
2620273,2620617,344,1,0,0,1
2620279,2620607,328,1,0,0,2
2620291,2620551,260,0,1,0,1
2620294,2620539,245,0,1,0,2
2620608,2621182,574,0,0,1,2
2620618,2621182,564,0,0,1,1
2621183,2621201,18,1,0,0,2
2621183,2621202,19,1,0,0,1
2621202,2621551,349,0,0,1,2
2621203,2621546,343,0,0,1,1
2621547,2621564,17,1,0,0,1
2621552,2621557,5,1,0,0,2
2621558,2622233,675,0,0,1,2
2621565,2622227,662,0,0,1,1
2622228,2622244,16,1,0,0,1
2622234,2622238,4,1,0,0,2
2622239,2623130,891,0,0,1,2
2622245,2623129,884,0,0,1,1
2623130,2623181,51,1,0,0,1
2623131,2623181,50,1,0,0,2
2623182,2623302,120,0,0,1,2
2623182,2623304,122,0,0,1,1
2623303,2623333,30,1,0,0,2
2623305,2623350,45,1,0,0,1
2623334,2623393,59,0,0,1,2
2623351,2624334,983,0,0,1,1
2623394,2623494,100,1,0,0,2
2623495,2623824,329,0,0,1,2
2623825,2624242,417,1,0,0,2
2624243,2624351,108,0,0,1,2
2624335,2624430,95,1,0,0,1
2624352,2624810,458,1,0,0,2
2624371,2624421,50,0,1,0,1
2624431,2624824,393,0,0,1,1
2624811,2624839,28,0,0,1,2
2624825,2624839,14,1,0,0,1
2624840,2624942,102,0,0,1,1
2624840,2628810,3970,1,0,0,2
2624943,2625005,62,1,0,0,1
2624964,2628761,3797,0,1,0,2
2624968,2624983,15,0,1,0,1
2625006,2625106,100,0,0,1,1
2625107,2625548,441,1,0,0,1
2625133,2625539,406,0,1,0,1
2625549,2625685,136,0,0,1,1
2625696,2625978,282,0,1,0,1
2625988,2626013,25,1,0,0,1
2626014,2626597,583,0,0,1,1
2626608,2626792,184,0,1,0,1
2626802,2626849,47,1,0,0,1
2626850,2627114,264,0,0,1,1
2627115,2627145,30,1,0,0,1
2627146,2627386,240,0,0,1,1
2627387,2627391,4,1,0,0,1
2627392,2627587,195,0,0,1,1
2627588,2627609,21,1,0,0,1
2627610,2627793,183,0,0,1,1
2627794,2627895,101,1,0,0,1
2627896,2628142,246,0,0,1,1
2628143,2628196,53,1,0,0,1
2628197,2628441,244,0,0,1,1
2628442,2628514,72,1,0,0,1
2628515,2628622,107,0,0,1,1
2628623,2628809,186,1,0,0,1
2628679,2628697,18,0,1,0,1
2628810,2628848,38,0,0,1,1
2628811,2628848,37,0,0,1,2
2628849,2628884,35,1,0,0,1
2628849,2628888,39,1,0,0,2
2628885,2629024,139,0,0,1,1
2628889,2629026,137,0,0,1,2
2629025,2629051,26,1,0,0,1
2629027,2629054,27,1,0,0,2
2629052,2629228,176,0,0,1,1
2629055,2629134,79,0,0,1,2
2629135,2629237,102,1,0,0,2
2629229,2629243,14,1,0,0,1
2629238,2629285,47,0,0,1,2
2629244,2629855,611,0,0,1,1
2629286,2629290,4,1,0,0,2
2629291,2629349,58,0,0,1,2
2629350,2629402,52,1,0,0,2
2629403,2629846,443,0,0,1,2
2629847,2629911,64,1,0,0,2
2629856,2629860,4,1,0,0,1
2629861,2630214,353,0,0,1,1
2629912,2630063,151,0,0,1,2
2630064,2630083,19,1,0,0,2
2630084,2630195,111,0,0,1,2
2630196,2630265,69,1,0,0,2
2630215,2630264,49,1,0,0,1
2630265,2630798,533,0,0,1,1
2630266,2630789,523,0,0,1,2
2630790,2631215,425,1,0,0,2
2630799,2631146,347,1,0,0,1
2630815,2631097,282,0,1,0,1
2630823,2631158,335,0,1,0,2
2631147,2632256,1109,0,0,1,1
2631216,2632256,1040,0,0,1,2
2632257,2632283,26,1,0,0,1
2632257,2632285,28,1,0,0,2
2632284,2633364,1080,0,0,1,1
2632286,2633364,1078,0,0,1,2
2633365,2633403,38,1,0,0,1
2633365,2633404,39,1,0,0,2
2633404,2633645,241,0,0,1,1
2633405,2633646,241,0,0,1,2
2633646,2633666,20,1,0,0,1
2633647,2633664,17,1,0,0,2
2633665,2636148,2483,0,0,1,2
2633667,2633794,127,0,0,1,1
2633795,2633807,12,1,0,0,1
2633808,2636147,2339,0,0,1,1
2636148,2636184,36,1,0,0,1
2636149,2636184,35,1,0,0,2
2636185,2636313,128,0,0,1,1
2636185,2636314,129,0,0,1,2
2636314,2636337,23,1,0,0,1
2636315,2636344,29,1,0,0,2
2636338,2636575,237,0,0,1,1
2636345,2636577,232,0,0,1,2
2636576,2636820,244,1,0,0,1
2636578,2636844,266,1,0,0,2
2636597,2636783,186,0,1,0,1
2636604,2636782,178,0,1,0,2
2636821,2637142,321,0,0,1,1
2636845,2637141,296,0,0,1,2
2637142,2637162,20,1,0,0,2
2637143,2637162,19,1,0,0,1
2637163,2637638,475,0,0,1,1
2637163,2637638,475,0,0,1,2
2637639,2637658,19,1,0,0,2
2637639,2637661,22,1,0,0,1
2637659,2637929,270,0,0,1,2
2637662,2637936,274,0,0,1,1
2637930,2638255,325,1,0,0,2
2637937,2638223,286,1,0,0,1
2637955,2638177,222,0,1,0,2
2637956,2638160,204,0,1,0,1
2638224,2638525,301,0,0,1,1
2638256,2638525,269,0,0,1,2
2638526,2638579,53,1,0,0,1
2638526,2638582,56,1,0,0,2
2638580,2639055,475,0,0,1,1
2638583,2639056,473,0,0,1,2
2639056,2639095,39,1,0,0,1
2639057,2639095,38,1,0,0,2
2639096,2639916,820,0,0,1,1
2639096,2639916,820,0,0,1,2
2639917,2640016,99,1,0,0,2
2639917,2640023,106,1,0,0,1
2640017,2640108,91,0,0,1,2
2640024,2640110,86,0,0,1,1
2640109,2640131,22,1,0,0,2
2640111,2641070,959,1,0,0,1
2640132,2640308,176,0,0,1,2
2640199,2640910,711,0,1,0,1
2640309,2640326,17,1,0,0,2
2640327,2641832,1505,0,0,1,2
2640950,2640956,6,0,1,0,1
2641071,2641143,72,0,0,1,1
2641144,2641153,9,1,0,0,1
2641154,2641282,128,0,0,1,1
2641283,2641392,109,1,0,0,1
2641393,2641433,40,0,0,1,1
2641434,2645505,4071,1,0,0,1
2641833,2642130,297,1,0,0,2
2641899,2641950,51,0,1,0,1
2641999,2642149,150,0,1,0,1
2642131,2642162,31,0,0,1,2
2642163,2643061,898,1,0,0,2
2642183,2645495,3312,0,1,0,1
2642188,2643052,864,0,1,0,2
2643062,2643408,346,0,0,1,2
2643409,2643433,24,1,0,0,2
2643434,2643865,431,0,0,1,2
2643876,2644917,1041,0,1,0,2
2644927,2644957,30,1,0,0,2
2644958,2645425,467,0,0,1,2
2645426,2645507,81,1,0,0,2
2645445,2645453,8,0,1,0,2
2645506,2645597,91,0,0,1,1
2645508,2645597,89,0,0,1,2
2645598,2645634,36,1,0,0,1
2645598,2645635,37,1,0,0,2
2645635,2645790,155,0,0,1,1
2645636,2646028,392,0,0,1,2
2645791,2645801,10,1,0,0,1
2645802,2647568,1766,0,0,1,1
2646029,2646038,9,1,0,0,2
2646039,2647569,1530,0,0,1,2
2647569,2647617,48,1,0,0,1
2647570,2647624,54,1,0,0,2
2647618,2648057,439,0,0,1,1
2647625,2648061,436,0,0,1,2
2648058,2648337,279,1,0,0,1
2648062,2648362,300,1,0,0,2
2648071,2648305,234,0,1,0,1
2648076,2648275,199,0,1,0,2
2648338,2648368,30,0,0,1,1
2648363,2649970,1607,0,0,1,2
2648369,2648394,25,1,0,0,1
2648395,2649971,1576,0,0,1,1
2649971,2649992,21,1,0,0,2
2649972,2649992,20,1,0,0,1
2649993,2650025,32,0,0,1,1
2649993,2650026,33,0,0,1,2
2650026,2650425,399,1,0,0,1
2650027,2650464,437,1,0,0,2
2650042,2650414,372,0,1,0,1
2650045,2650347,302,0,1,0,2
2650426,2651479,1053,0,0,1,1
2650465,2651478,1013,0,0,1,2
2651479,2651537,58,1,0,0,2
2651480,2651539,59,1,0,0,1
2651538,2651649,111,0,0,1,2
2651540,2651646,106,0,0,1,1
2651647,2651673,26,1,0,0,1
2651650,2651709,59,1,0,0,2
2651674,2651882,208,0,0,1,1
2651710,2651875,165,0,0,1,2
2651876,2651917,41,1,0,0,2
2651883,2651893,10,1,0,0,1
2651894,2653404,1510,0,0,1,1
2651918,2651995,77,0,0,1,2
2651996,2652000,4,1,0,0,2
2652001,2652366,365,0,0,1,2
2652367,2652640,273,1,0,0,2
2652379,2652468,89,0,1,0,2
2652539,2652554,15,0,1,0,2
2652641,2652667,26,0,0,1,2
2652668,2653764,1096,1,0,0,2
2653415,2653423,8,0,1,0,1
2653433,2653770,337,1,0,0,1
2653451,2653473,22,0,1,0,1
2653498,2653721,223,0,1,0,1
2653509,2653727,218,0,1,0,2
2653765,2654130,365,0,0,1,2
2653771,2654133,362,0,0,1,1
2654131,2654800,669,1,0,0,2
2654134,2654662,528,1,0,0,1
2654161,2654788,627,0,1,0,2
2654173,2654651,478,0,1,0,1
2654663,2654895,232,0,0,1,1
2654801,2654891,90,0,0,1,2
2654892,2654945,53,1,0,0,2
2654896,2654937,41,1,0,0,1
2654938,2655627,689,0,0,1,1
2654946,2655627,681,0,0,1,2
2655628,2655647,19,1,0,0,2
2655628,2655648,20,1,0,0,1
2655648,2656159,511,0,0,1,2
2655649,2656160,511,0,0,1,1
2656160,2656199,39,1,0,0,2
2656161,2656205,44,1,0,0,1
2656200,2656548,348,0,0,1,2
2656206,2656549,343,0,0,1,1
2656549,2656582,33,1,0,0,2
2656550,2656587,37,1,0,0,1
2656583,2656994,411,0,0,1,2
2656588,2656996,408,0,0,1,1
2656995,2657027,32,1,0,0,2
2656997,2657022,25,1,0,0,1
2657023,2657300,277,0,0,1,1
2657028,2657300,272,0,0,1,2
2657301,2657343,42,1,0,0,1
2657301,2657352,51,1,0,0,2
2657344,2657734,390,0,0,1,1
2657353,2657734,381,0,0,1,2
2657735,2657788,53,1,0,0,1
2657735,2657792,57,1,0,0,2
2657789,2657901,112,0,0,1,1
2657793,2657900,107,0,0,1,2
2657901,2657934,33,1,0,0,2
2657902,2657924,22,1,0,0,1
2657925,2659353,1428,0,0,1,1
2657935,2659347,1412,0,0,1,2
2659348,2659365,17,1,0,0,2
2659354,2659364,10,1,0,0,1
2659365,2659657,292,0,0,1,1
2659366,2659656,290,0,0,1,2
2659657,2659712,55,1,0,0,2
2659658,2659705,47,1,0,0,1
2659706,2659983,277,0,0,1,1
2659713,2659983,270,0,0,1,2
2659984,2660006,22,1,0,0,1
2659984,2660006,22,1,0,0,2
2660007,2660066,59,0,0,1,1
2660007,2660075,68,0,0,1,2
2660067,2660388,321,1,0,0,1
2660076,2660350,274,1,0,0,2
2660088,2660323,235,0,1,0,1
2660093,2660300,207,0,1,0,2
2660351,2660756,405,0,0,1,2
2660389,2660757,368,0,0,1,1
2660757,2660774,17,1,0,0,2
2660758,2660775,17,1,0,0,1
2660775,2661975,1200,0,0,1,2
2660776,2661974,1198,0,0,1,1
2661975,2662003,28,1,0,0,1
2661976,2662004,28,1,0,0,2
2662004,2662304,300,0,0,1,1
2662005,2662303,298,0,0,1,2
2662304,2662326,22,1,0,0,2
2662305,2662328,23,1,0,0,1
2662327,2663550,1223,0,0,1,2
2662329,2663549,1220,0,0,1,1
2663550,2663615,65,1,0,0,1
2663551,2663605,54,1,0,0,2
2663606,2663782,176,0,0,1,2
2663616,2663785,169,0,0,1,1
2663783,2663791,8,1,0,0,2
2663786,2663794,8,1,0,0,1
2663792,2664982,1190,0,0,1,2
2663795,2664983,1188,0,0,1,1
2664983,2665036,53,1,0,0,2
2664984,2665027,43,1,0,0,1
2665028,2665361,333,0,0,1,1
2665037,2665353,316,0,0,1,2
2665354,2665829,475,1,0,0,2
2665362,2666040,678,1,0,0,1
2665381,2665972,591,0,1,0,1
2665395,2665820,425,0,1,0,2
2665830,2666511,681,0,0,1,2
2666041,2666509,468,0,0,1,1
2666510,2666535,25,1,0,0,1
2666512,2666535,23,1,0,0,2
2666536,2667249,713,0,0,1,2
2666536,2667251,715,0,0,1,1
2667250,2667271,21,1,0,0,2
2667252,2667278,26,1,0,0,1
2667272,2668085,813,0,0,1,2
2667279,2668088,809,0,0,1,1
2668086,2668122,36,1,0,0,2
2668089,2668128,39,1,0,0,1
2668123,2668223,100,0,0,1,2
2668129,2668223,94,0,0,1,1
2668224,2668267,43,1,0,0,1
2668224,2668284,60,1,0,0,2
2668268,2668372,104,0,0,1,1
2668285,2668372,87,0,0,1,2
2668373,2668401,28,1,0,0,1
2668373,2668403,30,1,0,0,2
2668402,2668737,335,0,0,1,1
2668404,2668736,332,0,0,1,2
2668737,2668775,38,1,0,0,2
2668738,2668773,35,1,0,0,1
2668774,2669072,298,0,0,1,1
2668776,2669074,298,0,0,1,2
2669073,2669106,33,1,0,0,1
2669075,2669107,32,1,0,0,2
2669107,2669455,348,0,0,1,1
2669108,2669456,348,0,0,1,2
2669456,2669483,27,1,0,0,1
2669457,2669482,25,1,0,0,2
2669483,2669740,257,0,0,1,2
2669484,2669740,256,0,0,1,1
2669741,2669765,24,1,0,0,1
2669741,2669766,25,1,0,0,2
2669766,2670034,268,0,0,1,1
2669767,2670033,266,0,0,1,2
2670034,2670071,37,1,0,0,2
2670035,2670067,32,1,0,0,1
2670068,2670308,240,0,0,1,1
2670072,2670305,233,0,0,1,2
2670306,2670603,297,1,0,0,2
2670309,2670631,322,1,0,0,1
2670324,2670564,240,0,1,0,1
2670329,2670513,184,0,1,0,2
2670604,2670744,140,0,0,1,2
2670632,2670743,111,0,0,1,1
2670744,2670768,24,1,0,0,1
2670745,2670768,23,1,0,0,2
2670769,2670998,229,0,0,1,1
2670769,2670998,229,0,0,1,2
2720268,2720485,217,0,0,1,1
2720268,2720486,218,0,0,1,2
2720486,2720570,84,1,0,0,1
2720487,2720541,54,1,0,0,2
2720542,2720644,102,0,0,1,2
2720571,2720635,64,0,0,1,1
2720636,2725413,4777,1,0,0,1
2720645,2720692,47,1,0,0,2
2720670,2725403,4733,0,1,0,1
2720693,2720902,209,0,0,1,2
2720903,2720914,11,1,0,0,2
2720915,2721108,193,0,0,1,2
2721109,2721146,37,1,0,0,2
2721147,2721761,614,0,0,1,2
2721762,2725402,3640,1,0,0,2
2721782,2725337,3555,0,1,0,2
2725403,2725484,81,0,0,1,2
2725414,2725483,69,0,0,1,1
2725484,2725515,31,1,0,0,1
2725485,2725512,27,1,0,0,2
2725513,2726665,1152,0,0,1,2
2725516,2726668,1152,0,0,1,1
2726666,2726955,289,1,0,0,2
2726669,2726942,273,1,0,0,1
2726683,2726917,234,0,1,0,1
2726688,2726879,191,0,1,0,2
2726943,2729273,2330,0,0,1,1
2726956,2729273,2317,0,0,1,2
2729274,2729332,58,1,0,0,1
2729274,2729340,66,1,0,0,2
2729333,2729409,76,0,0,1,1
2729341,2729411,70,0,0,1,2
2729410,2729471,61,1,0,0,1
2729412,2729463,51,1,0,0,2
2729445,2729458,13,0,1,0,1
2729464,2729527,63,0,0,1,2
2729472,2729506,34,0,0,1,1
2729517,2729618,101,0,1,0,1
2729528,2729560,32,1,0,0,2
2729561,2730158,597,0,0,1,2
2729628,2729631,3,1,0,0,1
2729632,2729699,67,0,0,1,1
2729700,2729727,27,1,0,0,1
2729728,2729957,229,0,0,1,1
2729958,2729966,8,1,0,0,1
2729967,2730177,210,0,0,1,1
2730169,2730173,4,0,1,0,2
2730182,2730182,0,1,0,0,2
2730183,2730244,61,0,0,1,2
2730188,2731917,1729,0,1,0,1
2730255,2731344,1089,0,1,0,2
2731354,2731399,45,1,0,0,2
2731400,2731510,110,0,0,1,2
2731511,2731607,96,1,0,0,2
2731608,2731641,33,0,0,1,2
2731642,2731652,10,1,0,0,2
2731653,2731716,63,0,0,1,2
2731717,2731922,205,1,0,0,2
2731738,2731887,149,0,1,0,2
2731923,2732036,113,0,0,1,2
2731927,2731931,4,1,0,0,1
2731932,2732036,104,0,0,1,1
2732037,2732072,35,1,0,0,2
2732037,2732073,36,1,0,0,1
2732073,2733662,1589,0,0,1,2
2732074,2732266,192,0,0,1,1
2732267,2732274,7,1,0,0,1
2732275,2733661,1386,0,0,1,1
2733662,2733734,72,1,0,0,1
2733663,2733737,74,1,0,0,2
2733735,2734093,358,0,0,1,1
2733738,2734096,358,0,0,1,2
2734094,2734201,107,1,0,0,1
2734097,2734157,60,1,0,0,2
2734158,2734260,102,0,0,1,2
2734202,2734258,56,0,0,1,1
2734259,2734292,33,1,0,0,1
2734261,2734293,32,1,0,0,2
2734293,2734471,178,0,0,1,1
2734294,2736610,2316,0,0,1,2
2734472,2734527,55,1,0,0,1
2734528,2736611,2083,0,0,1,1
2736611,2737793,1182,1,0,0,2
2736612,2736734,122,1,0,0,1
2736689,2736710,21,0,1,0,2
2736701,2736701,0,0,1,0,1
2736735,2736829,94,0,0,1,1
2736830,2736858,28,1,0,0,1
2736859,2738433,1574,0,0,1,1
2737794,2738046,252,0,0,1,2
2738047,2738061,14,1,0,0,2
2738062,2738428,366,0,0,1,2
2738429,2738546,117,1,0,0,2
2738434,2738450,16,1,0,0,1
2738451,2738782,331,0,0,1,1
2738547,2738665,118,0,0,1,2
2738666,2738682,16,1,0,0,2
2738683,2738713,30,0,0,1,2
2738714,2739704,990,1,0,0,2
2738783,2739160,377,1,0,0,1
2738790,2739075,285,0,1,0,2
2738806,2738945,139,0,1,0,1
2738967,2738995,28,0,1,0,1
2739086,2739096,10,0,1,0,1
2739120,2739162,42,0,1,0,2
2739161,2739330,169,0,0,1,1
2739331,2739648,317,1,0,0,1
2739339,2739647,308,0,1,0,2
2739346,2739590,244,0,1,0,1
2739649,2739860,211,0,0,1,1
2739705,2739859,154,0,0,1,2
2739860,2739878,18,1,0,0,2
2739861,2739878,17,1,0,0,1
2739879,2740164,285,0,0,1,2
2739879,2740234,355,0,0,1,1
2740165,2740193,28,1,0,0,2
2740194,2740234,40,0,0,1,2
2740235,2740244,9,1,0,0,1
2740235,2740771,536,1,0,0,2
2740245,2741086,841,0,0,1,1
2740772,2740798,26,0,0,1,2
2740799,2740870,71,1,0,0,2
2740871,2741086,215,0,0,1,2
2741087,2741151,64,1,0,0,1
2741087,2741169,82,1,0,0,2
2741152,2741223,71,0,0,1,1
2741170,2741222,52,0,0,1,2
2741223,2741269,46,1,0,0,2
2741224,2741270,46,1,0,0,1
2741270,2741401,131,0,0,1,2
2741271,2741401,130,0,0,1,1
2741402,2741436,34,1,0,0,2
2741402,2741439,37,1,0,0,1
2741437,2741626,189,0,0,1,2
2741440,2741626,186,0,0,1,1
2741627,2741649,22,1,0,0,1
2741627,2741649,22,1,0,0,2
2741650,2742167,517,0,0,1,1
2741650,2743330,1680,0,0,1,2
2742168,2742186,18,1,0,0,1
2742187,2743329,1142,0,0,1,1
2743330,2743353,23,1,0,0,1
2743331,2743353,22,1,0,0,2
2743354,2743480,126,0,0,1,1
2743354,2743480,126,0,0,1,2
2743481,2743549,68,1,0,0,1
2743481,2743549,68,1,0,0,2
2743550,2743680,130,0,0,1,2
2743550,2743682,132,0,0,1,1
2743681,2743703,22,1,0,0,2
2743683,2743711,28,1,0,0,1
2743704,2745571,1867,0,0,1,2
2743712,2744529,817,0,0,1,1
2744530,2744538,8,1,0,0,1
2744539,2745571,1032,0,0,1,1
2745572,2745620,48,1,0,0,1
2745572,2745620,48,1,0,0,2
2745621,2745962,341,0,0,1,1
2745621,2745963,342,0,0,1,2
2745963,2746062,99,1,0,0,1
2745964,2746026,62,1,0,0,2
2746027,2746152,125,0,0,1,2
2746063,2746152,89,0,0,1,1
2746153,2746171,18,1,0,0,1
2746153,2746173,20,1,0,0,2
2746172,2746246,74,0,0,1,1
2746174,2746261,87,0,0,1,2
2746247,2748309,2062,1,0,0,1
2746262,2747328,1066,1,0,0,2
2746275,2748297,2022,0,1,0,1
2746279,2747170,891,0,1,0,2
2747329,2747414,85,0,0,1,2
2747415,2747934,519,1,0,0,2
2747935,2748002,67,0,0,1,2
2748013,2749950,1937,0,1,0,2
2748310,2748467,157,0,0,1,1
2748468,2748486,18,1,0,0,1
2748487,2748528,41,0,0,1,1
2748529,2748550,21,1,0,0,1
2748551,2749162,611,0,0,1,1
2749173,2749401,228,0,1,0,1
2749411,2750111,700,1,0,0,1
2749444,2750067,623,0,1,0,1
2749960,2750002,42,1,0,0,2
2750003,2750069,66,0,0,1,2
2750070,2750105,35,1,0,0,2
2750106,2750240,134,0,0,1,2
2750112,2750234,122,0,0,1,1
2750235,2750252,17,1,0,0,1
2750241,2750247,6,1,0,0,2
2750248,2751754,1506,0,0,1,2
2750253,2751753,1500,0,0,1,1
2751754,2753846,2092,1,0,0,1
2751755,2753843,2088,1,0,0,2
2751807,2752046,239,0,1,0,1
2751822,2753833,2011,0,1,0,2
2752069,2753811,1742,0,1,0,1
2753844,2753928,84,0,0,1,2
2753847,2753927,80,0,0,1,1
2753928,2753970,42,1,0,0,1
2753929,2753974,45,1,0,0,2
2753971,2754080,109,0,0,1,1
2753975,2754082,107,0,0,1,2
2754081,2754107,26,1,0,0,1
2754083,2754107,24,1,0,0,2
2754108,2755193,1085,0,0,1,1
2754108,2755193,1085,0,0,1,2
2755194,2755396,202,1,0,0,1
2755194,2755484,290,1,0,0,2
2755333,2755345,12,0,1,0,1
2755369,2755387,18,0,1,0,1
2755397,2755554,157,0,0,1,1
2755485,2755522,37,0,0,1,2
2755523,2755691,168,1,0,0,2
2755555,2755568,13,1,0,0,1
2755569,2755598,29,0,0,1,1
2755599,2755662,63,1,0,0,1
2755663,2755771,108,0,0,1,1
2755692,2755771,79,0,0,1,2
2755772,2755796,24,1,0,0,1
2755772,2755806,34,1,0,0,2
2755797,2756107,310,0,0,1,1
2755807,2757323,1516,0,0,1,2
2756108,2756117,9,1,0,0,1
2756118,2757322,1204,0,0,1,1
2757323,2757392,69,1,0,0,1
2757324,2757393,69,1,0,0,2
2757393,2757503,110,0,0,1,1
2757394,2757503,109,0,0,1,2
2757504,2757532,28,1,0,0,1
2757504,2757539,35,1,0,0,2
2757533,2757695,162,0,0,1,1
2757540,2757696,156,0,0,1,2
2757696,2757714,18,1,0,0,1
2757697,2757722,25,1,0,0,2
2757715,2757960,245,0,0,1,1
2757723,2757955,232,0,0,1,2
2757956,2757972,16,1,0,0,2
2757961,2757972,11,1,0,0,1
2757973,2758245,272,0,0,1,2
2757973,2758260,287,0,0,1,1
2758246,2758385,139,1,0,0,2
2758261,2758435,174,1,0,0,1
2758300,2758353,53,0,1,0,1
2758386,2758788,402,0,0,1,2
2758436,2758786,350,0,0,1,1
2758787,2758846,59,1,0,0,1
2758789,2758860,71,1,0,0,2
2758847,2759066,219,0,0,1,1
2758861,2759064,203,0,0,1,2
2759065,2759128,63,1,0,0,2
2759067,2759129,62,1,0,0,1
2759129,2759225,96,0,0,1,2
2759130,2759232,102,0,0,1,1
2759226,2760926,1700,1,0,0,2
2759233,2759267,34,1,0,0,1
2759268,2759590,322,0,0,1,1
2759379,2759429,50,0,1,0,2
2759491,2759578,87,0,1,0,2
2759591,2759601,10,1,0,0,1
2759602,2760276,674,0,0,1,1
2760002,2760891,889,0,1,0,2
2760277,2760752,475,1,0,0,1
2760288,2760681,393,0,1,0,1
2760753,2760781,28,0,0,1,1
2760792,2760834,42,0,1,0,1
2760844,2760895,51,1,0,0,1
2760896,2760979,83,0,0,1,1
2760927,2760980,53,0,0,1,2
2760980,2761030,50,1,0,0,1
2760981,2761021,40,1,0,0,2
2761022,2761131,109,0,0,1,2
2761031,2761129,98,0,0,1,1
2761130,2761149,19,1,0,0,1
2761132,2761164,32,1,0,0,2
2761150,2762305,1155,0,0,1,1
2761165,2762307,1142,0,0,1,2
2762306,2762395,89,1,0,0,1
2762308,2762419,111,1,0,0,2
2762396,2762734,338,0,0,1,1
2762420,2762530,110,0,0,1,2
2762531,2762610,79,1,0,0,2
2762611,2762733,122,0,0,1,2
2762734,2762806,72,1,0,0,2
2762735,2762806,71,1,0,0,1
2762807,2762903,96,0,0,1,1
2762807,2762904,97,0,0,1,2
2762904,2762941,37,1,0,0,1
2762905,2762934,29,1,0,0,2
2762935,2763098,163,0,0,1,2
2762942,2763097,155,0,0,1,1
2763098,2763108,10,1,0,0,1
2763099,2763108,9,1,0,0,2
2763109,2763367,258,0,0,1,1
2763109,2763367,258,0,0,1,2
2763368,2763372,4,1,0,0,2
2763368,2763378,10,1,0,0,1
2763373,2764370,997,0,0,1,2
2763379,2764370,991,0,0,1,1
2764371,2764457,86,1,0,0,1
2764371,2764462,91,1,0,0,2
2764458,2764530,72,0,0,1,1
2764463,2764532,69,0,0,1,2
2764531,2764569,38,1,0,0,1
2764533,2764570,37,1,0,0,2
2764570,2764631,61,0,0,1,1
2764571,2764634,63,0,0,1,2
2764632,2764659,27,1,0,0,1
2764635,2764656,21,1,0,0,2
2764657,2764891,234,0,0,1,2
2764660,2764890,230,0,0,1,1
2764891,2764903,12,1,0,0,1
2764892,2764903,11,1,0,0,2
2764904,2766050,1146,0,0,1,1
2764904,2766052,1148,0,0,1,2
2766051,2766106,55,1,0,0,1
2766053,2766109,56,1,0,0,2
2766107,2766221,114,0,0,1,1
2766110,2766221,111,0,0,1,2
2766222,2766250,28,1,0,0,1
2766222,2766250,28,1,0,0,2
2766251,2766550,299,0,0,1,1
2766251,2766552,301,0,0,1,2
2766551,2766562,11,1,0,0,1
2766553,2766561,8,1,0,0,2
2766562,2767710,1148,0,0,1,2
2766563,2767709,1146,0,0,1,1
2767710,2767774,64,1,0,0,1
2767711,2767795,84,1,0,0,2
2767775,2767807,32,0,0,1,1
2767796,2767883,87,0,0,1,2
2767808,2767859,51,1,0,0,1
2767860,2767882,22,0,0,1,1
2767883,2767941,58,1,0,0,1
2767884,2767923,39,1,0,0,2
2767924,2768018,94,0,0,1,2
2767942,2768032,90,0,0,1,1
2768019,2768029,10,1,0,0,2
2768030,2768052,22,0,0,1,2
2768043,2768201,158,0,1,0,1
2768053,2768092,39,1,0,0,2
2768093,2768775,682,0,0,1,2
2768211,2768413,202,1,0,0,1
2768274,2768329,55,0,1,0,1
2768414,2768457,43,0,0,1,1
2768468,2769499,1031,0,1,0,1
2768776,2768791,15,1,0,0,2
2768792,2768929,137,0,0,1,2
2768940,2769489,549,0,1,0,2
2769499,2769517,18,1,0,0,2
2769509,2769513,4,1,0,0,1
2769514,2769579,65,0,0,1,1
2769518,2769581,63,0,0,1,2
2769580,2769612,32,1,0,0,1
2769582,2769611,29,1,0,0,2
2769612,2769735,123,0,0,1,2
2769613,2769735,122,0,0,1,1
2769736,2769749,13,1,0,0,2
2769736,2769752,16,1,0,0,1
2769750,2770109,359,0,0,1,2
2769753,2770116,363,0,0,1,1
2770110,2770420,310,1,0,0,2
2770117,2770357,240,1,0,0,1
2770133,2770336,203,0,1,0,1
2770137,2770341,204,0,1,0,2
2770358,2771116,758,0,0,1,1
2770421,2771117,696,0,0,1,2
2771117,2771150,33,1,0,0,1
2771118,2771153,35,1,0,0,2
2771151,2771311,160,0,0,1,1
2771154,2771311,157,0,0,1,2
2771312,2771317,5,1,0,0,2
2771312,2771318,6,1,0,0,1
2771318,2772688,1370,0,0,1,2
2771319,2772688,1369,0,0,1,1
2772689,2772749,60,1,0,0,1
2772689,2772761,72,1,0,0,2
2772750,2772821,71,0,0,1,1
2772762,2772822,60,0,0,1,2
2772822,2772854,32,1,0,0,1
2772823,2772854,31,1,0,0,2
2772855,2772932,77,0,0,1,1
2772855,2772935,80,0,0,1,2
2772933,2772961,28,1,0,0,1
2772936,2772952,16,1,0,0,2
2772953,2773109,156,0,0,1,2
2772962,2773110,148,0,0,1,1
2773110,2773116,6,1,0,0,2
2773111,2773117,6,1,0,0,1
2773117,2773918,801,0,0,1,2
2773118,2773919,801,0,0,1,1
2773919,2773985,66,1,0,0,2
2773920,2773985,65,1,0,0,1
2773986,2774360,374,0,0,1,2
2773986,2774361,375,0,0,1,1
2774361,2774405,44,1,0,0,2
2774362,2774402,40,1,0,0,1
2774403,2774568,165,0,0,1,1
2774406,2775899,1493,0,0,1,2
2774569,2774586,17,1,0,0,1
2774587,2775900,1313,0,0,1,1
2775900,2775964,64,1,0,0,2
2775901,2775963,62,1,0,0,1
2775964,2776075,111,0,0,1,1
2775965,2776075,110,0,0,1,2
2776076,2776099,23,1,0,0,1
2776076,2776099,23,1,0,0,2
2776100,2776545,445,0,0,1,2
2776100,2776547,447,0,0,1,1
2776546,2776563,17,1,0,0,2
2776548,2776561,13,1,0,0,1
2776562,2777600,1038,0,0,1,1
2776564,2777600,1036,0,0,1,2
2777601,2777700,99,1,0,0,1
2777601,2777700,99,1,0,0,2
2777701,2777785,84,0,0,1,1
2777701,2777785,84,0,0,1,2
2777786,2777824,38,1,0,0,1
2777786,2777826,40,1,0,0,2
2777825,2777917,92,0,0,1,1
2777827,2777918,91,0,0,1,2
2777918,2777941,23,1,0,0,1
2777919,2777942,23,1,0,0,2
2777942,2779256,1314,0,0,1,1
2777943,2779256,1313,0,0,1,2
2779257,2779314,57,1,0,0,1
2779257,2779320,63,1,0,0,2
2779315,2779435,120,0,0,1,1
2779321,2779434,113,0,0,1,2
2779435,2779515,80,1,0,0,2
2779436,2779506,70,1,0,0,1
2779507,2779667,160,0,0,1,1
2779516,2779663,147,0,0,1,2
2779664,2779685,21,1,0,0,2
2779668,2779686,18,1,0,0,1
2779686,2780871,1185,0,0,1,2
2779687,2779963,276,0,0,1,1
2779964,2779974,10,1,0,0,1
2779975,2780857,882,0,0,1,1
2780858,2781142,284,1,0,0,1
2780872,2781184,312,1,0,0,2
2780893,2781096,203,0,1,0,1
2780900,2781109,209,0,1,0,2
2781143,2781384,241,0,0,1,1
2781185,2781252,67,0,0,1,2
2781253,2781323,70,1,0,0,2
2781324,2781384,60,0,0,1,2
2781385,2781452,67,1,0,0,1
2781385,2781453,68,1,0,0,2
2781453,2781692,239,0,0,1,1
2781454,2781688,234,0,0,1,2
2781689,2781706,17,1,0,0,2
2781693,2781702,9,1,0,0,1
2781703,2782166,463,0,0,1,1
2781707,2783171,1464,0,0,1,2
2782167,2782171,4,1,0,0,1
2782172,2783171,999,0,0,1,1
2783172,2783231,59,1,0,0,1
2783172,2783239,67,1,0,0,2
2783232,2783337,105,0,0,1,1
2783240,2783337,97,0,0,1,2
2783338,2783361,23,1,0,0,2
2783338,2783366,28,1,0,0,1
2783362,2784854,1492,0,0,1,2
2783367,2783535,168,0,0,1,1
2783536,2783542,6,1,0,0,1
2783543,2784854,1311,0,0,1,1
2784855,2784953,98,1,0,0,1
2784855,2784956,101,1,0,0,2
2784954,2785074,120,0,0,1,1
2784957,2785073,116,0,0,1,2
2785074,2785109,35,1,0,0,2
2785075,2785100,25,1,0,0,1
2785101,2785324,223,0,0,1,1
2785110,2785324,214,0,0,1,2
2785325,2785345,20,1,0,0,1
2785325,2785365,40,1,0,0,2
2785346,2786530,1184,0,0,1,1
2785366,2785404,38,0,0,1,2
2785405,2785416,11,1,0,0,2
2785417,2786532,1115,0,0,1,2
2786531,2786603,72,1,0,0,1
2786533,2786616,83,1,0,0,2
2786604,2786691,87,0,0,1,1
2786617,2786692,75,0,0,1,2
2786692,2786729,37,1,0,0,1
2786693,2786732,39,1,0,0,2
2786730,2786799,69,0,0,1,1
2786733,2786799,66,0,0,1,2
2786800,2786821,21,1,0,0,1
2786800,2786823,23,1,0,0,2
2786822,2787258,436,0,0,1,1
2786824,2787262,438,0,0,1,2
2787259,2787429,170,1,0,0,1
2787263,2787425,162,1,0,0,2
2787279,2787395,116,0,1,0,1
2787285,2787393,108,0,1,0,2
2787426,2787867,441,0,0,1,2
2787430,2787867,437,0,0,1,1
2787868,2787940,72,1,0,0,1
2787868,2787943,75,1,0,0,2
2787941,2788171,230,0,0,1,1
2787944,2788146,202,0,0,1,2
2788147,2788239,92,1,0,0,2
2788172,2788223,51,1,0,0,1
2788224,2788343,119,0,0,1,1
2788240,2788343,103,0,0,1,2
2788344,2788362,18,1,0,0,2
2788344,2788364,20,1,0,0,1
2788363,2789650,1287,0,0,1,2
2788365,2789649,1284,0,0,1,1
2789650,2789694,44,1,0,0,1
2789651,2789697,46,1,0,0,2
2789695,2789809,114,0,0,1,1
2789698,2789809,111,0,0,1,2
2789810,2789835,25,1,0,0,1
2789810,2789835,25,1,0,0,2
2789836,2790001,165,0,0,1,1
2789836,2790004,168,0,0,1,2
2790002,2790016,14,1,0,0,1
2790005,2790014,9,1,0,0,2
2790015,2791215,1200,0,0,1,2
2790017,2791216,1199,0,0,1,1
2791216,2791321,105,1,0,0,2
2791217,2791290,73,1,0,0,1
2791291,2791364,73,0,0,1,1
2791322,2791356,34,0,0,1,2
2791357,2791428,71,1,0,0,2
2791365,2791445,80,1,0,0,1
2791429,2791449,20,0,0,1,2
2791446,2791582,136,0,0,1,1
2791460,2791476,16,0,1,0,2
2791486,2792952,1466,1,0,0,2
2791531,2792904,1373,0,1,0,2
2791583,2791657,74,1,0,0,1
2791658,2791753,95,0,0,1,1
2791764,2791864,100,0,1,0,1
2791874,2791890,16,1,0,0,1
2791891,2792841,950,0,0,1,1
2792842,2792949,107,1,0,0,1
2792950,2793027,77,0,0,1,1
2792953,2793028,75,0,0,1,2
2793028,2793072,44,1,0,0,1
2793029,2793073,44,1,0,0,2
2793073,2794549,1476,0,0,1,1
2793074,2794549,1475,0,0,1,2
2794550,2794586,36,1,0,0,1
2794550,2794598,48,1,0,0,2
2794587,2794651,64,0,0,1,1
2794599,2794653,54,0,0,1,2
2794652,2794700,48,1,0,0,1
2794654,2794714,60,1,0,0,2
2794701,2794825,124,0,0,1,1
2794715,2794826,111,0,0,1,2
2794826,2794852,26,1,0,0,1
2794827,2794853,26,1,0,0,2
2794853,2795049,196,0,0,1,1
2794854,2795048,194,0,0,1,2
2795049,2795262,213,1,0,0,2
2795050,2795287,237,1,0,0,1
2795074,2795235,161,0,1,0,1
2795083,2795217,134,0,1,0,2
2795263,2796208,945,0,0,1,2
2795288,2796208,920,0,0,1,1
2796209,2796273,64,1,0,0,1
2796209,2796280,71,1,0,0,2
2796274,2796429,155,0,0,1,1
2796281,2796430,149,0,0,1,2
2796430,2796449,19,1,0,0,1
2796431,2796448,17,1,0,0,2
2796449,2797682,1233,0,0,1,2
2796450,2797790,1340,0,0,1,1
2797683,2797695,12,1,0,0,2
2797696,2797751,55,0,0,1,2
2797752,2799191,1439,1,0,0,2
2797791,2799084,1293,1,0,0,1
2797834,2799074,1240,0,1,0,1
2797857,2798042,185,0,1,0,2
2798075,2799063,988,0,1,0,2
2799085,2799368,283,0,0,1,1
2799192,2799369,177,0,0,1,2
2799369,2799444,75,1,0,0,1
2799370,2799457,87,1,0,0,2
2799445,2799542,97,0,0,1,1
2799458,2799555,97,0,0,1,2
2799543,2799588,45,1,0,0,1
2799556,2799565,9,1,0,0,2
2799566,2799809,243,0,0,1,2
2799589,2799696,107,0,0,1,1
2799697,2799711,14,1,0,0,1
2799712,2799963,251,0,0,1,1
2799810,2800143,333,1,0,0,2
2799964,2800013,49,1,0,0,1
2800014,2800463,449,0,0,1,1
2800144,2800221,77,0,0,1,2
2800222,2800318,96,1,0,0,2
2800319,2800358,39,0,0,1,2
2800359,2800499,140,1,0,0,2
2800464,2800505,41,1,0,0,1
2800500,2800832,332,0,0,1,2
2800506,2800743,237,0,0,1,1
2800744,2803928,3184,1,0,0,1
2800833,2800891,58,1,0,0,2
2800848,2802707,1859,0,1,0,1
2800892,2801032,140,0,0,1,2
2801033,2801072,39,1,0,0,2
2801047,2801063,16,0,1,0,2
2801073,2802317,1244,0,0,1,2
2802318,2802389,71,1,0,0,2
2802390,2803835,1445,0,0,1,2
2802797,2802860,63,0,1,0,1
2802881,2802883,2,0,1,0,1
2802908,2802959,51,0,1,0,1
2802986,2802994,8,0,1,0,1
2803021,2803045,24,0,1,0,1
2803130,2803175,45,0,1,0,1
2803836,2803929,93,1,0,0,2
2803859,2803860,1,0,1,0,1
2803929,2804024,95,0,0,1,1
2803930,2804023,93,0,0,1,2
2804024,2804061,37,1,0,0,2
2804025,2804059,34,1,0,0,1
2804060,2805537,1477,0,0,1,1
2804062,2805536,1474,0,0,1,2
2805537,2805598,61,1,0,0,2
2805538,2805596,58,1,0,0,1
2805597,2805702,105,0,0,1,1
2805599,2805701,102,0,0,1,2
2805702,2805885,183,1,0,0,2
2805703,2805734,31,1,0,0,1
2805735,2806949,1214,0,0,1,1
2805886,2806315,429,0,0,1,2
2806316,2806346,30,1,0,0,2
2806347,2806949,602,0,0,1,2
2806950,2807016,66,1,0,0,1
2806950,2807017,67,1,0,0,2
2807017,2807116,99,0,0,1,1
2807018,2807118,100,0,0,1,2
2807117,2807148,31,1,0,0,1
2807119,2807154,35,1,0,0,2
2807149,2807337,188,0,0,1,1
2807155,2807344,189,0,0,1,2
2807338,2807355,17,1,0,0,1
2807345,2807354,9,1,0,0,2
2807355,2808480,1125,0,0,1,2
2807356,2808480,1124,0,0,1,1
2808481,2808963,482,1,0,0,1
2808481,2808979,498,1,0,0,2
2808568,2808859,291,0,1,0,1
2808569,2808940,371,0,1,0,2
2808964,2810259,1295,0,0,1,1
2808980,2810260,1280,0,0,1,2
2810260,2810403,143,1,0,0,1
2810261,2810423,162,1,0,0,2
2810306,2810362,56,0,1,0,1
2810384,2810388,4,0,1,0,1
2810404,2810435,31,0,0,1,1
2810424,2810453,29,0,0,1,2
2810446,2811146,700,0,1,0,1
2810454,2810475,21,1,0,0,2
2810476,2810617,141,0,0,1,2
2810618,2810643,25,1,0,0,2
2810644,2810976,332,0,0,1,2
2810977,2810990,13,1,0,0,2
2810991,2811607,616,0,0,1,2
2811156,2811232,76,1,0,0,1
2811233,2811363,130,0,0,1,1
2811364,2811446,82,1,0,0,1
2811389,2811437,48,0,1,0,1
2811447,2811503,56,0,0,1,1
2811504,2812031,527,1,0,0,1
2811608,2812041,433,1,0,0,2
2811645,2811979,334,0,1,0,1
2811658,2812032,374,0,1,0,2
2812032,2813493,1461,0,0,1,1
2812042,2813493,1451,0,0,1,2
2813494,2813556,62,1,0,0,1
2813494,2813611,117,1,0,0,2
2813557,2814105,548,0,0,1,1
2813612,2813748,136,0,0,1,2
2813749,2813802,53,1,0,0,2
2813803,2814099,296,0,0,1,2
2814100,2814116,16,1,0,0,2
2814106,2814113,7,1,0,0,1
2814114,2814471,357,0,0,1,1
2814117,2814426,309,0,0,1,2
2814427,2818326,3899,1,0,0,2
2814472,2814841,369,1,0,0,1
2814487,2818219,3732,0,1,0,2
2814504,2814767,263,0,1,0,1
2814820,2814830,10,0,1,0,1
2814842,2814997,155,0,0,1,1
2814998,2815007,9,1,0,0,1
2815008,2815405,397,0,0,1,1
2815406,2815416,10,1,0,0,1
2815417,2816137,720,0,0,1,1
2816138,2816166,28,1,0,0,1
2816167,2816302,135,0,0,1,1
2816303,2816321,18,1,0,0,1
2816322,2816549,227,0,0,1,1
2816550,2816607,57,1,0,0,1
2816567,2816575,8,0,1,0,1
2816608,2816677,69,0,0,1,1
2816688,2816688,0,0,1,0,1
2816698,2816858,160,1,0,0,1
2816714,2816731,17,0,1,0,1
2816768,2816813,45,0,1,0,1
2816859,2816980,121,0,0,1,1
2816981,2817137,156,1,0,0,1
2817138,2817855,717,0,0,1,1
2817856,2817895,39,1,0,0,1
2817896,2818134,238,0,0,1,1
2818135,2818273,138,1,0,0,1
2818274,2818301,27,0,0,1,1
2818302,2818360,58,1,0,0,1
2818327,2818355,28,0,0,1,2
2818356,2818459,103,1,0,0,2
2818361,2818400,39,0,0,1,1
2818401,2818427,26,1,0,0,1
2818428,2818519,91,0,0,1,1
2818460,2818484,24,0,0,1,2
2818485,2818887,402,1,0,0,2
2818520,2818720,200,1,0,0,1
2818721,2819654,933,0,0,1,1
2818888,2819458,570,0,0,1,2
2819459,2819463,4,1,0,0,2
2819464,2819644,180,0,0,1,2
2819645,2819665,20,1,0,0,2
2819655,2819702,47,1,0,0,1
2819666,2819864,198,0,0,1,2
2819703,2820000,297,0,0,1,1
2819865,2819874,9,1,0,0,2
2819875,2819995,120,0,0,1,2
2819996,2820023,27,1,0,0,2
2820001,2820062,61,1,0,0,1
2820024,2821470,1446,0,0,1,2
2820063,2820227,164,0,0,1,1
2820228,2820375,147,1,0,0,1
2820376,2820457,81,0,0,1,1
2820458,2820510,52,1,0,0,1
2820511,2820717,206,0,0,1,1
2820718,2820781,63,1,0,0,1
2820782,2821212,430,0,0,1,1
2821213,2821269,56,1,0,0,1
2821270,2821411,141,0,0,1,1
2821412,2821528,116,1,0,0,1
2821471,2821552,81,1,0,0,2
2821529,2821639,110,0,0,1,1
2821553,2821635,82,0,0,1,2
2821636,2821659,23,1,0,0,2
2821640,2821664,24,1,0,0,1
2821660,2822632,972,0,0,1,2
2821665,2822628,963,0,0,1,1
2822629,2822858,229,1,0,0,1
2822633,2822926,293,1,0,0,2
2822645,2822829,184,0,1,0,1
2822645,2822834,189,0,1,0,2
2822859,2823630,771,0,0,1,1
2822927,2823631,704,0,0,1,2
2823631,2823681,50,1,0,0,1
2823632,2823679,47,1,0,0,2
2823680,2823939,259,0,0,1,2
2823682,2823940,258,0,0,1,1
2823940,2823957,17,1,0,0,2
2823941,2823957,16,1,0,0,1
2823958,2825748,1790,0,0,1,1
2823958,2825749,1791,0,0,1,2
2825749,2826472,723,1,0,0,1
2825750,2825802,52,1,0,0,2
2825803,2826272,469,0,0,1,2
2826273,2826410,137,1,0,0,2
2826298,2826399,101,0,1,0,1
2826411,2826868,457,0,0,1,2
2826473,2826868,395,0,0,1,1
2826869,2826891,22,1,0,0,2
2826869,2826906,37,1,0,0,1
2826892,2827407,515,0,0,1,2
2826907,2827408,501,0,0,1,1
2827408,2827453,45,1,0,0,2
2827409,2827442,33,1,0,0,1
2827443,2827661,218,0,0,1,1
2827454,2827565,111,0,0,1,2
2827566,2827583,17,1,0,0,2
2827584,2827775,191,0,0,1,2
2827662,2827731,69,1,0,0,1
2827732,2827768,36,0,0,1,1
2827769,2828489,720,1,0,0,1
2827776,2833843,6067,1,0,0,2
2827796,2828935,1139,0,1,0,2
2827797,2828347,550,0,1,0,1
2828444,2828454,10,0,1,0,1
2828490,2828752,262,0,0,1,1
2828753,2828815,62,1,0,0,1
2828764,2828766,2,0,1,0,1
2828816,2829108,292,0,0,1,1
2829109,2829203,94,1,0,0,1
2829118,2833825,4707,0,1,0,2
2829204,2829276,72,0,0,1,1
2829277,2829387,110,1,0,0,1
2829388,2829605,217,0,0,1,1
2829606,2829795,189,1,0,0,1
2829636,2829786,150,0,1,0,1
2829796,2829883,87,0,0,1,1
2829894,2830490,596,0,1,0,1
2830500,2830500,0,1,0,0,1
2830501,2830850,349,0,0,1,1
2830861,2831168,307,0,1,0,1
2831177,2831177,0,1,0,0,1
2831178,2831224,46,0,0,1,1
2831225,2831254,29,1,0,0,1
2831255,2831300,45,0,0,1,1
2831301,2831318,17,1,0,0,1
2831319,2832368,1049,0,0,1,1
2832369,2832518,149,1,0,0,1
2832519,2832553,34,0,0,1,1
2832554,2833473,919,1,0,0,1
2832580,2833129,549,0,1,0,1
2833220,2833220,0,0,1,0,1
2833474,2833520,46,0,0,1,1
2833531,2833779,248,0,1,0,1
2833789,2833834,45,1,0,0,1
2833835,2834129,294,0,0,1,1
2833844,2833942,98,0,0,1,2
2833943,2834005,62,1,0,0,2
2834006,2834123,117,0,0,1,2
2834124,2834157,33,1,0,0,2
2834130,2834150,20,1,0,0,1
2834151,2834251,100,0,0,1,1
2834158,2834252,94,0,0,1,2
2834252,2834618,366,1,0,0,1
2834253,2834593,340,1,0,0,2
2834272,2834540,268,0,1,0,1
2834280,2834568,288,0,1,0,2
2834594,2834891,297,0,0,1,2
2834619,2834889,270,0,0,1,1
2834890,2834916,26,1,0,0,1
2834892,2834915,23,1,0,0,2
2834916,2835778,862,0,0,1,2
2834917,2835778,861,0,0,1,1
2835779,2835856,77,1,0,0,2
2835779,2835859,80,1,0,0,1
2835857,2836047,190,0,0,1,2
2835860,2836108,248,0,0,1,1
2836048,2836067,19,1,0,0,2
2836068,2836107,39,0,0,1,2
2836108,2836449,341,1,0,0,2
2836109,2836146,37,1,0,0,1
2836147,2836452,305,0,0,1,1
2836450,2836489,39,0,0,1,2
2836453,2837046,593,1,0,0,1
2836467,2836471,4,0,1,0,1
2836490,2836564,74,1,0,0,2
2836539,2837022,483,0,1,0,1
2836565,2836695,130,0,0,1,2
2836706,2836996,290,0,1,0,2
2837006,2837079,73,1,0,0,2
2837047,2837236,189,0,0,1,1
2837080,2837234,154,0,0,1,2
2837235,2837252,17,1,0,0,2
2837237,2837253,16,1,0,0,1
2837253,2837861,608,0,0,1,2
2837254,2838031,777,0,0,1,1
2837862,2837866,4,1,0,0,2
2837867,2838033,166,0,0,1,2
2838032,2838088,56,1,0,0,1
2838034,2838108,74,1,0,0,2
2838089,2838485,396,0,0,1,1
2838109,2838493,384,0,0,1,2
2838486,2839288,802,1,0,0,1
2838494,2839047,553,1,0,0,2
2838509,2839278,769,0,1,0,1
2838520,2839020,500,0,1,0,2
2839048,2840208,1160,0,0,1,2
2839289,2839680,391,0,0,1,1
2839691,2840315,624,0,1,0,1
2840209,2840215,6,1,0,0,2
2840216,2840269,53,0,0,1,2
2840270,2840358,88,1,0,0,2
2840325,2840334,9,1,0,0,1
2840335,2840382,47,0,0,1,1
2840359,2840682,323,0,0,1,2
2840383,2840451,68,1,0,0,1
2840452,2840484,32,0,0,1,1
2840485,2840634,149,1,0,0,1
2840635,2841178,543,0,0,1,1
2840683,2840865,182,1,0,0,2
2840866,2840892,26,0,0,1,2
2840893,2841309,416,1,0,0,2
2841179,2841198,19,1,0,0,1
2841199,2841235,36,0,0,1,1
2841236,2841284,48,1,0,0,1
2841285,2841399,114,0,0,1,1
2841310,2841402,92,0,0,1,2
2841400,2841417,17,1,0,0,1
2841403,2841423,20,1,0,0,2
2841418,2842620,1202,0,0,1,1
2841424,2842621,1197,0,0,1,2
2842621,2842683,62,1,0,0,1
2842622,2842674,52,1,0,0,2
2842675,2842984,309,0,0,1,2
2842684,2842984,300,0,0,1,1
2842985,2843008,23,1,0,0,2
2842985,2843012,27,1,0,0,1
2843009,2843151,142,0,0,1,2
2843013,2843148,135,0,0,1,1
2843149,2843734,585,1,0,0,1
2843152,2843631,479,1,0,0,2
2843167,2843686,519,0,1,0,1
2843183,2843574,391,0,1,0,2
2843632,2844016,384,0,0,1,2
2843735,2844016,281,0,0,1,1
2844017,2844039,22,1,0,0,2
2844017,2844046,29,1,0,0,1
2844040,2845011,971,0,0,1,2
2844047,2845010,963,0,0,1,1
2845011,2845071,60,1,0,0,1
2845012,2845056,44,1,0,0,2
2845057,2845448,391,0,0,1,2
2845072,2845450,378,0,0,1,1
2845449,2845508,59,1,0,0,2
2845451,2845496,45,1,0,0,1
2845497,2846231,734,0,0,1,1
2845509,2846229,720,0,0,1,2
2846230,2846264,34,1,0,0,2
2846232,2846266,34,1,0,0,1
2846265,2846401,136,0,0,1,2
2846267,2846399,132,0,0,1,1
2846400,2846416,16,1,0,0,1
2846402,2846418,16,1,0,0,2
2846417,2847742,1325,0,0,1,1
2846419,2847742,1323,0,0,1,2
2847743,2847795,52,1,0,0,1
2847743,2847808,65,1,0,0,2
2847796,2847991,195,0,0,1,1
2847809,2847991,182,0,0,1,2
2847992,2848014,22,1,0,0,2
2847992,2848016,24,1,0,0,1
2848015,2848230,215,0,0,1,2
2848017,2848237,220,0,0,1,1
2848231,2848419,188,1,0,0,2
2848238,2848426,188,1,0,0,1
2848420,2848855,435,0,0,1,2
2848427,2848854,427,0,0,1,1
2848855,2849119,264,1,0,0,1
2848856,2849149,293,1,0,0,2
2848881,2849077,196,0,1,0,1
2848884,2849075,191,0,1,0,2
2849120,2849793,673,0,0,1,1
2849150,2849794,644,0,0,1,2
2849794,2849847,53,1,0,0,1
2849795,2849847,52,1,0,0,2
2849848,2850109,261,0,0,1,2
2849848,2850110,262,0,0,1,1
2850110,2850133,23,1,0,0,2
2850111,2850134,23,1,0,0,1
2850134,2850870,736,0,0,1,2
2850135,2851374,1239,0,0,1,1
2850871,2851047,176,1,0,0,2
2851048,2851087,39,0,0,1,2
2851088,2851272,184,1,0,0,2
2851273,2851368,95,0,0,1,2
2851369,2854215,2846,1,0,0,2
2851375,2851436,61,1,0,0,1
2851411,2851422,11,0,1,0,1
2851414,2853366,1952,0,1,0,2
2851437,2851465,28,0,0,1,1
2851466,2851489,23,1,0,0,1
2851490,2851567,77,0,0,1,1
2851568,2851604,36,1,0,0,1
2851605,2851827,222,0,0,1,1
2851828,2851836,8,1,0,0,1
2851837,2852238,401,0,0,1,1
2852239,2853365,1126,1,0,0,1
2852275,2852437,162,0,1,0,1
2852458,2853333,875,0,1,0,1
2853366,2853515,149,0,0,1,1
2853516,2853532,16,1,0,0,1
2853533,2853819,286,0,0,1,1
2853820,2853835,15,1,0,0,1
2853836,2854305,469,0,0,1,1
2854216,2854289,73,0,0,1,2
2854290,2854343,53,1,0,0,2
2854306,2854324,18,1,0,0,1
2854325,2854633,308,0,0,1,1
2854344,2854373,29,0,0,1,2
2854374,2854398,24,1,0,0,2
2854399,2854633,234,0,0,1,2
2854634,2854655,21,1,0,0,1
2854634,2854695,61,1,0,0,2
2854656,2854886,230,0,0,1,1
2854696,2854853,157,0,0,1,2
2854854,2855318,464,1,0,0,2
2854887,2855191,304,1,0,0,1
2854891,2855191,300,0,1,0,2
2854910,2855141,231,0,1,0,1
2855192,2855480,288,0,0,1,1
2855319,2855480,161,0,0,1,2
2855481,2855529,48,1,0,0,1
2855481,2855535,54,1,0,0,2
2855530,2855973,443,0,0,1,1
2855536,2855882,346,0,0,1,2
2855883,2856065,182,1,0,0,2
2855974,2856037,63,1,0,0,1
2856038,2857183,1145,0,0,1,1
2856066,2856562,496,0,0,1,2
2856563,2856600,37,1,0,0,2
2856601,2856754,153,0,0,1,2
2856755,2856791,36,1,0,0,2
2856792,2856852,60,0,0,1,2
2856853,2857251,398,1,0,0,2
2857184,2857234,50,1,0,0,1
2857235,2857306,71,0,0,1,1
2857252,2857307,55,0,0,1,2
2857307,2857331,24,1,0,0,1
2857308,2857334,26,1,0,0,2
2857332,2858941,1609,0,0,1,1
2857335,2858942,1607,0,0,1,2
2858942,2858976,34,1,0,0,1
2858943,2858975,32,1,0,0,2
2858976,2859154,178,0,0,1,2
2858977,2859282,305,0,0,1,1
2859155,2859186,31,1,0,0,2
2859187,2859282,95,0,0,1,2
2859283,2859305,22,1,0,0,1
2859283,2859325,42,1,0,0,2
2859306,2859769,463,0,0,1,1
2859326,2859763,437,0,0,1,2
2859764,2860198,434,1,0,0,2
2859770,2860211,441,1,0,0,1
2859787,2860201,414,0,1,0,1
2859795,2860185,390,0,1,0,2
2860199,2860234,35,0,0,1,2
2860212,2860621,409,0,0,1,1
2860235,2860241,6,1,0,0,2
2860242,2860280,38,0,0,1,2
2860281,2860300,19,1,0,0,2
2860301,2860610,309,0,0,1,2
2860611,2860701,90,1,0,0,2
2860622,2860632,10,1,0,0,1
2860633,2861196,563,0,0,1,1
2860702,2861196,494,0,0,1,2
2861197,2861211,14,1,0,0,2
2861197,2861215,18,1,0,0,1
2861212,2861628,416,0,0,1,2
2861216,2861635,419,0,0,1,1
2861629,2861656,27,1,0,0,2
2861636,2861656,20,1,0,0,1
2861657,2862031,374,0,0,1,2
2861657,2862500,843,0,0,1,1
2862032,2863206,1174,1,0,0,2
2862501,2862532,31,1,0,0,1
2862533,2862617,84,0,0,1,1
2862618,2862698,80,1,0,0,1
2862699,2862740,41,0,0,1,1
2862741,2865073,2332,1,0,0,1
2863022,2864925,1903,0,1,0,1
2863207,2863492,285,0,0,1,2
2863493,2863512,19,1,0,0,2
2863513,2863561,48,0,0,1,2
2863562,2864774,1212,1,0,0,2
2864775,2864866,91,0,0,1,2
2864867,2865105,238,1,0,0,2
2865074,2867358,2284,0,0,1,1
2865106,2865201,95,0,0,1,2
2865202,2865222,20,1,0,0,2
2865223,2865412,189,0,0,1,2
2865413,2865584,171,1,0,0,2
2865585,2865636,51,0,0,1,2
2865637,2865693,56,1,0,0,2
2865694,2866146,452,0,0,1,2
2866147,2866609,462,1,0,0,2
2866610,2866716,106,0,0,1,2
2866717,2867007,290,1,0,0,2
2867008,2867051,43,0,0,1,2
2867052,2867324,272,1,0,0,2
2867325,2867375,50,0,0,1,2
2867359,2867902,543,1,0,0,1
2867376,2867902,526,1,0,0,2
2867407,2867866,459,0,1,0,1
2867422,2867833,411,0,1,0,2
2867903,2868199,296,0,0,1,2
2867903,2868401,498,0,0,1,1
2868200,2868354,154,1,0,0,2
2868355,2868391,36,0,0,1,2
2868392,2868477,85,1,0,0,2
2868402,2868468,66,1,0,0,1
2868469,2868728,259,0,0,1,1
2868478,2868727,249,0,0,1,2
2868728,2873803,5075,1,0,0,2
2868729,2868917,188,1,0,0,1
2868760,2873774,5014,0,1,0,2
2868918,2869021,103,0,0,1,1
2869022,2869038,16,1,0,0,1
2869039,2869209,170,0,0,1,1
2869210,2869238,28,1,0,0,1
2869239,2869341,102,0,0,1,1
2869342,2869373,31,1,0,0,1
2869374,2869456,82,0,0,1,1
2869457,2869766,309,1,0,0,1
2869767,2869815,48,0,0,1,1
2869816,2869837,21,1,0,0,1
2869838,2869884,46,0,0,1,1
2869885,2870022,137,1,0,0,1
2870023,2870092,69,0,0,1,1
2870093,2873791,3698,1,0,0,1
2870111,2873764,3653,0,1,0,1
2873792,2873901,109,0,0,1,1
2873804,2873900,96,0,0,1,2
2873901,2873924,23,1,0,0,2
2873902,2873925,23,1,0,0,1
2873925,2875055,1130,0,0,1,2
2873926,2875275,1349,0,0,1,1
2875056,2875074,18,1,0,0,2
2875075,2875277,202,0,0,1,2
2875276,2875318,42,1,0,0,1
2875278,2875313,35,1,0,0,2
2875314,2875353,39,0,0,1,2
2875319,2875600,281,0,0,1,1
2875354,2875405,51,1,0,0,2
2875406,2875610,204,0,0,1,2
2875601,2876049,448,1,0,0,1
2875611,2876039,428,1,0,0,2
2875623,2876030,407,0,1,0,1
2875643,2875994,351,0,1,0,2
2876040,2876546,506,0,0,1,2
2876050,2876532,482,0,0,1,1
2876533,2876953,420,1,0,0,1
2876547,2876914,367,1,0,0,2
2876566,2876943,377,0,1,0,1
2876580,2876889,309,0,1,0,2
2876915,2877001,86,0,0,1,2
2876954,2876987,33,0,0,1,1
2876988,2877000,12,1,0,0,1
2877001,2877480,479,0,0,1,1
2877002,2877096,94,1,0,0,2
2877097,2877411,314,0,0,1,2
2877412,2877564,152,1,0,0,2
2877481,2877519,38,1,0,0,1
2877520,2877708,188,0,0,1,1
2877565,2877607,42,0,0,1,2
2877608,2877623,15,1,0,0,2
2877624,2877662,38,0,0,1,2
2877663,2877678,15,1,0,0,2
2877679,2877705,26,0,0,1,2
2877706,2877864,158,1,0,0,2
2877709,2877756,47,1,0,0,1
2877757,2877963,206,0,0,1,1
2877865,2877954,89,0,0,1,2
2877955,2878172,217,1,0,0,2
2877964,2878014,50,1,0,0,1
2878015,2878611,596,0,0,1,1
2878173,2878208,35,0,0,1,2
2878209,2878254,45,1,0,0,2
2878255,2878298,43,0,0,1,2
2878299,2878477,178,1,0,0,2
2878478,2878525,47,0,0,1,2
2878526,2878662,136,1,0,0,2
2878612,2878671,59,1,0,0,1
2878663,2878721,58,0,0,1,2
2878672,2878737,65,0,0,1,1
2878722,2878746,24,1,0,0,2
2878738,2878750,12,1,0,0,1
2878747,2878780,33,0,0,1,2
2878751,2878780,29,0,0,1,1
2878781,2878859,78,1,0,0,1
2878781,2878870,89,1,0,0,2
2878860,2879001,141,0,0,1,1
2878871,2878997,126,0,0,1,2
2878998,2879043,45,1,0,0,2
2879002,2879017,15,1,0,0,1
2879018,2880850,1832,0,0,1,1
2879044,2879079,35,0,0,1,2
2879080,2879092,12,1,0,0,2
2879093,2879774,681,0,0,1,2
2879775,2879835,60,1,0,0,2
2879836,2880851,1015,0,0,1,2
2880851,2880898,47,1,0,0,1
2880852,2880899,47,1,0,0,2
2880899,2881084,185,0,0,1,1
2880900,2881086,186,0,0,1,2
2881085,2881110,25,1,0,0,1
2881087,2881110,23,1,0,0,2
2881111,2881158,47,0,0,1,2
2881111,2881162,51,0,0,1,1
2881159,2881413,254,1,0,0,2
2881163,2881403,240,1,0,0,1
2881184,2881356,172,0,1,0,1
2881194,2881350,156,0,1,0,2
2881404,2881777,373,0,0,1,1
2881414,2881777,363,0,0,1,2
2881778,2881794,16,1,0,0,1
2881778,2881794,16,1,0,0,2
2881795,2882050,255,0,0,1,1
2881795,2882691,896,0,0,1,2
2882051,2882059,8,1,0,0,1
2882060,2882691,631,0,0,1,1
2882692,2882711,19,1,0,0,1
2882692,2882711,19,1,0,0,2
2882712,2882968,256,0,0,1,2
2882712,2882982,270,0,0,1,1
2882969,2883316,347,1,0,0,2
2882983,2883282,299,1,0,0,1
2883007,2883227,220,0,1,0,1
2883019,2883227,208,0,1,0,2
2883283,2884591,1308,0,0,1,1
2883317,2884592,1275,0,0,1,2
2884592,2884639,47,1,0,0,1
2884593,2884640,47,1,0,0,2
2884640,2884760,120,0,0,1,1
2884641,2884767,126,0,0,1,2
2884761,2884781,20,1,0,0,1
2884768,2884773,5,1,0,0,2
2884774,2884923,149,0,0,1,2
2884782,2886235,1453,0,0,1,1
2884924,2884932,8,1,0,0,2
2884933,2886236,1303,0,0,1,2
2886236,2886277,41,1,0,0,1
2886237,2886278,41,1,0,0,2
2886278,2886411,133,0,0,1,1
2886279,2886414,135,0,0,1,2
2886412,2886425,13,1,0,0,1
2886415,2886431,16,1,0,0,2
2886426,2886491,65,0,0,1,1
2886432,2886490,58,0,0,1,2
2886491,2886866,375,1,0,0,2
2886492,2886768,276,1,0,0,1
2886512,2886740,228,0,1,0,1
2886519,2886758,239,0,1,0,2
2886769,2887304,535,0,0,1,1
2886867,2887303,436,0,0,1,2
2887304,2887320,16,1,0,0,2
2887305,2887316,11,1,0,0,1
2887317,2887681,364,0,0,1,1
2887321,2887679,358,0,0,1,2
2887680,2887692,12,1,0,0,2
2887682,2887694,12,1,0,0,1
2887693,2888065,372,0,0,1,2
2887695,2888430,735,0,0,1,1
2888066,2888076,10,1,0,0,2
2888077,2888422,345,0,0,1,2
2888423,2889028,605,1,0,0,2
2888431,2888755,324,1,0,0,1
2888452,2888723,271,0,1,0,1
2888454,2888805,351,0,1,0,2
2888756,2889071,315,0,0,1,1
2889029,2889069,40,0,0,1,2
2889070,2889103,33,1,0,0,2
2889072,2889102,30,1,0,0,1
2889103,2889490,387,0,0,1,1
2889104,2889489,385,0,0,1,2
2889490,2889525,35,1,0,0,2
2889491,2889526,35,1,0,0,1
2889526,2889767,241,0,0,1,2
2889527,2889768,241,0,0,1,1
2889768,2893069,3301,1,0,0,2
2889769,2889838,69,1,0,0,1
2889808,2892960,3152,0,1,0,2
2889839,2889962,123,0,0,1,1
2889963,2889998,35,1,0,0,1
2889978,2889989,11,0,1,0,1
2889999,2890101,102,0,0,1,1
2890102,2890658,556,1,0,0,1
2890125,2890128,3,0,1,0,1
2890157,2890635,478,0,1,0,1
2890659,2891433,774,0,0,1,1
2891434,2891498,64,1,0,0,1
2891499,2891655,156,0,0,1,1
2891656,2891769,113,1,0,0,1
2891770,2891900,130,0,0,1,1
2891901,2891933,32,1,0,0,1
2891934,2892555,621,0,0,1,1
2892556,2892565,9,1,0,0,1
2892566,2893834,1268,0,0,1,1
2893070,2893150,80,0,0,1,2
2893151,2893227,76,1,0,0,2
2893228,2893284,56,0,0,1,2
2893285,2893403,118,1,0,0,2
2893404,2893590,186,0,0,1,2
2893591,2894435,844,1,0,0,2
2893835,2893844,9,1,0,0,1
2893845,2893884,39,0,0,1,1
2893854,2893861,7,0,1,0,2
2893885,2894336,451,1,0,0,1
2893893,2894424,531,0,1,0,2
2893920,2894290,370,0,1,0,1
2894337,2894494,157,0,0,1,1
2894436,2894494,58,0,0,1,2
2894495,2894531,36,1,0,0,1
2894495,2894536,41,1,0,0,2
2894532,2895243,711,0,0,1,1
2894537,2895245,708,0,0,1,2
2895244,2895292,48,1,0,0,1
2895246,2895302,56,1,0,0,2
2895293,2895400,107,0,0,1,1
2895303,2895399,96,0,0,1,2
2895400,2895434,34,1,0,0,2
2895401,2895425,24,1,0,0,1
2895426,2896640,1214,0,0,1,1
2895435,2896640,1205,0,0,1,2
2896641,2896692,51,1,0,0,1
2896641,2896693,52,1,0,0,2
2896693,2896921,228,0,0,1,1
2896694,2896927,233,0,0,1,2
2896922,2896940,18,1,0,0,1
2896928,2896937,9,1,0,0,2
2896938,2897251,313,0,0,1,2
2896941,2897262,321,0,0,1,1
2897252,2897602,350,1,0,0,2
2897263,2897601,338,1,0,0,1
2897285,2897571,286,0,1,0,1
2897286,2897551,265,0,1,0,2
2897602,2897682,80,0,0,1,1
2897603,2897682,79,0,0,1,2
2897683,2897704,21,1,0,0,1
2897683,2897720,37,1,0,0,2
2897705,2897969,264,0,0,1,1
2897721,2897974,253,0,0,1,2
2897970,2897987,17,1,0,0,1
2897975,2897985,10,1,0,0,2
2897986,2898887,901,0,0,1,2
2897988,2898888,900,0,0,1,1
2898888,2898934,46,1,0,0,2
2898889,2898935,46,1,0,0,1
2898935,2899210,275,0,0,1,2
2898936,2899211,275,0,0,1,1
2899211,2899237,26,1,0,0,2
2899212,2899247,35,1,0,0,1
2899238,2900173,935,0,0,1,2
2899248,2900174,926,0,0,1,1
2900174,2900240,66,1,0,0,2
2900175,2900236,61,1,0,0,1
2900237,2900352,115,0,0,1,1
2900241,2900351,110,0,0,1,2
2900352,2900389,37,1,0,0,2
2900353,2900391,38,1,0,0,1
2900390,2900422,32,0,0,1,2
2900392,2900524,132,0,0,1,1
2900423,2900437,14,1,0,0,2
2900438,2900521,83,0,0,1,2
2900522,2900546,24,1,0,0,2
2900525,2900536,11,1,0,0,1
2900537,2902047,1510,0,0,1,1
2900547,2901664,1117,0,0,1,2
2901665,2901687,22,1,0,0,2
2901688,2902003,315,0,0,1,2
2902004,2902020,16,1,0,0,2
2902021,2902051,30,0,0,1,2
2902048,2902083,35,1,0,0,1
2902052,2902085,33,1,0,0,2
2902084,2902428,344,0,0,1,1
2902086,2902430,344,0,0,1,2
2902429,2902689,260,1,0,0,1
2902431,2902740,309,1,0,0,2
2902448,2902638,190,0,1,0,1
2902455,2902650,195,0,1,0,2
2902690,2904267,1577,0,0,1,1
2902741,2904266,1525,0,0,1,2
2904267,2904311,44,1,0,0,2
2904268,2904311,43,1,0,0,1
2904312,2905533,1221,0,0,1,1
2904312,2905534,1222,0,0,1,2
2905534,2905586,52,1,0,0,1
2905535,2905587,52,1,0,0,2
2905587,2905852,265,0,0,1,1
2905588,2905852,264,0,0,1,2
2905853,2905907,54,1,0,0,1
2905853,2905911,58,1,0,0,2
2905908,2906068,160,0,0,1,1
2905912,2906073,161,0,0,1,2
2906069,2906089,20,1,0,0,1
2906074,2906084,10,1,0,0,2
2906085,2907238,1153,0,0,1,2
2906090,2907239,1149,0,0,1,1
2907239,2907292,53,1,0,0,2
2907240,2907289,49,1,0,0,1
2907290,2907434,144,0,0,1,1
2907293,2907434,141,0,0,1,2
2907435,2907693,258,1,0,0,1
2907435,2907736,301,1,0,0,2
2907457,2907657,200,0,1,0,1
2907459,2907650,191,0,1,0,2
2907694,2908357,663,0,0,1,1
2907737,2908354,617,0,0,1,2
2908355,2908649,294,1,0,0,2
2908358,2908638,280,1,0,0,1
2908383,2908585,202,0,1,0,1
2908384,2908591,207,0,1,0,2
2908639,2909137,498,0,0,1,1
2908650,2908684,34,0,0,1,2
2908685,2908697,12,1,0,0,2
2908698,2909135,437,0,0,1,2
2909136,2909160,24,1,0,0,2
2909138,2909161,23,1,0,0,1
2909161,2909837,676,0,0,1,2
2909162,2909837,675,0,0,1,1
2909838,2909894,56,1,0,0,2
2909838,2909902,64,1,0,0,1
2909895,2910228,333,0,0,1,2
2909903,2910811,908,0,0,1,1
2910229,2910308,79,1,0,0,2
2910309,2910632,323,0,0,1,2
2910633,2910651,18,1,0,0,2
2910652,2910688,36,0,0,1,2
2910689,2910877,188,1,0,0,2
2910812,2910884,72,1,0,0,1
2910878,2910976,98,0,0,1,2
2910885,2910976,91,0,0,1,1
2910977,2911001,24,1,0,0,2
2910977,2911004,27,1,0,0,1
2911002,2911203,201,0,0,1,2
2911005,2911202,197,0,0,1,1
2911203,2911222,19,1,0,0,1
2911204,2911219,15,1,0,0,2
2911220,2912167,947,0,0,1,2
2911223,2912166,943,0,0,1,1
2912167,2912199,32,1,0,0,1
2912168,2912200,32,1,0,0,2
2912200,2912335,135,0,0,1,1
2912201,2912336,135,0,0,1,2
2912336,2912355,19,1,0,0,1
2912337,2912354,17,1,0,0,2
2912355,2912466,111,0,0,1,2
2912356,2912467,111,0,0,1,1
2912467,2912787,320,1,0,0,2
2912468,2912800,332,1,0,0,1
2912485,2912716,231,0,1,0,1
2912487,2912719,232,0,1,0,2
2912788,2914291,1503,0,0,1,2
2912801,2912912,111,0,0,1,1
2912913,2912921,8,1,0,0,1
2912922,2914292,1370,0,0,1,1
2914292,2914311,19,1,0,0,2
2914293,2914311,18,1,0,0,1
2914312,2914430,118,0,0,1,2
2914312,2914436,124,0,0,1,1
2914431,2914834,403,1,0,0,2
2914437,2914771,334,1,0,0,1
2914460,2914723,263,0,1,0,1
2914461,2914730,269,0,1,0,2
2914772,2915754,982,0,0,1,1
2914835,2915755,920,0,0,1,2
2915755,2915793,38,1,0,0,1
2915756,2915793,37,1,0,0,2
2915794,2917092,1298,0,0,1,1
2915794,2917094,1300,0,0,1,2
2917093,2917131,38,1,0,0,1
2917095,2917131,36,1,0,0,2
2917132,2917328,196,0,0,1,1
2917132,2917328,196,0,0,1,2
2917329,2917355,26,1,0,0,2
2917329,2917357,28,1,0,0,1
2917356,2917521,165,0,0,1,2
2917358,2917532,174,0,0,1,1
2917522,2918118,596,1,0,0,2
2917533,2918151,618,1,0,0,1
2917548,2918063,515,0,1,0,1
2917554,2918109,555,0,1,0,2
2918119,2918549,430,0,0,1,2
2918152,2918533,381,0,0,1,1
2918534,2919035,501,1,0,0,1
2918550,2919941,1391,1,0,0,2
2918568,2918947,379,0,1,0,1
2918571,2919196,625,0,1,0,2
2919036,2919073,37,0,0,1,1
2919074,2919091,17,1,0,0,1
2919092,2919203,111,0,0,1,1
2919204,2919225,21,1,0,0,1
2919226,2919421,195,0,0,1,1
2919422,2919470,48,1,0,0,1
2919471,2920141,670,0,0,1,1
2919942,2920029,87,0,0,1,2
2920030,2920752,722,1,0,0,2
2920142,2920204,62,1,0,0,1
2920205,2920260,55,0,0,1,1
2920261,2920286,25,1,0,0,1
2920287,2920321,34,0,0,1,1
2920322,2920504,182,1,0,0,1
2920505,2920525,20,0,0,1,1
2920526,2920585,59,1,0,0,1
2920586,2920632,46,0,0,1,1
2920633,2920675,42,1,0,0,1
2920676,2920802,126,0,0,1,1
2920753,2922203,1450,0,0,1,2
2920803,2920818,15,1,0,0,1
2920819,2922202,1383,0,0,1,1
2922203,2922240,37,1,0,0,1
2922204,2922263,59,1,0,0,2
2922241,2922479,238,0,0,1,1
2922264,2922482,218,0,0,1,2
2922480,2922936,456,1,0,0,1
2922483,2922965,482,1,0,0,2
2922511,2922881,370,0,1,0,1
2922514,2922885,371,0,1,0,2
2922937,2924369,1432,0,0,1,1
2922966,2923274,308,0,0,1,2
2923275,2923481,206,1,0,0,2
2923482,2924247,765,0,0,1,2
2924248,2924774,526,1,0,0,2
2924370,2924727,357,1,0,0,1
2924389,2924683,294,0,1,0,1
2924393,2924676,283,0,1,0,2
2924728,2925325,597,0,0,1,1
2924775,2925146,371,0,0,1,2
2925147,2925156,9,1,0,0,2
2925157,2925323,166,0,0,1,2
2925324,2925363,39,1,0,0,2
2925326,2925368,42,1,0,0,1
2925364,2925387,23,0,0,1,2
2925369,2925775,406,0,0,1,1
2925388,2925441,53,1,0,0,2
2925442,2925772,330,0,0,1,2
2925773,2925812,39,1,0,0,2
2925776,2925811,35,1,0,0,1
2925812,2926097,285,0,0,1,1
2925813,2926095,282,0,0,1,2
2926096,2926169,73,1,0,0,2
2926098,2926177,79,1,0,0,1
2926170,2926239,69,0,0,1,2
2926178,2926238,60,0,0,1,1
2926239,2926285,46,1,0,0,1
2926240,2926293,53,1,0,0,2
2926286,2926400,114,0,0,1,1
2926294,2926399,105,0,0,1,2
2926400,2926423,23,1,0,0,2
2926401,2926423,22,1,0,0,1
2926424,2926592,168,0,0,1,1
2926424,2926595,171,0,0,1,2
2926593,2926607,14,1,0,0,1
2926596,2926605,9,1,0,0,2
2926606,2928074,1468,0,0,1,2
2926608,2928079,1471,0,0,1,1
2928075,2928094,19,1,0,0,2
2928080,2928094,14,1,0,0,1
2928095,2928151,56,0,0,1,2
2928095,2928152,57,0,0,1,1
2928152,2928177,25,1,0,0,2
2928153,2928177,24,1,0,0,1
2928178,2928317,139,0,0,1,2
2928178,2928318,140,0,0,1,1
2928318,2928358,40,1,0,0,2
2928319,2928358,39,1,0,0,1
2928359,2928563,204,0,0,1,1
2928359,2928563,204,0,0,1,2
2928564,2928580,16,1,0,0,1
2928564,2928583,19,1,0,0,2
2928581,2928707,126,0,0,1,1
2928584,2928711,127,0,0,1,2
2928708,2929003,295,1,0,0,1
2928712,2929015,303,1,0,0,2
2928730,2928964,234,0,1,0,1
2928737,2928942,205,0,1,0,2
2929004,2929701,697,0,0,1,1
2929016,2929697,681,0,0,1,2
2929698,2929709,11,1,0,0,2
2929702,2929707,5,1,0,0,1
2929708,2930521,813,0,0,1,1
2929710,2930519,809,0,0,1,2
2930520,2930774,254,1,0,0,2
2930522,2930792,270,1,0,0,1
2930547,2930725,178,0,1,0,1
2930549,2930714,165,0,1,0,2
2930775,2931156,381,0,0,1,2
2930793,2931157,364,0,0,1,1
2931157,2931186,29,1,0,0,2
2931158,2931191,33,1,0,0,1
2931187,2931933,746,0,0,1,2
2931192,2931932,740,0,0,1,1
2931933,2932008,75,1,0,0,1
2931934,2932014,80,1,0,0,2
2932009,2932171,162,0,0,1,1
2932015,2932174,159,0,0,1,2
2932172,2932233,61,1,0,0,1
2932175,2932222,47,1,0,0,2
2932223,2932429,206,0,0,1,2
2932234,2932426,192,0,0,1,1
2932427,2932485,58,1,0,0,1
2932430,2932483,53,1,0,0,2
2932484,2932608,124,0,0,1,2
2932486,2932607,121,0,0,1,1
2932608,2932696,88,1,0,0,1
2932609,2932692,83,1,0,0,2
2932693,2932938,245,0,0,1,2
2932697,2932936,239,0,0,1,1
2932937,2933015,78,1,0,0,1
2932939,2932994,55,1,0,0,2
2932995,2933108,113,0,0,1,2
2933016,2933106,90,0,0,1,1
2933107,2933147,40,1,0,0,1
2933109,2933145,36,1,0,0,2
2933146,2933573,427,0,0,1,2
2933148,2933438,290,0,0,1,1
2933439,2933470,31,1,0,0,1
2933471,2934056,585,0,0,1,1
2933574,2933602,28,1,0,0,2
2933603,2933716,113,0,0,1,2
2933717,2933764,47,1,0,0,2
2933765,2933922,157,0,0,1,2
2933923,2933982,59,1,0,0,2
2933983,2934118,135,0,0,1,2
2934067,2935111,1044,0,1,0,1
2934119,2934132,13,1,0,0,2
2934133,2934369,236,0,0,1,2
2934370,2934404,34,1,0,0,2
2934405,2934713,308,0,0,1,2
2934714,2934739,25,1,0,0,2
2934740,2935001,261,0,0,1,2
2935002,2935106,104,1,0,0,2
2935107,2935144,37,0,0,1,2
2935121,2935122,1,1,0,0,1
2935123,2935145,22,0,0,1,1
2935145,2935172,27,1,0,0,2
2935146,2935174,28,1,0,0,1
2935173,2935315,142,0,0,1,2
2935175,2935315,140,0,0,1,1
2935316,2935334,18,1,0,0,2
2935316,2935335,19,1,0,0,1
2935335,2935598,263,0,0,1,2
2935336,2935839,503,0,0,1,1
2935599,2935614,15,1,0,0,2
2935615,2935837,222,0,0,1,2
2935838,2936126,288,1,0,0,2
2935840,2936117,277,1,0,0,1
2935866,2936085,219,0,1,0,1
2935872,2936074,202,0,1,0,2
2936118,2936408,290,0,0,1,1
2936127,2936322,195,0,0,1,2
2936323,2936336,13,1,0,0,2
2936337,2936409,72,0,0,1,2
2936409,2936418,9,1,0,0,1
2936410,2936429,19,1,0,0,2
2936419,2937222,803,0,0,1,1
2936430,2937200,770,0,0,1,2
2937201,2937296,95,1,0,0,2
2937223,2937271,48,1,0,0,1
2937272,2937887,615,0,0,1,1
2937297,2937885,588,0,0,1,2
2937886,2937936,50,1,0,0,2
2937888,2937925,37,1,0,0,1
2937926,2938946,1020,0,0,1,1
2937937,2938391,454,0,0,1,2
2938392,2938413,21,1,0,0,2
2938414,2938461,47,0,0,1,2
2938462,2938527,65,1,0,0,2
2938528,2938657,129,0,0,1,2
2938658,2938685,27,1,0,0,2
2938686,2938870,184,0,0,1,2
2938871,2944785,5914,1,0,0,2
2938947,2944753,5806,1,0,0,1
2938968,2943939,4971,0,1,0,1
2938974,2939104,130,0,1,0,2
2939153,2939158,5,0,1,0,2
2939181,2939183,2,0,1,0,2
2939212,2944776,5564,0,1,0,2
2943998,2944715,717,0,1,0,1
2944754,2944862,108,0,0,1,1
2944786,2944862,76,0,0,1,2
2944863,2944886,23,1,0,0,2
2944863,2944895,32,1,0,0,1
2944887,2946576,1689,0,0,1,2
2944896,2946574,1678,0,0,1,1
2946575,2946631,56,1,0,0,1
2946577,2946627,50,1,0,0,2
2946628,2946707,79,0,0,1,2
2946632,2946711,79,0,0,1,1
2946708,2950659,3951,1,0,0,2
2946712,2947124,412,1,0,0,1
2946741,2947310,569,0,1,0,2
2946742,2947028,286,0,1,0,1
2947049,2947067,18,0,1,0,1
2947125,2947154,29,0,0,1,1
2947155,2947165,10,1,0,0,1
2947166,2947720,554,0,0,1,1
2947721,2948250,529,1,0,0,1
2947744,2950611,2867,0,1,0,2
2947782,2948225,443,0,1,0,1
2948251,2948795,544,0,0,1,1
2948796,2948829,33,1,0,0,1
2948830,2949139,309,0,0,1,1
2949140,2949201,61,1,0,0,1
2949202,2949334,132,0,0,1,1
2949335,2949339,4,1,0,0,1
2949340,2949388,48,0,0,1,1
2949389,2949429,40,1,0,0,1
2949430,2949452,22,0,0,1,1
2949453,2949468,15,1,0,0,1
2949469,2949570,101,0,0,1,1
2949571,2949601,30,1,0,0,1
2949602,2949650,48,0,0,1,1
2949651,2949746,95,1,0,0,1
2949747,2949843,96,0,0,1,1
2949844,2949894,50,1,0,0,1
2949895,2949948,53,0,0,1,1
2949949,2949999,50,1,0,0,1
2950000,2950449,449,0,0,1,1
2950460,2950570,110,0,1,0,1
2950580,2950755,175,1,0,0,1
2950660,2950720,60,0,0,1,2
2950721,2950748,27,1,0,0,2
2950749,2950938,189,0,0,1,2
2950756,2952476,1720,0,0,1,1
2950939,2950943,4,1,0,0,2
2950944,2951086,142,0,0,1,2
2951087,2951096,9,1,0,0,2
2951097,2952477,1380,0,0,1,2
2952477,2952528,51,1,0,0,1
2952478,2952527,49,1,0,0,2
2952528,2952661,133,0,0,1,2
2952529,2952661,132,0,0,1,1
2952662,2953088,426,1,0,0,2
2952662,2953162,500,1,0,0,1
2952675,2953152,477,0,1,0,1
2952697,2953043,346,0,1,0,2
2953089,2953151,62,0,0,1,2
2953152,2953195,43,1,0,0,2
2953163,2953451,288,0,0,1,1
2953196,2953453,257,0,0,1,2
2953452,2953514,62,1,0,0,1
2953454,2953477,23,1,0,0,2
2953478,2953763,285,0,0,1,2
2953515,2953727,212,0,0,1,1
2953728,2953780,52,1,0,0,1
2953739,2953768,29,0,1,0,1
2953764,2953780,16,1,0,0,2
2953781,2953802,21,0,0,1,1
2953781,2954028,247,0,0,1,2
2953803,2953818,15,1,0,0,1
2953819,2953939,120,0,0,1,1
2953940,2953956,16,1,0,0,1
2953957,2954010,53,0,0,1,1
2954011,2954762,751,1,0,0,1
2954025,2954751,726,0,1,0,1
2954029,2955710,1681,1,0,0,2
2954058,2954657,599,0,1,0,2
2954700,2954775,75,0,1,0,2
2954763,2954902,139,0,0,1,1
2954903,2955326,423,1,0,0,1
2954921,2955599,678,0,1,0,2
2954945,2955315,370,0,1,0,1
2955327,2956396,1069,0,0,1,1
2955711,2955737,26,0,0,1,2
2955738,2955943,205,1,0,0,2
2955944,2955967,23,0,0,1,2
2955968,2956512,544,1,0,0,2
2956397,2956456,59,1,0,0,1
2956457,2956633,176,0,0,1,1
2956513,2956629,116,0,0,1,2
2956630,2956704,74,1,0,0,2
2956634,2956649,15,1,0,0,1
2956650,2957718,1068,0,0,1,1
2956705,2956785,80,0,0,1,2
2956786,2956869,83,1,0,0,2
2956870,2956911,41,0,0,1,2
2956912,2956920,8,1,0,0,2
2956921,2957154,233,0,0,1,2
2957155,2957444,289,1,0,0,2
2957445,2957633,188,0,0,1,2
2957634,2957759,125,1,0,0,2
2957719,2957755,36,1,0,0,1
2957756,2958027,271,0,0,1,1
2957760,2958011,251,0,0,1,2
2958012,2958456,444,1,0,0,2
2958028,2958338,310,1,0,0,1
2958041,2958338,297,0,1,0,2
2958043,2958294,251,0,1,0,1
2958339,2959021,682,0,0,1,1
2958457,2959022,565,0,0,1,2
2959022,2959046,24,1,0,0,1
2959023,2959046,23,1,0,0,2
2959047,2959367,320,0,0,1,2
2959047,2959372,325,0,0,1,1
2959368,2959993,625,1,0,0,2
2959373,2959708,335,1,0,0,1
2959420,2959727,307,0,1,0,2
2959427,2959673,246,0,1,0,1
2959709,2960203,494,0,0,1,1
2959994,2960203,209,0,0,1,2
2960204,2960224,20,1,0,0,1
2960204,2960239,35,1,0,0,2
2960225,2960654,429,0,0,1,1
2960240,2960655,415,0,0,1,2
2960655,2960685,30,1,0,0,1
2960656,2960688,32,1,0,0,2
2960686,2961132,446,0,0,1,1
2960689,2960987,298,0,0,1,2
2960988,2960992,4,1,0,0,2
2960993,2961131,138,0,0,1,2
2961132,2961192,60,1,0,0,2
2961133,2961199,66,1,0,0,1
2961193,2961297,104,0,0,1,2
2961200,2961297,97,0,0,1,1
2961298,2961330,32,1,0,0,1
2961298,2961333,35,1,0,0,2
2961331,2962867,1536,0,0,1,1
2961334,2961775,441,0,0,1,2
2961776,2961785,9,1,0,0,2
2961786,2962869,1083,0,0,1,2
2962868,2962904,36,1,0,0,1
2962870,2962907,37,1,0,0,2
2962905,2963248,343,0,0,1,1
2962908,2963246,338,0,0,1,2
2963247,2963535,288,1,0,0,2
2963249,2963495,246,1,0,0,1
2963268,2963454,186,0,1,0,1
2963272,2963458,186,0,1,0,2
2963496,2964391,895,0,0,1,1
2963536,2964388,852,0,0,1,2
2964389,2964683,294,1,0,0,2
2964392,2964652,260,1,0,0,1
2964415,2964600,185,0,1,0,1
2964418,2964610,192,0,1,0,2
2964653,2965416,763,0,0,1,1
2964684,2965417,733,0,0,1,2
2965417,2965473,56,1,0,0,1
2965418,2965466,48,1,0,0,2
2965467,2965937,470,0,0,1,2
2965474,2965936,462,0,0,1,1
2965937,2965975,38,1,0,0,1
2965938,2965975,37,1,0,0,2
2965976,2966695,719,0,0,1,1
2965976,2966695,719,0,0,1,2
2966696,2966724,28,1,0,0,1
2966696,2966746,50,1,0,0,2
2966725,2966927,202,0,0,1,1
2966747,2966928,181,0,0,1,2
2966928,2966953,25,1,0,0,1
2966929,2966953,24,1,0,0,2
2966954,2967161,207,0,0,1,2
2966954,2967165,211,0,0,1,1
2967162,2967207,45,1,0,0,2
2967166,2967202,36,1,0,0,1
2967203,2967372,169,0,0,1,1
2967208,2967372,164,0,0,1,2
3010878,3011205,327,0,0,1,1
3010878,3011206,328,0,0,1,2
3011206,3011271,65,1,0,0,1
3011207,3011266,59,1,0,0,2
3011267,3011400,133,0,0,1,2
3011272,3011399,127,0,0,1,1
3011400,3011421,21,1,0,0,1
3011401,3011419,18,1,0,0,2
3011420,3013159,1739,0,0,1,2
3011422,3013159,1737,0,0,1,1
3013160,3013195,35,1,0,0,2
3013160,3013197,37,1,0,0,1
3013196,3013382,186,0,0,1,2
3013198,3013384,186,0,0,1,1
3013383,3013449,66,1,0,0,2
3013385,3013460,75,1,0,0,1
3013450,3014758,1308,0,0,1,2
3013461,3013659,198,0,0,1,1
3013660,3013667,7,1,0,0,1
3013668,3014756,1088,0,0,1,1
3014757,3014804,47,1,0,0,1
3014759,3014806,47,1,0,0,2
3014805,3015152,347,0,0,1,1
3014807,3015151,344,0,0,1,2
3015152,3015214,62,1,0,0,2
3015153,3015219,66,1,0,0,1
3015215,3015351,136,0,0,1,2
3015220,3015351,131,0,0,1,1
3015352,3015374,22,1,0,0,2
3015352,3015381,29,1,0,0,1
3015375,3015423,48,0,0,1,2
3015382,3015600,218,0,0,1,1
3015424,3015434,10,1,0,0,2
3015435,3015502,67,0,0,1,2
3015503,3015545,42,1,0,0,2
3015546,3015602,56,0,0,1,2
3015601,3015630,29,1,0,0,1
3015603,3015737,134,1,0,0,2
3015631,3015701,70,0,0,1,1
3015702,3015721,19,1,0,0,1
3015722,3016548,826,0,0,1,1
3015738,3015776,38,0,0,1,2
3015777,3015830,53,1,0,0,2
3015831,3015949,118,0,0,1,2
3015950,3015992,42,1,0,0,2
3015993,3016094,101,0,0,1,2
3016095,3016168,73,1,0,0,2
3016169,3016255,86,0,0,1,2
3016256,3016475,219,1,0,0,2
3016476,3016507,31,0,0,1,2
3016508,3016911,403,1,0,0,2
3016549,3016842,293,1,0,0,1
3016562,3016843,281,0,1,0,2
3016579,3016816,237,0,1,0,1
3016843,3017021,178,0,0,1,1
3016912,3017021,109,0,0,1,2
3017022,3017085,63,1,0,0,1
3017022,3017089,67,1,0,0,2
3017086,3017186,100,0,0,1,1
3017090,3017187,97,0,0,1,2
3017187,3017224,37,1,0,0,1
3017188,3017232,44,1,0,0,2
3017225,3017361,136,0,0,1,1
3017233,3017364,131,0,0,1,2
3017362,3017379,17,1,0,0,1
3017365,3017380,15,1,0,0,2
3017380,3018381,1001,0,0,1,1
3017381,3018380,999,0,0,1,2
3018381,3018442,61,1,0,0,2
3018382,3018440,58,1,0,0,1
3018441,3018641,200,0,0,1,1
3018443,3018641,198,0,0,1,2
3018642,3018684,42,1,0,0,1
3018642,3018714,72,1,0,0,2
3018685,3018938,253,0,0,1,1
3018715,3018938,223,0,0,1,2
3018939,3019023,84,1,0,0,2
3018939,3019029,90,1,0,0,1
3019024,3019102,78,0,0,1,2
3019030,3019100,70,0,0,1,1
3019101,3019140,39,1,0,0,1
3019103,3019148,45,1,0,0,2
3019141,3019229,88,0,0,1,1
3019149,3019230,81,0,0,1,2
3019230,3019255,25,1,0,0,1
3019231,3019265,34,1,0,0,2
3019256,3019395,139,0,0,1,1
3019266,3019402,136,0,0,1,2
3019396,3019411,15,1,0,0,1
3019403,3019408,5,1,0,0,2
3019409,3020324,915,0,0,1,2
3019412,3020324,912,0,0,1,1
3020325,3020386,61,1,0,0,2
3020325,3020387,62,1,0,0,1
3020387,3020695,308,0,0,1,2
3020388,3020695,307,0,0,1,1
3020696,3020745,49,1,0,0,2
3020696,3020749,53,1,0,0,1
3020746,3021958,1212,0,0,1,2
3020750,3020939,189,0,0,1,1
3020940,3020958,18,1,0,0,1
3020959,3021958,999,0,0,1,1
3021959,3022003,44,1,0,0,1
3021959,3022006,47,1,0,0,2
3022004,3022391,387,0,0,1,1
3022007,3022392,385,0,0,1,2
3022392,3022450,58,1,0,0,1
3022393,3022500,107,1,0,0,2
3022451,3022591,140,0,0,1,1
3022501,3022586,85,0,0,1,2
3022587,3023595,1008,1,0,0,2
3022592,3022616,24,1,0,0,1
3022608,3023584,976,0,1,0,2
3022617,3022851,234,0,0,1,1
3022862,3022864,2,0,1,0,1
3022873,3022873,0,1,0,0,1
3022874,3022914,40,0,0,1,1
3022925,3022941,16,0,1,0,1
3022950,3022950,0,1,0,0,1
3022951,3023488,537,0,0,1,1
3023489,3023589,100,1,0,0,1
3023590,3023883,293,0,0,1,1
3023596,3023741,145,0,0,1,2
3023742,3023794,52,1,0,0,2
3023795,3023840,45,0,0,1,2
3023841,3023959,118,1,0,0,2
3023884,3023954,70,1,0,0,1
3023955,3024023,68,0,0,1,1
3023960,3024023,63,0,0,1,2
3024024,3024058,34,1,0,0,1
3024024,3024059,35,1,0,0,2
3024059,3024206,147,0,0,1,1
3024060,3024208,148,0,0,1,2
3024207,3024225,18,1,0,0,1
3024209,3024283,74,1,0,0,2
3024226,3025005,779,0,0,1,1
3024284,3025005,721,0,0,1,2
3025006,3025156,150,1,0,0,1
3025006,3025264,258,1,0,0,2
3025040,3025128,88,0,1,0,2
3025053,3025097,44,0,1,0,1
3025157,3025446,289,0,0,1,1
3025265,3025445,180,0,0,1,2
3025446,3025496,50,1,0,0,2
3025447,3025505,58,1,0,0,1
3025497,3025646,149,0,0,1,2
3025506,3025646,140,0,0,1,1
3025647,3025667,20,1,0,0,1
3025647,3025696,49,1,0,0,2
3025668,3026232,564,0,0,1,1
3025697,3025872,175,0,0,1,2
3025873,3025936,63,1,0,0,2
3025937,3026048,111,0,0,1,2
3026049,3026807,758,1,0,0,2
3026233,3026588,355,1,0,0,1
3026255,3026796,541,0,1,0,2
3026278,3026561,283,0,1,0,1
3026589,3026725,136,0,0,1,1
3026726,3026791,65,1,0,0,1
3026792,3026976,184,0,0,1,1
3026808,3026950,142,0,0,1,2
3026951,3027043,92,1,0,0,2
3026977,3027042,65,1,0,0,1
3027043,3027123,80,0,0,1,1
3027044,3027124,80,0,0,1,2
3027124,3027159,35,1,0,0,1
3027125,3027160,35,1,0,0,2
3027160,3027988,828,0,0,1,1
3027161,3027989,828,0,0,1,2
3027989,3028072,83,1,0,0,1
3027990,3028095,105,1,0,0,2
3028073,3028327,254,0,0,1,1
3028096,3028122,26,0,0,1,2
3028123,3028139,16,1,0,0,2
3028140,3028309,169,0,0,1,2
3028310,3028314,4,1,0,0,2
3028315,3028339,24,0,0,1,2
3028328,3028332,4,1,0,0,1
3028333,3028388,55,0,0,1,1
3028340,3028454,114,1,0,0,2
3028389,3028451,62,1,0,0,1
3028452,3028480,28,0,0,1,1
3028455,3028482,27,0,0,1,2
3028481,3028517,36,1,0,0,1
3028483,3028535,52,1,0,0,2
3028518,3028658,140,0,0,1,1
3028536,3028662,126,0,0,1,2
3028659,3028675,16,1,0,0,1
3028663,3028674,11,1,0,0,2
3028675,3029851,1176,0,0,1,2
3028676,3029853,1177,0,0,1,1
3029852,3029909,57,1,0,0,2
3029854,3029908,54,1,0,0,1
3029909,3029937,28,0,0,1,1
3029910,3029936,26,0,0,1,2
3029937,3029994,57,1,0,0,2
3029938,3029992,54,1,0,0,1
3029993,3030208,215,0,0,1,1
3029995,3030209,214,0,0,1,2
3030209,3030270,61,1,0,0,1
3030210,3030270,60,1,0,0,2
3030271,3030369,98,0,0,1,1
3030271,3030370,99,0,0,1,2
3030370,3030397,27,1,0,0,1
3030371,3030404,33,1,0,0,2
3030398,3030526,128,0,0,1,1
3030405,3030528,123,0,0,1,2
3030527,3030547,20,1,0,0,1
3030529,3030547,18,1,0,0,2
3030548,3031656,1108,0,0,1,1
3030548,3031656,1108,0,0,1,2
3031657,3031716,59,1,0,0,1
3031657,3031749,92,1,0,0,2
3031717,3031839,122,0,0,1,1
3031750,3031838,88,0,0,1,2
3031839,3031860,21,1,0,0,2
3031840,3031863,23,1,0,0,1
3031861,3032072,211,0,0,1,2
3031864,3032066,202,0,0,1,1
3032067,3032082,15,1,0,0,1
3032073,3032081,8,1,0,0,2
3032082,3032877,795,0,0,1,2
3032083,3032875,792,0,0,1,1
3032876,3032931,55,1,0,0,1
3032878,3032935,57,1,0,0,2
3032932,3033358,426,0,0,1,1
3032936,3033359,423,0,0,1,2
3033359,3033419,60,1,0,0,1
3033360,3033427,67,1,0,0,2
3033420,3033533,113,0,0,1,1
3033428,3033535,107,0,0,1,2
3033534,3033558,24,1,0,0,1
3033536,3033556,20,1,0,0,2
3033557,3034442,885,0,0,1,2
3033559,3034441,882,0,0,1,1
3034442,3034526,84,1,0,0,1
3034443,3034529,86,1,0,0,2
3034527,3034844,317,0,0,1,1
3034530,3034845,315,0,0,1,2
3034845,3034911,66,1,0,0,1
3034846,3034915,69,1,0,0,2
3034912,3035020,108,0,0,1,1
3034916,3035020,104,0,0,1,2
3035021,3035054,33,1,0,0,1
3035021,3035058,37,1,0,0,2
3035055,3035943,888,0,0,1,1
3035059,3035943,884,0,0,1,2
3035944,3036038,94,1,0,0,1
3035944,3036047,103,1,0,0,2
3036039,3036404,365,0,0,1,1
3036048,3036405,357,0,0,1,2
3036405,3036488,83,1,0,0,1
3036406,3036463,57,1,0,0,2
3036443,3036461,18,0,1,0,1
3036464,3036572,108,0,0,1,2
3036489,3036539,50,0,0,1,1
3036550,3037500,950,0,1,0,1
3036573,3036600,27,1,0,0,2
3036601,3036626,25,0,0,1,2
3036637,3036669,32,0,1,0,2
3036679,3037517,838,1,0,0,2
3036694,3037484,790,0,1,0,2
3037510,3037510,0,1,0,0,1
3037511,3037794,283,0,0,1,1
3037518,3037794,276,0,0,1,2
3037795,3037848,53,1,0,0,1
3037795,3037855,60,1,0,0,2
3037849,3038821,972,0,0,1,1
3037856,3038823,967,0,0,1,2
3038822,3038865,43,1,0,0,1
3038824,3038866,42,1,0,0,2
3038866,3039259,393,0,0,1,1
3038867,3039261,394,0,0,1,2
3039260,3039391,131,1,0,0,1
3039262,3039333,71,1,0,0,2
3039334,3039356,22,0,0,1,2
3039357,3039406,49,1,0,0,2
3039392,3039444,52,0,0,1,1
3039407,3039446,39,0,0,1,2
3039445,3040809,1364,1,0,0,1
3039447,3039537,90,1,0,0,2
3039462,3040774,1312,0,1,0,1
3039469,3039484,15,0,1,0,2
3039538,3039627,89,0,0,1,2
3039638,3040836,1198,0,1,0,2
3040810,3040923,113,0,0,1,1
3040846,3040996,150,1,0,0,2
3040924,3040966,42,1,0,0,1
3040967,3041083,116,0,0,1,1
3040997,3041084,87,0,0,1,2
3041084,3041109,25,1,0,0,1
3041085,3041114,29,1,0,0,2
3041110,3042452,1342,0,0,1,1
3041115,3042451,1336,0,0,1,2
3042452,3042535,83,1,0,0,2
3042453,3042534,81,1,0,0,1
3042535,3042675,140,0,0,1,1
3042536,3042673,137,0,0,1,2
3042674,3042715,41,1,0,0,2
3042676,3042695,19,1,0,0,1
3042696,3043659,963,0,0,1,1
3042716,3043529,813,0,0,1,2
3043530,3043711,181,1,0,0,2
3043660,3043701,41,1,0,0,1
3043702,3043877,175,0,0,1,1
3043712,3043879,167,0,0,1,2
3043878,3043943,65,1,0,0,1
3043880,3043956,76,1,0,0,2
3043944,3044045,101,0,0,1,1
3043957,3044047,90,0,0,1,2
3044046,3044072,26,1,0,0,1
3044048,3044074,26,1,0,0,2
3044073,3044252,179,0,0,1,1
3044075,3044567,492,0,0,1,2
3044253,3044277,24,1,0,0,1
3044278,3045194,916,0,0,1,1
3044568,3044605,37,1,0,0,2
3044606,3044664,58,0,0,1,2
3044665,3044911,246,1,0,0,2
3044912,3044983,71,0,0,1,2
3044984,3045120,136,1,0,0,2
3045121,3045174,53,0,0,1,2
3045175,3045203,28,1,0,0,2
3045195,3045248,53,1,0,0,1
3045204,3045364,160,0,0,1,2
3045249,3045363,114,0,0,1,1
3045364,3045466,102,1,0,0,1
3045365,3045557,192,1,0,0,2
3045467,3045510,43,0,0,1,1
3045511,3045556,45,1,0,0,1
3045557,3045605,48,0,0,1,1
3045558,3045606,48,0,0,1,2
3045606,3045639,33,1,0,0,1
3045607,3045642,35,1,0,0,2
3045640,3045765,125,0,0,1,1
3045643,3045765,122,0,0,1,2
3045766,3045786,20,1,0,0,1
3045766,3045786,20,1,0,0,2
3045787,3046635,848,0,0,1,1
3045787,3046636,849,0,0,1,2
3046636,3046735,99,1,0,0,1
3046637,3046734,97,1,0,0,2
3046735,3047036,301,0,0,1,2
3046736,3047033,297,0,0,1,1
3047034,3047087,53,1,0,0,1
3047037,3047089,52,1,0,0,2
3047088,3047319,231,0,0,1,1
3047090,3047323,233,0,0,1,2
3047320,3047332,12,1,0,0,1
3047324,3047332,8,1,0,0,2
3047333,3048565,1232,0,0,1,1
3047333,3048566,1233,0,0,1,2
3048566,3050123,1557,1,0,0,1
3048567,3050247,1680,1,0,0,2
3048638,3049475,837,0,1,0,1
3048654,3050225,1571,0,1,0,2
3049500,3050108,608,0,1,0,1
3050124,3050450,326,0,0,1,1
3050248,3050284,36,0,0,1,2
3050285,3050303,18,1,0,0,2
3050304,3050329,25,0,0,1,2
3050330,3050528,198,1,0,0,2
3050451,3050525,74,1,0,0,1
3050526,3050610,84,0,0,1,1
3050529,3050610,81,0,0,1,2
3050611,3050652,41,1,0,0,1
3050611,3050656,45,1,0,0,2
3050653,3050706,53,0,0,1,1
3050657,3050707,50,0,0,1,2
3050707,3050732,25,1,0,0,1
3050708,3050735,27,1,0,0,2
3050733,3051751,1018,0,0,1,1
3050736,3051751,1015,0,0,1,2
3051752,3051813,61,1,0,0,1
3051752,3051827,75,1,0,0,2
3051814,3052122,308,0,0,1,1
3051828,3052123,295,0,0,1,2
3052123,3052214,91,1,0,0,1
3052124,3052179,55,1,0,0,2
3052180,3052283,103,0,0,1,2
3052215,3052250,35,0,0,1,1
3052251,3053242,991,1,0,0,1
3052262,3052283,21,0,1,0,1
3052284,3052309,25,1,0,0,2
3052310,3053174,864,0,0,1,2
3052658,3052666,8,0,1,0,1
3052706,3053229,523,0,1,0,1
3053175,3053317,142,1,0,0,2
3053243,3053596,353,0,0,1,1
3053318,3053385,67,0,0,1,2
3053386,3053436,50,1,0,0,2
3053437,3053596,159,0,0,1,2
3053597,3053674,77,1,0,0,1
3053597,3053677,80,1,0,0,2
3053675,3053774,99,0,0,1,1
3053678,3053774,96,0,0,1,2
3053775,3053811,36,1,0,0,2
3053775,3053812,37,1,0,0,1
3053812,3053902,90,0,0,1,2
3053813,3053902,89,0,0,1,1
3053903,3053920,17,1,0,0,2
3053903,3053923,20,1,0,0,1
3053921,3054205,284,0,0,1,2
3053924,3054206,282,0,0,1,1
3054206,3054215,9,1,0,0,2
3054207,3054216,9,1,0,0,1
3054216,3054794,578,0,0,1,2
3054217,3054796,579,0,0,1,1
3054795,3054872,77,1,0,0,2
3054797,3054871,74,1,0,0,1
3054872,3055218,346,0,0,1,1
3054873,3055219,346,0,0,1,2
3055219,3055279,60,1,0,0,1
3055220,3055291,71,1,0,0,2
3055280,3055389,109,0,0,1,1
3055292,3055388,96,0,0,1,2
3055389,3055409,20,1,0,0,2
3055390,3055414,24,1,0,0,1
3055410,3055581,171,0,0,1,2
3055415,3055581,166,0,0,1,1
3055582,3055588,6,1,0,0,2
3055582,3055589,7,1,0,0,1
3055589,3056503,914,0,0,1,2
3055590,3056503,913,0,0,1,1
3056504,3056538,34,1,0,0,2
3056504,3056541,37,1,0,0,1
3056539,3056679,140,0,0,1,2
3056542,3056679,137,0,0,1,1
3056680,3056710,30,1,0,0,1
3056680,3056713,33,1,0,0,2
3056711,3056934,223,0,0,1,1
3056714,3056932,218,0,0,1,2
3056933,3056943,10,1,0,0,2
3056935,3056940,5,1,0,0,1
3056941,3057926,985,0,0,1,1
3056944,3057931,987,0,0,1,2
3057927,3058215,288,1,0,0,1
3057932,3058334,402,1,0,0,2
3057953,3058178,225,0,1,0,1
3057955,3058184,229,0,1,0,2
3058216,3058416,200,0,0,1,1
3058335,3058418,83,0,0,1,2
3058417,3059898,1481,1,0,0,1
3058419,3060060,1641,1,0,0,2
3058466,3059692,1226,0,1,0,2
3058472,3059694,1222,0,1,0,1
3059725,3059726,1,0,1,0,1
3059899,3060007,108,0,0,1,1
3060008,3060055,47,1,0,0,1
3060056,3061444,1388,0,0,1,1
3060061,3061444,1383,0,0,1,2
3061445,3061549,104,1,0,0,1
3061445,3066224,4779,1,0,0,2
3061503,3062507,1004,0,1,0,2
3061550,3061687,137,0,0,1,1
3061688,3061896,208,1,0,0,1
3061699,3061706,7,0,1,0,1
3061897,3061992,95,0,0,1,1
3062003,3062003,0,0,1,0,1
3062013,3066241,4228,1,0,0,1
3062025,3062557,532,0,1,0,1
3062532,3066178,3646,0,1,0,2
3062807,3066225,3418,0,1,0,1
3066225,3066303,78,0,0,1,2
3066242,3066303,61,0,0,1,1
3066304,3066330,26,1,0,0,1
3066304,3066337,33,1,0,0,2
3066331,3066523,192,0,0,1,1
3066338,3066519,181,0,0,1,2
3066520,3066537,17,1,0,0,2
3066524,3066528,4,1,0,0,1
3066529,3067110,581,0,0,1,1
3066538,3067130,592,0,0,1,2
3067111,3067393,282,1,0,0,1
3067131,3067424,293,1,0,0,2
3067151,3067354,203,0,1,0,1
3067162,3067370,208,0,1,0,2
3067394,3067901,507,0,0,1,1
3067425,3067900,475,0,0,1,2
3067901,3068007,106,1,0,0,2
3067902,3067993,91,1,0,0,1
3067994,3068087,93,0,0,1,1
3068008,3068087,79,0,0,1,2
3068088,3068128,40,1,0,0,1
3068088,3068193,105,1,0,0,2
3068129,3068304,175,0,0,1,1
3068194,3068311,117,0,0,1,2
3068305,3068324,19,1,0,0,1
3068312,3068361,49,1,0,0,2
3068325,3068647,322,0,0,1,1
3068362,3068449,87,0,0,1,2
3068450,3068464,14,1,0,0,2
3068465,3068630,165,0,0,1,2
3068631,3068681,50,1,0,0,2
3068648,3068665,17,1,0,0,1
3068666,3069584,918,0,0,1,1
3068682,3069184,502,0,0,1,2
3069185,3069229,44,1,0,0,2
3069230,3069385,155,0,0,1,2
3069386,3069682,296,1,0,0,2
3069585,3069681,96,1,0,0,1
3069682,3069758,76,0,0,1,1
3069683,3069760,77,0,0,1,2
3069759,3069799,40,1,0,0,1
3069761,3069798,37,1,0,0,2
3069799,3069909,110,0,0,1,2
3069800,3069908,108,0,0,1,1
3069909,3069929,20,1,0,0,1
3069910,3069932,22,1,0,0,2
3069930,3071180,1250,0,0,1,1
3069933,3071181,1248,0,0,1,2
3071181,3071255,74,1,0,0,1
3071182,3071261,79,1,0,0,2
3071256,3071316,60,0,0,1,1
3071262,3071318,56,0,0,1,2
3071317,3071354,37,1,0,0,1
3071319,3071354,35,1,0,0,2
3071355,3071409,54,0,0,1,1
3071355,3071411,56,0,0,1,2
3071410,3071440,30,1,0,0,1
3071412,3071454,42,1,0,0,2
3071441,3071607,166,0,0,1,1
3071455,3071607,152,0,0,1,2
3071608,3071620,12,1,0,0,2
3071608,3071623,15,1,0,0,1
3071621,3072419,798,0,0,1,2
3071624,3072421,797,0,0,1,1
3072420,3072758,338,1,0,0,2
3072422,3072708,286,1,0,0,1
3072445,3072675,230,0,1,0,1
3072446,3072689,243,0,1,0,2
3072709,3072878,169,0,0,1,1
3072759,3072877,118,0,0,1,2
3072878,3072935,57,1,0,0,2
3072879,3072939,60,1,0,0,1
3072936,3074103,1167,0,0,1,2
3072940,3073155,215,0,0,1,1
3073156,3073161,5,1,0,0,1
3073162,3074101,939,0,0,1,1
3074102,3074126,24,1,0,0,1
3074104,3074125,21,1,0,0,2
3074126,3074429,303,0,0,1,2
3074127,3074428,301,0,0,1,1
3074429,3074482,53,1,0,0,1
3074430,3074485,55,1,0,0,2
3074483,3074580,97,0,0,1,1
3074486,3074580,94,0,0,1,2
3074581,3074603,22,1,0,0,1
3074581,3074608,27,1,0,0,2
3074604,3074752,148,0,0,1,1
3074609,3074747,138,0,0,1,2
3074748,3074764,16,1,0,0,2
3074753,3074764,11,1,0,0,1
3074765,3075870,1105,0,0,1,1
3074765,3075872,1107,0,0,1,2
3075871,3075970,99,1,0,0,1
3075873,3075975,102,1,0,0,2
3075971,3076060,89,0,0,1,1
3075976,3076061,85,0,0,1,2
3076061,3076092,31,1,0,0,1
3076062,3076102,40,1,0,0,2
3076093,3076290,197,0,0,1,1
3076103,3077191,1088,0,0,1,2
3076291,3076295,4,1,0,0,1
3076296,3077192,896,0,0,1,1
3077192,3077217,25,1,0,0,2
3077193,3077218,25,1,0,0,1
3077218,3077509,291,0,0,1,2
3077219,3077513,294,0,0,1,1
3077510,3077576,66,1,0,0,2
3077514,3077577,63,1,0,0,1
3077577,3077673,96,0,0,1,2
3077578,3077673,95,0,0,1,1
3077674,3077705,31,1,0,0,1
3077674,3077719,45,1,0,0,2
3077706,3078675,969,0,0,1,1
3077720,3078675,955,0,0,1,2
3078676,3078713,37,1,0,0,1
3078676,3078715,39,1,0,0,2
3078714,3079067,353,0,0,1,1
3078716,3079067,351,0,0,1,2
3079068,3079145,77,1,0,0,1
3079068,3080706,1638,1,0,0,2
3079146,3079240,94,0,0,1,1
3079156,3079272,116,0,1,0,2
3079241,3080681,1440,1,0,0,1
3079263,3080655,1392,0,1,0,1
3079319,3080665,1346,0,1,0,2
3080682,3080767,85,0,0,1,1
3080707,3080767,60,0,0,1,2
3080768,3080800,32,1,0,0,1
3080768,3080802,34,1,0,0,2
3080801,3081300,499,0,0,1,1
3080803,3081279,476,0,0,1,2
3081280,3081585,305,1,0,0,2
3081301,3081529,228,1,0,0,1
3081319,3081512,193,0,1,0,2
3081328,3081486,158,0,1,0,1
3081530,3082033,503,0,0,1,1
3081586,3082033,447,0,0,1,2
3082034,3082077,43,1,0,0,1
3082034,3082079,45,1,0,0,2
3082078,3082331,253,0,0,1,1
3082080,3082332,252,0,0,1,2
3082332,3082414,82,1,0,0,1
3082333,3082417,84,1,0,0,2
3082415,3082520,105,0,0,1,1
3082418,3082522,104,0,0,1,2
3082521,3082548,27,1,0,0,1
3082523,3082552,29,1,0,0,2
3082549,3083853,1304,0,0,1,1
3082553,3083853,1300,0,0,1,2
3083854,3083932,78,1,0,0,1
3083854,3083944,90,1,0,0,2
3083933,3084058,125,0,0,1,1
3083945,3084059,114,0,0,1,2
3084059,3084084,25,1,0,0,1
3084060,3084093,33,1,0,0,2
3084085,3084984,899,0,0,1,1
3084094,3084979,885,0,0,1,2
3084980,3085050,70,1,0,0,2
3084985,3085037,52,1,0,0,1
3085038,3085372,334,0,0,1,1
3085051,3085374,323,0,0,1,2
3085373,3085433,60,1,0,0,1
3085375,3085471,96,1,0,0,2
3085434,3085923,489,0,0,1,1
3085472,3086820,1348,0,0,1,2
3085924,3085976,52,1,0,0,1
3085977,3086049,72,0,0,1,1
3086050,3086134,84,1,0,0,1
3086135,3086156,21,0,0,1,1
3086157,3086169,12,1,0,0,1
3086170,3086271,101,0,0,1,1
3086272,3086324,52,1,0,0,1
3086325,3086371,46,0,0,1,1
3086372,3086484,112,1,0,0,1
3086485,3086748,263,0,0,1,1
3086749,3086765,16,1,0,0,1
3086766,3086817,51,0,0,1,1
3086818,3086912,94,1,0,0,1
3086821,3086916,95,1,0,0,2
3086913,3086941,28,0,0,1,1
3086917,3086941,24,0,0,1,2
3086942,3086983,41,1,0,0,1
3086942,3086985,43,1,0,0,2
3086984,3087050,66,0,0,1,1
3086986,3087049,63,0,0,1,2
3087050,3087087,37,1,0,0,2
3087051,3087085,34,1,0,0,1
3087086,3088014,928,0,0,1,1
3087088,3087773,685,0,0,1,2
3087774,3087796,22,1,0,0,2
3087797,3088014,217,0,0,1,2
3088015,3088080,65,1,0,0,1
3088015,3088081,66,1,0,0,2
3088081,3088392,311,0,0,1,1
3088082,3088392,310,0,0,1,2
3088393,3088454,61,1,0,0,1
3088393,3088461,68,1,0,0,2
3088455,3089562,1107,0,0,1,1
3088462,3088892,430,0,0,1,2
3088893,3089307,414,1,0,0,2
3089308,3089353,45,0,0,1,2
3089354,3089617,263,1,0,0,2
3089563,3089617,54,1,0,0,1
3089618,3090075,457,0,0,1,1
3089618,3090075,457,0,0,1,2
3090076,3090143,67,1,0,0,1
3090076,3090155,79,1,0,0,2
3090144,3090189,45,0,0,1,1
3090156,3090189,33,0,0,1,2
3090190,3090226,36,1,0,0,1
3090190,3090253,63,1,0,0,2
3090227,3090447,220,0,0,1,1
3090254,3090287,33,0,0,1,2
3090288,3090321,33,1,0,0,2
3090322,3090444,122,0,0,1,2
3090445,3090461,16,1,0,0,2
3090448,3090459,11,1,0,0,1
3090460,3090531,71,0,0,1,1
3090462,3090538,76,0,0,1,2
3090532,3090792,260,1,0,0,1
3090539,3090859,320,1,0,0,2
3090559,3090724,165,0,1,0,1
3090561,3090742,181,0,1,0,2
3090793,3092469,1676,0,0,1,1
3090860,3091568,708,0,0,1,2
3091569,3091594,25,1,0,0,2
3091595,3091790,195,0,0,1,2
3091791,3091842,51,1,0,0,2
3091843,3092026,183,0,0,1,2
3092027,3092031,4,1,0,0,2
3092032,3092101,69,0,0,1,2
3092102,3092124,22,1,0,0,2
3092125,3092177,52,0,0,1,2
3092178,3092198,20,1,0,0,2
3092199,3092269,70,0,0,1,2
3092270,3092287,17,1,0,0,2
3092288,3092465,177,0,0,1,2
3092466,3092508,42,1,0,0,2
3092470,3092511,41,1,0,0,1
3092509,3092891,382,0,0,1,2
3092512,3092893,381,0,0,1,1
3092892,3092908,16,1,0,0,2
3092894,3092905,11,1,0,0,1
3092906,3094538,1632,0,0,1,1
3092909,3094540,1631,0,0,1,2
3094539,3094596,57,1,0,0,1
3094541,3094599,58,1,0,0,2
3094597,3094693,96,0,0,1,1
3094600,3094689,89,0,0,1,2
3094690,3095270,580,1,0,0,2
3094694,3095016,322,1,0,0,1
3094711,3094971,260,0,1,0,1
3094712,3095046,334,0,1,0,2
3095017,3095367,350,0,0,1,1
3095271,3095367,96,0,0,1,2
3095368,3095408,40,1,0,0,1
3095368,3095430,62,1,0,0,2
3095409,3095978,569,0,0,1,1
3095431,3095980,549,0,0,1,2
3095979,3096047,68,1,0,0,1
3095981,3096047,66,1,0,0,2
3096048,3096144,96,0,0,1,2
3096048,3096146,98,0,0,1,1
3096145,3096184,39,1,0,0,2
3096147,3096174,27,1,0,0,1
3096175,3097409,1234,0,0,1,1
3096185,3097409,1224,0,0,1,2
3097410,3097451,41,1,0,0,1
3097410,3097453,43,1,0,0,2
3097452,3097823,371,0,0,1,1
3097454,3097825,371,0,0,1,2
3097824,3097842,18,1,0,0,1
3097826,3097836,10,1,0,0,2
3097837,3097938,101,0,0,1,2
3097843,3097938,95,0,0,1,1
3097939,3098219,280,1,0,0,1
3097939,3098250,311,1,0,0,2
3097962,3098165,203,0,1,0,1
3097962,3098169,207,0,1,0,2
3098220,3099629,1409,0,0,1,1
3098251,3099636,1385,0,0,1,2
3099630,3099648,18,1,0,0,1
3099637,3099658,21,1,0,0,2
3099649,3099893,244,0,0,1,1
3099659,3099892,233,0,0,1,2
3099893,3099935,42,1,0,0,2
3099894,3099936,42,1,0,0,1
3099936,3100523,587,0,0,1,2
3099937,3100525,588,0,0,1,1
3100524,3100575,51,1,0,0,2
3100526,3100575,49,1,0,0,1
3100576,3101070,494,0,0,1,1
3100576,3101073,497,0,0,1,2
3101071,3101125,54,1,0,0,1
3101074,3101143,69,1,0,0,2
3101126,3101296,170,0,0,1,1
3101144,3101220,76,0,0,1,2
3101231,3101452,221,0,1,0,2
3101297,3101310,13,1,0,0,1
3101311,3101437,126,0,0,1,1
3101438,3101477,39,1,0,0,1
3101462,3102144,682,1,0,0,2
3101478,3102074,596,0,0,1,1
3101824,3102087,263,0,1,0,2
3102075,3102124,49,1,0,0,1
3102125,3102156,31,0,0,1,1
3102145,3102251,106,0,0,1,2
3102157,3102174,17,1,0,0,1
3102175,3102247,72,0,0,1,1
3102248,3102299,51,1,0,0,1
3102252,3102276,24,1,0,0,2
3102277,3102772,495,0,0,1,2
3102300,3102368,68,0,0,1,1
3102369,3102405,36,1,0,0,1
3102406,3102491,85,0,0,1,1
3102492,3102543,51,1,0,0,1
3102544,3102564,20,0,0,1,1
3102565,3102660,95,1,0,0,1
3102661,3102790,129,0,0,1,1
3102773,3103214,441,1,0,0,2
3102791,3103211,420,1,0,0,1
3102828,3103200,372,0,1,0,1
3102853,3103064,211,0,1,0,2
3103212,3103259,47,0,0,1,1
3103215,3103516,301,0,0,1,2
3103260,3103331,71,1,0,0,1
3103332,3103398,66,0,0,1,1
3103399,3103504,105,1,0,0,1
3103412,3103495,83,0,1,0,1
3103505,3103577,72,0,0,1,1
3103517,3103532,15,1,0,0,2
3103533,3103574,41,0,0,1,2
3103575,3104823,1248,1,0,0,2
3103578,3104411,833,1,0,0,1
3103598,3104400,802,0,1,0,1
3103612,3104401,789,0,1,0,2
3104412,3104641,229,0,0,1,1
3104642,3104673,31,1,0,0,1
3104674,3104773,99,0,0,1,1
3104774,3104815,41,1,0,0,1
3104816,3105115,299,0,0,1,1
3104824,3104921,97,0,0,1,2
3104922,3105024,102,1,0,0,2
3105025,3105145,120,0,0,1,2
3105116,3105483,367,1,0,0,1
3105156,3105428,272,0,1,0,2
3105158,3105425,267,0,1,0,1
3105438,3105490,52,1,0,0,2
3105484,3105548,64,0,0,1,1
3105491,3105550,59,0,0,1,2
3105549,3105583,34,1,0,0,1
3105551,3105581,30,1,0,0,2
3105582,3105687,105,0,0,1,2
3105584,3105684,100,0,0,1,1
3105685,3105708,23,1,0,0,1
3105688,3105710,22,1,0,0,2
3105709,3105899,190,0,0,1,1
3105711,3106635,924,0,0,1,2
3105900,3105915,15,1,0,0,1
3105916,3106634,718,0,0,1,1
3106635,3106673,38,1,0,0,1
3106636,3106675,39,1,0,0,2
3106674,3107553,879,0,0,1,1
3106676,3107553,877,0,0,1,2
3107554,3107779,225,1,0,0,1
3107554,3107816,262,1,0,0,2
3107578,3107761,183,0,1,0,1
3107579,3107767,188,0,1,0,2
3107780,3108106,326,0,0,1,1
3107817,3108101,284,0,0,1,2
3108102,3108117,15,1,0,0,2
3108107,3108113,6,1,0,0,1
3108114,3108966,852,0,0,1,1
3108118,3108966,848,0,0,1,2
3108967,3108989,22,1,0,0,1
3108967,3108989,22,1,0,0,2
3108990,3109936,946,0,0,1,2
3108990,3109937,947,0,0,1,1
3109937,3109967,30,1,0,0,2
3109938,3109970,32,1,0,0,1
3109968,3110018,50,0,0,1,2
3109971,3110019,48,0,0,1,1
3110019,3110070,51,1,0,0,2
3110020,3110070,50,1,0,0,1
3110071,3110200,129,0,0,1,1
3110071,3110200,129,0,0,1,2
3110201,3110218,17,1,0,0,2
3110201,3110219,18,1,0,0,1
3110219,3110593,374,0,0,1,2
3110220,3110605,385,0,0,1,1
3110594,3110834,240,1,0,0,2
3110606,3110834,228,1,0,0,1
3110629,3110782,153,0,1,0,1
3110640,3110769,129,0,1,0,2
3110835,3111485,650,0,0,1,2
3110835,3111486,651,0,0,1,1
3111486,3111527,41,1,0,0,2
3111487,3111526,39,1,0,0,1
3111527,3111775,248,0,0,1,1
3111528,3111776,248,0,0,1,2
3111776,3111796,20,1,0,0,1
3111777,3111793,16,1,0,0,2
3111794,3111861,67,0,0,1,2
3111797,3111867,70,0,0,1,1
3111862,3112221,359,1,0,0,2
3111868,3112177,309,1,0,0,1
3111887,3112128,241,0,1,0,1
3111891,3112149,258,0,1,0,2
3112178,3113612,1434,0,0,1,1
3112222,3113615,1393,0,0,1,2
3113613,3113634,21,1,0,0,1
3113616,3113634,18,1,0,0,2
3113635,3114182,547,0,0,1,1
3113635,3114184,549,0,0,1,2
3114183,3114212,29,1,0,0,1
3114185,3114209,24,1,0,0,2
3114210,3115275,1065,0,0,1,2
3114213,3115275,1062,0,0,1,1
3115276,3115326,50,1,0,0,1
3115276,3115333,57,1,0,0,2
3115327,3115449,122,0,0,1,1
3115334,3115451,117,0,0,1,2
3115450,3115474,24,1,0,0,1
3115452,3115485,33,1,0,0,2
3115475,3116538,1063,0,0,1,1
3115486,3115696,210,0,0,1,2
3115697,3115707,10,1,0,0,2
3115708,3116539,831,0,0,1,2
3116539,3116591,52,1,0,0,1
3116540,3116586,46,1,0,0,2
3116587,3116718,131,0,0,1,2
3116592,3116727,135,0,0,1,1
3116719,3117224,505,1,0,0,2
3116728,3117073,345,1,0,0,1
3116747,3117019,272,0,1,0,1
3116748,3117027,279,0,1,0,2
3117074,3117345,271,0,0,1,1
3117225,3117285,60,0,0,1,2
3117286,3118315,1029,1,0,0,2
3117346,3117809,463,1,0,0,1
3117365,3117747,382,0,1,0,1
3117368,3118111,743,0,1,0,2
3117810,3117831,21,0,0,1,1
3117832,3117857,25,1,0,0,1
3117858,3118015,157,0,0,1,1
3118016,3118036,20,1,0,0,1
3118037,3118767,730,0,0,1,1
3118316,3118764,448,0,0,1,2
3118765,3118788,23,1,0,0,2
3118768,3118790,22,1,0,0,1
3118789,3118843,54,0,0,1,2
3118791,3118861,70,0,0,1,1
3118844,3119461,617,1,0,0,2
3118862,3119154,292,1,0,0,1
3118875,3119247,372,0,1,0,2
3118880,3119132,252,0,1,0,1
3119155,3119748,593,0,0,1,1
3119462,3119567,105,0,0,1,2
3119568,3119716,148,1,0,0,2
3119717,3119748,31,0,0,1,2
3119749,3119805,56,1,0,0,1
3119749,3125564,5815,1,0,0,2
3119792,3125537,5745,0,1,0,2
3119806,3119890,84,0,0,1,1
3119891,3119896,5,1,0,0,1
3119897,3119935,38,0,0,1,1
3119936,3119960,24,1,0,0,1
3119961,3120643,682,0,0,1,1
3120654,3120761,107,0,1,0,1
3120770,3120770,0,1,0,0,1
3120771,3121073,302,0,0,1,1
3121084,3122479,1395,0,1,0,1
3122489,3122510,21,1,0,0,1
3122511,3122692,181,0,0,1,1
3122693,3122720,27,1,0,0,1
3122721,3122820,99,0,0,1,1
3122831,3123259,428,0,1,0,1
3123269,3123317,48,1,0,0,1
3123318,3123778,460,0,0,1,1
3123779,3123817,38,1,0,0,1
3123818,3124117,299,0,0,1,1
3124118,3124128,10,1,0,0,1
3124129,3124166,37,0,0,1,1
3124167,3124339,172,1,0,0,1
3124340,3124449,109,0,0,1,1
3124460,3125530,1070,0,1,0,1
3125540,3125557,17,1,0,0,1
3125558,3125678,120,0,0,1,1
3125565,3125676,111,0,0,1,2
3125677,3125776,99,1,0,0,2
3125679,3125746,67,1,0,0,1
3125747,3125840,93,0,0,1,1
3125777,3125815,38,0,0,1,2
3125816,3131067,5251,1,0,0,2
3125841,3125890,49,1,0,0,1
3125865,3125970,105,0,1,0,2
3125891,3125948,57,0,0,1,1
3125949,3125970,21,1,0,0,1
3125971,3126168,197,0,0,1,1
3126131,3131057,4926,0,1,0,2
3126169,3126185,16,1,0,0,1
3126186,3126535,349,0,0,1,1
3126536,3126558,22,1,0,0,1
3126559,3127010,451,0,0,1,1
3127021,3127043,22,0,1,0,1
3127053,3127119,66,1,0,0,1
3127067,3127110,43,0,1,0,1
3127120,3127412,292,0,0,1,1
3127413,3127476,63,1,0,0,1
3127477,3127685,208,0,0,1,1
3127686,3128182,496,1,0,0,1
3127721,3127982,261,0,1,0,1
3128007,3128120,113,0,1,0,1
3128150,3128167,17,0,1,0,1
3128183,3128755,572,0,0,1,1
3128756,3128778,22,1,0,0,1
3128779,3128874,95,0,0,1,1
3128885,3130412,1527,0,1,0,1
3130422,3131047,625,1,0,0,1
3130454,3131036,582,0,1,0,1
3131048,3131140,92,0,0,1,1
3131068,3131142,74,0,0,1,2
3131141,3131168,27,1,0,0,1
3131143,3131172,29,1,0,0,2
3131169,3132996,1827,0,0,1,1
3131173,3132998,1825,0,0,1,2
3132997,3133035,38,1,0,0,1
3132999,3133038,39,1,0,0,2
3133036,3133217,181,0,0,1,1
3133039,3133200,161,0,0,1,2
3133201,3133597,396,1,0,0,2
3133218,3133501,283,1,0,0,1
3133236,3133488,252,0,1,0,1
3133239,3133506,267,0,1,0,2
3133502,3133966,464,0,0,1,1
3133598,3133949,351,0,0,1,2
3133950,3134341,391,1,0,0,2
3133967,3134235,268,1,0,0,1
3133984,3134248,264,0,1,0,2
3133985,3134211,226,0,1,0,1
3134236,3135079,843,0,0,1,1
3134342,3135079,737,0,0,1,2
3135080,3135101,21,1,0,0,1
3135080,3135103,23,1,0,0,2
3135102,3135218,116,0,0,1,1
3135104,3135206,102,0,0,1,2
3135207,3135841,634,1,0,0,2
3135219,3135530,311,1,0,0,1
3135236,3135626,390,0,1,0,2
3135239,3135502,263,0,1,0,1
3135531,3136899,1368,0,0,1,1
3135842,3136579,737,0,0,1,2
3136580,3136589,9,1,0,0,2
3136590,3136899,309,0,0,1,2
3136900,3136979,79,1,0,0,2
3136900,3139459,2559,1,0,0,1
3136940,3139098,2158,0,1,0,1
3136947,3136949,2,0,1,0,2
3136980,3137093,113,0,0,1,2
3137094,3138893,1799,1,0,0,2
3137474,3138843,1369,0,1,0,2
3138894,3138989,95,0,0,1,2
3138990,3139027,37,1,0,0,2
3139028,3139115,87,0,0,1,2
3139116,3139994,878,1,0,0,2
3139125,3139449,324,0,1,0,1
3139150,3139918,768,0,1,0,2
3139460,3139495,35,0,0,1,1
3139496,3139719,223,1,0,0,1
3139508,3139710,202,0,1,0,1
3139720,3139826,106,0,0,1,1
3139827,3139838,11,1,0,0,1
3139839,3140130,291,0,0,1,1
3139995,3140214,219,0,0,1,2
3140131,3141825,1694,1,0,0,1
3140215,3142873,2658,1,0,0,2
3140232,3141689,1457,0,1,0,1
3140240,3142834,2594,0,1,0,2
3141826,3142565,739,0,0,1,1
3142576,3142731,155,0,1,0,1
3142741,3142799,58,1,0,0,1
3142800,3142930,130,0,0,1,1
3142874,3142931,57,0,0,1,2
3142931,3142960,29,1,0,0,1
3142932,3142963,31,1,0,0,2
3142961,3143114,153,0,0,1,1
3142964,3143115,151,0,0,1,2
3143115,3143124,9,1,0,0,1
3143116,3143125,9,1,0,0,2
3143125,3144544,1419,0,0,1,1
3143126,3143582,456,0,0,1,2
3143583,3144640,1057,1,0,0,2
3144545,3144600,55,1,0,0,1
3144601,3144749,148,0,0,1,1
3144641,3144754,113,0,0,1,2
3144750,3144767,17,1,0,0,1
3144755,3144760,5,1,0,0,2
3144761,3144995,234,0,0,1,2
3144768,3145013,245,0,0,1,1
3144996,3145315,319,1,0,0,2
3145014,3145242,228,1,0,0,1
3145035,3145244,209,0,1,0,2
3145038,3145212,174,0,1,0,1
3145243,3145561,318,0,0,1,1
3145316,3145562,246,0,0,1,2
3145562,3145589,27,1,0,0,1
3145563,3145583,20,1,0,0,2
3145584,3146187,603,0,0,1,2
3145590,3146177,587,0,0,1,1
3146178,3146188,10,1,0,0,1
3146188,3146200,12,1,0,0,2
3146189,3146706,517,0,0,1,1
3146201,3146710,509,0,0,1,2
3146707,3146953,246,1,0,0,1
3146711,3147027,316,1,0,0,2
3146728,3146909,181,0,1,0,1
3146730,3146948,218,0,1,0,2
3146954,3147060,106,0,0,1,1
3147028,3147060,32,0,0,1,2
3147061,3147107,46,1,0,0,2
3147061,3147109,48,1,0,0,1
3147108,3147302,194,0,0,1,2
3147110,3147302,192,0,0,1,1
3147303,3147333,30,1,0,0,1
3147303,3147357,54,1,0,0,2
3147334,3147668,334,0,0,1,1
3147358,3147392,34,0,0,1,2
3147393,3147413,20,1,0,0,2
3147414,3147495,81,0,0,1,2
3147496,3147579,83,1,0,0,2
3147580,3147668,88,0,0,1,2
3147669,3147694,25,1,0,0,1
3147669,3147948,279,1,0,0,2
3147695,3148358,663,0,0,1,1
3147949,3148342,393,0,0,1,2
3148343,3148427,84,1,0,0,2
3148359,3148409,50,1,0,0,1
3148410,3148517,107,0,0,1,1
3148428,3148517,89,0,0,1,2
3148518,3148550,32,1,0,0,1
3148518,3148552,34,1,0,0,2
3148551,3148825,274,0,0,1,1
3148553,3150014,1461,0,0,1,2
3148826,3148830,4,1,0,0,1
3148831,3150012,1181,0,0,1,1
3150013,3150048,35,1,0,0,1
3150015,3150048,33,1,0,0,2
3150049,3150251,202,0,0,1,1
3150049,3150251,202,0,0,1,2
3150252,3150270,18,1,0,0,2
3150252,3150271,19,1,0,0,1
3150271,3150339,68,0,0,1,2
3150272,3150348,76,0,0,1,1
3150340,3150712,372,1,0,0,2
3150349,3150632,283,1,0,0,1
3150370,3150584,214,0,1,0,1
3150372,3150606,234,0,1,0,2
3150633,3151351,718,0,0,1,1
3150713,3151346,633,0,0,1,2
3151347,3151684,337,1,0,0,2
3151352,3151603,251,1,0,0,1
3151377,3151575,198,0,1,0,1
3151379,3151584,205,0,1,0,2
3151604,3152266,662,0,0,1,1
3151685,3152255,570,0,0,1,2
3152256,3152879,623,1,0,0,2
3152267,3152566,299,1,0,0,1
3152291,3152582,291,0,1,0,2
3152292,3152537,245,0,1,0,1
3152567,3152843,276,0,0,1,1
3152844,3152876,32,1,0,0,1
3152877,3153352,475,0,0,1,1
3152880,3153147,267,0,0,1,2
3153148,3153182,34,1,0,0,2
3153183,3153352,169,0,0,1,2
3153353,3153396,43,1,0,0,1
3153353,3153396,43,1,0,0,2
3153397,3153711,314,0,0,1,1
3153397,3153711,314,0,0,1,2
3153712,3153766,54,1,0,0,1
3153712,3153772,60,1,0,0,2
3153767,3153837,70,0,0,1,1
3153773,3153838,65,0,0,1,2
3153838,3153870,32,1,0,0,1
3153839,3153872,33,1,0,0,2
3153871,3154083,212,0,0,1,1
3153873,3154077,204,0,0,1,2
3154078,3154094,16,1,0,0,2
3154084,3154094,10,1,0,0,1
3154095,3155608,1513,0,0,1,1
3154095,3155609,1514,0,0,1,2
3155609,3155649,40,1,0,0,1
3155610,3155649,39,1,0,0,2
3155650,3155839,189,0,0,1,1
3155650,3155843,193,0,0,1,2
3155840,3155860,20,1,0,0,1
3155844,3155860,16,1,0,0,2
3155861,3155928,67,0,0,1,1
3155861,3155928,67,0,0,1,2
3155929,3156211,282,1,0,0,1
3155929,3156275,346,1,0,0,2
3155950,3156159,209,0,1,0,1
3155952,3156181,229,0,1,0,2
3156212,3156388,176,0,0,1,1
3156276,3156389,113,0,0,1,2
3156389,3156407,18,1,0,0,1
3156390,3156404,14,1,0,0,2
3156405,3156633,228,0,0,1,2
3156408,3156639,231,0,0,1,1
3156634,3156942,308,1,0,0,2
3156640,3156908,268,1,0,0,1
3156661,3156856,195,0,1,0,1
3156662,3156864,202,0,1,0,2
3156909,3157787,878,0,0,1,1
3156943,3157790,847,0,0,1,2
3157788,3157808,20,1,0,0,1
3157791,3157808,17,1,0,0,2
3157809,3157857,48,0,0,1,2
3157809,3157858,49,0,0,1,1
3157858,3158146,288,1,0,0,2
3157859,3158125,266,1,0,0,1
3157882,3158069,187,0,1,0,1
3157889,3158063,174,0,1,0,2
3158126,3158433,307,0,0,1,1
3158147,3158431,284,0,0,1,2
3158432,3158458,26,1,0,0,2
3158434,3158462,28,1,0,0,1
3158459,3159138,679,0,0,1,2
3158463,3159137,674,0,0,1,1
3159138,3159177,39,1,0,0,1
3159139,3159178,39,1,0,0,2
3159178,3159383,205,0,0,1,1
3159179,3159382,203,0,0,1,2
3159383,3159441,58,1,0,0,2
3159384,3159447,63,1,0,0,1
3159442,3159572,130,0,0,1,2
3159448,3159573,125,0,0,1,1
3159573,3159595,22,1,0,0,2
3159574,3159596,22,1,0,0,1
3159596,3160594,998,0,0,1,2
3159597,3160594,997,0,0,1,1
3160595,3160631,36,1,0,0,1
3160595,3160646,51,1,0,0,2
3160632,3160765,133,0,0,1,1
3160647,3160962,315,0,0,1,2
3160766,3160785,19,1,0,0,1
3160786,3160973,187,0,0,1,1
3160963,3161538,575,1,0,0,2
3160974,3161332,358,1,0,0,1
3160985,3161506,521,0,1,0,2
3160991,3161235,244,0,1,0,1
3161333,3161375,42,0,0,1,1
3161376,3161388,12,1,0,0,1
3161389,3162397,1008,0,0,1,1
3161539,3161564,25,0,0,1,2
3161565,3162048,483,1,0,0,2
3162049,3162116,67,0,0,1,2
3162117,3162148,31,1,0,0,2
3162149,3162277,128,0,0,1,2
3162278,3162371,93,1,0,0,2
3162372,3162392,20,0,0,1,2
3162393,3163455,1062,1,0,0,2
3162398,3162415,17,1,0,0,1
3162416,3162850,434,0,0,1,1
3162849,3163370,521,0,1,0,2
3162851,3163184,333,1,0,0,1
3162872,3163139,267,0,1,0,1
3163185,3163280,95,0,0,1,1
3163281,3163320,39,1,0,0,1
3163321,3163988,667,0,0,1,1
3163456,3163492,36,0,0,1,2
3163493,3163595,102,1,0,0,2
3163596,3163696,100,0,0,1,2
3163697,3163777,80,1,0,0,2
3163778,3163856,78,0,0,1,2
3163857,3164064,207,1,0,0,2
3163989,3164070,81,1,0,0,1
3164065,3164152,87,0,0,1,2
3164071,3164152,81,0,0,1,1
3164153,3164182,29,1,0,0,1
3164153,3164186,33,1,0,0,2
3164183,3165828,1645,0,0,1,1
3164187,3165827,1640,0,0,1,2
3165828,3165878,50,1,0,0,2
3165829,3165883,54,1,0,0,1
3165879,3166129,250,0,0,1,2
3165884,3166129,245,0,0,1,1
3166130,3166446,316,1,0,0,1
3166130,3166456,326,1,0,0,2
3166149,3166423,274,0,1,0,1
3166154,3166398,244,0,1,0,2
3166447,3166756,309,0,0,1,1
3166457,3166755,298,0,0,1,2
3166756,3166776,20,1,0,0,2
3166757,3166777,20,1,0,0,1
3166777,3166949,172,0,0,1,2
3166778,3166960,182,0,0,1,1
3166950,3167286,336,1,0,0,2
3166961,3167261,300,1,0,0,1
3166979,3167230,251,0,1,0,1
3166981,3167210,229,0,1,0,2
3167262,3167567,305,0,0,1,1
3167287,3167373,86,0,0,1,2
3167374,3167385,11,1,0,0,2
3167386,3167562,176,0,0,1,2
3167563,3167583,20,1,0,0,2
3167568,3167579,11,1,0,0,1
3167580,3168340,760,0,0,1,1
3167584,3168340,756,0,0,1,2
3168341,3168384,43,1,0,0,2
3168341,3168385,44,1,0,0,1
3168385,3169852,1467,0,0,1,2
3168386,3169852,1466,0,0,1,1
3169853,3169916,63,1,0,0,1
3169853,3169931,78,1,0,0,2
3169917,3170036,119,0,0,1,1
3169932,3170031,99,0,0,1,2
3170032,3170059,27,1,0,0,2
3170037,3170054,17,1,0,0,1
3170055,3170841,786,0,0,1,1
3170060,3170843,783,0,0,1,2
3170842,3170889,47,1,0,0,1
3170844,3170900,56,1,0,0,2
3170890,3171002,112,0,0,1,1
3170901,3171001,100,0,0,1,2
3171002,3171038,36,1,0,0,2
3171003,3171031,28,1,0,0,1
3171032,3171240,208,0,0,1,1
3171039,3171238,199,0,0,1,2
3171239,3171568,329,1,0,0,2
3171241,3171508,267,1,0,0,1
3171259,3171486,227,0,1,0,2
3171260,3171479,219,0,1,0,1
3171509,3172018,509,0,0,1,1
3171569,3172017,448,0,0,1,2
3172018,3172039,21,1,0,0,2
3172019,3172040,21,1,0,0,1
3172040,3172436,396,0,0,1,2
3172041,3172443,402,0,0,1,1
3172437,3172876,439,1,0,0,2
3172444,3172799,355,1,0,0,1
3172463,3172726,263,0,1,0,2
3172466,3172724,258,0,1,0,1
3172800,3173213,413,0,0,1,1
3172877,3173214,337,0,0,1,2
3173214,3173235,21,1,0,0,1
3173215,3173230,15,1,0,0,2
3173231,3173713,482,0,0,1,2
3173236,3173715,479,0,0,1,1
3173714,3173738,24,1,0,0,2
3173716,3173738,22,1,0,0,1
3173739,3174148,409,0,0,1,2
3173739,3174149,410,0,0,1,1
3174149,3174215,66,1,0,0,2
3174150,3174210,60,1,0,0,1
3174211,3174271,60,0,0,1,1
3174216,3174271,55,0,0,1,2
3174272,3174305,33,1,0,0,1
3174272,3174315,43,1,0,0,2
3174306,3174447,141,0,0,1,1
3174316,3174448,132,0,0,1,2
3174448,3174468,20,1,0,0,1
3174449,3174469,20,1,0,0,2
3174469,3175395,926,0,0,1,1
3174470,3175396,926,0,0,1,2
3175396,3175434,38,1,0,0,1
3175397,3175436,39,1,0,0,2
3175435,3175858,423,0,0,1,1
3175437,3175849,412,0,0,1,2
3175850,3176091,241,1,0,0,2
3175859,3176071,212,1,0,0,1
3175878,3176025,147,0,1,0,1
3175881,3176030,149,0,1,0,2
3176072,3176417,345,0,0,1,1
3176092,3176414,322,0,0,1,2
3176415,3176439,24,1,0,0,2
3176418,3176440,22,1,0,0,1
3176440,3176921,481,0,0,1,2
3176441,3176919,478,0,0,1,1
3176920,3177143,223,1,0,0,1
3176922,3177152,230,1,0,0,2
3176941,3177075,134,0,1,0,1
3176943,3177075,132,0,1,0,2
3177144,3177649,505,0,0,1,1
3177153,3177649,496,0,0,1,2
3177650,3177681,31,1,0,0,2
3177650,3177682,32,1,0,0,1
3177682,3177942,260,0,0,1,2
3177683,3177942,259,0,0,1,1
3177943,3178009,66,1,0,0,1
3177943,3178024,81,1,0,0,2
3178010,3178905,895,0,0,1,1
3178025,3178664,639,0,0,1,2
3178665,3178726,61,1,0,0,2
3178727,3178907,180,0,0,1,2
3178906,3178974,68,1,0,0,1
3178908,3178975,67,1,0,0,2
3178975,3179030,55,0,0,1,1
3178976,3179032,56,0,0,1,2
3179031,3179077,46,1,0,0,1
3179033,3179068,35,1,0,0,2
3179069,3179138,69,0,0,1,2
3179078,3179137,59,0,0,1,1
3179138,3179163,25,1,0,0,1
3179139,3179161,22,1,0,0,2
3179162,3180197,1035,0,0,1,2
3179164,3180197,1033,0,0,1,1
3180198,3180237,39,1,0,0,1
3180198,3180239,41,1,0,0,2
3180238,3180573,335,0,0,1,1
3180240,3180578,338,0,0,1,2
3180574,3180800,226,1,0,0,1
3180579,3180791,212,1,0,0,2
3180596,3180746,150,0,1,0,1
3180598,3180725,127,0,1,0,2
3180792,3181156,364,0,0,1,2
3180801,3181157,356,0,0,1,1
3181157,3181185,28,1,0,0,2
3181158,3181184,26,1,0,0,1
3181185,3181536,351,0,0,1,1
3181186,3181541,355,0,0,1,2
3181537,3181774,237,1,0,0,1
3181542,3181748,206,1,0,0,2
3181563,3181712,149,0,1,0,1
3181566,3181691,125,0,1,0,2
3181749,3182614,865,0,0,1,2
3181775,3182612,837,0,0,1,1
3182613,3182667,54,1,0,0,1
3182615,3182667,52,1,0,0,2
3182668,3183016,348,0,0,1,1
3182668,3183016,348,0,0,1,2
3183017,3183054,37,1,0,0,1
3183017,3183055,38,1,0,0,2
3183055,3183743,688,0,0,1,1
3183056,3183744,688,0,0,1,2
3183744,3183790,46,1,0,0,1
3183745,3183798,53,1,0,0,2
3183791,3184025,234,0,0,1,1
3183799,3184889,1090,0,0,1,2
3184026,3184030,4,1,0,0,1
3184031,3184888,857,0,0,1,1
3184889,3184930,41,1,0,0,1
3184890,3184932,42,1,0,0,2
3184931,3185219,288,0,0,1,1
3184933,3185216,283,0,0,1,2
3185217,3185547,330,1,0,0,2
3185220,3185532,312,1,0,0,1
3185241,3185499,258,0,1,0,1
3185242,3185485,243,0,1,0,2
3185533,3186191,658,0,0,1,1
3185548,3186189,641,0,0,1,2
3186190,3186213,23,1,0,0,2
3186192,3186214,22,1,0,0,1
3186214,3186458,244,0,0,1,2
3186215,3186459,244,0,0,1,1
3186459,3186814,355,1,0,0,2
3186460,3186789,329,1,0,0,1
3186486,3186755,269,0,1,0,1
3186487,3186743,256,0,1,0,2
3186790,3187497,707,0,0,1,1
3186815,3187498,683,0,0,1,2
3187498,3187521,23,1,0,0,1
3187499,3187521,22,1,0,0,2
3187522,3188464,942,0,0,1,2
3187522,3188465,943,0,0,1,1
3188465,3188522,57,1,0,0,2
3188466,3188517,51,1,0,0,1
3188518,3188599,81,0,0,1,1
3188523,3188599,76,0,0,1,2
3188600,3188624,24,1,0,0,2
3188600,3188631,31,1,0,0,1
3188625,3188881,256,0,0,1,2
3188632,3188879,247,0,0,1,1
3188880,3188898,18,1,0,0,1
3188882,3188897,15,1,0,0,2
3188898,3189930,1032,0,0,1,2
3188899,3189929,1030,0,0,1,1
3189930,3189986,56,1,0,0,1
3189931,3189978,47,1,0,0,2
3189979,3190115,136,0,0,1,2
3189987,3190112,125,0,0,1,1
3190113,3190131,18,1,0,0,1
3190116,3190128,12,1,0,0,2
3190129,3190285,156,0,0,1,2
3190132,3190287,155,0,0,1,1
3190286,3190659,373,1,0,0,2
3190288,3190630,342,1,0,0,1
3190310,3190588,278,0,1,0,1
3190312,3190593,281,0,1,0,2
3190631,3192114,1483,0,0,1,1
3190660,3192099,1439,0,0,1,2
3192100,3192433,333,1,0,0,2
3192115,3192436,321,1,0,0,1
3192135,3192401,266,0,1,0,1
3192140,3192393,253,0,1,0,2
3192434,3193641,1207,0,0,1,2
3192437,3193640,1203,0,0,1,1
3193641,3194973,1332,1,0,0,1
3193642,3195192,1550,1,0,0,2
3193688,3194930,1242,0,1,0,2
3193719,3194110,391,0,1,0,1
3194133,3194136,3,0,1,0,1
3194221,3194888,667,0,1,0,1
3194974,3195106,132,0,0,1,1
3195107,3195162,55,1,0,0,1
3195163,3195239,76,0,0,1,1
3195193,3195250,57,0,0,1,2
3195240,3195622,382,1,0,0,1
3195251,3195958,707,1,0,0,2
3195269,3195709,440,0,1,0,2
3195277,3195582,305,0,1,0,1
3195623,3195939,316,0,0,1,1
3195940,3195973,33,1,0,0,1
3195959,3196155,196,0,0,1,2
3195974,3196388,414,0,0,1,1
3196156,3196193,37,1,0,0,2
3196194,3196381,187,0,0,1,2
3196382,3205756,9374,1,0,0,2
3196389,3197062,673,1,0,0,1
3196404,3197879,1475,0,1,0,2
3196417,3196917,500,0,1,0,1
3197063,3197170,107,0,0,1,1
3197171,3197665,494,1,0,0,1
3197224,3197614,390,0,1,0,1
3197666,3198108,442,0,0,1,1
3198109,3198170,61,1,0,0,1
3198122,3202689,4567,0,1,0,2
3198154,3198155,1,0,1,0,1
3198171,3198275,104,0,0,1,1
3198276,3198312,36,1,0,0,1
3198313,3198471,158,0,0,1,1
3198472,3198508,36,1,0,0,1
3198509,3198670,161,0,0,1,1
3198671,3198675,4,1,0,0,1
3198676,3199105,429,0,0,1,1
3199116,3199249,133,0,1,0,1
3199258,3199258,0,1,0,0,1
3199259,3199294,35,0,0,1,1
3199295,3199953,658,1,0,0,1
3199318,3199396,78,0,1,0,1
3199417,3199867,450,0,1,0,1
3199954,3200144,190,0,0,1,1
3200145,3200545,400,1,0,0,1
3200201,3200503,302,0,1,0,1
3200546,3201125,579,0,0,1,1
3201126,3201480,354,1,0,0,1
3201143,3201415,272,0,1,0,1
3201481,3202109,628,0,0,1,1
3202110,3202133,23,1,0,0,1
3202134,3203555,1421,0,0,1,1
3202786,3202821,35,0,1,0,2
3202866,3202876,10,0,1,0,2
3202957,3202970,13,0,1,0,2
3203296,3204824,1528,0,1,0,2
3203556,3205449,1893,1,0,0,1
3203712,3204874,1162,0,1,0,1
3204912,3205547,635,0,1,0,2
3204923,3205422,499,0,1,0,1
3205450,3205921,471,0,0,1,1
3205757,3205923,166,0,0,1,2
3205922,3206595,673,1,0,0,1
3205924,3208097,2173,1,0,0,2
3205939,3208008,2069,0,1,0,2
3205942,3206573,631,0,1,0,1
3206596,3206930,334,0,0,1,1
3206931,3207420,489,1,0,0,1
3206957,3207396,439,0,1,0,1
3207421,3207521,100,0,0,1,1
3207522,3207556,34,1,0,0,1
3207557,3207952,395,0,0,1,1
3207953,3208004,51,1,0,0,1
3208005,3208069,64,0,0,1,1
3208070,3208096,26,1,0,0,1
3208097,3208235,138,0,0,1,1
3208098,3208239,141,0,0,1,2
3208236,3208243,7,1,0,0,1
3208240,3208244,4,1,0,0,2
3208244,3209638,1394,0,0,1,1
3208245,3209639,1394,0,0,1,2
3209639,3209692,53,1,0,0,1
3209640,3209690,50,1,0,0,2
3209691,3209764,73,0,0,1,2
3209693,3209763,70,0,0,1,1
3209764,3209800,36,1,0,0,1
3209765,3209792,27,1,0,0,2
3209793,3211846,2053,0,0,1,2
3209801,3211848,2047,0,0,1,1
3211847,3212544,697,1,0,0,2
3211849,3212292,443,1,0,0,1
3211893,3212263,370,0,1,0,1
3211896,3212266,370,0,1,0,2
3212293,3212328,35,0,0,1,1
3212329,3212371,42,1,0,0,1
3212372,3212980,608,0,0,1,1
3212545,3212720,175,0,0,1,2
3212721,3212740,19,1,0,0,2
3212741,3212910,169,0,0,1,2
3212911,3213020,109,1,0,0,2
3212981,3213008,27,1,0,0,1
3213009,3213727,718,0,0,1,1
3213021,3213174,153,0,0,1,2
3213175,3213234,59,1,0,0,2
3213235,3213322,87,0,0,1,2
3213323,3213328,5,1,0,0,2
3213329,3213391,62,0,0,1,2
3213392,3213433,41,1,0,0,2
3213434,3213524,90,0,0,1,2
3213525,3213546,21,1,0,0,2
3213547,3213627,80,0,0,1,2
3213628,3213787,159,1,0,0,2
3213728,3213784,56,1,0,0,1
3213785,3213887,102,0,0,1,1
3213788,3213888,100,0,0,1,2
3213888,3213921,33,1,0,0,1
3213889,3213916,27,1,0,0,2
3213917,3215046,1129,0,0,1,2
3213922,3215047,1125,0,0,1,1
3215047,3215099,52,1,0,0,2
3215048,3215103,55,1,0,0,1
3215100,3215277,177,0,0,1,2
3215104,3215287,183,0,0,1,1
3215278,3215859,581,1,0,0,2
3215288,3215589,301,1,0,0,1
3215302,3215559,257,0,1,0,1
3215304,3215638,334,0,1,0,2
3215590,3215933,343,0,0,1,1
3215860,3215936,76,0,0,1,2
3215934,3215948,14,1,0,0,1
3215937,3215960,23,1,0,0,2
3215949,3216065,116,0,0,1,1
3215961,3216043,82,0,0,1,2
3216044,3216634,590,1,0,0,2
3216066,3216371,305,1,0,0,1
3216077,3216384,307,0,1,0,2
3216085,3216331,246,0,1,0,1
3216372,3216841,469,0,0,1,1
3216635,3216845,210,0,0,1,2
3216842,3216862,20,1,0,0,1
3216846,3216866,20,1,0,0,2
3216863,3217314,451,0,0,1,1
3216867,3217302,435,0,0,1,2
3217303,3217714,411,1,0,0,2
3217315,3217647,332,1,0,0,1
3217327,3217619,292,0,1,0,2
3217329,3217583,254,0,1,0,1
3217648,3218481,833,0,0,1,1
3217715,3218481,766,0,0,1,2
3218482,3218539,57,1,0,0,2
3218482,3218547,65,1,0,0,1
3218540,3218616,76,0,0,1,2
3218548,3218618,70,0,0,1,1
3218617,3218653,36,1,0,0,2
3218619,3218647,28,1,0,0,1
3218648,3218831,183,0,0,1,1
3218654,3220292,1638,0,0,1,2
3218832,3218844,12,1,0,0,1
3218845,3220292,1447,0,0,1,1
3220293,3220346,53,1,0,0,1
3220293,3220349,56,1,0,0,2
3220347,3220523,176,0,0,1,1
3220350,3220523,173,0,0,1,2
3220524,3220840,316,1,0,0,1
3220524,3220887,363,1,0,0,2
3220542,3220803,261,0,1,0,1
3220544,3220878,334,0,1,0,2
3220841,3221408,567,0,0,1,1
3220888,3220951,63,0,0,1,2
3220952,3221011,59,1,0,0,2
3221012,3221055,43,0,0,1,2
3221056,3221116,60,1,0,0,2
3221117,3221392,275,0,0,1,2
3221393,3221913,520,1,0,0,2
3221409,3221756,347,1,0,0,1
3221420,3221892,472,0,1,0,2
3221426,3221692,266,0,1,0,1
3221757,3222428,671,0,0,1,1
3221914,3222094,180,0,0,1,2
3222095,3222100,5,1,0,0,2
3222101,3222243,142,0,0,1,2
3222244,3222257,13,1,0,0,2
3222258,3222426,168,0,0,1,2
3222427,3222456,29,1,0,0,2
3222429,3222455,26,1,0,0,1
3222456,3222539,83,0,0,1,1
3222457,3222529,72,0,0,1,2
3222530,3223042,512,1,0,0,2
3222540,3222843,303,1,0,0,1
3222551,3222885,334,0,1,0,2
3222554,3222801,247,0,1,0,1
3222844,3224394,1550,0,0,1,1
3223043,3223235,192,0,0,1,2
3223236,3223243,7,1,0,0,2
3223244,3223335,91,0,0,1,2
3223336,3223355,19,1,0,0,2
3223356,3223454,98,0,0,1,2
3223455,3223459,4,1,0,0,2
3223460,3223642,182,0,0,1,2
3223643,3223657,14,1,0,0,2
3223658,3223872,214,0,0,1,2
3223873,3224009,136,1,0,0,2
3224010,3224072,62,0,0,1,2
3224073,3224463,390,1,0,0,2
3224395,3224459,64,1,0,0,1
3224460,3224585,125,0,0,1,1
3224464,3224584,120,0,0,1,2
3224585,3224606,21,1,0,0,2
3224586,3224604,18,1,0,0,1
3224605,3225662,1057,0,0,1,1
3224607,3225663,1056,0,0,1,2
3225663,3225716,53,1,0,0,1
3225664,3225713,49,1,0,0,2
3225714,3225847,133,0,0,1,2
3225717,3225851,134,0,0,1,1
3225848,3226211,363,1,0,0,2
3225852,3226196,344,1,0,0,1
3225871,3226109,238,0,1,0,1
3225873,3226125,252,0,1,0,2
3226197,3226789,592,0,0,1,1
3226212,3226775,563,0,0,1,2
3226776,3227104,328,1,0,0,2
3226790,3227072,282,1,0,0,1
3226812,3227013,201,0,1,0,1
3226812,3227025,213,0,1,0,2
3227073,3227396,323,0,0,1,1
3227105,3227397,292,0,0,1,2
3227397,3227421,24,1,0,0,1
3227398,3227420,22,1,0,0,2
3227421,3227782,361,0,0,1,2
3227422,3227792,370,0,0,1,1
3227783,3228275,492,1,0,0,2
3227793,3228150,357,1,0,0,1
3227816,3228074,258,0,1,0,1
3227818,3228091,273,0,1,0,2
3228151,3228359,208,0,0,1,1
3228276,3228359,83,0,0,1,2
3228360,3228386,26,1,0,0,1
3228360,3228394,34,1,0,0,2
3228387,3228713,326,0,0,1,1
3228395,3228713,318,0,0,1,2
3228714,3228746,32,1,0,0,1
3228714,3228778,64,1,0,0,2
3228747,3229071,324,0,0,1,1
3228779,3229072,293,0,0,1,2
3229072,3229134,62,1,0,0,1
3229073,3232841,3768,1,0,0,2
3229122,3230620,1498,0,1,0,2
3229135,3229224,89,0,0,1,1
3229225,3229230,5,1,0,0,1
3229231,3229298,67,0,0,1,1
3229299,3229339,40,1,0,0,1
3229340,3229515,175,0,0,1,1
3229526,3230685,1159,0,1,0,1
3230679,3232743,2064,0,1,0,2
3230695,3231955,1260,1,0,0,1
3230745,3231152,407,0,1,0,1
3231251,3231336,85,0,1,0,1
3231463,3231945,482,0,1,0,1
3231956,3232054,98,0,0,1,1
3232055,3232084,29,1,0,0,1
3232085,3232331,246,0,0,1,1
3232332,3232360,28,1,0,0,1
3232361,3233004,643,0,0,1,1
3232842,3232919,77,0,0,1,2
3232920,3234139,1219,1,0,0,2
3232945,3234101,1156,0,1,0,2
3233005,3233068,63,1,0,0,1
3233069,3233740,671,0,0,1,1
3233741,3233750,9,1,0,0,1
3233751,3234046,295,0,0,1,1
3234047,3234114,67,1,0,0,1
3234115,3234248,133,0,0,1,1
3234140,3234249,109,0,0,1,2
3234249,3234275,26,1,0,0,1
3234250,3234279,29,1,0,0,2
3234276,3234482,206,0,0,1,1
3234280,3234481,201,0,0,1,2
3234482,3234522,40,1,0,0,2
3234483,3234521,38,1,0,0,1
3234522,3234696,174,0,0,1,1
3234523,3234697,174,0,0,1,2
3234697,3234733,36,1,0,0,1
3234698,3234734,36,1,0,0,2
3234734,3234997,263,0,0,1,1
3234735,3234997,262,0,0,1,2
3234998,3235024,26,1,0,0,1
3234998,3235043,45,1,0,0,2
3235025,3235256,231,0,0,1,1
3235044,3235255,211,0,0,1,2
3235256,3235291,35,1,0,0,2
3235257,3235307,50,1,0,0,1
3235292,3235475,183,0,0,1,2
3235308,3235474,166,0,0,1,1
3235475,3235501,26,1,0,0,1
3235476,3235503,27,1,0,0,2
3235502,3235569,67,0,0,1,1
3235504,3235686,182,0,0,1,2
3235570,3235574,4,1,0,0,1
3235575,3235687,112,0,0,1,1
3235687,3235715,28,1,0,0,2
3235688,3235715,27,1,0,0,1
3235716,3235759,43,0,0,1,1
3235716,3235814,98,0,0,1,2
3235770,3246802,11032,0,1,0,1
3235815,3246809,10994,1,0,0,2
3235912,3246746,10834,0,1,0,2
3246810,3246931,121,0,0,1,2
3246812,3246812,0,1,0,0,1
3246813,3246931,118,0,0,1,1
3288411,3288522,111,0,0,1,2
3288411,3288540,129,0,0,1,1
3288523,3288813,290,1,0,0,2
3288541,3288768,227,1,0,0,1
3288556,3288756,200,0,1,0,2
3288561,3288744,183,0,1,0,1
3288769,3288868,99,0,0,1,1
3288814,3288868,54,0,0,1,2
3288869,3288920,51,1,0,0,1
3288869,3288920,51,1,0,0,2
3288921,3289032,111,0,0,1,2
3288921,3289033,112,0,0,1,1
3289033,3289077,44,1,0,0,2
3289034,3289075,41,1,0,0,1
3289076,3289153,77,0,0,1,1
3289078,3289151,73,0,0,1,2
3289152,3289185,33,1,0,0,2
3289154,3289179,25,1,0,0,1
3289180,3289458,278,0,0,1,1
3289186,3289455,269,0,0,1,2
3289456,3289471,15,1,0,0,2
3289459,3289469,10,1,0,0,1
3289470,3290498,1028,0,0,1,1
3289472,3290497,1025,0,0,1,2
3290498,3290571,73,1,0,0,2
3290499,3290568,69,1,0,0,1
3290569,3290748,179,0,0,1,1
3290572,3290750,178,0,0,1,2
3290749,3290865,116,1,0,0,1
3290751,3290832,81,1,0,0,2
3290833,3290921,88,0,0,1,2
3290866,3290920,54,0,0,1,1
3290921,3291028,107,1,0,0,1
3290922,3291029,107,1,0,0,2
3291029,3291115,86,0,0,1,1
3291030,3291115,85,0,0,1,2
3291116,3291152,36,1,0,0,1
3291116,3291335,219,1,0,0,2
3291153,3292731,1578,0,0,1,1
3291336,3291403,67,0,0,1,2
3291404,3291481,77,1,0,0,2
3291482,3291635,153,0,0,1,2
3291636,3291701,65,1,0,0,2
3291702,3291771,69,0,0,1,2
3291772,3291780,8,1,0,0,2
3291781,3291865,84,0,0,1,2
3291866,3291881,15,1,0,0,2
3291882,3292730,848,0,0,1,2
3292731,3292783,52,1,0,0,2
3292732,3292780,48,1,0,0,1
3292781,3292928,147,0,0,1,1
3292784,3292926,142,0,0,1,2
3292927,3292938,11,1,0,0,2
3292929,3292941,12,1,0,0,1
3292939,3294001,1062,0,0,1,2
3292942,3294014,1072,0,0,1,1
3294002,3294558,556,1,0,0,2
3294015,3294343,328,1,0,0,1
3294037,3294269,232,0,1,0,1
3294041,3294376,335,0,1,0,2
3294344,3294449,105,0,0,1,1
3294450,3294511,61,1,0,0,1
3294512,3294585,73,0,0,1,1
3294559,3294584,25,0,0,1,2
3294585,3294622,37,1,0,0,2
3294586,3294611,25,1,0,0,1
3294612,3294720,108,0,0,1,1
3294623,3294721,98,0,0,1,2
3294721,3294737,16,1,0,0,1
3294722,3294752,30,1,0,0,2
3294738,3295759,1021,0,0,1,1
3294753,3295759,1006,0,0,1,2
3295760,3296122,362,1,0,0,1
3295760,3297380,1620,1,0,0,2
3295805,3296060,255,0,1,0,1
3295810,3296083,273,0,1,0,2
3296123,3296175,52,0,0,1,1
3296176,3297352,1176,1,0,0,1
3296207,3297369,1162,0,1,0,2
3296216,3297342,1126,0,1,0,1
3297353,3297779,426,0,0,1,1
3297381,3297780,399,0,0,1,2
3297780,3297872,92,1,0,0,1
3297781,3297874,93,1,0,0,2
3297873,3297972,99,0,0,1,1
3297875,3297973,98,0,0,1,2
3297973,3298008,35,1,0,0,1
3297974,3298011,37,1,0,0,2
3298009,3299544,1535,0,0,1,1
3298012,3298329,317,0,0,1,2
3298330,3298334,4,1,0,0,2
3298335,3299544,1209,0,0,1,2
3299545,3299649,104,1,0,0,1
3299545,3299666,121,1,0,0,2
3299650,3299750,100,0,0,1,1
3299667,3299749,82,0,0,1,2
3299750,3299841,91,1,0,0,2
3299751,3299786,35,1,0,0,1
3299787,3299987,200,0,0,1,1
3299842,3300385,543,0,0,1,2
3299988,3300002,14,1,0,0,1
3300003,3300778,775,0,0,1,1
3300386,3300476,90,1,0,0,2
3300477,3300535,58,0,0,1,2
3300536,3301525,989,1,0,0,2
3300779,3300987,208,1,0,0,1
3300791,3301274,483,0,1,0,2
3300838,3300971,133,0,1,0,1
3300988,3301102,114,0,0,1,1
3301113,3301124,11,0,1,0,1
3301134,3301157,23,1,0,0,1
3301158,3301201,43,0,0,1,1
3301202,3302430,1228,1,0,0,1
3301236,3302420,1184,0,1,0,1
3301526,3301566,40,0,0,1,2
3301567,3301595,28,1,0,0,2
3301596,3301755,159,0,0,1,2
3301756,3302436,680,1,0,0,2
3301784,3302427,643,0,1,0,2
3302431,3302716,285,0,0,1,1
3302437,3302632,195,0,0,1,2
3302633,3302758,125,1,0,0,2
3302717,3302750,33,1,0,0,1
3302751,3303940,1189,0,0,1,1
3302759,3302873,114,0,0,1,2
3302874,3302896,22,1,0,0,2
3302897,3303070,173,0,0,1,2
3303071,3303087,16,1,0,0,2
3303088,3303900,812,0,0,1,2
3303901,3303979,78,1,0,0,2
3303941,3303964,23,1,0,0,1
3303965,3304210,245,0,0,1,1
3303980,3304211,231,0,0,1,2
3304211,3304274,63,1,0,0,1
3304212,3304283,71,1,0,0,2
3304275,3304399,124,0,0,1,1
3304284,3304398,114,0,0,1,2
3304399,3304425,26,1,0,0,2
3304400,3304430,30,1,0,0,1
3304426,3305215,789,0,0,1,2
3304431,3305214,783,0,0,1,1
3305215,3305570,355,1,0,0,1
3305216,3305567,351,1,0,0,2
3305233,3305479,246,0,1,0,1
3305236,3305499,263,0,1,0,2
3305568,3305601,33,0,0,1,2
3305571,3305660,89,0,0,1,1
3305602,3305626,24,1,0,0,2
3305627,3305659,32,0,0,1,2
3305660,3305709,49,1,0,0,2
3305661,3305699,38,1,0,0,1
3305700,3305831,131,0,0,1,1
3305710,3305833,123,0,0,1,2
3305832,3305849,17,1,0,0,1
3305834,3305858,24,1,0,0,2
3305850,3306914,1064,0,0,1,1
3305859,3306916,1057,0,0,1,2
3306915,3306958,43,1,0,0,1
3306917,3306968,51,1,0,0,2
3306959,3307331,372,0,0,1,1
3306969,3307333,364,0,0,1,2
3307332,3307391,59,1,0,0,1
3307334,3307392,58,1,0,0,2
3307392,3307475,83,0,0,1,1
3307393,3307478,85,0,0,1,2
3307476,3307498,22,1,0,0,1
3307479,3307500,21,1,0,0,2
3307499,3308861,1362,0,0,1,1
3307501,3308860,1359,0,0,1,2
3308861,3308943,82,1,0,0,2
3308862,3308938,76,1,0,0,1
3308939,3309065,126,0,0,1,1
3308944,3309065,121,0,0,1,2
3309066,3309091,25,1,0,0,1
3309066,3309092,26,1,0,0,2
3309092,3310054,962,0,0,1,1
3309093,3310057,964,0,0,1,2
3310055,3310113,58,1,0,0,1
3310058,3310115,57,1,0,0,2
3310114,3310299,185,0,0,1,1
3310116,3310298,182,0,0,1,2
3310299,3310343,44,1,0,0,2
3310300,3310341,41,1,0,0,1
3310342,3310532,190,0,0,1,1
3310344,3310532,188,0,0,1,2
3310533,3310612,79,1,0,0,1
3310533,3310743,210,1,0,0,2
3310613,3310681,68,0,0,1,1
3310682,3310717,35,1,0,0,1
3310718,3310805,87,0,0,1,1
3310744,3310808,64,0,0,1,2
3310806,3310824,18,1,0,0,1
3310809,3310837,28,1,0,0,2
3310825,3312005,1180,0,0,1,1
3310838,3312005,1167,0,0,1,2
3312006,3312168,162,1,0,0,1
3312006,3313308,1302,1,0,0,2
3312087,3312157,70,0,1,0,1
3312122,3313288,1166,0,1,0,2
3312169,3312212,43,0,0,1,1
3312213,3313329,1116,1,0,0,1
3312227,3313318,1091,0,1,0,1
3313309,3313611,302,0,0,1,2
3313330,3313610,280,0,0,1,1
3313611,3313684,73,1,0,0,1
3313612,3313692,80,1,0,0,2
3313685,3313789,104,0,0,1,1
3313693,3313790,97,0,0,1,2
3313790,3313816,26,1,0,0,1
3313791,3313826,35,1,0,0,2
3313817,3314813,996,0,0,1,1
3313827,3314812,985,0,0,1,2
3314813,3314883,70,1,0,0,2
3314814,3314871,57,1,0,0,1
3314872,3315185,313,0,0,1,1
3314884,3315186,302,0,0,1,2
3315186,3315251,65,1,0,0,1
3315187,3315253,66,1,0,0,2
3315252,3315350,98,0,0,1,1
3315254,3315351,97,0,0,1,2
3315351,3315388,37,1,0,0,1
3315352,3315389,37,1,0,0,2
3315389,3315579,190,0,0,1,1
3315390,3315575,185,0,0,1,2
3315576,3315588,12,1,0,0,2
3315580,3315590,10,1,0,0,1
3315589,3315703,114,0,0,1,2
3315591,3315696,105,0,0,1,1
3315697,3315915,218,1,0,0,1
3315704,3315905,201,1,0,0,2
3315722,3315877,155,0,1,0,1
3315728,3315860,132,0,1,0,2
3315906,3316738,832,0,0,1,2
3315916,3316739,823,0,0,1,1
3316739,3316820,81,1,0,0,2
3316740,3316829,89,1,0,0,1
3316821,3316923,102,0,0,1,2
3316830,3316922,92,0,0,1,1
3316923,3316954,31,1,0,0,1
3316924,3316956,32,1,0,0,2
3316955,3318345,1390,0,0,1,1
3316957,3318347,1390,0,0,1,2
3318346,3318450,104,1,0,0,1
3318348,3318462,114,1,0,0,2
3318451,3318475,24,0,0,1,1
3318463,3318528,65,0,0,1,2
3318486,3319589,1103,0,1,0,1
3318529,3318571,42,1,0,0,2
3318572,3318625,53,0,0,1,2
3318636,3319218,582,0,1,0,2
3319228,3319614,386,1,0,0,2
3319251,3319503,252,0,1,0,2
3319599,3319600,1,1,0,0,1
3319601,3319869,268,0,0,1,1
3319615,3319872,257,0,0,1,2
3319870,3319940,70,1,0,0,1
3319873,3319937,64,1,0,0,2
3319938,3320004,66,0,0,1,2
3319941,3320001,60,0,0,1,1
3320002,3320314,312,1,0,0,1
3320005,3320070,65,1,0,0,2
3320027,3320040,13,0,1,0,1
3320071,3320143,72,0,0,1,2
3320075,3320143,68,0,1,0,1
3320144,3320175,31,1,0,0,2
3320176,3320366,190,0,0,1,2
3320315,3320346,31,0,0,1,1
3320347,3320426,79,1,0,0,1
3320367,3320381,14,1,0,0,2
3320382,3321042,660,0,0,1,2
3320427,3320681,254,0,0,1,1
3320682,3320780,98,1,0,0,1
3320781,3320876,95,0,0,1,1
3320877,3321134,257,1,0,0,1
3321043,3321132,89,1,0,0,2
3321077,3321080,3,0,1,0,1
3321133,3321477,344,0,0,1,2
3321135,3321446,311,0,0,1,1
3321447,3321452,5,1,0,0,1
3321453,3321475,22,0,0,1,1
3321476,3321549,73,1,0,0,1
3321478,3322634,1156,1,0,0,2
3321550,3321648,98,0,0,1,1
3321649,3321670,21,1,0,0,1
3321671,3322551,880,0,0,1,1
3322552,3322630,78,1,0,0,1
3322631,3322952,321,0,0,1,1
3322635,3322952,317,0,0,1,2
3322953,3323014,61,1,0,0,1
3322953,3323017,64,1,0,0,2
3323015,3323115,100,0,0,1,1
3323018,3323116,98,0,0,1,2
3323116,3323139,23,1,0,0,1
3323117,3323139,22,1,0,0,2
3323140,3324461,1321,0,0,1,2
3323140,3324462,1322,0,0,1,1
3324462,3324617,155,1,0,0,2
3324463,3324551,88,1,0,0,1
3324552,3324646,94,0,0,1,1
3324618,3324645,27,0,0,1,2
3324646,3326081,1435,1,0,0,2
3324647,3324678,31,1,0,0,1
3324660,3326070,1410,0,1,0,2
3324679,3325617,938,0,0,1,1
3325628,3325754,126,0,1,0,1
3325764,3326107,343,1,0,0,1
3325775,3326041,266,0,1,0,1
3326082,3326229,147,0,0,1,2
3326108,3326229,121,0,0,1,1
3326230,3326264,34,1,0,0,1
3326230,3326280,50,1,0,0,2
3326265,3326433,168,0,0,1,1
3326281,3326432,151,0,0,1,2
3326433,3326446,13,1,0,0,2
3326434,3326449,15,1,0,0,1
3326447,3327671,1224,0,0,1,2
3326450,3327673,1223,0,0,1,1
3327672,3327724,52,1,0,0,2
3327674,3327722,48,1,0,0,1
3327723,3327837,114,0,0,1,1
3327725,3327839,114,0,0,1,2
3327838,3327860,22,1,0,0,1
3327840,3327858,18,1,0,0,2
3327859,3329243,1384,0,0,1,2
3327861,3329242,1381,0,0,1,1
3329243,3329307,64,1,0,0,1
3329244,3329322,78,1,0,0,2
3329308,3329410,102,0,0,1,1
3329323,3329410,87,0,0,1,2
3329411,3329440,29,1,0,0,1
3329411,3329447,36,1,0,0,2
3329441,3330403,962,0,0,1,1
3329448,3330401,953,0,0,1,2
3330402,3330459,57,1,0,0,2
3330404,3330458,54,1,0,0,1
3330459,3330781,322,0,0,1,1
3330460,3330780,320,0,0,1,2
3330781,3330838,57,1,0,0,2
3330782,3330835,53,1,0,0,1
3330836,3330933,97,0,0,1,1
3330839,3330897,58,0,0,1,2
3330898,3330979,81,1,0,0,2
3330934,3330970,36,1,0,0,1
3330971,3331188,217,0,0,1,1
3330980,3331740,760,0,0,1,2
3331189,3331204,15,1,0,0,1
3331205,3332324,1119,0,0,1,1
3331741,3331764,23,1,0,0,2
3331765,3332327,562,0,0,1,2
3332325,3332409,84,1,0,0,1
3332328,3332419,91,1,0,0,2
3332410,3332467,57,0,0,1,1
3332420,3332466,46,0,0,1,2
3332467,3332523,56,1,0,0,2
3332468,3332509,41,1,0,0,1
3332510,3332714,204,0,0,1,1
3332524,3332711,187,0,0,1,2
3332712,3332732,20,1,0,0,2
3332715,3332733,18,1,0,0,1
3332733,3333999,1266,0,0,1,2
3332734,3334000,1266,0,0,1,1
3334000,3334211,211,1,0,0,2
3334001,3334072,71,1,0,0,1
3334073,3334188,115,0,0,1,1
3334189,3334212,23,1,0,0,1
3334212,3334419,207,0,0,1,2
3334213,3334419,206,0,0,1,1
3334420,3334436,16,1,0,0,2
3334420,3334437,17,1,0,0,1
3334437,3334548,111,0,0,1,2
3334438,3334544,106,0,0,1,1
3334545,3334562,17,1,0,0,1
3334549,3334564,15,1,0,0,2
3334563,3334627,64,0,0,1,1
3334565,3334631,66,0,0,1,2
3334628,3334877,249,1,0,0,1
3334632,3334926,294,1,0,0,2
3334651,3334827,176,0,1,0,1
3334652,3334860,208,0,1,0,2
3334878,3335529,651,0,0,1,1
3334927,3335532,605,0,0,1,2
3335530,3336598,1068,1,0,0,1
3335533,3335623,90,1,0,0,2
3335618,3336588,970,0,1,0,1
3335624,3335713,89,0,0,1,2
3335714,3336078,364,1,0,0,2
3335820,3336068,248,0,1,0,2
3336079,3336114,35,0,0,1,2
3336115,3336138,23,1,0,0,2
3336139,3336188,49,0,0,1,2
3336199,3336279,80,0,1,0,2
3336289,3336292,3,1,0,0,2
3336293,3336487,194,0,0,1,2
3336488,3336561,73,1,0,0,2
3336511,3336519,8,0,1,0,2
3336562,3336982,420,0,0,1,2
3336599,3336736,137,0,0,1,1
3336737,3336825,88,1,0,0,1
3336826,3336984,158,0,0,1,1
3336983,3338579,1596,1,0,0,2
3336985,3338562,1577,1,0,0,1
3337004,3338543,1539,0,1,0,1
3337006,3338564,1558,0,1,0,2
3338563,3338676,113,0,0,1,1
3338580,3338677,97,0,0,1,2
3338677,3338700,23,1,0,0,1
3338678,3338701,23,1,0,0,2
3338701,3339963,1262,0,0,1,1
3338702,3339962,1260,0,0,1,2
3339963,3341474,1511,1,0,0,2
3339964,3340028,64,1,0,0,1
3340029,3340166,137,0,0,1,1
3340073,3341455,1382,0,1,0,2
3340167,3340187,20,1,0,0,1
3340188,3341118,930,0,0,1,1
3341119,3341161,42,1,0,0,1
3341162,3341412,250,0,0,1,1
3341413,3341471,58,1,0,0,1
3341472,3341571,99,0,0,1,1
3341475,3341571,96,0,0,1,2
3341572,3341588,16,1,0,0,2
3341572,3341595,23,1,0,0,1
3341589,3342432,843,0,0,1,2
3341596,3341913,317,0,0,1,1
3341914,3341918,4,1,0,0,1
3341919,3342431,512,0,0,1,1
3342432,3342473,41,1,0,0,1
3342433,3342476,43,1,0,0,2
3342474,3342842,368,0,0,1,1
3342477,3342842,365,0,0,1,2
3342843,3342886,43,1,0,0,1
3342843,3342887,44,1,0,0,2
3342887,3343200,313,0,0,1,1
3342888,3343042,154,0,0,1,2
3343043,3343060,17,1,0,0,2
3343061,3343187,126,0,0,1,2
3343188,3343770,582,1,0,0,2
3343201,3343587,386,1,0,0,1
3343212,3343761,549,0,1,0,2
3343222,3343506,284,0,1,0,1
3343588,3343893,305,0,0,1,1
3343771,3343895,124,0,0,1,2
3343894,3343943,49,1,0,0,1
3343896,3343978,82,1,0,0,2
3343944,3344247,303,0,0,1,1
3343979,3344249,270,0,0,1,2
3344248,3344295,47,1,0,0,1
3344250,3344295,45,1,0,0,2
3344296,3344397,101,0,0,1,1
3344296,3344399,103,0,0,1,2
3344398,3344438,40,1,0,0,1
3344400,3344419,19,1,0,0,2
3344420,3345679,1259,0,0,1,2
3344439,3344694,255,0,0,1,1
3344695,3345048,353,1,0,0,1
3345049,3345679,630,0,0,1,1
3345680,3345736,56,1,0,0,1
3345680,3345759,79,1,0,0,2
3345737,3345847,110,0,0,1,1
3345760,3345847,87,0,0,1,2
3345848,3345866,18,1,0,0,2
3345848,3345869,21,1,0,0,1
3345867,3346792,925,0,0,1,2
3345870,3346090,220,0,0,1,1
3346091,3346095,4,1,0,0,1
3346096,3346790,694,0,0,1,1
3346791,3346829,38,1,0,0,1
3346793,3346828,35,1,0,0,2
3346829,3347077,248,0,0,1,2
3346830,3347076,246,0,0,1,1
3347077,3347130,53,1,0,0,1
3347078,3347131,53,1,0,0,2
3347131,3347237,106,0,0,1,1
3347132,3347240,108,0,0,1,2
3347238,3347263,25,1,0,0,1
3347241,3347261,20,1,0,0,2
3347262,3348136,874,0,0,1,2
3347264,3347539,275,0,0,1,1
3347540,3347550,10,1,0,0,1
3347551,3348136,585,0,0,1,1
3348137,3348177,40,1,0,0,1
3348137,3348178,41,1,0,0,2
3348178,3348489,311,0,0,1,1
3348179,3348489,310,0,0,1,2
3348490,3348544,54,1,0,0,2
3348490,3348549,59,1,0,0,1
3348545,3348650,105,0,0,1,2
3348550,3348647,97,0,0,1,1
3348648,3348671,23,1,0,0,1
3348651,3348673,22,1,0,0,2
3348672,3348843,171,0,0,1,1
3348674,3348880,206,0,0,1,2
3348844,3349527,683,1,0,0,1
3348881,3349496,615,1,0,0,2
3348903,3349326,423,0,1,0,1
3348910,3349185,275,0,1,0,2
3349223,3349246,23,0,1,0,2
3349497,3349518,21,0,0,1,2
3349519,3349585,66,1,0,0,2
3349528,3349576,48,0,0,1,1
3349577,3350024,447,1,0,0,1
3349586,3349938,352,0,0,1,2
3349939,3350041,102,1,0,0,2
3350025,3350094,69,0,0,1,1
3350042,3350095,53,0,0,1,2
3350095,3350137,42,1,0,0,1
3350096,3350139,43,1,0,0,2
3350138,3350225,87,0,0,1,1
3350140,3350223,83,0,0,1,2
3350224,3350260,36,1,0,0,2
3350226,3350250,24,1,0,0,1
3350251,3350942,691,0,0,1,1
3350261,3350943,682,0,0,1,2
3350943,3351012,69,1,0,0,1
3350944,3351013,69,1,0,0,2
3351013,3351312,299,0,0,1,1
3351014,3351313,299,0,0,1,2
3351313,3351372,59,1,0,0,1
3351314,3351371,57,1,0,0,2
3351372,3351480,108,0,0,1,2
3351373,3351477,104,0,0,1,1
3351478,3351502,24,1,0,0,1
3351481,3351505,24,1,0,0,2
3351503,3351764,261,0,0,1,1
3351506,3351767,261,0,0,1,2
3351765,3351779,14,1,0,0,1
3351768,3351778,10,1,0,0,2
3351779,3352432,653,0,0,1,2
3351780,3352432,652,0,0,1,1
3352433,3352545,112,1,0,0,1
3352433,3352549,116,1,0,0,2
3352546,3352830,284,0,0,1,1
3352550,3352830,280,0,0,1,2
3352831,3352887,56,1,0,0,1
3352831,3352903,72,1,0,0,2
3352888,3353022,134,0,0,1,1
3352904,3353023,119,0,0,1,2
3353023,3353042,19,1,0,0,1
3353024,3353037,13,1,0,0,2
3353038,3354132,1094,0,0,1,2
3353043,3354130,1087,0,0,1,1
3354131,3354177,46,1,0,0,1
3354133,3354177,44,1,0,0,2
3354178,3354316,138,0,0,1,1
3354178,3354316,138,0,0,1,2
3354317,3354360,43,1,0,0,1
3354317,3354371,54,1,0,0,2
3354361,3355803,1442,0,0,1,1
3354372,3355802,1430,0,0,1,2
3355803,3355859,56,1,0,0,2
3355804,3355862,58,1,0,0,1
3355860,3356796,936,0,0,1,2
3355863,3356066,203,0,0,1,1
3356067,3356087,20,1,0,0,1
3356088,3356795,707,0,0,1,1
3356796,3356868,72,1,0,0,1
3356797,3356867,70,1,0,0,2
3356868,3357217,349,0,0,1,2
3356869,3357216,347,0,0,1,1
3357217,3357272,55,1,0,0,1
3357218,3357283,65,1,0,0,2
3357273,3357363,90,0,0,1,1
3357284,3357361,77,0,0,1,2
3357362,3357456,94,1,0,0,2
3357364,3357403,39,1,0,0,1
3357404,3357659,255,0,0,1,1
3357457,3357663,206,0,0,1,2
3357660,3357664,4,1,0,0,1
3357664,3358416,752,1,0,0,2
3357665,3357756,91,0,0,1,1
3357757,3358283,526,1,0,0,1
3357779,3358379,600,0,1,0,2
3357787,3358273,486,0,1,0,1
3358284,3358313,29,0,0,1,1
3358314,3358383,69,1,0,0,1
3358326,3358327,1,0,1,0,1
3358384,3358709,325,0,0,1,1
3358417,3358709,292,0,0,1,2
3358710,3358764,54,1,0,0,2
3358710,3358769,59,1,0,0,1
3358765,3359444,679,0,0,1,2
3358770,3358988,218,0,0,1,1
3358989,3359004,15,1,0,0,1
3359005,3359705,700,0,0,1,1
3359445,3359465,20,1,0,0,2
3359466,3359557,91,0,0,1,2
3359558,3359799,241,1,0,0,2
3359706,3359765,59,1,0,0,1
3359766,3360137,371,0,0,1,1
3359800,3360135,335,0,0,1,2
3360136,3361284,1148,1,0,0,2
3360138,3360223,85,1,0,0,1
3360159,3361253,1094,0,1,0,2
3360187,3360214,27,0,1,0,1
3360224,3360280,56,0,0,1,1
3360281,3361240,959,1,0,0,1
3360292,3361201,909,0,1,0,1
3361241,3361595,354,0,0,1,1
3361285,3361361,76,0,0,1,2
3361362,3361479,117,1,0,0,2
3361480,3361587,107,0,0,1,2
3361588,3361674,86,1,0,0,2
3361596,3361655,59,1,0,0,1
3361656,3361775,119,0,0,1,1
3361675,3361776,101,0,0,1,2
3361776,3361797,21,1,0,0,1
3361777,3361794,17,1,0,0,2
3361795,3362143,348,0,0,1,2
3361798,3362153,355,0,0,1,1
3362144,3362426,282,1,0,0,2
3362154,3362398,244,1,0,0,1
3362173,3362361,188,0,1,0,2
3362175,3362359,184,0,1,0,1
3362399,3362806,407,0,0,1,1
3362427,3362807,380,0,0,1,2
3362807,3362864,57,1,0,0,1
3362808,3362856,48,1,0,0,2
3362857,3363143,286,0,0,1,2
3362865,3363143,278,0,0,1,1
3363144,3363182,38,1,0,0,2
3363144,3363184,40,1,0,0,1
3363183,3364614,1431,0,0,1,2
3363185,3364614,1429,0,0,1,1
3364615,3364664,49,1,0,0,1
3364615,3364668,53,1,0,0,2
3364665,3364750,85,0,0,1,1
3364669,3364750,81,0,0,1,2
3364751,3364779,28,1,0,0,2
3364751,3364784,33,1,0,0,1
3364780,3364858,78,0,0,1,2
3364785,3364857,72,0,0,1,1
3364858,3364880,22,1,0,0,1
3364859,3364884,25,1,0,0,2
3364881,3365193,312,0,0,1,1
3364885,3365186,301,0,0,1,2
3365187,3365442,255,1,0,0,2
3365194,3365469,275,1,0,0,1
3365220,3365404,184,0,1,0,1
3365221,3365392,171,0,1,0,2
3365443,3365556,113,0,0,1,2
3365470,3365555,85,0,0,1,1
3365556,3365630,74,1,0,0,1
3365557,3365633,76,1,0,0,2
3365631,3365814,183,0,0,1,1
3365634,3365814,180,0,0,1,2
3365815,3365835,20,1,0,0,2
3365815,3365838,23,1,0,0,1
3365836,3366045,209,0,0,1,2
3365839,3366049,210,0,0,1,1
3366046,3366649,603,1,0,0,2
3366050,3366525,475,1,0,0,1
3366072,3366514,442,0,1,0,1
3366076,3366554,478,0,1,0,2
3366526,3366586,60,0,0,1,1
3366587,3366653,66,1,0,0,1
3366650,3366838,188,0,0,1,2
3366654,3366836,182,0,0,1,1
3366837,3366862,25,1,0,0,1
3366839,3366866,27,1,0,0,2
3366863,3367035,172,0,0,1,1
3366867,3367033,166,0,0,1,2
3367034,3367243,209,1,0,0,2
3367036,3367246,210,1,0,0,1
3367055,3367194,139,0,1,0,1
3367058,3367198,140,0,1,0,2
3367244,3367441,197,0,0,1,2
3367247,3367440,193,0,0,1,1
3367441,3367447,6,1,0,0,1
3367442,3367450,8,1,0,0,2
3367448,3369355,1907,0,0,1,1
3367451,3369354,1903,0,0,1,2
3369355,3369409,54,1,0,0,2
3369356,3369403,47,1,0,0,1
3369404,3369587,183,0,0,1,1
3369410,3369576,166,0,0,1,2
3369577,3369882,305,1,0,0,2
3369588,3369862,274,1,0,0,1
3369605,3369804,199,0,1,0,1
3369611,3369829,218,0,1,0,2
3369863,3370805,942,0,0,1,1
3369883,3370806,923,0,0,1,2
3370806,3370840,34,1,0,0,1
3370807,3370841,34,1,0,0,2
3370841,3371274,433,0,0,1,1
3370842,3371274,432,0,0,1,2
3371275,3371302,27,1,0,0,2
3371275,3371303,28,1,0,0,1
3371303,3371542,239,0,0,1,2
3371304,3371541,237,0,0,1,1
3371542,3371583,41,1,0,0,1
3371543,3371582,39,1,0,0,2
3371583,3372759,1176,0,0,1,2
3371584,3372760,1176,0,0,1,1
3372760,3372850,90,1,0,0,2
3372761,3372821,60,1,0,0,1
3372822,3373108,286,0,0,1,1
3372851,3373103,252,0,0,1,2
3373104,3373187,83,1,0,0,2
3373109,3373188,79,1,0,0,1
3373188,3373307,119,0,0,1,2
3373189,3373305,116,0,0,1,1
3373306,3373343,37,1,0,0,1
3373308,3373348,40,1,0,0,2
3373344,3373500,156,0,0,1,1
3373349,3374552,1203,0,0,1,2
3373501,3373510,9,1,0,0,1
3373511,3374553,1042,0,0,1,1
3374553,3374605,52,1,0,0,2
3374554,3374603,49,1,0,0,1
3374604,3374798,194,0,0,1,1
3374606,3374787,181,0,0,1,2
3374788,3375244,456,1,0,0,2
3374799,3375112,313,1,0,0,1
3374818,3375048,230,0,1,0,1
3374820,3375102,282,0,1,0,2
3375113,3376748,1635,0,0,1,1
3375245,3375643,398,0,0,1,2
3375644,3375725,81,1,0,0,2
3375726,3375849,123,0,0,1,2
3375850,3376000,150,1,0,0,2
3376001,3376234,233,0,0,1,2
3376235,3376252,17,1,0,0,2
3376253,3376395,142,0,0,1,2
3376396,3376433,37,1,0,0,2
3376434,3376737,303,0,0,1,2
3376738,3377083,345,1,0,0,2
3376749,3377068,319,1,0,0,1
3376765,3377031,266,0,1,0,2
3376773,3376988,215,0,1,0,1
3377069,3377956,887,0,0,1,1
3377084,3377639,555,0,0,1,2
3377640,3377669,29,1,0,0,2
3377670,3377958,288,0,0,1,2
3377957,3378045,88,1,0,0,1
3377959,3378044,85,1,0,0,2
3378045,3378159,114,0,0,1,2
3378046,3378155,109,0,0,1,1
3378156,3378179,23,1,0,0,1
3378160,3378182,22,1,0,0,2
3378180,3378778,598,0,0,1,1
3378183,3379276,1093,0,0,1,2
3378779,3378845,66,1,0,0,1
3378846,3378880,34,0,0,1,1
3378881,3378886,5,1,0,0,1
3378887,3378992,105,0,0,1,1
3378993,3379029,36,1,0,0,1
3379030,3379278,248,0,0,1,1
3379277,3379325,48,1,0,0,2
3379279,3379331,52,1,0,0,1
3379326,3379608,282,0,0,1,2
3379332,3379607,275,0,0,1,1
3379608,3379662,54,1,0,0,1
3379609,3379651,42,1,0,0,2
3379652,3379796,144,0,0,1,2
3379663,3379784,121,0,0,1,1
3379785,3380213,428,1,0,0,1
3379797,3380227,430,1,0,0,2
3379821,3380116,295,0,1,0,1
3379826,3380218,392,0,1,0,2
3380144,3380172,28,0,1,0,1
3380201,3380204,3,0,1,0,1
3380214,3381705,1491,0,0,1,1
3380228,3380753,525,0,0,1,2
3380754,3380770,16,1,0,0,2
3380771,3381342,571,0,0,1,2
3381343,3381377,34,1,0,0,2
3381378,3381481,103,0,0,1,2
3381482,3381488,6,1,0,0,2
3381489,3381703,214,0,0,1,2
3381704,3381760,56,1,0,0,2
3381706,3381758,52,1,0,0,1
3381759,3382617,858,0,0,1,1
3381761,3382616,855,0,0,1,2
3382617,3382686,69,1,0,0,2
3382618,3382671,53,1,0,0,1
3382672,3382824,152,0,0,1,1
3382687,3382825,138,0,0,1,2
3382825,3386206,3381,1,0,0,1
3382826,3386248,3422,1,0,0,2
3382858,3386169,3311,0,1,0,2
3382862,3386195,3333,0,1,0,1
3386207,3386357,150,0,0,1,1
3386249,3386357,108,0,0,1,2
3386358,3386398,40,1,0,0,1
3386358,3386398,40,1,0,0,2
3386399,3386504,105,0,0,1,2
3386399,3386505,106,0,0,1,1
3386505,3386545,40,1,0,0,2
3386506,3386528,22,1,0,0,1
3386529,3386846,317,0,0,1,1
3386546,3386856,310,0,0,1,2
3386847,3386854,7,1,0,0,1
3386855,3388676,1821,0,0,1,1
3386857,3386899,42,1,0,0,2
3386900,3387494,594,0,0,1,2
3387495,3387556,61,1,0,0,2
3387557,3388404,847,0,0,1,2
3388405,3388433,28,1,0,0,2
3388434,3388627,193,0,0,1,2
3388628,3388726,98,1,0,0,2
3388677,3388731,54,1,0,0,1
3388727,3388855,128,0,0,1,2
3388732,3388853,121,0,0,1,1
3388854,3388872,18,1,0,0,1
3388856,3388875,19,1,0,0,2
3388873,3388982,109,0,0,1,1
3388876,3388988,112,0,0,1,2
3388983,3389260,277,1,0,0,1
3388989,3389279,290,1,0,0,2
3389001,3389233,232,0,1,0,1
3389005,3389235,230,0,1,0,2
3389261,3389790,529,0,0,1,1
3389280,3389787,507,0,0,1,2
3389788,3389803,15,1,0,0,2
3389791,3389801,10,1,0,0,1
3389802,3392660,2858,0,0,1,1
3389804,3392661,2857,0,0,1,2
3392661,3392712,51,1,0,0,1
3392662,3392713,51,1,0,0,2
3392713,3392834,121,0,0,1,1
3392714,3392835,121,0,0,1,2
3392835,3392885,50,1,0,0,1
3392836,3392888,52,1,0,0,2
3392886,3393002,116,0,0,1,1
3392889,3394158,1269,0,0,1,2
3393003,3393013,10,1,0,0,1
3393014,3393058,44,0,0,1,1
3393059,3393074,15,1,0,0,1
3393075,3393795,720,0,0,1,1
3393796,3393846,50,1,0,0,1
3393847,3394484,637,0,0,1,1
3394159,3394168,9,1,0,0,2
3394169,3394817,648,0,0,1,2
3394495,3394868,373,0,1,0,1
3394818,3394870,52,1,0,0,2
3394871,3394955,84,0,0,1,2
3394878,3394879,1,1,0,0,1
3394880,3395000,120,0,0,1,1
3394956,3395020,64,1,0,0,2
3395001,3395012,11,1,0,0,1
3395013,3395391,378,0,0,1,1
3395021,3395394,373,0,0,1,2
3395392,3395790,398,1,0,0,1
3395395,3395733,338,1,0,0,2
3395431,3395702,271,0,1,0,1
3395440,3395665,225,0,1,0,2
3395734,3397023,1289,0,0,1,2
3395791,3396569,778,0,0,1,1
3396570,3396585,15,1,0,0,1
3396586,3396839,253,0,0,1,1
3396840,3397017,177,1,0,0,1
3397018,3397045,27,0,0,1,1
3397024,3397239,215,1,0,0,2
3397046,3397171,125,1,0,0,1
3397172,3397524,352,0,0,1,1
3397240,3398749,1509,0,0,1,2
3397525,3397575,50,1,0,0,1
3397576,3398749,1173,0,0,1,1
3398750,3398815,65,1,0,0,1
3398750,3398822,72,1,0,0,2
3398816,3398921,105,0,0,1,1
3398823,3398920,97,0,0,1,2
3398921,3398956,35,1,0,0,2
3398922,3398957,35,1,0,0,1
3398957,3399087,130,0,0,1,2
3398958,3399083,125,0,0,1,1
3399084,3399100,16,1,0,0,1
3399088,3399094,6,1,0,0,2
3399095,3399911,816,0,0,1,2
3399101,3399711,610,0,0,1,1
3399712,3399726,14,1,0,0,1
3399727,3399924,197,0,0,1,1
3399912,3400340,428,1,0,0,2
3399925,3400340,415,1,0,0,1
3399943,3400316,373,0,1,0,1
3399944,3400311,367,0,1,0,2
3400341,3400424,83,0,0,1,1
3400341,3400429,88,0,0,1,2
3400425,3400447,22,1,0,0,1
3400430,3400442,12,1,0,0,2
3400443,3400814,371,0,0,1,2
3400448,3400822,374,0,0,1,1
3400815,3401294,479,1,0,0,2
3400823,3401203,380,1,0,0,1
3400836,3401274,438,0,1,0,2
3400843,3401132,289,0,1,0,1
3401204,3401420,216,0,0,1,1
3401295,3401418,123,0,0,1,2
3401419,3401445,26,1,0,0,2
3401421,3401440,19,1,0,0,1
3401441,3402118,677,0,0,1,1
3401446,3402112,666,0,0,1,2
3402113,3402661,548,1,0,0,2
3402119,3402520,401,1,0,0,1
3402132,3402622,490,0,1,0,2
3402143,3402406,263,0,1,0,1
3402521,3403390,869,0,0,1,1
3402662,3402690,28,0,0,1,2
3402691,3402863,172,1,0,0,2
3402864,3403391,527,0,0,1,2
3403391,3403440,49,1,0,0,1
3403392,3403453,61,1,0,0,2
3403441,3403556,115,0,0,1,1
3403454,3403558,104,0,0,1,2
3403557,3403598,41,1,0,0,1
3403559,3403608,49,1,0,0,2
3403599,3403719,120,0,0,1,1
3403609,3403720,111,0,0,1,2
3403720,3403738,18,1,0,0,1
3403721,3403737,16,1,0,0,2
3403738,3405373,1635,0,0,1,2
3403739,3405374,1635,0,0,1,1
3405374,3405418,44,1,0,0,2
3405375,3405413,38,1,0,0,1
3405414,3405570,156,0,0,1,1
3405419,3405583,164,0,0,1,2
3405571,3405983,412,1,0,0,1
3405584,3405916,332,1,0,0,2
3405595,3405864,269,0,1,0,1
3405601,3405871,270,0,1,0,2
3405917,3407501,1584,0,0,1,2
3405984,3407502,1518,0,0,1,1
3407502,3407529,27,1,0,0,2
3407503,3407531,28,1,0,0,1
3407530,3407662,132,0,0,1,2
3407532,3407667,135,0,0,1,1
3407663,3408062,399,1,0,0,2
3407668,3408093,425,1,0,0,1
3407691,3407964,273,0,1,0,1
3407695,3408044,349,0,1,0,2
3408063,3408353,290,0,0,1,2
3408094,3408354,260,0,0,1,1
3408354,3408394,40,1,0,0,2
3408355,3408396,41,1,0,0,1
3408395,3409316,921,0,0,1,2
3408397,3409315,918,0,0,1,1
3409316,3409384,68,1,0,0,1
3409317,3409386,69,1,0,0,2
3409385,3409487,102,0,0,1,1
3409387,3409488,101,0,0,1,2
3409488,3409524,36,1,0,0,1
3409489,3409524,35,1,0,0,2
3409525,3410860,1335,0,0,1,1
3409525,3410860,1335,0,0,1,2
3410861,3410915,54,1,0,0,2
3410861,3410916,55,1,0,0,1
3410916,3411189,273,0,0,1,2
3410917,3411188,271,0,0,1,1
3411189,3411473,284,1,0,0,1
3411190,3411498,308,1,0,0,2
3411209,3411418,209,0,1,0,1
3411213,3411434,221,0,1,0,2
3411474,3411497,23,0,0,1,1
3411498,3411513,15,1,0,0,1
3411499,3412143,644,0,0,1,2
3411514,3412139,625,0,0,1,1
3412140,3412442,302,1,0,0,1
3412144,3412470,326,1,0,0,2
3412164,3412404,240,0,1,0,2
3412169,3412389,220,0,1,0,1
3412443,3413121,678,0,0,1,1
3412471,3413122,651,0,0,1,2
3413122,3413143,21,1,0,0,1
3413123,3413141,18,1,0,0,2
3413142,3413867,725,0,0,1,2
3413144,3413868,724,0,0,1,1
3413868,3413891,23,1,0,0,2
3413869,3413892,23,1,0,0,1
3413892,3414538,646,0,0,1,2
3413893,3414538,645,0,0,1,1
3414539,3414597,58,1,0,0,2
3414539,3414600,61,1,0,0,1
3414598,3414810,212,0,0,1,2
3414601,3414811,210,0,0,1,1
3414811,3414830,19,1,0,0,2
3414812,3414837,25,1,0,0,1
3414831,3416559,1728,0,0,1,2
3414838,3416559,1721,0,0,1,1
3416560,3416593,33,1,0,0,1
3416560,3416615,55,1,0,0,2
3416594,3416766,172,0,0,1,1
3416616,3416772,156,0,0,1,2
3416767,3416785,18,1,0,0,1
3416773,3416782,9,1,0,0,2
3416783,3416844,61,0,0,1,2
3416786,3416845,59,0,0,1,1
3416845,3420615,3770,1,0,0,2
3416846,3417217,371,1,0,0,1
3416864,3420564,3700,0,1,0,2
3416873,3417166,293,0,1,0,1
3417218,3417257,39,0,0,1,1
3417258,3417286,28,1,0,0,1
3417287,3417955,668,0,0,1,1
3417956,3417978,22,1,0,0,1
3417979,3418754,775,0,0,1,1
3418755,3418779,24,1,0,0,1
3418780,3419151,371,0,0,1,1
3419152,3419172,20,1,0,0,1
3419173,3419458,285,0,0,1,1
3419459,3419477,18,1,0,0,1
3419478,3420405,927,0,0,1,1
3420406,3420468,62,1,0,0,1
3420469,3420515,46,0,0,1,1
3420516,3420606,90,1,0,0,1
3420607,3420727,120,0,0,1,1
3420616,3420725,109,0,0,1,2
3420726,3420750,24,1,0,0,2
3420728,3420746,18,1,0,0,1
3420747,3422297,1550,0,0,1,1
3420751,3422297,1546,0,0,1,2
3422298,3422335,37,1,0,0,1
3422298,3422336,38,1,0,0,2
3422336,3422553,217,0,0,1,1
3422337,3422550,213,0,0,1,2
3422551,3422926,375,1,0,0,2
3422554,3422899,345,1,0,0,1
3422597,3422840,243,0,1,0,1
3422600,3422850,250,0,1,0,2
3422900,3422983,83,0,0,1,1
3422927,3422982,55,0,0,1,2
3422983,3422998,15,1,0,0,2
3422984,3423003,19,1,0,0,1
3422999,3424383,1384,0,0,1,2
3423004,3424391,1387,0,0,1,1
3424384,3424803,419,1,0,0,2
3424392,3424792,400,1,0,0,1
3424413,3424701,288,0,1,0,1
3424415,3424750,335,0,1,0,2
3424793,3424820,27,0,0,1,1
3424804,3424845,41,0,0,1,2
3424821,3424828,7,1,0,0,1
3424829,3424997,168,0,0,1,1
3424846,3424936,90,1,0,0,2
3424937,3424996,59,0,0,1,2
3424997,3425043,46,1,0,0,2
3424998,3425045,47,1,0,0,1
3425044,3426176,1132,0,0,1,2
3425046,3426177,1131,0,0,1,1
3426177,3426208,31,1,0,0,2
3426178,3426205,27,1,0,0,1
3426206,3427191,985,0,0,1,1
3426209,3427188,979,0,0,1,2
3427189,3427576,387,1,0,0,2
3427192,3427553,361,1,0,0,1
3427206,3427557,351,0,1,0,2
3427212,3427472,260,0,1,0,1
3427554,3427752,198,0,0,1,1
3427577,3427752,175,0,0,1,2
3427753,3427792,39,1,0,0,1
3427753,3427792,39,1,0,0,2
3427793,3427944,151,0,0,1,1
3427793,3428355,562,0,0,1,2
3427945,3427956,11,1,0,0,1
3427957,3428360,403,0,0,1,1
3428356,3428985,629,1,0,0,2
3428361,3428831,470,1,0,0,1
3428383,3428893,510,0,1,0,2
3428391,3428761,370,0,1,0,1
3428832,3429419,587,0,0,1,1
3428986,3429119,133,0,0,1,2
3429120,3429195,75,1,0,0,2
3429196,3429911,715,0,0,1,2
3429420,3429424,4,1,0,0,1
3429425,3429915,490,0,0,1,1
3429912,3430628,716,1,0,0,2
3429916,3430564,648,1,0,0,1
3429935,3430482,547,0,1,0,2
3429940,3430285,345,0,1,0,1
3430565,3430673,108,0,0,1,1
3430629,3430660,31,0,0,1,2
3430661,3431083,422,1,0,0,2
3430674,3430712,38,1,0,0,1
3430713,3431084,371,0,0,1,1
3431084,3431113,29,0,0,1,2
3431085,3431120,35,1,0,0,1
3431114,3431474,360,1,0,0,2
3431121,3431161,40,0,0,1,1
3431162,3431193,31,1,0,0,1
3431194,3431398,204,0,0,1,1
3431399,3431407,8,1,0,0,1
3431408,3431648,240,0,0,1,1
3431475,3431531,56,0,0,1,2
3431532,3431550,18,1,0,0,2
3431551,3431613,62,0,0,1,2
3431614,3431708,94,1,0,0,2
3431649,3431936,287,1,0,0,1
3431709,3431816,107,0,0,1,2
3431817,3431842,25,1,0,0,2
3431843,3432433,590,0,0,1,2
3431937,3432440,503,0,0,1,1
3432434,3432455,21,1,0,0,2
3432441,3432490,49,1,0,0,1
3432456,3432574,118,0,0,1,2
3432491,3432577,86,0,0,1,1
3432575,3432631,56,1,0,0,2
3432578,3432626,48,1,0,0,1
3432627,3432881,254,0,0,1,1
3432632,3432882,250,0,0,1,2
3432882,3432901,19,1,0,0,1
3432883,3432899,16,1,0,0,2
3432900,3433625,725,0,0,1,2
3432902,3433619,717,0,0,1,1
3433620,3433988,368,1,0,0,1
3433626,3434077,451,1,0,0,2
3433645,3433912,267,0,1,0,1
3433646,3433995,349,0,1,0,2
3433989,3434115,126,0,0,1,1
3434078,3434111,33,0,0,1,2
3434112,3434130,18,1,0,0,2
3434116,3434126,10,1,0,0,1
3434127,3434864,737,0,0,1,1
3434131,3434866,735,0,0,1,2
3434865,3434883,18,1,0,0,1
3434867,3434882,15,1,0,0,2
3434883,3435015,132,0,0,1,2
3434884,3435050,166,0,0,1,1
3435016,3435528,512,1,0,0,2
3435051,3435385,334,1,0,0,1
3435064,3435381,317,0,1,0,2
3435069,3435335,266,0,1,0,1
3435386,3435902,516,0,0,1,1
3435529,3435903,374,0,0,1,2
3435903,3435982,79,1,0,0,1
3435904,3436219,315,1,0,0,2
3435983,3436247,264,0,0,1,1
3436220,3436258,38,0,0,1,2
3436248,3436288,40,1,0,0,1
3436259,3436421,162,1,0,0,2
3436289,3436325,36,0,0,1,1
3436326,3436915,589,1,0,0,1
3436337,3436343,6,0,1,0,1
3436365,3436906,541,0,1,0,1
3436422,3436453,31,0,0,1,2
3436454,3436499,45,1,0,0,2
3436500,3436536,36,0,0,1,2
3436537,3436573,36,1,0,0,2
3436574,3436798,224,0,0,1,2
3436799,3436816,17,1,0,0,2
3436817,3436852,35,0,0,1,2
3436853,3436930,77,1,0,0,2
3436916,3437163,247,0,0,1,1
3436931,3437149,218,0,0,1,2
3437150,3437503,353,1,0,0,2
3437164,3437510,346,1,0,0,1
3437207,3437446,239,0,1,0,1
3437211,3437421,210,0,1,0,2
3437504,3437537,33,0,0,1,2
3437511,3438138,627,0,0,1,1
3437538,3437542,4,1,0,0,2
3437543,3438136,593,0,0,1,2
3438137,3438161,24,1,0,0,2
3438139,3438161,22,1,0,0,1
3438162,3439057,895,0,0,1,2
3438162,3439065,903,0,0,1,1
3439058,3439574,516,1,0,0,2
3439066,3439472,406,1,0,0,1
3439091,3439365,274,0,1,0,1
3439093,3439406,313,0,1,0,2
3439473,3439612,139,0,0,1,1
3439575,3439622,47,0,0,1,2
3439613,3439631,18,1,0,0,1
3439623,3439773,150,1,0,0,2
3439632,3439736,104,0,0,1,1
3439737,3439772,35,1,0,0,1
3439773,3440211,438,0,0,1,1
3439774,3440020,246,0,0,1,2
3440021,3440071,50,1,0,0,2
3440072,3440210,138,0,0,1,2
3440211,3440296,85,1,0,0,2
3440212,3440283,71,1,0,0,1
3440284,3440395,111,0,0,1,1
3440297,3440396,99,0,0,1,2
3440396,3440416,20,1,0,0,1
3440397,3440425,28,1,0,0,2
3440417,3441953,1536,0,0,1,1
3440426,3441755,1329,0,0,1,2
3441756,3441771,15,1,0,0,2
3441772,3441802,30,0,0,1,2
3441803,3441807,4,1,0,0,2
3441808,3441955,147,0,0,1,2
3441954,3442004,50,1,0,0,1
3441956,3442019,63,1,0,0,2
3442005,3442220,215,0,0,1,1
3442020,3442222,202,0,0,1,2
3442221,3442243,22,1,0,0,1
3442223,3442252,29,1,0,0,2
3442244,3442348,104,0,0,1,1
3442253,3442338,85,0,0,1,2
3442339,3442609,270,1,0,0,2
3442349,3442604,255,1,0,0,1
3442369,3442551,182,0,1,0,1
3442376,3442556,180,0,1,0,2
3442605,3444289,1684,0,0,1,1
3442610,3444291,1681,0,0,1,2
3444290,3444316,26,1,0,0,1
3444292,3444319,27,1,0,0,2
3444317,3444748,431,0,0,1,1
3444320,3444747,427,0,0,1,2
3444748,3444786,38,1,0,0,2
3444749,3444786,37,1,0,0,1
3444787,3445402,615,0,0,1,2
3444787,3445403,616,0,0,1,1
3445403,3445457,54,1,0,0,2
3445404,3445453,49,1,0,0,1
3445454,3446012,558,0,0,1,1
3445458,3446012,554,0,0,1,2
3446013,3446073,60,1,0,0,1
3446013,3446076,63,1,0,0,2
3446074,3446166,92,0,0,1,1
3446077,3446165,88,0,0,1,2
3446166,3446204,38,1,0,0,2
3446167,3446201,34,1,0,0,1
3446202,3446339,137,0,0,1,1
3446205,3446340,135,0,0,1,2
3446340,3446348,8,1,0,0,1
3446341,3446355,14,1,0,0,2
3446349,3447736,1387,0,0,1,1
3446356,3447735,1379,0,0,1,2
3447736,3447775,39,1,0,0,2
3447737,3447774,37,1,0,0,1
3447775,3448029,254,0,0,1,1
3447776,3448023,247,0,0,1,2
3448024,3448356,332,1,0,0,2
3448030,3448317,287,1,0,0,1
3448050,3448271,221,0,1,0,1
3448056,3448285,229,0,1,0,2
3448318,3448946,628,0,0,1,1
3448357,3448947,590,0,0,1,2
3448947,3449226,279,1,0,0,1
3448948,3449254,306,1,0,0,2
3448968,3449174,206,0,1,0,1
3448968,3449180,212,0,1,0,2
3449227,3449953,726,0,0,1,1
3449255,3449953,698,0,0,1,2
3449954,3449981,27,1,0,0,1
3449954,3449982,28,1,0,0,2
3449982,3450395,413,0,0,1,1
3449983,3450396,413,0,0,1,2
3450396,3450449,53,1,0,0,1
3450397,3450443,46,1,0,0,2
3450444,3451796,1352,0,0,1,2
3450450,3451798,1348,0,0,1,1
3451797,3451813,16,1,0,0,2
3451799,3451819,20,1,0,0,1
3451814,3452830,1016,0,0,1,2
3451820,3452828,1008,0,0,1,1
3452829,3452885,56,1,0,0,1
3452831,3452897,66,1,0,0,2
3452886,3452992,106,0,0,1,1
3452898,3452992,94,0,0,1,2
3452993,3453018,25,1,0,0,1
3452993,3453029,36,1,0,0,2
3453019,3453155,136,0,0,1,1
3453030,3453159,129,0,0,1,2
3453156,3453455,299,1,0,0,1
3453160,3453443,283,1,0,0,2
3453178,3453373,195,0,1,0,1
3453182,3453374,192,0,1,0,2
3453444,3455269,1825,0,0,1,2
3453456,3455271,1815,0,0,1,1
3455270,3455861,591,1,0,0,2
3455272,3455686,414,1,0,0,1
3455312,3455640,328,0,1,0,2
3455313,3455577,264,0,1,0,1
3455687,3456072,385,0,0,1,1
3455862,3456072,210,0,0,1,2
3456073,3456135,62,1,0,0,2
3456073,3463347,7274,1,0,0,1
3456120,3463336,7216,0,1,0,1
3456136,3456249,113,0,0,1,2
3456250,3463354,7104,1,0,0,2
3456265,3463344,7079,0,1,0,2
3463348,3463419,71,0,0,1,1
3463355,3463422,67,0,0,1,2
3463420,3463448,28,1,0,0,1
3463423,3463445,22,1,0,0,2
3463446,3463539,93,0,0,1,2
3463449,3463541,92,0,0,1,1
3463540,3463912,372,1,0,0,2
3463542,3463848,306,1,0,0,1
3463558,3463848,290,0,1,0,2
3463563,3463791,228,0,1,0,1
3463849,3463943,94,0,0,1,1
3463913,3463939,26,0,0,1,2
3463940,3463956,16,1,0,0,2
3463944,3463959,15,1,0,0,1
3463957,3464347,390,0,0,1,2
3463960,3464358,398,0,0,1,1
3464348,3464691,343,1,0,0,2
3464359,3464645,286,1,0,0,1
3464368,3464666,298,0,1,0,2
3464377,3464601,224,0,1,0,1
3464646,3465509,863,0,0,1,1
3464692,3464715,23,0,0,1,2
3464716,3464797,81,1,0,0,2
3464798,3465498,700,0,0,1,2
3465499,3465891,392,1,0,0,2
3465510,3465822,312,1,0,0,1
3465521,3465882,361,0,1,0,2
3465530,3465757,227,0,1,0,1
3465823,3466046,223,0,0,1,1
3465892,3466047,155,0,0,1,2
3466047,3466090,43,1,0,0,1
3466048,3466091,43,1,0,0,2
3466091,3466574,483,0,0,1,1
3466092,3466576,484,0,0,1,2
3466575,3466600,25,1,0,0,1
3466577,3466610,33,1,0,0,2
3466601,3467384,783,0,0,1,1
3466611,3467384,773,0,0,1,2
3467385,3467452,67,1,0,0,1
3467385,3467455,70,1,0,0,2
3467453,3467509,56,0,0,1,1
3467456,3467509,53,0,0,1,2
3467510,3467542,32,1,0,0,2
3467510,3467544,34,1,0,0,1
3467543,3467690,147,0,0,1,2
3467545,3467694,149,0,0,1,1
3467691,3467706,15,1,0,0,2
3467695,3467705,10,1,0,0,1
3467706,3468870,1164,0,0,1,1
3467707,3468869,1162,0,0,1,2
3468870,3468930,60,1,0,0,2
3468871,3468926,55,1,0,0,1
3468927,3469207,280,0,0,1,1
3468931,3469208,277,0,0,1,2
3469208,3469493,285,1,0,0,1
3469209,3469490,281,1,0,0,2
3469228,3469430,202,0,1,0,1
3469234,3469444,210,0,1,0,2
3469491,3471017,1526,0,0,1,2
3469494,3471018,1524,0,0,1,1
3471018,3471258,240,1,0,0,2
3471019,3471256,237,1,0,0,1
3471040,3471187,147,0,1,0,1
3471041,3471202,161,0,1,0,2
3471257,3471501,244,0,0,1,1
3471259,3471502,243,0,0,1,2
3471502,3471540,38,1,0,0,1
3471503,3471540,37,1,0,0,2
3471541,3472505,964,0,0,1,1
3471541,3472505,964,0,0,1,2
3472506,3472548,42,1,0,0,2
3472506,3472557,51,1,0,0,1
3472549,3473667,1118,0,0,1,2
3472558,3472730,172,0,0,1,1
3472731,3472740,9,1,0,0,1
3472741,3473666,925,0,0,1,1
3473667,3473708,41,1,0,0,1
3473668,3473708,40,1,0,0,2
3473709,3473940,231,0,0,1,2
3473709,3473944,235,0,0,1,1
3473941,3474317,376,1,0,0,2
3473945,3474250,305,1,0,0,1
3473970,3474194,224,0,1,0,1
3473978,3474209,231,0,1,0,2
3474251,3474747,496,0,0,1,1
3474318,3474748,430,0,0,1,2
3474748,3474773,25,1,0,0,1
3474749,3474772,23,1,0,0,2
3474773,3475303,530,0,0,1,2
3474774,3475304,530,0,0,1,1
3475304,3475327,23,1,0,0,2
3475305,3475328,23,1,0,0,1
3475328,3476035,707,0,0,1,2
3475329,3476032,703,0,0,1,1
3476033,3476056,23,1,0,0,1
3476036,3476055,19,1,0,0,2
3476056,3476505,449,0,0,1,2
3476057,3476506,449,0,0,1,1
3476506,3476532,26,1,0,0,2
3476507,3476530,23,1,0,0,1
3476531,3476908,377,0,0,1,1
3476533,3476910,377,0,0,1,2
3476909,3476933,24,1,0,0,1
3476911,3476932,21,1,0,0,2
3476933,3477142,209,0,0,1,2
3476934,3477141,207,0,0,1,1
3477142,3477210,68,1,0,0,1
3477143,3482675,5532,1,0,0,2
3477211,3477579,368,0,0,1,1
3477227,3482666,5439,0,1,0,2
3477580,3477594,14,1,0,0,1
3477595,3478795,1200,0,0,1,1
3478796,3482672,3876,1,0,0,1
3478825,3482655,3830,0,1,0,1
3482673,3482739,66,0,0,1,1
3482676,3482737,61,0,0,1,2
3482738,3482766,28,1,0,0,2
3482740,3482775,35,1,0,0,1
3482767,3483837,1070,0,0,1,2
3482776,3482934,158,0,0,1,1
3482935,3482939,4,1,0,0,1
3482940,3483837,897,0,0,1,1
3483838,3483872,34,1,0,0,2
3483838,3483878,40,1,0,0,1
3483873,3484096,223,0,0,1,2
3483879,3484093,214,0,0,1,1
3484094,3484436,342,1,0,0,1
3484097,3484441,344,1,0,0,2
3484116,3484381,265,0,1,0,2
3484118,3484357,239,0,1,0,1
3484437,3484801,364,0,0,1,1
3484442,3484800,358,0,0,1,2
3484801,3484822,21,1,0,0,2
3484802,3484824,22,1,0,0,1
3484823,3484920,97,0,0,1,2
3484825,3484916,91,0,0,1,1
3484917,3485357,440,1,0,0,1
3484921,3485464,543,1,0,0,2
3484941,3485245,304,0,1,0,2
3484946,3485198,252,0,1,0,1
3485358,3485950,592,0,0,1,1
3485465,3485951,486,0,0,1,2
3485951,3485977,26,1,0,0,1
3485952,3485978,26,1,0,0,2
3485978,3486073,95,0,0,1,1
3485979,3486072,93,0,0,1,2
3486073,3486120,47,1,0,0,2
3486074,3486119,45,1,0,0,1
3486120,3486422,302,0,0,1,1
3486121,3486423,302,0,0,1,2
3486423,3486465,42,1,0,0,1
3486424,3486463,39,1,0,0,2
3486464,3486722,258,0,0,1,2
3486466,3486721,255,0,0,1,1
3486722,3486767,45,1,0,0,1
3486723,3486767,44,1,0,0,2
3486768,3487416,648,0,0,1,1
3486768,3487417,649,0,0,1,2
3487417,3487488,71,1,0,0,1
3487418,3487494,76,1,0,0,2
3487489,3487573,84,0,0,1,1
3487495,3487574,79,0,0,1,2
3487574,3487613,39,1,0,0,1
3487575,3487614,39,1,0,0,2
3487614,3487668,54,0,0,1,1
3487615,3487669,54,0,0,1,2
3487669,3487703,34,1,0,0,1
3487670,3487705,35,1,0,0,2
3487704,3488923,1219,0,0,1,1
3487706,3488923,1217,0,0,1,2
3488924,3488963,39,1,0,0,1
3488924,3488964,40,1,0,0,2
3488964,3489173,209,0,0,1,1
3488965,3489172,207,0,0,1,2
3489173,3489201,28,1,0,0,2
3489174,3489190,16,1,0,0,1
3489191,3489258,67,0,0,1,1
3489202,3489255,53,0,0,1,2
3489256,3489517,261,1,0,0,2
3489259,3489496,237,1,0,0,1
3489281,3489454,173,0,1,0,1
3489286,3489441,155,0,1,0,2
3489497,3490038,541,0,0,1,1
3489518,3490045,527,0,0,1,2
3490039,3490263,224,1,0,0,1
3490046,3490252,206,1,0,0,2
3490065,3490199,134,0,1,0,1
3490070,3490201,131,0,1,0,2
3490253,3490741,488,0,0,1,2
3490264,3490738,474,0,0,1,1
3490739,3491007,268,1,0,0,1
3490742,3491048,306,1,0,0,2
3490769,3490951,182,0,1,0,1
3490769,3490962,193,0,1,0,2
3491008,3491535,527,0,0,1,1
3491049,3491533,484,0,0,1,2
3491534,3491588,54,1,0,0,2
3491536,3491595,59,1,0,0,1
3491589,3491790,201,0,0,1,2
3491596,3491791,195,0,0,1,1
3491791,3491839,48,1,0,0,2
3491792,3491853,61,1,0,0,1
3491840,3492009,169,0,0,1,2
3491854,3492008,154,0,0,1,1
3492009,3492072,63,1,0,0,1
3492010,3492041,31,1,0,0,2
3492042,3492582,540,0,0,1,2
3492073,3492514,441,0,0,1,1
3492515,3492527,12,1,0,0,1
3492528,3492558,30,0,0,1,1
3492559,3492654,95,1,0,0,1
3492583,3492656,73,1,0,0,2
3492655,3492726,71,0,0,1,1
3492657,3492727,70,0,0,1,2
3492727,3492751,24,1,0,0,1
3492728,3492753,25,1,0,0,2
3492752,3492834,82,0,0,1,1
3492754,3492834,80,0,0,1,2
3492835,3492857,22,1,0,0,2
3492835,3492858,23,1,0,0,1
3492858,3493872,1014,0,0,1,2
3492859,3493872,1013,0,0,1,1
3493873,3493913,40,1,0,0,1
3493873,3493914,41,1,0,0,2
3493914,3494285,371,0,0,1,1
3493915,3494287,372,0,0,1,2
3494286,3494610,324,1,0,0,1
3494288,3494648,360,1,0,0,2
3494305,3494542,237,0,1,0,1
3494311,3494534,223,0,1,0,2
3494611,3495378,767,0,0,1,1
3494649,3495375,726,0,0,1,2
3495376,3495676,300,1,0,0,2
3495379,3495671,292,1,0,0,1
3495402,3495611,209,0,1,0,1
3495404,3495621,217,0,1,0,2
3495672,3496353,681,0,0,1,1
3495677,3495724,47,0,0,1,2
3495725,3495734,9,1,0,0,2
3495735,3496352,617,0,0,1,2
3496353,3496390,37,1,0,0,2
3496354,3496393,39,1,0,0,1
3496391,3497290,899,0,0,1,2
3496394,3497290,896,0,0,1,1
3497291,3497395,104,1,0,0,2
3497291,3500099,2808,1,0,0,1
3497387,3500012,2625,0,1,0,1
3497396,3497432,36,0,0,1,2
3497433,3497460,27,1,0,0,2
3497461,3497510,49,0,0,1,2
3497511,3497594,83,1,0,0,2
3497595,3497680,85,0,0,1,2
3497691,3502558,4867,0,1,0,2
3500100,3500345,245,0,0,1,1
3500346,3500421,75,1,0,0,1
3500422,3500497,75,0,0,1,1
3500498,3500523,25,1,0,0,1
3500524,3500583,59,0,0,1,1
3500584,3500719,135,1,0,0,1
3500720,3500828,108,0,0,1,1
3500829,3500854,25,1,0,0,1
3500855,3500946,91,0,0,1,1
3500947,3502535,1588,1,0,0,1
3500974,3502500,1526,0,1,0,1
3502536,3502633,97,0,0,1,1
3502568,3502569,1,1,0,0,2
3502570,3502632,62,0,0,1,2
3502633,3502659,26,1,0,0,2
3502634,3502655,21,1,0,0,1
3502656,3502927,271,0,0,1,1
3502660,3502938,278,0,0,1,2
3502928,3502942,14,1,0,0,1
3502939,3502943,4,1,0,0,2
3502943,3503764,821,0,0,1,1
3502944,3503141,197,0,0,1,2
3503142,3503805,663,1,0,0,2
3503765,3503804,39,1,0,0,1
3503805,3504007,202,0,0,1,1
3503806,3504007,201,0,0,1,2
3504008,3504042,34,1,0,0,1
3504008,3504055,47,1,0,0,2
3504043,3504243,200,0,0,1,1
3504056,3504234,178,0,0,1,2
3504235,3506799,2564,1,0,0,2
3504244,3504763,519,1,0,0,1
3504253,3506787,2534,0,1,0,2
3504262,3504632,370,0,1,0,1
3504764,3506056,1292,0,0,1,1
3506057,3506481,424,1,0,0,1
3506088,3506458,370,0,1,0,1
3506482,3506557,75,0,0,1,1
3506558,3506597,39,1,0,0,1
3506598,3506698,100,0,0,1,1
3506699,3506703,4,1,0,0,1
3506704,3507573,869,0,0,1,1
3506800,3506936,136,0,0,1,2
3506937,3506964,27,1,0,0,2
3506965,3507572,607,0,0,1,2
3507573,3507660,87,1,0,0,2
3507574,3507782,208,1,0,0,1
3507661,3507757,96,0,0,1,2
3507758,3507785,27,1,0,0,2
3507783,3507852,69,0,0,1,1
3507786,3508557,771,0,0,1,2
3507853,3507872,19,1,0,0,1
3507873,3508157,284,0,0,1,1
3508158,3508174,16,1,0,0,1
3508175,3508311,136,0,0,1,1
3508312,3508357,45,1,0,0,1
3508358,3508514,156,0,0,1,1
3508515,3508624,109,1,0,0,1
3508558,3508624,66,1,0,0,2
3508625,3508863,238,0,0,1,1
3508625,3508865,240,0,0,1,2
3508864,3508880,16,1,0,0,1
3508866,3508881,15,1,0,0,2
3508881,3509227,346,0,0,1,1
3508882,3509217,335,0,0,1,2
3509218,3509550,332,1,0,0,2
3509228,3509578,350,1,0,0,1
3509250,3509481,231,0,1,0,1
3509254,3509475,221,0,1,0,2
3509551,3510906,1355,0,0,1,2
3509579,3510907,1328,0,0,1,1
3510907,3510935,28,1,0,0,2
3510908,3510937,29,1,0,0,1
3510936,3511837,901,0,0,1,2
3510938,3511837,899,0,0,1,1
3511838,3511902,64,1,0,0,1
3511838,3513152,1314,1,0,0,2
3511903,3512079,176,0,0,1,1
3511975,3513135,1160,0,1,0,2
3512090,3512278,188,0,1,0,1
3512288,3512355,67,1,0,0,1
3512356,3512395,39,0,0,1,1
3512396,3512456,60,1,0,0,1
3512457,3512481,24,0,0,1,1
3512482,3512579,97,1,0,0,1
3512580,3512628,48,0,0,1,1
3512629,3513139,510,1,0,0,1
3512644,3513127,483,0,1,0,1
3513140,3513607,467,0,0,1,1
3513153,3513591,438,0,0,1,2
3513592,3514070,478,1,0,0,2
3513608,3513946,338,1,0,0,1
3513626,3513934,308,0,1,0,2
3513627,3513885,258,0,1,0,1
3513947,3515166,1219,0,0,1,1
3514071,3515165,1094,0,0,1,2
3515166,3515226,60,1,0,0,2
3515167,3515216,49,1,0,0,1
3515217,3515569,352,0,0,1,1
3515227,3515568,341,0,0,1,2
3515569,3515604,35,1,0,0,2
3515570,3515600,30,1,0,0,1
3515601,3516310,709,0,0,1,1
3515605,3516396,791,0,0,1,2
3516311,3516384,73,1,0,0,1
3516385,3516481,96,0,0,1,1
3516397,3516415,18,1,0,0,2
3516416,3516489,73,0,0,1,2
3516482,3516520,38,1,0,0,1
3516490,3516543,53,1,0,0,2
3516521,3516657,136,0,0,1,1
3516544,3516657,113,0,0,1,2
3516658,3516692,34,1,0,0,1
3516658,3516698,40,1,0,0,2
3516693,3517025,332,0,0,1,1
3516699,3517025,326,0,0,1,2
3517026,3517057,31,1,0,0,1
3517026,3517060,34,1,0,0,2
3517058,3517255,197,0,0,1,1
3517061,3517244,183,0,0,1,2
3517245,3517643,398,1,0,0,2
3517256,3517622,366,1,0,0,1
3517270,3517628,358,0,1,0,2
3517275,3517560,285,0,1,0,1
3517623,3517779,156,0,0,1,1
3517644,3517785,141,0,0,1,2
3517780,3517798,18,1,0,0,1
3517786,3517815,29,1,0,0,2
3517799,3518337,538,0,0,1,1
3517816,3518332,516,0,0,1,2
3518333,3520914,2581,1,0,0,2
3518338,3520939,2601,1,0,0,1
3518360,3520818,2458,0,1,0,2
3518366,3520861,2495,0,1,0,1
3520915,3521046,131,0,0,1,2
3520940,3521046,106,0,0,1,1
3521047,3521080,33,1,0,0,2
3521047,3521109,62,1,0,0,1
3521081,3521186,105,0,0,1,2
3521110,3521183,73,0,0,1,1
3521184,3521458,274,1,0,0,1
3521187,3521480,293,1,0,0,2
3521207,3521406,199,0,1,0,1
3521215,3521389,174,0,1,0,2
3521459,3521954,495,0,0,1,1
3521481,3521520,39,0,0,1,2
3521521,3521536,15,1,0,0,2
3521537,3521952,415,0,0,1,2
3521953,3521995,42,1,0,0,2
3521955,3521994,39,1,0,0,1
3521995,3522132,137,0,0,1,1
3521996,3522125,129,0,0,1,2
3522126,3522429,303,1,0,0,2
3522133,3522447,314,1,0,0,1
3522161,3522353,192,0,1,0,2
3522162,3522390,228,0,1,0,1
3522430,3522477,47,0,0,1,2
3522448,3522475,27,0,0,1,1
3522476,3522513,37,1,0,0,1
3522478,3522520,42,1,0,0,2
3522514,3522906,392,0,0,1,1
3522521,3522906,385,0,0,1,2
3522907,3522927,20,1,0,0,1
3522907,3522928,21,1,0,0,2
3522928,3523213,285,0,0,1,1
3522929,3523213,284,0,0,1,2
3559885,3560162,277,0,0,1,1
3559885,3560164,279,0,0,1,2
3560163,3560223,60,1,0,0,1
3560165,3560226,61,1,0,0,2
3560224,3560306,82,0,0,1,1
3560227,3560305,78,0,0,1,2
3560306,3560339,33,1,0,0,2
3560307,3560335,28,1,0,0,1
3560336,3561559,1223,0,0,1,1
3560340,3560627,287,0,0,1,2
3560628,3560638,10,1,0,0,2
3560639,3561557,918,0,0,1,2
3561558,3561607,49,1,0,0,2
3561560,3561606,46,1,0,0,1
3561607,3561918,311,0,0,1,1
3561608,3561920,312,0,0,1,2
3561919,3561967,48,1,0,0,1
3561921,3561984,63,1,0,0,2
3561968,3562074,106,0,0,1,1
3561985,3562075,90,0,0,1,2
3562075,3562101,26,1,0,0,1
3562076,3562101,25,1,0,0,2
3562102,3562263,161,0,0,1,1
3562102,3562264,162,0,0,1,2
3562264,3562281,17,1,0,0,1
3562265,3562281,16,1,0,0,2
3562282,3562886,604,0,0,1,2
3562282,3562897,615,0,0,1,1
3562887,3563152,265,1,0,0,2
3562898,3563146,248,1,0,0,1
3562919,3563089,170,0,1,0,1
3562921,3563090,169,0,1,0,2
3563147,3563379,232,0,0,1,1
3563153,3563378,225,0,0,1,2
3563379,3563488,109,1,0,0,2
3563380,3563449,69,1,0,0,1
3563450,3563602,152,0,0,1,1
3563489,3563596,107,0,0,1,2
3563597,3563617,20,1,0,0,2
3563603,3563618,15,1,0,0,1
3563618,3563786,168,0,0,1,2
3563619,3564490,871,0,0,1,1
3563787,3563794,7,1,0,0,2
3563795,3564490,695,0,0,1,2
3564491,3564545,54,1,0,0,1
3564491,3564562,71,1,0,0,2
3564546,3564876,330,0,0,1,1
3564563,3564876,313,0,0,1,2
3564877,3564937,60,1,0,0,1
3564877,3564941,64,1,0,0,2
3564938,3565037,99,0,0,1,1
3564942,3565037,95,0,0,1,2
3565038,3565071,33,1,0,0,1
3565038,3565073,35,1,0,0,2
3565072,3566038,966,0,0,1,1
3565074,3566018,944,0,0,1,2
3566019,3566542,523,1,0,0,2
3566039,3566433,394,1,0,0,1
3566060,3566387,327,0,1,0,2
3566065,3566373,308,0,1,0,1
3566434,3566472,38,0,0,1,1
3566473,3566528,55,1,0,0,1
3566529,3566653,124,0,0,1,1
3566543,3566651,108,0,0,1,2
3566652,3566669,17,1,0,0,2
3566654,3566673,19,1,0,0,1
3566670,3566945,275,0,0,1,2
3566674,3568280,1606,0,0,1,1
3566946,3566951,5,1,0,0,2
3566952,3568279,1327,0,0,1,2
3568280,3568345,65,1,0,0,2
3568281,3568344,63,1,0,0,1
3568345,3568443,98,0,0,1,1
3568346,3568444,98,0,0,1,2
3568444,3568479,35,1,0,0,1
3568445,3568485,40,1,0,0,2
3568480,3568653,173,0,0,1,1
3568486,3569827,1341,0,0,1,2
3568654,3568670,16,1,0,0,1
3568671,3569826,1155,0,0,1,1
3569827,3569874,47,1,0,0,1
3569828,3569876,48,1,0,0,2
3569875,3570167,292,0,0,1,1
3569877,3570168,291,0,0,1,2
3570168,3570238,70,1,0,0,1
3570169,3570236,67,1,0,0,2
3570237,3570305,68,0,0,1,2
3570239,3570304,65,0,0,1,1
3570305,3570341,36,1,0,0,1
3570306,3570345,39,1,0,0,2
3570342,3570574,232,0,0,1,1
3570346,3570568,222,0,0,1,2
3570569,3570585,16,1,0,0,2
3570575,3570579,4,1,0,0,1
3570580,3571363,783,0,0,1,1
3570586,3571363,777,0,0,1,2
3571364,3571419,55,1,0,0,1
3571364,3571426,62,1,0,0,2
3571420,3571775,355,0,0,1,1
3571427,3571775,348,0,0,1,2
3571776,3571801,25,1,0,0,1
3571776,3571802,26,1,0,0,2
3571802,3571929,127,0,0,1,1
3571803,3571932,129,0,0,1,2
3571930,3571940,10,1,0,0,1
3571933,3571940,7,1,0,0,2
3571941,3572758,817,0,0,1,2
3571941,3572764,823,0,0,1,1
3572759,3573087,328,1,0,0,2
3572765,3573128,363,1,0,0,1
3572795,3573030,235,0,1,0,2
3572796,3573062,266,0,1,0,1
3573088,3573227,139,0,0,1,2
3573129,3573225,96,0,0,1,1
3573226,3573521,295,1,0,0,1
3573228,3573492,264,1,0,0,2
3573253,3573494,241,0,1,0,1
3573268,3573322,54,0,1,0,2
3573390,3573399,9,0,1,0,2
3573493,3573580,87,0,0,1,2
3573522,3574235,713,0,0,1,1
3573581,3573713,132,1,0,0,2
3573714,3574062,348,0,0,1,2
3574063,3574109,46,1,0,0,2
3574110,3574167,57,0,0,1,2
3574168,3574210,42,1,0,0,2
3574211,3574238,27,0,0,1,2
3574239,3580721,6482,1,0,0,2
3574246,3576486,2240,0,1,0,1
3574264,3576648,2384,0,1,0,2
3576496,3576961,465,1,0,0,1
3576684,3576700,16,0,1,0,1
3576962,3577022,60,0,0,1,1
3577023,3577779,756,1,0,0,1
3577252,3577697,445,0,1,0,1
3577258,3577405,147,0,1,0,2
3577446,3577492,46,0,1,0,2
3577514,3577604,90,0,1,0,2
3577625,3580548,2923,0,1,0,2
3577780,3577802,22,0,0,1,1
3577803,3577855,52,1,0,0,1
3577856,3578047,191,0,0,1,1
3578048,3578064,16,1,0,0,1
3578065,3578255,190,0,0,1,1
3578256,3578264,8,1,0,0,1
3578265,3578634,369,0,0,1,1
3578635,3578709,74,1,0,0,1
3578648,3578697,49,0,1,0,1
3578710,3578741,31,0,0,1,1
3578742,3578757,15,1,0,0,1
3578758,3578964,206,0,0,1,1
3578965,3580641,1676,1,0,0,1
3579033,3579035,2,0,1,0,1
3579063,3580629,1566,0,1,0,1
3580642,3580680,38,0,0,1,1
3580681,3580723,42,1,0,0,1
3580722,3581016,294,0,0,1,2
3580724,3581015,291,0,0,1,1
3581016,3581032,16,1,0,0,1
3581017,3581031,14,1,0,0,2
3581032,3581726,694,0,0,1,2
3581033,3581727,694,0,0,1,1
3581727,3582322,595,1,0,0,2
3581728,3582075,347,1,0,0,1
3581753,3582010,257,0,1,0,1
3581754,3582220,466,0,1,0,2
3582076,3582191,115,0,0,1,1
3582192,3582237,45,1,0,0,1
3582238,3582361,123,0,0,1,1
3582323,3582366,43,0,0,1,2
3582362,3582381,19,1,0,0,1
3582367,3582383,16,1,0,0,2
3582382,3583290,908,0,0,1,1
3582384,3583292,908,0,0,1,2
3583291,3583344,53,1,0,0,1
3583293,3583345,52,1,0,0,2
3583345,3583654,309,0,0,1,1
3583346,3583655,309,0,0,1,2
3583655,3583732,77,1,0,0,1
3583656,3583740,84,1,0,0,2
3583733,3583805,72,0,0,1,1
3583741,3583806,65,0,0,1,2
3583806,3583846,40,1,0,0,1
3583807,3583862,55,1,0,0,2
3583847,3583942,95,0,0,1,1
3583863,3583944,81,0,0,1,2
3583943,3583966,23,1,0,0,1
3583945,3583976,31,1,0,0,2
3583967,3584850,883,0,0,1,1
3583977,3584850,873,0,0,1,2
3584851,3584925,74,1,0,0,1
3584851,3584935,84,1,0,0,2
3584926,3585254,328,0,0,1,1
3584936,3585254,318,0,0,1,2
3585255,3585309,54,1,0,0,1
3585255,3585314,59,1,0,0,2
3585310,3585461,151,0,0,1,1
3585315,3585463,148,0,0,1,2
3585462,3585479,17,1,0,0,1
3585464,3585477,13,1,0,0,2
3585478,3585688,210,0,0,1,2
3585480,3585700,220,0,0,1,1
3585689,3586024,335,1,0,0,2
3585701,3585973,272,1,0,0,1
3585712,3585959,247,0,1,0,2
3585716,3585935,219,0,1,0,1
3585974,3586308,334,0,0,1,1
3586025,3586311,286,0,0,1,2
3586309,3586364,55,1,0,0,1
3586312,3586365,53,1,0,0,2
3586365,3586717,352,0,0,1,1
3586366,3586716,350,0,0,1,2
3586717,3586810,93,1,0,0,2
3586718,3586794,76,1,0,0,1
3586795,3586864,69,0,0,1,1
3586811,3586864,53,0,0,1,2
3586865,3586901,36,1,0,0,1
3586865,3586924,59,1,0,0,2
3586902,3586964,62,0,0,1,1
3586925,3586964,39,0,0,1,2
3586965,3586998,33,1,0,0,1
3586965,3587016,51,1,0,0,2
3586999,3587259,260,0,0,1,1
3587017,3587259,242,0,0,1,2
3587260,3587269,9,1,0,0,2
3587260,3587272,12,1,0,0,1
3587270,3587575,305,0,0,1,2
3587273,3587720,447,0,0,1,1
3587576,3587610,34,1,0,0,2
3587611,3587721,110,0,0,1,2
3587721,3587802,81,1,0,0,1
3587722,3587813,91,1,0,0,2
3587803,3588159,356,0,0,1,1
3587814,3588160,346,0,0,1,2
3588160,3588239,79,1,0,0,1
3588161,3588241,80,1,0,0,2
3588240,3588298,58,0,0,1,1
3588242,3588299,57,0,0,1,2
3588299,3588343,44,1,0,0,1
3588300,3588345,45,1,0,0,2
3588344,3588403,59,0,0,1,1
3588346,3588404,58,0,0,1,2
3588404,3588442,38,1,0,0,1
3588405,3588444,39,1,0,0,2
3588443,3588622,179,0,0,1,1
3588445,3588623,178,0,0,1,2
3588623,3588641,18,1,0,0,1
3588624,3588649,25,1,0,0,2
3588642,3589174,532,0,0,1,1
3588650,3589174,524,0,0,1,2
3589175,3589264,89,1,0,0,1
3589175,3589267,92,1,0,0,2
3589265,3589612,347,0,0,1,1
3589268,3589614,346,0,0,1,2
3589613,3589741,128,1,0,0,1
3589615,3589693,78,1,0,0,2
3589692,3589714,22,0,1,0,1
3589694,3589792,98,0,0,1,2
3589742,3589792,50,0,0,1,1
3589793,3589844,51,1,0,0,2
3589793,3590608,815,1,0,0,1
3589807,3590597,790,0,1,0,1
3589845,3590487,642,0,0,1,2
3590498,3590537,39,0,1,0,2
3590547,3590609,62,1,0,0,2
3590609,3591007,398,0,0,1,1
3590610,3591009,399,0,0,1,2
3591008,3591083,75,1,0,0,1
3591010,3591088,78,1,0,0,2
3591084,3591195,111,0,0,1,1
3591089,3591195,106,0,0,1,2
3591196,3591227,31,1,0,0,1
3591196,3591227,31,1,0,0,2
3591228,3591970,742,0,0,1,1
3591228,3591970,742,0,0,1,2
3591971,3592347,376,1,0,0,1
3591971,3592642,671,1,0,0,2
3592033,3592287,254,0,1,0,1
3592034,3592297,263,0,1,0,2
3592348,3592478,130,0,0,1,1
3592479,3592508,29,1,0,0,1
3592509,3593138,629,0,0,1,1
3592643,3592696,53,0,0,1,2
3592697,3592766,69,1,0,0,2
3592767,3593133,366,0,0,1,2
3593134,3593637,503,1,0,0,2
3593139,3593579,440,1,0,0,1
3593184,3593624,440,0,1,0,2
3593195,3593565,370,0,1,0,1
3593580,3593899,319,0,0,1,1
3593638,3593662,24,0,0,1,2
3593663,3593684,21,1,0,0,2
3593685,3593715,30,0,0,1,2
3593716,3593976,260,1,0,0,2
3593900,3593975,75,1,0,0,1
3593976,3594077,101,0,0,1,1
3593977,3594078,101,0,0,1,2
3594078,3594109,31,1,0,0,1
3594079,3594113,34,1,0,0,2
3594110,3594247,137,0,0,1,1
3594114,3594251,137,0,0,1,2
3594248,3594265,17,1,0,0,1
3594252,3594265,13,1,0,0,2
3594266,3594986,720,0,0,1,2
3594266,3594987,721,0,0,1,1
3594987,3595054,67,1,0,0,2
3594988,3595051,63,1,0,0,1
3595052,3595358,306,0,0,1,1
3595055,3595356,301,0,0,1,2
3595357,3595426,69,1,0,0,2
3595359,3595420,61,1,0,0,1
3595421,3595489,68,0,0,1,1
3595427,3595490,63,0,0,1,2
3595490,3595524,34,1,0,0,1
3595491,3595528,37,1,0,0,2
3595525,3595718,193,0,0,1,1
3595529,3595719,190,0,0,1,2
3595719,3595736,17,1,0,0,1
3595720,3595735,15,1,0,0,2
3595736,3596450,714,0,0,1,2
3595737,3596449,712,0,0,1,1
3596450,3596530,80,1,0,0,1
3596451,3596530,79,1,0,0,2
3596531,3596842,311,0,0,1,1
3596531,3596842,311,0,0,1,2
3596843,3596875,32,1,0,0,1
3596843,3596879,36,1,0,0,2
3596876,3597071,195,0,0,1,1
3596880,3597071,191,0,0,1,2
3597072,3597076,4,1,0,0,2
3597072,3597078,6,1,0,0,1
3597077,3598704,1627,0,0,1,2
3597079,3598705,1626,0,0,1,1
3598705,3598753,48,1,0,0,2
3598706,3598749,43,1,0,0,1
3598750,3599739,989,0,0,1,1
3598754,3599741,987,0,0,1,2
3599740,3599799,59,1,0,0,1
3599742,3599800,58,1,0,0,2
3599800,3600157,357,0,0,1,1
3599801,3600155,354,0,0,1,2
3600156,3600221,65,1,0,0,2
3600158,3600231,73,1,0,0,1
3600222,3600361,139,0,0,1,2
3600232,3600362,130,0,0,1,1
3600362,3600379,17,1,0,0,2
3600363,3600380,17,1,0,0,1
3600380,3600508,128,0,0,1,2
3600381,3600522,141,0,0,1,1
3600509,3601203,694,1,0,0,2
3600523,3600909,386,1,0,0,1
3600534,3601090,556,0,1,0,2
3600539,3600873,334,0,1,0,1
3600910,3601127,217,0,0,1,1
3601128,3601184,56,1,0,0,1
3601136,3601136,0,0,1,0,2
3601185,3601557,372,0,0,1,1
3601204,3601559,355,0,0,1,2
3601558,3601631,73,1,0,0,1
3601560,3601636,76,1,0,0,2
3601632,3601743,111,0,0,1,1
3601637,3601663,26,0,0,1,2
3601664,3602761,1097,1,0,0,2
3601744,3601853,109,1,0,0,1
3601854,3602453,599,0,0,1,1
3602454,3602458,4,1,0,0,1
3602459,3602639,180,0,0,1,1
3602640,3602720,80,1,0,0,1
3602676,3602695,19,0,1,0,1
3602721,3602965,244,0,0,1,1
3602762,3602963,201,0,0,1,2
3602964,3603062,98,1,0,0,2
3602966,3603032,66,1,0,0,1
3603033,3603165,132,0,0,1,1
3603063,3603117,54,0,0,1,2
3603118,3603372,254,1,0,0,2
3603166,3603172,6,1,0,0,1
3603173,3604192,1019,0,0,1,1
3603373,3603590,217,0,0,1,2
3603591,3603769,178,1,0,0,2
3603770,3603800,30,0,0,1,2
3603801,3603868,67,1,0,0,2
3603869,3603924,55,0,0,1,2
3603925,3604038,113,1,0,0,2
3604039,3604191,152,0,0,1,2
3604192,3604423,231,1,0,0,2
3604193,3604227,34,1,0,0,1
3604228,3604450,222,0,0,1,1
3604424,3604450,26,0,0,1,2
3604451,3605768,1317,1,0,0,1
3604451,3607468,3017,1,0,0,2
3604489,3605746,1257,0,1,0,1
3604499,3607442,2943,0,1,0,2
3605769,3605927,158,0,0,1,1
3605928,3607038,1110,1,0,0,1
3605980,3605993,13,0,1,0,1
3606046,3607028,982,0,1,0,1
3607039,3607085,46,0,0,1,1
3607086,3607110,24,1,0,0,1
3607111,3607351,240,0,0,1,1
3607362,3607399,37,0,1,0,1
3607409,3607438,29,1,0,0,1
3607439,3607584,145,0,0,1,1
3607469,3607586,117,0,0,1,2
3607585,3607601,16,1,0,0,1
3607587,3607596,9,1,0,0,2
3607597,3607907,310,0,0,1,2
3607602,3607905,303,0,0,1,1
3607906,3608173,267,1,0,0,1
3607908,3608230,322,1,0,0,2
3607925,3608139,214,0,1,0,2
3607927,3608139,212,0,1,0,1
3608174,3608810,636,0,0,1,1
3608231,3608810,579,0,0,1,2
3608811,3608861,50,1,0,0,1
3608811,3608878,67,1,0,0,2
3608862,3608964,102,0,0,1,1
3608879,3608941,62,0,0,1,2
3608942,3609089,147,1,0,0,2
3608965,3609014,49,1,0,0,1
3609015,3609843,828,0,0,1,1
3609090,3609184,94,0,0,1,2
3609195,3609209,14,0,1,0,2
3609219,3609227,8,1,0,0,2
3609228,3609254,26,0,0,1,2
3609255,3609925,670,1,0,0,2
3609517,3609888,371,0,1,0,2
3609844,3609903,59,1,0,0,1
3609904,3610314,410,0,0,1,1
3609926,3609967,41,0,0,1,2
3609968,3610029,61,1,0,0,2
3610030,3610229,199,0,0,1,2
3610230,3610245,15,1,0,0,2
3610246,3610316,70,0,0,1,2
3610315,3610403,88,1,0,0,1
3610317,3610404,87,1,0,0,2
3610404,3610463,59,0,0,1,1
3610405,3610464,59,0,0,1,2
3610464,3610503,39,1,0,0,1
3610465,3610507,42,1,0,0,2
3610504,3610575,71,0,0,1,1
3610508,3610576,68,0,0,1,2
3610576,3610612,36,1,0,0,1
3610577,3610612,35,1,0,0,2
3610613,3611381,768,0,0,1,1
3610613,3611382,769,0,0,1,2
3611382,3611454,72,1,0,0,1
3611383,3611456,73,1,0,0,2
3611455,3611797,342,0,0,1,1
3611457,3611798,341,0,0,1,2
3611798,3611867,69,1,0,0,1
3611799,3611868,69,1,0,0,2
3611868,3611990,122,0,0,1,1
3611869,3611992,123,0,0,1,2
3611991,3612021,30,1,0,0,1
3611993,3612013,20,1,0,0,2
3612014,3612325,311,0,0,1,2
3612022,3612236,214,0,0,1,1
3612247,3612266,19,0,1,0,1
3612276,3612937,661,1,0,0,1
3612289,3612291,2,0,1,0,1
3612326,3612334,8,1,0,0,2
3612326,3612927,601,0,1,0,1
3612335,3612862,527,0,0,1,2
3612863,3612932,69,1,0,0,2
3612933,3613257,324,0,0,1,2
3612938,3613258,320,0,0,1,1
3613258,3613335,77,1,0,0,2
3613259,3613328,69,1,0,0,1
3613329,3613384,55,0,0,1,1
3613336,3613384,48,0,0,1,2
3613385,3613411,26,1,0,0,1
3613385,3613423,38,1,0,0,2
3613412,3613601,189,0,0,1,1
3613424,3613603,179,0,0,1,2
3613602,3613617,15,1,0,0,1
3613604,3613618,14,1,0,0,2
3613618,3614532,914,0,0,1,1
3613619,3614534,915,0,0,1,2
3614533,3614580,47,1,0,0,1
3614535,3614581,46,1,0,0,2
3614581,3614822,241,0,0,1,1
3614582,3614823,241,0,0,1,2
3614823,3614880,57,1,0,0,1
3614824,3614885,61,1,0,0,2
3614881,3615068,187,0,0,1,1
3614886,3615074,188,0,0,1,2
3615069,3615086,17,1,0,0,1
3615075,3615084,9,1,0,0,2
3615085,3615233,148,0,0,1,2
3615087,3615236,149,0,0,1,1
3615234,3615538,304,1,0,0,2
3615237,3615579,342,1,0,0,1
3615261,3615497,236,0,1,0,1
3615263,3615459,196,0,1,0,2
3615539,3615996,457,0,0,1,2
3615580,3615997,417,0,0,1,1
3615997,3616059,62,1,0,0,2
3615998,3616055,57,1,0,0,1
3616056,3616395,339,0,0,1,1
3616060,3616397,337,0,0,1,2
3616396,3616466,70,1,0,0,1
3616398,3616477,79,1,0,0,2
3616467,3616626,159,0,0,1,1
3616478,3616629,151,0,0,1,2
3616627,3616645,18,1,0,0,1
3616630,3616655,25,1,0,0,2
3616646,3617430,784,0,0,1,1
3616656,3616928,272,0,0,1,2
3616929,3616949,20,1,0,0,2
3616950,3617432,482,0,0,1,2
3617431,3617508,77,1,0,0,1
3617433,3617509,76,1,0,0,2
3617509,3617894,385,0,0,1,1
3617510,3617893,383,0,0,1,2
3617894,3617949,55,1,0,0,2
3617895,3617947,52,1,0,0,1
3617948,3618222,274,0,0,1,1
3617950,3619371,1421,0,0,1,2
3618223,3618233,10,1,0,0,1
3618234,3619371,1137,0,0,1,1
3619372,3619416,44,1,0,0,1
3619372,3619416,44,1,0,0,2
3619417,3619655,238,0,0,1,1
3619417,3620849,1432,0,0,1,2
3619656,3619665,9,1,0,0,1
3619666,3620848,1182,0,0,1,1
3620849,3620915,66,1,0,0,1
3620850,3620914,64,1,0,0,2
3620915,3620990,75,0,0,1,2
3620916,3620991,75,0,0,1,1
3620991,3621028,37,1,0,0,2
3620992,3621029,37,1,0,0,1
3621029,3621183,154,0,0,1,2
3621030,3621180,150,0,0,1,1
3621181,3621198,17,1,0,0,1
3621184,3621197,13,1,0,0,2
3621198,3622001,803,0,0,1,2
3621199,3621999,800,0,0,1,1
3622000,3622256,256,1,0,0,1
3622002,3622259,257,1,0,0,2
3622030,3622202,172,0,1,0,1
3622031,3622207,176,0,1,0,2
3622257,3622499,242,0,0,1,1
3622260,3622499,239,0,0,1,2
3622500,3624058,1558,1,0,0,1
3622500,3624075,1575,1,0,0,2
3622562,3623957,1395,0,1,0,2
3622568,3622637,69,0,1,0,1
3622662,3623968,1306,0,1,0,1
3624059,3624094,35,0,0,1,1
3624076,3624096,20,0,0,1,2
3624095,3624132,37,1,0,0,1
3624097,3624133,36,1,0,0,2
3624133,3624249,116,0,0,1,1
3624134,3624248,114,0,0,1,2
3624249,3624270,21,1,0,0,2
3624250,3624269,19,1,0,0,1
3624270,3625206,936,0,0,1,1
3624271,3625205,934,0,0,1,2
3625206,3625271,65,1,0,0,2
3625207,3625261,54,1,0,0,1
3625262,3625306,44,0,0,1,1
3625272,3625305,33,0,0,1,2
3625306,3625354,48,1,0,0,2
3625307,3625351,44,1,0,0,1
3625352,3625563,211,0,0,1,1
3625355,3625563,208,0,0,1,2
3625564,3625624,60,1,0,0,1
3625564,3625633,69,1,0,0,2
3625625,3625693,68,0,0,1,1
3625634,3625693,59,0,0,1,2
3625694,3625719,25,1,0,0,1
3625694,3625720,26,1,0,0,2
3625720,3626570,850,0,0,1,1
3625721,3626569,848,0,0,1,2
3626570,3626655,85,1,0,0,2
3626571,3626645,74,1,0,0,1
3626646,3627013,367,0,0,1,1
3626656,3627014,358,0,0,1,2
3627014,3627104,90,1,0,0,1
3627015,3627078,63,1,0,0,2
3627079,3627199,120,0,0,1,2
3627105,3627197,92,0,0,1,1
3627198,3627220,22,1,0,0,1
3627200,3627219,19,1,0,0,2
3627220,3628217,997,0,0,1,2
3627221,3628216,995,0,0,1,1
3628217,3628303,86,1,0,0,1
3628218,3628306,88,1,0,0,2
3628304,3628593,289,0,0,1,1
3628307,3628595,288,0,0,1,2
3628594,3628687,93,1,0,0,1
3628596,3628658,62,1,0,0,2
3628659,3628796,137,0,0,1,2
3628688,3628765,77,0,0,1,1
3628766,3628818,52,1,0,0,1
3628797,3628817,20,1,0,0,2
3628818,3629009,191,0,0,1,2
3628819,3629000,181,0,0,1,1
3629001,3629503,502,1,0,0,1
3629010,3629305,295,1,0,0,2
3629024,3629276,252,0,1,0,1
3629029,3629274,245,0,1,0,2
3629306,3629410,104,0,0,1,2
3629411,3629419,8,1,0,0,2
3629420,3629795,375,0,0,1,2
3629504,3629794,290,0,0,1,1
3629795,3629849,54,1,0,0,1
3629796,3629861,65,1,0,0,2
3629850,3629886,36,0,0,1,1
3629862,3629886,24,0,0,1,2
3629887,3629934,47,1,0,0,1
3629887,3629936,49,1,0,0,2
3629935,3630203,268,0,0,1,1
3629937,3630204,267,0,0,1,2
3630204,3630238,34,1,0,0,1
3630205,3630238,33,1,0,0,2
3630239,3630452,213,0,0,1,2
3630239,3630711,472,0,0,1,1
3630453,3630598,145,1,0,0,2
3630599,3630627,28,0,0,1,2
3630628,3630684,56,1,0,0,2
3630685,3630718,33,0,0,1,2
3630712,3631106,394,1,0,0,1
3630719,3631145,426,1,0,0,2
3630741,3631036,295,0,1,0,1
3630741,3631113,372,0,1,0,2
3631073,3631095,22,0,1,0,1
3631107,3631403,296,0,0,1,1
3631146,3631402,256,0,0,1,2
3631403,3631447,44,1,0,0,2
3631404,3631455,51,1,0,0,1
3631448,3631782,334,0,0,1,2
3631456,3631781,325,0,0,1,1
3631782,3633517,1735,1,0,0,1
3631783,3633532,1749,1,0,0,2
3631810,3633477,1667,0,1,0,1
3631835,3633465,1630,0,1,0,2
3633518,3633566,48,0,0,1,1
3633533,3633566,33,0,0,1,2
3633567,3633613,46,1,0,0,1
3633567,3633647,80,1,0,0,2
3633614,3633701,87,0,0,1,1
3633648,3633702,54,0,0,1,2
3633702,3633731,29,1,0,0,1
3633703,3633753,50,1,0,0,2
3633732,3633952,220,0,0,1,1
3633754,3635001,1247,0,0,1,2
3633953,3633968,15,1,0,0,1
3633969,3634997,1028,0,0,1,1
3634998,3635053,55,1,0,0,1
3635002,3635054,52,1,0,0,2
3635054,3635231,177,0,0,1,1
3635055,3635233,178,0,0,1,2
3635232,3635287,55,1,0,0,1
3635234,3635302,68,1,0,0,2
3635288,3635459,171,0,0,1,1
3635303,3635457,154,0,0,1,2
3635458,3635480,22,1,0,0,2
3635460,3635477,17,1,0,0,1
3635478,3635644,166,0,0,1,1
3635481,3635649,168,0,0,1,2
3635645,3635938,293,1,0,0,1
3635650,3635940,290,1,0,0,2
3635664,3635867,203,0,1,0,1
3635667,3635862,195,0,1,0,2
3635939,3637573,1634,0,0,1,1
3635941,3637572,1631,0,0,1,2
3637573,3637632,59,1,0,0,2
3637574,3637623,49,1,0,0,1
3637624,3637804,180,0,0,1,1
3637633,3637804,171,0,0,1,2
3637805,3637823,18,1,0,0,2
3637805,3637825,20,1,0,0,1
3637824,3639725,1901,0,0,1,2
3637826,3639735,1909,0,0,1,1
3639726,3640118,392,1,0,0,2
3639736,3640095,359,1,0,0,1
3639757,3640055,298,0,1,0,1
3639757,3640091,334,0,1,0,2
3640096,3640275,179,0,0,1,1
3640119,3640276,157,0,0,1,2
3640276,3640321,45,1,0,0,1
3640277,3640324,47,1,0,0,2
3640322,3640371,49,0,0,1,1
3640325,3640372,47,0,0,1,2
3640372,3640410,38,1,0,0,1
3640373,3640432,59,1,0,0,2
3640411,3641383,972,0,0,1,1
3640433,3641383,950,0,0,1,2
3641384,3641444,60,1,0,0,1
3641384,3641465,81,1,0,0,2
3641445,3641548,103,0,0,1,1
3641466,3641549,83,0,0,1,2
3641549,3641575,26,1,0,0,1
3641550,3641572,22,1,0,0,2
3641573,3641781,208,0,0,1,2
3641576,3642620,1044,0,0,1,1
3641782,3641790,8,1,0,0,2
3641791,3642620,829,0,0,1,2
3642621,3642667,46,1,0,0,1
3642621,3642682,61,1,0,0,2
3642668,3642872,204,0,0,1,1
3642683,3642867,184,0,0,1,2
3642868,3643333,465,1,0,0,2
3642873,3643295,422,1,0,0,1
3642893,3643238,345,0,1,0,1
3642896,3643230,334,0,1,0,2
3643296,3643596,300,0,0,1,1
3643334,3643591,257,0,0,1,2
3643592,3643607,15,1,0,0,2
3643597,3643602,5,1,0,0,1
3643603,3643815,212,0,0,1,1
3643608,3643800,192,0,0,1,2
3643801,3644256,455,1,0,0,2
3643816,3644186,370,1,0,0,1
3643832,3644182,350,0,1,0,2
3643835,3644110,275,0,1,0,1
3644187,3644669,482,0,0,1,1
3644257,3644655,398,0,0,1,2
3644656,3645042,386,1,0,0,2
3644670,3644998,328,1,0,0,1
3644688,3644956,268,0,1,0,2
3644690,3644956,266,0,1,0,1
3644999,3645288,289,0,0,1,1
3645043,3645288,245,0,0,1,2
3645289,3645332,43,1,0,0,1
3645289,3645333,44,1,0,0,2
3645333,3645767,434,0,0,1,1
3645334,3645769,435,0,0,1,2
3645768,3645904,136,1,0,0,1
3645770,3645829,59,1,0,0,2
3645815,3645893,78,0,1,0,1
3645830,3645966,136,0,0,1,2
3645905,3645962,57,0,0,1,1
3645963,3646020,57,1,0,0,1
3645967,3645986,19,1,0,0,2
3645987,3646276,289,0,0,1,2
3646001,3646002,1,0,1,0,1
3646021,3646141,120,0,0,1,1
3646142,3646158,16,1,0,0,1
3646159,3646491,332,0,0,1,1
3646277,3646285,8,1,0,0,2
3646286,3646575,289,0,0,1,2
3646492,3646496,4,1,0,0,1
3646497,3646613,116,0,0,1,1
3646576,3646617,41,1,0,0,2
3646614,3646635,21,1,0,0,1
3646618,3646762,144,0,0,1,2
3646636,3646935,299,0,0,1,1
3646763,3646767,4,1,0,0,2
3646768,3646800,32,0,0,1,2
3646801,3646901,100,1,0,0,2
3646902,3647006,104,0,0,1,2
3646936,3646976,40,1,0,0,1
3646977,3647026,49,0,0,1,1
3647007,3647021,14,1,0,0,2
3647022,3647063,41,0,0,1,2
3647027,3647126,99,1,0,0,1
3647064,3647117,53,1,0,0,2
3647082,3647097,15,0,1,0,1
3647118,3647353,235,0,0,1,2
3647127,3647558,431,0,0,1,1
3647354,3647390,36,1,0,0,2
3647391,3647503,112,0,0,1,2
3647504,3647623,119,1,0,0,2
3647559,3647574,15,1,0,0,1
3647575,3648574,999,0,0,1,1
3647624,3647667,43,0,0,1,2
3647668,3647802,134,1,0,0,2
3647803,3647876,73,0,0,1,2
3647877,3647916,39,1,0,0,2
3647917,3647985,68,0,0,1,2
3647986,3647993,7,1,0,0,2
3647994,3648584,590,0,0,1,2
3648575,3650080,1505,1,0,0,1
3648585,3649051,466,1,0,0,2
3648588,3649058,470,0,1,0,1
3648616,3649042,426,0,1,0,2
3649052,3649086,34,0,0,1,2
3649083,3650056,973,0,1,0,1
3649087,3650173,1086,1,0,0,2
3649110,3649995,885,0,1,0,2
3650081,3650533,452,0,0,1,1
3650114,3650123,9,0,1,0,2
3650174,3650605,431,0,0,1,2
3650544,3650659,115,0,1,0,1
3650606,3653860,3254,1,0,0,2
3650643,3653414,2771,0,1,0,2
3650669,3650688,19,1,0,0,1
3650689,3650799,110,0,0,1,1
3650800,3650829,29,1,0,0,1
3650830,3651351,521,0,0,1,1
3651362,3651849,487,0,1,0,1
3651859,3651860,1,1,0,0,1
3651861,3651931,70,0,0,1,1
3651932,3653116,1184,1,0,0,1
3651945,3653059,1114,0,1,0,1
3653117,3653370,253,0,0,1,1
3653371,3653399,28,1,0,0,1
3653400,3653917,517,0,0,1,1
3653861,3653919,58,0,0,1,2
3653918,3653955,37,1,0,0,1
3653920,3655131,1211,1,0,0,2
3653956,3654017,61,0,0,1,1
3654018,3654541,523,1,0,0,1
3654033,3654497,464,0,1,0,1
3654033,3654966,933,0,1,0,2
3654542,3655031,489,0,0,1,1
3655032,3655109,77,1,0,0,1
3655055,3655075,20,0,1,0,1
3655110,3655160,50,0,0,1,1
3655132,3655161,29,0,0,1,2
3655161,3655195,34,1,0,0,1
3655162,3655188,26,1,0,0,2
3655189,3655343,154,0,0,1,2
3655196,3655345,149,0,0,1,1
3655344,3655361,17,1,0,0,2
3655346,3655361,15,1,0,0,1
3655362,3657362,2000,0,0,1,1
3655362,3657363,2001,0,0,1,2
3657363,3657402,39,1,0,0,1
3657364,3657400,36,1,0,0,2
3657401,3657539,138,0,0,1,2
3657403,3657539,136,0,0,1,1
3657540,3657557,17,1,0,0,1
3657540,3657559,19,1,0,0,2
3657558,3657606,48,0,0,1,1
3657560,3657625,65,0,0,1,2
3657607,3658169,562,1,0,0,1
3657626,3658080,454,1,0,0,2
3657639,3658010,371,0,1,0,1
3657645,3658062,417,0,1,0,2
3658081,3658433,352,0,0,1,2
3658102,3658141,39,0,1,0,1
3658170,3658589,419,0,0,1,1
3658434,3658445,11,1,0,0,2
3658446,3658594,148,0,0,1,2
3658590,3658971,381,1,0,0,1
3658595,3659031,436,1,0,0,2
3658624,3658958,334,0,1,0,1
3658632,3659022,390,0,1,0,2
3658972,3659045,73,0,0,1,1
3659032,3659282,250,0,0,1,2
3659056,3659108,52,0,1,0,1
3659118,3659139,21,1,0,0,1
3659140,3659424,284,0,0,1,1
3659283,3659293,10,1,0,0,2
3659294,3659437,143,0,0,1,2
3659425,3659923,498,1,0,0,1
3659438,3659891,453,1,0,0,2
3659462,3659832,370,0,1,0,1
3659468,3659882,414,0,1,0,2
3659875,3659895,20,0,1,0,1
3659892,3660095,203,0,0,1,2
3659924,3660096,172,0,0,1,1
3660096,3660141,45,1,0,0,2
3660097,3660149,52,1,0,0,1
3660142,3660459,317,0,0,1,2
3660150,3661214,1064,0,0,1,1
3660460,3660481,21,1,0,0,2
3660482,3661215,733,0,0,1,2
3661215,3661272,57,1,0,0,1
3661216,3661283,67,1,0,0,2
3661273,3661393,120,0,0,1,1
3661284,3661392,108,0,0,1,2
3661393,3661408,15,1,0,0,2
3661394,3661410,16,1,0,0,1
3661409,3661652,243,0,0,1,2
3661411,3661657,246,0,0,1,1
3661653,3661663,10,1,0,0,2
3661658,3661663,5,1,0,0,1
3661664,3663410,1746,0,0,1,2
3661664,3663412,1748,0,0,1,1
3663411,3663472,61,1,0,0,2
3663413,3663470,57,1,0,0,1
3663471,3663575,104,0,0,1,1
3663473,3663575,102,0,0,1,2
3663576,3663599,23,1,0,0,1
3663576,3663601,25,1,0,0,2
3663600,3663795,195,0,0,1,1
3663602,3663784,182,0,0,1,2
3663785,3664058,273,1,0,0,2
3663796,3664068,272,1,0,0,1
3663820,3664016,196,0,1,0,1
3663829,3663990,161,0,1,0,2
3664059,3664220,161,0,0,1,2
3664069,3664221,152,0,0,1,1
3664221,3664240,19,1,0,0,2
3664222,3664246,24,1,0,0,1
3664241,3665467,1226,0,0,1,2
3664247,3665467,1220,0,0,1,1
3665468,3665518,50,1,0,0,1
3665468,3665519,51,1,0,0,2
3665519,3665594,75,0,0,1,1
3665520,3665586,66,0,0,1,2
3665587,3666481,894,1,0,0,2
3665595,3666029,434,1,0,0,1
3665614,3665984,370,0,1,0,1
3665617,3666100,483,0,1,0,2
3666030,3666433,403,0,0,1,1
3666434,3666481,47,1,0,0,1
3666482,3667322,840,0,0,1,1
3666482,3667322,840,0,0,1,2
3667323,3667392,69,1,0,0,1
3667323,3667398,75,1,0,0,2
3667393,3667517,124,0,0,1,1
3667399,3667517,118,0,0,1,2
3667518,3667540,22,1,0,0,2
3667518,3667550,32,1,0,0,1
3667541,3667798,257,0,0,1,2
3667551,3667795,244,0,0,1,1
3667796,3667813,17,1,0,0,1
3667799,3667814,15,1,0,0,2
3667814,3668939,1125,0,0,1,1
3667815,3668940,1125,0,0,1,2
3668940,3668988,48,1,0,0,1
3668941,3668994,53,1,0,0,2
3668989,3669293,304,0,0,1,1
3668995,3669293,298,0,0,1,2
3669294,3669564,270,1,0,0,1
3669294,3669566,272,1,0,0,2
3669317,3669511,194,0,1,0,1
3669322,3669498,176,0,1,0,2
3669565,3670384,819,0,0,1,1
3669567,3670382,815,0,0,1,2
3670383,3670389,6,1,0,0,2
3670385,3670390,5,1,0,0,1
3670390,3671176,786,0,0,1,2
3670391,3671177,786,0,0,1,1
3671177,3672228,1051,1,0,0,2
3671178,3671649,471,1,0,0,1
3671203,3671609,406,0,1,0,1
3671209,3671689,480,0,1,0,2
3671650,3671737,87,0,0,1,1
3671738,3671779,41,1,0,0,1
3671780,3672672,892,0,0,1,1
3672229,3672347,118,0,0,1,2
3672348,3672521,173,1,0,0,2
3672522,3672631,109,0,0,1,2
3672632,3672646,14,1,0,0,2
3672647,3672673,26,0,0,1,2
3672673,3672693,20,1,0,0,1
3672674,3672690,16,1,0,0,2
3672691,3672891,200,0,0,1,2
3672694,3672890,196,0,0,1,1
3672891,3672943,52,1,0,0,1
3672892,3673003,111,1,0,0,2
3672944,3673072,128,0,0,1,1
3673004,3673074,70,0,0,1,2
3673073,3673092,19,1,0,0,1
3673075,3673091,16,1,0,0,2
3673092,3674955,1863,0,0,1,2
3673093,3674955,1862,0,0,1,1
3674956,3675000,44,1,0,0,1
3674956,3675037,81,1,0,0,2
3675001,3675152,151,0,0,1,1
3675038,3675153,115,0,0,1,2
3675153,3675175,22,1,0,0,1
3675154,3675173,19,1,0,0,2
3675174,3675258,84,0,0,1,2
3675176,3675264,88,0,0,1,1
3675259,3675779,520,1,0,0,2
3675265,3675592,327,1,0,0,1
3675288,3675547,259,0,1,0,1
3675289,3675566,277,0,1,0,2
3675593,3675752,159,0,0,1,1
3675753,3675773,20,1,0,0,1
3675774,3676044,270,0,0,1,1
3675780,3676021,241,0,0,1,2
3676022,3676367,345,1,0,0,2
3676045,3676326,281,1,0,0,1
3676062,3676292,230,0,1,0,2
3676065,3676279,214,0,1,0,1
3676327,3676699,372,0,0,1,1
3676368,3676704,336,0,0,1,2
3676700,3676714,14,1,0,0,1
3676705,3676719,14,1,0,0,2
3676715,3677166,451,0,0,1,1
3676720,3677135,415,0,0,1,2
3677136,3677610,474,1,0,0,2
3677167,3677504,337,1,0,0,1
3677184,3677473,289,0,1,0,1
3677188,3677543,355,0,1,0,2
3677505,3677576,71,0,0,1,1
3677577,3677602,25,1,0,0,1
3677603,3677826,223,0,0,1,1
3677611,3677827,216,0,0,1,2
3677827,3677854,27,1,0,0,1
3677828,3677857,29,1,0,0,2
3677855,3678608,753,0,0,1,1
3677858,3678364,506,0,0,1,2
3678365,3678421,56,1,0,0,2
3678422,3678606,184,0,0,1,2
3678607,3678644,37,1,0,0,2
3678609,3678631,22,1,0,0,1
3678632,3679026,394,0,0,1,1
3678645,3679024,379,0,0,1,2
3679025,3679068,43,1,0,0,2
3679027,3679065,38,1,0,0,1
3679066,3679275,209,0,0,1,1
3679069,3680195,1126,0,0,1,2
3679276,3679285,9,1,0,0,1
3679286,3680194,908,0,0,1,1
3680195,3680248,53,1,0,0,1
3680196,3680248,52,1,0,0,2
3680249,3680383,134,0,0,1,2
3680249,3680384,135,0,0,1,1
3680384,3681004,620,1,0,0,2
3680385,3680810,425,1,0,0,1
3680421,3680717,296,0,1,0,1
3680424,3680809,385,0,1,0,2
3680811,3681201,390,0,0,1,1
3681005,3681192,187,0,0,1,2
3681193,3681722,529,1,0,0,2
3681202,3681515,313,1,0,0,1
3681217,3681451,234,0,1,0,1
3681217,3681476,259,0,1,0,2
3681516,3682046,530,0,0,1,1
3681723,3682047,324,0,0,1,2
3682047,3682073,26,1,0,0,1
3682048,3682072,24,1,0,0,2
3682073,3682330,257,0,0,1,2
3682074,3682329,255,0,0,1,1
3682330,3682355,25,1,0,0,1
3682331,3682355,24,1,0,0,2
3682356,3682913,557,0,0,1,2
3682356,3682915,559,0,0,1,1
3682914,3682955,41,1,0,0,2
3682916,3682954,38,1,0,0,1
3682955,3683194,239,0,0,1,1
3682956,3683193,237,0,0,1,2
3683194,3683238,44,1,0,0,2
3683195,3683233,38,1,0,0,1
3683234,3683642,408,0,0,1,1
3683239,3683641,402,0,0,1,2
3683642,3685008,1366,1,0,0,2
3683643,3683701,58,1,0,0,1
3683694,3684997,1303,0,1,0,2
3683702,3683821,119,0,0,1,1
3683822,3683858,36,1,0,0,1
3683859,3684296,437,0,0,1,1
3684297,3684310,13,1,0,0,1
3684311,3684441,130,0,0,1,1
3684442,3684446,4,1,0,0,1
3684447,3684514,67,0,0,1,1
3684515,3684575,60,1,0,0,1
3684576,3684758,182,0,0,1,1
3684769,3684946,177,0,1,0,1
3684956,3684990,34,1,0,0,1
3684991,3685142,151,0,0,1,1
3685009,3685140,131,0,0,1,2
3685141,3685575,434,1,0,0,2
3685143,3685452,309,1,0,0,1
3685176,3685416,240,0,1,0,1
3685176,3685456,280,0,1,0,2
3685453,3685920,467,0,0,1,1
3685576,3685923,347,0,0,1,2
3685921,3685935,14,1,0,0,1
3685924,3685936,12,1,0,0,2
3685936,3686103,167,0,0,1,1
3685937,3686087,150,0,0,1,2
3686088,3686457,369,1,0,0,2
3686104,3686372,268,1,0,0,1
3686118,3686368,250,0,1,0,2
3686121,3686341,220,0,1,0,1
3686373,3687067,694,0,0,1,1
3686458,3687053,595,0,0,1,2
3687054,3687506,452,1,0,0,2
3687068,3687405,337,1,0,0,1
3687084,3687365,281,0,1,0,2
3687085,3687352,267,0,1,0,1
3687406,3688210,804,0,0,1,1
3687507,3687562,55,0,0,1,2
3687563,3687598,35,1,0,0,2
3687599,3688209,610,0,0,1,2
3688210,3688375,165,1,0,0,2
3688211,3688263,52,1,0,0,1
3688264,3688419,155,0,0,1,1
3688376,3688418,42,0,0,1,2
3688419,3690181,1762,1,0,0,2
3688420,3688438,18,1,0,0,1
3688439,3689653,1214,0,0,1,1
3688487,3690086,1599,0,1,0,2
3689664,3690033,369,0,1,0,1
3690043,3690070,27,1,0,0,1
3690071,3690291,220,0,0,1,1
3690182,3690235,53,0,0,1,2
3690236,3691112,876,1,0,0,2
3690292,3690596,304,1,0,0,1
3690306,3690667,361,0,1,0,2
3690312,3690552,240,0,1,0,1
3690597,3691452,855,0,0,1,1
3691113,3691150,37,0,0,1,2
3691151,3691258,107,1,0,0,2
3691259,3691280,21,0,0,1,2
3691281,3691422,141,1,0,0,2
3691423,3691453,30,0,0,1,2
3691453,3691479,26,1,0,0,1
3691454,3691489,35,1,0,0,2
3691480,3692082,602,0,0,1,1
3691490,3691538,48,0,0,1,2
3691539,3691681,142,1,0,0,2
3691682,3691718,36,0,0,1,2
3691719,3694595,2876,1,0,0,2
3692083,3692485,402,1,0,0,1
3692094,3693011,917,0,1,0,2
3692106,3692439,333,0,1,0,1
3692486,3694016,1530,0,0,1,1
3694017,3695704,1687,1,0,0,1
3694062,3695693,1631,0,1,0,1
3694596,3694624,28,0,0,1,2
3694625,3694726,101,1,0,0,2
3694727,3694831,104,0,0,1,2
3694832,3694866,34,1,0,0,2
3694867,3695413,546,0,0,1,2
3695414,3695433,19,1,0,0,2
3695434,3695475,41,0,0,1,2
3695476,3695535,59,1,0,0,2
3695536,3695649,113,0,0,1,2
3695650,3695708,58,1,0,0,2
3695705,3695945,240,0,0,1,1
3695709,3695738,29,0,0,1,2
3695739,3695821,82,1,0,0,2
3695822,3695943,121,0,0,1,2
3695944,3695996,52,1,0,0,2
3695946,3695982,36,1,0,0,1
3695983,3696116,133,0,0,1,1
3695997,3696091,94,0,0,1,2
3696092,3696726,634,1,0,0,2
3696117,3696479,362,1,0,0,1
3696133,3696636,503,0,1,0,2
3696135,3696469,334,0,1,0,1
3696480,3697592,1112,0,0,1,1
3696727,3696767,40,0,0,1,2
3696768,3696884,116,1,0,0,2
3696885,3696918,33,0,0,1,2
3696919,3697117,198,1,0,0,2
3697118,3697559,441,0,0,1,2
3697560,3698061,501,1,0,0,2
3697593,3698040,447,1,0,0,1
3697621,3698043,422,0,1,0,2
3697622,3697956,334,0,1,0,1
3698041,3698188,147,0,0,1,1
3698062,3698188,126,0,0,1,2
3698189,3698221,32,1,0,0,1
3698189,3698227,38,1,0,0,2
3698222,3698891,669,0,0,1,1
3698228,3698612,384,0,0,1,2
3698613,3698622,9,1,0,0,2
3698623,3699114,491,0,0,1,2
3698902,3698973,71,0,1,0,1
3698983,3699001,18,1,0,0,1
3699002,3699051,49,0,0,1,1
3699062,3699871,809,0,1,0,1
3699115,3699244,129,1,0,0,2
3699245,3699452,207,0,0,1,2
3699453,3699886,433,1,0,0,2
3699587,3699658,71,0,1,0,2
3699680,3699759,79,0,1,0,2
3699811,3699811,0,0,1,0,2
3699881,3699881,0,1,0,0,1
3699882,3700094,212,0,0,1,1
3699887,3700094,207,0,0,1,2
3700095,3700165,70,1,0,0,2
3700095,3700173,78,1,0,0,1
3700166,3700236,70,0,0,1,2
3700174,3700236,62,0,0,1,1
3700237,3700273,36,1,0,0,1
3700237,3700273,36,1,0,0,2
3700274,3700402,128,0,0,1,2
3700274,3700403,129,0,0,1,1
3700403,3700420,17,1,0,0,2
3700404,3700420,16,1,0,0,1
3700421,3701708,1287,0,0,1,1
3700421,3701708,1287,0,0,1,2
3701709,3701747,38,1,0,0,2
3701709,3701748,39,1,0,0,1
3701748,3701922,174,0,0,1,2
3701749,3701927,178,0,0,1,1
3701923,3702212,289,1,0,0,2
3701928,3702216,288,1,0,0,1
3701948,3702152,204,0,1,0,1
3701956,3702155,199,0,1,0,2
3702213,3702591,378,0,0,1,2
3702217,3702577,360,0,0,1,1
3702578,3702897,319,1,0,0,1
3702592,3702920,328,1,0,0,2
3702613,3702832,219,0,1,0,1
3702616,3702850,234,0,1,0,2
3702898,3703207,309,0,0,1,1
3702921,3703206,285,0,0,1,2
3703207,3703236,29,1,0,0,2
3703208,3703236,28,1,0,0,1
3703237,3703275,38,0,0,1,1
3703237,3703281,44,0,0,1,2
3703276,3703567,291,1,0,0,1
3703282,3703580,298,1,0,0,2
3703304,3703502,198,0,1,0,1
3703307,3703522,215,0,1,0,2
3703568,3704265,697,0,0,1,1
3703581,3704268,687,0,0,1,2
3704266,3704590,324,1,0,0,1
3704269,3704651,382,1,0,0,2
3704298,3704539,241,0,1,0,1
3704301,3704598,297,0,1,0,2
3704591,3705114,523,0,0,1,1
3704652,3705115,463,0,0,1,2
3705115,3705168,53,1,0,0,1
3705116,3705179,63,1,0,0,2
3705169,3705291,122,0,0,1,1
3705180,3705291,111,0,0,1,2
3705292,3705310,18,1,0,0,2
3705292,3705312,20,1,0,0,1
3705311,3706660,1349,0,0,1,2
3705313,3706659,1346,0,0,1,1
3706660,3706696,36,1,0,0,1
3706661,3706698,37,1,0,0,2
3706697,3706855,158,0,0,1,1
3706699,3707457,758,0,0,1,2
3706856,3706862,6,1,0,0,1
3706863,3707468,605,0,0,1,1
3707458,3707736,278,1,0,0,2
3707469,3707723,254,1,0,0,1
3707489,3707688,199,0,1,0,1
3707492,3707693,201,0,1,0,2
3707724,3707904,180,0,0,1,1
3707737,3707788,51,0,0,1,2
3707789,3707804,15,1,0,0,2
3707805,3707835,30,0,0,1,2
3707836,3707840,4,1,0,0,2
3707841,3708923,1082,0,0,1,2
3707905,3707909,4,1,0,0,1
3707910,3708940,1030,0,0,1,1
3708924,3709479,555,1,0,0,2
3708941,3709363,422,1,0,0,1
3708965,3709335,370,0,1,0,1
3708966,3709374,408,0,1,0,2
3709364,3710354,990,0,0,1,1
3709480,3710354,874,0,0,1,2
3710355,3710424,69,1,0,0,1
3710355,3710463,108,1,0,0,2
3710425,3710522,97,0,0,1,1
3710464,3710509,45,0,0,1,2
3710510,3712013,1503,1,0,0,2
3710523,3710554,31,1,0,0,1
3710550,3712004,1454,0,1,0,2
3710555,3710745,190,0,0,1,1
3710746,3710833,87,1,0,0,1
3710834,3711466,632,0,0,1,1
3711467,3711482,15,1,0,0,1
3711483,3711931,448,0,0,1,1
3711932,3711991,59,1,0,0,1
3711992,3712231,239,0,0,1,1
3712014,3712232,218,0,0,1,2
3712232,3712248,16,1,0,0,1
3712233,3712248,15,1,0,0,2
3712249,3712968,719,0,0,1,1
3712249,3714039,1790,0,0,1,2
3712969,3712984,15,1,0,0,1
3712985,3714040,1055,0,0,1,1
3714040,3714086,46,1,0,0,2
3714041,3714086,45,1,0,0,1
3714087,3714380,293,0,0,1,1
3714087,3714384,297,0,0,1,2
3714381,3714918,537,1,0,0,1
3714385,3715616,1231,1,0,0,2
3714405,3715593,1188,0,1,0,2
3714421,3714898,477,0,1,0,1
3714919,3715446,527,0,0,1,1
3715447,3715464,17,1,0,0,1
3715465,3715519,54,0,0,1,1
3715520,3715585,65,1,0,0,1
3715586,3715686,100,0,0,1,1
3715617,3715686,69,0,0,1,2
3715687,3715711,24,1,0,0,2
3715687,3715714,27,1,0,0,1
3715712,3715858,146,0,0,1,2
3715715,3717430,1715,0,0,1,1
3715859,3715866,7,1,0,0,2
3715867,3715979,112,0,0,1,2
3715980,3716012,32,1,0,0,2
3716013,3716229,216,0,0,1,2
3716230,3716234,4,1,0,0,2
3716235,3716479,244,0,0,1,2
3716480,3716522,42,1,0,0,2
3716523,3716830,307,0,0,1,2
3716831,3716907,76,1,0,0,2
3716908,3717092,184,0,0,1,2
3717093,3717097,4,1,0,0,2
3717098,3717357,259,0,0,1,2
3717358,3717363,5,1,0,0,2
3717364,3717429,65,0,0,1,2
3717430,3717483,53,1,0,0,2
3717431,3717477,46,1,0,0,1
3717478,3717683,205,0,0,1,1
3717484,3717682,198,0,0,1,2
3717683,3717705,22,1,0,0,2
3717684,3717702,18,1,0,0,1
3717703,3717942,239,0,0,1,1
3717706,3717927,221,0,0,1,2
3717928,3718300,372,1,0,0,2
3717943,3718247,304,1,0,0,1
3717966,3718200,234,0,1,0,1
3717970,3718197,227,0,1,0,2
3718248,3718420,172,0,0,1,1
3718301,3718421,120,0,0,1,2
3718421,3718436,15,1,0,0,1
3718422,3718433,11,1,0,0,2
3718434,3719567,1133,0,0,1,2
3718437,3719567,1130,0,0,1,1
3719568,3719919,351,1,0,0,1
3719568,3720181,613,1,0,0,2
3719617,3719877,260,0,1,0,1
3719618,3719890,272,0,1,0,2
3719920,3720248,328,0,0,1,1
3720182,3720248,66,0,0,1,2
3720249,3720301,52,1,0,0,1
3720249,3720346,97,1,0,0,2
3720302,3721196,894,0,0,1,1
3720347,3720696,349,0,0,1,2
3720697,3720710,13,1,0,0,2
3720711,3721046,335,0,0,1,2
3721047,3726514,5467,1,0,0,2
3721197,3721261,64,1,0,0,1
3721243,3726071,4828,0,1,0,2
3721262,3721402,140,0,0,1,1
3721403,3721427,24,1,0,0,1
3721428,3721707,279,0,0,1,1
3721708,3721744,36,1,0,0,1
3721745,3721778,33,0,0,1,1
3721789,3721793,4,0,1,0,1
3721803,3723464,1661,1,0,0,1
3721821,3723330,1509,0,1,0,1
3723380,3723388,8,0,1,0,1
3723465,3723688,223,0,0,1,1
3723689,3723735,46,1,0,0,1
3723736,3724120,384,0,0,1,1
3724121,3724404,283,1,0,0,1
3724405,3724482,77,0,0,1,1
3724483,3724562,79,1,0,0,1
3724563,3724807,244,0,0,1,1
3724818,3725477,659,0,1,0,1
3725487,3725497,10,1,0,0,1
3725498,3725704,206,0,0,1,1
3725705,3725737,32,1,0,0,1
3725738,3725991,253,0,0,1,1
3725992,3726023,31,1,0,0,1
3726024,3726410,386,0,0,1,1
3726411,3726475,64,1,0,0,1
3726476,3726591,115,0,0,1,1
3726515,3726591,76,0,0,1,2
3726592,3726624,32,1,0,0,1
3726592,3726627,35,1,0,0,2
3726625,3726765,140,0,0,1,1
3726628,3726770,142,0,0,1,2
3726766,3726781,15,1,0,0,1
3726771,3726781,10,1,0,0,2
3726782,3727703,921,0,0,1,2
3726782,3727782,1000,0,0,1,1
3727704,3727829,125,1,0,0,2
3727783,3727822,39,1,0,0,1
3727823,3728108,285,0,0,1,1
3727830,3728094,264,0,0,1,2
3728095,3728362,267,1,0,0,2
3728109,3728356,247,1,0,0,1
3728129,3728293,164,0,1,0,1
3728133,3728286,153,0,1,0,2
3728357,3729137,780,0,0,1,1
3728363,3729136,773,0,0,1,2
3729137,3729160,23,1,0,0,2
3729138,3729162,24,1,0,0,1
3729161,3729971,810,0,0,1,2
3729163,3729977,814,0,0,1,1
3729972,3730279,307,1,0,0,2
3729978,3730240,262,1,0,0,1
3730001,3730195,194,0,1,0,1
3730002,3730190,188,0,1,0,2
3730241,3730278,37,0,0,1,1
3730279,3730283,4,1,0,0,1
3730280,3730744,464,0,0,1,2
3730284,3730742,458,0,0,1,1
3730743,3730787,44,1,0,0,1
3730745,3730787,42,1,0,0,2
3730788,3731197,409,0,0,1,2
3730788,3731199,411,0,0,1,1
3731198,3731242,44,1,0,0,2
3731200,3731257,57,1,0,0,1
3731243,3731391,148,0,0,1,2
3731258,3731388,130,0,0,1,1
3731389,3731401,12,1,0,0,1
3731392,3731406,14,1,0,0,2
3731402,3732706,1304,0,0,1,1
3731407,3732706,1299,0,0,1,2
3732707,3732757,50,1,0,0,1
3732707,3732759,52,1,0,0,2
3732758,3732963,205,0,0,1,1
3732760,3732950,190,0,0,1,2
3732951,3733181,230,1,0,0,2
3732964,3733154,190,1,0,0,1
3732985,3733122,137,0,1,0,2
3732986,3733127,141,0,1,0,1
3733155,3733788,633,0,0,1,1
3733182,3733785,603,0,0,1,2
3733786,3733810,24,1,0,0,2
3733789,3733801,12,1,0,0,1
3733802,3734015,213,0,0,1,1
3733811,3733999,188,0,0,1,2
3734000,3734256,256,1,0,0,2
3734016,3734252,236,1,0,0,1
3734037,3734193,156,0,1,0,1
3734040,3734184,144,0,1,0,2
3734253,3734841,588,0,0,1,1
3734257,3734842,585,0,0,1,2
3734842,3734870,28,1,0,0,1
3734843,3734881,38,1,0,0,2
3734871,3735111,240,0,0,1,1
3734882,3735110,228,0,0,1,2
3735111,3735136,25,1,0,0,2
3735112,3735137,25,1,0,0,1
3735137,3736506,1369,0,0,1,2
3735138,3736508,1370,0,0,1,1
3736507,3736681,174,1,0,0,2
3736509,3736582,73,1,0,0,1
3736583,3736633,50,0,0,1,1
3736634,3737465,831,1,0,0,1
3736682,3736703,21,0,0,1,2
3736704,3736741,37,1,0,0,2
3736742,3737083,341,0,0,1,2
3736787,3736836,49,0,1,0,1
3736871,3736932,61,0,1,0,1
3736962,3737010,48,0,1,0,1
3737052,3737054,2,0,1,0,1
3737084,3737088,4,1,0,0,2
3737087,3737330,243,0,1,0,1
3737089,3737326,237,0,0,1,2
3737327,3737411,84,1,0,0,2
3737373,3737426,53,0,1,0,1
3737412,3737597,185,0,0,1,2
3737466,3737923,457,0,0,1,1
3737598,3737615,17,1,0,0,2
3737616,3737649,33,0,0,1,2
3737650,3737800,150,1,0,0,2
3737801,3737835,34,0,0,1,2
3737836,3738013,177,1,0,0,2
3737934,3737977,43,0,1,0,1
3737987,3738020,33,1,0,0,1
3738014,3738339,325,0,0,1,2
3738021,3738237,216,0,0,1,1
3738238,3738249,11,1,0,0,1
3738250,3738327,77,0,0,1,1
3738328,3738695,367,1,0,0,1
3738340,3738679,339,1,0,0,2
3738362,3738632,270,0,1,0,2
3738362,3738644,282,0,1,0,1
3738680,3738726,46,0,0,1,2
3738696,3739145,449,0,0,1,1
3738727,3738846,119,1,0,0,2
3738847,3739151,304,0,0,1,2
3739146,3739164,18,1,0,0,1
3739152,3739200,48,1,0,0,2
3739165,3739342,177,0,0,1,1
3739201,3739305,104,0,0,1,2
3739306,3739310,4,1,0,0,2
3739311,3739350,39,0,0,1,2
3739343,3739770,427,1,0,0,1
3739351,3739980,629,1,0,0,2
3739372,3739742,370,0,1,0,2
3739374,3739744,370,0,1,0,1
3739771,3740236,465,0,0,1,1
3739981,3740237,256,0,0,1,2
3740237,3740307,70,1,0,0,1
3740238,3740294,56,1,0,0,2
3740295,3740679,384,0,0,1,2
3740308,3740679,371,0,0,1,1
3740680,3740711,31,1,0,0,1
3740680,3740712,32,1,0,0,2
3740712,3740937,225,0,0,1,1
3740713,3740826,113,0,0,1,2
3740827,3740877,50,1,0,0,2
3740878,3740932,54,0,0,1,2
3740933,3740979,46,1,0,0,2
3740938,3740979,41,1,0,0,1
3740980,3741639,659,0,0,1,1
3740980,3741639,659,0,0,1,2
3741640,3741687,47,1,0,0,1
3741640,3741705,65,1,0,0,2
3741688,3741732,44,0,0,1,1
3741706,3741733,27,0,0,1,2
3741733,3741766,33,1,0,0,1
3741734,3741759,25,1,0,0,2
3741760,3741895,135,0,0,1,2
3741767,3741897,130,0,0,1,1
3741896,3741918,22,1,0,0,2
3741898,3741918,20,1,0,0,1
3741919,3742740,821,0,0,1,1
3741919,3742740,821,0,0,1,2
3742741,3742782,41,1,0,0,1
3742741,3742782,41,1,0,0,2
3742783,3743051,268,0,0,1,2
3742783,3743052,269,0,0,1,1
3743052,3743064,12,1,0,0,2
3743053,3743064,11,1,0,0,1
3743065,3743177,112,0,0,1,2
3743065,3743187,122,0,0,1,1
3743178,3743497,319,1,0,0,2
3743188,3743466,278,1,0,0,1
3743208,3743411,203,0,1,0,1
3743210,3743390,180,0,1,0,2
3743467,3745029,1562,0,0,1,1
3743498,3745017,1519,0,0,1,2
3745018,3745395,377,1,0,0,2
3745030,3745441,411,1,0,0,1
3745058,3745331,273,0,1,0,1
3745059,3745312,253,0,1,0,2
3745396,3745676,280,0,0,1,2
3745442,3745676,234,0,0,1,1
3745677,3745736,59,1,0,0,1
3745677,3745738,61,1,0,0,2
3745737,3745893,156,0,0,1,1
3745739,3745893,154,0,0,1,2
3745894,3745932,38,1,0,0,1
3745894,3745941,47,1,0,0,2
3745933,3746212,279,0,0,1,1
3745942,3746213,271,0,0,1,2
3746213,3746286,73,1,0,0,1
3746214,3746277,63,1,0,0,2
3746278,3746404,126,0,0,1,2
3746287,3746404,117,0,0,1,1
3746405,3746424,19,1,0,0,2
3746405,3746427,22,1,0,0,1
3746425,3747544,1119,0,0,1,2
3746428,3747543,1115,0,0,1,1
3747544,3747578,34,1,0,0,1
3747545,3747579,34,1,0,0,2
3747579,3747936,357,0,0,1,1
3747580,3747940,360,0,0,1,2
3747937,3748263,326,1,0,0,1
3747941,3748260,319,1,0,0,2
3747963,3748175,212,0,1,0,1
3747966,3748168,202,0,1,0,2
3748261,3749302,1041,0,0,1,2
3748264,3749310,1046,0,0,1,1
3749303,3749585,282,1,0,0,2
3749311,3749566,255,1,0,0,1
3749336,3749509,173,0,1,0,2
3749337,3749501,164,0,1,0,1
3749567,3749807,240,0,0,1,1
3749586,3749805,219,0,0,1,2
3749806,3749856,50,1,0,0,2
3749808,3749863,55,1,0,0,1
3749857,3751051,1194,0,0,1,2
3749864,3751049,1185,0,0,1,1
3751050,3751110,60,1,0,0,1
3751052,3751108,56,1,0,0,2
3751109,3751222,113,0,0,1,2
3751111,3751220,109,0,0,1,1
3751221,3751252,31,1,0,0,1
3751223,3751249,26,1,0,0,2
3751250,3752647,1397,0,0,1,2
3751253,3752647,1394,0,0,1,1
3752648,3752696,48,1,0,0,1
3752648,3752702,54,1,0,0,2
3752697,3753283,586,0,0,1,1
3752703,3753287,584,0,0,1,2
3753284,3753304,20,1,0,0,1
3753288,3753303,15,1,0,0,2
3753304,3753579,275,0,0,1,2
3753305,3753594,289,0,0,1,1
3753580,3753831,251,1,0,0,2
3753595,3753823,228,1,0,0,1
3753626,3753752,126,0,1,0,1
3753629,3753736,107,0,1,0,2
3753824,3754954,1130,0,0,1,1
3753832,3754936,1104,0,0,1,2
3754937,3755334,397,1,0,0,2
3754955,3755348,393,1,0,0,1
3754992,3755266,274,0,1,0,1
3754996,3755255,259,0,1,0,2
3755335,3756484,1149,0,0,1,2
3755349,3756484,1135,0,0,1,1
3756485,3756537,52,1,0,0,1
3756485,3756539,54,1,0,0,2
3756538,3756653,115,0,0,1,1
3756540,3756652,112,0,0,1,2
3756653,3756678,25,1,0,0,2
3756654,3756688,34,1,0,0,1
3756679,3757932,1253,0,0,1,2
3756689,3757930,1241,0,0,1,1
3757931,3757970,39,1,0,0,1
3757933,3757969,36,1,0,0,2
3757970,3758238,268,0,0,1,2
3757971,3758227,256,0,0,1,1
3758228,3758576,348,1,0,0,1
3758239,3758579,340,1,0,0,2
3758258,3758506,248,0,1,0,1
3758267,3758506,239,0,1,0,2
3758577,3758658,81,0,0,1,1
3758580,3758660,80,0,0,1,2
3758659,3758675,16,1,0,0,1
3758661,3758667,6,1,0,0,2
3758668,3759102,434,0,0,1,2
3758676,3759098,422,0,0,1,1
3759099,3759334,235,1,0,0,1
3759103,3759339,236,1,0,0,2
3759123,3759273,150,0,1,0,1
3759124,3759272,148,0,1,0,2
3759335,3759693,358,0,0,1,1
3759340,3759688,348,0,0,1,2
3759689,3759707,18,1,0,0,2
3759694,3759704,10,1,0,0,1
3759705,3759917,212,0,0,1,1
3759708,3759917,209,0,0,1,2
3759918,3760192,274,1,0,0,2
3759918,3760211,293,1,0,0,1
3759942,3760126,184,0,1,0,1
3759947,3760124,177,0,1,0,2
3760193,3760603,410,0,0,1,2
3760212,3760604,392,0,0,1,1
3760604,3760630,26,1,0,0,2
3760605,3760629,24,1,0,0,1
3760630,3761357,727,0,0,1,1
3760631,3761357,726,0,0,1,2
3761358,3761400,42,1,0,0,2
3761358,3761401,43,1,0,0,1
3761401,3761598,197,0,0,1,2
3761402,3761597,195,0,0,1,1
3761598,3761673,75,1,0,0,1
3761599,3761651,52,1,0,0,2
3761652,3761767,115,0,0,1,2
3761674,3761765,91,0,0,1,1
3761766,3761801,35,1,0,0,1
3761768,3761794,26,1,0,0,2
3761783,3761790,7,0,1,0,1
3761795,3761977,182,0,0,1,2
3761802,3761947,145,0,0,1,1
3761948,3762007,59,1,0,0,1
3761978,3762084,106,1,0,0,2
3762008,3762037,29,0,0,1,1
3762038,3762124,86,1,0,0,1
3762085,3762684,599,0,0,1,2
3762125,3762145,20,0,0,1,1
3762146,3762747,601,1,0,0,1
3762685,3762723,38,1,0,0,2
3762717,3762718,1,0,1,0,1
3762724,3762944,220,0,0,1,2
3762748,3762926,178,0,0,1,1
3762927,3763405,478,1,0,0,1
3762945,3763326,381,1,0,0,2
3762963,3763278,315,0,1,0,1
3762968,3763302,334,0,1,0,2
3763327,3763393,66,0,0,1,2
3763394,3763404,10,1,0,0,2
3763405,3763712,307,0,0,1,2
3763406,3764206,800,0,0,1,1
3763713,3763749,36,1,0,0,2
3763750,3764225,475,0,0,1,2
3764207,3764649,442,1,0,0,1
3764226,3764725,499,1,0,0,2
3764262,3764579,317,0,1,0,2
3764263,3764559,296,0,1,0,1
3764650,3764880,230,0,0,1,1
3764726,3764826,100,0,0,1,2
3764827,3764848,21,1,0,0,2
3764849,3764991,142,0,0,1,2
3764881,3764885,4,1,0,0,1
3764886,3765008,122,0,0,1,1
3764992,3765063,71,1,0,0,2
3765009,3765080,71,1,0,0,1
3765064,3765382,318,0,0,1,2
3765081,3765383,302,0,0,1,1
3765383,3765483,100,1,0,0,2
3765384,3765422,38,1,0,0,1
3765423,3765997,574,0,0,1,1
3765484,3765553,69,0,0,1,2
3765554,3765587,33,1,0,0,2
3765588,3765841,253,0,0,1,2
3765842,3766069,227,1,0,0,2
3765998,3766055,57,1,0,0,1
3766056,3766212,156,0,0,1,1
3766070,3766214,144,0,0,1,2
3766213,3766234,21,1,0,0,1
3766215,3766231,16,1,0,0,2
3766232,3766412,180,0,0,1,2
3766235,3767514,1279,0,0,1,1
3766413,3766428,15,1,0,0,2
3766429,3767516,1087,0,0,1,2
3767515,3767573,58,1,0,0,1
3767517,3767585,68,1,0,0,2
3767574,3767717,143,0,0,1,1
3767586,3767714,128,0,0,1,2
3767715,3769358,1643,1,0,0,2
3767718,3768244,526,1,0,0,1
3767742,3768356,614,0,1,0,2
3767743,3768222,479,0,1,0,1
3768245,3768560,315,0,0,1,1
3768561,3768581,20,1,0,0,1
3768582,3768646,64,0,0,1,1
3768647,3769130,483,1,0,0,1
3768668,3769270,602,0,1,0,2
3768674,3769081,407,0,1,0,1
3769131,3769551,420,0,0,1,1
3769359,3769411,52,0,0,1,2
3769412,3769463,51,1,0,0,2
3769464,3769559,95,0,0,1,2
3769552,3770098,546,1,0,0,1
3769560,3770434,874,1,0,0,2
3769572,3770238,666,0,1,0,2
3769582,3770074,492,0,1,0,1
3770099,3771127,1028,0,0,1,1
3770435,3770486,51,0,0,1,2
3770487,3770791,304,1,0,0,2
3770792,3770858,66,0,0,1,2
3770859,3774432,3573,1,0,0,2
3771128,3773500,2372,1,0,0,1
3771148,3772646,1498,0,1,0,2
3771162,3773472,2310,0,1,0,1
3772741,3774421,1680,0,1,0,2
3773501,3773523,22,0,0,1,1
3773524,3776436,2912,1,0,0,1
3773536,3776425,2889,0,1,0,1
3774433,3774463,30,0,0,1,2
3774464,3776479,2015,1,0,0,2
3774707,3776421,1714,0,1,0,2
3776437,3776576,139,0,0,1,1
3776480,3776576,96,0,0,1,2
3776577,3776593,16,1,0,0,1
3776577,3776610,33,1,0,0,2
3776594,3778030,1436,0,0,1,1
3776611,3778032,1421,0,0,1,2
3778031,3778091,60,1,0,0,1
3778033,3778091,58,1,0,0,2
3778092,3778303,211,0,0,1,2
3778092,3778304,212,0,0,1,1
3778304,3778325,21,1,0,0,2
3778305,3778326,21,1,0,0,1
3778326,3780093,1767,0,0,1,2
3778327,3780097,1770,0,0,1,1
3780094,3780480,386,1,0,0,2
3780098,3780450,352,1,0,0,1
3780124,3780418,294,0,1,0,1
3780126,3780405,279,0,1,0,2
3780451,3781302,851,0,0,1,1
3780481,3781302,821,0,0,1,2
3781303,3781350,47,1,0,0,2
3781303,3781359,56,1,0,0,1
3781351,3781769,418,0,0,1,2
3781360,3781769,409,0,0,1,1
