start,end,duration,saccade,blink,fixation,eye
1518777,1519032,255,0,0,1,1
1518779,1519031,252,0,0,1,2
1519032,1519070,38,1,0,0,2
1519033,1519073,40,1,0,0,1
1519071,1519480,409,0,0,1,2
1519074,1519474,400,0,0,1,1
1519475,1519500,25,1,0,0,1
1519481,1519491,10,1,0,0,2
1519492,1521366,1874,0,0,1,2
1519501,1521706,2205,0,0,1,1
1521367,1521463,96,1,0,0,2
1521464,1521502,38,0,0,1,2
1521503,1521526,23,1,0,0,2
1521527,1521597,70,0,0,1,2
1521598,1521605,7,1,0,0,2
1521606,1521646,40,0,0,1,2
1521647,1521773,126,1,0,0,2
1521707,1521720,13,1,0,0,1
1521721,1521851,130,0,0,1,1
1521774,1521857,83,0,0,1,2
1521852,1521997,145,1,0,0,1
1521858,1522335,477,1,0,0,2
1521884,1521975,91,0,1,0,1
1521888,1521953,65,0,1,0,2
1521998,1522027,29,0,0,1,1
1522028,1522298,270,1,0,0,1
1522042,1522279,237,0,1,0,1
1522052,1522234,182,0,1,0,2
1522299,1522323,24,0,0,1,1
1522324,1522331,7,1,0,0,1
1522332,1522479,147,0,0,1,1
1522336,1522368,32,0,0,1,2
1522369,1522393,24,1,0,0,2
1522394,1522478,84,0,0,1,2
1522479,1522542,63,1,0,0,2
1522480,1522525,45,1,0,0,1
1522526,1522663,137,0,0,1,1
1522543,1522619,76,0,0,1,2
1522620,1522692,72,1,0,0,2
1522664,1522691,27,1,0,0,1
1522692,1523839,1147,0,0,1,1
1522693,1523841,1148,0,0,1,2
1523840,1523870,30,1,0,0,1
1523842,1523894,52,1,0,0,2
1523871,1524418,547,0,0,1,1
1523895,1524058,163,0,0,1,2
1524059,1524133,74,1,0,0,2
1524134,1524183,49,0,0,1,2
1524184,1524270,86,1,0,0,2
1524271,1524408,137,0,0,1,2
1524409,1524582,173,1,0,0,2
1524419,1524436,17,1,0,0,1
1524437,1524880,443,0,0,1,1
1524583,1525990,1407,0,0,1,2
1524881,1524890,9,1,0,0,1
1524891,1525988,1097,0,0,1,1
1525989,1527449,1460,1,0,0,1
1525991,1527472,1481,1,0,0,2
1526056,1527434,1378,0,1,0,1
1526066,1527443,1377,0,1,0,2
1527450,1527581,131,0,0,1,1
1527473,1527581,108,0,0,1,2
1527582,1527609,27,1,0,0,1
1527582,1527665,83,1,0,0,2
1527610,1528903,1293,0,0,1,1
1527666,1527712,46,0,0,1,2
1527713,1527763,50,1,0,0,2
1527764,1527849,85,0,0,1,2
1527850,1527974,124,1,0,0,2
1527975,1528077,102,0,0,1,2
1528078,1528094,16,1,0,0,2
1528095,1528309,214,0,0,1,2
1528310,1528376,66,1,0,0,2
1528377,1528507,130,0,0,1,2
1528508,1528523,15,1,0,0,2
1528524,1528904,380,0,0,1,2
1528904,1528981,77,1,0,0,1
1528905,1528971,66,1,0,0,2
1528972,1529118,146,0,0,1,2
1528982,1529119,137,0,0,1,1
1529119,1529162,43,1,0,0,2
1529120,1529167,47,1,0,0,1
1529163,1529357,194,0,0,1,2
1529168,1529356,188,0,0,1,1
1529357,1529367,10,1,0,0,1
1529358,1529367,9,1,0,0,2
1529368,1529733,365,0,0,1,1
1529368,1532573,3205,0,0,1,2
1529734,1529762,28,1,0,0,1
1529763,1531029,1266,0,0,1,1
1531030,1531047,17,1,0,0,1
1531048,1532575,1527,0,0,1,1
1532574,1532667,93,1,0,0,2
1532576,1532667,91,1,0,0,1
1532668,1532834,166,0,0,1,1
1532668,1532834,166,0,0,1,2
1532835,1532929,94,1,0,0,1
1532835,1532931,96,1,0,0,2
1532930,1533190,260,0,0,1,1
1532932,1533190,258,0,0,1,2
1533191,1533219,28,1,0,0,1
1533191,1533219,28,1,0,0,2
1533220,1533602,382,0,0,1,1
1533220,1533602,382,0,0,1,2
1533603,1533616,13,1,0,0,1
1533603,1533616,13,1,0,0,2
1533617,1535756,2139,0,0,1,1
1533617,1535757,2140,0,0,1,2
1535757,1535810,53,1,0,0,1
1535758,1535841,83,1,0,0,2
1535811,1535912,101,0,0,1,1
1535842,1535911,69,0,0,1,2
1535912,1535999,87,1,0,0,2
1535913,1535995,82,1,0,0,1
1535996,1536182,186,0,0,1,1
1536000,1536182,182,0,0,1,2
1536183,1536208,25,1,0,0,2
1536183,1536210,27,1,0,0,1
1536209,1536754,545,0,0,1,2
1536211,1536754,543,0,0,1,1
1536755,1536771,16,1,0,0,1
1536755,1536773,18,1,0,0,2
1536772,1538271,1499,0,0,1,1
1536774,1538272,1498,0,0,1,2
1538272,1538371,99,1,0,0,1
1538273,1538371,98,1,0,0,2
1538372,1538480,108,0,0,1,1
1538372,1538481,109,0,0,1,2
1538481,1538534,53,1,0,0,1
1538482,1538532,50,1,0,0,2
1538533,1538777,244,0,0,1,2
1538535,1538776,241,0,0,1,1
1538777,1538805,28,1,0,0,1
1538778,1538805,27,1,0,0,2
1538806,1540362,1556,0,0,1,1
1538806,1540362,1556,0,0,1,2
1540363,1540418,55,1,0,0,2
1540363,1540422,59,1,0,0,1
1540419,1540579,160,0,0,1,2
1540423,1540578,155,0,0,1,1
1540579,1540645,66,1,0,0,1
1540580,1540644,64,1,0,0,2
1540645,1540783,138,0,0,1,2
1540646,1540783,137,0,0,1,1
1540784,1540861,77,1,0,0,2
1540784,1540863,79,1,0,0,1
1540862,1541039,177,0,0,1,2
1540864,1541037,173,0,0,1,1
1541038,1541058,20,1,0,0,1
1541040,1541066,26,1,0,0,2
1541059,1542391,1332,0,0,1,1
1541067,1542391,1324,0,0,1,2
1542392,1542444,52,1,0,0,2
1542392,1542448,56,1,0,0,1
1542445,1542773,328,0,0,1,2
1542449,1542775,326,0,0,1,1
1542774,1542890,116,1,0,0,2
1542776,1542885,109,1,0,0,1
1542886,1543007,121,0,0,1,1
1542891,1543010,119,0,0,1,2
1543008,1543040,32,1,0,0,1
1543011,1543038,27,1,0,0,2
1543039,1543254,215,0,0,1,2
1543041,1543250,209,0,0,1,1
1543251,1543272,21,1,0,0,1
1543255,1543273,18,1,0,0,2
1543273,1543604,331,0,0,1,1
1543274,1543595,321,0,0,1,2
1543596,1543613,17,1,0,0,2
1543605,1543613,8,1,0,0,1
1543614,1543775,161,0,0,1,2
1543614,1544689,1075,0,0,1,1
1543776,1543784,8,1,0,0,2
1543785,1544687,902,0,0,1,2
1544688,1544746,58,1,0,0,2
1544690,1544744,54,1,0,0,1
1544745,1545150,405,0,0,1,1
1544747,1545150,403,0,0,1,2
1545151,1545216,65,1,0,0,2
1545151,1545217,66,1,0,0,1
1545217,1545638,421,0,0,1,2
1545218,1545638,420,0,0,1,1
1545639,1545649,10,1,0,0,1
1545639,1545665,26,1,0,0,2
1545650,1547028,1378,0,0,1,1
1545666,1547028,1362,0,0,1,2
1547029,1547079,50,1,0,0,2
1547029,1547080,51,1,0,0,1
1547080,1547206,126,0,0,1,2
1547081,1547206,125,0,0,1,1
1547207,1547256,49,1,0,0,1
1547207,1547263,56,1,0,0,2
1547257,1547509,252,0,0,1,1
1547264,1547509,245,0,0,1,2
1547510,1547535,25,1,0,0,1
1547510,1547536,26,1,0,0,2
1547536,1547927,391,0,0,1,1
1547537,1547927,390,0,0,1,2
1547928,1547938,10,1,0,0,1
1547928,1547939,11,1,0,0,2
1547939,1548713,774,0,0,1,1
1547940,1548713,773,0,0,1,2
1548714,1548745,31,1,0,0,1
1548714,1548747,33,1,0,0,2
1548746,1548981,235,0,0,1,1
1548748,1548981,233,0,0,1,2
1548982,1549045,63,1,0,0,2
1548982,1549050,68,1,0,0,1
1549046,1549145,99,0,0,1,2
1549051,1549143,92,0,0,1,1
1549144,1549177,33,1,0,0,1
1549146,1549184,38,1,0,0,2
1549178,1549425,247,0,0,1,1
1549185,1549425,240,0,0,1,2
1549426,1549447,21,1,0,0,1
1549426,1549452,26,1,0,0,2
1549448,1550237,789,0,0,1,1
1549453,1550239,786,0,0,1,2
1550238,1550286,48,1,0,0,1
1550240,1550288,48,1,0,0,2
1550287,1550802,515,0,0,1,1
1550289,1550805,516,0,0,1,2
1550803,1550863,60,1,0,0,1
1550806,1550867,61,1,0,0,2
1550864,1551035,171,0,0,1,1
1550868,1551035,167,0,0,1,2
1551036,1551111,75,1,0,0,1
1551036,1551123,87,1,0,0,2
1551112,1551270,158,0,0,1,1
1551124,1551269,145,0,0,1,2
1551270,1551295,25,1,0,0,2
1551271,1551296,25,1,0,0,1
1551296,1551538,242,0,0,1,2
1551297,1551535,238,0,0,1,1
1551536,1551550,14,1,0,0,1
1551539,1551553,14,1,0,0,2
1551551,1552257,706,0,0,1,1
1551554,1552257,703,0,0,1,2
1552258,1552323,65,1,0,0,2
1552258,1552327,69,1,0,0,1
1552324,1552960,636,0,0,1,2
1552328,1552960,632,0,0,1,1
1552961,1553048,87,1,0,0,2
1552961,1553050,89,1,0,0,1
1553049,1553156,107,0,0,1,2
1553051,1553158,107,0,0,1,1
1553157,1553184,27,1,0,0,2
1553159,1553189,30,1,0,0,1
1553185,1553397,212,0,0,1,2
1553190,1553396,206,0,0,1,1
1553397,1553414,17,1,0,0,1
1553398,1553414,16,1,0,0,2
1553415,1554162,747,0,0,1,1
1553415,1554164,749,0,0,1,2
1554163,1554219,56,1,0,0,1
1554165,1554210,45,1,0,0,2
1554211,1554694,483,0,0,1,2
1554220,1554692,472,0,0,1,1
1554693,1554749,56,1,0,0,1
1554695,1554762,67,1,0,0,2
1554750,1554884,134,0,0,1,1
1554763,1554883,120,0,0,1,2
1554884,1554948,64,1,0,0,2
1554885,1554961,76,1,0,0,1
1554949,1555060,111,0,0,1,2
1554962,1555059,97,0,0,1,1
1555060,1555097,37,1,0,0,1
1555061,1555098,37,1,0,0,2
1555098,1555420,322,0,0,1,1
1555099,1555423,324,0,0,1,2
1555421,1555439,18,1,0,0,1
1555424,1555439,15,1,0,0,2
1555440,1556700,1260,0,0,1,1
1555440,1556700,1260,0,0,1,2
1556701,1556750,49,1,0,0,2
1556701,1556752,51,1,0,0,1
1556751,1556994,243,0,0,1,2
1556753,1556989,236,0,0,1,1
1556990,1557012,22,1,0,0,1
1556995,1557006,11,1,0,0,2
1557007,1558713,1706,0,0,1,2
1557013,1558712,1699,0,0,1,1
1558713,1558781,68,1,0,0,1
1558714,1558784,70,1,0,0,2
1558782,1558886,104,0,0,1,1
1558785,1558889,104,0,0,1,2
1558887,1558920,33,1,0,0,1
1558890,1558912,22,1,0,0,2
1558913,1559022,109,0,0,1,2
1558921,1559087,166,0,0,1,1
1559023,1559034,11,1,0,0,2
1559035,1559086,51,0,0,1,2
1559087,1559114,27,1,0,0,2
1559088,1559112,24,1,0,0,1
1559113,1559718,605,0,0,1,1
1559115,1559422,307,0,0,1,2
1559423,1559471,48,1,0,0,2
1559472,1559657,185,0,0,1,2
1559658,1559788,130,1,0,0,2
1559719,1559771,52,1,0,0,1
1559772,1559977,205,0,0,1,1
1559789,1559978,189,0,0,1,2
1559978,1559995,17,1,0,0,1
1559979,1560003,24,1,0,0,2
1559996,1560820,824,0,0,1,1
1560004,1560047,43,0,0,1,2
1560048,1560078,30,1,0,0,2
1560079,1560820,741,0,0,1,2
1560821,1560891,70,1,0,0,1
1560821,1560892,71,1,0,0,2
1560892,1561028,136,0,0,1,1
1560893,1561028,135,0,0,1,2
1561029,1561053,24,1,0,0,2
1561029,1561054,25,1,0,0,1
1561054,1562135,1081,0,0,1,2
1561055,1562253,1198,0,0,1,1
1562136,1562140,4,1,0,0,2
1562141,1562210,69,0,0,1,2
1562211,1562361,150,1,0,0,2
1562254,1562358,104,1,0,0,1
1562359,1562520,161,0,0,1,1
1562362,1562520,158,0,0,1,2
1562521,1562542,21,1,0,0,2
1562521,1562550,29,1,0,0,1
1562543,1563671,1128,0,0,1,2
1562551,1563672,1121,0,0,1,1
1563672,1563742,70,1,0,0,2
1563673,1563732,59,1,0,0,1
1563733,1564104,371,0,0,1,1
1563743,1564104,361,0,0,1,2
1564105,1564176,71,1,0,0,2
1564105,1564180,75,1,0,0,1
1564177,1564344,167,0,0,1,2
1564181,1564342,161,0,0,1,1
1564343,1564397,54,1,0,0,1
1564345,1564405,60,1,0,0,2
1564398,1564557,159,0,0,1,1
1564406,1564557,151,0,0,1,2
1564558,1564575,17,1,0,0,1
1564558,1564605,47,1,0,0,2
1564576,1564816,240,0,0,1,1
1564606,1564816,210,0,0,1,2
1564817,1564843,26,1,0,0,2
1564817,1564844,27,1,0,0,1
1564844,1565261,417,0,0,1,2
1564845,1565265,420,0,0,1,1
1565262,1565282,20,1,0,0,2
1565266,1565283,17,1,0,0,1
1565283,1566344,1061,0,0,1,2
1565284,1566343,1059,0,0,1,1
1566344,1566422,78,1,0,0,1
1566345,1566422,77,1,0,0,2
1566423,1566541,118,0,0,1,2
1566423,1566542,119,0,0,1,1
1566542,1566578,36,1,0,0,2
1566543,1566569,26,1,0,0,1
1566570,1566951,381,0,0,1,1
1566579,1566951,372,0,0,1,2
1566952,1566962,10,1,0,0,1
1566952,1566962,10,1,0,0,2
1566963,1567863,900,0,0,1,2
1566963,1567864,901,0,0,1,1
1567864,1567910,46,1,0,0,2
1567865,1567904,39,1,0,0,1
1567905,1568501,596,0,0,1,1
1567911,1568501,590,0,0,1,2
1568502,1568548,46,1,0,0,1
1568502,1568550,48,1,0,0,2
1568549,1568732,183,0,0,1,1
1568551,1568732,181,0,0,1,2
1568733,1568750,17,1,0,0,1
1568733,1568770,37,1,0,0,2
1568751,1569086,335,0,0,1,1
1568771,1569085,314,0,0,1,2
1569086,1569102,16,1,0,0,2
1569087,1569095,8,1,0,0,1
1569096,1570098,1002,0,0,1,1
1569103,1569874,771,0,0,1,2
1569875,1569889,14,1,0,0,2
1569890,1570099,209,0,0,1,2
1570099,1570141,42,1,0,0,1
1570100,1570140,40,1,0,0,2
1570141,1570481,340,0,0,1,2
1570142,1570480,338,0,0,1,1
1570481,1570558,77,1,0,0,1
1570482,1570558,76,1,0,0,2
1570559,1570694,135,0,0,1,1
1570559,1570694,135,0,0,1,2
1570695,1570719,24,1,0,0,2
1570695,1570725,30,1,0,0,1
1570720,1571236,516,0,0,1,2
1570726,1571235,509,0,0,1,1
1571236,1571256,20,1,0,0,1
1571237,1571257,20,1,0,0,2
1571257,1572038,781,0,0,1,1
1571258,1572038,780,0,0,1,2
1572039,1572099,60,1,0,0,2
1572039,1572103,64,1,0,0,1
1572100,1572531,431,0,0,1,2
1572104,1572530,426,0,0,1,1
1572531,1572605,74,1,0,0,1
1572532,1572592,60,1,0,0,2
1572593,1573899,1306,0,0,1,2
1572606,1573171,565,0,0,1,1
1573172,1573181,9,1,0,0,1
1573182,1573898,716,0,0,1,1
1573899,1573948,49,1,0,0,1
1573900,1573962,62,1,0,0,2
1573949,1574399,450,0,0,1,1
1573963,1574398,435,0,0,1,2
1574399,1574486,87,1,0,0,2
1574400,1574475,75,1,0,0,1
1574476,1574611,135,0,0,1,1
1574487,1574611,124,0,0,1,2
1574612,1574635,23,1,0,0,1
1574612,1574637,25,1,0,0,2
1574636,1574894,258,0,0,1,1
1574638,1574891,253,0,0,1,2
1574892,1574914,22,1,0,0,2
1574895,1574903,8,1,0,0,1
1574904,1575533,629,0,0,1,1
1574915,1575014,99,0,0,1,2
1575015,1575057,42,1,0,0,2
1575058,1575532,474,0,0,1,2
1575533,1575573,40,1,0,0,2
1575534,1575571,37,1,0,0,1
1575572,1575952,380,0,0,1,1
1575574,1575952,378,0,0,1,2
1575953,1575996,43,1,0,0,1
1575953,1576237,284,1,0,0,2
1575997,1576343,346,0,0,1,1
1576238,1576346,108,0,0,1,2
1576344,1576410,66,1,0,0,1
1576347,1576419,72,1,0,0,2
1576411,1576568,157,0,0,1,1
1576420,1576566,146,0,0,1,2
1576567,1576596,29,1,0,0,2
1576569,1576589,20,1,0,0,1
1576590,1577067,477,0,0,1,1
1576597,1577060,463,0,0,1,2
1577061,1577078,17,1,0,0,2
1577068,1577082,14,1,0,0,1
1577079,1578302,1223,0,0,1,2
1577083,1578303,1220,0,0,1,1
1578303,1578437,134,1,0,0,2
1578304,1578420,116,1,0,0,1
1578421,1578517,96,0,0,1,1
1578438,1578516,78,0,0,1,2
1578517,1578577,60,1,0,0,2
1578518,1578578,60,1,0,0,1
1578578,1578811,233,0,0,1,2
1578579,1578811,232,0,0,1,1
1578812,1578832,20,1,0,0,2
1578812,1578837,25,1,0,0,1
1578833,1579990,1157,0,0,1,2
1578838,1579990,1152,0,0,1,1
1579991,1580084,93,1,0,0,2
1579991,1580085,94,1,0,0,1
1580085,1580230,145,0,0,1,2
1580086,1580229,143,0,0,1,1
1580230,1580299,69,1,0,0,1
1580231,1580308,77,1,0,0,2
1580300,1580477,177,0,0,1,1
1580309,1580475,166,0,0,1,2
1580476,1580505,29,1,0,0,2
1580478,1580503,25,1,0,0,1
1580504,1581124,620,0,0,1,1
1580506,1581125,619,0,0,1,2
1581125,1581144,19,1,0,0,1
1581126,1581143,17,1,0,0,2
1581144,1581563,419,0,0,1,2
1581145,1581562,417,0,0,1,1
1581563,1581615,52,1,0,0,1
1581564,1581616,52,1,0,0,2
1581616,1582103,487,0,0,1,1
1581617,1582101,484,0,0,1,2
1582102,1582151,49,1,0,0,2
1582104,1582159,55,1,0,0,1
1582152,1582240,88,0,0,1,2
1582160,1582239,79,0,0,1,1
1582240,1582313,73,1,0,0,1
1582241,1582326,85,1,0,0,2
1582314,1582419,105,0,0,1,1
1582327,1582419,92,0,0,1,2
1582420,1582458,38,1,0,0,2
1582420,1582459,39,1,0,0,1
1582459,1582953,494,0,0,1,2
1582460,1582952,492,0,0,1,1
1582953,1582974,21,1,0,0,1
1582954,1582973,19,1,0,0,2
1582974,1583547,573,0,0,1,2
1582975,1583548,573,0,0,1,1
1583548,1583611,63,1,0,0,2
1583549,1583615,66,1,0,0,1
1583612,1583881,269,0,0,1,2
1583616,1583881,265,0,0,1,1
1583882,1583934,52,1,0,0,2
1583882,1583940,58,1,0,0,1
1583935,1584147,212,0,0,1,2
1583941,1584146,205,0,0,1,1
1584147,1584201,54,1,0,0,1
1584148,1584215,67,1,0,0,2
1584202,1584319,117,0,0,1,1
1584216,1584318,102,0,0,1,2
1584319,1584340,21,1,0,0,2
1584320,1584348,28,1,0,0,1
1584341,1585378,1037,0,0,1,2
1584349,1585378,1029,0,0,1,1
1585379,1585428,49,1,0,0,2
1585379,1585430,51,1,0,0,1
1585429,1585854,425,0,0,1,2
1585431,1585854,423,0,0,1,1
1585855,1585938,83,1,0,0,1
1585855,1585938,83,1,0,0,2
1585939,1586134,195,0,0,1,1
1585939,1586138,199,0,0,1,2
1586135,1586155,20,1,0,0,1
1586139,1586156,17,1,0,0,2
1586156,1587122,966,0,0,1,1
1586157,1587121,964,0,0,1,2
1587122,1587187,65,1,0,0,2
1587123,1587200,77,1,0,0,1
1587188,1587805,617,0,0,1,2
1587201,1587806,605,0,0,1,1
1587806,1587841,35,1,0,0,2
1587807,1587839,32,1,0,0,1
1587840,1588042,202,0,0,1,1
1587842,1588041,199,0,0,1,2
1588042,1588061,19,1,0,0,2
1588043,1588058,15,1,0,0,1
1588059,1588967,908,0,0,1,1
1588062,1588967,905,0,0,1,2
1588968,1589008,40,1,0,0,2
1588968,1589009,41,1,0,0,1
1589009,1589616,607,0,0,1,2
1589010,1589617,607,0,0,1,1
1589617,1589668,51,1,0,0,2
1589618,1589679,61,1,0,0,1
1589669,1589863,194,0,0,1,2
1589680,1589861,181,0,0,1,1
1589862,1589882,20,1,0,0,1
1589864,1589881,17,1,0,0,2
1589882,1591013,1131,0,0,1,2
1589883,1591012,1129,0,0,1,1
1591013,1591062,49,1,0,0,1
1591014,1591071,57,1,0,0,2
1591063,1591506,443,0,0,1,1
1591072,1591506,434,0,0,1,2
1591507,1591556,49,1,0,0,2
1591507,1591572,65,1,0,0,1
1591557,1591734,177,0,0,1,2
1591573,1591734,161,0,0,1,1
1591735,1591756,21,1,0,0,1
1591735,1591757,22,1,0,0,2
1591757,1592065,308,0,0,1,1
1591758,1592065,307,0,0,1,2
1592066,1592076,10,1,0,0,1
1592066,1592076,10,1,0,0,2
1592077,1592907,830,0,0,1,1
1592077,1592908,831,0,0,1,2
1592908,1592951,43,1,0,0,1
1592909,1592951,42,1,0,0,2
1592952,1592986,34,0,0,1,2
1592952,1593406,454,0,0,1,1
1592987,1593024,37,1,0,0,2
1593025,1593403,378,0,0,1,2
1593404,1593505,101,1,0,0,2
1593407,1593500,93,1,0,0,1
1593501,1593620,119,0,0,1,1
1593506,1593619,113,0,0,1,2
1593620,1593661,41,1,0,0,2
1593621,1593650,29,1,0,0,1
1593651,1594821,1170,0,0,1,1
1593662,1594820,1158,0,0,1,2
1594821,1594868,47,1,0,0,2
1594822,1594879,57,1,0,0,1
1594869,1595277,408,0,0,1,2
1594880,1595276,396,0,0,1,1
1595277,1595355,78,1,0,0,1
1595278,1595355,77,1,0,0,2
1595356,1595503,147,0,0,1,1
1595356,1595503,147,0,0,1,2
1595504,1595534,30,1,0,0,1
1595504,1595534,30,1,0,0,2
1595535,1596675,1140,0,0,1,1
1595535,1596676,1141,0,0,1,2
1596676,1596728,52,1,0,0,1
1596677,1596723,46,1,0,0,2
1596724,1597219,495,0,0,1,2
1596729,1597218,489,0,0,1,1
1597219,1597286,67,1,0,0,1
1597220,1597287,67,1,0,0,2
1597287,1597493,206,0,0,1,1
1597288,1597492,204,0,0,1,2
1597493,1597516,23,1,0,0,2
1597494,1597516,22,1,0,0,1
1597517,1598994,1477,0,0,1,1
1597517,1598996,1479,0,0,1,2
1598995,1599056,61,1,0,0,1
1598997,1599067,70,1,0,0,2
1599057,1599246,189,0,0,1,1
1599068,1599246,178,0,0,1,2
1599247,1599272,25,1,0,0,2
1599247,1599274,27,1,0,0,1
1599273,1599545,272,0,0,1,2
1599275,1599549,274,0,0,1,1
1599546,1599570,24,1,0,0,2
1599550,1599561,11,1,0,0,1
1599562,1600208,646,0,0,1,1
1599571,1600208,637,0,0,1,2
1600209,1600227,18,1,0,0,1
1600209,1600236,27,1,0,0,2
1600228,1600897,669,0,0,1,1
1600237,1600897,660,0,0,1,2
1600898,1600995,97,1,0,0,1
1600898,1601016,118,1,0,0,2
1600996,1601095,99,0,0,1,1
1601017,1601097,80,0,0,1,2
1601096,1601130,34,1,0,0,1
1601098,1601122,24,1,0,0,2
1601123,1601463,340,0,0,1,2
1601131,1601463,332,0,0,1,1
1601464,1601482,18,1,0,0,2
1601464,1601488,24,1,0,0,1
1601483,1602336,853,0,0,1,2
1601489,1602334,845,0,0,1,1
1602335,1602390,55,1,0,0,1
1602337,1602407,70,1,0,0,2
1602391,1602572,181,0,0,1,1
1602408,1602465,57,0,0,1,2
1602466,1602470,4,1,0,0,2
1602471,1602572,101,0,0,1,2
1602573,1602659,86,1,0,0,1
1602573,1602662,89,1,0,0,2
1602660,1602824,164,0,0,1,1
1602663,1602825,162,0,0,1,2
1602825,1602922,97,1,0,0,1
1602826,1602932,106,1,0,0,2
1602923,1603165,242,0,0,1,1
1602933,1603164,231,0,0,1,2
1603165,1603187,22,1,0,0,2
1603166,1603193,27,1,0,0,1
1603188,1604414,1226,0,0,1,2
1603194,1604416,1222,0,0,1,1
1604415,1604526,111,1,0,0,2
1604417,1604501,84,1,0,0,1
1604502,1604679,177,0,0,1,1
1604527,1604679,152,0,0,1,2
1604680,1604730,50,1,0,0,2
1604680,1604731,51,1,0,0,1
1604731,1604851,120,0,0,1,2
1604732,1604851,119,0,0,1,1
1604852,1604872,20,1,0,0,2
1604852,1604873,21,1,0,0,1
1604873,1605128,255,0,0,1,2
1604874,1605129,255,0,0,1,1
1605129,1605154,25,1,0,0,2
1605130,1605154,24,1,0,0,1
1605155,1606272,1117,0,0,1,1
1605155,1606273,1118,0,0,1,2
1606273,1606313,40,1,0,0,1
1606274,1606329,55,1,0,0,2
1606314,1606674,360,0,0,1,1
1606330,1606445,115,0,0,1,2
1606446,1606455,9,1,0,0,2
1606456,1606661,205,0,0,1,2
1606662,1606760,98,1,0,0,2
1606675,1606761,86,1,0,0,1
1606761,1606881,120,0,0,1,2
1606762,1606879,117,0,0,1,1
1606880,1606910,30,1,0,0,1
1606882,1606911,29,1,0,0,2
1606911,1608124,1213,0,0,1,1
1606912,1608124,1212,0,0,1,2
1608125,1608201,76,1,0,0,1
1608125,1608211,86,1,0,0,2
1608202,1608631,429,0,0,1,1
1608212,1608631,419,0,0,1,2
1608632,1608704,72,1,0,0,2
1608632,1608718,86,1,0,0,1
1608705,1608855,150,0,0,1,2
1608719,1608853,134,0,0,1,1
1608854,1608889,35,1,0,0,1
1608856,1608881,25,1,0,0,2
1608882,1609259,377,0,0,1,2
1608890,1609254,364,0,0,1,1
1609255,1609282,27,1,0,0,1
1609260,1609274,14,1,0,0,2
1609275,1609767,492,0,0,1,2
1609283,1609768,485,0,0,1,1
1609768,1609831,63,1,0,0,2
1609769,1609830,61,1,0,0,1
1609831,1610459,628,0,0,1,1
1609832,1610459,627,0,0,1,2
1610460,1610566,106,1,0,0,1
1610460,1610566,106,1,0,0,2
1610567,1610689,122,0,0,1,1
1610567,1610690,123,0,0,1,2
1610690,1610728,38,1,0,0,1
1610691,1610727,36,1,0,0,2
1610728,1610995,267,0,0,1,2
1610729,1610996,267,0,0,1,1
1610996,1611018,22,1,0,0,2
1610997,1611022,25,1,0,0,1
1611019,1611583,564,0,0,1,2
1611023,1611584,561,0,0,1,1
1611584,1611640,56,1,0,0,2
1611585,1611650,65,1,0,0,1
1611641,1612285,644,0,0,1,2
1611651,1612284,633,0,0,1,1
1612285,1612381,96,1,0,0,1
1612286,1612383,97,1,0,0,2
1612382,1612553,171,0,0,1,1
1612384,1612554,170,0,0,1,2
1612554,1612586,32,1,0,0,1
1612555,1612593,38,1,0,0,2
1612587,1612764,177,0,0,1,1
1612594,1612765,171,0,0,1,2
1612765,1612786,21,1,0,0,1
1612766,1612809,43,1,0,0,2
1612787,1613407,620,0,0,1,1
1612810,1613405,595,0,0,1,2
1613406,1613466,60,1,0,0,2
1613408,1613466,58,1,0,0,1
1613467,1613954,487,0,0,1,2
1613467,1613955,488,0,0,1,1
1613955,1613972,17,1,0,0,2
1613956,1613973,17,1,0,0,1
1613973,1614091,118,0,0,1,2
1613974,1614092,118,0,0,1,1
1614092,1614163,71,1,0,0,2
1614093,1614164,71,1,0,0,1
1614164,1614313,149,0,0,1,2
1614165,1614312,147,0,0,1,1
1614313,1614338,25,1,0,0,1
1614314,1614349,35,1,0,0,2
1614339,1615262,923,0,0,1,1
1614350,1615261,911,0,0,1,2
1615262,1615331,69,1,0,0,2
1615263,1615332,69,1,0,0,1
1615332,1615659,327,0,0,1,2
1615333,1615659,326,0,0,1,1
1615660,1615709,49,1,0,0,1
1615660,1615713,53,1,0,0,2
1615710,1616103,393,0,0,1,1
1615714,1616102,388,0,0,1,2
1616103,1616135,32,1,0,0,2
1616104,1616135,31,1,0,0,1
1616136,1616608,472,0,0,1,2
1616136,1616613,477,0,0,1,1
1616609,1616634,25,1,0,0,2
1616614,1616628,14,1,0,0,1
1616629,1617325,696,0,0,1,1
1616635,1617324,689,0,0,1,2
1617325,1617360,35,1,0,0,2
1617326,1617358,32,1,0,0,1
1617359,1617731,372,0,0,1,1
1617361,1617731,370,0,0,1,2
1617732,1617837,105,1,0,0,2
1617732,1617838,106,1,0,0,1
1617838,1617936,98,0,0,1,2
1617839,1617936,97,0,0,1,1
1617937,1617970,33,1,0,0,1
1617937,1617980,43,1,0,0,2
1617971,1618249,278,0,0,1,1
1617981,1618249,268,0,0,1,2
1618250,1618272,22,1,0,0,2
1618250,1618277,27,1,0,0,1
1618273,1618571,298,0,0,1,2
1618278,1618573,295,0,0,1,1
1618572,1618600,28,1,0,0,2
1618574,1618591,17,1,0,0,1
1618592,1618945,353,0,0,1,1
1618601,1618947,346,0,0,1,2
1618946,1619023,77,1,0,0,1
1618948,1619015,67,1,0,0,2
1619016,1619664,648,0,0,1,2
1619024,1619660,636,0,0,1,1
1619661,1619748,87,1,0,0,1
1619665,1619750,85,1,0,0,2
1619749,1620039,290,0,0,1,1
1619751,1620040,289,0,0,1,2
1620040,1620061,21,1,0,0,1
1620041,1620067,26,1,0,0,2
1620062,1620386,324,0,0,1,1
1620068,1620390,322,0,0,1,2
1620387,1620402,15,1,0,0,1
1620391,1620405,14,1,0,0,2
1620403,1620882,479,0,0,1,1
1620406,1620882,476,0,0,1,2
1620883,1620937,54,1,0,0,1
1620883,1620939,56,1,0,0,2
1620938,1621639,701,0,0,1,1
1620940,1621638,698,0,0,1,2
1621639,1621721,82,1,0,0,2
1621640,1621731,91,1,0,0,1
1621722,1621830,108,0,0,1,2
1621732,1621830,98,0,0,1,1
1621831,1621873,42,1,0,0,1
1621831,1621881,50,1,0,0,2
1621874,1622474,600,0,0,1,1
1621882,1622474,592,0,0,1,2
1622475,1622480,5,1,0,0,1
1622475,1622483,8,1,0,0,2
1622481,1623141,660,0,0,1,1
1622484,1623142,658,0,0,1,2
1623142,1623207,65,1,0,0,1
1623143,1623221,78,1,0,0,2
1623208,1623714,506,0,0,1,1
1623222,1623714,492,0,0,1,2
1623715,1623804,89,1,0,0,2
1623715,1623808,93,1,0,0,1
1623805,1623987,182,0,0,1,2
1623809,1623987,178,0,0,1,1
1623988,1624014,26,1,0,0,2
1623988,1624015,27,1,0,0,1
1624015,1624427,412,0,0,1,2
1624016,1625055,1039,0,0,1,1
1624428,1624448,20,1,0,0,2
1624449,1625053,604,0,0,1,2
1625054,1625128,74,1,0,0,2
1625056,1625127,71,1,0,0,1
1625128,1625978,850,0,0,1,1
1625129,1625977,848,0,0,1,2
1625978,1626048,70,1,0,0,2
1625979,1626045,66,1,0,0,1
1626046,1626104,58,0,0,1,1
1626049,1626107,58,0,0,1,2
1626105,1626527,422,1,0,0,1
1626108,1626518,410,1,0,0,2
1626131,1626247,116,0,1,0,1
1626133,1626232,99,0,1,0,2
1626297,1626513,216,0,1,0,1
1626305,1626495,190,0,1,0,2
1626519,1626563,44,0,0,1,2
1626528,1626559,31,0,0,1,1
1626560,1627385,825,1,0,0,1
1626564,1627383,819,1,0,0,2
1626579,1627165,586,0,1,0,1
1626586,1627172,586,0,1,0,2
1627213,1627360,147,0,1,0,1
1627218,1627345,127,0,1,0,2
1627384,1627508,124,0,0,1,2
1627386,1627507,121,0,0,1,1
1627508,1627584,76,1,0,0,1
1627509,1627584,75,1,0,0,2
1627585,1627632,47,0,0,1,1
1627585,1627637,52,0,0,1,2
1627633,1627793,160,1,0,0,1
1627638,1627784,146,1,0,0,2
1627652,1627776,124,0,1,0,1
1627655,1627755,100,0,1,0,2
1627785,1628053,268,0,0,1,2
1627794,1628043,249,0,0,1,1
1628044,1628307,263,1,0,0,1
1628054,1628274,220,1,0,0,2
1628064,1628296,232,0,1,0,1
1628068,1628254,186,0,1,0,2
1628275,1628751,476,0,0,1,2
1628308,1628744,436,0,0,1,1
1628745,1628938,193,1,0,0,1
1628752,1628931,179,1,0,0,2
1628766,1628923,157,0,1,0,1
1628775,1628911,136,0,1,0,2
1628932,1629351,419,0,0,1,2
1628939,1629351,412,0,0,1,1
1629352,1629414,62,1,0,0,1
1629352,1629415,63,1,0,0,2
1629415,1629715,300,0,0,1,1
1629416,1629717,301,0,0,1,2
1629716,1629889,173,1,0,0,1
1629718,1629912,194,1,0,0,2
1629735,1629869,134,0,1,0,1
1629736,1629870,134,0,1,0,2
1629890,1630259,369,0,0,1,1
1629913,1630259,346,0,0,1,2
1630260,1630307,47,1,0,0,2
1630260,1630308,48,1,0,0,1
1630308,1630692,384,0,0,1,2
1630309,1630694,385,0,0,1,1
1630693,1630857,164,1,0,0,2
1630705,1630831,126,0,1,0,1
1630709,1630821,112,0,1,0,2
1630841,1630849,8,1,0,0,1
1630850,1631107,257,0,0,1,1
1630858,1631104,246,0,0,1,2
1631105,1631181,76,1,0,0,2
1631108,1631198,90,1,0,0,1
1631182,1631339,157,0,0,1,2
1631199,1631336,137,0,0,1,1
1631337,1631495,158,1,0,0,1
1631340,1631507,167,1,0,0,2
1631353,1631463,110,0,1,0,1
1631357,1631449,92,0,1,0,2
1631496,1631656,160,0,0,1,1
1631508,1631658,150,0,0,1,2
1631657,1631709,52,1,0,0,1
1631659,1631723,64,1,0,0,2
1631710,1632126,416,0,0,1,1
1631724,1632127,403,0,0,1,2
1632127,1632180,53,1,0,0,1
1632128,1632183,55,1,0,0,2
1632181,1632357,176,0,0,1,1
1632184,1632356,172,0,0,1,2
1632357,1632379,22,1,0,0,2
1632358,1632379,21,1,0,0,1
1632380,1634317,1937,0,0,1,1
1632380,1636031,3651,0,0,1,2
1634318,1634322,4,1,0,0,1
1634323,1636031,1708,0,0,1,1
1636032,1636057,25,1,0,0,2
1636032,1636059,27,1,0,0,1
1636058,1636345,287,0,0,1,2
1636060,1636343,283,0,0,1,1
1636344,1636534,190,1,0,0,1
1636346,1636539,193,1,0,0,2
1636374,1636485,111,0,1,0,1
1636375,1636477,102,0,1,0,2
1636535,1636601,66,0,0,1,1
1636540,1636599,59,0,0,1,2
1636600,1636629,29,1,0,0,2
1636602,1636628,26,1,0,0,1
1636629,1636973,344,0,0,1,1
1636630,1636984,354,0,0,1,2
1636974,1637342,368,1,0,0,1
1636985,1637303,318,1,0,0,2
1636997,1637331,334,0,1,0,1
1637002,1637289,287,0,1,0,2
1637304,1637680,376,0,0,1,2
1637343,1637671,328,0,0,1,1
1637672,1638206,534,1,0,0,1
1637681,1638193,512,1,0,0,2
1637691,1638195,504,0,1,0,1
1637704,1637979,275,0,1,0,2
1638002,1638183,181,0,1,0,2
1638194,1638331,137,0,0,1,2
1638207,1638332,125,0,0,1,1
1638332,1638400,68,1,0,0,2
1638333,1638399,66,1,0,0,1
1638400,1639150,750,0,0,1,1
1638401,1639139,738,0,0,1,2
1639140,1639385,245,1,0,0,2
1639151,1639378,227,1,0,0,1
1639169,1639361,192,0,1,0,1
1639170,1639348,178,0,1,0,2
1639379,1640101,722,0,0,1,1
1639386,1639515,129,0,0,1,2
1639516,1639605,89,1,0,0,2
1639606,1640100,494,0,0,1,2
1640101,1640166,65,1,0,0,2
1640102,1640161,59,1,0,0,1
1640162,1640366,204,0,0,1,1
1640167,1640355,188,0,0,1,2
1640356,1640594,238,1,0,0,2
1640367,1640635,268,1,0,0,1
1640385,1640577,192,0,1,0,1
1640388,1640571,183,0,1,0,2
1640595,1641005,410,0,0,1,2
1640636,1641003,367,0,0,1,1
1641004,1641183,179,1,0,0,1
1641006,1641150,144,1,0,0,2
1641031,1641133,102,0,1,0,1
1641038,1641115,77,0,1,0,2
1641151,1641489,338,0,0,1,2
1641184,1641489,305,0,0,1,1
1641490,1641513,23,1,0,0,2
1641490,1641522,32,1,0,0,1
1641514,1642213,699,0,0,1,2
1641523,1642218,695,0,0,1,1
1642214,1642681,467,1,0,0,2
1642219,1642694,475,1,0,0,1
1642241,1642683,442,0,1,0,1
1642244,1642650,406,0,1,0,2
1642682,1642823,141,0,0,1,2
1642695,1642823,128,0,0,1,1
1642824,1642986,162,1,0,0,2
1642824,1643002,178,1,0,0,1
1642841,1642975,134,0,1,0,1
1642847,1642946,99,0,1,0,2
1642987,1643096,109,0,0,1,2
1643003,1643096,93,0,0,1,1
1643097,1643134,37,1,0,0,2
1643097,1643143,46,1,0,0,1
1643135,1644319,1184,0,0,1,2
1643144,1644307,1163,0,0,1,1
1644308,1644475,167,1,0,0,1
1644320,1644494,174,1,0,0,2
1644337,1644458,121,0,1,0,1
1644343,1644447,104,0,1,0,2
1644476,1644666,190,0,0,1,1
1644495,1644540,45,0,0,1,2
1644541,1644557,16,1,0,0,2
1644558,1644653,95,0,0,1,2
1644654,1644846,192,1,0,0,2
1644667,1644855,188,1,0,0,1
1644683,1644833,150,0,1,0,1
1644690,1644817,127,0,1,0,2
1644847,1644877,30,0,0,1,2
1644856,1645034,178,0,0,1,1
1644878,1644898,20,1,0,0,2
1644899,1645035,136,0,0,1,2
1645035,1645098,63,1,0,0,1
1645036,1645103,67,1,0,0,2
1645099,1646083,984,0,0,1,1
1645104,1646089,985,0,0,1,2
1646084,1646262,178,1,0,0,1
1646090,1646262,172,1,0,0,2
1646106,1646222,116,0,1,0,1
1646109,1646226,117,0,1,0,2
1646263,1646287,24,0,0,1,2
1646263,1646460,197,0,0,1,1
1646288,1646306,18,1,0,0,2
1646307,1646460,153,0,0,1,2
1646461,1646521,60,1,0,0,2
1646461,1646526,65,1,0,0,1
1646522,1646929,407,0,0,1,2
1646527,1646928,401,0,0,1,1
1646929,1646992,63,1,0,0,1
1646930,1646981,51,1,0,0,2
1646982,1647357,375,0,0,1,2
1646993,1647362,369,0,0,1,1
1647358,1647548,190,1,0,0,2
1647363,1647567,204,1,0,0,1
1647391,1647529,138,0,1,0,1
1647396,1647503,107,0,1,0,2
1647549,1648184,635,0,0,1,2
1647568,1648184,616,0,0,1,1
1648185,1648208,23,1,0,0,1
1648185,1648216,31,1,0,0,2
1648209,1648517,308,0,0,1,1
1648217,1648523,306,0,0,1,2
1648518,1648535,17,1,0,0,1
1648524,1648536,12,1,0,0,2
1648536,1649783,1247,0,0,1,1
1648537,1649784,1247,0,0,1,2
1649784,1649854,70,1,0,0,1
1649785,1649849,64,1,0,0,2
1649850,1649931,81,0,0,1,2
1649855,1650023,168,0,0,1,1
1649932,1649945,13,1,0,0,2
1649946,1650026,80,0,0,1,2
1650024,1650047,23,1,0,0,1
1650027,1650054,27,1,0,0,2
1650048,1652560,2512,0,0,1,1
1650055,1650948,893,0,0,1,2
1650949,1650966,17,1,0,0,2
1650967,1652565,1598,0,0,1,2
1652561,1652587,26,1,0,0,1
1652566,1652625,59,1,0,0,2
1652588,1652975,387,0,0,1,1
1652626,1652802,176,0,0,1,2
1652803,1652828,25,1,0,0,2
1652829,1652975,146,0,0,1,2
1652976,1653059,83,1,0,0,1
1652976,1653059,83,1,0,0,2
1653060,1653289,229,0,0,1,1
1653060,1653289,229,0,0,1,2
1653290,1653311,21,1,0,0,2
1653290,1653319,29,1,0,0,1
1653312,1654284,972,0,0,1,2
1653320,1656193,2873,0,0,1,1
1654285,1654347,62,1,0,0,2
1654348,1654951,603,0,0,1,2
1654952,1654982,30,1,0,0,2
1654983,1655353,370,0,0,1,2
1655354,1655410,56,1,0,0,2
1655411,1655603,192,0,0,1,2
1655604,1655639,35,1,0,0,2
1655640,1655670,30,0,0,1,2
1655671,1655840,169,1,0,0,2
1655841,1656199,358,0,0,1,2
1656194,1656217,23,1,0,0,1
1656200,1656242,42,1,0,0,2
1656218,1656595,377,0,0,1,1
1656243,1656603,360,0,0,1,2
1656596,1656619,23,1,0,0,1
1656604,1656620,16,1,0,0,2
1656620,1657014,394,0,0,1,1
1656621,1657022,401,0,0,1,2
1657015,1657033,18,1,0,0,1
1657023,1657033,10,1,0,0,2
1657034,1657182,148,0,0,1,2
1657034,1657643,609,0,0,1,1
1657183,1657193,10,1,0,0,2
1657194,1657570,376,0,0,1,2
1657571,1657712,141,1,0,0,2
1657644,1657711,67,1,0,0,1
1657712,1659878,2166,0,0,1,1
1657713,1659878,2165,0,0,1,2
1659879,1659938,59,1,0,0,1
1659879,1659941,62,1,0,0,2
1659939,1660770,831,0,0,1,1
1659942,1660771,829,0,0,1,2
1660771,1660847,76,1,0,0,1
1660772,1660849,77,1,0,0,2
1660848,1661027,179,0,0,1,1
1660850,1661029,179,0,0,1,2
1661028,1661121,93,1,0,0,1
1661030,1661159,129,1,0,0,2
1661122,1661273,151,0,0,1,1
1661160,1661271,111,0,0,1,2
1661272,1661334,62,1,0,0,2
1661274,1661312,38,1,0,0,1
1661313,1662171,858,0,0,1,1
1661335,1662181,846,0,0,1,2
1662172,1662197,25,1,0,0,1
1662182,1662195,13,1,0,0,2
1662196,1662305,109,0,0,1,2
1662198,1663095,897,0,0,1,1
1662306,1662404,98,1,0,0,2
1662405,1662474,69,0,0,1,2
1662475,1662511,36,1,0,0,2
1662512,1663094,582,0,0,1,2
1663095,1663622,527,1,0,0,2
1663096,1663201,105,1,0,0,1
1663135,1663152,17,0,1,0,2
1663202,1663272,70,0,0,1,1
1663273,1663477,204,1,0,0,1
1663296,1663455,159,0,1,0,1
1663296,1663473,177,0,1,0,2
1663478,1663685,207,0,0,1,1
1663623,1663664,41,0,0,1,2
1663665,1664185,520,1,0,0,2
1663686,1663926,240,1,0,0,1
1663706,1663905,199,0,1,0,2
1663706,1663911,205,0,1,0,1
1663927,1664268,341,0,0,1,1
1664186,1664249,63,0,0,1,2
1664250,1664564,314,1,0,0,2
1664269,1664608,339,1,0,0,1
1664297,1664584,287,0,1,0,1
1664299,1664553,254,0,1,0,2
1664565,1664875,310,0,0,1,2
1664609,1664956,347,0,0,1,1
1664876,1664901,25,1,0,0,2
1664902,1664952,50,0,0,1,2
1664953,1665009,56,1,0,0,2
1664957,1664999,42,1,0,0,1
1665000,1665726,726,0,0,1,1
1665010,1665388,378,0,0,1,2
1665389,1665579,190,1,0,0,2
1665580,1665645,65,0,0,1,2
1665646,1665670,24,1,0,0,2
1665671,1665715,44,0,0,1,2
1665716,1665906,190,1,0,0,2
1665727,1665902,175,1,0,0,1
1665744,1665891,147,0,1,0,1
1665748,1665876,128,0,1,0,2
1665903,1665929,26,0,0,1,1
1665907,1665988,81,0,0,1,2
1665930,1665934,4,1,0,0,1
1665935,1665986,51,0,0,1,1
1665987,1666247,260,1,0,0,1
1665989,1666279,290,1,0,0,2
1666009,1666225,216,0,1,0,1
1666015,1666211,196,0,1,0,2
1666248,1666522,274,0,0,1,1
1666280,1666525,245,0,0,1,2
1666523,1666867,344,1,0,0,1
1666526,1666881,355,1,0,0,2
1666549,1666826,277,0,1,0,1
1666563,1666820,257,0,1,0,2
1666868,1667036,168,0,0,1,1
1666882,1667034,152,0,0,1,2
1667035,1667072,37,1,0,0,2
1667037,1667073,36,1,0,0,1
1667073,1667248,175,0,0,1,2
1667074,1669066,1992,0,0,1,1
1667249,1667270,21,1,0,0,2
1667271,1667477,206,0,0,1,2
1667478,1667537,59,1,0,0,2
1667538,1667733,195,0,0,1,2
1667734,1667765,31,1,0,0,2
1667766,1667804,38,0,0,1,2
1667805,1667835,30,1,0,0,2
1667836,1669065,1229,0,0,1,2
1669066,1669124,58,1,0,0,2
1669067,1669128,61,1,0,0,1
1669125,1669242,117,0,0,1,2
1669129,1669241,112,0,0,1,1
1669242,1669274,32,1,0,0,1
1669243,1669274,31,1,0,0,2
1669275,1672441,3166,0,0,1,1
1669275,1672441,3166,0,0,1,2
1672442,1672500,58,1,0,0,1
1672442,1672568,126,1,0,0,2
1672501,1672643,142,0,0,1,1
1672569,1672643,74,0,0,1,2
1672644,1672674,30,1,0,0,2
1672644,1672678,34,1,0,0,1
1672675,1673447,772,0,0,1,2
1672679,1672905,226,0,0,1,1
1672906,1672919,13,1,0,0,1
1672920,1674082,1162,0,0,1,1
1673448,1673482,34,1,0,0,2
1673483,1673571,88,0,0,1,2
1673572,1673588,16,1,0,0,2
1673589,1673626,37,0,0,1,2
1673627,1673637,10,1,0,0,2
1673638,1673690,52,0,0,1,2
1673691,1673830,139,1,0,0,2
1673831,1673991,160,0,0,1,2
1673992,1674134,142,1,0,0,2
1674083,1674135,52,1,0,0,1
1674135,1674260,125,0,0,1,2
1674136,1674261,125,0,0,1,1
1674261,1674292,31,1,0,0,2
1674262,1674303,41,1,0,0,1
1674293,1677641,3348,0,0,1,2
1674304,1677641,3337,0,0,1,1
1677642,1677679,37,1,0,0,1
1677642,1677679,37,1,0,0,2
1677680,1677824,144,0,0,1,1
1677680,1677825,145,0,0,1,2
1677825,1677846,21,1,0,0,1
1677826,1677845,19,1,0,0,2
1677846,1678301,455,0,0,1,2
1677847,1678302,455,0,0,1,1
1678302,1678313,11,1,0,0,2
1678303,1678308,5,1,0,0,1
1678309,1679658,1349,0,0,1,1
1678314,1680113,1799,0,0,1,2
1679659,1679670,11,1,0,0,1
1679671,1680113,442,0,0,1,1
1680114,1680181,67,1,0,0,1
1680114,1680181,67,1,0,0,2
1680182,1680696,514,0,0,1,2
1680182,1680698,516,0,0,1,1
1680697,1680734,37,1,0,0,2
1680699,1680717,18,1,0,0,1
1680718,1681904,1186,0,0,1,1
1680735,1681903,1168,0,0,1,2
1681904,1681931,27,1,0,0,2
1681905,1681936,31,1,0,0,1
1681932,1682535,603,0,0,1,2
1681937,1682536,599,0,0,1,1
1682536,1682589,53,1,0,0,2
1682537,1682581,44,1,0,0,1
1682582,1683266,684,0,0,1,1
1682590,1683269,679,0,0,1,2
1683267,1683301,34,1,0,0,1
1683270,1683307,37,1,0,0,2
1683302,1684089,787,0,0,1,1
1683308,1684089,781,0,0,1,2
1684090,1684164,74,1,0,0,1
1684090,1684166,76,1,0,0,2
1684165,1684286,121,0,0,1,1
1684167,1684287,120,0,0,1,2
1684287,1684326,39,1,0,0,1
1684288,1684323,35,1,0,0,2
1684324,1684615,291,0,0,1,2
1684327,1684609,282,0,0,1,1
1684610,1684623,13,1,0,0,1
1684616,1684626,10,1,0,0,2
1684624,1685764,1140,0,0,1,1
1684627,1685764,1137,0,0,1,2
1685765,1685775,10,1,0,0,1
1685765,1685775,10,1,0,0,2
1685776,1685956,180,0,0,1,1
1685776,1685956,180,0,0,1,2
1685957,1686010,53,1,0,0,1
1685957,1686010,53,1,0,0,2
1686011,1686138,127,0,0,1,1
1686011,1686138,127,0,0,1,2
1686139,1686172,33,1,0,0,2
1686139,1686173,34,1,0,0,1
1686173,1688362,2189,0,0,1,2
1686174,1688362,2188,0,0,1,1
1688363,1688393,30,1,0,0,1
1688363,1688394,31,1,0,0,2
1688394,1688965,571,0,0,1,1
1688395,1688967,572,0,0,1,2
1688966,1689018,52,1,0,0,1
1688968,1689015,47,1,0,0,2
1689016,1689313,297,0,0,1,2
1689019,1689313,294,0,0,1,1
1689314,1689355,41,1,0,0,1
1689314,1689356,42,1,0,0,2
1689356,1689558,202,0,0,1,1
1689357,1689558,201,0,0,1,2
1689559,1689630,71,1,0,0,1
1689559,1689643,84,1,0,0,2
1689631,1689830,199,0,0,1,1
1689644,1689832,188,0,0,1,2
1689831,1689854,23,1,0,0,1
1689833,1689850,17,1,0,0,2
1689851,1691761,1910,0,0,1,2
1689855,1690807,952,0,0,1,1
1690808,1690818,10,1,0,0,1
1690819,1691760,941,0,0,1,1
1691761,1691806,45,1,0,0,1
1691762,1691830,68,1,0,0,2
1691807,1694350,2543,0,0,1,1
1691831,1691868,37,0,0,1,2
1691869,1691958,89,1,0,0,2
1691959,1692170,211,0,0,1,2
1692171,1692186,15,1,0,0,2
1692187,1692744,557,0,0,1,2
1692745,1692782,37,1,0,0,2
1692783,1692909,126,0,0,1,2
1692910,1693080,170,1,0,0,2
1693081,1693163,82,0,0,1,2
1693164,1693539,375,1,0,0,2
1693540,1693870,330,0,0,1,2
1693871,1694018,147,1,0,0,2
1694019,1694060,41,0,0,1,2
1694061,1694099,38,1,0,0,2
1694100,1694308,208,0,0,1,2
1694309,1694317,8,1,0,0,2
1694318,1694349,31,0,0,1,2
1694350,1694386,36,1,0,0,2
1694351,1694386,35,1,0,0,1
1694387,1695060,673,0,0,1,1
1694387,1695060,673,0,0,1,2
1695061,1695116,55,1,0,0,1
1695061,1695116,55,1,0,0,2
1695117,1695575,458,0,0,1,2
1695117,1695576,459,0,0,1,1
1695576,1695649,73,1,0,0,2
1695577,1695646,69,1,0,0,1
1695647,1695766,119,0,0,1,1
1695650,1695764,114,0,0,1,2
1695765,1695848,83,1,0,0,2
1695767,1695836,69,1,0,0,1
1695837,1695950,113,0,0,1,1
1695849,1695954,105,0,0,1,2
1695951,1695987,36,1,0,0,1
1695955,1695982,27,1,0,0,2
1695983,1696292,309,0,0,1,2
1695988,1696291,303,0,0,1,1
1696292,1696311,19,1,0,0,1
1696293,1696311,18,1,0,0,2
1696312,1697973,1661,0,0,1,2
1696312,1697974,1662,0,0,1,1
1697974,1698037,63,1,0,0,2
1697975,1698037,62,1,0,0,1
1698038,1701750,3712,0,0,1,1
1698038,1701752,3714,0,0,1,2
1701751,1701808,57,1,0,0,1
1701753,1701819,66,1,0,0,2
1701809,1701990,181,0,0,1,1
1701820,1701990,170,0,0,1,2
1701991,1702036,45,1,0,0,2
1701991,1702039,48,1,0,0,1
1702037,1702163,126,0,0,1,2
1702040,1702162,122,0,0,1,1
1702163,1702200,37,1,0,0,1
1702164,1702199,35,1,0,0,2
1702200,1702940,740,0,0,1,2
1702201,1703572,1371,0,0,1,1
1702941,1702954,13,1,0,0,2
1702955,1703571,616,0,0,1,2
1703572,1703592,20,1,0,0,2
1703573,1703593,20,1,0,0,1
1703593,1704202,609,0,0,1,2
1703594,1704202,608,0,0,1,1
1704203,1704262,59,1,0,0,1
1704203,1704271,68,1,0,0,2
1704263,1704375,112,0,0,1,1
1704272,1704375,103,0,0,1,2
1704376,1704409,33,1,0,0,1
1704376,1704422,46,1,0,0,2
1704410,1704667,257,0,0,1,1
1704423,1704672,249,0,0,1,2
1704668,1704689,21,1,0,0,1
1704673,1704703,30,1,0,0,2
1704690,1705108,418,0,0,1,1
1704704,1705115,411,0,0,1,2
1705109,1705132,23,1,0,0,1
1705116,1705128,12,1,0,0,2
1705129,1705557,428,0,0,1,2
1705133,1705556,423,0,0,1,1
1705557,1705578,21,1,0,0,1
1705558,1705582,24,1,0,0,2
1705579,1706708,1129,0,0,1,1
1705583,1706709,1126,0,0,1,2
1706709,1706759,50,1,0,0,1
1706710,1706761,51,1,0,0,2
1706760,1707341,581,0,0,1,1
1706762,1707340,578,0,0,1,2
1707341,1707402,61,1,0,0,2
1707342,1707402,60,1,0,0,1
1707403,1707748,345,0,0,1,1
1707403,1707748,345,0,0,1,2
1707749,1707804,55,1,0,0,1
1707749,1707806,57,1,0,0,2
1707805,1707897,92,0,0,1,1
1707807,1707896,89,0,0,1,2
1707897,1707966,69,1,0,0,2
1707898,1707967,69,1,0,0,1
1707967,1708079,112,0,0,1,2
1707968,1708078,110,0,0,1,1
1708079,1708142,63,1,0,0,1
1708080,1708126,46,1,0,0,2
1708127,1708341,214,0,0,1,2
1708143,1708341,198,0,0,1,1
1708342,1708361,19,1,0,0,2
1708342,1708365,23,1,0,0,1
1708362,1708751,389,0,0,1,2
1708366,1709075,709,0,0,1,1
1708752,1708771,19,1,0,0,2
1708772,1708904,132,0,0,1,2
1708905,1708937,32,1,0,0,2
1708938,1708972,34,0,0,1,2
1708973,1709101,128,1,0,0,2
1709076,1709096,20,1,0,0,1
1709097,1709772,675,0,0,1,1
1709102,1709363,261,0,0,1,2
1709364,1709398,34,1,0,0,2
1709399,1709513,114,0,0,1,2
1709514,1709523,9,1,0,0,2
1709524,1709588,64,0,0,1,2
1709589,1709599,10,1,0,0,2
1709600,1709635,35,0,0,1,2
1709636,1709649,13,1,0,0,2
1709650,1709681,31,0,0,1,2
1709682,1709830,148,1,0,0,2
1709773,1709811,38,1,0,0,1
1709812,1710530,718,0,0,1,1
1709831,1710532,701,0,0,1,2
1710531,1710556,25,1,0,0,1
1710533,1710558,25,1,0,0,2
1710557,1711007,450,0,0,1,1
1710559,1711007,448,0,0,1,2
1711008,1711035,27,1,0,0,1
1711008,1711035,27,1,0,0,2
1711036,1711560,524,0,0,1,1
1711036,1711560,524,0,0,1,2
1711561,1711585,24,1,0,0,1
1711561,1711591,30,1,0,0,2
1711586,1712325,739,0,0,1,1
1711592,1712327,735,0,0,1,2
1712326,1712363,37,1,0,0,1
1712328,1712375,47,1,0,0,2
1712364,1713074,710,0,0,1,1
1712376,1712438,62,0,0,1,2
1712439,1712457,18,1,0,0,2
1712458,1712599,141,0,0,1,2
1712600,1712760,160,1,0,0,2
1712761,1712810,49,0,0,1,2
1712811,1712932,121,1,0,0,2
1712933,1713033,100,0,0,1,2
1713034,1713146,112,1,0,0,2
1713075,1713135,60,1,0,0,1
1713136,1713503,367,0,0,1,1
1713147,1713503,356,0,0,1,2
1713504,1713596,92,1,0,0,1
1713504,1713606,102,1,0,0,2
1713597,1713708,111,0,0,1,1
1713607,1713710,103,0,0,1,2
1713709,1713761,52,1,0,0,1
1713711,1713745,34,1,0,0,2
1713746,1714131,385,0,0,1,2
1713762,1714138,376,0,0,1,1
1714132,1714155,23,1,0,0,2
1714139,1714143,4,1,0,0,1
1714144,1714595,451,0,0,1,1
1714156,1714587,431,0,0,1,2
1714588,1714607,19,1,0,0,2
1714596,1714608,12,1,0,0,1
1714608,1715553,945,0,0,1,2
1714609,1715551,942,0,0,1,1
1715552,1715597,45,1,0,0,1
1715554,1715597,43,1,0,0,2
1715598,1719260,3662,0,0,1,2
1715598,1719651,4053,0,0,1,1
1719261,1719276,15,1,0,0,2
1719277,1719445,168,0,0,1,2
1719446,1719463,17,1,0,0,2
1719464,1719653,189,0,0,1,2
1719652,1719699,47,1,0,0,1
1719654,1719697,43,1,0,0,2
1719698,1721698,2000,0,0,1,2
1719700,1721697,1997,0,0,1,1
1721698,1721762,64,1,0,0,1
1721699,1721760,61,1,0,0,2
1721761,1724608,2847,0,0,1,2
1721763,1724604,2841,0,0,1,1
1724605,1724640,35,1,0,0,1
1724609,1724648,39,1,0,0,2
1724641,1725652,1011,0,0,1,1
1724649,1725651,1002,0,0,1,2
1725652,1725742,90,1,0,0,2
1725653,1725735,82,1,0,0,1
1725736,1725832,96,0,0,1,1
1725743,1725832,89,0,0,1,2
1725833,1725869,36,1,0,0,1
1725833,1725870,37,1,0,0,2
1725870,1726183,313,0,0,1,1
1725871,1726184,313,0,0,1,2
1726184,1726211,27,1,0,0,1
1726185,1726202,17,1,0,0,2
1726203,1726508,305,0,0,1,2
1726212,1726503,291,0,0,1,1
1726504,1726520,16,1,0,0,1
1726509,1726522,13,1,0,0,2
1726521,1727601,1080,0,0,1,1
1726523,1727602,1079,0,0,1,2
1727602,1727648,46,1,0,0,1
1727603,1727650,47,1,0,0,2
1727649,1728010,361,0,0,1,1
1727651,1728011,360,0,0,1,2
1728011,1728042,31,1,0,0,1
1728012,1728036,24,1,0,0,2
1728037,1729956,1919,0,0,1,2
1728043,1729958,1915,0,0,1,1
1729957,1729994,37,1,0,0,2
1729959,1729989,30,1,0,0,1
1729990,1730377,387,0,0,1,1
1729995,1730376,381,0,0,1,2
1730377,1730424,47,1,0,0,2
1730378,1730430,52,1,0,0,1
1730425,1731133,708,0,0,1,2
1730431,1731132,701,0,0,1,1
1731133,1731179,46,1,0,0,1
1731134,1731178,44,1,0,0,2
1731179,1731305,126,0,0,1,2
1731180,1731302,122,0,0,1,1
1731303,1731330,27,1,0,0,1
1731306,1731329,23,1,0,0,2
1731330,1732888,1558,0,0,1,2
1731331,1732886,1555,0,0,1,1
1732887,1732960,73,1,0,0,1
1732889,1732964,75,1,0,0,2
1732961,1733112,151,0,0,1,1
1732965,1733111,146,0,0,1,2
1733112,1733133,21,1,0,0,2
1733113,1733135,22,1,0,0,1
1733134,1733485,351,0,0,1,2
1733136,1733485,349,0,0,1,1
1733486,1733490,4,1,0,0,2
1733486,1733497,11,1,0,0,1
1733491,1734283,792,0,0,1,2
1733498,1734284,786,0,0,1,1
1734284,1734305,21,1,0,0,2
1734285,1734306,21,1,0,0,1
1734306,1734692,386,0,0,1,2
1734307,1734692,385,0,0,1,1
1734693,1734714,21,1,0,0,1
1734693,1734723,30,1,0,0,2
1734715,1736010,1295,0,0,1,1
1734724,1736008,1284,0,0,1,2
1736009,1736056,47,1,0,0,2
1736011,1736055,44,1,0,0,1
1736056,1736609,553,0,0,1,1
1736057,1736610,553,0,0,1,2
1736610,1736678,68,1,0,0,1
1736611,1736690,79,1,0,0,2
1736679,1736795,116,0,0,1,1
1736691,1736796,105,0,0,1,2
1736796,1736837,41,1,0,0,1
1736797,1736838,41,1,0,0,2
1736838,1737083,245,0,0,1,1
1736839,1737083,244,0,0,1,2
1737084,1737101,17,1,0,0,1
1737084,1737110,26,1,0,0,2
1737102,1737752,650,0,0,1,1
1737111,1737753,642,0,0,1,2
1737753,1737773,20,1,0,0,1
1737754,1737774,20,1,0,0,2
1737774,1738546,772,0,0,1,1
1737775,1738547,772,0,0,1,2
1738547,1738613,66,1,0,0,1
1738548,1738614,66,1,0,0,2
1738614,1738901,287,0,0,1,1
1738615,1738901,286,0,0,1,2
1738902,1738923,21,1,0,0,1
1738902,1738928,26,1,0,0,2
1738924,1742348,3424,0,0,1,1
1738929,1742348,3419,0,0,1,2
1742349,1742403,54,1,0,0,2
1742349,1742406,57,1,0,0,1
1742404,1742618,214,0,0,1,2
1742407,1742617,210,0,0,1,1
1742618,1742639,21,1,0,0,1
1742619,1742645,26,1,0,0,2
1742640,1744406,1766,0,0,1,1
1742646,1744408,1762,0,0,1,2
1744407,1744459,52,1,0,0,1
1744409,1744484,75,1,0,0,2
1744460,1744644,184,0,0,1,1
1744485,1744570,85,0,0,1,2
1744571,1744693,122,1,0,0,2
1744645,1744681,36,1,0,0,1
1744682,1745881,1199,0,0,1,1
1744694,1745882,1188,0,0,1,2
1745882,1745909,27,1,0,0,1
1745883,1745908,25,1,0,0,2
1745909,1747038,1129,0,0,1,2
1745910,1747037,1127,0,0,1,1
1747038,1747074,36,1,0,0,1
1747039,1747082,43,1,0,0,2
1747075,1747594,519,0,0,1,1
1747083,1747595,512,0,0,1,2
1747595,1747637,42,1,0,0,1
1747596,1747631,35,1,0,0,2
1747632,1748313,681,0,0,1,2
1747638,1748313,675,0,0,1,1
1748314,1748367,53,1,0,0,1
1748314,1748367,53,1,0,0,2
1748368,1748487,119,0,0,1,1
1748368,1748487,119,0,0,1,2
1748488,1748528,40,1,0,0,1
1748488,1748538,50,1,0,0,2
1748529,1749347,818,0,0,1,1
1748539,1749348,809,0,0,1,2
1749348,1749367,19,1,0,0,1
1749349,1749369,20,1,0,0,2
1749368,1749777,409,0,0,1,1
1749370,1749779,409,0,0,1,2
1749778,1749850,72,1,0,0,1
1749780,1749849,69,1,0,0,2
1749850,1750069,219,0,0,1,2
1749851,1750069,218,0,0,1,1
1750070,1750092,22,1,0,0,1
1750070,1750095,25,1,0,0,2
1750093,1753203,3110,0,0,1,1
1750096,1753202,3106,0,0,1,2
1753203,1753272,69,1,0,0,2
1753204,1753273,69,1,0,0,1
1753273,1753641,368,0,0,1,2
1753274,1753637,363,0,0,1,1
1753638,1753665,27,1,0,0,1
1753642,1753664,22,1,0,0,2
1753665,1755140,1475,0,0,1,2
1753666,1755141,1475,0,0,1,1
1755141,1755184,43,1,0,0,2
1755142,1755185,43,1,0,0,1
1755185,1755514,329,0,0,1,2
1755186,1755513,327,0,0,1,1
1755514,1755544,30,1,0,0,1
1755515,1755537,22,1,0,0,2
1755538,1757586,2048,0,0,1,2
1755545,1757586,2041,0,0,1,1
1757587,1757648,61,1,0,0,1
1757587,1757650,63,1,0,0,2
1757649,1758340,691,0,0,1,1
1757651,1758341,690,0,0,1,2
1758341,1758381,40,1,0,0,1
1758342,1758383,41,1,0,0,2
1758382,1758713,331,0,0,1,1
1758384,1758713,329,0,0,1,2
1758714,1758739,25,1,0,0,1
1758714,1758752,38,1,0,0,2
1758740,1758936,196,0,0,1,1
1758753,1758936,183,0,0,1,2
1758937,1759004,67,1,0,0,1
1758937,1759014,77,1,0,0,2
1759005,1759123,118,0,0,1,1
1759015,1759124,109,0,0,1,2
1759124,1759153,29,1,0,0,1
1759125,1759150,25,1,0,0,2
1759151,1759518,367,0,0,1,2
1759154,1759518,364,0,0,1,1
1759519,1759544,25,1,0,0,1
1759519,1759545,26,1,0,0,2
1759545,1760882,1337,0,0,1,1
1759546,1760882,1336,0,0,1,2
1760883,1760949,66,1,0,0,2
1760883,1760958,75,1,0,0,1
1760950,1761313,363,0,0,1,2
1760959,1761313,354,0,0,1,1
1761314,1761347,33,1,0,0,1
1761314,1761349,35,1,0,0,2
1761348,1761840,492,0,0,1,1
1761350,1761839,489,0,0,1,2
1761840,1761867,27,1,0,0,2
1761841,1761865,24,1,0,0,1
1761866,1762302,436,0,0,1,1
1761868,1762301,433,0,0,1,2
1762302,1762338,36,1,0,0,2
1762303,1762326,23,1,0,0,1
1762327,1763864,1537,0,0,1,1
1762339,1763864,1525,0,0,1,2
1763865,1763901,36,1,0,0,1
1763865,1763905,40,1,0,0,2
1763902,1764773,871,0,0,1,1
1763906,1764774,868,0,0,1,2
1764774,1764864,90,1,0,0,1
1764775,1764864,89,1,0,0,2
1764865,1764980,115,0,0,1,1
1764865,1764981,116,0,0,1,2
1764981,1765008,27,1,0,0,1
1764982,1765014,32,1,0,0,2
1765009,1765200,191,0,0,1,1
1765015,1765199,184,0,0,1,2
1765200,1765228,28,1,0,0,2
1765201,1765228,27,1,0,0,1
1765229,1766190,961,0,0,1,2
1765229,1766191,962,0,0,1,1
1766191,1766239,48,1,0,0,2
1766192,1766239,47,1,0,0,1
1766240,1766417,177,0,0,1,2
1766240,1766420,180,0,0,1,1
1766418,1766435,17,1,0,0,2
1766421,1766441,20,1,0,0,1
1766436,1767539,1103,0,0,1,2
1766442,1767538,1096,0,0,1,1
1767539,1767567,28,1,0,0,1
1767540,1767566,26,1,0,0,2
1767567,1768699,1132,0,0,1,2
1767568,1768700,1132,0,0,1,1
1768700,1768741,41,1,0,0,2
1768701,1768740,39,1,0,0,1
1768741,1769562,821,0,0,1,1
1768742,1769560,818,0,0,1,2
1769561,1769623,62,1,0,0,2
1769563,1769632,69,1,0,0,1
1769624,1769826,202,0,0,1,2
1769633,1769826,193,0,0,1,1
1769827,1769856,29,1,0,0,2
1769827,1769857,30,1,0,0,1
1769857,1771217,1360,0,0,1,2
1769858,1771220,1362,0,0,1,1
1771218,1771233,15,1,0,0,2
1771221,1771236,15,1,0,0,1
1771234,1771581,347,0,0,1,2
1771237,1771585,348,0,0,1,1
1771582,1771601,19,1,0,0,2
1771586,1771595,9,1,0,0,1
1771596,1771827,231,0,0,1,1
1771602,1771827,225,0,0,1,2
1771828,1771878,50,1,0,0,1
1771828,1771878,50,1,0,0,2
1771879,1772229,350,0,0,1,1
1771879,1772230,351,0,0,1,2
1772230,1772257,27,1,0,0,1
1772231,1772258,27,1,0,0,2
1772258,1774215,1957,0,0,1,1
1772259,1774216,1957,0,0,1,2
1774216,1774265,49,1,0,0,1
1774217,1774262,45,1,0,0,2
1774263,1774940,677,0,0,1,2
1774266,1774940,674,0,0,1,1
1774941,1774980,39,1,0,0,1
1774941,1774980,39,1,0,0,2
1774981,1775404,423,0,0,1,1
1774981,1775406,425,0,0,1,2
1775405,1775491,86,1,0,0,1
1775407,1775490,83,1,0,0,2
1775491,1775570,79,0,0,1,2
1775492,1775633,141,0,0,1,1
1775571,1775585,14,1,0,0,2
1775586,1775635,49,0,0,1,2
1775634,1775660,26,1,0,0,1
1775636,1775666,30,1,0,0,2
1775661,1777289,1628,0,0,1,1
1775667,1775983,316,0,0,1,2
1775984,1776060,76,1,0,0,2
1776061,1776128,67,0,0,1,2
1776129,1776334,205,1,0,0,2
1776335,1776643,308,0,0,1,2
1776644,1776801,157,1,0,0,2
1776802,1777295,493,0,0,1,2
1777290,1777305,15,1,0,0,1
1777296,1777348,52,1,0,0,2
1777306,1777646,340,0,0,1,1
1777349,1777649,300,0,0,1,2
1777647,1777671,24,1,0,0,1
1777650,1777672,22,1,0,0,2
1777672,1779832,2160,0,0,1,1
1777673,1779835,2162,0,0,1,2
1779833,1779859,26,1,0,0,1
1779836,1779893,57,1,0,0,2
1779860,1780180,320,0,0,1,1
1779894,1780042,148,0,0,1,2
1780043,1780072,29,1,0,0,2
1780073,1780180,107,0,0,1,2
1780181,1780247,66,1,0,0,1
1780181,1780256,75,1,0,0,2
1780248,1782737,2489,0,0,1,1
1780257,1782738,2481,0,0,1,2
1782738,1782775,37,1,0,0,1
1782739,1782777,38,1,0,0,2
1782776,1783106,330,0,0,1,1
1782778,1783107,329,0,0,1,2
1783107,1783155,48,1,0,0,1
1783108,1783164,56,1,0,0,2
1783156,1783467,311,0,0,1,1
1783165,1783210,45,0,0,1,2
1783211,1783350,139,1,0,0,2
1783351,1783468,117,0,0,1,2
1783468,1783532,64,1,0,0,1
1783469,1783522,53,1,0,0,2
1783523,1783660,137,0,0,1,2
1783533,1783658,125,0,0,1,1
1783659,1783688,29,1,0,0,1
1783661,1783681,20,1,0,0,2
1783682,1785103,1421,0,0,1,2
1783689,1785101,1412,0,0,1,1
1785102,1785170,68,1,0,0,1
1785104,1785172,68,1,0,0,2
1785171,1785461,290,0,0,1,1
1785173,1785461,288,0,0,1,2
1785462,1785491,29,1,0,0,2
1785462,1785496,34,1,0,0,1
1785492,1787575,2083,0,0,1,2
1785497,1787576,2079,0,0,1,1
1787576,1787621,45,1,0,0,2
1787577,1787612,35,1,0,0,1
1787613,1788678,1065,0,0,1,1
1787622,1788676,1054,0,0,1,2
1788677,1788720,43,1,0,0,2
1788679,1788720,41,1,0,0,1
1788721,1788876,155,0,0,1,1
1788721,1788879,158,0,0,1,2
1788877,1788905,28,1,0,0,1
1788880,1788905,25,1,0,0,2
1788906,1789163,257,0,0,1,2
1788906,1790355,1449,0,0,1,1
1789164,1789181,17,1,0,0,2
1789182,1790354,1172,0,0,1,2
1790355,1790412,57,1,0,0,2
1790356,1790425,69,1,0,0,1
1790413,1790922,509,0,0,1,2
1790426,1790922,496,0,0,1,1
1790923,1790950,27,1,0,0,1
1790923,1790967,44,1,0,0,2
1790951,1791311,360,0,0,1,1
1790968,1791311,343,0,0,1,2
1791312,1791346,34,1,0,0,1
1791312,1791346,34,1,0,0,2
1791347,1793116,1769,0,0,1,2
1791347,1793152,1805,0,0,1,1
1793117,1793196,79,1,0,0,2
1793153,1793194,41,1,0,0,1
1793195,1793549,354,0,0,1,1
1793197,1793550,353,0,0,1,2
1793550,1793594,44,1,0,0,1
1793551,1793604,53,1,0,0,2
1793595,1793779,184,0,0,1,1
1793605,1793781,176,0,0,1,2
1793780,1793850,70,1,0,0,1
1793782,1793843,61,1,0,0,2
1793844,1793914,70,0,0,1,2
1793851,1793916,65,0,0,1,1
1793915,1794022,107,1,0,0,2
1793917,1794024,107,1,0,0,1
1794023,1794134,111,0,0,1,2
1794025,1794135,110,0,0,1,1
1794135,1794308,173,1,0,0,2
1794136,1794167,31,1,0,0,1
1794168,1794526,358,0,0,1,1
1794309,1794427,118,0,0,1,2
1794428,1794432,4,1,0,0,2
1794433,1794532,99,0,0,1,2
1794527,1794540,13,1,0,0,1
1794533,1794537,4,1,0,0,2
1794538,1794994,456,0,0,1,2
1794541,1795269,728,0,0,1,1
1794995,1795052,57,1,0,0,2
1795053,1795115,62,0,0,1,2
1795116,1795125,9,1,0,0,2
1795126,1795172,46,0,0,1,2
1795173,1795209,36,1,0,0,2
1795210,1795270,60,0,0,1,2
1795270,1795296,26,1,0,0,1
1795271,1795300,29,1,0,0,2
1795297,1796120,823,0,0,1,1
1795301,1795340,39,0,0,1,2
1795341,1795725,384,1,0,0,2
1795726,1795858,132,0,0,1,2
1795859,1796047,188,1,0,0,2
1796048,1796085,37,0,0,1,2
1796086,1796211,125,1,0,0,2
1796121,1796190,69,1,0,0,1
1796191,1796482,291,0,0,1,1
1796212,1796316,104,0,0,1,2
1796317,1796331,14,1,0,0,2
1796332,1796484,152,0,0,1,2
1796483,1796525,42,1,0,0,1
1796485,1796524,39,1,0,0,2
1796525,1797771,1246,0,0,1,2
1796526,1797775,1249,0,0,1,1
1797772,1797822,50,1,0,0,2
1797776,1797816,40,1,0,0,1
1797817,1798097,280,0,0,1,1
1797823,1798097,274,0,0,1,2
1798098,1798153,55,1,0,0,1
1798098,1798153,55,1,0,0,2
1798154,1798695,541,0,0,1,2
1798154,1798697,543,0,0,1,1
1798696,1798781,85,1,0,0,2
1798698,1798783,85,1,0,0,1
1798782,1798958,176,0,0,1,2
1798784,1799112,328,0,0,1,1
1798959,1798963,4,1,0,0,2
1798964,1799018,54,0,0,1,2
1799019,1799028,9,1,0,0,2
1799029,1799096,67,0,0,1,2
1799097,1799313,216,1,0,0,2
1799113,1799298,185,1,0,0,1
1799161,1799257,96,0,1,0,2
1799202,1799246,44,0,1,0,1
1799299,1799873,574,0,0,1,1
1799314,1799873,559,0,0,1,2
1799874,1799930,56,1,0,0,1
1799874,1799953,79,1,0,0,2
1799931,1800269,338,0,0,1,1
1799954,1800269,315,0,0,1,2
1800270,1800300,30,1,0,0,1
1800270,1800300,30,1,0,0,2
1800301,1802933,2632,0,0,1,1
1800301,1802933,2632,0,0,1,2
1802934,1802978,44,1,0,0,2
1802934,1802979,45,1,0,0,1
1802979,1803387,408,0,0,1,2
1802980,1803385,405,0,0,1,1
1803386,1803411,25,1,0,0,1
1803388,1803412,24,1,0,0,2
1803412,1806059,2647,0,0,1,1
1803413,1806059,2646,0,0,1,2
1806060,1806087,27,1,0,0,1
1806060,1806087,27,1,0,0,2
1806088,1806471,383,0,0,1,1
1806088,1806472,384,0,0,1,2
1806472,1806592,120,1,0,0,1
1806473,1806589,116,1,0,0,2
1806590,1806787,197,0,0,1,2
1806593,1806787,194,0,0,1,1
1806788,1806808,20,1,0,0,2
1806788,1806814,26,1,0,0,1
1806809,1807253,444,0,0,1,2
1806815,1807252,437,0,0,1,1
1807253,1807265,12,1,0,0,1
1807254,1807268,14,1,0,0,2
1807266,1808411,1145,0,0,1,1
1807269,1808412,1143,0,0,1,2
1808412,1808483,71,1,0,0,1
1808413,1808493,80,1,0,0,2
1808484,1808721,237,0,0,1,1
1808494,1808727,233,0,0,1,2
1808722,1808739,17,1,0,0,1
1808728,1808741,13,1,0,0,2
1808740,1809129,389,0,0,1,1
1808742,1809130,388,0,0,1,2
1809130,1809150,20,1,0,0,1
1809131,1809149,18,1,0,0,2
1809150,1811584,2434,0,0,1,2
1809151,1811584,2433,0,0,1,1
1811585,1811669,84,1,0,0,1
1811585,1811679,94,1,0,0,2
1811670,1811833,163,0,0,1,1
1811680,1811836,156,0,0,1,2
1811834,1811859,25,1,0,0,1
1811837,1811856,19,1,0,0,2
1811857,1812212,355,0,0,1,2
1811860,1812210,350,0,0,1,1
1812211,1812228,17,1,0,0,1
1812213,1812226,13,1,0,0,2
1812227,1813440,1213,0,0,1,2
1812229,1813441,1212,0,0,1,1
1813441,1813483,42,1,0,0,2
1813442,1813488,46,1,0,0,1
1813484,1815799,2315,0,0,1,2
1813489,1815798,2309,0,0,1,1
1815799,1815849,50,1,0,0,1
1815800,1815861,61,1,0,0,2
1815850,1816194,344,0,0,1,1
1815862,1816194,332,0,0,1,2
1816195,1816238,43,1,0,0,1
1816195,1816246,51,1,0,0,2
1816239,1816537,298,0,0,1,1
1816247,1816391,144,0,0,1,2
1816392,1816439,47,1,0,0,2
1816440,1816538,98,0,0,1,2
1816538,1816572,34,1,0,0,1
1816539,1816573,34,1,0,0,2
1816573,1817018,445,0,0,1,1
1816574,1817019,445,0,0,1,2
1817019,1817034,15,1,0,0,1
1817020,1817040,20,1,0,0,2
1817035,1817181,146,0,0,1,1
1817041,1817180,139,0,0,1,2
1817181,1817212,31,1,0,0,2
1817182,1817211,29,1,0,0,1
1817212,1817558,346,0,0,1,1
1817213,1817558,345,0,0,1,2
1817559,1817589,30,1,0,0,2
1817559,1817590,31,1,0,0,1
1817590,1817821,231,0,0,1,2
1817591,1817822,231,0,0,1,1
1817822,1817850,28,1,0,0,2
1817823,1817851,28,1,0,0,1
1817851,1818363,512,0,0,1,2
1817852,1818363,511,0,0,1,1
1818364,1818400,36,1,0,0,2
1818364,1818402,38,1,0,0,1
1818401,1818723,322,0,0,1,2
1818403,1818724,321,0,0,1,1
1818724,1818756,32,1,0,0,2
1818725,1818755,30,1,0,0,1
1818756,1819087,331,0,0,1,1
1818757,1819087,330,0,0,1,2
1819088,1822001,2913,1,0,0,2
1819088,1822142,3054,1,0,0,1
1819136,1821990,2854,0,1,0,2
1819143,1822034,2891,0,1,0,1
1822002,1822063,61,0,0,1,2
1822064,1822145,81,1,0,0,2
1822143,1822269,126,0,0,1,1
1822146,1822269,123,0,0,1,2
1822270,1822315,45,1,0,0,1
1822270,1822319,49,1,0,0,2
1822316,1822633,317,0,0,1,1
1822320,1822628,308,0,0,1,2
1822629,1822875,246,1,0,0,2
1822634,1822865,231,1,0,0,1
1822647,1822787,140,0,1,0,1
1822650,1822788,138,0,1,0,2
1822866,1823049,183,0,0,1,1
1822876,1823049,173,0,0,1,2
1878066,1878375,309,0,0,1,2
1878066,1878377,311,0,0,1,1
1878376,1878470,94,1,0,0,2
1878378,1878457,79,1,0,0,1
1878458,1878552,94,0,0,1,1
1878471,1878553,82,0,0,1,2
1878553,1878583,30,1,0,0,1
1878554,1878583,29,1,0,0,2
1878584,1879066,482,0,0,1,2
1878584,1879067,483,0,0,1,1
1879067,1879095,28,1,0,0,2
1879068,1879091,23,1,0,0,1
1879092,1880516,1424,0,0,1,1
1879096,1880517,1421,0,0,1,2
1880517,1880555,38,1,0,0,1
1880518,1880564,46,1,0,0,2
1880556,1880789,233,0,0,1,1
1880565,1880789,224,0,0,1,2
1880790,1880841,51,1,0,0,1
1880790,1880841,51,1,0,0,2
1880842,1880955,113,0,0,1,1
1880842,1880958,116,0,0,1,2
1880956,1880989,33,1,0,0,1
1880959,1880987,28,1,0,0,2
1880988,1881260,272,0,0,1,2
1880990,1881258,268,0,0,1,1
1881259,1881279,20,1,0,0,1
1881261,1881278,17,1,0,0,2
1881279,1882955,1676,0,0,1,2
1881280,1882956,1676,0,0,1,1
1882956,1883005,49,1,0,0,2
1882957,1883006,49,1,0,0,1
1883006,1883049,43,0,0,1,2
1883007,1883048,41,0,0,1,1
1883049,1883141,92,1,0,0,1
1883050,1883150,100,1,0,0,2
1883142,1883499,357,0,0,1,1
1883151,1883495,344,0,0,1,2
1883496,1883514,18,1,0,0,2
1883500,1883510,10,1,0,0,1
1883511,1883933,422,0,0,1,1
1883515,1883932,417,0,0,1,2
1883933,1883951,18,1,0,0,2
1883934,1883950,16,1,0,0,1
1883951,1884510,559,0,0,1,1
1883952,1884511,559,0,0,1,2
1884511,1884538,27,1,0,0,1
1884512,1884537,25,1,0,0,2
1884538,1885725,1187,0,0,1,2
1884539,1885725,1186,0,0,1,1
1885726,1885751,25,1,0,0,1
1885726,1885752,26,1,0,0,2
1885752,1886307,555,0,0,1,1
1885753,1886307,554,0,0,1,2
1886308,1886390,82,1,0,0,1
1886308,1886399,91,1,0,0,2
1886391,1886463,72,0,0,1,1
1886400,1886465,65,0,0,1,2
1886464,1886526,62,1,0,0,1
1886466,1886522,56,1,0,0,2
1886523,1886910,387,0,0,1,2
1886527,1886910,383,0,0,1,1
1886911,1887109,198,1,0,0,1
1886911,1887120,209,1,0,0,2
1886933,1887088,155,0,1,0,1
1886933,1887103,170,0,1,0,2
1887110,1887143,33,0,0,1,1
1887121,1888022,901,0,0,1,2
1887144,1887165,21,1,0,0,1
1887166,1888021,855,0,0,1,1
1888022,1888101,79,1,0,0,1
1888023,1888101,78,1,0,0,2
1888102,1888337,235,0,0,1,1
1888102,1888337,235,0,0,1,2
1888338,1888453,115,1,0,0,1
1888338,1888464,126,1,0,0,2
1888454,1888566,112,0,0,1,1
1888465,1888562,97,0,0,1,2
1888563,1888592,29,1,0,0,2
1888567,1888593,26,1,0,0,1
1888593,1888905,312,0,0,1,2
1888594,1890133,1539,0,0,1,1
1888906,1888933,27,1,0,0,2
1888934,1890125,1191,0,0,1,2
1890126,1890243,117,1,0,0,2
1890134,1890229,95,1,0,0,1
1890230,1890563,333,0,0,1,1
1890244,1890563,319,0,0,1,2
1890564,1890651,87,1,0,0,1
1890564,1890665,101,1,0,0,2
1890652,1890771,119,0,0,1,1
1890666,1890771,105,0,0,1,2
1890772,1890812,40,1,0,0,1
1890772,1890824,52,1,0,0,2
1890813,1891054,241,0,0,1,1
1890825,1891052,227,0,0,1,2
1891053,1891090,37,1,0,0,2
1891055,1891060,5,1,0,0,1
1891061,1892575,1514,0,0,1,1
1891091,1891154,63,0,0,1,2
1891155,1891226,71,1,0,0,2
1891227,1891347,120,0,0,1,2
1891348,1891362,14,1,0,0,2
1891363,1892573,1210,0,0,1,2
1892574,1892629,55,1,0,0,2
1892576,1892628,52,1,0,0,1
1892629,1892808,179,0,0,1,1
1892630,1892807,177,0,0,1,2
1892808,1892899,91,1,0,0,2
1892809,1892900,91,1,0,0,1
1892900,1893052,152,0,0,1,2
1892901,1893054,153,0,0,1,1
1893053,1893091,38,1,0,0,2
1893055,1893091,36,1,0,0,1
1893092,1893315,223,0,0,1,2
1893092,1893321,229,0,0,1,1
1893316,1893337,21,1,0,0,2
1893322,1893337,15,1,0,0,1
1893338,1893799,461,0,0,1,2
1893338,1893803,465,0,0,1,1
1893800,1893822,22,1,0,0,2
1893804,1893816,12,1,0,0,1
1893817,1894688,871,0,0,1,1
1893823,1894687,864,0,0,1,2
1894688,1894733,45,1,0,0,2
1894689,1894736,47,1,0,0,1
1894734,1895099,365,0,0,1,2
1894737,1895102,365,0,0,1,1
1895100,1895241,141,1,0,0,2
1895103,1895219,116,1,0,0,1
1895220,1895308,88,0,0,1,1
1895242,1895293,51,0,0,1,2
1895294,1895363,69,1,0,0,2
1895309,1895359,50,1,0,0,1
1895360,1895581,221,0,0,1,1
1895364,1897217,1853,0,0,1,2
1895582,1895604,22,1,0,0,1
1895605,1897217,1612,0,0,1,1
1897218,1897260,42,1,0,0,1
1897218,1897266,48,1,0,0,2
1897261,1897389,128,0,0,1,1
1897267,1897388,121,0,0,1,2
1897389,1897409,20,1,0,0,2
1897390,1897407,17,1,0,0,1
1897408,1898872,1464,0,0,1,1
1897410,1898871,1461,0,0,1,2
1898872,1898944,72,1,0,0,2
1898873,1898944,71,1,0,0,1
1898945,1899029,84,0,0,1,1
1898945,1899030,85,0,0,1,2
1899030,1899080,50,1,0,0,1
1899031,1899078,47,1,0,0,2
1899079,1899280,201,0,0,1,2
1899081,1899274,193,0,0,1,1
1899275,1899296,21,1,0,0,1
1899281,1899297,16,1,0,0,2
1899297,1900980,1683,0,0,1,1
1899298,1899953,655,0,0,1,2
1899954,1899965,11,1,0,0,2
1899966,1900977,1011,0,0,1,2
1900978,1901026,48,1,0,0,2
1900981,1901026,45,1,0,0,1
1901027,1901258,231,0,0,1,1
1901027,1901258,231,0,0,1,2
1901259,1901311,52,1,0,0,1
1901259,1901321,62,1,0,0,2
1901312,1901525,213,0,0,1,1
1901322,1901528,206,0,0,1,2
1901526,1901549,23,1,0,0,1
1901529,1901552,23,1,0,0,2
1901550,1902193,643,0,0,1,1
1901553,1902193,640,0,0,1,2
1902194,1902237,43,1,0,0,1
1902194,1902238,44,1,0,0,2
1902238,1902865,627,0,0,1,1
1902239,1902866,627,0,0,1,2
1902866,1902910,44,1,0,0,1
1902867,1902909,42,1,0,0,2
1902910,1903040,130,0,0,1,2
1902911,1903041,130,0,0,1,1
1903041,1903116,75,1,0,0,2
1903042,1903122,80,1,0,0,1
1903117,1903359,242,0,0,1,2
1903123,1903359,236,0,0,1,1
1903360,1903379,19,1,0,0,1
1903360,1903386,26,1,0,0,2
1903380,1904265,885,0,0,1,1
1903387,1904265,878,0,0,1,2
1904266,1904314,48,1,0,0,1
1904266,1904324,58,1,0,0,2
1904315,1904614,299,0,0,1,1
1904325,1904615,290,0,0,1,2
1904615,1904680,65,1,0,0,1
1904616,1904683,67,1,0,0,2
1904681,1904795,114,0,0,1,1
1904684,1904796,112,0,0,1,2
1904796,1904827,31,1,0,0,1
1904797,1904824,27,1,0,0,2
1904825,1906169,1344,0,0,1,2
1904828,1906168,1340,0,0,1,1
1906169,1906223,54,1,0,0,1
1906170,1906227,57,1,0,0,2
1906224,1906437,213,0,0,1,1
1906228,1906437,209,0,0,1,2
1906438,1906553,115,1,0,0,1
1906438,1906601,163,1,0,0,2
1906554,1906782,228,0,0,1,1
1906602,1906777,175,0,0,1,2
1906778,1906854,76,1,0,0,2
1906783,1906810,27,1,0,0,1
1906811,1907889,1078,0,0,1,1
1906855,1907480,625,0,0,1,2
1907481,1907526,45,1,0,0,2
1907527,1907611,84,0,0,1,2
1907612,1907630,18,1,0,0,2
1907631,1907658,27,0,0,1,2
1907659,1907966,307,1,0,0,2
1907890,1907949,59,1,0,0,1
1907950,1908342,392,0,0,1,1
1907967,1908341,374,0,0,1,2
1908342,1908443,101,1,0,0,2
1908343,1908443,100,1,0,0,1
1908444,1908565,121,0,0,1,2
1908444,1908566,122,0,0,1,1
1908566,1908592,26,1,0,0,2
1908567,1908598,31,1,0,0,1
1908593,1909551,958,0,0,1,2
1908599,1909551,952,0,0,1,1
1909552,1909601,49,1,0,0,1
1909552,1909613,61,1,0,0,2
1909602,1910109,507,0,0,1,1
1909614,1910107,493,0,0,1,2
1910108,1910396,288,1,0,0,2
1910110,1910154,44,1,0,0,1
1910155,1910337,182,0,0,1,1
1910338,1910395,57,1,0,0,1
1910396,1910566,170,0,0,1,1
1910397,1910569,172,0,0,1,2
1910567,1910585,18,1,0,0,1
1910570,1910584,14,1,0,0,2
1910585,1911893,1308,0,0,1,2
1910586,1911890,1304,0,0,1,1
1911891,1911931,40,1,0,0,1
1911894,1911931,37,1,0,0,2
1911932,1912048,116,0,0,1,1
1911932,1912050,118,0,0,1,2
1912049,1912105,56,1,0,0,1
1912051,1912105,54,1,0,0,2
1912106,1912371,265,0,0,1,2
1912106,1912377,271,0,0,1,1
1912372,1912389,17,1,0,0,2
1912378,1912389,11,1,0,0,1
1912390,1913854,1464,0,0,1,2
1912390,1913855,1465,0,0,1,1
1913855,1913969,114,1,0,0,2
1913856,1913960,104,1,0,0,1
1913961,1914037,76,0,0,1,1
1913970,1914036,66,0,0,1,2
1914037,1914099,62,1,0,0,2
1914038,1914095,57,1,0,0,1
1914096,1914521,425,0,0,1,1
1914100,1914517,417,0,0,1,2
1914518,1914542,24,1,0,0,2
1914522,1914545,23,1,0,0,1
1914543,1915295,752,0,0,1,2
1914546,1915292,746,0,0,1,1
1915293,1915351,58,1,0,0,1
1915296,1915355,59,1,0,0,2
1915352,1915677,325,0,0,1,1
1915356,1915679,323,0,0,1,2
1915678,1915787,109,1,0,0,1
1915680,1915786,106,1,0,0,2
1915787,1915933,146,0,0,1,2
1915788,1915936,148,0,0,1,1
1915934,1915965,31,1,0,0,2
1915937,1915962,25,1,0,0,1
1915963,1917115,1152,0,0,1,1
1915966,1917114,1148,0,0,1,2
1917115,1917178,63,1,0,0,2
1917116,1917174,58,1,0,0,1
1917175,1917511,336,0,0,1,1
1917179,1917510,331,0,0,1,2
1917511,1917612,101,1,0,0,2
1917512,1917606,94,1,0,0,1
1917607,1917730,123,0,0,1,1
1917613,1917730,117,0,0,1,2
1917731,1917758,27,1,0,0,1
1917731,1917772,41,1,0,0,2
1917759,1918197,438,0,0,1,1
1917773,1918191,418,0,0,1,2
1918192,1918215,23,1,0,0,2
1918198,1918226,28,1,0,0,1
1918216,1918448,232,0,0,1,2
1918227,1918453,226,0,0,1,1
1918449,1918481,32,1,0,0,2
1918454,1918474,20,1,0,0,1
1918475,1918835,360,0,0,1,1
1918482,1918836,354,0,0,1,2
1918836,1918886,50,1,0,0,1
1918837,1918884,47,1,0,0,2
1918885,1919019,134,0,0,1,2
1918887,1919021,134,0,0,1,1
1919020,1919083,63,1,0,0,2
1919022,1919084,62,1,0,0,1
1919084,1919149,65,0,0,1,2
1919085,1919143,58,0,0,1,1
1919144,1919211,67,1,0,0,1
1919150,1919222,72,1,0,0,2
1919212,1919388,176,0,0,1,1
1919223,1919386,163,0,0,1,2
1919387,1919446,59,1,0,0,2
1919389,1919440,51,1,0,0,1
1919441,1919681,240,0,0,1,1
1919447,1919679,232,0,0,1,2
1919680,1919699,19,1,0,0,2
1919682,1919697,15,1,0,0,1
1919698,1920535,837,0,0,1,1
1919700,1920535,835,0,0,1,2
1920536,1920580,44,1,0,0,1
1920536,1920581,45,1,0,0,2
1920581,1921026,445,0,0,1,1
1920582,1921023,441,0,0,1,2
1921024,1921103,79,1,0,0,2
1921027,1921086,59,1,0,0,1
1921087,1921260,173,0,0,1,1
1921104,1921259,155,0,0,1,2
1921260,1921299,39,1,0,0,2
1921261,1921290,29,1,0,0,1
1921291,1921574,283,0,0,1,1
1921300,1921575,275,0,0,1,2
1921575,1921596,21,1,0,0,1
1921576,1921601,25,1,0,0,2
1921597,1922184,587,0,0,1,1
1921602,1922183,581,0,0,1,2
1922184,1922222,38,1,0,0,2
1922185,1922219,34,1,0,0,1
1922220,1922622,402,0,0,1,1
1922223,1922624,401,0,0,1,2
1922623,1922672,49,1,0,0,1
1922625,1922673,48,1,0,0,2
1922673,1923061,388,0,0,1,1
1922674,1923064,390,0,0,1,2
1923062,1923084,22,1,0,0,1
1923065,1923091,26,1,0,0,2
1923085,1924407,1322,0,0,1,1
1923092,1923380,288,0,0,1,2
1923381,1923423,42,1,0,0,2
1923424,1923490,66,0,0,1,2
1923491,1923657,166,1,0,0,2
1923658,1924414,756,0,0,1,2
1924408,1924453,45,1,0,0,1
1924415,1924447,32,1,0,0,2
1924448,1924556,108,0,0,1,2
1924454,1924557,103,0,0,1,1
1924557,1924681,124,1,0,0,2
1924558,1924680,122,1,0,0,1
1924681,1924783,102,0,0,1,1
1924682,1924783,101,0,0,1,2
1924784,1924831,47,1,0,0,2
1924784,1924835,51,1,0,0,1
1924832,1925210,378,0,0,1,2
1924836,1925208,372,0,0,1,1
1925209,1925235,26,1,0,0,1
1925211,1925231,20,1,0,0,2
1925232,1926237,1005,0,0,1,2
1925236,1926235,999,0,0,1,1
1926236,1926289,53,1,0,0,1
1926238,1926304,66,1,0,0,2
1926290,1926472,182,0,0,1,1
1926305,1926471,166,0,0,1,2
1926472,1926561,89,1,0,0,2
1926473,1926553,80,1,0,0,1
1926554,1926632,78,0,0,1,1
1926562,1926625,63,0,0,1,2
1926626,1927119,493,1,0,0,2
1926633,1927125,492,1,0,0,1
1926666,1927108,442,0,1,0,2
1926674,1927115,441,0,1,0,1
1927120,1927345,225,0,0,1,2
1927126,1927346,220,0,0,1,1
1927346,1927378,32,1,0,0,2
1927347,1927377,30,1,0,0,1
1927378,1928268,890,0,0,1,1
1927379,1928260,881,0,0,1,2
1928261,1928452,191,1,0,0,2
1928269,1928469,200,1,0,0,1
1928294,1928432,138,0,1,0,1
1928295,1928417,122,0,1,0,2
1928453,1928832,379,0,0,1,2
1928470,1928831,361,0,0,1,1
1928832,1928892,60,1,0,0,1
1928833,1928900,67,1,0,0,2
1928893,1929068,175,0,0,1,1
1928901,1929068,167,0,0,1,2
1929069,1929156,87,1,0,0,1
1929069,1929162,93,1,0,0,2
1929157,1929294,137,0,0,1,1
1929163,1929295,132,0,0,1,2
1929295,1929326,31,1,0,0,1
1929296,1929322,26,1,0,0,2
1929323,1930198,875,0,0,1,2
1929327,1930196,869,0,0,1,1
1930197,1930244,47,1,0,0,1
1930199,1930245,46,1,0,0,2
1930245,1930597,352,0,0,1,1
1930246,1930597,351,0,0,1,2
1930598,1930682,84,1,0,0,2
1930598,1930683,85,1,0,0,1
1930683,1931006,323,0,0,1,2
1930684,1931003,319,0,0,1,1
1931004,1931048,44,1,0,0,1
1931007,1931052,45,1,0,0,2
1931049,1931455,406,0,0,1,1
1931053,1931457,404,0,0,1,2
1931456,1931642,186,1,0,0,1
1931458,1931653,195,1,0,0,2
1931474,1931618,144,0,1,0,1
1931475,1931608,133,0,1,0,2
1931643,1932339,696,0,0,1,1
1931654,1932337,683,0,0,1,2
1932338,1932360,22,1,0,0,2
1932340,1932359,19,1,0,0,1
1932360,1932718,358,0,0,1,1
1932361,1932718,357,0,0,1,2
1932719,1932807,88,1,0,0,2
1932719,1932808,89,1,0,0,1
1932808,1932971,163,0,0,1,2
1932809,1932971,162,0,0,1,1
1932972,1933002,30,1,0,0,1
1932972,1933002,30,1,0,0,2
1933003,1933224,221,0,0,1,1
1933003,1933227,224,0,0,1,2
1933225,1933250,25,1,0,0,1
1933228,1933243,15,1,0,0,2
1933244,1934250,1006,0,0,1,2
1933251,1934249,998,0,0,1,1
1934250,1934297,47,1,0,0,1
1934251,1934298,47,1,0,0,2
1934298,1934661,363,0,0,1,1
1934299,1934664,365,0,0,1,2
1934662,1934759,97,1,0,0,1
1934665,1934761,96,1,0,0,2
1934760,1934949,189,0,0,1,1
1934762,1934949,187,0,0,1,2
1934950,1934981,31,1,0,0,1
1934950,1934983,33,1,0,0,2
1934982,1935941,959,0,0,1,1
1934984,1935941,957,0,0,1,2
1935942,1935996,54,1,0,0,2
1935942,1935999,57,1,0,0,1
1935997,1936256,259,0,0,1,2
1936000,1936259,259,0,0,1,1
1936257,1936315,58,1,0,0,2
1936260,1936319,59,1,0,0,1
1936316,1936460,144,0,0,1,2
1936320,1936461,141,0,0,1,1
1936461,1936522,61,1,0,0,2
1936462,1936504,42,1,0,0,1
1936505,1936676,171,0,0,1,1
1936523,1936678,155,0,0,1,2
1936677,1936703,26,1,0,0,1
1936679,1936704,25,1,0,0,2
1936704,1937736,1032,0,0,1,1
1936705,1937739,1034,0,0,1,2
1937737,1937787,50,1,0,0,1
1937740,1937779,39,1,0,0,2
1937780,1938195,415,0,0,1,2
1937788,1938194,406,0,0,1,1
1938195,1938268,73,1,0,0,1
1938196,1938261,65,1,0,0,2
1938262,1938408,146,0,0,1,2
1938269,1938406,137,0,0,1,1
1938407,1938436,29,1,0,0,1
1938409,1938439,30,1,0,0,2
1938437,1938945,508,0,0,1,1
1938440,1938940,500,0,0,1,2
1938941,1939139,198,1,0,0,2
1938946,1939026,80,1,0,0,1
1939027,1939349,322,0,0,1,1
1939140,1939352,212,0,0,1,2
1939350,1939410,60,1,0,0,1
1939353,1939426,73,1,0,0,2
1939411,1939886,475,0,0,1,1
1939427,1939883,456,0,0,1,2
1939884,1939960,76,1,0,0,2
1939887,1939957,70,1,0,0,1
1939958,1940087,129,0,0,1,1
1939961,1940088,127,0,0,1,2
1940088,1940119,31,1,0,0,1
1940089,1940120,31,1,0,0,2
1940120,1940566,446,0,0,1,1
1940121,1940567,446,0,0,1,2
1940567,1940589,22,1,0,0,1
1940568,1940598,30,1,0,0,2
1940590,1940873,283,0,0,1,1
1940599,1940874,275,0,0,1,2
1940874,1940946,72,1,0,0,1
1940875,1940960,85,1,0,0,2
1940947,1941591,644,0,0,1,1
1940961,1941590,629,0,0,1,2
1941591,1941664,73,1,0,0,2
1941592,1941652,60,1,0,0,1
1941653,1941752,99,0,0,1,1
1941665,1941753,88,0,0,1,2
1941753,1941789,36,1,0,0,1
1941754,1941789,35,1,0,0,2
1941790,1942381,591,0,0,1,1
1941790,1942381,591,0,0,1,2
1942382,1942401,19,1,0,0,2
1942382,1942402,20,1,0,0,1
1942402,1942741,339,0,0,1,2
1942403,1942740,337,0,0,1,1
1942741,1942759,18,1,0,0,1
1942742,1942760,18,1,0,0,2
1942760,1943198,438,0,0,1,1
1942761,1943196,435,0,0,1,2
1943197,1943246,49,1,0,0,2
1943199,1943240,41,1,0,0,1
1943241,1943708,467,0,0,1,1
1943247,1943710,463,0,0,1,2
1943709,1943789,80,1,0,0,1
1943711,1943790,79,1,0,0,2
1943790,1943914,124,0,0,1,1
1943791,1943915,124,0,0,1,2
1943915,1943937,22,1,0,0,1
1943916,1943939,23,1,0,0,2
1943938,1944214,276,0,0,1,1
1943940,1944211,271,0,0,1,2
1944212,1944228,16,1,0,0,2
1944215,1944226,11,1,0,0,1
1944227,1945357,1130,0,0,1,1
1944229,1945359,1130,0,0,1,2
1945358,1945439,81,1,0,0,1
1945360,1945437,77,1,0,0,2
1945438,1945579,141,0,0,1,2
1945440,1945577,137,0,0,1,1
1945578,1945682,104,1,0,0,1
1945580,1945682,102,1,0,0,2
1945683,1945791,108,0,0,1,2
1945683,1945793,110,0,0,1,1
1945792,1945821,29,1,0,0,2
1945794,1945826,32,1,0,0,1
1945822,1946903,1081,0,0,1,2
1945827,1946904,1077,0,0,1,1
1946904,1947009,105,1,0,0,2
1946905,1947008,103,1,0,0,1
1947009,1947364,355,0,0,1,1
1947010,1947364,354,0,0,1,2
1947365,1947421,56,1,0,0,2
1947365,1947434,69,1,0,0,1
1947422,1947497,75,0,0,1,2
1947435,1947497,62,0,0,1,1
1947498,1947542,44,1,0,0,1
1947498,1947542,44,1,0,0,2
1947543,1947982,439,0,0,1,1
1947543,1947982,439,0,0,1,2
1947983,1948002,19,1,0,0,1
1947983,1948003,20,1,0,0,2
1948003,1948575,572,0,0,1,1
1948004,1948578,574,0,0,1,2
1948576,1948638,62,1,0,0,1
1948579,1948645,66,1,0,0,2
1948639,1949250,611,0,0,1,1
1948646,1949250,604,0,0,1,2
1949251,1949319,68,1,0,0,1
1949251,1949329,78,1,0,0,2
1949320,1949753,433,0,0,1,1
1949330,1949759,429,0,0,1,2
1949754,1949775,21,1,0,0,1
1949760,1949777,17,1,0,0,2
1949776,1950523,747,0,0,1,1
1949778,1950521,743,0,0,1,2
1950522,1950574,52,1,0,0,2
1950524,1950579,55,1,0,0,1
1950575,1950843,268,0,0,1,2
1950580,1950845,265,0,0,1,1
1950844,1950895,51,1,0,0,2
1950846,1950889,43,1,0,0,1
1950890,1951148,258,0,0,1,1
1950896,1951148,252,0,0,1,2
1951149,1951244,95,1,0,0,1
1951149,1951256,107,1,0,0,2
1951245,1951427,182,0,0,1,1
1951257,1951426,169,0,0,1,2
1951427,1951461,34,1,0,0,2
1951428,1951457,29,1,0,0,1
1951458,1952234,776,0,0,1,1
1951462,1952236,774,0,0,1,2
1952235,1952272,37,1,0,0,1
1952237,1952284,47,1,0,0,2
1952273,1952838,565,0,0,1,1
1952285,1952840,555,0,0,1,2
1952839,1952934,95,1,0,0,1
1952841,1952937,96,1,0,0,2
1952935,1953162,227,0,0,1,1
1952938,1953160,222,0,0,1,2
1953161,1953190,29,1,0,0,2
1953163,1953189,26,1,0,0,1
1953190,1954580,1390,0,0,1,1
1953191,1954579,1388,0,0,1,2
1954580,1954633,53,1,0,0,2
1954581,1954626,45,1,0,0,1
1954627,1956302,1675,0,0,1,1
1954634,1955096,462,0,0,1,2
1955097,1955110,13,1,0,0,2
1955111,1956303,1192,0,0,1,2
1956303,1956381,78,1,0,0,1
1956304,1956392,88,1,0,0,2
1956382,1956575,193,0,0,1,1
1956393,1956576,183,0,0,1,2
1956576,1956610,34,1,0,0,1
1956577,1956608,31,1,0,0,2
1956609,1957524,915,0,0,1,2
1956611,1957524,913,0,0,1,1
1957525,1957573,48,1,0,0,2
1957525,1957582,57,1,0,0,1
1957574,1958199,625,0,0,1,2
1957583,1958200,617,0,0,1,1
1958200,1958254,54,1,0,0,2
1958201,1958254,53,1,0,0,1
1958255,1958425,170,0,0,1,2
1958255,1958426,171,0,0,1,1
1958426,1958457,31,1,0,0,2
1958427,1958456,29,1,0,0,1
1958457,1958723,266,0,0,1,1
1958458,1958722,264,0,0,1,2
1958723,1958751,28,1,0,0,2
1958724,1958753,29,1,0,0,1
1958752,1959182,430,0,0,1,2
1958754,1959177,423,0,0,1,1
1959178,1959295,117,1,0,0,1
1959183,1959253,70,1,0,0,2
1959211,1959259,48,0,1,0,1
1959254,1959564,310,0,0,1,2
1959296,1959557,261,0,0,1,1
1959558,1959760,202,1,0,0,1
1959565,1959720,155,1,0,0,2
1959575,1959732,157,0,1,0,1
1959586,1959710,124,0,1,0,2
1959721,1959935,214,0,0,1,2
1959761,1959937,176,0,0,1,1
1959936,1959998,62,1,0,0,2
1959938,1959999,61,1,0,0,1
1959999,1960073,74,0,0,1,2
1960000,1960077,77,0,0,1,1
1960074,1960152,78,1,0,0,2
1960078,1960166,88,1,0,0,1
1960153,1960302,149,0,0,1,2
1960167,1960303,136,0,0,1,1
1960303,1960339,36,1,0,0,2
1960304,1960346,42,1,0,0,1
1960340,1960765,425,0,0,1,2
1960347,1960765,418,0,0,1,1
1960766,1960786,20,1,0,0,1
1960766,1960794,28,1,0,0,2
1960787,1961110,323,0,0,1,1
1960795,1961107,312,0,0,1,2
1961108,1961172,64,1,0,0,2
1961111,1961175,64,1,0,0,1
1961173,1961861,688,0,0,1,2
1961176,1961861,685,0,0,1,1
1961862,1961882,20,1,0,0,1
1961862,1961883,21,1,0,0,2
1961883,1962095,212,0,0,1,1
1961884,1962094,210,0,0,1,2
1962095,1962119,24,1,0,0,2
1962096,1962112,16,1,0,0,1
1962113,1963113,1000,0,0,1,1
1962120,1963112,992,0,0,1,2
1963113,1963149,36,1,0,0,2
1963114,1963142,28,1,0,0,1
1963143,1963543,400,0,0,1,1
1963150,1963542,392,0,0,1,2
1963543,1963675,132,1,0,0,2
1963544,1963618,74,1,0,0,1
1963619,1963787,168,0,0,1,1
1963676,1963784,108,0,0,1,2
1963785,1963842,57,1,0,0,2
1963788,1963811,23,1,0,0,1
1963812,1964257,445,0,0,1,1
1963843,1963932,89,0,0,1,2
1963933,1963942,9,1,0,0,2
1963943,1964208,265,0,0,1,2
1964209,1964319,110,1,0,0,2
1964258,1964301,43,1,0,0,1
1964302,1964666,364,0,0,1,1
1964320,1964668,348,0,0,1,2
1964667,1964716,49,1,0,0,1
1964669,1964715,46,1,0,0,2
1964716,1965015,299,0,0,1,2
1964717,1965016,299,0,0,1,1
1965016,1965108,92,1,0,0,2
1965017,1965115,98,1,0,0,1
1965109,1965365,256,0,0,1,2
1965116,1965370,254,0,0,1,1
1965366,1965399,33,1,0,0,2
1965371,1965389,18,1,0,0,1
1965390,1965818,428,0,0,1,1
1965400,1965815,415,0,0,1,2
1965816,1965876,60,1,0,0,2
1965819,1965877,58,1,0,0,1
1965877,1966745,868,0,0,1,2
1965878,1966749,871,0,0,1,1
1966746,1966838,92,1,0,0,2
1966750,1966827,77,1,0,0,1
1966828,1966988,160,0,0,1,1
1966839,1966989,150,0,0,1,2
1966989,1967015,26,1,0,0,1
1966990,1967023,33,1,0,0,2
1967016,1967982,966,0,0,1,1
1967024,1967983,959,0,0,1,2
1967983,1968053,70,1,0,0,1
1967984,1968066,82,1,0,0,2
1968054,1968487,433,0,0,1,1
1968067,1968486,419,0,0,1,2
1968487,1968563,76,1,0,0,2
1968488,1968564,76,1,0,0,1
1968564,1969283,719,0,0,1,2
1968565,1969284,719,0,0,1,1
1969284,1969341,57,1,0,0,2
1969285,1969341,56,1,0,0,1
1969342,1969898,556,0,0,1,1
1969342,1969903,561,0,0,1,2
1969899,1969977,78,1,0,0,1
1969904,1969979,75,1,0,0,2
1969978,1970717,739,0,0,1,1
1969980,1970716,736,0,0,1,2
1970717,1970786,69,1,0,0,2
1970718,1970799,81,1,0,0,1
1970787,1971482,695,0,0,1,2
1970800,1971482,682,0,0,1,1
1971483,1971551,68,1,0,0,2
1971483,1971554,71,1,0,0,1
1971552,1971572,20,0,0,1,2
1971555,1971580,25,0,0,1,1
1971573,1974148,2575,1,0,0,2
1971581,1974178,2597,1,0,0,1
1971607,1974137,2530,0,1,0,2
1971616,1974146,2530,0,1,0,1
1974149,1974630,481,0,0,1,2
1974179,1974633,454,0,0,1,1
1974631,1974833,202,1,0,0,2
1974634,1974805,171,1,0,0,1
1974657,1974755,98,0,1,0,1
1974661,1974741,80,0,1,0,2
1974806,1975175,369,0,0,1,1
1974834,1975174,340,0,0,1,2
1975175,1975198,23,1,0,0,2
1975176,1975192,16,1,0,0,1
1975193,1975810,617,0,0,1,1
1975199,1976515,1316,0,0,1,2
1975811,1975827,16,1,0,0,1
1975828,1976515,687,0,0,1,1
1976516,1976574,58,1,0,0,1
1976516,1976590,74,1,0,0,2
1976575,1976749,174,0,0,1,1
1976591,1976749,158,0,0,1,2
1976750,1976773,23,1,0,0,1
1976750,1976778,28,1,0,0,2
1976774,1977498,724,0,0,1,1
1976779,1979042,2263,0,0,1,2
1977499,1977503,4,1,0,0,1
1977504,1979043,1539,0,0,1,1
1979043,1979106,63,1,0,0,2
1979044,1979115,71,1,0,0,1
1979107,1979798,691,0,0,1,2
1979116,1979797,681,0,0,1,1
1979798,1979837,39,1,0,0,1
1979799,1979846,47,1,0,0,2
1979838,1981471,1633,0,0,1,1
1979847,1981471,1624,0,0,1,2
1981472,1981517,45,1,0,0,1
1981472,1981522,50,1,0,0,2
1981518,1983887,2369,0,0,1,1
1981523,1983879,2356,0,0,1,2
1983880,1984071,191,1,0,0,2
1983888,1983997,109,1,0,0,1
1983912,1983980,68,0,1,0,1
1983915,1983970,55,0,1,0,2
1983998,1984279,281,0,0,1,1
1984072,1984266,194,0,0,1,2
1984267,1984684,417,1,0,0,2
1984280,1984713,433,1,0,0,1
1984298,1984704,406,0,1,0,1
1984303,1984673,370,0,1,0,2
1984685,1984796,111,0,0,1,2
1984714,1984794,80,0,0,1,1
1984795,1984996,201,1,0,0,1
1984797,1984983,186,1,0,0,2
1984815,1984963,148,0,1,0,1
1984817,1984954,137,0,1,0,2
1984984,1985139,155,0,0,1,2
1984997,1985137,140,0,0,1,1
1985138,1985183,45,1,0,0,1
1985140,1985188,48,1,0,0,2
1985184,1985285,101,0,0,1,1
1985189,1985285,96,0,0,1,2
1985286,1985355,69,1,0,0,1
1985286,1985370,84,1,0,0,2
1985356,1985556,200,0,0,1,1
1985371,1985560,189,0,0,1,2
1985557,1986393,836,1,0,0,1
1985561,1986382,821,1,0,0,2
1985629,1986359,730,0,1,0,2
1985631,1986360,729,0,1,0,1
1986383,1986481,98,0,0,1,2
1986394,1986482,88,0,0,1,1
1986482,1986527,45,1,0,0,2
1986483,1986526,43,1,0,0,1
1986527,1986633,106,0,0,1,1
1986528,1986630,102,0,0,1,2
1986631,1986861,230,1,0,0,2
1986634,1986857,223,1,0,0,1
1986658,1986775,117,0,1,0,1
1986659,1986769,110,0,1,0,2
1986858,1987059,201,0,0,1,1
1986862,1987058,196,0,0,1,2
1987059,1987077,18,1,0,0,2
1987060,1987079,19,1,0,0,1
1987078,1987730,652,0,0,1,2
1987080,1987731,651,0,0,1,1
1987731,1987786,55,1,0,0,2
1987732,1987797,65,1,0,0,1
1987787,1988221,434,0,0,1,2
1987798,1988221,423,0,0,1,1
1988222,1988244,22,1,0,0,1
1988222,1988252,30,1,0,0,2
1988245,1988690,445,0,0,1,1
1988253,1988689,436,0,0,1,2
1988690,1988714,24,1,0,0,2
1988691,1988723,32,1,0,0,1
1988715,1990042,1327,0,0,1,2
1988724,1990042,1318,0,0,1,1
1990043,1990093,50,1,0,0,1
1990043,1990095,52,1,0,0,2
1990094,1990723,629,0,0,1,1
1990096,1990725,629,0,0,1,2
1990724,1990770,46,1,0,0,1
1990726,1990790,64,1,0,0,2
1990771,1990998,227,0,0,1,1
1990791,1991001,210,0,0,1,2
1990999,1991069,70,1,0,0,1
1991002,1991071,69,1,0,0,2
1991070,1991214,144,0,0,1,1
1991072,1991216,144,0,0,1,2
1991215,1991241,26,1,0,0,1
1991217,1991243,26,1,0,0,2
1991242,1992248,1006,0,0,1,1
1991244,1992246,1002,0,0,1,2
1992247,1992294,47,1,0,0,2
1992249,1992295,46,1,0,0,1
1992295,1992548,253,0,0,1,2
1992296,1992547,251,0,0,1,1
1992548,1992590,42,1,0,0,1
1992549,1992611,62,1,0,0,2
1992591,1992742,151,0,0,1,1
1992612,1992748,136,0,0,1,2
1992743,1992867,124,1,0,0,1
1992749,1992823,74,1,0,0,2
1992824,1994969,2145,0,0,1,2
1992868,1994968,2100,0,0,1,1
1994969,1995023,54,1,0,0,1
1994970,1995037,67,1,0,0,2
1995024,1995590,566,0,0,1,1
1995038,1995588,550,0,0,1,2
1995589,1995639,50,1,0,0,2
1995591,1995636,45,1,0,0,1
1995637,1996004,367,0,0,1,1
1995640,1996003,363,0,0,1,2
1996004,1996084,80,1,0,0,2
1996005,1996081,76,1,0,0,1
1996082,1996187,105,0,0,1,1
1996085,1996187,102,0,0,1,2
1996188,1996218,30,1,0,0,2
1996188,1996219,31,1,0,0,1
1996219,1996467,248,0,0,1,2
1996220,1996465,245,0,0,1,1
1996466,1996699,233,1,0,0,1
1996468,1996702,234,1,0,0,2
1996482,1996690,208,0,1,0,1
1996485,1996620,135,0,1,0,2
1996700,1996788,88,0,0,1,1
1996703,1996796,93,0,0,1,2
1996789,1997221,432,1,0,0,1
1996797,1997109,312,1,0,0,2
1996803,1997211,408,0,1,0,1
1996818,1997029,211,0,1,0,2
1997110,1997159,49,0,0,1,2
1997160,1997180,20,1,0,0,2
1997181,1997394,213,0,0,1,2
1997222,1997394,172,0,0,1,1
1997395,1997446,51,1,0,0,2
1997395,1997448,53,1,0,0,1
1997447,1997615,168,0,0,1,2
1997449,1997615,166,0,0,1,1
1997616,1997642,26,1,0,0,2
1997616,1997643,27,1,0,0,1
1997643,1998705,1062,0,0,1,2
1997644,1998705,1061,0,0,1,1
1998706,1998727,21,1,0,0,2
1998706,1998734,28,1,0,0,1
1998728,1999760,1032,0,0,1,2
1998735,1999760,1025,0,0,1,1
1999761,1999793,32,1,0,0,2
1999761,1999794,33,1,0,0,1
1999794,2000234,440,0,0,1,2
1999795,2000232,437,0,0,1,1
2000233,2000277,44,1,0,0,1
2000235,2000276,41,1,0,0,2
2000277,2000726,449,0,0,1,2
2000278,2000726,448,0,0,1,1
2000727,2000802,75,1,0,0,1
2000727,2000814,87,1,0,0,2
2000803,2000997,194,0,0,1,1
2000815,2000998,183,0,0,1,2
2000998,2001030,32,1,0,0,1
2000999,2001061,62,1,0,0,2
2001031,2002325,1294,0,0,1,1
2001062,2001098,36,0,0,1,2
2001099,2001232,133,1,0,0,2
2001233,2001375,142,0,0,1,2
2001376,2001436,60,1,0,0,2
2001437,2001499,62,0,0,1,2
2001500,2001609,109,1,0,0,2
2001610,2001651,41,0,0,1,2
2001652,2001663,11,1,0,0,2
2001664,2001708,44,0,0,1,2
2001709,2001965,256,1,0,0,2
2001966,2001997,31,0,0,1,2
2001998,2002123,125,1,0,0,2
2002124,2002205,81,0,0,1,2
2002206,2002229,23,1,0,0,2
2002230,2002315,85,0,0,1,2
2002316,2002396,80,1,0,0,2
2002326,2002385,59,1,0,0,1
2002386,2002558,172,0,0,1,1
2002397,2002559,162,0,0,1,2
2002559,2002588,29,1,0,0,1
2002560,2002587,27,1,0,0,2
2002588,2003673,1085,0,0,1,2
2002589,2003672,1083,0,0,1,1
2003673,2003698,25,1,0,0,1
2003674,2003689,15,1,0,0,2
2003690,2004024,334,0,0,1,2
2003699,2004023,324,0,0,1,1
2004024,2004053,29,1,0,0,1
2004025,2004051,26,1,0,0,2
2004052,2004802,750,0,0,1,2
2004054,2004803,749,0,0,1,1
2004803,2004857,54,1,0,0,2
2004804,2004852,48,1,0,0,1
2004853,2005710,857,0,0,1,1
2004858,2005710,852,0,0,1,2
2005711,2005763,52,1,0,0,1
2005711,2005763,52,1,0,0,2
2005764,2006237,473,0,0,1,2
2005764,2006238,474,0,0,1,1
2006238,2006321,83,1,0,0,2
2006239,2006321,82,1,0,0,1
2006322,2006561,239,0,0,1,2
2006322,2006564,242,0,0,1,1
2006562,2006586,24,1,0,0,2
2006565,2006577,12,1,0,0,1
2006578,2007300,722,0,0,1,1
2006587,2006954,367,0,0,1,2
2006955,2007050,95,1,0,0,2
2007051,2007304,253,0,0,1,2
2007301,2007321,20,1,0,0,1
2007305,2007395,90,1,0,0,2
2007322,2007563,241,0,0,1,1
2007396,2007561,165,0,0,1,2
2007562,2007626,64,1,0,0,2
2007564,2007615,51,1,0,0,1
2007616,2007802,186,0,0,1,1
2007627,2007803,176,0,0,1,2
2007803,2007836,33,1,0,0,1
2007804,2007828,24,1,0,0,2
2007829,2010005,2176,0,0,1,2
2007837,2010005,2168,0,0,1,1
2010006,2010056,50,1,0,0,1
2010006,2010062,56,1,0,0,2
2010057,2011109,1052,0,0,1,1
2010063,2011111,1048,0,0,1,2
2011110,2011188,78,1,0,0,1
2011112,2011191,79,1,0,0,2
2011189,2011434,245,0,0,1,1
2011192,2011547,355,0,0,1,2
2011435,2011446,11,1,0,0,1
2011447,2012958,1511,0,0,1,1
2011548,2011580,32,1,0,0,2
2011581,2011733,152,0,0,1,2
2011734,2011744,10,1,0,0,2
2011745,2011841,96,0,0,1,2
2011842,2011861,19,1,0,0,2
2011862,2012159,297,0,0,1,2
2012160,2012179,19,1,0,0,2
2012180,2012958,778,0,0,1,2
2012959,2013018,59,1,0,0,2
2012959,2013026,67,1,0,0,1
2013019,2013295,276,0,0,1,2
2013027,2013294,267,0,0,1,1
2013295,2013321,26,1,0,0,1
2013296,2013319,23,1,0,0,2
2013320,2013779,459,0,0,1,2
2013322,2013777,455,0,0,1,1
2013778,2013806,28,1,0,0,1
2013780,2013797,17,1,0,0,2
2013798,2015276,1478,0,0,1,2
2013807,2015277,1470,0,0,1,1
2015277,2015332,55,1,0,0,2
2015278,2015324,46,1,0,0,1
2015325,2015791,466,0,0,1,1
2015333,2015789,456,0,0,1,2
2015790,2015840,50,1,0,0,2
2015792,2015837,45,1,0,0,1
2015838,2016996,1158,0,0,1,1
2015841,2016998,1157,0,0,1,2
2016997,2017057,60,1,0,0,1
2016999,2017058,59,1,0,0,2
2017058,2017225,167,0,0,1,1
2017059,2017224,165,0,0,1,2
2017225,2017255,30,1,0,0,2
2017226,2017256,30,1,0,0,1
2017256,2017954,698,0,0,1,2
2017257,2017951,694,0,0,1,1
2017952,2017971,19,1,0,0,1
2017955,2017971,16,1,0,0,2
2017972,2018420,448,0,0,1,2
2017972,2018421,449,0,0,1,1
2018421,2018470,49,1,0,0,2
2018422,2018465,43,1,0,0,1
2018466,2018834,368,0,0,1,1
2018471,2018833,362,0,0,1,2
2018834,2018855,21,1,0,0,2
2018835,2018858,23,1,0,0,1
2018856,2020654,1798,0,0,1,2
2018859,2020655,1796,0,0,1,1
2020655,2020699,44,1,0,0,2
2020656,2020694,38,1,0,0,1
2020695,2021127,432,0,0,1,1
2020700,2021128,428,0,0,1,2
2021128,2021170,42,1,0,0,1
2021129,2021181,52,1,0,0,2
2021171,2021892,721,0,0,1,1
2021182,2021893,711,0,0,1,2
2021893,2021942,49,1,0,0,1
2021894,2021951,57,1,0,0,2
2021943,2022110,167,0,0,1,1
2021952,2022110,158,0,0,1,2
2022111,2022134,23,1,0,0,1
2022111,2022135,24,1,0,0,2
2022135,2023208,1073,0,0,1,1
2022136,2023209,1073,0,0,1,2
2023209,2023265,56,1,0,0,1
2023210,2023262,52,1,0,0,2
2023263,2023480,217,0,0,1,2
2023266,2023479,213,0,0,1,1
2023480,2023506,26,1,0,0,1
2023481,2023505,24,1,0,0,2
2023506,2024321,815,0,0,1,2
2023507,2024319,812,0,0,1,1
2024320,2024337,17,1,0,0,1
2024322,2024335,13,1,0,0,2
2024336,2025770,1434,0,0,1,2
2024338,2025769,1431,0,0,1,1
2025770,2025819,49,1,0,0,1
2025771,2025906,135,1,0,0,2
2025820,2026565,745,0,0,1,1
2025907,2026565,658,0,0,1,2
2026566,2026620,54,1,0,0,2
2026566,2026623,57,1,0,0,1
2026621,2026677,56,0,0,1,2
2026624,2026743,119,0,0,1,1
2026678,2026811,133,1,0,0,2
2026744,2026810,66,1,0,0,1
2026811,2026943,132,0,0,1,1
2026812,2026941,129,0,0,1,2
2026942,2026966,24,1,0,0,2
2026944,2026974,30,1,0,0,1
2026967,2027702,735,0,0,1,2
2026975,2027703,728,0,0,1,1
2027703,2027755,52,1,0,0,2
2027704,2027765,61,1,0,0,1
2027756,2028137,381,0,0,1,2
2027766,2028135,369,0,0,1,1
2028136,2028164,28,1,0,0,1
2028138,2028175,37,1,0,0,2
2028165,2029373,1208,0,0,1,1
2028176,2028428,252,0,0,1,2
2028429,2028458,29,1,0,0,2
2028459,2028641,182,0,0,1,2
2028642,2028658,16,1,0,0,2
2028659,2028706,47,0,0,1,2
2028707,2028743,36,1,0,0,2
2028744,2028798,54,0,0,1,2
2028799,2028815,16,1,0,0,2
2028816,2028850,34,0,0,1,2
2028851,2028860,9,1,0,0,2
2028861,2029077,216,0,0,1,2
2029078,2030037,959,1,0,0,2
2029374,2029404,30,1,0,0,1
2029405,2029980,575,0,0,1,1
2029981,2030023,42,1,0,0,1
2030024,2030779,755,0,0,1,1
2030038,2030780,742,0,0,1,2
2030780,2030835,55,1,0,0,1
2030781,2030838,57,1,0,0,2
2030836,2031067,231,0,0,1,1
2030839,2031068,229,0,0,1,2
2031068,2031150,82,1,0,0,1
2031069,2031153,84,1,0,0,2
2031151,2031253,102,0,0,1,1
2031154,2031256,102,0,0,1,2
2031254,2031287,33,1,0,0,1
2031257,2031286,29,1,0,0,2
2031287,2032192,905,0,0,1,2
2031288,2032188,900,0,0,1,1
2032189,2032248,59,1,0,0,1
2032193,2032245,52,1,0,0,2
2032246,2032421,175,0,0,1,2
2032249,2032424,175,0,0,1,1
2032422,2032456,34,1,0,0,2
2032425,2032448,23,1,0,0,1
2032449,2032701,252,0,0,1,1
2032457,2032701,244,0,0,1,2
2032702,2032731,29,1,0,0,1
2032702,2032732,30,1,0,0,2
2032732,2034483,1751,0,0,1,1
2032733,2034483,1750,0,0,1,2
2034484,2034547,63,1,0,0,1
2034484,2034555,71,1,0,0,2
2034548,2035161,613,0,0,1,1
2034556,2035161,605,0,0,1,2
2035162,2035220,58,1,0,0,2
2035162,2035228,66,1,0,0,1
2035221,2035559,338,0,0,1,2
2035229,2035559,330,0,0,1,1
2035560,2035622,62,1,0,0,2
2035560,2035624,64,1,0,0,1
2035623,2035737,114,0,0,1,2
2035625,2035737,112,0,0,1,1
2035738,2035771,33,1,0,0,1
2035738,2035772,34,1,0,0,2
2035772,2036367,595,0,0,1,1
2035773,2036367,594,0,0,1,2
2036368,2036379,11,1,0,0,2
2036368,2036380,12,1,0,0,1
2036380,2036591,211,0,0,1,2
2036381,2036589,208,0,0,1,1
2036590,2036650,60,1,0,0,1
2036592,2036664,72,1,0,0,2
2036651,2039022,2371,0,0,1,1
2036665,2039022,2357,0,0,1,2
2039023,2039061,38,1,0,0,1
2039023,2039063,40,1,0,0,2
2039062,2039797,735,0,0,1,1
2039064,2039799,735,0,0,1,2
2039798,2039854,56,1,0,0,1
2039800,2039857,57,1,0,0,2
2039855,2040020,165,0,0,1,1
2039858,2040019,161,0,0,1,2
2040020,2040058,38,1,0,0,2
2040021,2040059,38,1,0,0,1
2040059,2041357,1298,0,0,1,2
2040060,2041356,1296,0,0,1,1
2041357,2041422,65,1,0,0,1
2041358,2041421,63,1,0,0,2
2041422,2041680,258,0,0,1,2
2041423,2041681,258,0,0,1,1
2041681,2041712,31,1,0,0,2
2041682,2041714,32,1,0,0,1
2041713,2043488,1775,0,0,1,2
2041715,2043491,1776,0,0,1,1
2043489,2043545,56,1,0,0,2
2043492,2043540,48,1,0,0,1
2043541,2044124,583,0,0,1,1
2043546,2044126,580,0,0,1,2
2044125,2044176,51,1,0,0,1
2044127,2044173,46,1,0,0,2
2044174,2044670,496,0,0,1,2
2044177,2044670,493,0,0,1,1
2044671,2044716,45,1,0,0,2
2044671,2044717,46,1,0,0,1
2044717,2045101,384,0,0,1,2
2044718,2045102,384,0,0,1,1
2045102,2045221,119,1,0,0,2
2045103,2045302,199,1,0,0,1
2045222,2045329,107,0,0,1,2
2045303,2045332,29,0,0,1,1
2045330,2045366,36,1,0,0,2
2045333,2045374,41,1,0,0,1
2045367,2046115,748,0,0,1,2
2045375,2045767,392,0,0,1,1
2045768,2045776,8,1,0,0,1
2045777,2046084,307,0,0,1,1
2046085,2046091,6,1,0,0,1
2046092,2046263,171,0,0,1,1
2046116,2046162,46,1,0,0,2
2046163,2046260,97,0,0,1,2
2046261,2046387,126,1,0,0,2
2046264,2046298,34,1,0,0,1
2046299,2046931,632,0,0,1,1
2046388,2046489,101,0,0,1,2
2046490,2046579,89,1,0,0,2
2046580,2046742,162,0,0,1,2
2046743,2046824,81,1,0,0,2
2046825,2046928,103,0,0,1,2
2046929,2046988,59,1,0,0,2
2046932,2046984,52,1,0,0,1
2046985,2047264,279,0,0,1,1
2046989,2047266,277,0,0,1,2
2047265,2047294,29,1,0,0,1
2047267,2047288,21,1,0,0,2
2047289,2047636,347,0,0,1,2
2047295,2047646,351,0,0,1,1
2047637,2048180,543,1,0,0,2
2047647,2048181,534,1,0,0,1
2047799,2048169,370,0,1,0,2
2047801,2048170,369,0,1,0,1
2048181,2048299,118,0,0,1,2
2048182,2048301,119,0,0,1,1
2048300,2048324,24,1,0,0,2
2048302,2048328,26,1,0,0,1
2048325,2048459,134,0,0,1,2
2048329,2048464,135,0,0,1,1
2048460,2048674,214,1,0,0,2
2048465,2048630,165,1,0,0,1
2048481,2048591,110,0,1,0,1
2048486,2048574,88,0,1,0,2
2048631,2048795,164,0,0,1,1
2048675,2048797,122,0,0,1,2
2048796,2048815,19,1,0,0,1
2048798,2048815,17,1,0,0,2
2048816,2049313,497,0,0,1,1
2048816,2049317,501,0,0,1,2
2049314,2049394,80,1,0,0,1
2049318,2049393,75,1,0,0,2
2049394,2049649,255,0,0,1,2
2049395,2049652,257,0,0,1,1
2049650,2049860,210,1,0,0,2
2049653,2049816,163,1,0,0,1
2049669,2049790,121,0,1,0,1
2049675,2049755,80,0,1,0,2
2049817,2050555,738,0,0,1,1
2049861,2050557,696,0,0,1,2
2050556,2050599,43,1,0,0,1
2050558,2050595,37,1,0,0,2
2050596,2050814,218,0,0,1,2
2050600,2050816,216,0,0,1,1
2050815,2050922,107,1,0,0,2
2050817,2050921,104,1,0,0,1
2050922,2051460,538,0,0,1,1
2050923,2051458,535,0,0,1,2
2051459,2051490,31,1,0,0,2
2051461,2051481,20,1,0,0,1
2051482,2051794,312,0,0,1,1
2051491,2051793,302,0,0,1,2
2051794,2051816,22,1,0,0,2
2051795,2051814,19,1,0,0,1
2051815,2052517,702,0,0,1,1
2051817,2052518,701,0,0,1,2
2052518,2052586,68,1,0,0,1
2052519,2052583,64,1,0,0,2
2052584,2053449,865,0,0,1,2
2052587,2053446,859,0,0,1,1
2053447,2053467,20,1,0,0,1
2053450,2053463,13,1,0,0,2
2053464,2054175,711,0,0,1,2
2053468,2054169,701,0,0,1,1
2054170,2054201,31,1,0,0,1
2054176,2054202,26,1,0,0,2
2054202,2054785,583,0,0,1,1
2054203,2054787,584,0,0,1,2
2054786,2054823,37,1,0,0,1
2054788,2054825,37,1,0,0,2
2054824,2055153,329,0,0,1,1
2054826,2055152,326,0,0,1,2
2055153,2055218,65,1,0,0,2
2055154,2055217,63,1,0,0,1
2055218,2056325,1107,0,0,1,1
2055219,2055536,317,0,0,1,2
2055537,2055577,40,1,0,0,2
2055578,2056325,747,0,0,1,2
2056326,2056397,71,1,0,0,1
2056326,2056403,77,1,0,0,2
2056398,2056584,186,0,0,1,1
2056404,2056584,180,0,0,1,2
2056585,2056615,30,1,0,0,1
2056585,2056616,31,1,0,0,2
2056616,2057377,761,0,0,1,1
2056617,2057379,762,0,0,1,2
2057378,2057399,21,1,0,0,1
2057380,2057398,18,1,0,0,2
2057399,2057688,289,0,0,1,2
2057400,2057687,287,0,0,1,1
2057688,2057729,41,1,0,0,1
2057689,2057727,38,1,0,0,2
2057728,2058904,1176,0,0,1,2
2057730,2058903,1173,0,0,1,1
2058904,2058926,22,1,0,0,1
2058905,2058926,21,1,0,0,2
2058927,2060224,1297,0,0,1,1
2058927,2060224,1297,0,0,1,2
2060225,2060281,56,1,0,0,1
2060225,2060458,233,1,0,0,2
2060282,2060647,365,0,0,1,1
2060459,2060645,186,0,0,1,2
2060646,2060691,45,1,0,0,2
2060648,2060691,43,1,0,0,1
2060692,2061121,429,0,0,1,2
2060692,2061123,431,0,0,1,1
2061122,2061170,48,1,0,0,2
2061124,2061173,49,1,0,0,1
2061171,2061281,110,0,0,1,2
2061174,2061279,105,0,0,1,1
2061280,2061358,78,1,0,0,1
2061282,2061358,76,1,0,0,2
2061359,2061471,112,0,0,1,1
2061359,2061473,114,0,0,1,2
2061472,2061518,46,1,0,0,1
2061474,2061510,36,1,0,0,2
2061511,2062125,614,0,0,1,2
2061519,2062123,604,0,0,1,1
2062124,2062145,21,1,0,0,1
2062126,2062149,23,1,0,0,2
2062146,2062726,580,0,0,1,1
2062150,2062725,575,0,0,1,2
2062726,2062781,55,1,0,0,2
2062727,2062779,52,1,0,0,1
2062780,2063054,274,0,0,1,1
2062782,2063052,270,0,0,1,2
2063053,2063079,26,1,0,0,2
2063055,2063071,16,1,0,0,1
2063072,2065290,2218,0,0,1,1
2063080,2065287,2207,0,0,1,2
2065288,2065336,48,1,0,0,2
2065291,2065338,47,1,0,0,1
2065337,2066360,1023,0,0,1,2
2065339,2066359,1020,0,0,1,1
2066360,2066401,41,1,0,0,1
2066361,2066401,40,1,0,0,2
2066402,2066727,325,0,0,1,1
2066402,2066727,325,0,0,1,2
2066728,2066819,91,1,0,0,1
2066728,2066826,98,1,0,0,2
2066820,2066920,100,0,0,1,1
2066827,2066920,93,0,0,1,2
2066921,2066952,31,1,0,0,1
2066921,2066968,47,1,0,0,2
2066953,2067338,385,0,0,1,1
2066969,2067340,371,0,0,1,2
2067339,2067367,28,1,0,0,1
2067341,2067359,18,1,0,0,2
2067360,2067560,200,0,0,1,2
2067368,2067433,65,0,0,1,1
2067434,2067440,6,1,0,0,1
2067441,2068101,660,0,0,1,1
2067561,2067627,66,1,0,0,2
2067628,2067650,22,0,0,1,2
2067651,2067799,148,1,0,0,2
2067800,2067856,56,0,0,1,2
2067857,2067883,26,1,0,0,2
2067884,2067939,55,0,0,1,2
2067940,2067990,50,1,0,0,2
2067991,2068098,107,0,0,1,2
2068099,2068146,47,1,0,0,2
2068102,2068147,45,1,0,0,1
2068147,2068413,266,0,0,1,2
2068148,2068411,263,0,0,1,1
2068412,2068442,30,1,0,0,1
2068414,2068435,21,1,0,0,2
2068436,2070427,1991,0,0,1,2
2068443,2070427,1984,0,0,1,1
2070428,2070467,39,1,0,0,1
2070428,2070478,50,1,0,0,2
2070468,2071580,1112,0,0,1,1
2070479,2071581,1102,0,0,1,2
2071581,2071656,75,1,0,0,1
2071582,2071658,76,1,0,0,2
2071657,2071803,146,0,0,1,1
2071659,2071802,143,0,0,1,2
2071803,2071840,37,1,0,0,2
2071804,2071833,29,1,0,0,1
2071834,2072865,1031,0,0,1,1
2071841,2072864,1023,0,0,1,2
2072865,2072907,42,1,0,0,2
2072866,2072905,39,1,0,0,1
2072906,2074299,1393,0,0,1,1
2072908,2074298,1390,0,0,1,2
2074299,2074337,38,1,0,0,2
2074300,2074337,37,1,0,0,1
2074338,2075369,1031,0,0,1,2
2074338,2075371,1033,0,0,1,1
2075370,2075404,34,1,0,0,2
2075372,2075405,33,1,0,0,1
2075405,2075788,383,0,0,1,2
2075406,2075787,381,0,0,1,1
2075788,2075819,31,1,0,0,1
2075789,2075828,39,1,0,0,2
2075820,2076087,267,0,0,1,1
2075829,2076087,258,0,0,1,2
2076088,2076128,40,1,0,0,2
2076088,2076129,41,1,0,0,1
2076129,2076362,233,0,0,1,2
2076130,2076359,229,0,0,1,1
2076360,2076382,22,1,0,0,1
2076363,2076382,19,1,0,0,2
2076383,2077138,755,0,0,1,2
2076383,2077143,760,0,0,1,1
2077139,2077164,25,1,0,0,2
2077144,2077155,11,1,0,0,1
2077156,2077399,243,0,0,1,1
2077165,2077399,234,0,0,1,2
2077400,2077477,77,1,0,0,1
2077400,2077477,77,1,0,0,2
2077478,2077603,125,0,0,1,1
2077478,2077604,126,0,0,1,2
2077604,2077645,41,1,0,0,1
2077605,2077632,27,1,0,0,2
2077633,2078857,1224,0,0,1,2
2077646,2078856,1210,0,0,1,1
2078857,2078876,19,1,0,0,1
2078858,2078878,20,1,0,0,2
2078877,2079201,324,0,0,1,1
2078879,2079201,322,0,0,1,2
2079202,2079222,20,1,0,0,1
2079202,2079222,20,1,0,0,2
2079223,2080124,901,0,0,1,1
2079223,2080124,901,0,0,1,2
2080125,2080179,54,1,0,0,1
2080125,2080183,58,1,0,0,2
2080180,2080686,506,0,0,1,1
2080184,2080689,505,0,0,1,2
2080687,2080744,57,1,0,0,1
2080690,2080743,53,1,0,0,2
2080744,2080862,118,0,0,1,2
2080745,2080866,121,0,0,1,1
2080863,2080949,86,1,0,0,2
2080867,2080953,86,1,0,0,1
2080950,2081153,203,0,0,1,2
2080954,2081151,197,0,0,1,1
2081152,2081183,31,1,0,0,1
2081154,2081184,30,1,0,0,2
2081184,2082686,1502,0,0,1,1
2081185,2082686,1501,0,0,1,2
2082687,2082744,57,1,0,0,1
2082687,2082759,72,1,0,0,2
2082745,2083605,860,0,0,1,1
2082760,2083606,846,0,0,1,2
2083606,2083635,29,1,0,0,1
2083607,2083628,21,1,0,0,2
2083629,2084393,764,0,0,1,2
2083636,2084392,756,0,0,1,1
2084393,2084421,28,1,0,0,1
2084394,2084420,26,1,0,0,2
2084421,2084964,543,0,0,1,2
2084422,2084965,543,0,0,1,1
2084965,2085010,45,1,0,0,2
2084966,2085002,36,1,0,0,1
2085003,2085261,258,0,0,1,1
2085011,2085261,250,0,0,1,2
2085262,2085318,56,1,0,0,1
2085262,2085454,192,1,0,0,2
2085319,2086267,948,0,0,1,1
2085455,2085758,303,0,0,1,2
2085759,2085805,46,1,0,0,2
2085806,2085871,65,0,0,1,2
2085872,2085905,33,1,0,0,2
2085906,2086026,120,0,0,1,2
2086027,2086117,90,1,0,0,2
2086118,2086268,150,0,0,1,2
2086268,2086307,39,1,0,0,1
2086269,2086317,48,1,0,0,2
2086308,2086590,282,0,0,1,1
2086318,2086591,273,0,0,1,2
2086591,2086670,79,1,0,0,1
2086592,2086673,81,1,0,0,2
2086671,2086851,180,0,0,1,1
2086674,2086850,176,0,0,1,2
2086851,2086884,33,1,0,0,2
2086852,2086875,23,1,0,0,1
2086876,2088298,1422,0,0,1,1
2086885,2088296,1411,0,0,1,2
2088297,2088351,54,1,0,0,2
2088299,2088341,42,1,0,0,1
2088342,2088539,197,0,0,1,1
2088352,2088538,186,0,0,1,2
2088539,2088567,28,1,0,0,2
2088540,2088564,24,1,0,0,1
2088565,2089492,927,0,0,1,1
2088568,2089496,928,0,0,1,2
2089493,2089509,16,1,0,0,1
2089497,2089523,26,1,0,0,2
2089510,2090536,1026,0,0,1,1
2089524,2090527,1003,0,0,1,2
2090528,2090720,192,1,0,0,2
2090537,2090681,144,1,0,0,1
2090682,2090816,134,0,0,1,1
2090721,2090811,90,0,0,1,2
2090812,2091528,716,1,0,0,2
2090817,2091300,483,1,0,0,1
2090847,2091289,442,0,1,0,1
2090851,2091292,441,0,1,0,2
2091301,2091324,23,0,0,1,1
2091325,2091526,201,1,0,0,1
2091341,2091502,161,0,1,0,1
2091346,2091479,133,0,1,0,2
2091527,2091767,240,0,0,1,1
2091529,2091768,239,0,0,1,2
2091768,2091823,55,1,0,0,1
2091769,2091821,52,1,0,0,2
2091822,2091955,133,0,0,1,2
2091824,2091957,133,0,0,1,1
2091956,2092063,107,1,0,0,2
2091958,2092054,96,1,0,0,1
2092055,2092145,90,0,0,1,1
2092064,2092144,80,0,0,1,2
2092145,2092261,116,1,0,0,2
2092146,2092258,112,1,0,0,1
2092259,2092374,115,0,0,1,1
2092262,2092375,113,0,0,1,2
2092375,2092422,47,1,0,0,1
2092376,2092414,38,1,0,0,2
2092415,2092748,333,0,0,1,2
2092423,2092752,329,0,0,1,1
2092749,2092974,225,1,0,0,2
2092753,2092994,241,1,0,0,1
2092767,2092941,174,0,1,0,1
2092773,2092908,135,0,1,0,2
2092975,2093015,40,0,0,1,2
2092995,2093277,282,0,0,1,1
2093016,2093072,56,1,0,0,2
2093073,2093276,203,0,0,1,2
2093277,2093293,16,1,0,0,2
2093278,2093296,18,1,0,0,1
2093294,2094683,1389,0,0,1,2
2093297,2094685,1388,0,0,1,1
2094684,2094728,44,1,0,0,2
2094686,2094723,37,1,0,0,1
2094724,2097366,2642,0,0,1,1
2094729,2097364,2635,0,0,1,2
2097365,2097403,38,1,0,0,2
2097367,2097406,39,1,0,0,1
2097404,2097863,459,0,0,1,2
2097407,2097860,453,0,0,1,1
2097861,2097893,32,1,0,0,1
2097864,2097896,32,1,0,0,2
2097894,2098763,869,0,0,1,1
2097897,2098759,862,0,0,1,2
2098760,2098778,18,1,0,0,2
2098764,2098775,11,1,0,0,1
2098776,2099689,913,0,0,1,1
2098779,2099695,916,0,0,1,2
2099690,2099710,20,1,0,0,1
2099696,2099712,16,1,0,0,2
2099711,2100162,451,0,0,1,1
2099713,2100162,449,0,0,1,2
2100163,2100226,63,1,0,0,1
2100163,2100235,72,1,0,0,2
2100227,2100474,247,0,0,1,1
2100236,2100477,241,0,0,1,2
2100475,2100498,23,1,0,0,1
2100478,2100499,21,1,0,0,2
2100499,2100911,412,0,0,1,1
2100500,2100920,420,0,0,1,2
2100912,2100934,22,1,0,0,1
2100921,2100939,18,1,0,0,2
2100935,2100971,36,0,0,1,1
2100940,2100973,33,0,0,1,2
2100972,2100986,14,1,0,0,1
2100974,2100985,11,1,0,0,2
2100986,2101483,497,0,0,1,2
2100987,2101482,495,0,0,1,1
2101483,2101510,27,1,0,0,1
2101484,2101507,23,1,0,0,2
2101508,2101934,426,0,0,1,2
2101511,2101934,423,0,0,1,1
2101935,2101954,19,1,0,0,2
2101935,2101957,22,1,0,0,1
2101955,2102369,414,0,0,1,2
2101958,2102370,412,0,0,1,1
2102370,2102425,55,1,0,0,2
2102371,2102428,57,1,0,0,1
2102426,2102720,294,0,0,1,2
2102429,2102720,291,0,0,1,1
2102721,2102773,52,1,0,0,1
2102721,2102773,52,1,0,0,2
2102774,2103361,587,0,0,1,2
2102774,2103363,589,0,0,1,1
2103362,2103400,38,1,0,0,2
2103364,2103389,25,1,0,0,1
2103390,2103646,256,0,0,1,1
2103401,2103646,245,0,0,1,2
2103647,2103728,81,1,0,0,2
2103647,2103733,86,1,0,0,1
2103729,2103898,169,0,0,1,2
2103734,2103898,164,0,0,1,1
2103899,2103938,39,1,0,0,1
2103899,2104016,117,1,0,0,2
2103939,2105516,1577,0,0,1,1
2104017,2104974,957,0,0,1,2
2104975,2105011,36,1,0,0,2
2105012,2105200,188,0,0,1,2
2105201,2105322,121,1,0,0,2
2105323,2105379,56,0,0,1,2
2105380,2105484,104,1,0,0,2
2105485,2105518,33,0,0,1,2
2105517,2105581,64,1,0,0,1
2105519,2105578,59,1,0,0,2
2105579,2105978,399,0,0,1,2
2105582,2105977,395,0,0,1,1
2105978,2106002,24,1,0,0,1
2105979,2106002,23,1,0,0,2
2106003,2107193,1190,0,0,1,1
2106003,2107195,1192,0,0,1,2
2107194,2107225,31,1,0,0,1
2107196,2107218,22,1,0,0,2
2107219,2107961,742,0,0,1,2
2107226,2107963,737,0,0,1,1
2107962,2108013,51,1,0,0,2
2107964,2108009,45,1,0,0,1
2108010,2108312,302,0,0,1,1
2108014,2108313,299,0,0,1,2
2108313,2108365,52,1,0,0,1
2108314,2108381,67,1,0,0,2
2108366,2108746,380,0,0,1,1
2108382,2108748,366,0,0,1,2
2108747,2108787,40,1,0,0,1
2108749,2108790,41,1,0,0,2
2108788,2109315,527,0,0,1,1
2108791,2109174,383,0,0,1,2
2109175,2109197,22,1,0,0,2
2109198,2109312,114,0,0,1,2
2109313,2109354,41,1,0,0,2
2109316,2109347,31,1,0,0,1
2109348,2109508,160,0,0,1,1
2109355,2109508,153,0,0,1,2
2109509,2109609,100,1,0,0,1
2109509,2109618,109,1,0,0,2
2109610,2109708,98,0,0,1,1
2109619,2109711,92,0,0,1,2
2109709,2109749,40,1,0,0,1
2109712,2109736,24,1,0,0,2
2109737,2111201,1464,0,0,1,2
2109750,2111202,1452,0,0,1,1
2111202,2111250,48,1,0,0,2
2111203,2111242,39,1,0,0,1
2111243,2111526,283,0,0,1,1
2111251,2111525,274,0,0,1,2
2111526,2111601,75,1,0,0,2
2111527,2111590,63,1,0,0,1
2111591,2111987,396,0,0,1,1
2111602,2111987,385,0,0,1,2
2111988,2112009,21,1,0,0,1
2111988,2112019,31,1,0,0,2
2112010,2112438,428,0,0,1,1
2112020,2112440,420,0,0,1,2
2112439,2112460,21,1,0,0,1
2112441,2112462,21,1,0,0,2
2112461,2113827,1366,0,0,1,1
2112463,2113828,1365,0,0,1,2
2113828,2113880,52,1,0,0,1
2113829,2113879,50,1,0,0,2
2113880,2114239,359,0,0,1,2
2113881,2114239,358,0,0,1,1
2114240,2114303,63,1,0,0,2
2114240,2114306,66,1,0,0,1
2114304,2114607,303,0,0,1,2
2114307,2114606,299,0,0,1,1
2114607,2114648,41,1,0,0,1
2114608,2114651,43,1,0,0,2
2114649,2115376,727,0,0,1,1
2114652,2115375,723,0,0,1,2
2115376,2115418,42,1,0,0,2
2115377,2115407,30,1,0,0,1
2115408,2115546,138,0,0,1,1
2115419,2115545,126,0,0,1,2
2115546,2115621,75,1,0,0,2
2115547,2115631,84,1,0,0,1
2115622,2115811,189,0,0,1,2
2115632,2115810,178,0,0,1,1
2115811,2115835,24,1,0,0,1
2115812,2115838,26,1,0,0,2
2115836,2116396,560,0,0,1,1
2115839,2116395,556,0,0,1,2
2116396,2116416,20,1,0,0,2
2116397,2116413,16,1,0,0,1
2116414,2116638,224,0,0,1,1
2116417,2116638,221,0,0,1,2
2116639,2116699,60,1,0,0,1
2116639,2116703,64,1,0,0,2
2116700,2116897,197,0,0,1,1
2116704,2116898,194,0,0,1,2
2116898,2116925,27,1,0,0,1
2116899,2116936,37,1,0,0,2
2116926,2117530,604,0,0,1,1
2116937,2117530,593,0,0,1,2
2117531,2117552,21,1,0,0,1
2117531,2117552,21,1,0,0,2
2117553,2119127,1574,0,0,1,1
2117553,2119128,1575,0,0,1,2
2119128,2119164,36,1,0,0,1
2119129,2119154,25,1,0,0,2
2119155,2119878,723,0,0,1,2
2119165,2119878,713,0,0,1,1
2119879,2119922,43,1,0,0,1
2119879,2119925,46,1,0,0,2
2119923,2120130,207,0,0,1,1
2119926,2120126,200,0,0,1,2
2120127,2120168,41,1,0,0,2
2120131,2120158,27,1,0,0,1
2120159,2120695,536,0,0,1,1
2120169,2120694,525,0,0,1,2
2120695,2120727,32,1,0,0,2
2120696,2120727,31,1,0,0,1
2120728,2121173,445,0,0,1,1
2120728,2121174,446,0,0,1,2
2121174,2121200,26,1,0,0,1
2121175,2121210,35,1,0,0,2
2121201,2121449,248,0,0,1,1
2121211,2121448,237,0,0,1,2
2121449,2131746,10297,1,0,0,2
2121450,2131746,10296,1,0,0,1
2121485,2131735,10250,0,1,0,1
2121485,2131735,10250,0,1,0,2
2131747,2131872,125,0,0,1,2
2131747,2131873,126,0,0,1,1
2131873,2131941,68,1,0,0,2
2131874,2131934,60,1,0,0,1
2131935,2132177,242,0,0,1,1
2131942,2132181,239,0,0,1,2
2132178,2132786,608,1,0,0,1
2132182,2132793,611,1,0,0,2
2132225,2132775,550,0,1,0,1
2132230,2132744,514,0,1,0,2
2132787,2132965,178,0,0,1,1
2132794,2132964,170,0,0,1,2
2132965,2133020,55,1,0,0,2
2132966,2133019,53,1,0,0,1
2133020,2133363,343,0,0,1,1
2133021,2133365,344,0,0,1,2
2133364,2133400,36,1,0,0,1
2133366,2133407,41,1,0,0,2
2133401,2133625,224,0,0,1,1
2133408,2133625,217,0,0,1,2
2176694,2176930,236,0,0,1,1
2176694,2176932,238,0,0,1,2
2176931,2176954,23,1,0,0,1
2176933,2176954,21,1,0,0,2
2176955,2177859,904,0,0,1,1
2176955,2177859,904,0,0,1,2
2177860,2177881,21,1,0,0,1
2177860,2177886,26,1,0,0,2
2177882,2178226,344,0,0,1,1
2177887,2178220,333,0,0,1,2
2178221,2178374,153,1,0,0,2
2178227,2178355,128,1,0,0,1
2178264,2178284,20,0,1,0,2
2178273,2178278,5,0,1,0,1
2178356,2178629,273,0,0,1,1
2178375,2178628,253,0,0,1,2
2178629,2178840,211,1,0,0,2
2178630,2178784,154,1,0,0,1
2178659,2178760,101,0,1,0,1
2178662,2178746,84,0,1,0,2
2178785,2178828,43,0,0,1,1
2178829,2178845,16,1,0,0,1
2178841,2178962,121,0,0,1,2
2178846,2178962,116,0,0,1,1
2178963,2178983,20,1,0,0,2
2178963,2178986,23,1,0,0,1
2178984,2179407,423,0,0,1,2
2178987,2179406,419,0,0,1,1
2179407,2179421,14,1,0,0,1
2179408,2179420,12,1,0,0,2
2179421,2181685,2264,0,0,1,2
2179422,2181683,2261,0,0,1,1
2181684,2181745,61,1,0,0,1
2181686,2181765,79,1,0,0,2
2181746,2181925,179,0,0,1,1
2181766,2181924,158,0,0,1,2
2181925,2181954,29,1,0,0,2
2181926,2181954,28,1,0,0,1
2181955,2182389,434,0,0,1,2
2181955,2183716,1761,0,0,1,1
2182390,2182397,7,1,0,0,2
2182398,2183715,1317,0,0,1,2
2183716,2183764,48,1,0,0,2
2183717,2183767,50,1,0,0,1
2183765,2183938,173,0,0,1,2
2183768,2183944,176,0,0,1,1
2183939,2183962,23,1,0,0,2
2183945,2183958,13,1,0,0,1
2183959,2185532,1573,0,0,1,1
2183963,2185533,1570,0,0,1,2
2185533,2185684,151,1,0,0,1
2185534,2185813,279,1,0,0,2
2185685,2185763,78,0,0,1,1
2185764,2185799,35,1,0,0,1
2185800,2186700,900,0,0,1,1
2185814,2186701,887,0,0,1,2
2186701,2186747,46,1,0,0,1
2186702,2186750,48,1,0,0,2
2186748,2187072,324,0,0,1,1
2186751,2187075,324,0,0,1,2
2187073,2187117,44,1,0,0,1
2187076,2187276,200,1,0,0,2
2187118,2187375,257,0,0,1,1
2187277,2187328,51,0,0,1,2
2187329,2187348,19,1,0,0,2
2187349,2187375,26,0,0,1,2
2187376,2187478,102,1,0,0,1
2187376,2187482,106,1,0,0,2
2187479,2187653,174,0,0,1,1
2187483,2187654,171,0,0,1,2
2187654,2187685,31,1,0,0,1
2187655,2187687,32,1,0,0,2
2187686,2187894,208,0,0,1,1
2187688,2187899,211,0,0,1,2
2187895,2187919,24,1,0,0,1
2187900,2187916,16,1,0,0,2
2187917,2188177,260,0,0,1,2
2187920,2188785,865,0,0,1,1
2188178,2188201,23,1,0,0,2
2188202,2188222,20,0,0,1,2
2188223,2188236,13,1,0,0,2
2188237,2188567,330,0,0,1,2
2188568,2188598,30,1,0,0,2
2188599,2188787,188,0,0,1,2
2188786,2188839,53,1,0,0,1
2188788,2188874,86,1,0,0,2
2188840,2189145,305,0,0,1,1
2188875,2188899,24,0,0,1,2
2188900,2188952,52,1,0,0,2
2188953,2189148,195,0,0,1,2
2189146,2189286,140,1,0,0,1
2189149,2189456,307,1,0,0,2
2189287,2189400,113,0,0,1,1
2189401,2189424,23,1,0,0,1
2189425,2190479,1054,0,0,1,1
2189457,2190481,1024,0,0,1,2
2190480,2190557,77,1,0,0,1
2190482,2190556,74,1,0,0,2
2190557,2190911,354,0,0,1,2
2190558,2190912,354,0,0,1,1
2190912,2190994,82,1,0,0,2
2190913,2190993,80,1,0,0,1
2190994,2191150,156,0,0,1,1
2190995,2191151,156,0,0,1,2
2191151,2191184,33,1,0,0,1
2191152,2191184,32,1,0,0,2
2191185,2191418,233,0,0,1,2
2191185,2191420,235,0,0,1,1
2191419,2191436,17,1,0,0,2
2191421,2191438,17,1,0,0,1
2191437,2192353,916,0,0,1,2
2191439,2192355,916,0,0,1,1
2192354,2192420,66,1,0,0,2
2192356,2192418,62,1,0,0,1
2192419,2192715,296,0,0,1,1
2192421,2192717,296,0,0,1,2
2192716,2192811,95,1,0,0,1
2192718,2192810,92,1,0,0,2
2192811,2193053,242,0,0,1,2
2192812,2193050,238,0,0,1,1
2193051,2193074,23,1,0,0,1
2193054,2193080,26,1,0,0,2
2193075,2193404,329,0,0,1,1
2193081,2193404,323,0,0,1,2
2193405,2193425,20,1,0,0,1
2193405,2193431,26,1,0,0,2
2193426,2193936,510,0,0,1,1
2193432,2193934,502,0,0,1,2
2193935,2194017,82,1,0,0,2
2193937,2194001,64,1,0,0,1
2194002,2194379,377,0,0,1,1
2194018,2194377,359,0,0,1,2
2194378,2194494,116,1,0,0,2
2194380,2194494,114,1,0,0,1
2194495,2194600,105,0,0,1,2
2194495,2194601,106,0,0,1,1
2194601,2194625,24,1,0,0,2
2194602,2194624,22,1,0,0,1
2194625,2194878,253,0,0,1,1
2194626,2194871,245,0,0,1,2
2194872,2194888,16,1,0,0,2
2194879,2194888,9,1,0,0,1
2194889,2195444,555,0,0,1,2
2194889,2195446,557,0,0,1,1
2195445,2195506,61,1,0,0,2
2195447,2195508,61,1,0,0,1
2195507,2195786,279,0,0,1,2
2195509,2195785,276,0,0,1,1
2195786,2195842,56,1,0,0,1
2195787,2196402,615,1,0,0,2
2195843,2196227,384,0,0,1,1
2196228,2196335,107,1,0,0,1
2196336,2196499,163,0,0,1,1
2196403,2196499,96,0,0,1,2
2196500,2196527,27,1,0,0,1
2196500,2196534,34,1,0,0,2
2196528,2196821,293,0,0,1,1
2196535,2196823,288,0,0,1,2
2196822,2196840,18,1,0,0,1
2196824,2196838,14,1,0,0,2
2196839,2197540,701,0,0,1,2
2196841,2197537,696,0,0,1,1
2197538,2197613,75,1,0,0,1
2197541,2197623,82,1,0,0,2
2197614,2198007,393,0,0,1,1
2197624,2198009,385,0,0,1,2
2198008,2198064,56,1,0,0,1
2198010,2198074,64,1,0,0,2
2198065,2198169,104,0,0,1,1
2198075,2198169,94,0,0,1,2
2198170,2198200,30,1,0,0,1
2198170,2198213,43,1,0,0,2
2198201,2198416,215,0,0,1,1
2198214,2198415,201,0,0,1,2
2198416,2198445,29,1,0,0,2
2198417,2198443,26,1,0,0,1
2198444,2199058,614,0,0,1,1
2198446,2199055,609,0,0,1,2
2199056,2199124,68,1,0,0,2
2199059,2199133,74,1,0,0,1
2199125,2199787,662,0,0,1,2
2199134,2199786,652,0,0,1,1
2199787,2199859,72,1,0,0,1
2199788,2199873,85,1,0,0,2
2199860,2200067,207,0,0,1,1
2199874,2200067,193,0,0,1,2
2200068,2200097,29,1,0,0,1
2200068,2200097,29,1,0,0,2
2200098,2200777,679,0,0,1,2
2200098,2200778,680,0,0,1,1
2200778,2200818,40,1,0,0,2
2200779,2200821,42,1,0,0,1
2200819,2201443,624,0,0,1,2
2200822,2201443,621,0,0,1,1
2201444,2201558,114,1,0,0,2
2201444,2201559,115,1,0,0,1
2201559,2201727,168,0,0,1,2
2201560,2201730,170,0,0,1,1
2201728,2201758,30,1,0,0,2
2201731,2201750,19,1,0,0,1
2201751,2202470,719,0,0,1,1
2201759,2202471,712,0,0,1,2
2202471,2202531,60,1,0,0,1
2202472,2202532,60,1,0,0,2
2202532,2202788,256,0,0,1,1
2202533,2202787,254,0,0,1,2
2202788,2202843,55,1,0,0,2
2202789,2202837,48,1,0,0,1
2202838,2203100,262,0,0,1,1
2202844,2203102,258,0,0,1,2
2203101,2203133,32,1,0,0,1
2203103,2203146,43,1,0,0,2
2203134,2203456,322,0,0,1,1
2203147,2203458,311,0,0,1,2
2203457,2203470,13,1,0,0,1
2203459,2203470,11,1,0,0,2
2203471,2204106,635,0,0,1,2
2203471,2204109,638,0,0,1,1
2204107,2204143,36,1,0,0,2
2204110,2204144,34,1,0,0,1
2204144,2204496,352,0,0,1,2
2204145,2204497,352,0,0,1,1
2204497,2204566,69,1,0,0,2
2204498,2204567,69,1,0,0,1
2204567,2204671,104,0,0,1,2
2204568,2204671,103,0,0,1,1
2204672,2204695,23,1,0,0,1
2204672,2204706,34,1,0,0,2
2204696,2205633,937,0,0,1,1
2204707,2205633,926,0,0,1,2
2205634,2205687,53,1,0,0,1
2205634,2205706,72,1,0,0,2
2205688,2205970,282,0,0,1,1
2205707,2205971,264,0,0,1,2
2205971,2206050,79,1,0,0,1
2205972,2206064,92,1,0,0,2
2206051,2206196,145,0,0,1,1
2206065,2206196,131,0,0,1,2
2206197,2206226,29,1,0,0,2
2206197,2206229,32,1,0,0,1
2206227,2206496,269,0,0,1,2
2206230,2206495,265,0,0,1,1
2206496,2206524,28,1,0,0,1
2206497,2206526,29,1,0,0,2
2206525,2206940,415,0,0,1,1
2206527,2206942,415,0,0,1,2
2206941,2207019,78,1,0,0,1
2206943,2207006,63,1,0,0,2
2207007,2207608,601,0,0,1,2
2207020,2207610,590,0,0,1,1
2207609,2207701,92,1,0,0,2
2207611,2207690,79,1,0,0,1
2207691,2207953,262,0,0,1,1
2207702,2207953,251,0,0,1,2
2207954,2207970,16,1,0,0,1
2207954,2207977,23,1,0,0,2
2207971,2208624,653,0,0,1,1
2207978,2208619,641,0,0,1,2
2208620,2208683,63,1,0,0,2
2208625,2208695,70,1,0,0,1
2208684,2209356,672,0,0,1,2
2208696,2209354,658,0,0,1,1
2209355,2209407,52,1,0,0,1
2209357,2209406,49,1,0,0,2
2209407,2210568,1161,0,0,1,2
2209408,2209737,329,0,0,1,1
2209738,2209748,10,1,0,0,1
2209749,2210569,820,0,0,1,1
2210569,2210604,35,1,0,0,2
2210570,2210601,31,1,0,0,1
2210602,2211081,479,0,0,1,1
2210605,2211078,473,0,0,1,2
2211079,2211211,132,1,0,0,2
2211082,2211203,121,1,0,0,1
2211204,2211395,191,0,0,1,1
2211212,2211352,140,0,0,1,2
2211353,2211357,4,1,0,0,2
2211358,2211398,40,0,0,1,2
2211396,2211418,22,1,0,0,1
2211399,2211501,102,1,0,0,2
2211419,2212318,899,0,0,1,1
2211502,2211599,97,0,0,1,2
2211600,2211614,14,1,0,0,2
2211615,2211732,117,0,0,1,2
2211733,2211737,4,1,0,0,2
2211738,2212321,583,0,0,1,2
2212319,2212407,88,1,0,0,1
2212322,2212416,94,1,0,0,2
2212408,2212728,320,0,0,1,1
2212417,2212729,312,0,0,1,2
2212729,2212786,57,1,0,0,1
2212730,2212794,64,1,0,0,2
2212787,2212982,195,0,0,1,1
2212795,2212985,190,0,0,1,2
2212983,2212999,16,1,0,0,1
2212986,2213010,24,1,0,0,2
2213000,2213826,826,0,0,1,1
2213011,2213081,70,0,0,1,2
2213082,2213352,270,1,0,0,2
2213353,2213438,85,0,0,1,2
2213439,2213485,46,1,0,0,2
2213486,2213682,196,0,0,1,2
2213683,2213704,21,1,0,0,2
2213705,2213825,120,0,0,1,2
2213826,2213897,71,1,0,0,2
2213827,2213880,53,1,0,0,1
2213881,2214209,328,0,0,1,1
2213898,2214205,307,0,0,1,2
2214206,2214292,86,1,0,0,2
2214210,2214294,84,1,0,0,1
2214293,2214385,92,0,0,1,2
2214295,2214383,88,0,0,1,1
2214384,2214442,58,1,0,0,1
2214386,2214430,44,1,0,0,2
2214431,2214691,260,0,0,1,2
2214443,2214691,248,0,0,1,1
2214692,2214718,26,1,0,0,2
2214692,2214719,27,1,0,0,1
2214719,2214784,65,0,0,1,2
2214720,2215249,529,0,0,1,1
2214785,2215337,552,1,0,0,2
2215250,2215324,74,1,0,0,1
2215325,2215755,430,0,0,1,1
2215338,2215754,416,0,0,1,2
2215755,2215832,77,1,0,0,2
2215756,2215830,74,1,0,0,1
2215831,2215924,93,0,0,1,1
2215833,2215925,92,0,0,1,2
2215925,2215957,32,1,0,0,1
2215926,2215956,30,1,0,0,2
2215957,2216296,339,0,0,1,2
2215958,2216289,331,0,0,1,1
2216290,2216306,16,1,0,0,1
2216297,2216304,7,1,0,0,2
2216305,2216610,305,0,0,1,2
2216307,2216607,300,0,0,1,1
2216608,2216670,62,1,0,0,1
2216611,2216692,81,1,0,0,2
2216671,2217151,480,0,0,1,1
2216693,2217150,457,0,0,1,2
2217151,2217226,75,1,0,0,2
2217152,2217235,83,1,0,0,1
2217227,2217452,225,0,0,1,2
2217236,2217453,217,0,0,1,1
2217453,2217480,27,1,0,0,2
2217454,2217480,26,1,0,0,1
2217481,2218138,657,0,0,1,1
2217481,2218138,657,0,0,1,2
2218139,2218196,57,1,0,0,1
2218139,2218198,59,1,0,0,2
2218197,2218657,460,0,0,1,1
2218199,2218657,458,0,0,1,2
2218658,2218732,74,1,0,0,1
2218658,2218739,81,1,0,0,2
2218733,2219754,1021,0,0,1,1
2218740,2219755,1015,0,0,1,2
2219755,2219852,97,1,0,0,1
2219756,2219856,100,1,0,0,2
2219853,2220182,329,0,0,1,1
2219857,2220184,327,0,0,1,2
2220183,2220233,50,1,0,0,1
2220185,2220240,55,1,0,0,2
2220234,2221057,823,0,0,1,1
2220241,2221056,815,0,0,1,2
2221057,2221104,47,1,0,0,2
2221058,2221101,43,1,0,0,1
2221102,2221624,522,0,0,1,1
2221105,2221624,519,0,0,1,2
2221625,2221711,86,1,0,0,1
2221625,2221724,99,1,0,0,2
2221712,2221950,238,0,0,1,1
2221725,2221952,227,0,0,1,2
2221951,2221978,27,1,0,0,1
2221953,2221976,23,1,0,0,2
2221977,2222577,600,0,0,1,2
2221979,2222579,600,0,0,1,1
2222578,2222644,66,1,0,0,2
2222580,2222645,65,1,0,0,1
2222645,2223303,658,0,0,1,2
2222646,2223302,656,0,0,1,1
2223303,2223384,81,1,0,0,1
2223304,2223393,89,1,0,0,2
2223385,2223494,109,0,0,1,1
2223394,2223494,100,0,0,1,2
2223495,2223527,32,1,0,0,1
2223495,2223537,42,1,0,0,2
2223528,2223783,255,0,0,1,1
2223538,2223784,246,0,0,1,2
2223784,2223802,18,1,0,0,1
2223785,2223809,24,1,0,0,2
2223803,2224553,750,0,0,1,1
2223810,2224556,746,0,0,1,2
2224554,2224634,80,1,0,0,1
2224557,2224623,66,1,0,0,2
2224624,2224997,373,0,0,1,2
2224635,2224996,361,0,0,1,1
2224997,2225087,90,1,0,0,1
2224998,2225075,77,1,0,0,2
2225076,2225240,164,0,0,1,2
2225088,2225242,154,0,0,1,1
2225241,2225264,23,1,0,0,2
2225243,2225264,21,1,0,0,1
2225265,2226067,802,0,0,1,2
2225265,2226070,805,0,0,1,1
2226068,2226142,74,1,0,0,2
2226071,2226110,39,1,0,0,1
2226111,2226439,328,0,0,1,1
2226143,2226441,298,0,0,1,2
2226440,2226513,73,1,0,0,1
2226442,2226526,84,1,0,0,2
2226514,2226655,141,0,0,1,1
2226527,2226590,63,0,0,1,2
2226591,2226603,12,1,0,0,2
2226604,2226655,51,0,0,1,2
2226656,2226674,18,1,0,0,1
2226656,2226686,30,1,0,0,2
2226675,2227728,1053,0,0,1,1
2226687,2227731,1044,0,0,1,2
2227729,2227814,85,1,0,0,1
2227732,2227829,97,1,0,0,2
2227815,2227919,104,0,0,1,1
2227830,2227920,90,0,0,1,2
2227920,2228006,86,1,0,0,1
2227921,2228006,85,1,0,0,2
2228007,2228166,159,0,0,1,1
2228007,2228166,159,0,0,1,2
2228167,2228200,33,1,0,0,1
2228167,2228206,39,1,0,0,2
2228201,2228553,352,0,0,1,1
2228207,2228553,346,0,0,1,2
2228554,2228569,15,1,0,0,2
2228554,2228570,16,1,0,0,1
2228570,2229349,779,0,0,1,2
2228571,2229350,779,0,0,1,1
2229350,2229404,54,1,0,0,2
2229351,2229395,44,1,0,0,1
2229396,2229603,207,0,0,1,1
2229405,2229605,200,0,0,1,2
2229604,2229681,77,1,0,0,1
2229606,2229680,74,1,0,0,2
2229681,2229773,92,0,0,1,2
2229682,2229775,93,0,0,1,1
2229774,2229808,34,1,0,0,2
2229776,2229811,35,1,0,0,1
2229809,2230918,1109,0,0,1,2
2229812,2230049,237,0,0,1,1
2230050,2230057,7,1,0,0,1
2230058,2230919,861,0,0,1,1
2230919,2230967,48,1,0,0,2
2230920,2230974,54,1,0,0,1
2230968,2231379,411,0,0,1,2
2230975,2231379,404,0,0,1,1
2231380,2231424,44,1,0,0,2
2231380,2231428,48,1,0,0,1
2231425,2232905,1480,0,0,1,2
2231429,2231699,270,0,0,1,1
2231700,2231712,12,1,0,0,1
2231713,2232903,1190,0,0,1,1
2232904,2232960,56,1,0,0,1
2232906,2232975,69,1,0,0,2
2232961,2233109,148,0,0,1,1
2232976,2233112,136,0,0,1,2
2233110,2233148,38,1,0,0,1
2233113,2233169,56,1,0,0,2
2233149,2233405,256,0,0,1,1
2233170,2233402,232,0,0,1,2
2233403,2233449,46,1,0,0,2
2233406,2233411,5,1,0,0,1
2233412,2234132,720,0,0,1,1
2233450,2233544,94,0,0,1,2
2233545,2233553,8,1,0,0,2
2233554,2233592,38,0,0,1,2
2233593,2233771,178,1,0,0,2
2233772,2233957,185,0,0,1,2
2233958,2233996,38,1,0,0,2
2233997,2234131,134,0,0,1,2
2234132,2234187,55,1,0,0,2
2234133,2234187,54,1,0,0,1
2234188,2234654,466,0,0,1,1
2234188,2234654,466,0,0,1,2
2234655,2234716,61,1,0,0,2
2234655,2234729,74,1,0,0,1
2234717,2234889,172,0,0,1,2
2234730,2234890,160,0,0,1,1
2234890,2234920,30,1,0,0,2
2234891,2234913,22,1,0,0,1
2234914,2235675,761,0,0,1,1
2234921,2235676,755,0,0,1,2
2235676,2235739,63,1,0,0,1
2235677,2235750,73,1,0,0,2
2235740,2236170,430,0,0,1,1
2235751,2236170,419,0,0,1,2
2236171,2236229,58,1,0,0,1
2236171,2236395,224,1,0,0,2
2236230,2236360,130,0,0,1,1
2236361,2236392,31,1,0,0,1
2236393,2237066,673,0,0,1,1
2236396,2237065,669,0,0,1,2
2237066,2237124,58,1,0,0,2
2237067,2237115,48,1,0,0,1
2237116,2237320,204,0,0,1,1
2237125,2237322,197,0,0,1,2
2237321,2237366,45,1,0,0,1
2237323,2237378,55,1,0,0,2
2237367,2237761,394,0,0,1,1
2237379,2237763,384,0,0,1,2
2237762,2237864,102,1,0,0,1
2237764,2237873,109,1,0,0,2
2237865,2238000,135,0,0,1,1
2237874,2237999,125,0,0,1,2
2238000,2238119,119,1,0,0,2
2238001,2238019,18,1,0,0,1
2238020,2238734,714,0,0,1,1
2238120,2238156,36,0,0,1,2
2238157,2238272,115,1,0,0,2
2238273,2238380,107,0,0,1,2
2238381,2238506,125,1,0,0,2
2238507,2238572,65,0,0,1,2
2238573,2238652,79,1,0,0,2
2238653,2238730,77,0,0,1,2
2238731,2238804,73,1,0,0,2
2238735,2238805,70,1,0,0,1
2238805,2239351,546,0,0,1,2
2238806,2239349,543,0,0,1,1
2239350,2239442,92,1,0,0,1
2239352,2239451,99,1,0,0,2
2239443,2239582,139,0,0,1,1
2239452,2239586,134,0,0,1,2
2239583,2239631,48,1,0,0,1
2239587,2239639,52,1,0,0,2
2239632,2239807,175,0,0,1,1
2239640,2239799,159,0,0,1,2
2239800,2239847,47,1,0,0,2
2239808,2239829,21,1,0,0,1
2239830,2240298,468,0,0,1,1
2239848,2240295,447,0,0,1,2
2240296,2240380,84,1,0,0,2
2240299,2240366,67,1,0,0,1
2240367,2240906,539,0,0,1,1
2240381,2240550,169,0,0,1,2
2240551,2240560,9,1,0,0,2
2240561,2240906,345,0,0,1,2
2240907,2240964,57,1,0,0,1
2240907,2240964,57,1,0,0,2
2240965,2241075,110,0,0,1,1
2240965,2241078,113,0,0,1,2
2241076,2241104,28,1,0,0,1
2241079,2241103,24,1,0,0,2
2241104,2241997,893,0,0,1,2
2241105,2241998,893,0,0,1,1
2241998,2242059,61,1,0,0,2
2241999,2242063,64,1,0,0,1
2242060,2242524,464,0,0,1,2
2242064,2242525,461,0,0,1,1
2242525,2242597,72,1,0,0,2
2242526,2242595,69,1,0,0,1
2242596,2242756,160,0,0,1,1
2242598,2242754,156,0,0,1,2
2242755,2242831,76,1,0,0,2
2242757,2242790,33,1,0,0,1
2242791,2243248,457,0,0,1,1
2242832,2242934,102,0,0,1,2
2242935,2243181,246,1,0,0,2
2243182,2243250,68,0,0,1,2
2243249,2243335,86,1,0,0,1
2243251,2243334,83,1,0,0,2
2243335,2243925,590,0,0,1,2
2243336,2243926,590,0,0,1,1
2243926,2244004,78,1,0,0,2
2243927,2244004,77,1,0,0,1
2244005,2244209,204,0,0,1,1
2244005,2244210,205,0,0,1,2
2244210,2244243,33,1,0,0,1
2244211,2244242,31,1,0,0,2
2244243,2244500,257,0,0,1,2
2244244,2244502,258,0,0,1,1
2244501,2244534,33,1,0,0,2
2244503,2244524,21,1,0,0,1
2244525,2244835,310,0,0,1,1
2244535,2244834,299,0,0,1,2
2244835,2244907,72,1,0,0,2
2244836,2244913,77,1,0,0,1
2244908,2245102,194,0,0,1,2
2244914,2245103,189,0,0,1,1
2245103,2245164,61,1,0,0,2
2245104,2245177,73,1,0,0,1
2245165,2245436,271,0,0,1,2
2245178,2245436,258,0,0,1,1
2245437,2245491,54,1,0,0,1
2245437,2245499,62,1,0,0,2
2245492,2246524,1032,0,0,1,1
2245500,2246525,1025,0,0,1,2
2246525,2246606,81,1,0,0,1
2246526,2246613,87,1,0,0,2
2246607,2246831,224,0,0,1,1
2246614,2246831,217,0,0,1,2
2246832,2246935,103,1,0,0,1
2246832,2246943,111,1,0,0,2
2246936,2247100,164,0,0,1,1
2246944,2247100,156,0,0,1,2
2247101,2247122,21,1,0,0,1
2247101,2247132,31,1,0,0,2
2247123,2247661,538,0,0,1,1
2247133,2247657,524,0,0,1,2
2247658,2247718,60,1,0,0,2
2247662,2247709,47,1,0,0,1
2247710,2247916,206,0,0,1,1
2247719,2247917,198,0,0,1,2
2247917,2247973,56,1,0,0,1
2247918,2247970,52,1,0,0,2
2247971,2248307,336,0,0,1,2
2247974,2248307,333,0,0,1,1
2248308,2248401,93,1,0,0,1
2248308,2248408,100,1,0,0,2
2248402,2248513,111,0,0,1,1
2248409,2248513,104,0,0,1,2
2248514,2248540,26,1,0,0,1
2248514,2248546,32,1,0,0,2
2248541,2249194,653,0,0,1,1
2248547,2248849,302,0,0,1,2
2248850,2248873,23,1,0,0,2
2248874,2249195,321,0,0,1,2
2249195,2249286,91,1,0,0,1
2249196,2249284,88,1,0,0,2
2249285,2249702,417,0,0,1,2
2249287,2249702,415,0,0,1,1
2249703,2249773,70,1,0,0,1
2249703,2249806,103,1,0,0,2
2249774,2249882,108,0,0,1,1
2249807,2249884,77,0,0,1,2
2249883,2249942,59,1,0,0,1
2249885,2249942,57,1,0,0,2
2249943,2250825,882,0,0,1,1
2249943,2250829,886,0,0,1,2
2250826,2250902,76,1,0,0,1
2250830,2250914,84,1,0,0,2
2250903,2251277,374,0,0,1,1
2250915,2251276,361,0,0,1,2
2251277,2251387,110,1,0,0,2
2251278,2251384,106,1,0,0,1
2251385,2251583,198,0,0,1,1
2251388,2251584,196,0,0,1,2
2251584,2251622,38,1,0,0,1
2251585,2251607,22,1,0,0,2
2251608,2252328,720,0,0,1,2
2251623,2252327,704,0,0,1,1
2252328,2252456,128,1,0,0,1
2252329,2252447,118,1,0,0,2
2252448,2252788,340,0,0,1,2
2252457,2252786,329,0,0,1,1
2252787,2252845,58,1,0,0,1
2252789,2252849,60,1,0,0,2
2252846,2253788,942,0,0,1,1
2252850,2253786,936,0,0,1,2
2253787,2253851,64,1,0,0,2
2253789,2253853,64,1,0,0,1
2253852,2254287,435,0,0,1,2
2253854,2254288,434,0,0,1,1
2254288,2254358,70,1,0,0,2
2254289,2254367,78,1,0,0,1
2254359,2254523,164,0,0,1,2
2254368,2254520,152,0,0,1,1
2254521,2254553,32,1,0,0,1
2254524,2254553,29,1,0,0,2
2254554,2255146,592,0,0,1,1
2254554,2255148,594,0,0,1,2
2255147,2255220,73,1,0,0,1
2255149,2255222,73,1,0,0,2
2255221,2255678,457,0,0,1,1
2255223,2255678,455,0,0,1,2
2255679,2255783,104,1,0,0,1
2255679,2255783,104,1,0,0,2
2255784,2255893,109,0,0,1,1
2255784,2255895,111,0,0,1,2
2255894,2255927,33,1,0,0,1
2255896,2255928,32,1,0,0,2
2255928,2256633,705,0,0,1,1
2255929,2256633,704,0,0,1,2
2256634,2256739,105,1,0,0,1
2256634,2256740,106,1,0,0,2
2256740,2257208,468,0,0,1,1
2256741,2257209,468,0,0,1,2
2257209,2257291,82,1,0,0,1
2257210,2257290,80,1,0,0,2
2257291,2257542,251,0,0,1,2
2257292,2257541,249,0,0,1,1
2257542,2257571,29,1,0,0,1
2257543,2257571,28,1,0,0,2
2257572,2258387,815,0,0,1,1
2257572,2258387,815,0,0,1,2
2258388,2258476,88,1,0,0,1
2258388,2258480,92,1,0,0,2
2258477,2259008,531,0,0,1,1
2258481,2259008,527,0,0,1,2
2259009,2259084,75,1,0,0,1
2259009,2259085,76,1,0,0,2
2259085,2259208,123,0,0,1,1
2259086,2259208,122,0,0,1,2
2259209,2259232,23,1,0,0,1
2259209,2259326,117,1,0,0,2
2259233,2259375,142,0,0,1,1
2259327,2259369,42,0,0,1,2
2259370,2260684,1314,1,0,0,2
2259376,2260701,1325,1,0,0,1
2259410,2260428,1018,0,1,0,2
2259413,2260690,1277,0,1,0,1
2260466,2260624,158,0,1,0,2
2260685,2260783,98,0,0,1,2
2260702,2260780,78,0,0,1,1
2260781,2260952,171,1,0,0,1
2260784,2260948,164,1,0,0,2
2260801,2260920,119,0,1,0,1
2260806,2260911,105,0,1,0,2
2260949,2261060,111,0,0,1,2
2260953,2261060,107,0,0,1,1
2261061,2261105,44,1,0,0,1
2261061,2261127,66,1,0,0,2
2261106,2261376,270,0,0,1,1
2261128,2261379,251,0,0,1,2
2261377,2261414,37,1,0,0,1
2261380,2261398,18,1,0,0,2
2261399,2262463,1064,0,0,1,2
2261415,2262462,1047,0,0,1,1
2262463,2262512,49,1,0,0,1
2262464,2262512,48,1,0,0,2
2262513,2264874,2361,0,0,1,1
2262513,2264875,2362,0,0,1,2
2264875,2264898,23,1,0,0,1
2264876,2264899,23,1,0,0,2
2264899,2265725,826,0,0,1,1
2264900,2265725,825,0,0,1,2
2265726,2265817,91,1,0,0,1
2265726,2265827,101,1,0,0,2
2265818,2265930,112,0,0,1,1
2265828,2265930,102,0,0,1,2
2265931,2265962,31,1,0,0,1
2265931,2265972,41,1,0,0,2
2265963,2266231,268,0,0,1,1
2265973,2266227,254,0,0,1,2
2266228,2266266,38,1,0,0,2
2266232,2266241,9,1,0,0,1
2266242,2267061,819,0,0,1,1
2266267,2267059,792,0,0,1,2
2267060,2267115,55,1,0,0,2
2267062,2267110,48,1,0,0,1
2267111,2267372,261,0,0,1,1
2267116,2267372,256,0,0,1,2
2267373,2267392,19,1,0,0,1
2267373,2267393,20,1,0,0,2
2267393,2268293,900,0,0,1,1
2267394,2268294,900,0,0,1,2
2268294,2268315,21,1,0,0,1
2268295,2268315,20,1,0,0,2
2268316,2269462,1146,0,0,1,1
2268316,2269463,1147,0,0,1,2
2269463,2269504,41,1,0,0,1
2269464,2269532,68,1,0,0,2
2269505,2270361,856,0,0,1,1
2269533,2270339,806,0,0,1,2
2270340,2270476,136,1,0,0,2
2270362,2270466,104,1,0,0,1
2270467,2270607,140,0,0,1,1
2270477,2270606,129,0,0,1,2
2270607,2270640,33,1,0,0,2
2270608,2270630,22,1,0,0,1
2270631,2270880,249,0,0,1,1
2270641,2270880,239,0,0,1,2
2270881,2270894,13,1,0,0,2
2270881,2270897,16,1,0,0,1
2270895,2272075,1180,0,0,1,2
2270898,2272077,1179,0,0,1,1
2272076,2272128,52,1,0,0,2
2272078,2272120,42,1,0,0,1
2272121,2274637,2516,0,0,1,1
2272129,2274636,2507,0,0,1,2
2274637,2274695,58,1,0,0,2
2274638,2274695,57,1,0,0,1
2274696,2275777,1081,0,0,1,2
2274696,2275778,1082,0,0,1,1
2275778,2275845,67,1,0,0,2
2275779,2275842,63,1,0,0,1
2275843,2276031,188,0,0,1,1
2275846,2276031,185,0,0,1,2
2276032,2276059,27,1,0,0,1
2276032,2276059,27,1,0,0,2
2276060,2276816,756,0,0,1,1
2276060,2276817,757,0,0,1,2
2276817,2276841,24,1,0,0,1
2276818,2276842,24,1,0,0,2
2276842,2277537,695,0,0,1,1
2276843,2277537,694,0,0,1,2
2277538,2277598,60,1,0,0,1
2277538,2277598,60,1,0,0,2
2277599,2277887,288,0,0,1,2
2277599,2277889,290,0,0,1,1
2277888,2277921,33,1,0,0,2
2277890,2277922,32,1,0,0,1
2277922,2280028,2106,0,0,1,2
2277923,2280029,2106,0,0,1,1
2280029,2280079,50,1,0,0,2
2280030,2280087,57,1,0,0,1
2280080,2280562,482,0,0,1,2
2280088,2280562,474,0,0,1,1
2280563,2280614,51,1,0,0,1
2280563,2280625,62,1,0,0,2
2280615,2281041,426,0,0,1,1
2280626,2281041,415,0,0,1,2
2281042,2281121,79,1,0,0,1
2281042,2281125,83,1,0,0,2
2281122,2281368,246,0,0,1,1
2281126,2281369,243,0,0,1,2
2281369,2281690,321,1,0,0,1
2281370,2281575,205,1,0,0,2
2281387,2281541,154,0,1,0,1
2281391,2281531,140,0,1,0,2
2281576,2281599,23,0,0,1,2
2281600,2281699,99,1,0,0,2
2281691,2281811,120,0,0,1,1
2281700,2281813,113,0,0,1,2
2281812,2281840,28,1,0,0,1
2281814,2281869,55,1,0,0,2
2281841,2282289,448,0,0,1,1
2281870,2282288,418,0,0,1,2
2282289,2282307,18,1,0,0,2
2282290,2282310,20,1,0,0,1
2282308,2282756,448,0,0,1,2
2282311,2282755,444,0,0,1,1
2282756,2282811,55,1,0,0,1
2282757,2282812,55,1,0,0,2
2282812,2283056,244,0,0,1,1
2282813,2283057,244,0,0,1,2
2283057,2283083,26,1,0,0,1
2283058,2283084,26,1,0,0,2
2283084,2283986,902,0,0,1,1
2283085,2283986,901,0,0,1,2
2283987,2283998,11,1,0,0,2
2283987,2283999,12,1,0,0,1
2283999,2285773,1774,0,0,1,2
2284000,2285775,1775,0,0,1,1
2285774,2285819,45,1,0,0,2
2285776,2285811,35,1,0,0,1
2285812,2286340,528,0,0,1,1
2285820,2286340,520,0,0,1,2
2286341,2286426,85,1,0,0,1
2286341,2286429,88,1,0,0,2
2286427,2286543,116,0,0,1,1
2286430,2286545,115,0,0,1,2
2286544,2286581,37,1,0,0,1
2286546,2286577,31,1,0,0,2
2286578,2287645,1067,0,0,1,2
2286582,2287257,675,0,0,1,1
2287258,2287265,7,1,0,0,1
2287266,2287646,380,0,0,1,1
2287646,2287686,40,1,0,0,2
2287647,2287688,41,1,0,0,1
2287687,2288129,442,0,0,1,2
2287689,2288129,440,0,0,1,1
2288130,2288146,16,1,0,0,1
2288130,2288190,60,1,0,0,2
2288147,2289778,1631,0,0,1,1
2288191,2289777,1586,0,0,1,2
2289778,2289824,46,1,0,0,2
2289779,2289823,44,1,0,0,1
2289824,2290240,416,0,0,1,1
2289825,2290240,415,0,0,1,2
2290241,2290280,39,1,0,0,2
2290241,2290282,41,1,0,0,1
2290281,2290621,340,0,0,1,2
2290283,2290621,338,0,0,1,1
2290622,2290678,56,1,0,0,1
2290622,2290690,68,1,0,0,2
2290679,2290935,256,0,0,1,1
2290691,2290935,244,0,0,1,2
2290936,2290982,46,1,0,0,1
2290936,2290992,56,1,0,0,2
2290983,2291192,209,0,0,1,1
2290993,2291194,201,0,0,1,2
2291193,2291255,62,1,0,0,1
2291195,2291271,76,1,0,0,2
2291256,2291428,172,0,0,1,1
2291272,2291429,157,0,0,1,2
2291429,2291459,30,1,0,0,1
2291430,2291461,31,1,0,0,2
2291460,2292452,992,0,0,1,1
2291462,2292453,991,0,0,1,2
2292453,2292503,50,1,0,0,1
2292454,2292507,53,1,0,0,2
2292504,2292896,392,0,0,1,1
2292508,2292897,389,0,0,1,2
2292897,2292930,33,1,0,0,1
2292898,2292935,37,1,0,0,2
2292931,2294544,1613,0,0,1,1
2292936,2294543,1607,0,0,1,2
2294544,2294599,55,1,0,0,2
2294545,2294600,55,1,0,0,1
2294600,2294930,330,0,0,1,2
2294601,2294930,329,0,0,1,1
2294931,2295000,69,1,0,0,1
2294931,2295011,80,1,0,0,2
2295001,2295654,653,0,0,1,1
2295012,2295654,642,0,0,1,2
2295655,2295707,52,1,0,0,2
2295655,2295708,53,1,0,0,1
2295708,2295954,246,0,0,1,2
2295709,2295955,246,0,0,1,1
2295955,2296011,56,1,0,0,2
2295956,2296015,59,1,0,0,1
2296012,2296137,125,0,0,1,2
2296016,2296137,121,0,0,1,1
2296138,2296165,27,1,0,0,1
2296138,2296177,39,1,0,0,2
2296166,2297693,1527,0,0,1,1
2296178,2297695,1517,0,0,1,2
2297694,2297741,47,1,0,0,1
2297696,2297745,49,1,0,0,2
2297742,2299936,2194,0,0,1,1
2297746,2299937,2191,0,0,1,2
2299937,2299978,41,1,0,0,1
2299938,2299974,36,1,0,0,2
2299975,2300600,625,0,0,1,2
2299979,2300600,621,0,0,1,1
2300601,2300645,44,1,0,0,2
2300601,2300647,46,1,0,0,1
2300646,2301028,382,0,0,1,2
2300648,2301027,379,0,0,1,1
2301028,2301058,30,1,0,0,1
2301029,2301066,37,1,0,0,2
2301059,2301399,340,0,0,1,1
2301067,2301398,331,0,0,1,2
2301399,2301441,42,1,0,0,2
2301400,2301436,36,1,0,0,1
2301437,2301749,312,0,0,1,1
2301442,2301749,307,0,0,1,2
2301750,2301828,78,1,0,0,1
2301750,2301853,103,1,0,0,2
2301829,2301956,127,0,0,1,1
2301854,2301930,76,0,0,1,2
2301931,2302052,121,1,0,0,2
2301957,2301986,29,1,0,0,1
2301987,2302676,689,0,0,1,1
2302053,2302128,75,0,0,1,2
2302129,2302177,48,1,0,0,2
2302178,2302331,153,0,0,1,2
2302332,2302336,4,1,0,0,2
2302337,2302676,339,0,0,1,2
2302677,2302693,16,1,0,0,1
2302677,2302694,17,1,0,0,2
2302694,2302947,253,0,0,1,1
2302695,2302947,252,0,0,1,2
2302948,2302990,42,1,0,0,1
2302948,2303008,60,1,0,0,2
2302991,2304423,1432,0,0,1,1
2303009,2304424,1415,0,0,1,2
2304424,2304447,23,1,0,0,1
2304425,2304456,31,1,0,0,2
2304448,2305060,612,0,0,1,1
2304457,2305059,602,0,0,1,2
2305060,2305108,48,1,0,0,2
2305061,2305106,45,1,0,0,1
2305107,2305431,324,0,0,1,1
2305109,2305429,320,0,0,1,2
2305430,2305491,61,1,0,0,2
2305432,2305492,60,1,0,0,1
2305492,2305951,459,0,0,1,2
2305493,2305952,459,0,0,1,1
2305952,2306030,78,1,0,0,2
2305953,2306020,67,1,0,0,1
2306021,2306176,155,0,0,1,1
2306031,2306174,143,0,0,1,2
2306175,2306327,152,1,0,0,2
2306177,2306218,41,1,0,0,1
2306219,2306245,26,0,0,1,1
2306246,2306325,79,1,0,0,1
2306326,2306547,221,0,0,1,1
2306328,2306546,218,0,0,1,2
2306547,2306574,27,1,0,0,2
2306548,2306576,28,1,0,0,1
2306575,2307350,775,0,0,1,2
2306577,2307357,780,0,0,1,1
2307351,2307369,18,1,0,0,2
2307358,2307368,10,1,0,0,1
2307369,2307989,620,0,0,1,1
2307370,2307988,618,0,0,1,2
2307989,2308063,74,1,0,0,2
2307990,2308051,61,1,0,0,1
2308052,2308525,473,0,0,1,1
2308064,2308525,461,0,0,1,2
2308526,2308548,22,1,0,0,2
2308526,2308555,29,1,0,0,1
2308549,2308839,290,0,0,1,2
2308556,2310317,1761,0,0,1,1
2308840,2308915,75,1,0,0,2
2308916,2308955,39,0,0,1,2
2308956,2308971,15,1,0,0,2
2308972,2309083,111,0,0,1,2
2309084,2309088,4,1,0,0,2
2309089,2309874,785,0,0,1,2
2309875,2309947,72,1,0,0,2
2309948,2310317,369,0,0,1,2
2310318,2310359,41,1,0,0,1
2310318,2310360,42,1,0,0,2
2310360,2310529,169,0,0,1,1
2310361,2310529,168,0,0,1,2
2310530,2310584,54,1,0,0,1
2310530,2310607,77,1,0,0,2
2310585,2311528,943,0,0,1,1
2310608,2311529,921,0,0,1,2
2311529,2311570,41,1,0,0,1
2311530,2311577,47,1,0,0,2
2311571,2311889,318,0,0,1,1
2311578,2311886,308,0,0,1,2
2311887,2311960,73,1,0,0,2
2311890,2311943,53,1,0,0,1
2311944,2312059,115,0,0,1,1
2311961,2312059,98,0,0,1,2
2312060,2312093,33,1,0,0,1
2312060,2312093,33,1,0,0,2
2312094,2312426,332,0,0,1,2
2312094,2312438,344,0,0,1,1
2312427,2312811,384,1,0,0,2
2312439,2312786,347,1,0,0,1
2312470,2312541,71,0,1,0,1
2312476,2312525,49,0,1,0,2
2312602,2312737,135,0,1,0,1
2312608,2312727,119,0,1,0,2
2312787,2313800,1013,0,0,1,1
2312812,2313800,988,0,0,1,2
2313801,2313844,43,1,0,0,1
2313801,2313846,45,1,0,0,2
2313845,2316327,2482,0,0,1,1
2313847,2316326,2479,0,0,1,2
2316327,2316372,45,1,0,0,2
2316328,2316372,44,1,0,0,1
2316373,2316825,452,0,0,1,1
2316373,2316825,452,0,0,1,2
2316826,2316852,26,1,0,0,1
2316826,2316853,27,1,0,0,2
2316853,2317601,748,0,0,1,1
2316854,2317601,747,0,0,1,2
2317602,2317638,36,1,0,0,1
2317602,2317638,36,1,0,0,2
2317639,2318166,527,0,0,1,1
2317639,2318170,531,0,0,1,2
2318167,2318183,16,1,0,0,1
2318171,2318184,13,1,0,0,2
2318184,2318457,273,0,0,1,1
2318185,2318456,271,0,0,1,2
2318457,2318474,17,1,0,0,2
2318458,2318475,17,1,0,0,1
2318475,2319235,760,0,0,1,2
2318476,2319234,758,0,0,1,1
2319235,2319296,61,1,0,0,1
2319236,2319299,63,1,0,0,2
2319297,2321397,2100,0,0,1,1
2319300,2321397,2097,0,0,1,2
2321398,2321456,58,1,0,0,1
2321398,2321458,60,1,0,0,2
2321457,2321768,311,0,0,1,1
2321459,2321768,309,0,0,1,2
2321769,2321812,43,1,0,0,1
2321769,2321819,50,1,0,0,2
2321813,2322223,410,0,0,1,1
2321820,2322225,405,0,0,1,2
2322224,2322257,33,1,0,0,1
2322226,2322258,32,1,0,0,2
2322258,2323150,892,0,0,1,1
2322259,2323151,892,0,0,1,2
2323151,2323178,27,1,0,0,1
2323152,2323178,26,1,0,0,2
2323179,2323442,263,0,0,1,1
2323179,2323443,264,0,0,1,2
2323443,2323470,27,1,0,0,1
2323444,2323471,27,1,0,0,2
2323471,2324106,635,0,0,1,1
2323472,2324108,636,0,0,1,2
2324107,2324147,40,1,0,0,1
2324109,2324148,39,1,0,0,2
2324148,2324413,265,0,0,1,1
2324149,2324412,263,0,0,1,2
2324413,2324440,27,1,0,0,2
2324414,2324434,20,1,0,0,1
2324435,2326160,1725,0,0,1,1
2324441,2326159,1718,0,0,1,2
2326160,2326216,56,1,0,0,2
2326161,2326211,50,1,0,0,1
2326212,2326638,426,0,0,1,1
2326217,2326638,421,0,0,1,2
2326639,2326668,29,1,0,0,2
2326639,2326670,31,1,0,0,1
2326669,2327355,686,0,0,1,2
2326671,2327355,684,0,0,1,1
2327356,2327430,74,1,0,0,2
2327356,2327441,85,1,0,0,1
2327431,2327484,53,0,0,1,2
2327442,2327545,103,0,0,1,1
2327485,2327492,7,1,0,0,2
2327493,2327547,54,0,0,1,2
2327546,2327576,30,1,0,0,1
2327548,2327589,41,1,0,0,2
2327577,2328347,770,0,0,1,1
2327590,2328347,757,0,0,1,2
2328348,2328368,20,1,0,0,1
2328348,2328370,22,1,0,0,2
2328369,2328518,149,0,0,1,1
2328371,2328519,148,0,0,1,2
2328519,2328570,51,1,0,0,1
2328520,2328567,47,1,0,0,2
2328568,2328855,287,0,0,1,2
2328571,2328854,283,0,0,1,1
2328855,2328879,24,1,0,0,1
2328856,2328879,23,1,0,0,2
2328880,2330619,1739,0,0,1,1
2328880,2330620,1740,0,0,1,2
2330620,2330678,58,1,0,0,1
2330621,2330676,55,1,0,0,2
2330677,2331039,362,0,0,1,2
2330679,2331039,360,0,0,1,1
2331040,2331092,52,1,0,0,1
2331040,2331094,54,1,0,0,2
2331093,2331784,691,0,0,1,1
2331095,2331784,689,0,0,1,2
2331785,2331857,72,1,0,0,2
2331785,2331859,74,1,0,0,1
2331858,2331964,106,0,0,1,2
2331860,2331965,105,0,0,1,1
2331965,2332014,49,1,0,0,2
2331966,2332014,48,1,0,0,1
2332015,2332315,300,0,0,1,1
2332015,2332319,304,0,0,1,2
2332316,2332337,21,1,0,0,1
2332320,2332336,16,1,0,0,2
2332337,2332591,254,0,0,1,2
2332338,2333386,1048,0,0,1,1
2332592,2332599,7,1,0,0,2
2332600,2333380,780,0,0,1,2
2333381,2333448,67,1,0,0,2
2333387,2333448,61,1,0,0,1
2333449,2333615,166,0,0,1,1
2333449,2333615,166,0,0,1,2
2333616,2333635,19,1,0,0,1
2333616,2333636,20,1,0,0,2
2333636,2334071,435,0,0,1,1
2333637,2334072,435,0,0,1,2
2334072,2334094,22,1,0,0,1
2334073,2334089,16,1,0,0,2
2334090,2335213,1123,0,0,1,2
2334095,2335214,1119,0,0,1,1
2335214,2335247,33,1,0,0,2
2335215,2335248,33,1,0,0,1
2335248,2335895,647,0,0,1,2
2335249,2335894,645,0,0,1,1
2335895,2335940,45,1,0,0,1
2335896,2335952,56,1,0,0,2
2335941,2336234,293,0,0,1,1
2335953,2336235,282,0,0,1,2
2336235,2336291,56,1,0,0,1
2336236,2336293,57,1,0,0,2
2336292,2337037,745,0,0,1,1
2336294,2337035,741,0,0,1,2
2337036,2337081,45,1,0,0,2
2337038,2337080,42,1,0,0,1
2337081,2337201,120,0,0,1,1
2337082,2337201,119,0,0,1,2
2337202,2337263,61,1,0,0,2
2337202,2337265,63,1,0,0,1
2337264,2337443,179,0,0,1,2
2337266,2337442,176,0,0,1,1
2337443,2337469,26,1,0,0,1
2337444,2337469,25,1,0,0,2
2337470,2338357,887,0,0,1,2
2337470,2338358,888,0,0,1,1
2338358,2338411,53,1,0,0,2
2338359,2338407,48,1,0,0,1
2338408,2338784,376,0,0,1,1
2338412,2338784,372,0,0,1,2
2338785,2338844,59,1,0,0,2
2338785,2338850,65,1,0,0,1
2338845,2339069,224,0,0,1,2
2338851,2339076,225,0,0,1,1
2339070,2339217,147,1,0,0,2
2339077,2339548,471,1,0,0,1
2339091,2339226,135,0,1,0,1
2339098,2339203,105,0,1,0,2
2339218,2339254,36,0,0,1,2
2339255,2339496,241,1,0,0,2
2339264,2339516,252,0,1,0,1
2339283,2339483,200,0,1,0,2
2339497,2340642,1145,0,0,1,2
2339549,2340632,1083,0,0,1,1
2340633,2340753,120,1,0,0,1
2340643,2340758,115,1,0,0,2
2340654,2340717,63,0,1,0,1
2340664,2340694,30,0,1,0,2
2340754,2341118,364,0,0,1,1
2340759,2340810,51,0,0,1,2
2340811,2340828,17,1,0,0,2
2340829,2341117,288,0,0,1,2
2341118,2341173,55,1,0,0,2
2341119,2341163,44,1,0,0,1
2341164,2341755,591,0,0,1,1
2341174,2341755,581,0,0,1,2
2341756,2341789,33,1,0,0,1
2341756,2341796,40,1,0,0,2
2341790,2342524,734,0,0,1,1
2341797,2342525,728,0,0,1,2
2342525,2342608,83,1,0,0,1
2342526,2342610,84,1,0,0,2
2342609,2342712,103,0,0,1,1
2342611,2342713,102,0,0,1,2
2342713,2342754,41,1,0,0,1
2342714,2342786,72,1,0,0,2
2342755,2343088,333,0,0,1,1
2342787,2342965,178,0,0,1,2
2342966,2343118,152,1,0,0,2
2343089,2343119,30,1,0,0,1
2343119,2343192,73,0,0,1,2
2343120,2343483,363,0,0,1,1
2343193,2343229,36,1,0,0,2
2343230,2343463,233,0,0,1,2
2343464,2343853,389,1,0,0,2
2343484,2343512,28,1,0,0,1
2343513,2343803,290,0,0,1,1
2343804,2343848,44,1,0,0,1
2343849,2344661,812,0,0,1,1
2343854,2343955,101,0,0,1,2
2343956,2344068,112,1,0,0,2
2344069,2344483,414,0,0,1,2
2344484,2345153,669,1,0,0,2
2344662,2344686,24,1,0,0,1
2344687,2345018,331,0,0,1,1
2345019,2345053,34,1,0,0,1
2345054,2346083,1029,0,0,1,1
2345154,2346082,928,0,0,1,2
2346083,2346120,37,1,0,0,2
2346084,2346117,33,1,0,0,1
2346118,2346552,434,0,0,1,1
2346121,2346552,431,0,0,1,2
2346553,2346595,42,1,0,0,1
2346553,2346606,53,1,0,0,2
2346596,2347033,437,0,0,1,1
2346607,2347036,429,0,0,1,2
2347034,2347070,36,1,0,0,1
2347037,2347080,43,1,0,0,2
2347071,2347300,229,0,0,1,1
2347081,2347299,218,0,0,1,2
2347300,2347347,47,1,0,0,2
2347301,2347348,47,1,0,0,1
2347348,2347548,200,0,0,1,2
2347349,2347549,200,0,0,1,1
2347549,2347566,17,1,0,0,2
2347550,2347567,17,1,0,0,1
2347567,2349407,1840,0,0,1,2
2347568,2349406,1838,0,0,1,1
2349407,2349433,26,1,0,0,1
2349408,2349428,20,1,0,0,2
2349429,2350398,969,0,0,1,2
2349434,2350398,964,0,0,1,1
2350399,2350438,39,1,0,0,1
2350399,2350441,42,1,0,0,2
2350439,2350904,465,0,0,1,1
2350442,2350905,463,0,0,1,2
2350905,2350926,21,1,0,0,1
2350906,2350924,18,1,0,0,2
2350925,2351713,788,0,0,1,2
2350927,2351713,786,0,0,1,1
2351714,2351740,26,1,0,0,1
2351714,2351749,35,1,0,0,2
2351741,2352120,379,0,0,1,1
2351750,2352120,370,0,0,1,2
2352121,2352146,25,1,0,0,2
2352121,2352155,34,1,0,0,1
2352147,2352774,627,0,0,1,2
2352156,2352775,619,0,0,1,1
2352775,2352826,51,1,0,0,2
2352776,2352831,55,1,0,0,1
2352827,2353238,411,0,0,1,2
2352832,2353241,409,0,0,1,1
2353239,2353296,57,1,0,0,2
2353242,2353294,52,1,0,0,1
2353295,2353627,332,0,0,1,1
2353297,2353628,331,0,0,1,2
2353628,2353675,47,1,0,0,1
2353629,2353672,43,1,0,0,2
2353673,2353899,226,0,0,1,2
2353676,2353898,222,0,0,1,1
2353899,2353984,85,1,0,0,1
2353900,2353984,84,1,0,0,2
2353985,2354273,288,0,0,1,1
2353985,2354273,288,0,0,1,2
2354274,2354289,15,1,0,0,1
2354274,2354291,17,1,0,0,2
2354290,2355385,1095,0,0,1,1
2354292,2355382,1090,0,0,1,2
2355383,2355440,57,1,0,0,2
2355386,2355452,66,1,0,0,1
2355441,2355722,281,0,0,1,2
2355453,2355721,268,0,0,1,1
2355722,2355780,58,1,0,0,1
2355723,2355798,75,1,0,0,2
2355781,2356020,239,0,0,1,1
2355799,2356021,222,0,0,1,2
2356021,2356055,34,1,0,0,1
2356022,2356056,34,1,0,0,2
2356056,2356621,565,0,0,1,1
2356057,2356620,563,0,0,1,2
2356621,2356642,21,1,0,0,2
2356622,2356641,19,1,0,0,1
2356642,2357345,703,0,0,1,1
2356643,2357345,702,0,0,1,2
2357346,2357371,25,1,0,0,1
2357346,2357381,35,1,0,0,2
2357372,2358184,812,0,0,1,1
2357382,2358185,803,0,0,1,2
2358185,2358252,67,1,0,0,1
2358186,2358251,65,1,0,0,2
2358252,2359017,765,0,0,1,2
2358253,2359017,764,0,0,1,1
2359018,2359040,22,1,0,0,2
2359018,2359044,26,1,0,0,1
2359041,2359537,496,0,0,1,2
2359045,2359537,492,0,0,1,1
2359538,2359582,44,1,0,0,1
2359538,2359583,45,1,0,0,2
2359583,2359780,197,0,0,1,1
2359584,2359781,197,0,0,1,2
2359781,2359840,59,1,0,0,1
2359782,2359869,87,1,0,0,2
2359841,2359975,134,0,0,1,1
2359870,2359975,105,0,0,1,2
2359976,2360005,29,1,0,0,1
2359976,2360073,97,1,0,0,2
2360006,2361239,1233,0,0,1,1
2360074,2360228,154,0,0,1,2
2360229,2360250,21,1,0,0,2
2360251,2360275,24,0,0,1,2
2360276,2360331,55,1,0,0,2
2360332,2360544,212,0,0,1,2
2360545,2360881,336,1,0,0,2
2360882,2361029,147,0,0,1,2
2361030,2361117,87,1,0,0,2
2361118,2361240,122,0,0,1,2
2361240,2361305,65,1,0,0,1
2361241,2361318,77,1,0,0,2
2361306,2362038,732,0,0,1,1
2361319,2362038,719,0,0,1,2
2362039,2362065,26,1,0,0,2
2362039,2362068,29,1,0,0,1
2362066,2363088,1022,0,0,1,2
2362069,2363088,1019,0,0,1,1
2363089,2363119,30,1,0,0,2
2363089,2363120,31,1,0,0,1
2363120,2363761,641,0,0,1,2
2363121,2363763,642,0,0,1,1
2363762,2363800,38,1,0,0,2
2363764,2363799,35,1,0,0,1
2363800,2364541,741,0,0,1,1
2363801,2364542,741,0,0,1,2
2364542,2364580,38,1,0,0,1
2364543,2364590,47,1,0,0,2
2364581,2364897,316,0,0,1,1
2364591,2364894,303,0,0,1,2
2364895,2364972,77,1,0,0,2
2364898,2364968,70,1,0,0,1
2364969,2365084,115,0,0,1,1
2364973,2365085,112,0,0,1,2
2365085,2365114,29,1,0,0,1
2365086,2365289,203,1,0,0,2
2365115,2365622,507,0,0,1,1
2365290,2365390,100,0,0,1,2
2365391,2365411,20,1,0,0,2
2365412,2365467,55,0,0,1,2
2365468,2365549,81,1,0,0,2
2365550,2365610,60,0,0,1,2
2365611,2366089,478,1,0,0,2
2365623,2365644,21,1,0,0,1
2365645,2366006,361,0,0,1,1
2366007,2366077,70,1,0,0,1
2366078,2366178,100,0,0,1,1
2366090,2366179,89,0,0,1,2
2366179,2366214,35,1,0,0,1
2366180,2366218,38,1,0,0,2
2366215,2368155,1940,0,0,1,1
2366219,2368155,1936,0,0,1,2
2368156,2368199,43,1,0,0,1
2368156,2368205,49,1,0,0,2
2368200,2368785,585,0,0,1,1
2368206,2368788,582,0,0,1,2
2368786,2368832,46,1,0,0,1
2368789,2368838,49,1,0,0,2
2368833,2369312,479,0,0,1,1
2368839,2369311,472,0,0,1,2
2369312,2369384,72,1,0,0,2
2369313,2369384,71,1,0,0,1
2369385,2369513,128,0,0,1,1
2369385,2369513,128,0,0,1,2
2369514,2369538,24,1,0,0,1
2369514,2369548,34,1,0,0,2
2369539,2371267,1728,0,0,1,1
2369549,2369937,388,0,0,1,2
2369938,2369957,19,1,0,0,2
2369958,2371265,1307,0,0,1,2
2371266,2371314,48,1,0,0,2
2371268,2371316,48,1,0,0,1
2371315,2372233,918,0,0,1,2
2371317,2372231,914,0,0,1,1
2372232,2372248,16,1,0,0,1
2372234,2372283,49,1,0,0,2
2372249,2372274,25,0,0,1,1
2372275,2372291,16,1,0,0,1
2372284,2372569,285,0,0,1,2
2372292,2372561,269,0,0,1,1
2372562,2373108,546,1,0,0,1
2372570,2372741,171,1,0,0,2
2372584,2372744,160,0,1,0,1
2372595,2372675,80,0,1,0,2
2372742,2372780,38,0,0,1,2
2372781,2373069,288,1,0,0,2
2372795,2373084,289,0,1,0,1
2372809,2373036,227,0,1,0,2
2373070,2373651,581,0,0,1,2
2373109,2373650,541,0,0,1,1
2373651,2373696,45,1,0,0,1
2373652,2373719,67,1,0,0,2
2373697,2373992,295,0,0,1,1
2373720,2373993,273,0,0,1,2
2373993,2374038,45,1,0,0,1
2373994,2374037,43,1,0,0,2
2374038,2374443,405,0,0,1,2
2374039,2374443,404,0,0,1,1
2374444,2374484,40,1,0,0,1
2374444,2374486,42,1,0,0,2
2374485,2375114,629,0,0,1,1
2374487,2375114,627,0,0,1,2
2375115,2375191,76,1,0,0,2
2375115,2375193,78,1,0,0,1
2375192,2375398,206,0,0,1,2
2375194,2375397,203,0,0,1,1
2375398,2375432,34,1,0,0,1
2375399,2375431,32,1,0,0,2
2375432,2377111,1679,0,0,1,2
2375433,2377110,1677,0,0,1,1
2377111,2377184,73,1,0,0,1
2377112,2377390,278,1,0,0,2
2377185,2377312,127,0,0,1,1
2377313,2377341,28,1,0,0,1
2377342,2377960,618,0,0,1,1
2377391,2377460,69,0,0,1,2
2377461,2377488,27,1,0,0,2
2377489,2377567,78,0,0,1,2
2377568,2377621,53,1,0,0,2
2377622,2377961,339,0,0,1,2
2377961,2377994,33,1,0,0,1
2377962,2378044,82,1,0,0,2
2377995,2379316,1321,0,0,1,1
2378045,2378094,49,0,0,1,2
2378095,2378115,20,1,0,0,2
2378116,2378490,374,0,0,1,2
2378491,2378512,21,1,0,0,2
2378513,2378638,125,0,0,1,2
2378639,2378654,15,1,0,0,2
2378655,2378789,134,0,0,1,2
2378790,2378844,54,1,0,0,2
2378845,2379105,260,0,0,1,2
2379106,2379169,63,1,0,0,2
2379170,2379250,80,0,0,1,2
2379251,2379382,131,1,0,0,2
2379317,2379378,61,1,0,0,1
2379379,2379691,312,0,0,1,1
2379383,2379692,309,0,0,1,2
2379692,2379743,51,1,0,0,1
2379693,2379936,243,1,0,0,2
2379744,2380621,877,0,0,1,1
2379937,2380005,68,0,0,1,2
2380006,2380434,428,1,0,0,2
2380435,2380472,37,0,0,1,2
2380473,2381063,590,1,0,0,2
2380622,2380666,44,1,0,0,1
2380667,2381125,458,0,0,1,1
2381064,2381126,62,0,0,1,2
2381126,2381201,75,1,0,0,1
2381127,2381192,65,1,0,0,2
2381193,2381435,242,0,0,1,2
2381202,2381434,232,0,0,1,1
2381435,2381451,16,1,0,0,1
2381436,2381452,16,1,0,0,2
2381452,2382286,834,0,0,1,1
2381453,2382893,1440,0,0,1,2
2382287,2382291,4,1,0,0,1
2382292,2382893,601,0,0,1,1
2382894,2382955,61,1,0,0,1
2382894,2382970,76,1,0,0,2
2382956,2383129,173,0,0,1,1
2382971,2383128,157,0,0,1,2
2383129,2383155,26,1,0,0,2
2383130,2383156,26,1,0,0,1
2383156,2383774,618,0,0,1,2
2383157,2383774,617,0,0,1,1
2383775,2383794,19,1,0,0,2
2383775,2383796,21,1,0,0,1
2383795,2384965,1170,0,0,1,2
2383797,2384963,1166,0,0,1,1
2384964,2385032,68,1,0,0,1
2384966,2385032,66,1,0,0,2
2385033,2385466,433,0,0,1,2
2385033,2385468,435,0,0,1,1
2385467,2385511,44,1,0,0,2
2385469,2385507,38,1,0,0,1
2385508,2386128,620,0,0,1,1
2385512,2386000,488,0,0,1,2
2386001,2386033,32,1,0,0,2
2386034,2386128,94,0,0,1,2
2386129,2386165,36,1,0,0,2
2386129,2386167,38,1,0,0,1
2386166,2386695,529,0,0,1,2
2386168,2386695,527,0,0,1,1
2386696,2386769,73,1,0,0,2
2386696,2386815,119,1,0,0,1
2386770,2386880,110,0,0,1,2
2386816,2386880,64,0,0,1,1
2386881,2386909,28,1,0,0,1
2386881,2386916,35,1,0,0,2
2386910,2387357,447,0,0,1,1
2386917,2387359,442,0,0,1,2
2387358,2387379,21,1,0,0,1
2387360,2387377,17,1,0,0,2
2387378,2387886,508,0,0,1,2
2387380,2388331,951,0,0,1,1
2387887,2388013,126,1,0,0,2
2388014,2388034,20,0,0,1,2
2388035,2388222,187,1,0,0,2
2388223,2388309,86,0,0,1,2
2388310,2388649,339,1,0,0,2
2388332,2388371,39,1,0,0,1
2388372,2388590,218,0,0,1,1
2388591,2388641,50,1,0,0,1
2388642,2388886,244,0,0,1,1
2388650,2388888,238,0,0,1,2
2388887,2388914,27,1,0,0,1
2388889,2388913,24,1,0,0,2
2388914,2389875,961,0,0,1,2
2388915,2389876,961,0,0,1,1
2389876,2389899,23,1,0,0,2
2389877,2389897,20,1,0,0,1
2389898,2391830,1932,0,0,1,1
2389900,2391825,1925,0,0,1,2
2391826,2391863,37,1,0,0,2
2391831,2391864,33,1,0,0,1
2391864,2392616,752,0,0,1,2
2391865,2392616,751,0,0,1,1
2392617,2392700,83,1,0,0,1
2392617,2392702,85,1,0,0,2
2392701,2392810,109,0,0,1,1
2392703,2392811,108,0,0,1,2
2392811,2392843,32,1,0,0,1
2392812,2392839,27,1,0,0,2
2392840,2393142,302,0,0,1,2
2392844,2393147,303,0,0,1,1
2393143,2393167,24,1,0,0,2
2393148,2393167,19,1,0,0,1
2393168,2394105,937,0,0,1,2
2393168,2394106,938,0,0,1,1
2394106,2394150,44,1,0,0,2
2394107,2394148,41,1,0,0,1
2394149,2394456,307,0,0,1,1
2394151,2394464,313,0,0,1,2
2394457,2394481,24,1,0,0,1
2394465,2394484,19,1,0,0,2
2394482,2396623,2141,0,0,1,1
2394485,2396623,2138,0,0,1,2
2396624,2396661,37,1,0,0,1
2396624,2396666,42,1,0,0,2
2396662,2397770,1108,0,0,1,1
2396667,2397772,1105,0,0,1,2
2397771,2397883,112,1,0,0,1
2397773,2397885,112,1,0,0,2
2397884,2398020,136,0,0,1,1
2397886,2398018,132,0,0,1,2
2398019,2398049,30,1,0,0,2
2398021,2398049,28,1,0,0,1
2398050,2398947,897,0,0,1,1
2398050,2398948,898,0,0,1,2
2398948,2399025,77,1,0,0,1
2398949,2399027,78,1,0,0,2
2399026,2401128,2102,0,0,1,1
2399028,2401128,2100,0,0,1,2
2401129,2401189,60,1,0,0,2
2401129,2401199,70,1,0,0,1
2401190,2401489,299,0,0,1,2
2401200,2401490,290,0,0,1,1
2401490,2401546,56,1,0,0,2
2401491,2401546,55,1,0,0,1
2401547,2401952,405,0,0,1,2
2401547,2401953,406,0,0,1,1
2401953,2402005,52,1,0,0,2
2401954,2402006,52,1,0,0,1
2402006,2402375,369,0,0,1,2
2402007,2402376,369,0,0,1,1
2402376,2402456,80,1,0,0,2
2402377,2402457,80,1,0,0,1
2402457,2402663,206,0,0,1,2
2402458,2402664,206,0,0,1,1
2402664,2402686,22,1,0,0,2
2402665,2402684,19,1,0,0,1
2402685,2403723,1038,0,0,1,1
2402687,2403721,1034,0,0,1,2
2403722,2403760,38,1,0,0,2
2403724,2403765,41,1,0,0,1
2403761,2403926,165,0,0,1,2
2403766,2403931,165,0,0,1,1
2403927,2403950,23,1,0,0,2
2403932,2403947,15,1,0,0,1
2403948,2404445,497,0,0,1,1
2403951,2404447,496,0,0,1,2
2404446,2404473,27,1,0,0,1
2404448,2404474,26,1,0,0,2
2404474,2404793,319,0,0,1,1
2404475,2404794,319,0,0,1,2
2404794,2404816,22,1,0,0,1
2404795,2404814,19,1,0,0,2
2404815,2405881,1066,0,0,1,2
2404817,2405882,1065,0,0,1,1
2405882,2405914,32,1,0,0,2
2405883,2405915,32,1,0,0,1
2405915,2406370,455,0,0,1,2
2405916,2406369,453,0,0,1,1
2406370,2406403,33,1,0,0,1
2406371,2406405,34,1,0,0,2
2406404,2406991,587,0,0,1,1
2406406,2406991,585,0,0,1,2
2406992,2407024,32,1,0,0,1
2406992,2407033,41,1,0,0,2
2407025,2407223,198,0,0,1,1
2407034,2407225,191,0,0,1,2
2407224,2407263,39,1,0,0,1
2407226,2407273,47,1,0,0,2
2407264,2407491,227,0,0,1,1
2407274,2407492,218,0,0,1,2
2407492,2407517,25,1,0,0,1
2407493,2407528,35,1,0,0,2
2407518,2407694,176,0,0,1,1
2407529,2407690,161,0,0,1,2
2407691,2432698,25007,1,0,0,2
2407695,2432847,25152,1,0,0,1
2407729,2432689,24960,0,1,0,2
2407731,2432838,25107,0,1,0,1
2432699,2432753,54,0,0,1,2
2432754,2432787,33,1,0,0,2
2432788,2432957,169,0,0,1,2
2432848,2432967,119,0,0,1,1
2432958,2434308,1350,1,0,0,2
2432968,2434067,1099,1,0,0,1
2432997,2433998,1001,0,1,0,1
2432997,2433998,1001,0,1,0,2
2434068,2434146,78,0,0,1,1
2434147,2434179,32,1,0,0,1
2434180,2434455,275,0,0,1,1
2434309,2434455,146,0,0,1,2
2434456,2434487,31,1,0,0,1
2434456,2434487,31,1,0,0,2
2434488,2434747,259,0,0,1,2
2434488,2434748,260,0,0,1,1
2434748,2434779,31,1,0,0,2
2434749,2434778,29,1,0,0,1
2434779,2434961,182,0,0,1,1
2434780,2434961,181,0,0,1,2
2434962,2434988,26,1,0,0,2
2434962,2434990,28,1,0,0,1
2434989,2435244,255,0,0,1,2
2434991,2435244,253,0,0,1,1
2477787,2478094,307,0,0,1,1
2477787,2478094,307,0,0,1,2
2478095,2478198,103,1,0,0,1
2478095,2478247,152,1,0,0,2
2478199,2478280,81,0,0,1,1
2478248,2478286,38,0,0,1,2
2478281,2478331,50,1,0,0,1
2478287,2478338,51,1,0,0,2
2478332,2478950,618,0,0,1,1
2478339,2478949,610,0,0,1,2
2478950,2478968,18,1,0,0,2
2478951,2478967,16,1,0,0,1
2478968,2480131,1163,0,0,1,1
2478969,2480129,1160,0,0,1,2
2480130,2480216,86,1,0,0,2
2480132,2480178,46,1,0,0,1
2480179,2480459,280,0,0,1,1
2480217,2480459,242,0,0,1,2
2480460,2480547,87,1,0,0,1
2480460,2480548,88,1,0,0,2
2480548,2480715,167,0,0,1,1
2480549,2480714,165,0,0,1,2
2480715,2480742,27,1,0,0,2
2480716,2480742,26,1,0,0,1
2480743,2481016,273,0,0,1,2
2480743,2482439,1696,0,0,1,1
2481017,2481046,29,1,0,0,2
2481047,2481794,747,0,0,1,2
2481795,2481825,30,1,0,0,2
2481826,2482307,481,0,0,1,2
2482308,2482319,11,1,0,0,2
2482320,2482439,119,0,0,1,2
2482440,2482507,67,1,0,0,2
2482440,2482508,68,1,0,0,1
2482508,2482643,135,0,0,1,2
2482509,2482643,134,0,0,1,1
2482644,2482669,25,1,0,0,2
2482644,2482681,37,1,0,0,1
2482670,2483632,962,0,0,1,2
2482682,2483630,948,0,0,1,1
2483631,2483701,70,1,0,0,1
2483633,2483704,71,1,0,0,2
2483702,2483930,228,0,0,1,1
2483705,2483931,226,0,0,1,2
2483931,2484008,77,1,0,0,1
2483932,2484010,78,1,0,0,2
2484009,2484230,221,0,0,1,1
2484011,2484229,218,0,0,1,2
2484230,2484258,28,1,0,0,2
2484231,2484258,27,1,0,0,1
2484259,2484816,557,0,0,1,1
2484259,2484816,557,0,0,1,2
2484817,2484878,61,1,0,0,1
2484817,2484885,68,1,0,0,2
2484879,2485479,600,0,0,1,1
2484886,2485480,594,0,0,1,2
2485480,2485519,39,1,0,0,1
2485481,2485517,36,1,0,0,2
2485518,2485765,247,0,0,1,2
2485520,2485767,247,0,0,1,1
2485766,2485838,72,1,0,0,2
2485768,2485836,68,1,0,0,1
2485837,2486034,197,0,0,1,1
2485839,2486034,195,0,0,1,2
2486035,2486064,29,1,0,0,2
2486035,2486065,30,1,0,0,1
2486065,2486362,297,0,0,1,2
2486066,2486363,297,0,0,1,1
2486363,2486389,26,1,0,0,2
2486364,2486389,25,1,0,0,1
2486390,2487208,818,0,0,1,2
2486390,2487209,819,0,0,1,1
2487209,2487267,58,1,0,0,2
2487210,2487267,57,1,0,0,1
2487268,2487612,344,0,0,1,1
2487268,2487613,345,0,0,1,2
2487613,2487666,53,1,0,0,1
2487614,2487670,56,1,0,0,2
2487667,2487772,105,0,0,1,1
2487671,2487773,102,0,0,1,2
2487773,2487802,29,1,0,0,1
2487774,2487796,22,1,0,0,2
2487797,2488963,1166,0,0,1,2
2487803,2488962,1159,0,0,1,1
2488963,2489016,53,1,0,0,1
2488964,2489015,51,1,0,0,2
2489016,2489352,336,0,0,1,2
2489017,2489353,336,0,0,1,1
2489353,2489467,114,1,0,0,2
2489354,2489466,112,1,0,0,1
2489467,2489603,136,0,0,1,1
2489468,2489604,136,0,0,1,2
2489604,2489634,30,1,0,0,1
2489605,2489634,29,1,0,0,2
2489635,2490379,744,0,0,1,1
2489635,2490381,746,0,0,1,2
2490380,2490480,100,1,0,0,1
2490382,2490482,100,1,0,0,2
2490481,2490963,482,0,0,1,1
2490483,2490963,480,0,0,1,2
2490964,2491034,70,1,0,0,2
2490964,2491041,77,1,0,0,1
2491035,2491129,94,0,0,1,2
2491042,2491131,89,0,0,1,1
2491130,2491216,86,1,0,0,2
2491132,2491224,92,1,0,0,1
2491217,2491325,108,0,0,1,2
2491225,2491323,98,0,0,1,1
2491324,2491373,49,1,0,0,1
2491326,2491366,40,1,0,0,2
2491367,2491550,183,0,0,1,2
2491374,2491549,175,0,0,1,1
2491550,2491578,28,1,0,0,1
2491551,2491571,20,1,0,0,2
2491572,2492442,870,0,0,1,2
2491579,2492441,862,0,0,1,1
2492442,2492490,48,1,0,0,1
2492443,2492492,49,1,0,0,2
2492491,2492783,292,0,0,1,1
2492493,2492784,291,0,0,1,2
2492784,2492824,40,1,0,0,1
2492785,2492840,55,1,0,0,2
2492825,2492967,142,0,0,1,1
2492841,2492967,126,0,0,1,2
2492968,2493086,118,1,0,0,1
2492968,2493099,131,1,0,0,2
2493087,2493196,109,0,0,1,1
2493100,2493195,95,0,0,1,2
2493196,2493229,33,1,0,0,2
2493197,2493230,33,1,0,0,1
2493230,2494033,803,0,0,1,2
2493231,2494034,803,0,0,1,1
2494034,2494132,98,1,0,0,2
2494035,2494120,85,1,0,0,1
2494121,2494728,607,0,0,1,1
2494133,2494727,594,0,0,1,2
2494728,2494789,61,1,0,0,2
2494729,2494791,62,1,0,0,1
2494790,2494978,188,0,0,1,2
2494792,2494978,186,0,0,1,1
2494979,2495004,25,1,0,0,1
2494979,2495008,29,1,0,0,2
2495005,2495807,802,0,0,1,1
2495009,2495807,798,0,0,1,2
2495808,2495855,47,1,0,0,1
2495808,2495864,56,1,0,0,2
2495856,2496206,350,0,0,1,1
2495865,2496207,342,0,0,1,2
2496207,2496331,124,1,0,0,1
2496208,2496342,134,1,0,0,2
2496332,2496467,135,0,0,1,1
2496343,2496469,126,0,0,1,2
2496468,2496488,20,1,0,0,1
2496470,2496490,20,1,0,0,2
2496489,2497164,675,0,0,1,1
2496491,2497165,674,0,0,1,2
2497165,2497216,51,1,0,0,1
2497166,2497223,57,1,0,0,2
2497217,2497553,336,0,0,1,1
2497224,2497552,328,0,0,1,2
2497553,2497609,56,1,0,0,2
2497554,2497607,53,1,0,0,1
2497608,2497890,282,0,0,1,1
2497610,2497889,279,0,0,1,2
2497890,2497984,94,1,0,0,2
2497891,2497975,84,1,0,0,1
2497976,2498088,112,0,0,1,1
2497985,2498087,102,0,0,1,2
2498088,2498112,24,1,0,0,2
2498089,2498111,22,1,0,0,1
2498112,2499057,945,0,0,1,1
2498113,2499054,941,0,0,1,2
2499055,2499143,88,1,0,0,2
2499058,2499146,88,1,0,0,1
2499144,2499311,167,0,0,1,2
2499147,2499311,164,0,0,1,1
2499312,2499398,86,1,0,0,1
2499312,2499403,91,1,0,0,2
2499399,2499544,145,0,0,1,1
2499404,2499543,139,0,0,1,2
2499544,2499572,28,1,0,0,2
2499545,2499572,27,1,0,0,1
2499573,2500105,532,0,0,1,2
2499573,2500107,534,0,0,1,1
2500106,2500161,55,1,0,0,2
2500108,2500161,53,1,0,0,1
2500162,2501251,1089,0,0,1,1
2500162,2501251,1089,0,0,1,2
2501252,2501315,63,1,0,0,2
2501252,2501348,96,1,0,0,1
2501316,2501506,190,0,0,1,2
2501349,2501505,156,0,0,1,1
2501506,2501525,19,1,0,0,1
2501507,2501535,28,1,0,0,2
2501526,2503109,1583,0,0,1,1
2501536,2503111,1575,0,0,1,2
2503110,2503228,118,1,0,0,1
2503112,2503228,116,1,0,0,2
2503229,2503347,118,0,0,1,1
2503229,2503348,119,0,0,1,2
2503348,2503380,32,1,0,0,1
2503349,2503390,41,1,0,0,2
2503381,2504479,1098,0,0,1,1
2503391,2504479,1088,0,0,1,2
2504480,2504540,60,1,0,0,2
2504480,2504542,62,1,0,0,1
2504541,2504827,286,0,0,1,2
2504543,2504828,285,0,0,1,1
2504828,2504937,109,1,0,0,2
2504829,2504926,97,1,0,0,1
2504927,2505097,170,0,0,1,1
2504938,2505097,159,0,0,1,2
2505098,2505128,30,1,0,0,2
2505098,2505129,31,1,0,0,1
2505129,2505413,284,0,0,1,2
2505130,2505420,290,0,0,1,1
2505414,2505438,24,1,0,0,2
2505421,2505438,17,1,0,0,1
2505439,2506252,813,0,0,1,2
2505439,2506257,818,0,0,1,1
2506253,2506346,93,1,0,0,2
2506258,2506347,89,1,0,0,1
2506347,2506670,323,0,0,1,2
2506348,2506669,321,0,0,1,1
2506670,2506746,76,1,0,0,1
2506671,2506755,84,1,0,0,2
2506747,2506941,194,0,0,1,1
2506756,2506939,183,0,0,1,2
2506940,2506966,26,1,0,0,2
2506942,2506969,27,1,0,0,1
2506967,2508047,1080,0,0,1,2
2506970,2508048,1078,0,0,1,1
2508048,2508101,53,1,0,0,2
2508049,2508106,57,1,0,0,1
2508102,2508578,476,0,0,1,2
2508107,2508576,469,0,0,1,1
2508577,2508642,65,1,0,0,1
2508579,2508655,76,1,0,0,2
2508643,2510041,1398,0,0,1,1
2508656,2508871,215,0,0,1,2
2508872,2508881,9,1,0,0,2
2508882,2510040,1158,0,0,1,2
2510041,2510104,63,1,0,0,2
2510042,2510100,58,1,0,0,1
2510101,2510277,176,0,0,1,1
2510105,2510275,170,0,0,1,2
2510276,2510380,104,1,0,0,2
2510278,2510376,98,1,0,0,1
2510377,2510505,128,0,0,1,1
2510381,2510504,123,0,0,1,2
2510505,2510567,62,1,0,0,2
2510506,2510528,22,1,0,0,1
2510529,2511040,511,0,0,1,1
2510568,2510912,344,0,0,1,2
2510913,2510917,4,1,0,0,2
2510918,2511120,202,0,0,1,2
2511041,2511050,9,1,0,0,1
2511051,2511469,418,0,0,1,1
2511121,2511130,9,1,0,0,2
2511131,2511472,341,0,0,1,2
2511470,2511526,56,1,0,0,1
2511473,2511532,59,1,0,0,2
2511527,2512074,547,0,0,1,1
2511533,2512074,541,0,0,1,2
2512075,2512134,59,1,0,0,2
2512075,2512136,61,1,0,0,1
2512135,2512303,168,0,0,1,2
2512137,2512303,166,0,0,1,1
2512304,2512327,23,1,0,0,1
2512304,2512328,24,1,0,0,2
2512328,2512534,206,0,0,1,1
2512329,2512535,206,0,0,1,2
2512535,2512561,26,1,0,0,1
2512536,2512553,17,1,0,0,2
2512554,2513637,1083,0,0,1,2
2512562,2513638,1076,0,0,1,1
2513638,2513748,110,1,0,0,2
2513639,2513742,103,1,0,0,1
2513743,2513777,34,0,0,1,1
2513749,2513778,29,0,0,1,2
2513778,2513881,103,1,0,0,1
2513779,2513881,102,1,0,0,2
2513882,2514031,149,0,0,1,1
2513882,2514031,149,0,0,1,2
2514032,2514060,28,1,0,0,2
2514032,2514061,29,1,0,0,1
2514061,2515015,954,0,0,1,2
2514062,2515015,953,0,0,1,1
2515016,2515066,50,1,0,0,2
2515016,2515067,51,1,0,0,1
2515067,2515433,366,0,0,1,2
2515068,2515436,368,0,0,1,1
2515434,2515479,45,1,0,0,2
2515437,2515491,54,1,0,0,1
2515480,2515728,248,0,0,1,2
2515492,2515729,237,0,0,1,1
2515729,2515750,21,1,0,0,2
2515730,2515749,19,1,0,0,1
2515750,2515968,218,0,0,1,1
2515751,2515973,222,0,0,1,2
2515969,2515990,21,1,0,0,1
2515974,2515986,12,1,0,0,2
2515987,2516591,604,0,0,1,2
2515991,2516591,600,0,0,1,1
2516592,2516634,42,1,0,0,1
2516592,2516646,54,1,0,0,2
2516635,2517040,405,0,0,1,1
2516647,2517039,392,0,0,1,2
2517040,2517125,85,1,0,0,2
2517041,2517126,85,1,0,0,1
2517126,2517277,151,0,0,1,2
2517127,2517275,148,0,0,1,1
2517276,2517326,50,1,0,0,1
2517278,2517324,46,1,0,0,2
2517325,2517475,150,0,0,1,2
2517327,2517478,151,0,0,1,1
2517476,2517498,22,1,0,0,2
2517479,2517494,15,1,0,0,1
2517495,2518033,538,0,0,1,1
2517499,2518033,534,0,0,1,2
2518034,2518095,61,1,0,0,1
2518034,2518098,64,1,0,0,2
2518096,2518605,509,0,0,1,1
2518099,2518604,505,0,0,1,2
2518605,2518653,48,1,0,0,2
2518606,2518656,50,1,0,0,1
2518654,2518745,91,0,0,1,2
2518657,2518743,86,0,0,1,1
2518744,2518795,51,1,0,0,1
2518746,2518819,73,1,0,0,2
2518796,2519862,1066,0,0,1,1
2518820,2519861,1041,0,0,1,2
2519862,2519898,36,1,0,0,2
2519863,2519896,33,1,0,0,1
2519897,2520303,406,0,0,1,1
2519899,2520303,404,0,0,1,2
2520304,2520339,35,1,0,0,1
2520304,2520346,42,1,0,0,2
2520340,2520629,289,0,0,1,1
2520347,2520625,278,0,0,1,2
2520626,2520641,15,1,0,0,2
2520630,2520641,11,1,0,0,1
2520642,2521743,1101,0,0,1,2
2520642,2521744,1102,0,0,1,1
2521744,2521815,71,1,0,0,2
2521745,2521817,72,1,0,0,1
2521816,2521991,175,0,0,1,2
2521818,2521993,175,0,0,1,1
2521992,2522022,30,1,0,0,2
2521994,2522014,20,1,0,0,1
2522015,2522808,793,0,0,1,1
2522023,2522807,784,0,0,1,2
2522808,2522897,89,1,0,0,2
2522809,2522883,74,1,0,0,1
2522884,2523242,358,0,0,1,1
2522898,2523241,343,0,0,1,2
2523242,2523296,54,1,0,0,2
2523243,2523304,61,1,0,0,1
2523297,2523466,169,0,0,1,2
2523305,2523465,160,0,0,1,1
2523466,2523485,19,1,0,0,1
2523467,2523485,18,1,0,0,2
2523486,2524231,745,0,0,1,1
2523486,2524233,747,0,0,1,2
2524232,2524277,45,1,0,0,1
2524234,2524276,42,1,0,0,2
2524277,2524841,564,0,0,1,2
2524278,2524844,566,0,0,1,1
2524842,2524962,120,1,0,0,2
2524845,2524937,92,1,0,0,1
2524938,2525128,190,0,0,1,1
2524963,2525130,167,0,0,1,2
2525129,2525150,21,1,0,0,1
2525131,2525157,26,1,0,0,2
2525151,2525747,596,0,0,1,1
2525158,2525748,590,0,0,1,2
2525748,2525809,61,1,0,0,1
2525749,2525826,77,1,0,0,2
2525810,2526382,572,0,0,1,1
2525827,2526382,555,0,0,1,2
2526383,2526436,53,1,0,0,1
2526383,2526481,98,1,0,0,2
2526437,2526459,22,0,0,1,1
2526460,2526468,8,1,0,0,1
2526469,2526569,100,0,0,1,1
2526482,2526569,87,0,0,1,2
2526570,2526600,30,1,0,0,1
2526570,2526600,30,1,0,0,2
2526601,2527367,766,0,0,1,1
2526601,2527367,766,0,0,1,2
2527368,2527452,84,1,0,0,2
2527368,2527453,85,1,0,0,1
2527453,2527873,420,0,0,1,2
2527454,2527872,418,0,0,1,1
2527873,2527959,86,1,0,0,1
2527874,2527960,86,1,0,0,2
2527960,2528139,179,0,0,1,1
2527961,2528142,181,0,0,1,2
2528140,2528173,33,1,0,0,1
2528143,2528171,28,1,0,0,2
2528172,2528902,730,0,0,1,2
2528174,2528901,727,0,0,1,1
2528902,2528983,81,1,0,0,1
2528903,2528978,75,1,0,0,2
2528979,2529358,379,0,0,1,2
2528984,2529355,371,0,0,1,1
2529356,2529440,84,1,0,0,1
2529359,2529442,83,1,0,0,2
2529441,2529606,165,0,0,1,1
2529443,2529603,160,0,0,1,2
2529604,2529632,28,1,0,0,2
2529607,2529630,23,1,0,0,1
2529631,2530261,630,0,0,1,1
2529633,2530258,625,0,0,1,2
2530259,2530322,63,1,0,0,2
2530262,2530324,62,1,0,0,1
2530323,2530604,281,0,0,1,2
2530325,2530758,433,0,0,1,1
2530605,2530610,5,1,0,0,2
2530611,2530647,36,0,0,1,2
2530648,2530673,25,1,0,0,2
2530674,2530761,87,0,0,1,2
2530759,2530822,63,1,0,0,1
2530762,2530823,61,1,0,0,2
2530823,2530954,131,0,0,1,1
2530824,2530953,129,0,0,1,2
2530954,2530980,26,1,0,0,2
2530955,2530979,24,1,0,0,1
2530980,2531654,674,0,0,1,1
2530981,2531654,673,0,0,1,2
2531655,2531711,56,1,0,0,1
2531655,2531711,56,1,0,0,2
2531712,2532326,614,0,0,1,1
2531712,2532327,615,0,0,1,2
2532327,2532399,72,1,0,0,1
2532328,2532411,83,1,0,0,2
2532400,2532646,246,0,0,1,1
2532412,2532648,236,0,0,1,2
2532647,2532678,31,1,0,0,1
2532649,2532677,28,1,0,0,2
2532678,2533384,706,0,0,1,2
2532679,2533385,706,0,0,1,1
2533385,2533464,79,1,0,0,2
2533386,2533469,83,1,0,0,1
2533465,2533782,317,0,0,1,2
2533470,2533781,311,0,0,1,1
2533782,2533893,111,1,0,0,1
2533783,2533894,111,1,0,0,2
2533894,2534011,117,0,0,1,1
2533895,2534012,117,0,0,1,2
2534012,2534040,28,1,0,0,1
2534013,2534039,26,1,0,0,2
2534040,2534786,746,0,0,1,2
2534041,2534785,744,0,0,1,1
2534786,2534844,58,1,0,0,1
2534787,2534841,54,1,0,0,2
2534842,2535368,526,0,0,1,2
2534845,2535369,524,0,0,1,1
2535369,2535475,106,1,0,0,2
2535370,2535471,101,1,0,0,1
2535472,2536161,689,0,0,1,1
2535476,2536160,684,0,0,1,2
2536161,2536189,28,1,0,0,2
2536162,2536188,26,1,0,0,1
2536189,2536472,283,0,0,1,1
2536190,2536474,284,0,0,1,2
2536473,2536525,52,1,0,0,1
2536475,2536533,58,1,0,0,2
2536526,2536983,457,0,0,1,1
2536534,2536983,449,0,0,1,2
2536984,2537035,51,1,0,0,1
2536984,2537038,54,1,0,0,2
2537036,2537259,223,0,0,1,1
2537039,2537259,220,0,0,1,2
2537260,2537277,17,1,0,0,1
2537260,2537280,20,1,0,0,2
2537278,2538036,758,0,0,1,1
2537281,2538035,754,0,0,1,2
2538036,2538084,48,1,0,0,2
2538037,2538097,60,1,0,0,1
2538085,2538534,449,0,0,1,2
2538098,2538536,438,0,0,1,1
2538535,2538606,71,1,0,0,2
2538537,2538605,68,1,0,0,1
2538606,2538793,187,0,0,1,1
2538607,2538793,186,0,0,1,2
2538794,2538822,28,1,0,0,1
2538794,2538823,29,1,0,0,2
2538823,2539903,1080,0,0,1,1
2538824,2539904,1080,0,0,1,2
2539904,2539976,72,1,0,0,1
2539905,2539963,58,1,0,0,2
2539964,2540085,121,0,0,1,2
2539977,2540087,110,0,0,1,1
2540086,2540184,98,1,0,0,2
2540088,2540175,87,1,0,0,1
2540176,2540271,95,0,0,1,1
2540185,2540273,88,0,0,1,2
2540272,2540317,45,1,0,0,1
2540274,2540318,44,1,0,0,2
2540318,2540577,259,0,0,1,1
2540319,2540567,248,0,0,1,2
2540568,2540605,37,1,0,0,2
2540578,2540600,22,1,0,0,1
2540601,2541343,742,0,0,1,1
2540606,2540751,145,0,0,1,2
2540752,2540877,125,1,0,0,2
2540878,2540958,80,0,0,1,2
2540959,2541026,67,1,0,0,2
2541027,2541056,29,0,0,1,2
2541057,2541101,44,1,0,0,2
2541102,2541347,245,0,0,1,2
2541344,2541412,68,1,0,0,1
2541348,2541414,66,1,0,0,2
2541413,2541896,483,0,0,1,1
2541415,2541892,477,0,0,1,2
2541893,2541943,50,1,0,0,2
2541897,2541944,47,1,0,0,1
2541944,2542122,178,0,0,1,2
2541945,2542121,176,0,0,1,1
2542122,2542146,24,1,0,0,1
2542123,2542149,26,1,0,0,2
2542147,2542986,839,0,0,1,1
2542150,2542988,838,0,0,1,2
2542987,2543029,42,1,0,0,1
2542989,2543051,62,1,0,0,2
2543030,2543312,282,0,0,1,1
2543052,2543310,258,0,0,1,2
2543311,2543445,134,1,0,0,2
2543313,2543443,130,1,0,0,1
2543444,2543642,198,0,0,1,1
2543446,2543645,199,0,0,1,2
2543643,2543667,24,1,0,0,1
2543646,2543675,29,1,0,0,2
2543668,2544657,989,0,0,1,1
2543676,2544080,404,0,0,1,2
2544081,2544091,10,1,0,0,2
2544092,2544657,565,0,0,1,2
2544658,2544743,85,1,0,0,1
2544658,2544756,98,1,0,0,2
2544744,2545153,409,0,0,1,1
2544757,2545152,395,0,0,1,2
2545153,2545199,46,1,0,0,2
2545154,2545188,34,1,0,0,1
2545189,2545465,276,0,0,1,1
2545200,2545478,278,0,0,1,2
2545466,2545483,17,1,0,0,1
2545479,2545562,83,1,0,0,2
2545484,2546160,676,0,0,1,1
2545563,2545610,47,0,0,1,2
2545611,2545664,53,1,0,0,2
2545665,2546162,497,0,0,1,2
2546161,2546208,47,1,0,0,1
2546163,2546208,45,1,0,0,2
2546209,2546643,434,0,0,1,2
2546209,2546644,435,0,0,1,1
2546644,2546703,59,1,0,0,2
2546645,2546704,59,1,0,0,1
2546704,2546832,128,0,0,1,2
2546705,2546832,127,0,0,1,1
2546833,2546863,30,1,0,0,1
2546833,2546865,32,1,0,0,2
2546864,2547163,299,0,0,1,1
2546866,2547163,297,0,0,1,2
2547164,2547183,19,1,0,0,1
2547164,2547185,21,1,0,0,2
2547184,2548084,900,0,0,1,1
2547186,2548083,897,0,0,1,2
2548084,2548161,77,1,0,0,2
2548085,2548151,66,1,0,0,1
2548152,2548377,225,0,0,1,1
2548162,2548377,215,0,0,1,2
2548378,2548396,18,1,0,0,1
2548378,2548405,27,1,0,0,2
2548397,2549528,1131,0,0,1,1
2548406,2549528,1122,0,0,1,2
2549529,2549634,105,1,0,0,1
2549529,2549635,106,1,0,0,2
2549635,2549763,128,0,0,1,1
2549636,2549763,127,0,0,1,2
2549764,2549798,34,1,0,0,1
2549764,2549800,36,1,0,0,2
2549799,2550530,731,0,0,1,1
2549801,2550530,729,0,0,1,2
2550531,2550582,51,1,0,0,2
2550531,2550595,64,1,0,0,1
2550583,2550963,380,0,0,1,2
2550596,2550961,365,0,0,1,1
2550962,2551031,69,1,0,0,1
2550964,2551031,67,1,0,0,2
2551032,2551252,220,0,0,1,1
2551032,2551253,221,0,0,1,2
2551253,2551278,25,1,0,0,1
2551254,2551274,20,1,0,0,2
2551275,2551987,712,0,0,1,2
2551279,2551988,709,0,0,1,1
2551988,2552047,59,1,0,0,2
2551989,2552044,55,1,0,0,1
2552045,2552386,341,0,0,1,1
2552048,2552385,337,0,0,1,2
2552386,2552444,58,1,0,0,2
2552387,2552460,73,1,0,0,1
2552445,2552629,184,0,0,1,2
2552461,2552631,170,0,0,1,1
2552630,2552659,29,1,0,0,2
2552632,2552658,26,1,0,0,1
2552659,2553341,682,0,0,1,1
2552660,2553341,681,0,0,1,2
2553342,2553394,52,1,0,0,1
2553342,2553401,59,1,0,0,2
2553395,2553839,444,0,0,1,1
2553402,2553837,435,0,0,1,2
2553838,2553916,78,1,0,0,2
2553840,2553917,77,1,0,0,1
2553917,2554055,138,0,0,1,2
2553918,2554055,137,0,0,1,1
2554056,2554084,28,1,0,0,1
2554056,2554088,32,1,0,0,2
2554085,2555037,952,0,0,1,1
2554089,2555038,949,0,0,1,2
2555038,2555100,62,1,0,0,1
2555039,2555103,64,1,0,0,2
2555101,2555243,142,0,0,1,1
2555104,2555243,139,0,0,1,2
2555244,2555375,131,1,0,0,2
2555244,2555390,146,1,0,0,1
2555376,2555496,120,0,0,1,2
2555391,2555503,112,0,0,1,1
2555497,2555527,30,1,0,0,2
2555504,2555522,18,1,0,0,1
2555523,2556232,709,0,0,1,1
2555528,2556232,704,0,0,1,2
2556233,2556318,85,1,0,0,1
2556233,2556331,98,1,0,0,2
2556319,2556732,413,0,0,1,1
2556332,2556738,406,0,0,1,2
2556733,2556807,74,1,0,0,1
2556739,2556816,77,1,0,0,2
2556808,2556968,160,0,0,1,1
2556817,2556967,150,0,0,1,2
2556968,2556998,30,1,0,0,2
2556969,2556990,21,1,0,0,1
2556991,2557575,584,0,0,1,1
2556999,2557576,577,0,0,1,2
2557576,2557621,45,1,0,0,1
2557577,2557621,44,1,0,0,2
2557622,2558280,658,0,0,1,2
2557622,2558282,660,0,0,1,1
2558281,2558346,65,1,0,0,2
2558283,2558346,63,1,0,0,1
2558347,2558429,82,0,0,1,1
2558347,2558434,87,0,0,1,2
2558430,2559355,925,1,0,0,1
2558435,2559343,908,1,0,0,2
2558458,2559332,874,0,1,0,2
2558466,2559339,873,0,1,0,1
2559344,2559389,45,0,0,1,2
2559356,2559388,32,0,0,1,1
2559389,2561638,2249,1,0,0,1
2559390,2561630,2240,1,0,0,2
2559407,2561613,2206,0,1,0,1
2559412,2561619,2207,0,1,0,2
2561631,2561669,38,0,0,1,2
2561639,2561670,31,0,0,1,1
2561670,2561735,65,1,0,0,2
2561671,2561719,48,1,0,0,1
2561720,2562849,1129,0,0,1,1
2561736,2562849,1113,0,0,1,2
2562850,2562869,19,1,0,0,1
2562850,2562869,19,1,0,0,2
2562870,2563584,714,0,0,1,1
2562870,2563586,716,0,0,1,2
2563585,2563624,39,1,0,0,1
2563587,2563631,44,1,0,0,2
2563625,2564016,391,0,0,1,1
2563632,2564016,384,0,0,1,2
2564017,2564040,23,1,0,0,1
2564017,2564049,32,1,0,0,2
2564041,2565479,1438,0,0,1,1
2564050,2565474,1424,0,0,1,2
2565475,2565491,16,1,0,0,2
2565480,2565490,10,1,0,0,1
2565491,2567508,2017,0,0,1,1
2565492,2567509,2017,0,0,1,2
2567509,2567581,72,1,0,0,1
2567510,2567583,73,1,0,0,2
2567582,2567749,167,0,0,1,1
2567584,2567749,165,0,0,1,2
2567750,2567774,24,1,0,0,1
2567750,2567781,31,1,0,0,2
2567775,2568648,873,0,0,1,1
2567782,2568648,866,0,0,1,2
2568649,2568684,35,1,0,0,1
2568649,2568690,41,1,0,0,2
2568685,2568845,160,0,0,1,1
2568691,2568845,154,0,0,1,2
2568846,2568900,54,1,0,0,1
2568846,2568909,63,1,0,0,2
2568901,2569148,247,0,0,1,1
2568910,2569147,237,0,0,1,2
2569148,2569168,20,1,0,0,2
2569149,2569171,22,1,0,0,1
2569169,2569353,184,0,0,1,2
2569172,2569350,178,0,0,1,1
2569351,2570985,1634,1,0,0,1
2569354,2569726,372,1,0,0,2
2569379,2570976,1597,0,1,0,1
2569383,2569716,333,0,1,0,2
2569727,2569868,141,0,0,1,2
2569869,2570307,438,1,0,0,2
2569885,2570290,405,0,1,0,2
2570308,2570591,283,0,0,1,2
2570592,2570612,20,1,0,0,2
2570613,2571205,592,0,0,1,2
2570986,2571205,219,0,0,1,1
2571206,2571256,50,1,0,0,1
2571206,2571272,66,1,0,0,2
2571257,2571484,227,0,0,1,1
2571273,2571484,211,0,0,1,2
2571485,2571546,61,1,0,0,2
2571485,2571553,68,1,0,0,1
2571547,2571990,443,0,0,1,2
2571554,2571990,436,0,0,1,1
2571991,2572041,50,1,0,0,1
2571991,2572046,55,1,0,0,2
2572042,2572325,283,0,0,1,1
2572047,2572325,278,0,0,1,2
2572326,2572403,77,1,0,0,1
2572326,2572413,87,1,0,0,2
2572404,2572496,92,0,0,1,1
2572414,2572496,82,0,0,1,2
2572497,2572561,64,1,0,0,2
2572497,2572564,67,1,0,0,1
2572562,2573752,1190,0,0,1,2
2572565,2573705,1140,0,0,1,1
2573706,2573850,144,1,0,0,1
2573753,2573772,19,1,0,0,2
2573773,2574036,263,0,0,1,2
2573851,2574037,186,0,0,1,1
2574037,2574113,76,1,0,0,2
2574038,2574100,62,1,0,0,1
2574101,2576460,2359,0,0,1,1
2574114,2576460,2346,0,0,1,2
2576461,2576498,37,1,0,0,1
2576461,2576499,38,1,0,0,2
2576499,2578089,1590,0,0,1,1
2576500,2578089,1589,0,0,1,2
2578090,2578158,68,1,0,0,1
2578090,2578164,74,1,0,0,2
2578159,2578259,100,0,0,1,1
2578165,2578259,94,0,0,1,2
2578260,2578299,39,1,0,0,2
2578260,2578300,40,1,0,0,1
2578300,2579793,1493,0,0,1,2
2578301,2579790,1489,0,0,1,1
2579791,2579829,38,1,0,0,1
2579794,2579835,41,1,0,0,2
2579830,2580063,233,0,0,1,1
2579836,2580063,227,0,0,1,2
2580064,2580103,39,1,0,0,2
2580064,2580105,41,1,0,0,1
2580104,2580515,411,0,0,1,2
2580106,2580516,410,0,0,1,1
2580516,2580547,31,1,0,0,2
2580517,2580544,27,1,0,0,1
2580545,2580969,424,0,0,1,1
2580548,2580970,422,0,0,1,2
2580970,2580990,20,1,0,0,1
2580971,2580989,18,1,0,0,2
2580990,2582189,1199,0,0,1,2
2580991,2582190,1199,0,0,1,1
2582190,2582244,54,1,0,0,2
2582191,2582249,58,1,0,0,1
2582245,2582701,456,0,0,1,2
2582250,2582703,453,0,0,1,1
2582702,2582751,49,1,0,0,2
2582704,2582742,38,1,0,0,1
2582743,2583681,938,0,0,1,1
2582752,2583682,930,0,0,1,2
2583682,2583741,59,1,0,0,1
2583683,2583739,56,1,0,0,2
2583740,2583866,126,0,0,1,2
2583742,2583866,124,0,0,1,1
2583867,2583923,56,1,0,0,1
2583867,2583937,70,1,0,0,2
2583924,2584043,119,0,0,1,1
2583938,2584044,106,0,0,1,2
2584044,2584074,30,1,0,0,1
2584045,2584074,29,1,0,0,2
2584075,2584297,222,0,0,1,2
2584075,2584302,227,0,0,1,1
2584298,2584316,18,1,0,0,2
2584303,2584315,12,1,0,0,1
2584316,2585160,844,0,0,1,1
2584317,2585160,843,0,0,1,2
2585161,2585199,38,1,0,0,1
2585161,2585199,38,1,0,0,2
2585200,2585586,386,0,0,1,1
2585200,2585586,386,0,0,1,2
2585587,2585609,22,1,0,0,2
2585587,2585610,23,1,0,0,1
2585610,2586282,672,0,0,1,2
2585611,2586283,672,0,0,1,1
2586283,2586308,25,1,0,0,2
2586284,2586308,24,1,0,0,1
2586309,2587547,1238,0,0,1,2
2586309,2587548,1239,0,0,1,1
2587548,2587586,38,1,0,0,2
2587549,2587587,38,1,0,0,1
2587587,2588022,435,0,0,1,2
2587588,2588023,435,0,0,1,1
2588023,2588063,40,1,0,0,2
2588024,2588061,37,1,0,0,1
2588062,2588512,450,0,0,1,1
2588064,2588513,449,0,0,1,2
2588513,2588601,88,1,0,0,1
2588514,2588590,76,1,0,0,2
2588591,2588700,109,0,0,1,2
2588602,2588699,97,0,0,1,1
2588700,2588750,50,1,0,0,1
2588701,2588728,27,1,0,0,2
2588729,2589464,735,0,0,1,2
2588751,2590239,1488,0,0,1,1
2589465,2589497,32,1,0,0,2
2589498,2589600,102,0,0,1,2
2589601,2589672,71,1,0,0,2
2589673,2589705,32,0,0,1,2
2589706,2589966,260,1,0,0,2
2589967,2590104,137,0,0,1,2
2590105,2590286,181,1,0,0,2
2590240,2590283,43,1,0,0,1
2590284,2590433,149,0,0,1,1
2590287,2590433,146,0,0,1,2
2590434,2590456,22,1,0,0,2
2590434,2590459,25,1,0,0,1
2590457,2592472,2015,0,0,1,2
2590460,2592474,2014,0,0,1,1
2592473,2592547,74,1,0,0,2
2592475,2592525,50,1,0,0,1
2592526,2592944,418,0,0,1,1
2592548,2592945,397,0,0,1,2
2592945,2592985,40,1,0,0,1
2592946,2592994,48,1,0,0,2
2592986,2593647,661,0,0,1,1
2592995,2593648,653,0,0,1,2
2593648,2593691,43,1,0,0,1
2593649,2593701,52,1,0,0,2
2593692,2593892,200,0,0,1,1
2593702,2593892,190,0,0,1,2
2593893,2593946,53,1,0,0,1
2593893,2593949,56,1,0,0,2
2593947,2594140,193,0,0,1,1
2593950,2594144,194,0,0,1,2
2594141,2594155,14,1,0,0,1
2594145,2594153,8,1,0,0,2
2594154,2595244,1090,0,0,1,2
2594156,2595246,1090,0,0,1,1
2595245,2595287,42,1,0,0,2
2595247,2595278,31,1,0,0,1
2595279,2595379,100,0,0,1,1
2595288,2595380,92,0,0,1,2
2595380,2595451,71,1,0,0,1
2595381,2595451,70,1,0,0,2
2595452,2597539,2087,0,0,1,2
2595452,2597541,2089,0,0,1,1
2597540,2597618,78,1,0,0,2
2597542,2597615,73,1,0,0,1
2597616,2598340,724,0,0,1,1
2597619,2598340,721,0,0,1,2
2598341,2598378,37,1,0,0,1
2598341,2598385,44,1,0,0,2
2598379,2598766,387,0,0,1,1
2598386,2598633,247,0,0,1,2
2598634,2598652,18,1,0,0,2
2598653,2598754,101,0,0,1,2
2598755,2598812,57,1,0,0,2
2598767,2598813,46,1,0,0,1
2598813,2599177,364,0,0,1,2
2598814,2599178,364,0,0,1,1
2599178,2599198,20,1,0,0,2
2599179,2599198,19,1,0,0,1
2599199,2600627,1428,0,0,1,2
2599199,2600628,1429,0,0,1,1
2600628,2600700,72,1,0,0,2
2600629,2600696,67,1,0,0,1
2600697,2601026,329,0,0,1,1
2600701,2601022,321,0,0,1,2
2601023,2601429,406,1,0,0,2
2601027,2601426,399,1,0,0,1
2601045,2601415,370,0,1,0,1
2601048,2601418,370,0,1,0,2
2601427,2601481,54,0,0,1,1
2601430,2601482,52,0,0,1,2
2601482,2601787,305,1,0,0,1
2601483,2601758,275,1,0,0,2
2601502,2601776,274,0,1,0,1
2601509,2601726,217,0,1,0,2
2601759,2602368,609,0,0,1,2
2601788,2602368,580,0,0,1,1
2602369,2602390,21,1,0,0,1
2602369,2602398,29,1,0,0,2
2602391,2602952,561,0,0,1,1
2602399,2602950,551,0,0,1,2
2602951,2603020,69,1,0,0,2
2602953,2603015,62,1,0,0,1
2603016,2603273,257,0,0,1,1
2603021,2603272,251,0,0,1,2
2603273,2603316,43,1,0,0,2
2603274,2603305,31,1,0,0,1
2603306,2603616,310,0,0,1,1
2603317,2603617,300,0,0,1,2
2603617,2603659,42,1,0,0,1
2603618,2603655,37,1,0,0,2
2603656,2604157,501,0,0,1,2
2603660,2604159,499,0,0,1,1
2604158,2604216,58,1,0,0,2
2604160,2604229,69,1,0,0,1
2604217,2604378,161,0,0,1,2
2604230,2604377,147,0,0,1,1
2604378,2604408,30,1,0,0,1
2604379,2604406,27,1,0,0,2
2604407,2605810,1403,0,0,1,2
2604409,2605808,1399,0,0,1,1
2605809,2605879,70,1,0,0,1
2605811,2605902,91,1,0,0,2
2605880,2606250,370,0,0,1,1
2605903,2606041,138,0,0,1,2
2606042,2606110,68,1,0,0,2
2606111,2606246,135,0,0,1,2
2606247,2606298,51,1,0,0,2
2606251,2606277,26,1,0,0,1
2606278,2606819,541,0,0,1,1
2606299,2606799,500,0,0,1,2
2606800,2606836,36,1,0,0,2
2606820,2606836,16,1,0,0,1
2606837,2607543,706,0,0,1,2
2606837,2607544,707,0,0,1,1
2607544,2607590,46,1,0,0,2
2607545,2607578,33,1,0,0,1
2607579,2608141,562,0,0,1,1
2607591,2608140,549,0,0,1,2
2608141,2608191,50,1,0,0,2
2608142,2608180,38,1,0,0,1
2608181,2608458,277,0,0,1,1
2608192,2608459,267,0,0,1,2
2608459,2608505,46,1,0,0,1
2608460,2608510,50,1,0,0,2
2608506,2609209,703,0,0,1,1
2608511,2609210,699,0,0,1,2
2609210,2609252,42,1,0,0,1
2609211,2609265,54,1,0,0,2
2609253,2609642,389,0,0,1,1
2609266,2609641,375,0,0,1,2
2609642,2609698,56,1,0,0,2
2609643,2609697,54,1,0,0,1
2609698,2609822,124,0,0,1,1
2609699,2609822,123,0,0,1,2
2609823,2609891,68,1,0,0,1
2609823,2609893,70,1,0,0,2
2609892,2610063,171,0,0,1,1
2609894,2610064,170,0,0,1,2
2610064,2610089,25,1,0,0,1
2610065,2610084,19,1,0,0,2
2610085,2610436,351,0,0,1,2
2610090,2611185,1095,0,0,1,1
2610437,2610456,19,1,0,0,2
2610457,2610524,67,0,0,1,2
2610525,2610553,28,1,0,0,2
2610554,2610586,32,0,0,1,2
2610587,2610600,13,1,0,0,2
2610601,2610797,196,0,0,1,2
2610798,2610802,4,1,0,0,2
2610803,2610846,43,0,0,1,2
2610847,2610935,88,1,0,0,2
2610936,2610991,55,0,0,1,2
2610992,2611007,15,1,0,0,2
2611008,2611186,178,0,0,1,2
2611186,2611227,41,1,0,0,1
2611187,2611227,40,1,0,0,2
2611228,2611538,310,0,0,1,1
2611228,2611540,312,0,0,1,2
2611539,2611566,27,1,0,0,1
2611541,2611566,25,1,0,0,2
2611567,2612680,1113,0,0,1,1
2611567,2613457,1890,0,0,1,2
2612681,2612742,61,1,0,0,1
2612743,2613121,378,0,0,1,1
2613122,2613135,13,1,0,0,1
2613136,2613455,319,0,0,1,1
2613456,2613517,61,1,0,0,1
2613458,2613521,63,1,0,0,2
2613518,2613759,241,0,0,1,1
2613522,2613759,237,0,0,1,2
2613760,2613810,50,1,0,0,1
2613760,2613813,53,1,0,0,2
2613811,2614255,444,0,0,1,1
2613814,2614088,274,0,0,1,2
2614089,2614140,51,1,0,0,2
2614141,2614190,49,0,0,1,2
2614191,2614197,6,1,0,0,2
2614198,2614255,57,0,0,1,2
2614256,2614285,29,1,0,0,1
2614256,2614287,31,1,0,0,2
2614286,2614841,555,0,0,1,1
2614288,2614841,553,0,0,1,2
2614842,2614930,88,1,0,0,1
2614842,2614939,97,1,0,0,2
2614931,2615352,421,0,0,1,1
2614940,2615352,412,0,0,1,2
2615353,2615373,20,1,0,0,1
2615353,2615382,29,1,0,0,2
2615374,2615822,448,0,0,1,1
2615383,2615821,438,0,0,1,2
2615822,2615868,46,1,0,0,2
2615823,2615857,34,1,0,0,1
2615858,2616480,622,0,0,1,1
2615869,2616486,617,0,0,1,2
2616481,2616505,24,1,0,0,1
2616487,2616505,18,1,0,0,2
2616506,2616810,304,0,0,1,1
2616506,2616812,306,0,0,1,2
2616811,2616833,22,1,0,0,1
2616813,2616836,23,1,0,0,2
2616834,2618291,1457,0,0,1,1
2616837,2618289,1452,0,0,1,2
2618290,2618321,31,1,0,0,2
2618292,2618319,27,1,0,0,1
2618320,2619575,1255,0,0,1,1
2618322,2618877,555,0,0,1,2
2618878,2618928,50,1,0,0,2
2618929,2619582,653,0,0,1,2
2619576,2619654,78,1,0,0,1
2619583,2619652,69,1,0,0,2
2619653,2620116,463,0,0,1,2
2619655,2620118,463,0,0,1,1
2620117,2620141,24,1,0,0,2
2620119,2620146,27,1,0,0,1
2620142,2620428,286,0,0,1,2
2620147,2620439,292,0,0,1,1
2620429,2621020,591,1,0,0,2
2620440,2621057,617,1,0,0,1
2620467,2620801,334,0,1,0,2
2620467,2621046,579,0,1,0,1
2620854,2620985,131,0,1,0,2
2621021,2621051,30,0,0,1,2
2621052,2621074,22,1,0,0,2
2621058,2621437,379,0,0,1,1
2621075,2621436,361,0,0,1,2
2621437,2621461,24,1,0,0,2
2621438,2621464,26,1,0,0,1
2621462,2621947,485,0,0,1,2
2621465,2621947,482,0,0,1,1
2621948,2621986,38,1,0,0,2
2621948,2621987,39,1,0,0,1
2621987,2622263,276,0,0,1,2
2621988,2622262,274,0,0,1,1
2622263,2622304,41,1,0,0,1
2622264,2622343,79,1,0,0,2
2622305,2622619,314,0,0,1,1
2622344,2622371,27,0,0,1,2
2622372,2622481,109,1,0,0,2
2622482,2622624,142,0,0,1,2
2622620,2622661,41,1,0,0,1
2622625,2622675,50,1,0,0,2
2622662,2622860,198,0,0,1,1
2622676,2622861,185,0,0,1,2
2622861,2622899,38,1,0,0,1
2622862,2622911,49,1,0,0,2
2622900,2623061,161,0,0,1,1
2622912,2623068,156,0,0,1,2
2623062,2623080,18,1,0,0,1
2623069,2623081,12,1,0,0,2
2623081,2623616,535,0,0,1,1
2623082,2623611,529,0,0,1,2
2623612,2623629,17,1,0,0,2
2623617,2623628,11,1,0,0,1
2623629,2623912,283,0,0,1,1
2623630,2623912,282,0,0,1,2
2623913,2623966,53,1,0,0,1
2623913,2623990,77,1,0,0,2
2623967,2624467,500,0,0,1,1
2623991,2624468,477,0,0,1,2
2624468,2624492,24,1,0,0,1
2624469,2624561,92,1,0,0,2
2624493,2624850,357,0,0,1,1
2624562,2624583,21,0,0,1,2
2624584,2624875,291,1,0,0,2
2624851,2624874,23,1,0,0,1
2624875,2625430,555,0,0,1,1
2624876,2625062,186,0,0,1,2
2625063,2625088,25,1,0,0,2
2625089,2625115,26,0,0,1,2
2625116,2625144,28,1,0,0,2
2625145,2625230,85,0,0,1,2
2625231,2625336,105,1,0,0,2
2625337,2625390,53,0,0,1,2
2625391,2625477,86,1,0,0,2
2625431,2625462,31,1,0,0,1
2625463,2625869,406,0,0,1,1
2625478,2625537,59,0,0,1,2
2625538,2625910,372,1,0,0,2
2625870,2625907,37,1,0,0,1
2625908,2626097,189,0,0,1,1
2625911,2625936,25,0,0,1,2
2625937,2626172,235,1,0,0,2
2626098,2626170,72,1,0,0,1
2626171,2626536,365,0,0,1,1
2626173,2626537,364,0,0,1,2
2626537,2626565,28,1,0,0,1
2626538,2626563,25,1,0,0,2
2626564,2627137,573,0,0,1,2
2626566,2627138,572,0,0,1,1
2627138,2627201,63,1,0,0,2
2627139,2627206,67,1,0,0,1
2627202,2627321,119,0,0,1,2
2627207,2627318,111,0,0,1,1
2627319,2627352,33,1,0,0,1
2627322,2627360,38,1,0,0,2
2627353,2627943,590,0,0,1,1
2627361,2627944,583,0,0,1,2
2627944,2627965,21,1,0,0,1
2627945,2627965,20,1,0,0,2
2627966,2628221,255,0,0,1,1
2627966,2628222,256,0,0,1,2
2628222,2628283,61,1,0,0,1
2628223,2628280,57,1,0,0,2
2628281,2629110,829,0,0,1,2
2628284,2629110,826,0,0,1,1
2629111,2629147,36,1,0,0,1
2629111,2629147,36,1,0,0,2
2629148,2629851,703,0,0,1,1
2629148,2629851,703,0,0,1,2
2629852,2629881,29,1,0,0,2
2629852,2629882,30,1,0,0,1
2629882,2630348,466,0,0,1,2
2629883,2630348,465,0,0,1,1
2630349,2630404,55,1,0,0,1
2630349,2630418,69,1,0,0,2
2630405,2630875,470,0,0,1,1
2630419,2630875,456,0,0,1,2
2630876,2630912,36,1,0,0,1
2630876,2630912,36,1,0,0,2
2630913,2631582,669,0,0,1,1
2630913,2631582,669,0,0,1,2
2631583,2631635,52,1,0,0,1
2631583,2631657,74,1,0,0,2
2631636,2631751,115,0,0,1,1
2631658,2631755,97,0,0,1,2
2631752,2631784,32,1,0,0,1
2631756,2631797,41,1,0,0,2
2631785,2632042,257,0,0,1,1
2631798,2632044,246,0,0,1,2
2632043,2632058,15,1,0,0,1
2632045,2632068,23,1,0,0,2
2632059,2633328,1269,0,0,1,1
2632069,2633330,1261,0,0,1,2
2633329,2633377,48,1,0,0,1
2633331,2633384,53,1,0,0,2
2633378,2634921,1543,0,0,1,1
2633385,2634921,1536,0,0,1,2
2634922,2634946,24,1,0,0,1
2634922,2634946,24,1,0,0,2
2634947,2636011,1064,0,0,1,1
2634947,2636012,1065,0,0,1,2
2636012,2636051,39,1,0,0,1
2636013,2636063,50,1,0,0,2
2636052,2636593,541,0,0,1,1
2636064,2636594,530,0,0,1,2
2636594,2636648,54,1,0,0,1
2636595,2636660,65,1,0,0,2
2636649,2636981,332,0,0,1,1
2636661,2636983,322,0,0,1,2
2636982,2637039,57,1,0,0,1
2636984,2637049,65,1,0,0,2
2637040,2637147,107,0,0,1,1
2637050,2637146,96,0,0,1,2
2637147,2637224,77,1,0,0,2
2637148,2637225,77,1,0,0,1
2637225,2637330,105,0,0,1,2
2637226,2637331,105,0,0,1,1
2637331,2637363,32,1,0,0,2
2637332,2637368,36,1,0,0,1
2637364,2637611,247,0,0,1,2
2637369,2637612,243,0,0,1,1
2637612,2637634,22,1,0,0,2
2637613,2637639,26,1,0,0,1
2637635,2638233,598,0,0,1,2
2637640,2638234,594,0,0,1,1
2638234,2638289,55,1,0,0,2
2638235,2638278,43,1,0,0,1
2638279,2638484,205,0,0,1,1
2638290,2638479,189,0,0,1,2
2638480,2638500,20,1,0,0,2
2638485,2638494,9,1,0,0,1
2638495,2639100,605,0,0,1,1
2638501,2639100,599,0,0,1,2
2639101,2639122,21,1,0,0,1
2639101,2639127,26,1,0,0,2
2639123,2640379,1256,0,0,1,1
2639128,2640377,1249,0,0,1,2
2640378,2640421,43,1,0,0,2
2640380,2640413,33,1,0,0,1
2640414,2641450,1036,0,0,1,1
2640422,2641449,1027,0,0,1,2
2641450,2641526,76,1,0,0,2
2641451,2641523,72,1,0,0,1
2641524,2641678,154,0,0,1,1
2641527,2641679,152,0,0,1,2
2641679,2641707,28,1,0,0,1
2641680,2641708,28,1,0,0,2
2641708,2642747,1039,0,0,1,1
2641709,2642746,1037,0,0,1,2
2642747,2642790,43,1,0,0,2
2642748,2642790,42,1,0,0,1
2642791,2643258,467,0,0,1,1
2642791,2643258,467,0,0,1,2
2643259,2643285,26,1,0,0,2
2643259,2643287,28,1,0,0,1
2643286,2645972,2686,0,0,1,2
2643288,2645971,2683,0,0,1,1
2645972,2646019,47,1,0,0,1
2645973,2646032,59,1,0,0,2
2646020,2646146,126,0,0,1,1
2646033,2646149,116,0,0,1,2
2646147,2646174,27,1,0,0,1
2646150,2646175,25,1,0,0,2
2646175,2647427,1252,0,0,1,1
2646176,2647428,1252,0,0,1,2
2647428,2647499,71,1,0,0,1
2647429,2647504,75,1,0,0,2
2647500,2647980,480,0,0,1,1
2647505,2647981,476,0,0,1,2
2647981,2647997,16,1,0,0,1
2647982,2648009,27,1,0,0,2
2647998,2648836,838,0,0,1,1
2648010,2648834,824,0,0,1,2
2648835,2648860,25,1,0,0,2
2648837,2648858,21,1,0,0,1
2648859,2649569,710,0,0,1,1
2648861,2649569,708,0,0,1,2
2649570,2649596,26,1,0,0,1
2649570,2649606,36,1,0,0,2
2649597,2649939,342,0,0,1,1
2649607,2649939,332,0,0,1,2
2649940,2649996,56,1,0,0,1
2649940,2649996,56,1,0,0,2
2649997,2650349,352,0,0,1,1
2649997,2650352,355,0,0,1,2
2650350,2650383,33,1,0,0,1
2650353,2650385,32,1,0,0,2
2650384,2651094,710,0,0,1,1
2650386,2651092,706,0,0,1,2
2651093,2651171,78,1,0,0,2
2651095,2651160,65,1,0,0,1
2651161,2651351,190,0,0,1,1
2651172,2651352,180,0,0,1,2
2651352,2651369,17,1,0,0,1
2651353,2651372,19,1,0,0,2
2651370,2652502,1132,0,0,1,1
2651373,2652503,1130,0,0,1,2
2652503,2652558,55,1,0,0,1
2652504,2652566,62,1,0,0,2
2652559,2652805,246,0,0,1,1
2652567,2652804,237,0,0,1,2
2652805,2652831,26,1,0,0,2
2652806,2652832,26,1,0,0,1
2652832,2653764,932,0,0,1,2
2652833,2653759,926,0,0,1,1
2653760,2653786,26,1,0,0,1
2653765,2653795,30,1,0,0,2
2653787,2654873,1086,0,0,1,1
2653796,2654873,1077,0,0,1,2
2654874,2654922,48,1,0,0,1
2654874,2654932,58,1,0,0,2
2654923,2655131,208,0,0,1,1
2654933,2655131,198,0,0,1,2
2655132,2655180,48,1,0,0,1
2655132,2655192,60,1,0,0,2
2655181,2655449,268,0,0,1,1
2655193,2655449,256,0,0,1,2
2655450,2655506,56,1,0,0,1
2655450,2655513,63,1,0,0,2
2655507,2655945,438,0,0,1,1
2655514,2655943,429,0,0,1,2
2655944,2655998,54,1,0,0,2
2655946,2655990,44,1,0,0,1
2655991,2656194,203,0,0,1,1
2655999,2656194,195,0,0,1,2
2656195,2656281,86,1,0,0,2
2656195,2656283,88,1,0,0,1
2656282,2656425,143,0,0,1,2
2656284,2656424,140,0,0,1,1
2656425,2656460,35,1,0,0,1
2656426,2656463,37,1,0,0,2
2656461,2657807,1346,0,0,1,1
2656464,2657808,1344,0,0,1,2
2657808,2657878,70,1,0,0,1
2657809,2657881,72,1,0,0,2
2657879,2658078,199,0,0,1,1
2657882,2658075,193,0,0,1,2
2658076,2658104,28,1,0,0,2
2658079,2658101,22,1,0,0,1
2658102,2658704,602,0,0,1,1
2658105,2658704,599,0,0,1,2
2658705,2658726,21,1,0,0,1
2658705,2658735,30,1,0,0,2
2658727,2659585,858,0,0,1,1
2658736,2659587,851,0,0,1,2
2659586,2659609,23,1,0,0,1
2659588,2659609,21,1,0,0,2
2659610,2660307,697,0,0,1,2
2659610,2660308,698,0,0,1,1
2660308,2660343,35,1,0,0,2
2660309,2660339,30,1,0,0,1
2660340,2660856,516,0,0,1,1
2660344,2660852,508,0,0,1,2
2660853,2660893,40,1,0,0,2
2660857,2660884,27,1,0,0,1
2660885,2661616,731,0,0,1,1
2660894,2661616,722,0,0,1,2
2661617,2661664,47,1,0,0,2
2661617,2661667,50,1,0,0,1
2661665,2661856,191,0,0,1,2
2661668,2661856,188,0,0,1,1
2661857,2661873,16,1,0,0,1
2661857,2661876,19,1,0,0,2
2661874,2663338,1464,0,0,1,1
2661877,2663339,1462,0,0,1,2
2663339,2663394,55,1,0,0,1
2663340,2663385,45,1,0,0,2
2663386,2663559,173,0,0,1,2
2663395,2663556,161,0,0,1,1
2663557,2663585,28,1,0,0,1
2663560,2663593,33,1,0,0,2
2663586,2664462,876,0,0,1,1
2663594,2664463,869,0,0,1,2
2664463,2664484,21,1,0,0,1
2664464,2664484,20,1,0,0,2
2664485,2664862,377,0,0,1,2
2664485,2664868,383,0,0,1,1
2664863,2664883,20,1,0,0,2
2664869,2664881,12,1,0,0,1
2664882,2665582,700,0,0,1,1
2664884,2665581,697,0,0,1,2
2665582,2665626,44,1,0,0,2
2665583,2665616,33,1,0,0,1
2665617,2665998,381,0,0,1,1
2665627,2665998,371,0,0,1,2
2665999,2666029,30,1,0,0,2
2665999,2666033,34,1,0,0,1
2666030,2666340,310,0,0,1,2
2666034,2666333,299,0,0,1,1
2666334,2666370,36,1,0,0,1
2666341,2666371,30,1,0,0,2
2666371,2667030,659,0,0,1,1
2666372,2667033,661,0,0,1,2
2667031,2667067,36,1,0,0,1
2667034,2667068,34,1,0,0,2
2667068,2667435,367,0,0,1,1
2667069,2667433,364,0,0,1,2
2667434,2667550,116,1,0,0,2
2667436,2667532,96,1,0,0,1
2667533,2667653,120,0,0,1,1
2667551,2667622,71,0,0,1,2
2667623,2667686,63,1,0,0,2
2667654,2667687,33,1,0,0,1
2667687,2667807,120,0,0,1,2
2667688,2668534,846,0,0,1,1
2667808,2667903,95,1,0,0,2
2667904,2668536,632,0,0,1,2
2668535,2668572,37,1,0,0,1
2668537,2668581,44,1,0,0,2
2668573,2670662,2089,0,0,1,1
2668582,2670661,2079,0,0,1,2
2670662,2670737,75,1,0,0,2
2670663,2670706,43,1,0,0,1
2670707,2670921,214,0,0,1,1
2670738,2670871,133,0,0,1,2
2670872,2670976,104,1,0,0,2
2670922,2670965,43,1,0,0,1
2670966,2671242,276,0,0,1,1
2670977,2671243,266,0,0,1,2
2671243,2671284,41,1,0,0,1
2671244,2671286,42,1,0,0,2
2671285,2671802,517,0,0,1,1
2671287,2671803,516,0,0,1,2
2671803,2671872,69,1,0,0,1
2671804,2671889,85,1,0,0,2
2671873,2672003,130,0,0,1,1
2671890,2672003,113,0,0,1,2
2672004,2672028,24,1,0,0,1
2672004,2672028,24,1,0,0,2
2672029,2672497,468,0,0,1,1
2672029,2672498,469,0,0,1,2
2672498,2672516,18,1,0,0,1
2672499,2672512,13,1,0,0,2
2672513,2673528,1015,0,0,1,2
2672517,2673528,1011,0,0,1,1
2673529,2673560,31,1,0,0,1
2673529,2673565,36,1,0,0,2
2673561,2673901,340,0,0,1,1
2673566,2673901,335,0,0,1,2
2673902,2673935,33,1,0,0,2
2673902,2673936,34,1,0,0,1
2673936,2674284,348,0,0,1,2
2673937,2675529,1592,0,0,1,1
2674285,2674319,34,1,0,0,2
2674320,2674628,308,0,0,1,2
2674629,2674649,20,1,0,0,2
2674650,2674802,152,0,0,1,2
2674803,2674825,22,1,0,0,2
2674826,2675530,704,0,0,1,2
2675530,2675552,22,1,0,0,1
2675531,2675553,22,1,0,0,2
2675553,2676300,747,0,0,1,1
2675554,2676300,746,0,0,1,2
2676301,2676331,30,1,0,0,1
2676301,2676332,31,1,0,0,2
2676332,2677236,904,0,0,1,1
2676333,2677237,904,0,0,1,2
2677237,2677262,25,1,0,0,1
2677238,2677264,26,1,0,0,2
2677263,2677624,361,0,0,1,1
2677265,2677625,360,0,0,1,2
2677625,2677702,77,1,0,0,1
2677626,2677725,99,1,0,0,2
2677703,2677820,117,0,0,1,1
2677726,2677823,97,0,0,1,2
2677821,2677851,30,1,0,0,1
2677824,2677891,67,1,0,0,2
2677852,2679203,1351,0,0,1,1
2677892,2677917,25,0,0,1,2
2677918,2677969,51,1,0,0,2
2677970,2678051,81,0,0,1,2
2678052,2678096,44,1,0,0,2
2678097,2678179,82,0,0,1,2
2678180,2678201,21,1,0,0,2
2678202,2678370,168,0,0,1,2
2678371,2678382,11,1,0,0,2
2678383,2678406,23,0,0,1,2
2678407,2678435,28,1,0,0,2
2678436,2678456,20,0,0,1,2
2678457,2678522,65,1,0,0,2
2678523,2678566,43,0,0,1,2
2678567,2678621,54,1,0,0,2
2678622,2678925,303,0,0,1,2
2678926,2678954,28,1,0,0,2
2678955,2679166,211,0,0,1,2
2679167,2679264,97,1,0,0,2
2679204,2679250,46,1,0,0,1
2679251,2680919,1668,0,0,1,1
2679265,2680922,1657,0,0,1,2
2680920,2680941,21,1,0,0,1
2680923,2680942,19,1,0,0,2
2680942,2681607,665,0,0,1,1
2680943,2681609,666,0,0,1,2
2681608,2681669,61,1,0,0,1
2681610,2681667,57,1,0,0,2
2681668,2682048,380,0,0,1,2
2681670,2682049,379,0,0,1,1
2682049,2682147,98,1,0,0,2
2682050,2682144,94,1,0,0,1
2682145,2682451,306,0,0,1,1
2682148,2682451,303,0,0,1,2
2682452,2682498,46,1,0,0,2
2682452,2682503,51,1,0,0,1
2682499,2682707,208,0,0,1,2
2682504,2682706,202,0,0,1,1
2682707,2682732,25,1,0,0,1
2682708,2682735,27,1,0,0,2
2682733,2683089,356,0,0,1,1
2682736,2683084,348,0,0,1,2
2683085,2683100,15,1,0,0,2
2683090,2683100,10,1,0,0,1
2683101,2684522,1421,0,0,1,2
2683101,2684523,1422,0,0,1,1
2684523,2684571,48,1,0,0,2
2684524,2684574,50,1,0,0,1
2684572,2684815,243,0,0,1,2
2684575,2685291,716,0,0,1,1
2684816,2684829,13,1,0,0,2
2684830,2685292,462,0,0,1,2
2685292,2685319,27,1,0,0,1
2685293,2685329,36,1,0,0,2
2685320,2686035,715,0,0,1,1
2685330,2686032,702,0,0,1,2
2686033,2686075,42,1,0,0,2
2686036,2686074,38,1,0,0,1
2686075,2686960,885,0,0,1,1
2686076,2686962,886,0,0,1,2
2686961,2687004,43,1,0,0,1
2686963,2687006,43,1,0,0,2
2687005,2687335,330,0,0,1,1
2687007,2687337,330,0,0,1,2
2687336,2687374,38,1,0,0,1
2687338,2687388,50,1,0,0,2
2687375,2688271,896,0,0,1,1
2687389,2688272,883,0,0,1,2
2688272,2688304,32,1,0,0,1
2688273,2688315,42,1,0,0,2
2688305,2688575,270,0,0,1,1
2688316,2688574,258,0,0,1,2
2688575,2688623,48,1,0,0,2
2688576,2688612,36,1,0,0,1
2688613,2688984,371,0,0,1,1
2688624,2688984,360,0,0,1,2
2688985,2688998,13,1,0,0,1
2688985,2689000,15,1,0,0,2
2688999,2690382,1383,0,0,1,1
2689001,2690380,1379,0,0,1,2
2690381,2690456,75,1,0,0,2
2690383,2690457,74,1,0,0,1
2690457,2690713,256,0,0,1,2
2690458,2690716,258,0,0,1,1
2690714,2690816,102,1,0,0,2
2690717,2690817,100,1,0,0,1
2690743,2690786,43,0,1,0,1
2690750,2690776,26,0,1,0,2
2690817,2690949,132,0,0,1,2
2690818,2690955,137,0,0,1,1
2690950,2691204,254,1,0,0,2
2690956,2691215,259,1,0,0,1
2690974,2691173,199,0,1,0,1
2690977,2691155,178,0,1,0,2
2691205,2691686,481,0,0,1,2
2691216,2691686,470,0,0,1,1
2691687,2691708,21,1,0,0,2
2691687,2691710,23,1,0,0,1
2691709,2692563,854,0,0,1,2
2691711,2692562,851,0,0,1,1
2692563,2692630,67,1,0,0,1
2692564,2692630,66,1,0,0,2
2692631,2693094,463,0,0,1,2
2692631,2693097,466,0,0,1,1
2693095,2693139,44,1,0,0,2
2693098,2693130,32,1,0,0,1
2693131,2693480,349,0,0,1,1
2693140,2693481,341,0,0,1,2
2693481,2693521,40,1,0,0,1
2693482,2693529,47,1,0,0,2
2693522,2693954,432,0,0,1,1
2693530,2693954,424,0,0,1,2
2693955,2694002,47,1,0,0,1
2693955,2694009,54,1,0,0,2
2694003,2694289,286,0,0,1,1
2694010,2694289,279,0,0,1,2
2694290,2694371,81,1,0,0,1
2694290,2694379,89,1,0,0,2
2694372,2694498,126,0,0,1,1
2694380,2694495,115,0,0,1,2
2694496,2694518,22,1,0,0,2
2694499,2694515,16,1,0,0,1
2694516,2695677,1161,0,0,1,1
2694519,2695675,1156,0,0,1,2
2695676,2695722,46,1,0,0,2
2695678,2695714,36,1,0,0,1
2695715,2695968,253,0,0,1,1
2695723,2695780,57,0,0,1,2
2695781,2695787,6,1,0,0,2
2695788,2695970,182,0,0,1,2
2695969,2696017,48,1,0,0,1
2695971,2696082,111,1,0,0,2
2696018,2698327,2309,0,0,1,1
2696083,2696179,96,0,0,1,2
2696180,2696246,66,1,0,0,2
2696247,2696308,61,0,0,1,2
2696309,2696357,48,1,0,0,2
2696358,2696389,31,0,0,1,2
2696390,2696560,170,1,0,0,2
2696561,2696586,25,0,0,1,2
2696587,2696954,367,1,0,0,2
2696955,2697101,146,0,0,1,2
2697102,2697115,13,1,0,0,2
2697116,2697796,680,0,0,1,2
2697797,2697824,27,1,0,0,2
2697825,2698326,501,0,0,1,2
2698327,2698397,70,1,0,0,2
2698328,2698375,47,1,0,0,1
2698376,2698730,354,0,0,1,1
2698398,2698729,331,0,0,1,2
2698730,2698781,51,1,0,0,2
2698731,2698765,34,1,0,0,1
2698766,2699383,617,0,0,1,1
2698782,2699385,603,0,0,1,2
2699384,2699435,51,1,0,0,1
2699386,2699437,51,1,0,0,2
2699436,2699880,444,0,0,1,1
2699438,2699877,439,0,0,1,2
2699878,2699957,79,1,0,0,2
2699881,2699945,64,1,0,0,1
2699946,2700062,116,0,0,1,1
2699958,2700062,104,0,0,1,2
2700063,2700089,26,1,0,0,2
2700063,2700093,30,1,0,0,1
2700090,2701195,1105,0,0,1,2
2700094,2701196,1102,0,0,1,1
2701196,2701273,77,1,0,0,2
2701197,2701261,64,1,0,0,1
2701262,2701776,514,0,0,1,1
2701274,2701777,503,0,0,1,2
2701777,2701809,32,1,0,0,1
2701778,2701801,23,1,0,0,2
2701802,2702363,561,0,0,1,2
2701810,2702362,552,0,0,1,1
2702363,2702386,23,1,0,0,1
2702364,2702397,33,1,0,0,2
2702387,2703428,1041,0,0,1,1
2702398,2703422,1024,0,0,1,2
2703423,2703472,49,1,0,0,2
2703429,2703464,35,1,0,0,1
2703465,2703702,237,0,0,1,1
2703473,2703702,229,0,0,1,2
2703703,2703741,38,1,0,0,2
2703703,2703744,41,1,0,0,1
2703742,2704530,788,0,0,1,2
2703745,2704529,784,0,0,1,1
2704530,2704563,33,1,0,0,1
2704531,2704562,31,1,0,0,2
2704563,2704867,304,0,0,1,2
2704564,2704867,303,0,0,1,1
2704868,2704936,68,1,0,0,1
2704868,2704947,79,1,0,0,2
2704937,2705061,124,0,0,1,1
2704948,2705062,114,0,0,1,2
2705062,2705105,43,1,0,0,1
2705063,2705106,43,1,0,0,2
2705106,2705427,321,0,0,1,1
2705107,2705422,315,0,0,1,2
2705423,2705448,25,1,0,0,2
2705428,2705448,20,1,0,0,1
2705449,2706529,1080,0,0,1,2
2705449,2706531,1082,0,0,1,1
2706530,2706582,52,1,0,0,2
2706532,2706585,53,1,0,0,1
2706583,2706984,401,0,0,1,2
2706586,2706984,398,0,0,1,1
2706985,2707005,20,1,0,0,1
2706985,2707006,21,1,0,0,2
2707006,2708664,1658,0,0,1,1
2707007,2708664,1657,0,0,1,2
2708665,2708717,52,1,0,0,2
2708665,2708728,63,1,0,0,1
2708718,2708963,245,0,0,1,2
2708729,2708965,236,0,0,1,1
2708964,2709017,53,1,0,0,2
2708966,2709008,42,1,0,0,1
2709009,2709153,144,0,0,1,1
2709018,2709151,133,0,0,1,2
2709152,2709203,51,1,0,0,2
2709154,2709211,57,1,0,0,1
2709204,2709733,529,0,0,1,2
2709212,2709731,519,0,0,1,1
2709732,2709765,33,1,0,0,1
2709734,2709771,37,1,0,0,2
2709766,2710338,572,0,0,1,1
2709772,2710338,566,0,0,1,2
2710339,2710382,43,1,0,0,1
2710339,2710383,44,1,0,0,2
2710383,2710479,96,0,0,1,1
2710384,2710480,96,0,0,1,2
2710480,2710531,51,1,0,0,1
2710481,2710546,65,1,0,0,2
2710532,2711220,688,0,0,1,1
2710547,2711218,671,0,0,1,2
2711219,2737852,26633,1,0,0,2
2711221,2737865,26644,1,0,0,1
2711261,2737840,26579,0,1,0,2
2711263,2737841,26578,0,1,0,1
2737853,2737973,120,0,0,1,2
2737866,2737931,65,0,0,1,1
2737932,2737937,5,1,0,0,1
2737938,2737975,37,0,0,1,1
2737974,2738015,41,1,0,0,2
2737976,2738019,43,1,0,0,1
2738016,2738278,262,0,0,1,2
2738020,2738279,259,0,0,1,1
2738279,2738312,33,1,0,0,2
2738280,2738312,32,1,0,0,1
2738313,2738544,231,0,0,1,2
2738313,2738559,246,0,0,1,1
2738545,2739806,1261,1,0,0,2
2738560,2739788,1228,1,0,0,1
2738579,2739777,1198,0,1,0,1
2738580,2739742,1162,0,1,0,2
2739789,2739913,124,0,0,1,1
2739807,2739914,107,0,0,1,2
2739914,2739944,30,1,0,0,1
2739915,2739952,37,1,0,0,2
2739945,2740149,204,0,0,1,1
2739953,2740149,196,0,0,1,2
2783438,2783699,261,0,0,1,1
2783438,2783699,261,0,0,1,2
2783700,2783781,81,1,0,0,1
2783700,2783788,88,1,0,0,2
2783782,2783902,120,0,0,1,1
2783789,2783899,110,0,0,1,2
2783900,2783952,52,1,0,0,2
2783903,2783940,37,1,0,0,1
2783941,2785757,1816,0,0,1,1
2783953,2784569,616,0,0,1,2
2784570,2784579,9,1,0,0,2
2784580,2785757,1177,0,0,1,2
2785758,2785800,42,1,0,0,1
2785758,2785801,43,1,0,0,2
2785801,2786028,227,0,0,1,1
2785802,2786028,226,0,0,1,2
2786029,2786176,147,1,0,0,1
2786029,2786178,149,1,0,0,2
2786177,2786277,100,0,0,1,1
2786179,2786277,98,0,0,1,2
2786278,2786306,28,1,0,0,1
2786278,2786313,35,1,0,0,2
2786307,2786520,213,0,0,1,1
2786314,2786518,204,0,0,1,2
2786519,2786561,42,1,0,0,2
2786521,2786531,10,1,0,0,1
2786532,2787509,977,0,0,1,1
2786562,2787506,944,0,0,1,2
2787507,2787619,112,1,0,0,2
2787510,2787610,100,1,0,0,1
2787611,2787956,345,0,0,1,1
2787620,2787956,336,0,0,1,2
2787957,2788046,89,1,0,0,2
2787957,2788081,124,1,0,0,1
2788047,2788164,117,0,0,1,2
2788082,2788163,81,0,0,1,1
2788164,2788232,68,1,0,0,1
2788165,2788190,25,1,0,0,2
2788191,2789509,1318,0,0,1,2
2788233,2789510,1277,0,0,1,1
2789510,2789595,85,1,0,0,2
2789511,2789589,78,1,0,0,1
2789590,2790016,426,0,0,1,1
2789596,2789671,75,0,0,1,2
2789672,2789701,29,1,0,0,2
2789702,2790017,315,0,0,1,2
2790017,2790055,38,1,0,0,1
2790018,2790062,44,1,0,0,2
2790056,2790862,806,0,0,1,1
2790063,2790862,799,0,0,1,2
2790863,2790882,19,1,0,0,1
2790863,2790884,21,1,0,0,2
2790883,2792173,1290,0,0,1,1
2790885,2792177,1292,0,0,1,2
2792174,2792249,75,1,0,0,1
2792178,2792251,73,1,0,0,2
2792250,2792375,125,0,0,1,1
2792252,2792374,122,0,0,1,2
2792375,2792401,26,1,0,0,2
2792376,2792400,24,1,0,0,1
2792401,2793862,1461,0,0,1,1
2792402,2793862,1460,0,0,1,2
2793863,2793935,72,1,0,0,2
2793863,2793937,74,1,0,0,1
2793936,2794049,113,0,0,1,2
2793938,2794050,112,0,0,1,1
2794050,2794089,39,1,0,0,2
2794051,2794075,24,1,0,0,1
2794076,2795100,1024,0,0,1,1
2794090,2795098,1008,0,0,1,2
2795099,2795190,91,1,0,0,2
2795101,2795191,90,1,0,0,1
2795191,2795613,422,0,0,1,2
2795192,2795613,421,0,0,1,1
2795614,2795716,102,1,0,0,2
2795614,2795718,104,1,0,0,1
2795717,2797180,1463,0,0,1,2
2795719,2797180,1461,0,0,1,1
2797181,2797254,73,1,0,0,1
2797181,2797262,81,1,0,0,2
2797255,2797542,287,0,0,1,1
2797263,2797542,279,0,0,1,2
2797543,2797600,57,1,0,0,1
2797543,2797615,72,1,0,0,2
2797601,2797711,110,0,0,1,1
2797616,2797711,95,0,0,1,2
2797712,2797735,23,1,0,0,1
2797712,2797735,23,1,0,0,2
2797736,2798482,746,0,0,1,2
2797736,2798483,747,0,0,1,1
2798483,2798527,44,1,0,0,2
2798484,2798520,36,1,0,0,1
2798521,2799005,484,0,0,1,1
2798528,2799003,475,0,0,1,2
2799004,2799068,64,1,0,0,2
2799006,2799070,64,1,0,0,1
2799069,2799167,98,0,0,1,2
2799071,2799167,96,0,0,1,1
2799168,2799249,81,1,0,0,2
2799168,2799251,83,1,0,0,1
2799250,2799418,168,0,0,1,2
2799252,2799416,164,0,0,1,1
2799417,2799465,48,1,0,0,1
2799419,2799450,31,1,0,0,2
2799451,2799745,294,0,0,1,2
2799466,2799744,278,0,0,1,1
2799745,2799774,29,1,0,0,1
2799746,2799774,28,1,0,0,2
2799775,2800233,458,0,0,1,1
2799775,2800233,458,0,0,1,2
2800234,2800290,56,1,0,0,1
2800234,2800293,59,1,0,0,2
2800291,2800537,246,0,0,1,1
2800294,2800536,242,0,0,1,2
2800537,2800593,56,1,0,0,2
2800538,2800587,49,1,0,0,1
2800588,2800632,44,0,0,1,1
2800594,2800632,38,0,0,1,2
2800633,2800702,69,1,0,0,1
2800633,2800708,75,1,0,0,2
2800703,2800862,159,0,0,1,1
2800709,2800864,155,0,0,1,2
2800863,2800893,30,1,0,0,1
2800865,2800891,26,1,0,0,2
2800892,2801575,683,0,0,1,2
2800894,2801574,680,0,0,1,1
2801575,2801618,43,1,0,0,1
2801576,2801631,55,1,0,0,2
2801619,2802036,417,0,0,1,1
2801632,2802034,402,0,0,1,2
2802035,2802143,108,1,0,0,2
2802037,2802142,105,1,0,0,1
2802143,2802326,183,0,0,1,1
2802144,2802327,183,0,0,1,2
2802327,2802355,28,1,0,0,1
2802328,2802376,48,1,0,0,2
2802356,2803079,723,0,0,1,1
2802377,2803077,700,0,0,1,2
2803078,2803170,92,1,0,0,2
2803080,2803168,88,1,0,0,1
2803169,2803570,401,0,0,1,1
2803171,2803570,399,0,0,1,2
2803571,2803630,59,1,0,0,1
2803571,2803646,75,1,0,0,2
2803631,2803825,194,0,0,1,1
2803647,2803824,177,0,0,1,2
2803825,2803854,29,1,0,0,2
2803826,2803853,27,1,0,0,1
2803854,2804627,773,0,0,1,1
2803855,2804625,770,0,0,1,2
2804626,2804702,76,1,0,0,2
2804628,2804714,86,1,0,0,1
2804703,2805070,367,0,0,1,2
2804715,2805070,355,0,0,1,1
2805071,2805160,89,1,0,0,1
2805071,2805174,103,1,0,0,2
2805161,2805313,152,0,0,1,1
2805175,2805313,138,0,0,1,2
2805314,2805347,33,1,0,0,1
2805314,2805348,34,1,0,0,2
2805348,2806141,793,0,0,1,1
2805349,2806139,790,0,0,1,2
2806140,2806212,72,1,0,0,2
2806142,2806200,58,1,0,0,1
2806201,2806433,232,0,0,1,1
2806213,2806297,84,0,0,1,2
2806298,2806311,13,1,0,0,2
2806312,2806432,120,0,0,1,2
2806433,2806491,58,1,0,0,2
2806434,2806483,49,1,0,0,1
2806484,2806575,91,0,0,1,1
2806492,2806574,82,0,0,1,2
2806575,2806617,42,1,0,0,2
2806576,2806630,54,1,0,0,1
2806618,2807516,898,0,0,1,2
2806631,2807516,885,0,0,1,1
2807517,2807574,57,1,0,0,2
2807517,2807577,60,1,0,0,1
2807575,2808013,438,0,0,1,2
2807578,2808010,432,0,0,1,1
2808011,2808092,81,1,0,0,1
2808014,2808087,73,1,0,0,2
2808088,2808299,211,0,0,1,2
2808093,2808298,205,0,0,1,1
2808299,2808327,28,1,0,0,1
2808300,2808327,27,1,0,0,2
2808328,2808903,575,0,0,1,1
2808328,2808905,577,0,0,1,2
2808904,2808970,66,1,0,0,1
2808906,2808988,82,1,0,0,2
2808971,2809224,253,0,0,1,1
2808989,2809225,236,0,0,1,2
2809225,2809276,51,1,0,0,1
2809226,2809271,45,1,0,0,2
2809272,2809416,144,0,0,1,2
2809277,2809415,138,0,0,1,1
2809416,2809479,63,1,0,0,1
2809417,2809475,58,1,0,0,2
2809476,2809811,335,0,0,1,2
2809480,2809812,332,0,0,1,1
2809812,2809835,23,1,0,0,2
2809813,2809832,19,1,0,0,1
2809833,2810163,330,0,0,1,1
2809836,2810163,327,0,0,1,2
2810164,2810210,46,1,0,0,1
2810164,2810210,46,1,0,0,2
2810211,2810577,366,0,0,1,1
2810211,2810579,368,0,0,1,2
2810578,2810622,44,1,0,0,1
2810580,2810618,38,1,0,0,2
2810619,2810811,192,0,0,1,2
2810623,2810812,189,0,0,1,1
2810812,2810883,71,1,0,0,2
2810813,2810882,69,1,0,0,1
2810883,2811047,164,0,0,1,1
2810884,2811046,162,0,0,1,2
2811047,2811068,21,1,0,0,2
2811048,2811064,16,1,0,0,1
2811065,2811814,749,0,0,1,1
2811069,2811811,742,0,0,1,2
2811812,2811894,82,1,0,0,2
2811815,2811882,67,1,0,0,1
2811883,2812177,294,0,0,1,1
2811895,2812176,281,0,0,1,2
2812177,2812273,96,1,0,0,2
2812178,2812262,84,1,0,0,1
2812263,2812381,118,0,0,1,1
2812274,2812381,107,0,0,1,2
2812382,2812405,23,1,0,0,1
2812382,2812406,24,1,0,0,2
2812406,2813223,817,0,0,1,1
2812407,2813224,817,0,0,1,2
2813224,2813311,87,1,0,0,1
2813225,2813321,96,1,0,0,2
2813312,2813708,396,0,0,1,1
2813322,2813627,305,0,0,1,2
2813628,2813632,4,1,0,0,2
2813633,2813707,74,0,0,1,2
2813708,2813799,91,1,0,0,2
2813709,2813797,88,1,0,0,1
2813798,2813952,154,0,0,1,1
2813800,2813954,154,0,0,1,2
2813953,2813983,30,1,0,0,1
2813955,2813983,28,1,0,0,2
2813984,2814563,579,0,0,1,1
2813984,2814564,580,0,0,1,2
2814564,2814630,66,1,0,0,1
2814565,2814641,76,1,0,0,2
2814631,2815087,456,0,0,1,1
2814642,2815084,442,0,0,1,2
2815085,2815178,93,1,0,0,2
2815088,2815177,89,1,0,0,1
2815178,2815359,181,0,0,1,1
2815179,2815360,181,0,0,1,2
2815360,2815387,27,1,0,0,1
2815361,2815390,29,1,0,0,2
2815388,2815629,241,0,0,1,1
2815391,2815855,464,0,0,1,2
2815630,2815637,7,1,0,0,1
2815638,2815852,214,0,0,1,1
2815853,2815931,78,1,0,0,1
2815856,2815930,74,1,0,0,2
2815931,2816536,605,0,0,1,2
2815932,2816537,605,0,0,1,1
2816537,2816612,75,1,0,0,2
2816538,2816642,104,1,0,0,1
2816613,2816633,20,0,0,1,2
2816634,2816650,16,1,0,0,2
2816643,2816749,106,0,0,1,1
2816651,2816749,98,0,0,1,2
2816750,2816779,29,1,0,0,2
2816750,2816780,30,1,0,0,1
2816780,2817480,700,0,0,1,2
2816781,2817480,699,0,0,1,1
2817481,2817554,73,1,0,0,1
2817481,2817557,76,1,0,0,2
2817555,2817947,392,0,0,1,1
2817558,2817946,388,0,0,1,2
2817947,2818051,104,1,0,0,2
2817948,2818041,93,1,0,0,1
2818042,2818213,171,0,0,1,1
2818052,2818210,158,0,0,1,2
2818211,2818252,41,1,0,0,2
2818214,2818244,30,1,0,0,1
2818245,2818737,492,0,0,1,1
2818253,2818737,484,0,0,1,2
2818738,2818787,49,1,0,0,1
2818738,2818812,74,1,0,0,2
2818788,2819010,222,0,0,1,1
2818813,2819008,195,0,0,1,2
2819009,2819073,64,1,0,0,2
2819011,2819063,52,1,0,0,1
2819064,2819328,264,0,0,1,1
2819074,2819329,255,0,0,1,2
2819329,2819400,71,1,0,0,1
2819330,2819398,68,1,0,0,2
2819399,2819522,123,0,0,1,2
2819401,2819522,121,0,0,1,1
2819523,2819555,32,1,0,0,1
2819523,2819555,32,1,0,0,2
2819556,2820043,487,0,0,1,1
2819556,2820044,488,0,0,1,2
2820044,2820098,54,1,0,0,1
2820045,2820102,57,1,0,0,2
2820099,2820367,268,0,0,1,1
2820103,2820369,266,0,0,1,2
2820368,2820412,44,1,0,0,1
2820370,2820424,54,1,0,0,2
2820413,2820757,344,0,0,1,1
2820425,2820755,330,0,0,1,2
2820756,2820854,98,1,0,0,2
2820758,2820839,81,1,0,0,1
2820840,2820993,153,0,0,1,1
2820855,2820993,138,0,0,1,2
2820994,2821034,40,1,0,0,1
2820994,2821036,42,1,0,0,2
2821035,2821615,580,0,0,1,1
2821037,2821614,577,0,0,1,2
2821615,2821710,95,1,0,0,2
2821616,2821707,91,1,0,0,1
2821708,2822094,386,0,0,1,1
2821711,2822094,383,0,0,1,2
2822095,2822194,99,1,0,0,2
2822095,2822196,101,1,0,0,1
2822195,2822318,123,0,0,1,2
2822197,2822318,121,0,0,1,1
2822319,2822342,23,1,0,0,2
2822319,2822345,26,1,0,0,1
2822343,2823042,699,0,0,1,2
2822346,2823040,694,0,0,1,1
2823041,2823119,78,1,0,0,1
2823043,2823115,72,1,0,0,2
2823116,2823466,350,0,0,1,2
2823120,2823464,344,0,0,1,1
2823465,2823555,90,1,0,0,1
2823467,2823559,92,1,0,0,2
2823556,2823666,110,0,0,1,1
2823560,2823661,101,0,0,1,2
2823662,2823702,40,1,0,0,2
2823667,2823690,23,1,0,0,1
2823691,2824390,699,0,0,1,1
2823703,2824387,684,0,0,1,2
2824388,2824482,94,1,0,0,2
2824391,2824475,84,1,0,0,1
2824476,2824846,370,0,0,1,1
2824483,2824843,360,0,0,1,2
2824844,2824904,60,1,0,0,2
2824847,2824900,53,1,0,0,1
2824901,2825860,959,0,0,1,1
2824905,2825863,958,0,0,1,2
2825861,2825939,78,1,0,0,1
2825864,2825953,89,1,0,0,2
2825940,2826214,274,0,0,1,1
2825954,2826212,258,0,0,1,2
2826213,2826301,88,1,0,0,2
2826215,2826303,88,1,0,0,1
2826302,2826414,112,0,0,1,2
2826304,2826413,109,0,0,1,1
2826414,2826435,21,1,0,0,1
2826415,2826436,21,1,0,0,2
2826436,2827225,789,0,0,1,1
2826437,2827225,788,0,0,1,2
2827226,2827292,66,1,0,0,1
2827226,2827296,70,1,0,0,2
2827293,2827668,375,0,0,1,1
2827297,2827668,371,0,0,1,2
2827669,2827758,89,1,0,0,2
2827669,2827760,91,1,0,0,1
2827759,2827910,151,0,0,1,2
2827761,2827910,149,0,0,1,1
2827911,2827941,30,1,0,0,2
2827911,2827943,32,1,0,0,1
2827942,2828449,507,0,0,1,2
2827944,2828452,508,0,0,1,1
2828450,2828518,68,1,0,0,2
2828453,2828519,66,1,0,0,1
2828519,2828802,283,0,0,1,2
2828520,2828803,283,0,0,1,1
2828803,2828852,49,1,0,0,2
2828804,2828854,50,1,0,0,1
2828853,2829133,280,0,0,1,2
2828855,2829133,278,0,0,1,1
2829134,2829252,118,1,0,0,2
2829134,2829254,120,1,0,0,1
2829253,2829356,103,0,0,1,2
2829255,2829358,103,0,0,1,1
2829357,2829390,33,1,0,0,2
2829359,2829389,30,1,0,0,1
2829390,2830041,651,0,0,1,1
2829391,2830040,649,0,0,1,2
2830041,2830119,78,1,0,0,2
2830042,2830119,77,1,0,0,1
2830120,2830733,613,0,0,1,1
2830120,2830733,613,0,0,1,2
2830734,2830830,96,1,0,0,1
2830734,2830832,98,1,0,0,2
2830831,2830954,123,0,0,1,1
2830833,2830954,121,0,0,1,2
2830955,2830984,29,1,0,0,1
2830955,2830986,31,1,0,0,2
2830985,2831608,623,0,0,1,1
2830987,2831607,620,0,0,1,2
2831608,2831657,49,1,0,0,2
2831609,2831659,50,1,0,0,1
2831658,2832216,558,0,0,1,2
2831660,2832214,554,0,0,1,1
2832215,2832298,83,1,0,0,1
2832217,2832299,82,1,0,0,2
2832299,2832411,112,0,0,1,1
2832300,2832411,111,0,0,1,2
2832412,2832444,32,1,0,0,1
2832412,2832455,43,1,0,0,2
2832445,2833198,753,0,0,1,1
2832456,2833200,744,0,0,1,2
2833199,2833263,64,1,0,0,1
2833201,2833262,61,1,0,0,2
2833263,2833635,372,0,0,1,2
2833264,2833639,375,0,0,1,1
2833636,2833743,107,1,0,0,2
2833640,2833727,87,1,0,0,1
2833728,2833784,56,0,0,1,1
2833744,2833828,84,0,0,1,2
2833785,2833861,76,1,0,0,1
2833829,2833873,44,1,0,0,2
2833862,2834367,505,0,0,1,1
2833874,2834367,493,0,0,1,2
2834368,2834434,66,1,0,0,1
2834368,2834451,83,1,0,0,2
2834435,2834820,385,0,0,1,1
2834452,2834824,372,0,0,1,2
2834821,2834871,50,1,0,0,1
2834825,2834890,65,1,0,0,2
2834872,2835057,185,0,0,1,1
2834891,2835063,172,0,0,1,2
2835058,2835122,64,1,0,0,1
2835064,2835133,69,1,0,0,2
2835123,2835286,163,0,0,1,1
2835134,2835299,165,0,0,1,2
2835287,2835310,23,1,0,0,1
2835300,2835318,18,1,0,0,2
2835311,2835930,619,0,0,1,1
2835319,2835861,542,0,0,1,2
2835862,2835876,14,1,0,0,2
2835877,2835916,39,0,0,1,2
2835917,2835982,65,1,0,0,2
2835931,2835994,63,1,0,0,1
2835983,2836419,436,0,0,1,2
2835995,2836416,421,0,0,1,1
2836417,2836513,96,1,0,0,1
2836420,2836537,117,1,0,0,2
2836514,2837304,790,0,0,1,1
2836538,2837304,766,0,0,1,2
2837305,2837388,83,1,0,0,1
2837305,2837399,94,1,0,0,2
2837389,2837797,408,0,0,1,1
2837400,2837797,397,0,0,1,2
2837798,2837820,22,1,0,0,1
2837798,2837829,31,1,0,0,2
2837821,2839142,1321,0,0,1,1
2837830,2839141,1311,0,0,1,2
2839142,2839200,58,1,0,0,2
2839143,2839195,52,1,0,0,1
2839196,2839320,124,0,0,1,1
2839201,2839323,122,0,0,1,2
2839321,2839351,30,1,0,0,1
2839324,2839351,27,1,0,0,2
2839352,2839729,377,0,0,1,2
2839352,2840152,800,0,0,1,1
2839730,2839771,41,1,0,0,2
2839772,2840085,313,0,0,1,2
2840086,2840101,15,1,0,0,2
2840102,2840154,52,0,0,1,2
2840153,2840188,35,1,0,0,1
2840155,2840190,35,1,0,0,2
2840189,2840523,334,0,0,1,1
2840191,2840522,331,0,0,1,2
2840523,2840653,130,1,0,0,2
2840524,2840609,85,1,0,0,1
2840610,2840749,139,0,0,1,1
2840654,2840747,93,0,0,1,2
2840748,2840786,38,1,0,0,2
2840750,2840773,23,1,0,0,1
2840774,2841929,1155,0,0,1,1
2840787,2841231,444,0,0,1,2
2841232,2841265,33,1,0,0,2
2841266,2841932,666,0,0,1,2
2841930,2842000,70,1,0,0,1
2841933,2842012,79,1,0,0,2
2842001,2842072,71,0,0,1,1
2842013,2842071,58,0,0,1,2
2842072,2842206,134,1,0,0,2
2842073,2842196,123,1,0,0,1
2842197,2843071,874,0,0,1,1
2842207,2843071,864,0,0,1,2
2843072,2843161,89,1,0,0,1
2843072,2843171,99,1,0,0,2
2843162,2843448,286,0,0,1,1
2843172,2843451,279,0,0,1,2
2843449,2843520,71,1,0,0,1
2843452,2843536,84,1,0,0,2
2843521,2843840,319,0,0,1,1
2843537,2844941,1404,0,0,1,2
2843841,2843856,15,1,0,0,1
2843857,2844333,476,0,0,1,1
2844334,2844435,101,1,0,0,1
2844436,2844943,507,0,0,1,1
2844942,2845034,92,1,0,0,2
2844944,2845013,69,1,0,0,1
2845014,2845208,194,0,0,1,1
2845035,2845208,173,0,0,1,2
2845209,2845234,25,1,0,0,1
2845209,2845234,25,1,0,0,2
2845235,2845932,697,0,0,1,2
2845235,2845933,698,0,0,1,1
2845933,2845979,46,1,0,0,2
2845934,2845979,45,1,0,0,1
2845980,2846342,362,0,0,1,1
2845980,2846342,362,0,0,1,2
2846343,2846405,62,1,0,0,1
2846343,2846409,66,1,0,0,2
2846406,2847270,864,0,0,1,1
2846410,2847269,859,0,0,1,2
2847270,2847317,47,1,0,0,2
2847271,2847314,43,1,0,0,1
2847315,2847715,400,0,0,1,1
2847318,2847712,394,0,0,1,2
2847713,2847781,68,1,0,0,2
2847716,2847780,64,1,0,0,1
2847781,2847999,218,0,0,1,1
2847782,2847997,215,0,0,1,2
2847998,2848014,16,1,0,0,2
2848000,2848015,15,1,0,0,1
2848015,2849154,1139,0,0,1,2
2848016,2849151,1135,0,0,1,1
2849152,2849257,105,1,0,0,1
2849155,2849268,113,1,0,0,2
2849258,2849520,262,0,0,1,1
2849269,2849521,252,0,0,1,2
2849521,2849540,19,1,0,0,1
2849522,2849547,25,1,0,0,2
2849541,2850254,713,0,0,1,1
2849548,2850255,707,0,0,1,2
2850255,2850300,45,1,0,0,1
2850256,2850304,48,1,0,0,2
2850301,2850585,284,0,0,1,1
2850305,2850585,280,0,0,1,2
2850586,2850666,80,1,0,0,1
2850586,2850679,93,1,0,0,2
2850667,2850871,204,0,0,1,1
2850680,2850870,190,0,0,1,2
2850871,2850909,38,1,0,0,2
2850872,2850905,33,1,0,0,1
2850906,2851347,441,0,0,1,1
2850910,2851346,436,0,0,1,2
2851347,2851393,46,1,0,0,2
2851348,2851396,48,1,0,0,1
2851394,2851823,429,0,0,1,2
2851397,2851928,531,0,0,1,1
2851824,2851840,16,1,0,0,2
2851841,2851928,87,0,0,1,2
2851929,2852018,89,1,0,0,2
2851929,2852024,95,1,0,0,1
2852019,2852200,181,0,0,1,2
2852025,2852195,170,0,0,1,1
2852196,2852373,177,1,0,0,1
2852201,2852213,12,1,0,0,2
2852214,2852948,734,0,0,1,2
2852374,2852948,574,0,0,1,1
2852949,2852990,41,1,0,0,1
2852949,2853002,53,1,0,0,2
2852991,2853351,360,0,0,1,1
2853003,2853349,346,0,0,1,2
2853350,2853458,108,1,0,0,2
2853352,2853446,94,1,0,0,1
2853447,2853731,284,0,0,1,1
2853459,2853553,94,0,0,1,2
2853554,2853568,14,1,0,0,2
2853569,2853733,164,0,0,1,2
2853732,2853751,19,1,0,0,1
2853734,2853774,40,1,0,0,2
2853752,2854401,649,0,0,1,1
2853775,2853871,96,0,0,1,2
2853872,2853951,79,1,0,0,2
2853952,2853982,30,0,0,1,2
2853983,2854064,81,1,0,0,2
2854065,2854108,43,0,0,1,2
2854109,2854119,10,1,0,0,2
2854120,2854203,83,0,0,1,2
2854204,2854305,101,1,0,0,2
2854306,2854395,89,0,0,1,2
2854396,2854461,65,1,0,0,2
2854402,2854460,58,1,0,0,1
2854461,2854870,409,0,0,1,1
2854462,2854870,408,0,0,1,2
2854871,2854923,52,1,0,0,1
2854871,2854925,54,1,0,0,2
2854924,2855026,102,0,0,1,1
2854926,2855026,100,0,0,1,2
2855027,2855053,26,1,0,0,1
2855027,2855053,26,1,0,0,2
2855054,2856313,1259,0,0,1,2
2855054,2856314,1260,0,0,1,1
2856314,2856383,69,1,0,0,2
2856315,2856383,68,1,0,0,1
2856384,2856501,117,0,0,1,1
2856384,2856502,118,0,0,1,2
2856502,2856536,34,1,0,0,1
2856503,2856537,34,1,0,0,2
2856537,2857830,1293,0,0,1,1
2856538,2857831,1293,0,0,1,2
2857831,2861162,3331,1,0,0,1
2857832,2861141,3309,1,0,0,2
2857927,2861128,3201,0,1,0,2
2857936,2861151,3215,0,1,0,1
2861142,2861231,89,0,0,1,2
2861163,2861233,70,0,0,1,1
2861232,2861288,56,1,0,0,2
2861234,2861288,54,1,0,0,1
2861289,2861430,141,0,0,1,2
2861289,2861431,142,0,0,1,1
2861431,2861456,25,1,0,0,2
2861432,2861458,26,1,0,0,1
2861457,2861762,305,0,0,1,2
2861459,2861761,302,0,0,1,1
2861762,2861936,174,1,0,0,1
2861763,2862102,339,1,0,0,2
2861785,2861917,132,0,1,0,1
2861786,2861913,127,0,1,0,2
2861937,2861974,37,0,0,1,1
2861975,2862037,62,1,0,0,1
2862038,2862237,199,0,0,1,1
2862103,2862242,139,0,0,1,2
2862238,2862254,16,1,0,0,1
2862243,2862254,11,1,0,0,2
2862255,2863295,1040,0,0,1,1
2862255,2863296,1041,0,0,1,2
2863296,2863359,63,1,0,0,1
2863297,2863359,62,1,0,0,2
2863360,2863522,162,0,0,1,1
2863360,2863522,162,0,0,1,2
2863523,2863559,36,1,0,0,2
2863523,2863592,69,1,0,0,1
2863560,2865844,2284,0,0,1,2
2863593,2865846,2253,0,0,1,1
2865845,2865916,71,1,0,0,2
2865847,2865906,59,1,0,0,1
2865907,2866394,487,0,0,1,1
2865917,2866395,478,0,0,1,2
2866395,2866449,54,1,0,0,1
2866396,2866452,56,1,0,0,2
2866450,2866887,437,0,0,1,1
2866453,2866887,434,0,0,1,2
2866888,2866951,63,1,0,0,1
2866888,2866971,83,1,0,0,2
2866952,2867002,50,0,0,1,1
2866972,2867002,30,0,0,1,2
2867003,2867064,61,1,0,0,2
2867003,2867065,62,1,0,0,1
2867065,2867244,179,0,0,1,2
2867066,2867245,179,0,0,1,1
2867245,2867264,19,1,0,0,2
2867246,2867266,20,1,0,0,1
2867265,2868714,1449,0,0,1,2
2867267,2868714,1447,0,0,1,1
2868715,2868765,50,1,0,0,2
2868715,2868773,58,1,0,0,1
2868766,2868892,126,0,0,1,2
2868774,2868893,119,0,0,1,1
2868893,2868937,44,1,0,0,2
2868894,2868927,33,1,0,0,1
2868928,2869594,666,0,0,1,1
2868938,2869595,657,0,0,1,2
2869595,2869605,10,1,0,0,1
2869596,2869600,4,1,0,0,2
2869601,2871645,2044,0,0,1,2
2869606,2871645,2039,0,0,1,1
2871646,2871673,27,1,0,0,1
2871646,2871683,37,1,0,0,2
2871674,2872673,999,0,0,1,1
2871684,2872673,989,0,0,1,2
2872674,2872743,69,1,0,0,2
2872674,2872747,73,1,0,0,1
2872744,2872865,121,0,0,1,2
2872748,2872863,115,0,0,1,1
2872864,2872895,31,1,0,0,1
2872866,2872898,32,1,0,0,2
2872896,2874115,1219,0,0,1,1
2872899,2874116,1217,0,0,1,2
2874116,2874176,60,1,0,0,1
2874117,2874179,62,1,0,0,2
2874177,2877896,3719,0,0,1,1
2874180,2877895,3715,0,0,1,2
2877896,2877975,79,1,0,0,2
2877897,2877956,59,1,0,0,1
2877957,2878019,62,0,0,1,1
2877976,2878020,44,0,0,1,2
2878020,2878066,46,1,0,0,1
2878021,2878066,45,1,0,0,2
2878067,2878182,115,0,0,1,1
2878067,2878182,115,0,0,1,2
2878183,2878213,30,1,0,0,1
2878183,2878225,42,1,0,0,2
2878214,2879653,1439,0,0,1,1
2878226,2879653,1427,0,0,1,2
2879654,2879707,53,1,0,0,1
2879654,2879712,58,1,0,0,2
2879708,2880101,393,0,0,1,1
2879713,2880100,387,0,0,1,2
2880101,2880123,22,1,0,0,2
2880102,2880131,29,1,0,0,1
2880124,2881742,1618,0,0,1,2
2880132,2881743,1611,0,0,1,1
2881743,2881802,59,1,0,0,2
2881744,2881806,62,1,0,0,1
2881803,2882301,498,0,0,1,2
2881807,2882301,494,0,0,1,1
2882302,2882333,31,1,0,0,1
2882302,2882339,37,1,0,0,2
2882334,2882980,646,0,0,1,1
2882340,2882980,640,0,0,1,2
2882981,2883011,30,1,0,0,1
2882981,2883011,30,1,0,0,2
2883012,2883250,238,0,0,1,1
2883012,2883250,238,0,0,1,2
2883251,2883307,56,1,0,0,2
2883251,2883309,58,1,0,0,1
2883308,2883594,286,0,0,1,2
2883310,2883593,283,0,0,1,1
2883594,2883613,19,1,0,0,1
2883595,2883620,25,1,0,0,2
2883614,2883966,352,0,0,1,1
2883621,2883970,349,0,0,1,2
2883967,2883992,25,1,0,0,1
2883971,2883993,22,1,0,0,2
2883993,2885146,1153,0,0,1,1
2883994,2885146,1152,0,0,1,2
2885147,2885205,58,1,0,0,1
2885147,2885243,96,1,0,0,2
2885206,2887686,2480,0,0,1,1
2885244,2887686,2442,0,0,1,2
2887687,2887735,48,1,0,0,1
2887687,2887736,49,1,0,0,2
2887736,2888939,1203,0,0,1,1
2887737,2888940,1203,0,0,1,2
2888940,2888986,46,1,0,0,1
2888941,2888990,49,1,0,0,2
2888987,2889195,208,0,0,1,1
2888991,2889194,203,0,0,1,2
2889195,2889266,71,1,0,0,2
2889196,2889251,55,1,0,0,1
2889252,2889436,184,0,0,1,1
2889267,2889438,171,0,0,1,2
2889437,2889464,27,1,0,0,1
2889439,2889466,27,1,0,0,2
2889465,2890546,1081,0,0,1,1
2889467,2890545,1078,0,0,1,2
2890546,2890587,41,1,0,0,2
2890547,2890589,42,1,0,0,1
2890588,2890935,347,0,0,1,2
2890590,2890936,346,0,0,1,1
2890936,2890966,30,1,0,0,2
2890937,2890958,21,1,0,0,1
2890959,2893006,2047,0,0,1,1
2890967,2892201,1234,0,0,1,2
2892202,2892254,52,1,0,0,2
2892255,2893006,751,0,0,1,2
2893007,2893034,27,1,0,0,1
2893007,2893052,45,1,0,0,2
2893035,2893848,813,0,0,1,1
2893053,2893848,795,0,0,1,2
2893849,2893884,35,1,0,0,1
2893849,2894014,165,1,0,0,2
2893885,2894173,288,0,0,1,1
2894015,2894070,55,0,0,1,2
2894071,2894245,174,1,0,0,2
2894174,2894237,63,1,0,0,1
2894238,2894358,120,0,0,1,1
2894246,2894361,115,0,0,1,2
2894359,2894383,24,1,0,0,1
2894362,2894385,23,1,0,0,2
2894384,2895968,1584,0,0,1,1
2894386,2895968,1582,0,0,1,2
2895969,2896023,54,1,0,0,1
2895969,2896024,55,1,0,0,2
2896024,2896149,125,0,0,1,1
2896025,2896148,123,0,0,1,2
2896149,2896186,37,1,0,0,2
2896150,2896183,33,1,0,0,1
2896184,2897037,853,0,0,1,1
2896187,2896362,175,0,0,1,2
2896363,2896435,72,1,0,0,2
2896436,2897038,602,0,0,1,2
2897038,2897067,29,1,0,0,1
2897039,2897091,52,1,0,0,2
2897068,2897892,824,0,0,1,1
2897092,2897893,801,0,0,1,2
2897893,2897913,20,1,0,0,1
2897894,2897936,42,1,0,0,2
2897914,2898239,325,0,0,1,1
2897937,2898239,302,0,0,1,2
2898240,2898286,46,1,0,0,1
2898240,2898299,59,1,0,0,2
2898287,2899008,721,0,0,1,1
2898300,2899007,707,0,0,1,2
2899008,2899054,46,1,0,0,2
2899009,2899051,42,1,0,0,1
2899052,2899558,506,0,0,1,1
2899055,2899557,502,0,0,1,2
2899558,2899731,173,1,0,0,2
2899559,2899648,89,1,0,0,1
2899649,2900030,381,0,0,1,1
2899732,2900032,300,0,0,1,2
2900031,2900104,73,1,0,0,1
2900033,2900102,69,1,0,0,2
2900103,2900217,114,0,0,1,2
2900105,2900217,112,0,0,1,1
2900218,2900257,39,1,0,0,2
2900218,2900259,41,1,0,0,1
2900258,2901667,1409,0,0,1,2
2900260,2901668,1408,0,0,1,1
2901668,2901720,52,1,0,0,2
2901669,2901707,38,1,0,0,1
2901708,2904302,2594,0,0,1,1
2901721,2904300,2579,0,0,1,2
2904301,2904347,46,1,0,0,2
2904303,2904340,37,1,0,0,1
2904341,2904820,479,0,0,1,1
2904348,2904820,472,0,0,1,2
2904821,2904860,39,1,0,0,1
2904821,2904867,46,1,0,0,2
2904861,2905572,711,0,0,1,1
2904868,2905572,704,0,0,1,2
2905573,2905613,40,1,0,0,1
2905573,2905619,46,1,0,0,2
2905614,2905877,263,0,0,1,1
2905620,2905877,257,0,0,1,2
2905878,2905896,18,1,0,0,1
2905878,2905904,26,1,0,0,2
2905897,2906235,338,0,0,1,1
2905905,2906230,325,0,0,1,2
2906231,2906251,20,1,0,0,2
2906236,2906247,11,1,0,0,1
2906248,2906804,556,0,0,1,1
2906252,2906804,552,0,0,1,2
2906805,2906845,40,1,0,0,1
2906805,2906847,42,1,0,0,2
2906846,2908960,2114,0,0,1,1
2906848,2908959,2111,0,0,1,2
2908960,2909004,44,1,0,0,2
2908961,2908998,37,1,0,0,1
2908999,2910059,1060,0,0,1,1
2909005,2910059,1054,0,0,1,2
2910060,2910132,72,1,0,0,2
2910060,2910136,76,1,0,0,1
2910133,2910240,107,0,0,1,2
2910137,2910242,105,0,0,1,1
2910241,2910275,34,1,0,0,2
2910243,2910276,33,1,0,0,1
2910276,2910875,599,0,0,1,2
2910277,2910877,600,0,0,1,1
2910876,2910886,10,1,0,0,2
2910878,2910890,12,1,0,0,1
2910887,2911194,307,0,0,1,2
2910891,2911194,303,0,0,1,1
2911195,2911261,66,1,0,0,2
2911195,2911262,67,1,0,0,1
2911262,2911456,194,0,0,1,2
2911263,2911456,193,0,0,1,1
2911457,2911484,27,1,0,0,1
2911457,2911484,27,1,0,0,2
2911485,2911766,281,0,0,1,2
2911485,2911771,286,0,0,1,1
2911767,2911785,18,1,0,0,2
2911772,2911788,16,1,0,0,1
2911786,2912141,355,0,0,1,2
2911789,2912142,353,0,0,1,1
2912142,2912162,20,1,0,0,2
2912143,2912162,19,1,0,0,1
2912163,2912965,802,0,0,1,1
2912163,2912965,802,0,0,1,2
2912966,2912986,20,1,0,0,1
2912966,2912987,21,1,0,0,2
2912987,2913713,726,0,0,1,1
2912988,2913714,726,0,0,1,2
2913714,2913765,51,1,0,0,1
2913715,2913755,40,1,0,0,2
2913756,2914632,876,0,0,1,2
2913766,2914631,865,0,0,1,1
2914632,2914710,78,1,0,0,1
2914633,2914723,90,1,0,0,2
2914711,2914825,114,0,0,1,1
2914724,2914824,100,0,0,1,2
2914825,2914846,21,1,0,0,2
2914826,2914846,20,1,0,0,1
2914847,2916529,1682,0,0,1,1
2914847,2916529,1682,0,0,1,2
2916530,2916569,39,1,0,0,1
2916530,2916580,50,1,0,0,2
2916570,2916787,217,0,0,1,1
2916581,2916786,205,0,0,1,2
2916787,2916810,23,1,0,0,2
2916788,2916818,30,1,0,0,1
2916811,2917704,893,0,0,1,2
2916819,2917704,885,0,0,1,1
2917705,2917722,17,1,0,0,1
2917705,2917733,28,1,0,0,2
2917723,2918208,485,0,0,1,1
2917734,2918207,473,0,0,1,2
2918208,2918227,19,1,0,0,2
2918209,2918227,18,1,0,0,1
2918228,2918804,576,0,0,1,2
2918228,2918805,577,0,0,1,1
2918805,2918850,45,1,0,0,2
2918806,2918843,37,1,0,0,1
2918844,2920538,1694,0,0,1,1
2918851,2920541,1690,0,0,1,2
2920539,2920601,62,1,0,0,1
2920542,2920613,71,1,0,0,2
2920602,2920809,207,0,0,1,1
2920614,2920808,194,0,0,1,2
2920809,2920830,21,1,0,0,2
2920810,2920832,22,1,0,0,1
2920831,2921698,867,0,0,1,2
2920833,2921700,867,0,0,1,1
2921699,2921760,61,1,0,0,2
2921701,2921759,58,1,0,0,1
2921760,2922249,489,0,0,1,1
2921761,2922248,487,0,0,1,2
2922249,2922279,30,1,0,0,2
2922250,2922274,24,1,0,0,1
2922275,2923853,1578,0,0,1,1
2922280,2923852,1572,0,0,1,2
2923853,2923914,61,1,0,0,2
2923854,2923902,48,1,0,0,1
2923903,2924446,543,0,0,1,1
2923915,2924445,530,0,0,1,2
2924446,2924496,50,1,0,0,2
2924447,2924494,47,1,0,0,1
2924495,2925053,558,0,0,1,1
2924497,2925055,558,0,0,1,2
2925054,2925105,51,1,0,0,1
2925056,2925110,54,1,0,0,2
2925106,2925246,140,0,0,1,1
2925111,2925245,134,0,0,1,2
2925246,2925275,29,1,0,0,2
2925247,2925276,29,1,0,0,1
2925276,2925923,647,0,0,1,2
2925277,2925921,644,0,0,1,1
2925922,2925940,18,1,0,0,1
2925924,2925943,19,1,0,0,2
2925941,2926718,777,0,0,1,1
2925944,2926718,774,0,0,1,2
2926719,2926762,43,1,0,0,2
2926719,2926763,44,1,0,0,1
2926763,2927630,867,0,0,1,2
2926764,2927630,866,0,0,1,1
2927631,2927654,23,1,0,0,1
2927631,2927663,32,1,0,0,2
2927655,2928145,490,0,0,1,1
2927664,2928147,483,0,0,1,2
2928146,2928170,24,1,0,0,1
2928148,2928170,22,1,0,0,2
2928171,2928984,813,0,0,1,2
2928171,2928985,814,0,0,1,1
2928985,2929037,52,1,0,0,2
2928986,2929039,53,1,0,0,1
2929038,2929412,374,0,0,1,2
2929040,2929413,373,0,0,1,1
2929413,2929447,34,1,0,0,2
2929414,2929443,29,1,0,0,1
2929444,2930611,1167,0,0,1,1
2929448,2930611,1163,0,0,1,2
2930612,2930709,97,1,0,0,2
2930612,2930712,100,1,0,0,1
2930710,2930822,112,0,0,1,2
2930713,2930824,111,0,0,1,1
2930823,2930860,37,1,0,0,2
2930825,2930862,37,1,0,0,1
2930861,2931869,1008,0,0,1,2
2930863,2931869,1006,0,0,1,1
2931870,2931913,43,1,0,0,1
2931870,2931915,45,1,0,0,2
2931914,2932045,131,0,0,1,1
2931916,2932045,129,0,0,1,2
2932046,2932069,23,1,0,0,1
2932046,2932071,25,1,0,0,2
2932070,2932619,549,0,0,1,1
2932072,2932618,546,0,0,1,2
2932619,2932637,18,1,0,0,2
2932620,2932641,21,1,0,0,1
2932638,2934794,2156,0,0,1,2
2932642,2934793,2151,0,0,1,1
2934794,2934849,55,1,0,0,1
2934795,2934853,58,1,0,0,2
2934850,2935361,511,0,0,1,1
2934854,2935362,508,0,0,1,2
2935362,2935415,53,1,0,0,1
2935363,2935418,55,1,0,0,2
2935416,2935594,178,0,0,1,1
2935419,2935597,178,0,0,1,2
2935595,2935624,29,1,0,0,1
2935598,2935623,25,1,0,0,2
2935624,2936458,834,0,0,1,2
2935625,2936455,830,0,0,1,1
2936456,2936486,30,1,0,0,1
2936459,2936485,26,1,0,0,2
2936486,2937287,801,0,0,1,2
2936487,2937290,803,0,0,1,1
2937288,2937360,72,1,0,0,2
2937291,2937363,72,1,0,0,1
2937361,2937687,326,0,0,1,2
2937364,2937686,322,0,0,1,1
2937687,2937708,21,1,0,0,1
2937688,2937710,22,1,0,0,2
2937709,2938854,1145,0,0,1,1
2937711,2938855,1144,0,0,1,2
2938855,2938883,28,1,0,0,1
2938856,2938873,17,1,0,0,2
2938874,2939705,831,0,0,1,2
2938884,2939705,821,0,0,1,1
2939706,2939742,36,1,0,0,2
2939706,2939743,37,1,0,0,1
2939743,2940263,520,0,0,1,2
2939744,2940265,521,0,0,1,1
2940264,2940300,36,1,0,0,2
2940266,2940291,25,1,0,0,1
2940292,2941338,1046,0,0,1,1
2940301,2941335,1034,0,0,1,2
2941336,2941367,31,1,0,0,2
2941339,2941363,24,1,0,0,1
2941364,2941569,205,0,0,1,1
2941368,2941567,199,0,0,1,2
2941568,2941583,15,1,0,0,2
2941570,2941591,21,1,0,0,1
2941584,2942252,668,0,0,1,2
2941592,2942258,666,0,0,1,1
2942253,2942279,26,1,0,0,2
2942259,2942279,20,1,0,0,1
2942280,2942679,399,0,0,1,1
2942280,2942680,400,0,0,1,2
2942680,2942735,55,1,0,0,1
2942681,2942737,56,1,0,0,2
2942736,2943035,299,0,0,1,1
2942738,2943035,297,0,0,1,2
2943036,2943062,26,1,0,0,2
2943036,2943066,30,1,0,0,1
2943063,2944240,1177,0,0,1,2
2943067,2944241,1174,0,0,1,1
2944241,2944279,38,1,0,0,2
2944242,2944269,27,1,0,0,1
2944270,2944913,643,0,0,1,1
2944280,2944912,632,0,0,1,2
2944913,2944950,37,1,0,0,2
2944914,2944948,34,1,0,0,1
2944949,2945246,297,0,0,1,1
2944951,2945247,296,0,0,1,2
2945247,2945277,30,1,0,0,1
2945248,2945277,29,1,0,0,2
2945278,2945939,661,0,0,1,2
2945278,2945940,662,0,0,1,1
2945940,2945989,49,1,0,0,2
2945941,2945982,41,1,0,0,1
2945983,2946245,262,0,0,1,1
2945990,2946244,254,0,0,1,2
2946245,2946335,90,1,0,0,2
2946246,2946333,87,1,0,0,1
2946334,2946444,110,0,0,1,1
2946336,2946445,109,0,0,1,2
2946445,2946475,30,1,0,0,1
2946446,2946480,34,1,0,0,2
2946476,2947027,551,0,0,1,1
2946481,2946561,80,0,0,1,2
2946562,2946620,58,1,0,0,2
2946621,2946837,216,0,0,1,2
2946838,2946969,131,1,0,0,2
2946970,2947001,31,0,0,1,2
2947002,2947016,14,1,0,0,2
2947017,2947040,23,0,0,1,2
2947028,2947046,18,1,0,0,1
2947041,2947232,191,1,0,0,2
2947047,2947591,544,0,0,1,1
2947233,2947381,148,0,0,1,2
2947382,2947432,50,1,0,0,2
2947433,2947592,159,0,0,1,2
2947592,2947640,48,1,0,0,1
2947593,2947935,342,1,0,0,2
2947641,2947919,278,0,0,1,1
2947920,2947940,20,1,0,0,1
2947936,2949136,1200,0,0,1,2
2947941,2949657,1716,0,0,1,1
2949137,2949145,8,1,0,0,2
2949146,2949657,511,0,0,1,2
2949658,2949710,52,1,0,0,1
2949658,2949716,58,1,0,0,2
2949711,2950811,1100,0,0,1,1
2949717,2950803,1086,0,0,1,2
2950804,2951019,215,1,0,0,2
2950812,2951008,196,1,0,0,1
2950833,2950941,108,0,1,0,2
2950835,2950940,105,0,1,0,1
2951009,2951270,261,0,0,1,1
2951020,2951084,64,0,0,1,2
2951085,2951155,70,1,0,0,2
2951156,2951270,114,0,0,1,2
2951271,2951355,84,1,0,0,1
2951271,2951357,86,1,0,0,2
2951356,2951470,114,0,0,1,1
2951358,2951471,113,0,0,1,2
2951471,2951501,30,1,0,0,1
2951472,2951511,39,1,0,0,2
2951502,2951911,409,0,0,1,1
2951512,2951905,393,0,0,1,2
2951906,2951921,15,1,0,0,2
2951912,2951926,14,1,0,0,1
2951922,2952535,613,0,0,1,2
2951927,2952534,607,0,0,1,1
2952535,2952573,38,1,0,0,1
2952536,2952597,61,1,0,0,2
2952574,2955037,2463,0,0,1,1
2952598,2955038,2440,0,0,1,2
2955038,2955073,35,1,0,0,1
2955039,2955077,38,1,0,0,2
2955074,2955408,334,0,0,1,1
2955078,2955407,329,0,0,1,2
2955408,2955463,55,1,0,0,2
2955409,2955449,40,1,0,0,1
2955450,2956125,675,0,0,1,1
2955464,2956124,660,0,0,1,2
2956125,2956188,63,1,0,0,2
2956126,2956190,64,1,0,0,1
2956189,2956382,193,0,0,1,2
2956191,2956386,195,0,0,1,1
2956383,2956410,27,1,0,0,2
2956387,2956410,23,1,0,0,1
2956411,2957333,922,0,0,1,2
2956411,2957335,924,0,0,1,1
2957334,2957391,57,1,0,0,2
2957336,2957416,80,1,0,0,1
2957392,2957529,137,0,0,1,2
2957417,2957529,112,0,0,1,1
2957530,2957559,29,1,0,0,2
2957530,2957560,30,1,0,0,1
2957560,2959519,1959,0,0,1,2
2957561,2959521,1960,0,0,1,1
2959520,2959571,51,1,0,0,2
2959522,2959568,46,1,0,0,1
2959569,2960274,705,0,0,1,1
2959572,2960273,701,0,0,1,2
2960274,2960347,73,1,0,0,2
2960275,2960327,52,1,0,0,1
2960328,2960880,552,0,0,1,1
2960348,2960880,532,0,0,1,2
2960881,2960922,41,1,0,0,1
2960881,2960925,44,1,0,0,2
2960923,2961124,201,0,0,1,1
2960926,2962060,1134,0,0,1,2
2961125,2961135,10,1,0,0,1
2961136,2962060,924,0,0,1,1
2962061,2962104,43,1,0,0,1
2962061,2962104,43,1,0,0,2
2962105,2962560,455,0,0,1,1
2962105,2962561,456,0,0,1,2
2962561,2962585,24,1,0,0,1
2962562,2962587,25,1,0,0,2
2962586,2963484,898,0,0,1,1
2962588,2963485,897,0,0,1,2
2963485,2963525,40,1,0,0,1
2963486,2963527,41,1,0,0,2
2963526,2964152,626,0,0,1,1
2963528,2964154,626,0,0,1,2
2964153,2964198,45,1,0,0,1
2964155,2964197,42,1,0,0,2
2964198,2964843,645,0,0,1,2
2964199,2964843,644,0,0,1,1
2964844,2964898,54,1,0,0,2
2964844,2964900,56,1,0,0,1
2964899,2965306,407,0,0,1,2
2964901,2965307,406,0,0,1,1
2965307,2965349,42,1,0,0,2
2965308,2965348,40,1,0,0,1
2965349,2965502,153,0,0,1,1
2965350,2965502,152,0,0,1,2
2965503,2965602,99,1,0,0,2
2965503,2965606,103,1,0,0,1
2965603,2965705,102,0,0,1,2
2965607,2965705,98,0,0,1,1
2965706,2965733,27,1,0,0,2
2965706,2965734,28,1,0,0,1
2965734,2966399,665,0,0,1,2
2965735,2966399,664,0,0,1,1
2966400,2966421,21,1,0,0,2
2966400,2966429,29,1,0,0,1
2966422,2967272,850,0,0,1,2
2966430,2967275,845,0,0,1,1
2967273,2967327,54,1,0,0,2
2967276,2967322,46,1,0,0,1
2967323,2967650,327,0,0,1,1
2967328,2967648,320,0,0,1,2
2967649,2967672,23,1,0,0,2
2967651,2967665,14,1,0,0,1
2967666,2968714,1048,0,0,1,1
2967673,2968710,1037,0,0,1,2
2968711,2968748,37,1,0,0,2
2968715,2968744,29,1,0,0,1
2968745,2969990,1245,0,0,1,1
2968749,2969989,1240,0,0,1,2
2969990,2970032,42,1,0,0,2
2969991,2970030,39,1,0,0,1
2970031,2970595,564,0,0,1,1
2970033,2970594,561,0,0,1,2
2970595,2970652,57,1,0,0,2
2970596,2970654,58,1,0,0,1
2970653,2971167,514,0,0,1,2
2970655,2971168,513,0,0,1,1
2971168,2971226,58,1,0,0,2
2971169,2971217,48,1,0,0,1
2971218,2971463,245,0,0,1,1
2971227,2971464,237,0,0,1,2
2971464,2971523,59,1,0,0,1
2971465,2971531,66,1,0,0,2
2971524,2971733,209,0,0,1,1
2971532,2971738,206,0,0,1,2
2971734,2971750,16,1,0,0,1
2971739,2971750,11,1,0,0,2
2971751,2973010,1259,0,0,1,2
2971751,2973011,1260,0,0,1,1
2973011,2973068,57,1,0,0,2
2973012,2973056,44,1,0,0,1
2973057,2973261,204,0,0,1,1
2973069,2973264,195,0,0,1,2
2973262,2973292,30,1,0,0,1
2973265,2973292,27,1,0,0,2
2973293,2973498,205,0,0,1,2
2973293,2973514,221,0,0,1,1
2973499,2973916,417,1,0,0,2
2973515,2974155,640,1,0,0,1
2973539,2973626,87,0,1,0,1
2973540,2973614,74,0,1,0,2
2973693,2973902,209,0,1,0,1
2973695,2973880,185,0,1,0,2
2973917,2973948,31,0,0,1,2
2973949,2974191,242,1,0,0,2
2973964,2974116,152,0,1,0,1
2973979,2974097,118,0,1,0,2
2974156,2975189,1033,0,0,1,1
2974192,2975190,998,0,0,1,2
2975190,2975235,45,1,0,0,1
2975191,2975234,43,1,0,0,2
2975235,2975486,251,0,0,1,2
2975236,2975488,252,0,0,1,1
2975487,2975542,55,1,0,0,2
2975489,2975529,40,1,0,0,1
2975530,2976021,491,0,0,1,1
2975543,2976021,478,0,0,1,2
2976022,2976057,35,1,0,0,1
2976022,2976058,36,1,0,0,2
2976058,2976628,570,0,0,1,1
2976059,2976629,570,0,0,1,2
2976629,2976653,24,1,0,0,1
2976630,2976655,25,1,0,0,2
2976654,2978173,1519,0,0,1,1
2976656,2976947,291,0,0,1,2
2976948,2976957,9,1,0,0,2
2976958,2978174,1216,0,0,1,2
2978174,2978221,47,1,0,0,1
2978175,2978228,53,1,0,0,2
2978222,2978415,193,0,0,1,1
2978229,2978417,188,0,0,1,2
2978416,2978440,24,1,0,0,1
2978418,2978441,23,1,0,0,2
2978441,2981042,2601,0,0,1,1
2978442,2981040,2598,0,0,1,2
2981041,2981079,38,1,0,0,2
2981043,2981071,28,1,0,0,1
2981072,2982019,947,0,0,1,1
2981080,2982018,938,0,0,1,2
2982019,2982097,78,1,0,0,2
2982020,2982097,77,1,0,0,1
2982098,2982449,351,0,0,1,2
2982098,2982862,764,0,0,1,1
2982450,2982467,17,1,0,0,2
2982468,2982863,395,0,0,1,2
2982863,2982880,17,1,0,0,1
2982864,2982883,19,1,0,0,2
2982881,2983399,518,0,0,1,1
2982884,2983398,514,0,0,1,2
2983399,2983418,19,1,0,0,2
2983400,2983413,13,1,0,0,1
2983414,2984907,1493,0,0,1,1
2983419,2984907,1488,0,0,1,2
2984908,2984967,59,1,0,0,1
2984908,2984971,63,1,0,0,2
2984968,2985261,293,0,0,1,1
2984972,2985262,290,0,0,1,2
2985262,2985288,26,1,0,0,1
2985263,2985288,25,1,0,0,2
2985289,2988612,3323,0,0,1,1
2985289,2988612,3323,0,0,1,2
2988613,2988637,24,1,0,0,2
2988613,2988638,25,1,0,0,1
2988638,2988781,143,0,0,1,2
2988639,2988781,142,0,0,1,1
2988782,2988818,36,1,0,0,1
2988782,2988820,38,1,0,0,2
2988819,2989782,963,0,0,1,1
2988821,2989788,967,0,0,1,2
2989783,2989803,20,1,0,0,1
2989789,2989805,16,1,0,0,2
2989804,2989999,195,0,0,1,1
2989806,2990001,195,0,0,1,2
2990000,2990036,36,1,0,0,1
2990002,2990054,52,1,0,0,2
2990037,2990321,284,0,0,1,1
2990055,2990321,266,0,0,1,2
2990322,2990343,21,1,0,0,1
2990322,2990343,21,1,0,0,2
2990344,2991408,1064,0,0,1,2
2990344,2991409,1065,0,0,1,1
2991409,2991433,24,1,0,0,2
2991410,2991433,23,1,0,0,1
2991434,2991849,415,0,0,1,1
2991434,2991849,415,0,0,1,2
2991850,2991869,19,1,0,0,1
2991850,2991871,21,1,0,0,2
2991870,2992614,744,0,0,1,1
2991872,2992611,739,0,0,1,2
2992612,2992674,62,1,0,0,2
2992615,2992672,57,1,0,0,1
2992673,2993406,733,0,0,1,1
2992675,2993407,732,0,0,1,2
2993407,2993491,84,1,0,0,1
2993408,2993484,76,1,0,0,2
2993485,2994825,1340,0,0,1,2
2993492,2994825,1333,0,0,1,1
2994826,2994888,62,1,0,0,1
2994826,2994897,71,1,0,0,2
2994889,2995224,335,0,0,1,1
2994898,2995226,328,0,0,1,2
2995225,2995250,25,1,0,0,1
2995227,2995251,24,1,0,0,2
2995251,2997104,1853,0,0,1,1
2995252,2997103,1851,0,0,1,2
2997104,2997164,60,1,0,0,2
2997105,2997156,51,1,0,0,1
2997157,2997786,629,0,0,1,1
2997165,2997785,620,0,0,1,2
2997786,2997829,43,1,0,0,2
2997787,2997830,43,1,0,0,1
2997830,2998551,721,0,0,1,2
2997831,2998554,723,0,0,1,1
2998552,2998685,133,1,0,0,2
2998555,2998630,75,1,0,0,1
2998631,2998819,188,0,0,1,1
2998686,2998816,130,0,0,1,2
2998817,2998858,41,1,0,0,2
2998820,2998845,25,1,0,0,1
2998846,2999578,732,0,0,1,1
2998859,2998914,55,0,0,1,2
2998915,2998955,40,1,0,0,2
2998956,2999036,80,0,0,1,2
2999037,2999060,23,1,0,0,2
2999061,2999580,519,0,0,1,2
2999579,2999594,15,1,0,0,1
2999581,2999600,19,1,0,0,2
2999595,3000057,462,0,0,1,1
2999601,3000057,456,0,0,1,2
3000058,3000119,61,1,0,0,2
3000058,3000121,63,1,0,0,1
3000120,3000347,227,0,0,1,2
3000122,3000351,229,0,0,1,1
3000348,3000371,23,1,0,0,2
3000352,3000371,19,1,0,0,1
3000372,3001367,995,0,0,1,1
3000372,3001369,997,0,0,1,2
3001368,3001396,28,1,0,0,1
3001370,3001396,26,1,0,0,2
3001397,3002356,959,0,0,1,1
3001397,3002359,962,0,0,1,2
3002357,3002409,52,1,0,0,1
3002360,3002416,56,1,0,0,2
3002410,3003480,1070,0,0,1,1
3002417,3003481,1064,0,0,1,2
3003481,3003537,56,1,0,0,1
3003482,3003541,59,1,0,0,2
3003538,3003776,238,0,0,1,1
3003542,3003778,236,0,0,1,2
3003777,3003864,87,1,0,0,1
3003779,3003863,84,1,0,0,2
3003864,3004754,890,0,0,1,2
3003865,3004241,376,0,0,1,1
3004242,3004247,5,1,0,0,1
3004248,3004751,503,0,0,1,1
3004752,3004833,81,1,0,0,1
3004755,3004836,81,1,0,0,2
3004834,3005092,258,0,0,1,1
3004837,3006958,2121,0,0,1,2
3005093,3005099,6,1,0,0,1
3005100,3006008,908,0,0,1,1
3006009,3006026,17,1,0,0,1
3006027,3006959,932,0,0,1,1
3006959,3007007,48,1,0,0,2
3006960,3007007,47,1,0,0,1
3007008,3007504,496,0,0,1,2
3007008,3007506,498,0,0,1,1
3007505,3007553,48,1,0,0,2
3007507,3007542,35,1,0,0,1
3007543,3007868,325,0,0,1,1
3007554,3007868,314,0,0,1,2
