start,end,duration,saccade,blink,fixation,eye
8960120,8960122,2,0,0,1,1
8960123,8960144,21,1,0,0,1
8960133,8960135,2,0,1,0,2
8960145,8960388,243,0,0,1,1
8960204,8960208,4,0,0,1,2
8960209,8960275,66,1,0,0,2
8960276,8960332,56,0,0,1,2
8960333,8960499,166,1,0,0,2
8960389,8960444,55,1,0,0,1
8960445,8960584,139,0,0,1,1
8960500,8960583,83,0,0,1,2
8960584,8960642,58,1,0,0,2
8960585,8960626,41,1,0,0,1
8960627,8960780,153,0,0,1,1
8960643,8960777,134,0,0,1,2
8960778,8960798,20,1,0,0,2
8960781,8960796,15,1,0,0,1
8960797,8961078,281,0,0,1,1
8960799,8961077,278,0,0,1,2
8961078,8961090,12,1,0,0,2
8961079,8961088,9,1,0,0,1
8961089,8962113,1024,0,0,1,1
8961091,8962113,1022,0,0,1,2
8962114,8962123,9,1,0,0,2
8962114,8962124,10,1,0,0,1
8962124,8963520,1396,0,0,1,2
8962125,8963514,1389,0,0,1,1
8963515,8963535,20,1,0,0,1
8963521,8963531,10,1,0,0,2
8963532,8964075,543,0,0,1,2
8963536,8964082,546,0,0,1,1
8964076,8964368,292,1,0,0,2
8964083,8964259,176,1,0,0,1
8964129,8964212,83,0,1,0,2
8964152,8964200,48,0,1,0,1
8964260,8965595,1335,0,0,1,1
8964369,8965597,1228,0,0,1,2
8965596,8965615,19,1,0,0,1
8965598,8965613,15,1,0,0,2
8965614,8965844,230,0,0,1,2
8965616,8965853,237,0,0,1,1
8965845,8966100,255,1,0,0,2
8965854,8965981,127,1,0,0,1
8965899,8965957,58,0,1,0,2
8965917,8965929,12,0,1,0,1
8965982,8966165,183,0,0,1,1
8966101,8966556,455,0,0,1,2
8966166,8966175,9,1,0,0,1
8966176,8966555,379,0,0,1,1
8966556,8966576,20,1,0,0,1
8966557,8966576,19,1,0,0,2
8966577,8968728,2151,0,0,1,1
8966577,8968735,2158,0,0,1,2
8968729,8968748,19,1,0,0,1
8968736,8968747,11,1,0,0,2
8968748,8972639,3891,0,0,1,2
8968749,8972639,3890,0,0,1,1
8972640,8972729,89,1,0,0,1
8972640,8972729,89,1,0,0,2
8972730,8972812,82,0,0,1,1
8972730,8972813,83,0,0,1,2
8972813,8972853,40,1,0,0,1
8972814,8972860,46,1,0,0,2
8972854,8976053,3199,0,0,1,1
8972861,8976073,3212,0,0,1,2
8976054,8976158,104,1,0,0,1
8976074,8976146,72,1,0,0,2
8976147,8976272,125,0,0,1,2
8976159,8976271,112,0,0,1,1
8976272,8976321,49,1,0,0,1
8976273,8976307,34,1,0,0,2
8976308,8976469,161,0,0,1,2
8976322,8976471,149,0,0,1,1
8976470,8976486,16,1,0,0,2
8976472,8976490,18,1,0,0,1
8976487,8977390,903,0,0,1,2
8976491,8977392,901,0,0,1,1
8977391,8977408,17,1,0,0,2
8977393,8977401,8,1,0,0,1
8977402,8979001,1599,0,0,1,1
8977409,8979000,1591,0,0,1,2
8979001,8979063,62,1,0,0,2
8979002,8979077,75,1,0,0,1
8979064,8979192,128,0,0,1,2
8979078,8979193,115,0,0,1,1
8979193,8979214,21,1,0,0,2
8979194,8979211,17,1,0,0,1
8979212,8981448,2236,0,0,1,1
8979215,8981447,2232,0,0,1,2
8981448,8981487,39,1,0,0,2
8981449,8981490,41,1,0,0,1
8981488,8981639,151,0,0,1,2
8981491,8981642,151,0,0,1,1
8981640,8981663,23,1,0,0,2
8981643,8981661,18,1,0,0,1
8981662,8982284,622,0,0,1,1
8981664,8983912,2248,0,0,1,2
8982285,8982292,7,1,0,0,1
8982293,8983908,1615,0,0,1,1
8983909,8984130,221,1,0,0,1
8983913,8984141,228,1,0,0,2
8984131,8984258,127,0,0,1,1
8984142,8984225,83,0,0,1,2
8984226,8984289,63,1,0,0,2
8984259,8984278,19,1,0,0,1
8984279,8986232,1953,0,0,1,1
8984290,8984575,285,0,0,1,2
8984576,8984589,13,1,0,0,2
8984590,8985125,535,0,0,1,2
8985126,8985135,9,1,0,0,2
8985136,8986240,1104,0,0,1,2
8986233,8986275,42,1,0,0,1
8986241,8986299,58,1,0,0,2
8986276,8986509,233,0,0,1,1
8986300,8986506,206,0,0,1,2
8986507,8986577,70,1,0,0,2
8986510,8986594,84,1,0,0,1
8986578,8986708,130,0,0,1,2
8986595,8986703,108,0,0,1,1
8986704,8986741,37,1,0,0,1
8986709,8986740,31,1,0,0,2
8986741,8986855,114,0,0,1,2
8986742,8986857,115,0,0,1,1
8986856,8986876,20,1,0,0,2
8986858,8986870,12,1,0,0,1
8986871,8987888,1017,0,0,1,1
8986877,8987888,1011,0,0,1,2
8987889,8987907,18,1,0,0,1
8987889,8987911,22,1,0,0,2
8987908,8988039,131,0,0,1,1
8987912,8988039,127,0,0,1,2
8988040,8988057,17,1,0,0,1
8988040,8988061,21,1,0,0,2
8988058,8988866,808,0,0,1,1
8988062,8988868,806,0,0,1,2
8988867,8988919,52,1,0,0,1
8988869,8988918,49,1,0,0,2
8988919,8989097,178,0,0,1,2
8988920,8989100,180,0,0,1,1
8989098,8989155,57,1,0,0,2
8989101,8989151,50,1,0,0,1
8989152,8989303,151,0,0,1,1
8989156,8989297,141,0,0,1,2
8989298,8989353,55,1,0,0,2
8989304,8989353,49,1,0,0,1
8989354,8989551,197,0,0,1,1
8989354,8989558,204,0,0,1,2
8989552,8989572,20,1,0,0,1
8989559,8989571,12,1,0,0,2
8989572,8989762,190,0,0,1,2
8989573,8989757,184,0,0,1,1
8989758,8989780,22,1,0,0,1
8989763,8989778,15,1,0,0,2
8989779,8992198,2419,0,0,1,2
8989781,8989953,172,0,0,1,1
8989954,8989972,18,1,0,0,1
8989973,8992195,2222,0,0,1,1
8992196,8992263,67,1,0,0,1
8992199,8992265,66,1,0,0,2
8992264,8992527,263,0,0,1,1
8992266,8992524,258,0,0,1,2
8992525,8992579,54,1,0,0,2
8992528,8992595,67,1,0,0,1
8992580,8992695,115,0,0,1,2
8992596,8992695,99,0,0,1,1
8992696,8992719,23,1,0,0,1
8992696,8992720,24,1,0,0,2
8992720,8992766,46,0,0,1,1
8992721,8992768,47,0,0,1,2
8992767,8992980,213,1,0,0,1
8992769,8992974,205,1,0,0,2
8992799,8992913,114,0,1,0,2
8992806,8992912,106,0,1,0,1
8992975,8993118,143,0,0,1,2
8992981,8993121,140,0,0,1,1
8993119,8993133,14,1,0,0,2
8993122,8993127,5,1,0,0,1
8993128,8994474,1346,0,0,1,1
8993134,8994474,1340,0,0,1,2
8994475,8994528,53,1,0,0,1
8994475,8994531,56,1,0,0,2
8994529,8994943,414,0,0,1,1
8994532,8994941,409,0,0,1,2
8994942,8995015,73,1,0,0,2
8994944,8995020,76,1,0,0,1
8995016,8995204,188,0,0,1,2
8995021,8995203,182,0,0,1,1
8995204,8995224,20,1,0,0,1
8995205,8995218,13,1,0,0,2
8995219,8995961,742,0,0,1,2
8995225,8995952,727,0,0,1,1
8995953,8995973,20,1,0,0,1
8995962,8995974,12,1,0,0,2
8995974,8996211,237,0,0,1,1
8995975,8996841,866,0,0,1,2
8996212,8996228,16,1,0,0,1
8996229,8996837,608,0,0,1,1
8996838,8996933,95,1,0,0,1
8996842,8996925,83,1,0,0,2
8996926,8997190,264,0,0,1,2
8996934,8997186,252,0,0,1,1
8997187,8997490,303,1,0,0,1
8997191,8997484,293,1,0,0,2
8997219,8997407,188,0,1,0,2
8997226,8997385,159,0,1,0,1
8997485,8997530,45,0,0,1,2
8997491,8997531,40,0,0,1,1
8997531,8997598,67,1,0,0,2
8997532,8997755,223,1,0,0,1
8997599,8998096,497,0,0,1,2
8997756,8997805,49,0,0,1,1
8997806,8997865,59,1,0,0,1
8997866,8997978,112,0,0,1,1
8997979,8997983,4,1,0,0,1
8997984,8998744,760,0,0,1,1
8998097,8998116,19,1,0,0,2
8998117,8998394,277,0,0,1,2
8998395,8998410,15,1,0,0,2
8998411,8998973,562,0,0,1,2
8998745,8998753,8,1,0,0,1
8998754,8998904,150,0,0,1,1
8998905,8998962,57,1,0,0,1
8998963,8998987,24,0,0,1,1
8998974,8999172,198,1,0,0,2
8998988,8999128,140,1,0,0,1
8999012,8999064,52,0,1,0,1
8999017,8999090,73,0,1,0,2
8999129,8999372,243,0,0,1,1
8999173,8999370,197,0,0,1,2
8999371,8999417,46,1,0,0,2
8999373,8999416,43,1,0,0,1
8999417,8999547,130,0,0,1,1
8999418,8999556,138,0,0,1,2
8999548,8999610,62,1,0,0,1
8999557,8999628,71,1,0,0,2
8999611,8999674,63,0,0,1,1
8999629,8999659,30,0,0,1,2
8999660,9000417,757,1,0,0,2
8999675,9000122,447,1,0,0,1
8999690,9000185,495,0,1,0,2
8999702,9000073,371,0,1,0,1
9000123,9000149,26,0,0,1,1
9000150,9000169,19,1,0,0,1
9000170,9000747,577,0,0,1,1
9000242,9000401,159,0,1,0,2
9000418,9000467,49,0,0,1,2
9000468,9000472,4,1,0,0,2
9000473,9000745,272,0,0,1,2
9000746,9000756,10,1,0,0,2
9000748,9000752,4,1,0,0,1
9000753,9001491,738,0,0,1,1
9000757,9000933,176,0,0,1,2
9000934,9001096,162,1,0,0,2
9001097,9001162,65,0,0,1,2
9001163,9001177,14,1,0,0,2
9001178,9001487,309,0,0,1,2
9001488,9001612,124,1,0,0,2
9001492,9001562,70,1,0,0,1
9001563,9001918,355,0,0,1,1
9001613,9001917,304,0,0,1,2
9001918,9001957,39,1,0,0,2
9001919,9001957,38,1,0,0,1
9001958,9002080,122,0,0,1,1
9001958,9002082,124,0,0,1,2
9002081,9002099,18,1,0,0,1
9002083,9002100,17,1,0,0,2
9002100,9002428,328,0,0,1,1
9002101,9002428,327,0,0,1,2
9002429,9002445,16,1,0,0,1
9002429,9002448,19,1,0,0,2
9002446,9003038,592,0,0,1,1
9002449,9004133,1684,0,0,1,2
9003039,9003044,5,1,0,0,1
9003045,9004131,1086,0,0,1,1
9004132,9004209,77,1,0,0,1
9004134,9004231,97,1,0,0,2
9004210,9004283,73,0,0,1,1
9004232,9004280,48,0,0,1,2
9004281,9004334,53,1,0,0,2
9004284,9004325,41,1,0,0,1
9004326,9005808,1482,0,0,1,1
9004335,9005807,1472,0,0,1,2
9005808,9005829,21,1,0,0,2
9005809,9005829,20,1,0,0,1
9005830,9006170,340,0,0,1,1
9005830,9006170,340,0,0,1,2
9006171,9006246,75,1,0,0,2
9006171,9006247,76,1,0,0,1
9006247,9006671,424,0,0,1,2
9006248,9006668,420,0,0,1,1
9006669,9006739,70,1,0,0,1
9006672,9006734,62,1,0,0,2
9006735,9006861,126,0,0,1,2
9006740,9006863,123,0,0,1,1
9006862,9006889,27,1,0,0,2
9006864,9006890,26,1,0,0,1
9006890,9007006,116,0,0,1,2
9006891,9007008,117,0,0,1,1
9007007,9007271,264,1,0,0,2
9007009,9007232,223,1,0,0,1
9007049,9007209,160,0,1,0,2
9007063,9007196,133,0,1,0,1
9007233,9007389,156,0,0,1,1
9007272,9007308,36,0,0,1,2
9007309,9007411,102,1,0,0,2
9007390,9007410,20,1,0,0,1
9007411,9008779,1368,0,0,1,1
9007412,9007461,49,0,0,1,2
9007462,9007485,23,1,0,0,2
9007486,9008782,1296,0,0,1,2
9008780,9008855,75,1,0,0,1
9008783,9008856,73,1,0,0,2
9008856,9009196,340,0,0,1,1
9008857,9009195,338,0,0,1,2
9009196,9009235,39,1,0,0,2
9009197,9009236,39,1,0,0,1
9009236,9009390,154,0,0,1,2
9009237,9009390,153,0,0,1,1
9009391,9009404,13,1,0,0,1
9009391,9009404,13,1,0,0,2
9009405,9009740,335,0,0,1,1
9009405,9009740,335,0,0,1,2
9009741,9010005,264,1,0,0,1
9009741,9010029,288,1,0,0,2
9009776,9009937,161,0,1,0,2
9009788,9009927,139,0,1,0,1
9010006,9011325,1319,0,0,1,1
9010030,9010079,49,0,0,1,2
9010080,9010097,17,1,0,0,2
9010098,9011306,1208,0,0,1,2
9011307,9011737,430,1,0,0,2
9011326,9011589,263,1,0,0,1
9011341,9011571,230,0,1,0,2
9011356,9011513,157,0,1,0,1
9011590,9011658,68,0,0,1,1
9011659,9011745,86,1,0,0,1
9011738,9011852,114,0,0,1,2
9011746,9011851,105,0,0,1,1
9011852,9011870,18,1,0,0,1
9011853,9011874,21,1,0,0,2
9011871,9011923,52,0,0,1,1
9011875,9011911,36,0,0,1,2
9011912,9012332,420,1,0,0,2
9011924,9012351,427,1,0,0,1
9011945,9012190,245,0,1,0,2
9011957,9012248,291,0,1,0,1
9012219,9012256,37,0,1,0,2
9012333,9012361,28,0,0,1,2
9012352,9012421,69,0,0,1,1
9012362,9012376,14,1,0,0,2
9012377,9012425,48,0,0,1,2
9012422,9012442,20,1,0,0,1
9012426,9012441,15,1,0,0,2
9012442,9012648,206,0,0,1,2
9012443,9012652,209,0,0,1,1
9012649,9012664,15,1,0,0,2
9012653,9012680,27,1,0,0,1
9012665,9014184,1519,0,0,1,2
9012681,9014184,1503,0,0,1,1
9014185,9014244,59,1,0,0,1
9014185,9014266,81,1,0,0,2
9014245,9014578,333,0,0,1,1
9014267,9014579,312,0,0,1,2
9014579,9014616,37,1,0,0,1
9014580,9014628,48,1,0,0,2
9014617,9014664,47,0,0,1,1
9014629,9014665,36,0,0,1,2
9014665,9014754,89,1,0,0,1
9014666,9014784,118,1,0,0,2
9014755,9014823,68,0,0,1,1
9014785,9014823,38,0,0,1,2
9014824,9014863,39,1,0,0,2
9014824,9014864,40,1,0,0,1
9014864,9015051,187,0,0,1,2
9014865,9015057,192,0,0,1,1
9015052,9015081,29,1,0,0,2
9015058,9015076,18,1,0,0,1
9015077,9017288,2211,0,0,1,1
9015082,9017267,2185,0,0,1,2
9017268,9017563,295,1,0,0,2
9017289,9017521,232,1,0,0,1
9017313,9017498,185,0,1,0,2
9017321,9017468,147,0,1,0,1
9017522,9017716,194,0,0,1,1
9017564,9017623,59,0,0,1,2
9017624,9017675,51,1,0,0,2
9017676,9017715,39,0,0,1,2
9017716,9017818,102,1,0,0,2
9017717,9017841,124,1,0,0,1
9017819,9017840,21,0,0,1,2
9017841,9020637,2796,1,0,0,2
9017842,9017912,70,0,0,1,1
9017913,9019114,1201,1,0,0,1
9017939,9020355,2416,0,1,0,2
9017942,9019104,1162,0,1,0,1
9019115,9019304,189,0,0,1,1
9019315,9020397,1082,0,1,0,1
9020407,9020447,40,1,0,0,1
9020448,9020590,142,0,0,1,1
9020591,9020632,41,1,0,0,1
9020633,9020830,197,0,0,1,1
9020638,9020828,190,0,0,1,2
9020829,9020879,50,1,0,0,2
9020831,9020875,44,1,0,0,1
9020876,9021013,137,0,0,1,1
9020880,9020988,108,0,0,1,2
9020989,9021072,83,1,0,0,2
9021014,9021034,20,1,0,0,1
9021035,9023447,2412,0,0,1,1
9021073,9021109,36,0,0,1,2
9021110,9021216,106,1,0,0,2
9021217,9021269,52,0,0,1,2
9021270,9021445,175,1,0,0,2
9021446,9021469,23,0,0,1,2
9021470,9021483,13,1,0,0,2
9021484,9021548,64,0,0,1,2
9021549,9021638,89,1,0,0,2
9021639,9021923,284,0,0,1,2
9021924,9021983,59,1,0,0,2
9021984,9022043,59,0,0,1,2
9022044,9022947,903,1,0,0,2
9022948,9023085,137,0,0,1,2
9023086,9023555,469,1,0,0,2
9023448,9023519,71,1,0,0,1
9023520,9023634,114,0,0,1,1
9023556,9023635,79,0,0,1,2
9023635,9023653,18,1,0,0,1
9023636,9023655,19,1,0,0,2
9023654,9025823,2169,0,0,1,1
9023656,9025809,2153,0,0,1,2
9025810,9026013,203,1,0,0,2
9025824,9025980,156,1,0,0,1
9025848,9025926,78,0,1,0,2
9025869,9025873,4,0,1,0,1
9025981,9026034,53,0,0,1,1
9026014,9026053,39,0,0,1,2
9026035,9026072,37,1,0,0,1
9026054,9026252,198,1,0,0,2
9026073,9026138,65,0,0,1,1
9026139,9026194,55,1,0,0,1
9026195,9026362,167,0,0,1,1
9026253,9026318,65,0,0,1,2
9026319,9026411,92,1,0,0,2
9026363,9026394,31,1,0,0,1
9026395,9026930,535,0,0,1,1
9026412,9026572,160,0,0,1,2
9026573,9026577,4,1,0,0,2
9026578,9026933,355,0,0,1,2
9026931,9026957,26,1,0,0,1
9026934,9026970,36,1,0,0,2
9026958,9027096,138,0,0,1,1
9026971,9027096,125,0,0,1,2
9027097,9027117,20,1,0,0,1
9027097,9027118,21,1,0,0,2
9027118,9028418,1300,0,0,1,1
9027119,9027648,529,0,0,1,2
9027649,9027659,10,1,0,0,2
9027660,9028263,603,0,0,1,2
9028264,9028637,373,1,0,0,2
9028419,9028470,51,1,0,0,1
9028471,9028575,104,0,0,1,1
9028576,9028622,46,1,0,0,1
9028623,9028805,182,0,0,1,1
9028638,9028804,166,0,0,1,2
9028805,9028823,18,1,0,0,2
9028806,9028825,19,1,0,0,1
9028824,9031197,2373,0,0,1,2
9028826,9030234,1408,0,0,1,1
9030235,9030307,72,1,0,0,1
9030308,9030511,203,0,0,1,1
9030512,9030552,40,1,0,0,1
9030553,9030770,217,0,0,1,1
9030771,9030781,10,1,0,0,1
9030782,9030848,66,0,0,1,1
9030849,9030902,53,1,0,0,1
9030903,9031206,303,0,0,1,1
9031198,9031788,590,1,0,0,2
9031207,9031260,53,1,0,0,1
9031261,9031340,79,0,0,1,1
9031341,9031376,35,1,0,0,1
9031377,9033537,2160,0,0,1,1
9031789,9033537,1748,0,0,1,2
9033538,9033607,69,1,0,0,1
9033538,9033703,165,1,0,0,2
9033608,9033720,112,0,0,1,1
9033704,9033724,20,0,0,1,2
9033721,9033752,31,1,0,0,1
9033725,9034557,832,1,0,0,2
9033753,9033981,228,0,0,1,1
9033982,9034007,25,1,0,0,1
9034008,9034176,168,0,0,1,1
9034177,9034206,29,1,0,0,1
9034207,9034614,407,0,0,1,1
9034558,9034596,38,0,0,1,2
9034597,9035157,560,1,0,0,2
9034615,9034637,22,1,0,0,1
9034638,9035753,1115,0,0,1,1
9035158,9035178,20,0,0,1,2
9035179,9035318,139,1,0,0,2
9035319,9035344,25,0,0,1,2
9035345,9035681,336,1,0,0,2
9035682,9035744,62,0,0,1,2
9035745,9036304,559,1,0,0,2
9035754,9035799,45,1,0,0,1
9035800,9036211,411,0,0,1,1
9036212,9036337,125,1,0,0,1
9036305,9036404,99,0,0,1,2
9036338,9036404,66,0,0,1,1
9036405,9036444,39,1,0,0,1
9036405,9036453,48,1,0,0,2
9036445,9036580,135,0,0,1,1
9036454,9036580,126,0,0,1,2
9036581,9036605,24,1,0,0,2
9036581,9036612,31,1,0,0,1
9036606,9036998,392,0,0,1,2
9036613,9036990,377,0,0,1,1
9036991,9037898,907,1,0,0,1
9036999,9037328,329,1,0,0,2
9037025,9037107,82,0,1,0,1
9037034,9037087,53,0,1,0,2
9037329,9037535,206,0,0,1,2
9037536,9037552,16,1,0,0,2
9037553,9038115,562,0,0,1,2
9037899,9037978,79,0,0,1,1
9037979,9038175,196,1,0,0,1
9038116,9038212,96,1,0,0,2
9038176,9038547,371,0,0,1,1
9038213,9038551,338,0,0,1,2
9038548,9038640,92,1,0,0,1
9038552,9038649,97,1,0,0,2
9038641,9038872,231,0,0,1,1
9038650,9038871,221,0,0,1,2
9038872,9038887,15,1,0,0,2
9038873,9038887,14,1,0,0,1
9038888,9040063,1175,0,0,1,1
9038888,9040075,1187,0,0,1,2
9040064,9040251,187,1,0,0,1
9040076,9040300,224,1,0,0,2
9040114,9040195,81,0,1,0,2
9040121,9040190,69,0,1,0,1
9040252,9040417,165,0,0,1,1
9040301,9040417,116,0,0,1,2
9040418,9040470,52,1,0,0,2
9040418,9040477,59,1,0,0,1
9040471,9040593,122,0,0,1,2
9040478,9040595,117,0,0,1,1
9040594,9040671,77,1,0,0,2
9040596,9040662,66,1,0,0,1
9040663,9040791,128,0,0,1,1
9040672,9040792,120,0,0,1,2
9040792,9040810,18,1,0,0,1
9040793,9040820,27,1,0,0,2
9040811,9041630,819,0,0,1,1
9040821,9041626,805,0,0,1,2
9041627,9041642,15,1,0,0,2
9041631,9041636,5,1,0,0,1
9041637,9042186,549,0,0,1,1
9041643,9042174,531,0,0,1,2
9042175,9042428,253,1,0,0,2
9042187,9042398,211,1,0,0,1
9042218,9042357,139,0,1,0,2
9042235,9042332,97,0,1,0,1
9042399,9042627,228,0,0,1,1
9042429,9042455,26,0,0,1,2
9042456,9042482,26,1,0,0,2
9042483,9042625,142,0,0,1,2
9042626,9042667,41,1,0,0,2
9042628,9042668,40,1,0,0,1
9042668,9042713,45,0,0,1,2
9042669,9042716,47,0,0,1,1
9042714,9044852,2138,1,0,0,2
9042717,9042790,73,1,0,0,1
9042791,9042912,121,0,0,1,1
9042913,9043036,123,1,0,0,1
9042976,9043044,68,0,1,0,2
9042981,9043020,39,0,1,0,1
9043037,9043097,60,0,0,1,1
9043097,9043257,160,0,1,0,2
9043108,9043331,223,0,1,0,1
9043340,9043340,0,1,0,0,1
9043341,9043389,48,0,0,1,1
9043383,9043444,61,0,1,0,2
9043400,9043445,45,0,1,0,1
9043455,9043493,38,1,0,0,1
9043478,9043484,6,0,1,0,1
9043494,9043540,46,0,0,1,1
9043551,9043581,30,0,1,0,1
9043591,9044436,845,1,0,0,1
9043607,9044404,797,0,1,0,1
9043748,9043839,91,0,1,0,2
9043872,9044497,625,0,1,0,2
9044437,9044606,169,0,0,1,1
9044617,9044631,14,0,1,0,1
9044641,9044642,1,1,0,0,1
9044643,9044713,70,0,0,1,1
9044724,9044820,96,0,1,0,1
9044732,9044799,67,0,1,0,2
9044830,9044841,11,1,0,0,1
9044842,9045209,367,0,0,1,1
9044853,9044922,69,0,0,1,2
9044923,9044940,17,1,0,0,2
9044941,9044979,38,0,0,1,2
9044980,9045030,50,1,0,0,2
9045031,9045087,56,0,0,1,2
9045088,9045132,44,1,0,0,2
9045133,9045203,70,0,0,1,2
9045204,9045311,107,1,0,0,2
9045210,9045254,44,1,0,0,1
9045255,9045456,201,0,0,1,1
9045312,9045451,139,0,0,1,2
9045452,9045504,52,1,0,0,2
9045457,9045474,17,1,0,0,1
9045475,9045640,165,0,0,1,1
9045505,9045544,39,0,0,1,2
9045545,9045611,66,1,0,0,2
9045612,9045637,25,0,0,1,2
9045638,9045674,36,1,0,0,2
9045641,9045657,16,1,0,0,1
9045658,9046034,376,0,0,1,1
9045675,9045788,113,0,0,1,2
9045789,9045803,14,1,0,0,2
9045804,9046033,229,0,0,1,2
9046034,9046067,33,1,0,0,2
9046035,9046053,18,1,0,0,1
9046054,9046279,225,0,0,1,1
9046068,9046277,209,0,0,1,2
9046278,9046309,31,1,0,0,2
9046280,9046294,14,1,0,0,1
9046295,9046559,264,0,0,1,1
9046310,9046543,233,0,0,1,2
9046544,9047072,528,1,0,0,2
9046560,9046948,388,1,0,0,1
9046580,9046764,184,0,1,0,2
9046604,9046908,304,0,1,0,1
9046787,9046817,30,0,1,0,2
9046856,9046919,63,0,1,0,2
9046949,9047100,151,0,0,1,1
9047073,9047102,29,0,0,1,2
9047101,9047176,75,1,0,0,1
9047103,9047192,89,1,0,0,2
9047177,9047351,174,0,0,1,1
9047193,9047348,155,0,0,1,2
9047349,9047405,56,1,0,0,2
9047352,9047415,63,1,0,0,1
9047406,9047516,110,0,0,1,2
9047416,9047516,100,0,0,1,1
9047517,9047549,32,1,0,0,1
9047517,9047552,35,1,0,0,2
9047550,9048952,1402,0,0,1,1
9047553,9048952,1399,0,0,1,2
9048953,9049004,51,1,0,0,2
9048953,9049008,55,1,0,0,1
9049005,9049323,318,0,0,1,2
9049009,9049324,315,0,0,1,1
9049324,9049382,58,1,0,0,2
9049325,9049372,47,1,0,0,1
9049373,9049462,89,0,0,1,1
9049383,9049463,80,0,0,1,2
9049463,9049535,72,1,0,0,1
9049464,9049526,62,1,0,0,2
9049527,9049645,118,0,0,1,2
9049536,9049643,107,0,0,1,1
9049644,9049675,31,1,0,0,1
9049646,9049684,38,1,0,0,2
9049676,9049812,136,0,0,1,1
9049685,9049806,121,0,0,1,2
9049807,9049822,15,1,0,0,2
9049813,9049823,10,1,0,0,1
9049823,9050031,208,0,0,1,2
9049824,9050030,206,0,0,1,1
9050031,9050048,17,1,0,0,1
9050032,9050049,17,1,0,0,2
9050049,9050251,202,0,0,1,1
9050050,9050252,202,0,0,1,2
9050252,9050691,439,1,0,0,1
9050253,9050749,496,1,0,0,2
9050281,9050595,314,0,1,0,2
9050291,9050580,289,0,1,0,1
9050692,9050966,274,0,0,1,1
9050750,9050780,30,0,0,1,2
9050781,9050824,43,1,0,0,2
9050825,9051195,370,0,0,1,2
9050967,9050975,8,1,0,0,1
9050976,9051194,218,0,0,1,1
9051195,9051257,62,1,0,0,1
9051196,9051241,45,1,0,0,2
9051242,9051388,146,0,0,1,2
9051258,9051385,127,0,0,1,1
9051386,9051407,21,1,0,0,1
9051389,9051408,19,1,0,0,2
9051408,9051662,254,0,0,1,1
9051409,9051664,255,0,0,1,2
9051663,9051678,15,1,0,0,1
9051665,9051679,14,1,0,0,2
9051679,9053230,1551,0,0,1,1
9051680,9053232,1552,0,0,1,2
9053231,9053287,56,1,0,0,1
9053233,9053273,40,1,0,0,2
9053274,9053406,132,0,0,1,2
9053288,9053403,115,0,0,1,1
9053404,9053432,28,1,0,0,1
9053407,9053428,21,1,0,0,2
9053429,9055499,2070,0,0,1,2
9053433,9055496,2063,0,0,1,1
9055497,9055525,28,1,0,0,1
9055500,9055533,33,1,0,0,2
9055526,9055676,150,0,0,1,1
9055534,9055676,142,0,0,1,2
9055677,9055734,57,1,0,0,1
9055677,9055749,72,1,0,0,2
9055735,9055834,99,0,0,1,1
9055750,9055831,81,0,0,1,2
9055832,9055871,39,1,0,0,2
9055835,9055864,29,1,0,0,1
9055865,9057341,1476,0,0,1,1
9055872,9057337,1465,0,0,1,2
9057338,9057365,27,1,0,0,2
9057342,9057362,20,1,0,0,1
9057363,9057761,398,0,0,1,1
9057366,9057738,372,0,0,1,2
9057739,9059570,1831,1,0,0,2
9057762,9059351,1589,1,0,0,1
9057827,9057914,87,0,1,0,2
9057831,9059340,1509,0,1,0,1
9057937,9059326,1389,0,1,0,2
9059352,9059508,156,0,0,1,1
9059509,9059514,5,1,0,0,1
9059515,9060227,712,0,0,1,1
9059571,9059745,174,0,0,1,2
9059746,9059954,208,1,0,0,2
9059955,9059978,23,0,0,1,2
9059979,9060939,960,1,0,0,2
9060228,9060232,4,1,0,0,1
9060233,9060796,563,0,0,1,1
9060797,9060889,92,1,0,0,1
9060890,9061252,362,0,0,1,1
9060940,9061253,313,0,0,1,2
9061253,9061328,75,1,0,0,1
9061254,9061325,71,1,0,0,2
9061326,9061433,107,0,0,1,2
9061329,9061435,106,0,0,1,1
9061434,9061470,36,1,0,0,2
9061436,9061464,28,1,0,0,1
9061465,9062416,951,0,0,1,1
9061471,9062411,940,0,0,1,2
9062412,9062436,24,1,0,0,2
9062417,9062436,19,1,0,0,1
9062437,9062605,168,0,0,1,2
9062437,9062609,172,0,0,1,1
9062606,9062626,20,1,0,0,2
9062610,9062626,16,1,0,0,1
9062627,9062829,202,0,0,1,2
9062627,9062832,205,0,0,1,1
9062830,9062896,66,1,0,0,2
9062833,9062896,63,1,0,0,1
9062897,9063290,393,0,0,1,2
9062897,9063293,396,0,0,1,1
9063291,9063876,585,1,0,0,2
9063294,9063374,80,1,0,0,1
9063375,9063471,96,0,0,1,1
9063472,9063516,44,1,0,0,1
9063517,9063652,135,0,0,1,1
9063653,9063674,21,1,0,0,1
9063675,9064516,841,0,0,1,1
9063877,9064515,638,0,0,1,2
9064516,9064541,25,1,0,0,2
9064517,9064536,19,1,0,0,1
9064537,9066115,1578,0,0,1,1
9064542,9064849,307,0,0,1,2
9064850,9064880,30,1,0,0,2
9064881,9066115,1234,0,0,1,2
9066116,9066180,64,1,0,0,1
9066116,9066376,260,1,0,0,2
9066181,9066287,106,0,0,1,1
9066288,9066391,103,1,0,0,1
9066377,9066464,87,0,0,1,2
9066392,9066464,72,0,0,1,1
9066465,9066500,35,1,0,0,2
9066465,9066501,36,1,0,0,1
9066501,9066652,151,0,0,1,2
9066502,9066653,151,0,0,1,1
9066653,9066675,22,1,0,0,2
9066654,9066677,23,1,0,0,1
9066676,9066926,250,0,0,1,2
9066678,9066925,247,0,0,1,1
9066926,9066946,20,1,0,0,1
9066927,9066949,22,1,0,0,2
9066947,9067163,216,0,0,1,1
9066950,9067165,215,0,0,1,2
9067164,9067183,19,1,0,0,1
9067166,9067185,19,1,0,0,2
9067184,9068609,1425,0,0,1,1
9067186,9068612,1426,0,0,1,2
9068610,9068638,28,1,0,0,1
9068613,9068636,23,1,0,0,2
9068637,9068847,210,0,0,1,2
9068639,9068843,204,0,0,1,1
9068844,9068860,16,1,0,0,1
9068848,9068861,13,1,0,0,2
9068861,9069283,422,0,0,1,1
9068862,9069286,424,0,0,1,2
9069284,9069359,75,1,0,0,1
9069287,9069356,69,1,0,0,2
9069357,9069731,374,0,0,1,2
9069360,9069731,371,0,0,1,1
9069732,9069805,73,1,0,0,1
9069732,9069811,79,1,0,0,2
9069806,9069901,95,0,0,1,1
9069812,9069895,83,0,0,1,2
9069896,9069938,42,1,0,0,2
9069902,9069936,34,1,0,0,1
9069937,9070421,484,0,0,1,1
9069939,9070418,479,0,0,1,2
9070419,9070440,21,1,0,0,2
9070422,9070440,18,1,0,0,1
9070441,9070566,125,0,0,1,2
9070441,9070571,130,0,0,1,1
9070567,9070590,23,1,0,0,2
9070572,9070591,19,1,0,0,1
9070591,9071226,635,0,0,1,2
9070592,9071231,639,0,0,1,1
9071227,9071317,90,1,0,0,2
9071232,9071312,80,1,0,0,1
9071313,9071687,374,0,0,1,1
9071318,9071684,366,0,0,1,2
9071685,9071906,221,1,0,0,2
9071688,9071748,60,1,0,0,1
9071749,9071860,111,0,0,1,1
9071861,9071889,28,1,0,0,1
9071890,9072388,498,0,0,1,1
9071907,9072013,106,0,0,1,2
9072014,9072018,4,1,0,0,2
9072019,9072155,136,0,0,1,2
9072156,9072171,15,1,0,0,2
9072172,9072216,44,0,0,1,2
9072217,9072272,55,1,0,0,2
9072273,9072308,35,0,0,1,2
9072309,9072318,9,1,0,0,2
9072319,9072390,71,0,0,1,2
9072389,9072410,21,1,0,0,1
9072391,9072429,38,1,0,0,2
9072411,9072614,203,0,0,1,1
9072430,9072611,181,0,0,1,2
9072612,9072782,170,1,0,0,2
9072615,9072632,17,1,0,0,1
9072633,9072869,236,0,0,1,1
9072783,9072863,80,0,0,1,2
9072864,9072887,23,1,0,0,2
9072870,9072889,19,1,0,0,1
9072888,9073206,318,0,0,1,2
9072890,9073741,851,0,0,1,1
9073207,9073222,15,1,0,0,2
9073223,9073570,347,0,0,1,2
9073571,9073580,9,1,0,0,2
9073581,9073743,162,0,0,1,2
9073742,9073829,87,1,0,0,1
9073744,9073965,221,1,0,0,2
9073830,9073916,86,0,0,1,1
9073917,9073961,44,1,0,0,1
9073962,9074086,124,0,0,1,1
9073966,9074013,47,0,0,1,2
9074014,9074127,113,1,0,0,2
9074087,9074118,31,1,0,0,1
9074119,9074282,163,0,0,1,1
9074128,9074192,64,0,0,1,2
9074193,9074204,11,1,0,0,2
9074205,9074281,76,0,0,1,2
9074282,9074298,16,1,0,0,2
9074283,9074301,18,1,0,0,1
9074299,9074821,522,0,0,1,2
9074302,9074826,524,0,0,1,1
9074822,9074859,37,1,0,0,2
9074827,9074834,7,1,0,0,1
9074835,9075752,917,0,0,1,1
9074860,9074957,97,0,0,1,2
9074958,9074974,16,1,0,0,2
9074975,9075116,141,0,0,1,2
9075117,9075126,9,1,0,0,2
9075127,9075752,625,0,0,1,2
9075753,9075821,68,1,0,0,1
9075753,9075852,99,1,0,0,2
9075822,9076172,350,0,0,1,1
9075853,9076171,318,0,0,1,2
9076172,9076248,76,1,0,0,2
9076173,9076258,85,1,0,0,1
9076249,9076397,148,0,0,1,2
9076259,9076398,139,0,0,1,1
9076398,9076426,28,1,0,0,2
9076399,9076428,29,1,0,0,1
9076427,9076531,104,0,0,1,2
9076429,9076531,102,0,0,1,1
9076532,9076550,18,1,0,0,2
9076532,9076551,19,1,0,0,1
9076551,9076797,246,0,0,1,2
9076552,9076794,242,0,0,1,1
9076795,9076813,18,1,0,0,1
9076798,9076807,9,1,0,0,2
9076808,9077253,445,0,0,1,2
9076814,9078510,1696,0,0,1,1
9077254,9077262,8,1,0,0,2
9077263,9078508,1245,0,0,1,2
9078509,9078647,138,1,0,0,2
9078511,9078644,133,1,0,0,1
9078645,9078681,36,0,0,1,1
9078648,9078683,35,0,0,1,2
9078682,9078705,23,1,0,0,1
9078684,9078701,17,1,0,0,2
9078702,9078918,216,0,0,1,2
9078706,9078918,212,0,0,1,1
9078919,9078928,9,1,0,0,1
9078919,9078928,9,1,0,0,2
9078929,9079627,698,0,0,1,2
9078929,9079628,699,0,0,1,1
9079628,9079639,11,1,0,0,2
9079629,9079635,6,1,0,0,1
9079636,9079882,246,0,0,1,1
9079640,9079875,235,0,0,1,2
9079876,9079895,19,1,0,0,2
9079883,9079887,4,1,0,0,1
9079888,9080144,256,0,0,1,1
9079896,9080142,246,0,0,1,2
9080143,9080163,20,1,0,0,2
9080145,9080160,15,1,0,0,1
9080161,9080967,806,0,0,1,1
9080164,9080968,804,0,0,1,2
9080968,9081024,56,1,0,0,1
9080969,9081028,59,1,0,0,2
9081025,9081209,184,0,0,1,1
9081029,9081218,189,0,0,1,2
9081210,9081224,14,1,0,0,1
9081219,9081225,6,1,0,0,2
9081225,9083072,1847,0,0,1,1
9081226,9083073,1847,0,0,1,2
9083073,9083154,81,1,0,0,1
9083074,9083153,79,1,0,0,2
9083154,9083180,26,0,0,1,2
9083155,9083282,127,0,0,1,1
9083181,9083226,45,1,0,0,2
9083227,9083275,48,0,0,1,2
9083276,9083351,75,1,0,0,2
9083283,9083337,54,1,0,0,1
9083338,9083507,169,0,0,1,1
9083352,9083511,159,0,0,1,2
9083508,9083528,20,1,0,0,1
9083512,9083538,26,1,0,0,2
9083529,9083758,229,0,0,1,1
9083539,9084371,832,0,0,1,2
9083759,9083764,5,1,0,0,1
9083765,9084491,726,0,0,1,1
9084372,9084565,193,1,0,0,2
9084492,9084508,16,1,0,0,1
9084509,9085326,817,0,0,1,1
9084566,9084825,259,0,0,1,2
9084826,9084845,19,1,0,0,2
9084846,9085237,391,0,0,1,2
9085238,9085243,5,1,0,0,2
9085244,9085295,51,0,0,1,2
9085296,9085415,119,1,0,0,2
9085327,9085385,58,1,0,0,1
9085343,9085344,1,0,1,0,2
9085386,9085686,300,0,0,1,1
9085416,9085682,266,0,0,1,2
9085683,9087657,1974,1,0,0,2
9085687,9085776,89,1,0,0,1
9085777,9085883,106,0,0,1,1
9085884,9085924,40,1,0,0,1
9085925,9086120,195,0,0,1,1
9086121,9086138,17,1,0,0,1
9086139,9087087,948,0,0,1,1
9087088,9087108,20,1,0,0,1
9087109,9087610,501,0,0,1,1
9087611,9087658,47,1,0,0,1
9087658,9088032,374,0,0,1,2
9087659,9088032,373,0,0,1,1
9088033,9088105,72,1,0,0,1
9088033,9088107,74,1,0,0,2
9088106,9088301,195,0,0,1,1
9088108,9088301,193,0,0,1,2
9088302,9088319,17,1,0,0,1
9088302,9088322,20,1,0,0,2
9088320,9088528,208,0,0,1,1
9088323,9088527,204,0,0,1,2
9088528,9088551,23,1,0,0,2
9088529,9088545,16,1,0,0,1
9088546,9089315,769,0,0,1,1
9088552,9089314,762,0,0,1,2
9089315,9089335,20,1,0,0,2
9089316,9089333,17,1,0,0,1
9089334,9089569,235,0,0,1,1
9089336,9089563,227,0,0,1,2
9089564,9089583,19,1,0,0,2
9089570,9089580,10,1,0,0,1
9089581,9090532,951,0,0,1,1
9089584,9090529,945,0,0,1,2
9090530,9090821,291,1,0,0,2
9090533,9090608,75,1,0,0,1
9090609,9090775,166,0,0,1,1
9090776,9090806,30,1,0,0,1
9090807,9092714,1907,0,0,1,1
9090822,9091159,337,0,0,1,2
9091160,9091176,16,1,0,0,2
9091177,9092710,1533,0,0,1,2
9092711,9092817,106,1,0,0,2
9092715,9092767,52,1,0,0,1
9092768,9093239,471,0,0,1,1
9092818,9092877,59,0,0,1,2
9092878,9093360,482,1,0,0,2
9093240,9093284,44,1,0,0,1
9093285,9093640,355,0,0,1,1
9093361,9093631,270,0,0,1,2
9093632,9093920,288,1,0,0,2
9093641,9093896,255,1,0,0,1
9093667,9093842,175,0,1,0,2
9093669,9093854,185,0,1,0,1
9093897,9094366,469,0,0,1,1
9093921,9094365,444,0,0,1,2
9094366,9094720,354,1,0,0,2
9094367,9094552,185,1,0,0,1
9094397,9094520,123,0,1,0,2
9094400,9094505,105,0,1,0,1
9094553,9094825,272,0,0,1,1
9094721,9094825,104,0,0,1,2
9094826,9094858,32,1,0,0,2
9094826,9094863,37,1,0,0,1
9094859,9095210,351,0,0,1,2
9094864,9095215,351,0,0,1,1
9095211,9095455,244,1,0,0,2
9095216,9095444,228,1,0,0,1
9095266,9095390,124,0,1,0,2
9095275,9095374,99,0,1,0,1
9095445,9095675,230,0,0,1,1
9095456,9095515,59,0,0,1,2
9095516,9095520,4,1,0,0,2
9095521,9095590,69,0,0,1,2
9095591,9095747,156,1,0,0,2
9095676,9095727,51,1,0,0,1
9095728,9096162,434,0,0,1,1
9095748,9095977,229,0,0,1,2
9095978,9096256,278,1,0,0,2
9096163,9096204,41,1,0,0,1
9096205,9096581,376,0,0,1,1
9096257,9096563,306,0,0,1,2
9096564,9098434,1870,1,0,0,2
9096582,9096769,187,1,0,0,1
9096618,9096741,123,0,1,0,2
9096633,9096721,88,0,1,0,1
9096770,9096875,105,0,0,1,1
9096876,9097340,464,1,0,0,1
9096897,9097339,442,0,1,0,2
9096909,9097314,405,0,1,0,1
9097341,9097500,159,0,0,1,1
9097501,9097768,267,1,0,0,1
9097540,9097733,193,0,1,0,2
9097545,9097730,185,0,1,0,1
9097769,9098117,348,0,0,1,1
9098118,9098132,14,1,0,0,1
9098133,9098189,56,0,0,1,1
9098190,9098247,57,1,0,0,1
9098248,9098551,303,0,0,1,1
9098435,9098538,103,0,0,1,2
9098539,9098630,91,1,0,0,2
9098552,9098623,71,1,0,0,1
9098624,9098717,93,0,0,1,1
9098631,9098691,60,0,0,1,2
9098692,9098948,256,1,0,0,2
9098718,9098897,179,1,0,0,1
9098748,9098840,92,0,1,0,1
9098748,9098855,107,0,1,0,2
9098898,9099052,154,0,0,1,1
9098949,9098990,41,0,0,1,2
9098991,9099500,509,1,0,0,2
9099053,9099094,41,1,0,0,1
9099095,9099366,271,0,0,1,1
9099367,9099421,54,1,0,0,1
9099422,9099695,273,0,0,1,1
9099501,9099675,174,0,0,1,2
9099676,9099988,312,1,0,0,2
9099696,9099926,230,1,0,0,1
9099740,9099890,150,0,1,0,2
9099763,9099874,111,0,1,0,1
9099927,9100260,333,0,0,1,1
9099989,9100029,40,0,0,1,2
9100030,9100313,283,1,0,0,2
9100261,9100301,40,1,0,0,1
9100302,9100529,227,0,0,1,1
9100314,9100530,216,0,0,1,2
9100530,9100575,45,1,0,0,1
9100531,9100592,61,1,0,0,2
9100576,9100707,131,0,0,1,1
9100593,9100707,114,0,0,1,2
9100708,9100773,65,1,0,0,1
9100708,9101090,382,1,0,0,2
9100774,9101023,249,0,0,1,1
9101024,9101083,59,1,0,0,1
9101084,9101285,201,0,0,1,1
9101091,9101263,172,0,0,1,2
9101264,9101546,282,1,0,0,2
9101286,9101497,211,1,0,0,1
9101321,9101455,134,0,1,0,2
9101326,9101448,122,0,1,0,1
9101498,9103272,1774,0,0,1,1
9101547,9101591,44,0,0,1,2
9101592,9101709,117,1,0,0,2
9101710,9101738,28,0,0,1,2
9101739,9101946,207,1,0,0,2
9101947,9101977,30,0,0,1,2
9101978,9103337,1359,1,0,0,2
9103273,9103337,64,1,0,0,1
9103338,9103479,141,0,0,1,2
9103338,9103668,330,0,0,1,1
9103480,9104507,1027,1,0,0,2
9103669,9103698,29,1,0,0,1
9103699,9104434,735,0,0,1,1
9104435,9104504,69,1,0,0,1
9104505,9105346,841,0,0,1,1
9104508,9105344,836,0,0,1,2
9105345,9105688,343,1,0,0,2
9105347,9105687,340,1,0,0,1
9105379,9105614,235,0,1,0,2
9105387,9105617,230,0,1,0,1
9105643,9105646,3,0,1,0,2
9105688,9105860,172,0,0,1,1
9105689,9105723,34,0,0,1,2
9105724,9107503,1779,1,0,0,2
9105861,9105919,58,1,0,0,1
9105920,9106379,459,0,0,1,1
9106380,9106426,46,1,0,0,1
9106427,9106544,117,0,0,1,1
9106545,9106754,209,1,0,0,1
9106552,9106680,128,0,1,0,2
9106566,9106691,125,0,1,0,1
9106710,9106719,9,0,1,0,2
9106755,9106903,148,0,0,1,1
9106904,9106954,50,1,0,0,1
9106955,9107361,406,0,0,1,1
9107362,9107408,46,1,0,0,1
9107409,9107933,524,0,0,1,1
9107504,9107534,30,0,0,1,2
9107535,9107577,42,1,0,0,2
9107578,9107610,32,0,0,1,2
9107611,9107787,176,1,0,0,2
9107788,9107817,29,0,0,1,2
9107818,9108977,1159,1,0,0,2
9107934,9107983,49,1,0,0,1
9107984,9108230,246,0,0,1,1
9108231,9108264,33,1,0,0,1
9108265,9108464,199,0,0,1,1
9108465,9108498,33,1,0,0,1
9108499,9108776,277,0,0,1,1
9108777,9108965,188,1,0,0,1
9108808,9108921,113,0,1,0,2
9108835,9108873,38,0,1,0,1
9108966,9109149,183,0,0,1,1
9108978,9109067,89,0,0,1,2
9109068,9110016,948,1,0,0,2
9109150,9109207,57,1,0,0,1
9109208,9109607,399,0,0,1,1
9109608,9109918,310,1,0,0,1
9109642,9109812,170,0,1,0,2
9109648,9109857,209,0,1,0,1
9109853,9109857,4,0,1,0,2
9109889,9109931,42,0,1,0,2
9109919,9110053,134,0,0,1,1
9110017,9110050,33,0,0,1,2
9110051,9110102,51,1,0,0,2
9110054,9110105,51,1,0,0,1
9110103,9110124,21,0,0,1,2
9110106,9110482,376,0,0,1,1
9110125,9112163,2038,1,0,0,2
9110483,9110540,57,1,0,0,1
9110541,9110856,315,0,0,1,1
9110857,9110906,49,1,0,0,1
9110907,9111386,479,0,0,1,1
9111387,9111435,48,1,0,0,1
9111436,9111710,274,0,0,1,1
9111711,9112018,307,1,0,0,1
9111742,9111899,157,0,1,0,2
9111754,9111957,203,0,1,0,1
9111930,9111938,8,0,1,0,2
9111962,9111983,21,0,1,0,2
9112008,9112013,5,0,1,0,2
9112019,9112070,51,0,0,1,1
9112071,9112122,51,1,0,0,1
9112123,9112494,371,0,0,1,1
9112164,9112230,66,0,0,1,2
9112231,9113144,913,1,0,0,2
9112495,9112549,54,1,0,0,1
9112550,9112673,123,0,0,1,1
9112674,9113076,402,1,0,0,1
9112718,9112977,259,0,1,0,2
9112724,9113059,335,0,1,0,1
9113012,9113039,27,0,1,0,2
9113077,9113200,123,0,0,1,1
9113145,9113189,44,0,0,1,2
9113190,9113856,666,1,0,0,2
9113201,9113367,166,1,0,0,1
9113237,9113318,81,0,1,0,2
9113255,9113313,58,0,1,0,1
9113368,9113646,278,0,0,1,1
9113647,9113696,49,1,0,0,1
9113697,9113951,254,0,0,1,1
9113857,9113951,94,0,0,1,2
9113952,9113996,44,1,0,0,1
9113952,9114001,49,1,0,0,2
9113997,9114138,141,0,0,1,1
9114002,9114140,138,0,0,1,2
9114139,9114190,51,1,0,0,1
9114141,9114245,104,1,0,0,2
9114191,9114402,211,0,0,1,1
9114246,9114403,157,0,0,1,2
9114403,9114462,59,1,0,0,1
9114404,9114464,60,1,0,0,2
9114463,9114578,115,0,0,1,1
9114465,9114576,111,0,0,1,2
9114577,9114601,24,1,0,0,2
9114579,9114603,24,1,0,0,1
9114602,9114826,224,0,0,1,2
9114604,9114825,221,0,0,1,1
9114826,9114837,11,1,0,0,1
9114827,9114837,10,1,0,0,2
9114838,9115282,444,0,0,1,2
9114838,9117411,2573,0,0,1,1
9115283,9115303,20,1,0,0,2
9115304,9115379,75,0,0,1,2
9115380,9116672,1292,1,0,0,2
9116673,9116705,32,0,0,1,2
9116706,9117332,626,1,0,0,2
9117333,9117358,25,0,0,1,2
9117359,9117374,15,1,0,0,2
9117375,9117404,29,0,0,1,2
9117405,9117920,515,1,0,0,2
9117412,9117420,8,1,0,0,1
9117421,9117849,428,0,0,1,1
9117850,9117908,58,1,0,0,1
9117909,9120414,2505,0,0,1,1
9117921,9120414,2493,0,0,1,2
9120415,9120461,46,1,0,0,2
9120415,9120462,47,1,0,0,1
9120462,9120760,298,0,0,1,2
9120463,9120761,298,0,0,1,1
9120761,9121297,536,1,0,0,2
9120762,9121043,281,1,0,0,1
9120800,9121013,213,0,1,0,2
9120812,9120973,161,0,1,0,1
9121044,9121258,214,0,0,1,1
9121259,9121296,37,1,0,0,1
9121297,9121561,264,0,0,1,1
9121298,9121343,45,0,0,1,2
9121344,9121637,293,1,0,0,2
9121562,9121637,75,1,0,0,1
9121638,9121779,141,0,0,1,2
9121638,9121781,143,0,0,1,1
9121780,9121797,17,1,0,0,2
9121782,9121797,15,1,0,0,1
9121798,9123691,1893,0,0,1,2
9121798,9123695,1897,0,0,1,1
9123692,9123710,18,1,0,0,2
9123696,9123708,12,1,0,0,1
9123709,9124225,516,0,0,1,1
9123711,9124229,518,0,0,1,2
9124226,9124279,53,1,0,0,1
9124230,9124285,55,1,0,0,2
9124280,9124441,161,0,0,1,1
9124286,9124442,156,0,0,1,2
9124442,9124461,19,1,0,0,1
9124443,9124460,17,1,0,0,2
9124461,9126839,2378,0,0,1,2
9124462,9126836,2374,0,0,1,1
9126837,9126855,18,1,0,0,1
9126840,9126856,16,1,0,0,2
9126856,9127427,571,0,0,1,1
9126857,9127431,574,0,0,1,2
9127428,9127481,53,1,0,0,1
9127432,9127482,50,1,0,0,2
9127482,9127985,503,0,0,1,1
9127483,9127986,503,0,0,1,2
9127986,9128049,63,1,0,0,1
9127987,9128050,63,1,0,0,2
9128050,9128196,146,0,0,1,1
9128051,9128197,146,0,0,1,2
9128197,9128205,8,1,0,0,1
9128198,9128205,7,1,0,0,2
9128206,9129460,1254,0,0,1,2
9128206,9129463,1257,0,0,1,1
9129461,9129478,17,1,0,0,2
9129464,9129472,8,1,0,0,1
9129473,9129675,202,0,0,1,1
9129479,9129674,195,0,0,1,2
9129675,9129695,20,1,0,0,2
9129676,9129695,19,1,0,0,1
9129696,9129843,147,0,0,1,2
9129696,9129845,149,0,0,1,1
9129844,9129888,44,1,0,0,2
9129846,9129899,53,1,0,0,1
9129889,9130083,194,0,0,1,2
9129900,9130081,181,0,0,1,1
9130082,9130109,27,1,0,0,1
9130084,9130104,20,1,0,0,2
9130105,9131494,1389,0,0,1,2
9130110,9131495,1385,0,0,1,1
9131495,9131511,16,1,0,0,2
9131496,9131511,15,1,0,0,1
9131512,9132268,756,0,0,1,2
9131512,9132279,767,0,0,1,1
9132269,9132963,694,1,0,0,2
9132280,9132490,210,1,0,0,1
9132311,9132457,146,0,1,0,2
9132320,9132428,108,0,1,0,1
9132491,9133206,715,0,0,1,1
9132964,9133206,242,0,0,1,2
9133207,9133271,64,1,0,0,2
9133207,9133273,66,1,0,0,1
9133272,9133415,143,0,0,1,2
9133274,9133413,139,0,0,1,1
9133414,9133432,18,1,0,0,1
9133416,9133435,19,1,0,0,2
9133433,9135496,2063,0,0,1,1
9133436,9135496,2060,0,0,1,2
9135497,9135534,37,1,0,0,1
9135497,9135537,40,1,0,0,2
9135535,9137681,2146,0,0,1,1
9135538,9137672,2134,0,0,1,2
9137673,9138137,464,1,0,0,2
9137682,9138034,352,1,0,0,1
9137720,9137995,275,0,1,0,2
9137766,9137973,207,0,1,0,1
9138035,9138354,319,0,0,1,1
9138138,9138213,75,0,0,1,2
9138214,9138280,66,1,0,0,2
9138281,9138352,71,0,0,1,2
9138353,9138660,307,1,0,0,2
9138355,9138424,69,1,0,0,1
9138425,9138600,175,0,0,1,1
9138601,9138659,58,1,0,0,1
9138660,9138917,257,0,0,1,1
9138661,9138916,255,0,0,1,2
9138917,9138969,52,1,0,0,2
9138918,9138965,47,1,0,0,1
9138966,9139115,149,0,0,1,1
9138970,9139115,145,0,0,1,2
9139116,9139158,42,1,0,0,1
9139116,9139159,43,1,0,0,2
9139159,9139357,198,0,0,1,1
9139160,9139356,196,0,0,1,2
9139357,9139419,62,1,0,0,2
9139358,9139416,58,1,0,0,1
9139417,9139595,178,0,0,1,1
9139420,9139595,175,0,0,1,2
9139596,9139616,20,1,0,0,1
9139596,9139621,25,1,0,0,2
9139617,9141500,1883,0,0,1,1
9139622,9139799,177,0,0,1,2
9139800,9139814,14,1,0,0,2
9139815,9141315,1500,0,0,1,2
9141316,9141323,7,1,0,0,2
9141324,9141495,171,0,0,1,2
9141496,9141513,17,1,0,0,2
9141501,9141511,10,1,0,0,1
9141512,9142076,564,0,0,1,1
9141514,9142075,561,0,0,1,2
9142076,9142119,43,1,0,0,2
9142077,9142114,37,1,0,0,1
9142115,9142343,228,0,0,1,1
9142120,9142341,221,0,0,1,2
9142342,9142367,25,1,0,0,2
9142344,9142364,20,1,0,0,1
9142365,9142812,447,0,0,1,1
9142368,9142805,437,0,0,1,2
9142806,9143054,248,1,0,0,2
9142813,9143012,199,1,0,0,1
9142837,9142938,101,0,1,0,2
9142859,9142904,45,0,1,0,1
9143013,9144252,1239,0,0,1,1
9143055,9143132,77,0,0,1,2
9143133,9143226,93,1,0,0,2
9143227,9144250,1023,0,0,1,2
9144251,9144284,33,1,0,0,2
9144253,9144280,27,1,0,0,1
9144281,9144494,213,0,0,1,1
9144285,9144473,188,0,0,1,2
9144474,9145966,1492,1,0,0,2
9144495,9145144,649,1,0,0,1
9144527,9144725,198,0,1,0,2
9144550,9144694,144,0,1,0,1
9144922,9145135,213,0,1,0,2
9144942,9145100,158,0,1,0,1
9145145,9146000,855,0,0,1,1
9145967,9145989,22,0,0,1,2
9145990,9146058,68,1,0,0,2
9146001,9146050,49,1,0,0,1
9146051,9146167,116,0,0,1,1
9146059,9146128,69,0,0,1,2
9146129,9146611,482,1,0,0,2
9146168,9146708,540,1,0,0,1
9146230,9146233,3,0,1,0,2
9146380,9146465,85,0,1,0,2
9146612,9146761,149,0,0,1,2
9146709,9146939,230,0,0,1,1
9146762,9147347,585,1,0,0,2
9146940,9146962,22,1,0,0,1
9146963,9148292,1329,0,0,1,1
9147348,9147368,20,0,0,1,2
9147369,9147619,250,1,0,0,2
9147620,9147711,91,0,0,1,2
9147712,9147986,274,1,0,0,2
9147987,9148127,140,0,0,1,2
9148128,9148373,245,1,0,0,2
9148293,9148340,47,1,0,0,1
9148341,9149171,830,0,0,1,1
9148374,9149162,788,0,0,1,2
9149163,9149201,38,1,0,0,2
9149172,9149187,15,1,0,0,1
9149188,9149471,283,0,0,1,1
9149202,9149469,267,0,0,1,2
9149470,9149491,21,1,0,0,2
9149472,9149500,28,1,0,0,1
9149492,9149910,418,0,0,1,2
9149501,9149932,431,0,0,1,1
9149911,9150389,478,1,0,0,2
9149933,9150486,553,1,0,0,1
9149961,9150013,52,0,1,0,2
9149961,9150102,141,0,1,0,1
9150072,9150111,39,0,1,0,2
9150390,9150420,30,0,0,1,2
9150421,9150548,127,1,0,0,2
9150487,9150715,228,0,0,1,1
9150549,9150575,26,0,0,1,2
9150576,9151001,425,1,0,0,2
9150716,9150978,262,1,0,0,1
9150752,9150938,186,0,1,0,2
9150759,9150924,165,0,1,0,1
9150979,9151572,593,0,0,1,1
9151002,9151023,21,0,0,1,2
9151024,9151096,72,1,0,0,2
9151097,9151573,476,0,0,1,2
9151573,9151604,31,1,0,0,1
9151574,9151603,29,1,0,0,2
9151604,9151812,208,0,0,1,2
9151605,9151809,204,0,0,1,1
9151810,9151865,55,1,0,0,1
9151813,9151877,64,1,0,0,2
9151866,9151958,92,0,0,1,1
9151878,9151956,78,0,0,1,2
9151957,9151987,30,1,0,0,2
9151959,9151986,27,1,0,0,1
9151987,9152200,213,0,0,1,1
9151988,9152197,209,0,0,1,2
9152198,9152214,16,1,0,0,2
9152201,9152208,7,1,0,0,1
9152209,9154623,2414,0,0,1,1
9152215,9154622,2407,0,0,1,2
9154623,9154684,61,1,0,0,2
9154624,9154677,53,1,0,0,1
9154678,9154810,132,0,0,1,1
9154685,9154807,122,0,0,1,2
9154808,9154833,25,1,0,0,2
9154811,9154835,24,1,0,0,1
9154834,9155460,626,0,0,1,2
9154836,9155466,630,0,0,1,1
9155461,9155483,22,1,0,0,2
9155467,9155476,9,1,0,0,1
9155477,9156744,1267,0,0,1,1
9155484,9156553,1069,0,0,1,2
9156554,9156564,10,1,0,0,2
9156565,9156742,177,0,0,1,2
9156743,9156793,50,1,0,0,2
9156745,9156792,47,1,0,0,1
9156793,9157033,240,0,0,1,1
9156794,9157000,206,0,0,1,2
9157001,9157737,736,1,0,0,2
9157034,9157048,14,1,0,0,1
9157049,9157079,30,0,0,1,1
9157080,9157113,33,1,0,0,1
9157114,9157415,301,0,0,1,1
9157416,9157689,273,1,0,0,1
9157435,9157615,180,0,1,0,2
9157449,9157587,138,0,1,0,1
9157690,9158380,690,0,0,1,1
9157738,9157764,26,0,0,1,2
9157765,9158113,348,1,0,0,2
9158114,9158379,265,0,0,1,2
9158380,9158567,187,1,0,0,2
9158381,9158430,49,1,0,0,1
9158431,9158480,49,0,0,1,1
9158481,9158529,48,1,0,0,1
9158530,9158632,102,0,0,1,1
9158568,9158632,64,0,0,1,2
9158633,9158674,41,1,0,0,1
9158633,9158675,42,1,0,0,2
9158675,9160695,2020,0,0,1,1
9158676,9160693,2017,0,0,1,2
9160694,9160736,42,1,0,0,2
9160696,9160728,32,1,0,0,1
9160729,9161257,528,0,0,1,1
9160737,9161258,521,0,0,1,2
9161258,9161279,21,1,0,0,1
9161259,9161278,19,1,0,0,2
9161279,9163969,2690,0,0,1,2
9161280,9163970,2690,0,0,1,1
9163970,9164019,49,1,0,0,2
9163971,9164018,47,1,0,0,1
9164019,9164131,112,0,0,1,1
9164020,9164131,111,0,0,1,2
9164132,9164165,33,1,0,0,2
9164132,9164167,35,1,0,0,1
9164166,9164287,121,0,0,1,2
9164168,9164289,121,0,0,1,1
9164288,9164312,24,1,0,0,2
9164290,9164308,18,1,0,0,1
9164309,9165743,1434,0,0,1,1
9164313,9165630,1317,0,0,1,2
9165631,9166279,648,1,0,0,2
9165744,9165773,29,1,0,0,1
9165774,9166205,431,0,0,1,1
9166206,9166265,59,1,0,0,1
9166266,9166827,561,0,0,1,1
9166280,9166829,549,0,0,1,2
9166828,9166853,25,1,0,0,1
9166830,9166853,23,1,0,0,2
9166854,9168388,1534,0,0,1,2
9166854,9168398,1544,0,0,1,1
9168389,9168782,393,1,0,0,2
9168399,9168698,299,1,0,0,1
9168446,9168664,218,0,1,0,2
9168461,9168627,166,0,1,0,1
9168699,9169036,337,0,0,1,1
9168783,9168854,71,0,0,1,2
9168855,9168898,43,1,0,0,2
9168899,9169037,138,0,0,1,2
9169037,9169062,25,1,0,0,1
9169038,9169553,515,1,0,0,2
9169063,9169191,128,0,0,1,1
9169192,9169520,328,1,0,0,1
9169213,9169478,265,0,1,0,2
9169219,9169479,260,0,1,0,1
9169521,9169733,212,0,0,1,1
9169554,9169604,50,0,0,1,2
9169605,9169672,67,1,0,0,2
9169673,9169734,61,0,0,1,2
9169734,9169804,70,1,0,0,1
9169735,9169802,67,1,0,0,2
9169803,9169952,149,0,0,1,2
9169805,9169951,146,0,0,1,1
9169952,9169969,17,1,0,0,1
9169953,9169972,19,1,0,0,2
9169970,9172942,2972,0,0,1,1
9169973,9170176,203,0,0,1,2
9170177,9170188,11,1,0,0,2
9170189,9172605,2416,0,0,1,2
9172606,9172619,13,1,0,0,2
9172620,9172941,321,0,0,1,2
9172942,9172977,35,1,0,0,2
9172943,9172980,37,1,0,0,1
9172978,9173246,268,0,0,1,2
9172981,9173246,265,0,0,1,1
9173247,9173251,4,1,0,0,1
9173247,9173259,12,1,0,0,2
9173252,9175116,1864,0,0,1,1
9173260,9175106,1846,0,0,1,2
9175107,9175448,341,1,0,0,2
9175117,9175383,266,1,0,0,1
9175147,9175349,202,0,1,0,2
9175168,9175316,148,0,1,0,1
9175384,9175919,535,0,0,1,1
9175449,9175508,59,0,0,1,2
9175509,9175845,336,1,0,0,2
9175846,9175918,72,0,0,1,2
9175919,9175951,32,1,0,0,2
9175920,9175953,33,1,0,0,1
9175952,9176381,429,0,0,1,2
9175954,9176379,425,0,0,1,1
9176380,9176444,64,1,0,0,1
9176382,9178446,2064,1,0,0,2
9176445,9176613,168,0,0,1,1
9176614,9176637,23,1,0,0,1
9176638,9176867,229,0,0,1,1
9176868,9176889,21,1,0,0,1
9176890,9177112,222,0,0,1,1
9177113,9177132,19,1,0,0,1
9177133,9178350,1217,0,0,1,1
9178351,9178396,45,1,0,0,1
9178397,9180413,2016,0,0,1,1
9178447,9179384,937,0,0,1,2
9179385,9179587,202,1,0,0,2
9179588,9179641,53,0,0,1,2
9179642,9179739,97,1,0,0,2
9179740,9180414,674,0,0,1,2
9180414,9180450,36,1,0,0,1
9180415,9180451,36,1,0,0,2
9180451,9180659,208,0,0,1,1
9180452,9180659,207,0,0,1,2
9180660,9180896,236,1,0,0,1
9180660,9181122,462,1,0,0,2
9180702,9180841,139,0,1,0,2
9180715,9180829,114,0,1,0,1
9180897,9181597,700,0,0,1,1
9181123,9181200,77,0,0,1,2
9181201,9181227,26,1,0,0,2
9181228,9181300,72,0,0,1,2
9181301,9181363,62,1,0,0,2
9181364,9181599,235,0,0,1,2
9181598,9181654,56,1,0,0,1
9181600,9181662,62,1,0,0,2
9181655,9181757,102,0,0,1,1
9181663,9181756,93,0,0,1,2
9181757,9181817,60,1,0,0,2
9181758,9181799,41,1,0,0,1
9181800,9182036,236,0,0,1,1
9181818,9182039,221,0,0,1,2
9182037,9182049,12,1,0,0,1
9182040,9182056,16,1,0,0,2
9182050,9182282,232,0,0,1,1
9182057,9182285,228,0,0,1,2
9182283,9182300,17,1,0,0,1
9182286,9182304,18,1,0,0,2
9182301,9182551,250,0,0,1,1
9182305,9183111,806,0,0,1,2
9182552,9182561,9,1,0,0,1
9182562,9183314,752,0,0,1,1
9183112,9183116,4,1,0,0,2
9183117,9183312,195,0,0,1,2
9183313,9183321,8,1,0,0,2
9183315,9183329,14,1,0,0,1
9183322,9183732,410,0,0,1,2
9183330,9183733,403,0,0,1,1
9183733,9183799,66,1,0,0,2
9183734,9183781,47,1,0,0,1
9183782,9184564,782,0,0,1,1
9183800,9184556,756,0,0,1,2
9184557,9184580,23,1,0,0,2
9184565,9184574,9,1,0,0,1
9184575,9186416,1841,0,0,1,1
9184581,9186415,1834,0,0,1,2
9186416,9186549,133,1,0,0,2
9186417,9186468,51,1,0,0,1
9186469,9186795,326,0,0,1,1
9186550,9186794,244,0,0,1,2
9186795,9186842,47,1,0,0,2
9186796,9186837,41,1,0,0,1
9186838,9187279,441,0,0,1,1
9186843,9187279,436,0,0,1,2
9187280,9187342,62,1,0,0,2
9187280,9187359,79,1,0,0,1
9187343,9187416,73,0,0,1,2
9187360,9187450,90,0,0,1,1
9187417,9187579,162,1,0,0,2
9187451,9187492,41,1,0,0,1
9187493,9187616,123,0,0,1,1
9187580,9187607,27,0,0,1,2
9187608,9187669,61,1,0,0,2
9187617,9187636,19,1,0,0,1
9187637,9188088,451,0,0,1,1
9187670,9187732,62,0,0,1,2
9187733,9187761,28,1,0,0,2
9187762,9187874,112,0,0,1,2
9187875,9187888,13,1,0,0,2
9187889,9188090,201,0,0,1,2
9188089,9188107,18,1,0,0,1
9188091,9188112,21,1,0,0,2
9188108,9189735,1627,0,0,1,1
9188113,9188230,117,0,0,1,2
9188231,9188278,47,1,0,0,2
9188279,9188348,69,0,0,1,2
9188349,9188362,13,1,0,0,2
9188363,9188465,102,0,0,1,2
9188466,9188497,31,1,0,0,2
9188498,9188744,246,0,0,1,2
9188745,9188761,16,1,0,0,2
9188762,9188805,43,0,0,1,2
9188806,9188824,18,1,0,0,2
9188825,9188906,81,0,0,1,2
9188907,9188928,21,1,0,0,2
9188929,9189585,656,0,0,1,2
9189586,9189640,54,1,0,0,2
9189641,9189735,94,0,0,1,2
9189736,9189776,40,1,0,0,1
9189736,9190128,392,1,0,0,2
9189777,9190276,499,0,0,1,1
9190129,9190210,81,0,0,1,2
9190211,9190821,610,1,0,0,2
9190277,9190283,6,1,0,0,1
9190284,9191861,1577,0,0,1,1
9190822,9190850,28,0,0,1,2
9190851,9191016,165,1,0,0,2
9191017,9191056,39,0,0,1,2
9191057,9191146,89,1,0,0,2
9191147,9191228,81,0,0,1,2
9191229,9191370,141,1,0,0,2
9191371,9191401,30,0,0,1,2
9191402,9192272,870,1,0,0,2
9191862,9192196,334,1,0,0,1
9191893,9192109,216,0,1,0,2
9191897,9192091,194,0,1,0,1
9192197,9192748,551,0,0,1,1
9192273,9192342,69,0,0,1,2
9192343,9192416,73,1,0,0,2
9192417,9192749,332,0,0,1,2
9192749,9192780,31,1,0,0,1
9192750,9192781,31,1,0,0,2
9192781,9193263,482,0,0,1,1
9192782,9193257,475,0,0,1,2
9193258,9193290,32,1,0,0,2
9193264,9193294,30,1,0,0,1
9193291,9193541,250,0,0,1,2
9193295,9193542,247,0,0,1,1
9193542,9193818,276,1,0,0,2
9193543,9193596,53,1,0,0,1
9193597,9193762,165,0,0,1,1
9193763,9193787,24,1,0,0,1
9193788,9194592,804,0,0,1,1
9193819,9194137,318,0,0,1,2
9194138,9194239,101,1,0,0,2
9194240,9194285,45,0,0,1,2
9194286,9194404,118,1,0,0,2
9194405,9194593,188,0,0,1,2
9194593,9194623,30,1,0,0,1
9194594,9194626,32,1,0,0,2
9194624,9195748,1124,0,0,1,1
9194627,9194736,109,0,0,1,2
9194737,9194791,54,1,0,0,2
9194792,9194842,50,0,0,1,2
9194843,9194856,13,1,0,0,2
9194857,9195505,648,0,0,1,2
9195506,9195568,62,1,0,0,2
9195569,9195749,180,0,0,1,2
9195749,9195790,41,1,0,0,1
9195750,9196177,427,1,0,0,2
9195791,9195998,207,0,0,1,1
9195999,9196019,20,1,0,0,1
9196020,9196555,535,0,0,1,1
9196178,9196388,210,0,0,1,2
9196389,9196814,425,1,0,0,2
9196556,9196576,20,1,0,0,1
9196577,9197833,1256,0,0,1,1
9196815,9196900,85,0,0,1,2
9196901,9197035,134,1,0,0,2
9197036,9197177,141,0,0,1,2
9197178,9197321,143,1,0,0,2
9197322,9197363,41,0,0,1,2
9197364,9197502,138,1,0,0,2
9197503,9197657,154,0,0,1,2
9197658,9197694,36,1,0,0,2
9197695,9197778,83,0,0,1,2
9197779,9197794,15,1,0,0,2
9197795,9197817,22,0,0,1,2
9197818,9198388,570,1,0,0,2
9197834,9198234,400,1,0,0,1
9197859,9198194,335,0,1,0,2
9197872,9198177,305,0,1,0,1
9198235,9198356,121,0,0,1,1
9198357,9198390,33,1,0,0,1
9198389,9198739,350,0,0,1,2
9198391,9198753,362,0,0,1,1
9198740,9199248,508,1,0,0,2
9198754,9199166,412,1,0,0,1
9198783,9199153,370,0,1,0,2
9198784,9199155,371,0,1,0,1
9199167,9199399,232,0,0,1,1
9199249,9199397,148,0,0,1,2
9199398,9199443,45,1,0,0,2
9199400,9199442,42,1,0,0,1
9199443,9199630,187,0,0,1,1
9199444,9199623,179,0,0,1,2
9199624,9199639,15,1,0,0,2
9199631,9199638,7,1,0,0,1
9199639,9199729,90,0,0,1,1
9199640,9199747,107,0,0,1,2
9199730,9200053,323,1,0,0,1
9199748,9200073,325,1,0,0,2
9199776,9200000,224,0,1,0,2
9199781,9200006,225,0,1,0,1
9200054,9200094,40,0,0,1,1
9200074,9200158,84,0,0,1,2
9200095,9200112,17,1,0,0,1
9200113,9200155,42,0,0,1,1
9200156,9200179,23,1,0,0,1
9200159,9200179,20,1,0,0,2
9200180,9202297,2117,0,0,1,2
9200180,9202302,2122,0,0,1,1
9202298,9202344,46,1,0,0,2
9202303,9202337,34,1,0,0,1
9202338,9202602,264,0,0,1,1
9202345,9202603,258,0,0,1,2
9202603,9202628,25,1,0,0,1
9202604,9202636,32,1,0,0,2
9202629,9202939,310,0,0,1,1
9202637,9202938,301,0,0,1,2
9202939,9202960,21,1,0,0,2
9202940,9202958,18,1,0,0,1
9202959,9204568,1609,0,0,1,1
9202961,9204554,1593,0,0,1,2
9204555,9204821,266,1,0,0,2
9204569,9204734,165,1,0,0,1
9204633,9204654,21,0,1,0,2
9204735,9205143,408,0,0,1,1
9204822,9204857,35,0,0,1,2
9204858,9205090,232,1,0,0,2
9205091,9205139,48,0,0,1,2
9205140,9205181,41,1,0,0,2
9205144,9205180,36,1,0,0,1
9205181,9205750,569,0,0,1,1
9205182,9205751,569,0,0,1,2
9205751,9205800,49,1,0,0,1
9205752,9206048,296,1,0,0,2
9205801,9205996,195,0,0,1,1
9205997,9206047,50,1,0,0,1
9206048,9206165,117,0,0,1,1
9206049,9206160,111,0,0,1,2
9206161,9206188,27,1,0,0,2
9206166,9206185,19,1,0,0,1
9206186,9206379,193,0,0,1,1
9206189,9206372,183,0,0,1,2
9206373,9206389,16,1,0,0,2
9206380,9206385,5,1,0,0,1
9206386,9206672,286,0,0,1,1
9206390,9206671,281,0,0,1,2
9206672,9206692,20,1,0,0,2
9206673,9206683,10,1,0,0,1
9206684,9208145,1461,0,0,1,1
9206693,9207077,384,0,0,1,2
9207078,9207089,11,1,0,0,2
9207090,9208146,1056,0,0,1,2
9208146,9208185,39,1,0,0,1
9208147,9208183,36,1,0,0,2
9208184,9210274,2090,0,0,1,2
9208186,9210268,2082,0,0,1,1
9210269,9210538,269,1,0,0,1
9210275,9210935,660,1,0,0,2
9210314,9210501,187,0,1,0,2
9210333,9210488,155,0,1,0,1
9210539,9210889,350,0,0,1,1
9210890,9210934,44,1,0,0,1
9210935,9211213,278,0,0,1,1
9210936,9211204,268,0,0,1,2
9211205,9214150,2945,1,0,0,2
9211214,9211221,7,1,0,0,1
9211222,9211267,45,0,0,1,1
9211268,9211556,288,1,0,0,1
9211299,9211456,157,0,1,0,2
9211301,9211461,160,0,1,0,1
9211557,9211630,73,0,0,1,1
9211631,9211949,318,1,0,0,1
9211658,9211899,241,0,1,0,2
9211663,9211903,240,0,1,0,1
9211950,9212043,93,0,0,1,1
9212044,9212054,10,1,0,0,1
9212055,9214066,2011,0,0,1,1
9214067,9214115,48,1,0,0,1
9214116,9214476,360,0,0,1,1
9214151,9214479,328,0,0,1,2
9214477,9214500,23,1,0,0,1
9214480,9214502,22,1,0,0,2
9214501,9215192,691,0,0,1,1
9214503,9215194,691,0,0,1,2
9215193,9215212,19,1,0,0,1
9215195,9215212,17,1,0,0,2
9215213,9216679,1466,0,0,1,1
9215213,9216680,1467,0,0,1,2
9216680,9216707,27,1,0,0,1
9216681,9216699,18,1,0,0,2
9216700,9216978,278,0,0,1,2
9216708,9216984,276,0,0,1,1
9216979,9218002,1023,1,0,0,2
9216985,9217284,299,1,0,0,1
9217040,9217215,175,0,1,0,2
9217050,9217219,169,0,1,0,1
9217285,9217538,253,0,0,1,1
9217539,9217563,24,1,0,0,1
9217564,9217748,184,0,0,1,1
9217749,9217810,61,1,0,0,1
9217811,9217934,123,0,0,1,1
9217935,9217963,28,1,0,0,1
9217964,9218211,247,0,0,1,1
9218003,9218173,170,0,0,1,2
9218174,9218310,136,1,0,0,2
9218212,9218232,20,1,0,0,1
9218233,9218403,170,0,0,1,1
9218311,9218380,69,0,0,1,2
9218381,9218521,140,1,0,0,2
9218404,9218419,15,1,0,0,1
9218420,9220050,1630,0,0,1,1
9218522,9218605,83,0,0,1,2
9218606,9219480,874,1,0,0,2
9219481,9219515,34,0,0,1,2
9219516,9220553,1037,1,0,0,2
9220051,9220070,19,1,0,0,1
9220071,9220233,162,0,0,1,1
9220234,9220289,55,1,0,0,1
9220290,9220457,167,0,0,1,1
9220458,9220483,25,1,0,0,1
9220484,9221065,581,0,0,1,1
9220554,9220586,32,0,0,1,2
9220587,9220737,150,1,0,0,2
9220738,9221050,312,0,0,1,2
9221051,9221089,38,1,0,0,2
9221066,9221086,20,1,0,0,1
9221087,9221327,240,0,0,1,1
9221090,9221153,63,0,0,1,2
9221154,9221270,116,1,0,0,2
9221271,9221329,58,0,0,1,2
9221328,9221350,22,1,0,0,1
9221330,9221348,18,1,0,0,2
9221349,9221411,62,0,0,1,2
9221351,9222547,1196,0,0,1,1
9221412,9221479,67,1,0,0,2
9221480,9222262,782,0,0,1,2
9222263,9222306,43,1,0,0,2
9222307,9222390,83,0,0,1,2
9222391,9222408,17,1,0,0,2
9222409,9222510,101,0,0,1,2
9222511,9222851,340,1,0,0,2
9222548,9222758,210,1,0,0,1
9222562,9222646,84,0,1,0,1
9222564,9222665,101,0,1,0,2
9222759,9224191,1432,0,0,1,1
9222852,9222873,21,0,0,1,2
9222874,9222946,72,1,0,0,2
9222947,9222999,52,0,0,1,2
9223000,9224253,1253,1,0,0,2
9224192,9224246,54,1,0,0,1
9224247,9224373,126,0,0,1,1
9224254,9224374,120,0,0,1,2
9224374,9224405,31,1,0,0,1
9224375,9224404,29,1,0,0,2
9224405,9224515,110,0,0,1,2
9224406,9224523,117,0,0,1,1
9224516,9224821,305,1,0,0,2
9224524,9224954,430,1,0,0,1
9224583,9224891,308,0,1,0,1
9224594,9224629,35,0,1,0,2
9224681,9224735,54,0,1,0,2
9224770,9224781,11,0,1,0,2
9224822,9224843,21,0,0,1,2
9224844,9225000,156,1,0,0,2
9224955,9225334,379,0,0,1,1
9225001,9225337,336,0,0,1,2
9225335,9225430,95,1,0,0,1
9225338,9225372,34,1,0,0,2
9225373,9225522,149,0,0,1,2
9225431,9226122,691,0,0,1,1
9225523,9225538,15,1,0,0,2
9225539,9225897,358,0,0,1,2
9225898,9225930,32,1,0,0,2
9225931,9226090,159,0,0,1,2
9226091,9226096,5,1,0,0,2
9226097,9226541,444,0,0,1,2
9226123,9226127,4,1,0,0,1
9226128,9226653,525,0,0,1,1
9226542,9226558,16,1,0,0,2
9226559,9227069,510,0,0,1,2
9226654,9226658,4,1,0,0,1
9226659,9226727,68,0,0,1,1
9226728,9226744,16,1,0,0,1
9226745,9226839,94,0,0,1,1
9226840,9226875,35,1,0,0,1
9226876,9227071,195,0,0,1,1
9227070,9227515,445,1,0,0,2
9227072,9227115,43,1,0,0,1
9227116,9227555,439,0,0,1,1
9227516,9227567,51,0,0,1,2
9227556,9227607,51,1,0,0,1
9227568,9227667,99,1,0,0,2
9227608,9228513,905,0,0,1,1
9227668,9227697,29,0,0,1,2
9227698,9227998,300,1,0,0,2
9227999,9228020,21,0,0,1,2
9228021,9228588,567,1,0,0,2
9228514,9228533,19,1,0,0,1
9228534,9228725,191,0,0,1,1
9228589,9228638,49,0,0,1,2
9228639,9229690,1051,1,0,0,2
9228726,9228771,45,1,0,0,1
9228772,9229113,341,0,0,1,1
9229114,9229607,493,1,0,0,1
9229140,9229536,396,0,1,0,1
9229142,9229512,370,0,1,0,2
9229554,9229569,15,0,1,0,2
9229608,9230086,478,0,0,1,1
9229691,9229717,26,0,0,1,2
9229718,9229796,78,1,0,0,2
9229797,9229831,34,0,0,1,2
9229832,9229922,90,1,0,0,2
9229923,9230084,161,0,0,1,2
9230085,9230125,40,1,0,0,2
9230087,9230122,35,1,0,0,1
9230123,9230399,276,0,0,1,1
9230126,9230397,271,0,0,1,2
9230398,9230428,30,1,0,0,2
9230400,9230423,23,1,0,0,1
9230424,9231056,632,0,0,1,1
9230429,9231055,626,0,0,1,2
9231056,9231120,64,1,0,0,2
9231057,9231125,68,1,0,0,1
9231121,9231542,421,0,0,1,2
9231126,9231546,420,0,0,1,1
9231543,9231819,276,1,0,0,2
9231547,9231811,264,1,0,0,1
9231580,9231718,138,0,1,0,2
9231584,9231722,138,0,1,0,1
9231812,9231890,78,0,0,1,1
9231820,9231891,71,0,0,1,2
9231891,9231905,14,1,0,0,1
9231892,9231907,15,1,0,0,2
9231906,9232926,1020,0,0,1,1
9231908,9233131,1223,0,0,1,2
9232927,9232931,4,1,0,0,1
9232932,9233136,204,0,0,1,1
9233132,9233150,18,1,0,0,2
9233137,9233147,10,1,0,0,1
9233148,9234092,944,0,0,1,1
9233151,9234093,942,0,0,1,2
9234093,9234142,49,1,0,0,1
9234094,9234144,50,1,0,0,2
9234143,9234275,132,0,0,1,1
9234145,9234275,130,0,0,1,2
9234276,9234297,21,1,0,0,2
9234276,9234303,27,1,0,0,1
9234298,9234663,365,0,0,1,2
9234304,9234668,364,0,0,1,1
9234664,9234685,21,1,0,0,2
9234669,9234683,14,1,0,0,1
9234684,9234992,308,0,0,1,1
9234686,9234985,299,0,0,1,2
9234986,9235006,20,1,0,0,2
9234993,9235002,9,1,0,0,1
9235003,9235248,245,0,0,1,1
9235007,9235245,238,0,0,1,2
9235246,9235289,43,1,0,0,2
9235249,9235265,16,1,0,0,1
9235266,9235614,348,0,0,1,1
9235290,9235339,49,0,0,1,2
9235340,9235362,22,1,0,0,2
9235363,9235513,150,0,0,1,2
9235514,9235534,20,1,0,0,2
9235535,9235588,53,0,0,1,2
9235589,9235628,39,1,0,0,2
9235615,9235621,6,1,0,0,1
9235622,9236441,819,0,0,1,1
9235629,9236383,754,0,0,1,2
9236384,9238160,1776,1,0,0,2
9236442,9236485,43,1,0,0,1
9236486,9236797,311,0,0,1,1
9236798,9236821,23,1,0,0,1
9236822,9237057,235,0,0,1,1
9237058,9237100,42,1,0,0,1
9237101,9237326,225,0,0,1,1
9237327,9237349,22,1,0,0,1
9237350,9238054,704,0,0,1,1
9238055,9238108,53,1,0,0,1
9238109,9238235,126,0,0,1,1
9238161,9238195,34,0,0,1,2
9238196,9239012,816,1,0,0,2
9238236,9238247,11,1,0,0,1
9238248,9238457,209,0,0,1,1
9238458,9238745,287,1,0,0,1
9238476,9238699,223,0,1,0,2
9238484,9238672,188,0,1,0,1
9238746,9238778,32,0,0,1,1
9238779,9238795,16,1,0,0,1
9238796,9239298,502,0,0,1,1
9239013,9239068,55,0,0,1,2
9239069,9239116,47,1,0,0,2
9239117,9239205,88,0,0,1,2
9239206,9242452,3246,1,0,0,2
9239299,9239326,27,1,0,0,1
9239327,9239458,131,0,0,1,1
9239459,9239476,17,1,0,0,1
9239477,9239836,359,0,0,1,1
9239837,9239857,20,1,0,0,1
9239858,9239992,134,0,0,1,1
9239993,9240012,19,1,0,0,1
9240013,9240884,871,0,0,1,1
9240885,9240895,10,1,0,0,1
9240896,9241603,707,0,0,1,1
9241604,9241643,39,1,0,0,1
9241644,9241835,191,0,0,1,1
9241836,9241854,18,1,0,0,1
9241855,9242154,299,0,0,1,1
9242155,9242172,17,1,0,0,1
9242173,9242826,653,0,0,1,1
9242453,9242543,90,0,0,1,2
9242544,9242698,154,1,0,0,2
9242699,9242820,121,0,0,1,2
9242821,9242976,155,1,0,0,2
9242827,9242856,29,1,0,0,1
9242857,9243082,225,0,0,1,1
9242977,9243010,33,0,0,1,2
9243011,9243029,18,1,0,0,2
9243030,9243069,39,0,0,1,2
9243070,9244112,1042,1,0,0,2
9243083,9243103,20,1,0,0,1
9243104,9243324,220,0,0,1,1
9243325,9243347,22,1,0,0,1
9243348,9243500,152,0,0,1,1
9243501,9243523,22,1,0,0,1
9243524,9243708,184,0,0,1,1
9243709,9243733,24,1,0,0,1
9243734,9244047,313,0,0,1,1
9244048,9244095,47,1,0,0,1
9244096,9245301,1205,0,0,1,1
9244113,9244181,68,0,0,1,2
9244182,9244470,288,1,0,0,2
9244471,9244607,136,0,0,1,2
9244608,9244648,40,1,0,0,2
9244649,9244721,72,0,0,1,2
9244722,9244867,145,1,0,0,2
9244868,9244915,47,0,0,1,2
9244916,9244938,22,1,0,0,2
9244939,9245064,125,0,0,1,2
9245065,9245336,271,1,0,0,2
9245302,9245339,37,1,0,0,1
9245337,9245359,22,0,0,1,2
9245340,9245460,120,0,0,1,1
9245360,9246689,1329,1,0,0,2
9245461,9246153,692,1,0,0,1
9245591,9246149,558,0,1,0,2
9245599,9246041,442,0,1,0,1
9246087,9246088,1,0,1,0,1
9246154,9246183,29,0,0,1,1
9246184,9246194,10,1,0,0,1
9246195,9246276,81,0,0,1,1
9246277,9246290,13,1,0,0,1
9246291,9247631,1340,0,0,1,1
9246690,9246769,79,0,0,1,2
9246770,9246991,221,1,0,0,2
9246992,9247046,54,0,0,1,2
9247047,9247067,20,1,0,0,2
9247068,9247101,33,0,0,1,2
9247102,9250622,3520,1,0,0,2
9247632,9247682,50,1,0,0,1
9247683,9248696,1013,0,0,1,1
9248697,9248716,19,1,0,0,1
9248717,9249111,394,0,0,1,1
9249112,9249405,293,1,0,0,1
9249151,9249275,124,0,1,0,2
9249160,9249305,145,0,1,0,1
9249406,9249880,474,0,0,1,1
9249881,9250180,299,1,0,0,1
9249917,9250113,196,0,1,0,1
9249917,9250139,222,0,1,0,2
9250181,9250341,160,0,0,1,1
9250342,9250382,40,1,0,0,1
9250383,9250796,413,0,0,1,1
9250623,9250655,32,0,0,1,2
9250656,9251519,863,1,0,0,2
9250797,9250825,28,1,0,0,1
9250826,9251163,337,0,0,1,1
9251164,9251200,36,1,0,0,1
9251201,9251642,441,0,0,1,1
9251520,9251637,117,0,0,1,2
9251638,9251701,63,1,0,0,2
9251643,9251659,16,1,0,0,1
9251660,9252962,1302,0,0,1,1
9251702,9251729,27,0,0,1,2
9251730,9251831,101,1,0,0,2
9251832,9251894,62,0,0,1,2
9251895,9252518,623,1,0,0,2
9252519,9252669,150,0,0,1,2
9252670,9252740,70,1,0,0,2
9252741,9252765,24,0,0,1,2
9252766,9252843,77,1,0,0,2
9252844,9252890,46,0,0,1,2
9252891,9253566,675,1,0,0,2
9252963,9253005,42,1,0,0,1
9253006,9253134,128,0,0,1,1
9253135,9253152,17,1,0,0,1
9253153,9253859,706,0,0,1,1
9253567,9253593,26,0,0,1,2
9253594,9254577,983,1,0,0,2
9253860,9253876,16,1,0,0,1
9253877,9255391,1514,0,0,1,1
9254578,9254607,29,0,0,1,2
9254608,9254941,333,1,0,0,2
9254942,9255009,67,0,0,1,2
9255010,9255532,522,1,0,0,2
9255392,9255435,43,1,0,0,1
9255436,9256050,614,0,0,1,1
9255533,9255557,24,0,0,1,2
9255558,9256207,649,1,0,0,2
9256051,9256144,93,1,0,0,1
9256145,9256676,531,0,0,1,1
9256208,9256335,127,0,0,1,2
9256336,9256390,54,1,0,0,2
9256391,9256539,148,0,0,1,2
9256540,9256871,331,1,0,0,2
9256677,9256736,59,1,0,0,1
9256737,9256910,173,0,0,1,1
9256872,9256999,127,0,0,1,2
9256911,9256927,16,1,0,0,1
9256928,9258803,1875,0,0,1,1
9257000,9257646,646,1,0,0,2
9257647,9257669,22,0,0,1,2
9257670,9258057,387,1,0,0,2
9258058,9258111,53,0,0,1,2
9258112,9258621,509,1,0,0,2
9258622,9258645,23,0,0,1,2
9258646,9259676,1030,1,0,0,2
9258804,9258855,51,1,0,0,1
9258856,9258975,119,0,0,1,1
9258976,9259001,25,1,0,0,1
9259002,9259255,253,0,0,1,1
9259256,9259271,15,1,0,0,1
9259272,9260996,1724,0,0,1,1
9259677,9259710,33,0,0,1,2
9259711,9259789,78,1,0,0,2
9259790,9260208,418,0,0,1,2
9260209,9260262,53,1,0,0,2
9260263,9260367,104,0,0,1,2
9260368,9260415,47,1,0,0,2
9260416,9260436,20,0,0,1,2
9260437,9260508,71,1,0,0,2
9260509,9260626,117,0,0,1,2
9260627,9260878,251,1,0,0,2
9260879,9260919,40,0,0,1,2
9260920,9261674,754,1,0,0,2
9260997,9261484,487,1,0,0,1
9261028,9261327,299,0,1,0,2
9261031,9261366,335,0,1,0,1
9261485,9261733,248,0,0,1,1
9261675,9261728,53,0,0,1,2
9261729,9262825,1096,1,0,0,2
9261734,9261756,22,1,0,0,1
9261757,9262603,846,0,0,1,1
9262604,9262675,71,1,0,0,1
9262676,9262776,100,0,0,1,1
9262777,9262808,31,1,0,0,1
9262809,9263008,199,0,0,1,1
9262826,9263007,181,0,0,1,2
9263008,9263018,10,1,0,0,2
9263009,9263020,11,1,0,0,1
9263019,9263201,182,0,0,1,2
9263021,9264222,1201,0,0,1,1
9263202,9263966,764,1,0,0,2
9263967,9264223,256,0,0,1,2
9264223,9264262,39,1,0,0,1
9264224,9264261,37,1,0,0,2
9264262,9264385,123,0,0,1,2
9264263,9264383,120,0,0,1,1
9264384,9264411,27,1,0,0,1
9264386,9264406,20,1,0,0,2
9264407,9265065,658,0,0,1,2
9264412,9265363,951,0,0,1,1
9265066,9265397,331,1,0,0,2
9265364,9265368,4,1,0,0,1
9265369,9266364,995,0,0,1,1
9265398,9265426,28,0,0,1,2
9265427,9265808,381,1,0,0,2
9265809,9266365,556,0,0,1,2
9266365,9266420,55,1,0,0,1
9266366,9266417,51,1,0,0,2
9266418,9266441,23,0,0,1,2
9266421,9266449,28,0,0,1,1
9266442,9266682,240,1,0,0,2
9266450,9266629,179,1,0,0,1
9266492,9266562,70,0,1,0,2
9266507,9266539,32,0,1,0,1
9266630,9267481,851,0,0,1,1
9266683,9266754,71,0,0,1,2
9266755,9266817,62,1,0,0,2
9266818,9266873,55,0,0,1,2
9266874,9267561,687,1,0,0,2
9267482,9267548,66,1,0,0,1
9267549,9267684,135,0,0,1,1
9267562,9267682,120,0,0,1,2
9267683,9267707,24,1,0,0,2
9267685,9267708,23,1,0,0,1
9267708,9270102,2394,0,0,1,2
9267709,9269351,1642,0,0,1,1
9269352,9269369,17,1,0,0,1
9269370,9269578,208,0,0,1,1
9269579,9269794,215,1,0,0,1
9269795,9270065,270,0,0,1,1
9270066,9270207,141,1,0,0,1
9270103,9270160,57,1,0,0,2
9270161,9270807,646,0,0,1,2
9270208,9270312,104,0,0,1,1
9270313,9270356,43,1,0,0,1
9270357,9270595,238,0,0,1,1
9270596,9270608,12,1,0,0,1
9270609,9270653,44,0,0,1,1
9270654,9271005,351,1,0,0,1
9270808,9270837,29,1,0,0,2
9270838,9271272,434,0,0,1,2
9271006,9271237,231,0,0,1,1
9271238,9271338,100,1,0,0,1
9271273,9271285,12,1,0,0,2
9271286,9271958,672,0,0,1,2
9271339,9271372,33,0,0,1,1
9271373,9271383,10,1,0,0,1
9271384,9271461,77,0,0,1,1
9271462,9271501,39,1,0,0,1
9271502,9271569,67,0,0,1,1
9271570,9271574,4,1,0,0,1
9271575,9271850,275,0,0,1,1
9271851,9272243,392,1,0,0,1
9271959,9271970,11,1,0,0,2
9271971,9272375,404,0,0,1,2
9272244,9272344,100,0,0,1,1
9272345,9272702,357,1,0,0,1
9272376,9272748,372,1,0,0,2
9272432,9272643,211,0,1,0,2
9272439,9272657,218,0,1,0,1
9272703,9273010,307,0,0,1,1
9272749,9272771,22,0,0,1,2
9272772,9272800,28,1,0,0,2
9272801,9272832,31,0,0,1,2
9272833,9273759,926,1,0,0,2
9273011,9273047,36,1,0,0,1
9273048,9273327,279,0,0,1,1
9273328,9273356,28,1,0,0,1
9273357,9273613,256,0,0,1,1
9273614,9273643,29,1,0,0,1
9273644,9273942,298,0,0,1,1
9273760,9273827,67,0,0,1,2
9273828,9274229,401,1,0,0,2
9273943,9273971,28,1,0,0,1
9273972,9274149,177,0,0,1,1
9274150,9274183,33,1,0,0,1
9274184,9274359,175,0,0,1,1
9274230,9274250,20,0,0,1,2
9274251,9274497,246,1,0,0,2
9274360,9274368,8,1,0,0,1
9274369,9274796,427,0,0,1,1
9274498,9274624,126,0,0,1,2
9274625,9276171,1546,1,0,0,2
9274797,9274808,11,1,0,0,1
9274809,9276100,1291,0,0,1,1
9276101,9276164,63,1,0,0,1
9276165,9276704,539,0,0,1,1
9276172,9276389,217,0,0,1,2
9276390,9276406,16,1,0,0,2
9276407,9276700,293,0,0,1,2
9276701,9276719,18,1,0,0,2
9276705,9276718,13,1,0,0,1
9276719,9277034,315,0,0,1,1
9276720,9276779,59,0,0,1,2
9276780,9277061,281,1,0,0,2
9277035,9277050,15,1,0,0,1
9277051,9277287,236,0,0,1,1
9277062,9277285,223,0,0,1,2
9277286,9277769,483,1,0,0,2
9277288,9277308,20,1,0,0,1
9277309,9277482,173,0,0,1,1
9277483,9277504,21,1,0,0,1
9277505,9277742,237,0,0,1,1
9277743,9277765,22,1,0,0,1
9277766,9277921,155,0,0,1,1
9277770,9277804,34,0,0,1,2
9277805,9277962,157,1,0,0,2
9277922,9277942,20,1,0,0,1
9277943,9278203,260,0,0,1,1
9277963,9278020,57,0,0,1,2
9278021,9278820,799,1,0,0,2
9278204,9278680,476,1,0,0,1
9278273,9278542,269,0,1,0,2
9278288,9278650,362,0,1,0,1
9278570,9278604,34,0,1,0,2
9278681,9278878,197,0,0,1,1
9278821,9278876,55,0,0,1,2
9278877,9280493,1616,1,0,0,2
9278879,9278903,24,1,0,0,1
9278904,9279297,393,0,0,1,1
9279298,9279320,22,1,0,0,1
9279321,9279645,324,0,0,1,1
9279646,9279677,31,1,0,0,1
9279678,9279947,269,0,0,1,1
9279948,9279977,29,1,0,0,1
9279978,9280235,257,0,0,1,1
9280236,9280308,72,1,0,0,1
9280309,9280439,130,0,0,1,1
9280440,9280459,19,1,0,0,1
9280460,9281976,1516,0,0,1,1
9280494,9281977,1483,0,0,1,2
9281977,9281998,21,1,0,0,1
9281978,9281996,18,1,0,0,2
9281997,9282179,182,0,0,1,2
9281999,9282179,180,0,0,1,1
9282180,9282198,18,1,0,0,2
9282180,9282200,20,1,0,0,1
9282199,9282281,82,0,0,1,2
9282201,9282281,80,0,0,1,1
9282282,9282333,51,1,0,0,1
9282282,9282338,56,1,0,0,2
9282334,9282481,147,0,0,1,1
9282339,9282482,143,0,0,1,2
9282482,9282503,21,1,0,0,1
9282483,9282503,20,1,0,0,2
9282504,9283251,747,0,0,1,2
9282504,9283252,748,0,0,1,1
9283252,9283265,13,1,0,0,2
9283253,9283265,12,1,0,0,1
9283266,9284451,1185,0,0,1,1
9283266,9284453,1187,0,0,1,2
9284452,9284518,66,1,0,0,1
9284454,9284510,56,1,0,0,2
9284511,9284571,60,0,0,1,2
9284519,9284961,442,0,0,1,1
9284572,9285392,820,1,0,0,2
9284962,9285249,287,1,0,0,1
9284977,9285150,173,0,1,0,2
9284984,9285168,184,0,1,0,1
9285250,9285575,325,0,0,1,1
9285393,9285503,110,0,0,1,2
9285504,9285997,493,1,0,0,2
9285576,9285602,26,1,0,0,1
9285603,9285785,182,0,0,1,1
9285786,9285814,28,1,0,0,1
9285815,9285967,152,0,0,1,1
9285968,9285988,20,1,0,0,1
9285989,9286229,240,0,0,1,1
9285998,9286063,65,0,0,1,2
9286064,9286086,22,1,0,0,2
9286087,9286144,57,0,0,1,2
9286145,9286806,661,1,0,0,2
9286230,9286266,36,1,0,0,1
9286267,9286475,208,0,0,1,1
9286476,9286502,26,1,0,0,1
9286503,9286675,172,0,0,1,1
9286676,9286715,39,1,0,0,1
9286716,9286993,277,0,0,1,1
9286807,9286892,85,0,0,1,2
9286893,9286945,52,1,0,0,2
9286946,9286974,28,0,0,1,2
9286975,9287018,43,1,0,0,2
9286994,9286998,4,1,0,0,1
9286999,9287172,173,0,0,1,1
9287019,9287168,149,0,0,1,2
9287169,9287232,63,1,0,0,2
9287173,9287207,34,1,0,0,1
9287208,9287398,190,0,0,1,1
9287233,9287262,29,0,0,1,2
9287263,9287296,33,1,0,0,2
9287297,9287396,99,0,0,1,2
9287397,9288703,1306,1,0,0,2
9287399,9287427,28,1,0,0,1
9287428,9287641,213,0,0,1,1
9287642,9287671,29,1,0,0,1
9287672,9287908,236,0,0,1,1
9287909,9287941,32,1,0,0,1
9287942,9288297,355,0,0,1,1
9288298,9288319,21,1,0,0,1
9288320,9288501,181,0,0,1,1
9288502,9288530,28,1,0,0,1
9288531,9288900,369,0,0,1,1
9288704,9288767,63,0,0,1,2
9288768,9288807,39,1,0,0,2
9288808,9288870,62,0,0,1,2
9288871,9289389,518,1,0,0,2
9288901,9289119,218,1,0,0,1
9288930,9289064,134,0,1,0,2
9288935,9289072,137,0,1,0,1
9289120,9289271,151,0,0,1,1
9289272,9289305,33,1,0,0,1
9289306,9289389,83,0,0,1,1
9567197,9567201,4,0,0,1,1
9567202,9567207,5,1,0,0,1
9567202,9567445,243,0,0,1,2
9567208,9567447,239,0,0,1,1
9567446,9567515,69,1,0,0,2
9567448,9567517,69,1,0,0,1
9567516,9567613,97,0,0,1,2
9567518,9567616,98,0,0,1,1
9567614,9567647,33,1,0,0,2
9567617,9567646,29,1,0,0,1
9567647,9568011,364,0,0,1,1
9567648,9568011,363,0,0,1,2
9568012,9568031,19,1,0,0,1
9568012,9568032,20,1,0,0,2
9568032,9568714,682,0,0,1,1
9568033,9568719,686,0,0,1,2
9568715,9568734,19,1,0,0,1
9568720,9568733,13,1,0,0,2
9568734,9569488,754,0,0,1,2
9568735,9569487,752,0,0,1,1
9569488,9569541,53,1,0,0,1
9569489,9569561,72,1,0,0,2
9569542,9569826,284,0,0,1,1
9569562,9569823,261,0,0,1,2
9569824,9569882,58,1,0,0,2
9569827,9569879,52,1,0,0,1
9569880,9570028,148,0,0,1,1
9569883,9570026,143,0,0,1,2
9570027,9570046,19,1,0,0,2
9570029,9570049,20,1,0,0,1
9570047,9570217,170,0,0,1,2
9570050,9570240,190,0,0,1,1
9570218,9570506,288,1,0,0,2
9570241,9570457,216,1,0,0,1
9570249,9570397,148,0,1,0,2
9570297,9570383,86,0,1,0,1
9570458,9570532,74,0,0,1,1
9570507,9570528,21,0,0,1,2
9570529,9570553,24,1,0,0,2
9570533,9570551,18,1,0,0,1
9570552,9570975,423,0,0,1,1
9570554,9570929,375,0,0,1,2
9570930,9571114,184,1,0,0,2
9570976,9571037,61,1,0,0,1
9570996,9571004,8,0,1,0,2
9571038,9571309,271,0,0,1,1
9571115,9571308,193,0,0,1,2
9571309,9571329,20,1,0,0,2
9571310,9571329,19,1,0,0,1
9571330,9573282,1952,0,0,1,1
9571330,9573282,1952,0,0,1,2
9573283,9573366,83,1,0,0,1
9573283,9573375,92,1,0,0,2
9573367,9573462,95,0,0,1,1
9573376,9573462,86,0,0,1,2
9573463,9573500,37,1,0,0,1
9573463,9573506,43,1,0,0,2
9573501,9573736,235,0,0,1,1
9573507,9573735,228,0,0,1,2
9573736,9573757,21,1,0,0,2
9573737,9573752,15,1,0,0,1
9573753,9576202,2449,0,0,1,1
9573758,9576199,2441,0,0,1,2
9576200,9576262,62,1,0,0,2
9576203,9576269,66,1,0,0,1
9576263,9576313,50,0,0,1,2
9576270,9576344,74,0,0,1,1
9576314,9576468,154,1,0,0,2
9576345,9576393,48,1,0,0,1
9576394,9579110,2716,0,0,1,1
9576469,9576661,192,0,0,1,2
9576662,9576731,69,1,0,0,2
9576732,9577602,870,0,0,1,2
9577603,9577608,5,1,0,0,2
9577609,9579110,1501,0,0,1,2
9579111,9579193,82,1,0,0,2
9579111,9579194,83,1,0,0,1
9579194,9579346,152,0,0,1,2
9579195,9579356,161,0,0,1,1
9579347,9579378,31,1,0,0,2
9579357,9579364,7,1,0,0,1
9579365,9581435,2070,0,0,1,1
9579379,9579784,405,0,0,1,2
9579785,9579830,45,1,0,0,2
9579831,9581427,1596,0,0,1,2
9581428,9581497,69,1,0,0,2
9581436,9581489,53,1,0,0,1
9581490,9581627,137,0,0,1,1
9581498,9581624,126,0,0,1,2
9581625,9581833,208,1,0,0,2
9581628,9581687,59,1,0,0,1
9581688,9581794,106,0,0,1,1
9581795,9581813,18,1,0,0,1
9581814,9583935,2121,0,0,1,1
9581834,9582594,760,0,0,1,2
9582595,9582607,12,1,0,0,2
9582608,9583934,1326,0,0,1,2
9583935,9584010,75,1,0,0,2
9583936,9584003,67,1,0,0,1
9584004,9584106,102,0,0,1,1
9584011,9584109,98,0,0,1,2
9584107,9584130,23,1,0,0,1
9584110,9584137,27,1,0,0,2
9584131,9584287,156,0,0,1,1
9584138,9584290,152,0,0,1,2
9584288,9584311,23,1,0,0,1
9584291,9584315,24,1,0,0,2
9584312,9584517,205,0,0,1,1
9584316,9584523,207,0,0,1,2
9584518,9584532,14,1,0,0,1
9584524,9584529,5,1,0,0,2
9584530,9586359,1829,0,0,1,2
9584533,9586362,1829,0,0,1,1
9586360,9586445,85,1,0,0,2
9586363,9586453,90,1,0,0,1
9586446,9586512,66,0,0,1,2
9586454,9586541,87,0,0,1,1
9586513,9589144,2631,1,0,0,2
9586542,9586547,5,1,0,0,1
9586548,9586572,24,0,0,1,1
9586573,9586608,35,1,0,0,1
9586609,9586630,21,0,0,1,1
9586631,9586639,8,1,0,0,1
9586640,9586984,344,0,0,1,1
9586985,9587002,17,1,0,0,1
9587003,9587678,675,0,0,1,1
9587679,9587700,21,1,0,0,1
9587701,9587936,235,0,0,1,1
9587937,9587956,19,1,0,0,1
9587957,9588252,295,0,0,1,1
9588253,9588269,16,1,0,0,1
9588270,9588942,672,0,0,1,1
9588943,9588998,55,1,0,0,1
9588999,9589306,307,0,0,1,1
9589145,9589206,61,0,0,1,2
9589207,9589409,202,1,0,0,2
9589307,9589388,81,1,0,0,1
9589389,9589501,112,0,0,1,1
9589410,9589504,94,0,0,1,2
9589502,9589544,42,1,0,0,1
9589505,9589559,54,1,0,0,2
9589545,9589773,228,0,0,1,1
9589560,9589768,208,0,0,1,2
9589769,9589794,25,1,0,0,2
9589774,9589790,16,1,0,0,1
9589791,9589990,199,0,0,1,1
9589795,9589985,190,0,0,1,2
9589986,9590021,35,1,0,0,2
9589991,9589999,8,1,0,0,1
9590000,9590229,229,0,0,1,1
9590022,9590229,207,0,0,1,2
9590230,9590247,17,1,0,0,1
9590230,9590249,19,1,0,0,2
9590248,9591276,1028,0,0,1,1
9590250,9591272,1022,0,0,1,2
9591273,9591318,45,1,0,0,2
9591277,9591319,42,1,0,0,1
9591319,9591641,322,0,0,1,2
9591320,9591645,325,0,0,1,1
9591642,9591706,64,1,0,0,2
9591646,9591695,49,1,0,0,1
9591696,9591829,133,0,0,1,1
9591707,9591831,124,0,0,1,2
9591830,9591850,20,1,0,0,1
9591832,9591868,36,1,0,0,2
9591851,9592554,703,0,0,1,1
9591869,9592556,687,0,0,1,2
9592555,9592575,20,1,0,0,1
9592557,9592578,21,1,0,0,2
9592576,9592727,151,0,0,1,1
9592579,9592727,148,0,0,1,2
9592728,9592748,20,1,0,0,1
9592728,9592752,24,1,0,0,2
9592749,9593742,993,0,0,1,1
9592753,9593742,989,0,0,1,2
9593743,9594046,303,1,0,0,1
9593743,9594161,418,1,0,0,2
9593847,9594034,187,0,1,0,2
9593877,9593955,78,0,1,0,1
9594047,9594136,89,0,0,1,1
9594137,9594161,24,1,0,0,1
9594162,9594450,288,0,0,1,2
9594162,9594479,317,0,0,1,1
9594451,9594561,110,1,0,0,2
9594480,9594500,20,1,0,0,1
9594501,9594667,166,0,0,1,1
9594562,9594664,102,0,0,1,2
9594665,9594684,19,1,0,0,2
9594668,9594688,20,1,0,0,1
9594685,9595091,406,0,0,1,2
9594689,9595091,402,0,0,1,1
9595092,9595100,8,1,0,0,2
9595092,9595102,10,1,0,0,1
9595101,9595605,504,0,0,1,2
9595103,9596416,1313,0,0,1,1
9595606,9595693,87,1,0,0,2
9595694,9595749,55,0,0,1,2
9595750,9595830,80,1,0,0,2
9595831,9596078,247,0,0,1,2
9596079,9596083,4,1,0,0,2
9596084,9596412,328,0,0,1,2
9596413,9596483,70,1,0,0,2
9596417,9596483,66,1,0,0,1
9596484,9596622,138,0,0,1,1
9596484,9597853,1369,0,0,1,2
9596623,9596636,13,1,0,0,1
9596637,9597664,1027,0,0,1,1
9597665,9597673,8,1,0,0,1
9597674,9597849,175,0,0,1,1
9597850,9597866,16,1,0,0,1
9597854,9597865,11,1,0,0,2
9597866,9598125,259,0,0,1,2
9597867,9598130,263,0,0,1,1
9598126,9598161,35,1,0,0,2
9598131,9598160,29,1,0,0,1
9598161,9598443,282,0,0,1,1
9598162,9598438,276,0,0,1,2
9598439,9598513,74,1,0,0,2
9598444,9598514,70,1,0,0,1
9598514,9598618,104,0,0,1,2
9598515,9598621,106,0,0,1,1
9598619,9598668,49,1,0,0,2
9598622,9598661,39,1,0,0,1
9598662,9599433,771,0,0,1,1
9598669,9599263,594,0,0,1,2
9599264,9599298,34,1,0,0,2
9599299,9599431,132,0,0,1,2
9599432,9599449,17,1,0,0,2
9599434,9599449,15,1,0,0,1
9599450,9600325,875,0,0,1,1
9599450,9600326,876,0,0,1,2
9600326,9600405,79,1,0,0,1
9600327,9600405,78,1,0,0,2
9600406,9600743,337,0,0,1,1
9600406,9600743,337,0,0,1,2
9600744,9600831,87,1,0,0,2
9600744,9600849,105,1,0,0,1
9600832,9600961,129,0,0,1,2
9600850,9600899,49,0,0,1,1
9600900,9601027,127,1,0,0,1
9600962,9603107,2145,1,0,0,2
9601028,9601726,698,0,0,1,1
9601727,9601802,75,1,0,0,1
9601803,9602218,415,0,0,1,1
9602219,9602391,172,1,0,0,1
9602392,9602460,68,0,0,1,1
9602461,9602493,32,1,0,0,1
9602494,9602822,328,0,0,1,1
9602823,9602882,59,1,0,0,1
9602883,9603229,346,0,0,1,1
9603108,9603228,120,0,0,1,2
9603229,9604316,1087,1,0,0,2
9603230,9603278,48,1,0,0,1
9603279,9603354,75,0,0,1,1
9603355,9604029,674,1,0,0,1
9603396,9603578,182,0,1,0,2
9603425,9603579,154,0,1,0,1
9603636,9603852,216,0,1,0,1
9603665,9603693,28,0,1,0,2
9603726,9603734,8,0,1,0,2
9604030,9604202,172,0,0,1,1
9604203,9604222,19,1,0,0,1
9604223,9604394,171,0,0,1,1
9604317,9604392,75,0,0,1,2
9604393,9605519,1126,1,0,0,2
9604395,9604549,154,1,0,0,1
9604550,9604744,194,0,0,1,1
9604745,9604763,18,1,0,0,1
9604764,9605194,430,0,0,1,1
9605195,9605413,218,1,0,0,1
9605414,9605763,349,0,0,1,1
9605520,9605608,88,0,0,1,2
9605609,9606145,536,1,0,0,2
9605764,9606098,334,1,0,0,1
9606018,9606023,5,0,1,0,2
9606060,9606064,4,0,1,0,2
9606099,9606219,120,0,0,1,1
9606146,9606166,20,0,0,1,2
9606167,9606255,88,1,0,0,2
9606220,9606243,23,1,0,0,1
9606244,9606499,255,0,0,1,1
9606256,9606500,244,0,0,1,2
9606500,9606522,22,1,0,0,1
9606501,9606518,17,1,0,0,2
9606519,9608181,1662,0,0,1,2
9606523,9608390,1867,0,0,1,1
9608182,9608343,161,1,0,0,2
9608344,9608369,25,0,0,1,2
9608370,9608447,77,1,0,0,2
9608391,9608448,57,1,0,0,1
9608448,9608563,115,0,0,1,2
9608449,9608564,115,0,0,1,1
9608564,9608601,37,1,0,0,2
9608565,9608601,36,1,0,0,1
9608602,9608818,216,0,0,1,2
9608602,9608820,218,0,0,1,1
9608819,9608836,17,1,0,0,2
9608821,9608839,18,1,0,0,1
9608837,9610750,1913,0,0,1,2
9608840,9610750,1910,0,0,1,1
9610751,9610807,56,1,0,0,1
9610751,9610877,126,1,0,0,2
9610808,9610929,121,0,0,1,1
9610878,9610930,52,0,0,1,2
9610930,9610949,19,1,0,0,1
9610931,9611006,75,1,0,0,2
9610950,9611265,315,0,0,1,1
9611007,9611040,33,0,0,1,2
9611041,9611056,15,1,0,0,2
9611057,9611163,106,0,0,1,2
9611164,9612515,1351,1,0,0,2
9611266,9611283,17,1,0,0,1
9611284,9612642,1358,0,0,1,1
9612516,9612646,130,0,0,1,2
9612643,9612703,60,1,0,0,1
9612647,9612721,74,1,0,0,2
9612704,9613013,309,0,0,1,1
9612722,9612747,25,0,0,1,2
9612748,9612824,76,1,0,0,2
9612825,9612874,49,0,0,1,2
9612875,9612941,66,1,0,0,2
9612942,9613016,74,0,0,1,2
9613014,9613097,83,1,0,0,1
9613017,9613103,86,1,0,0,2
9613098,9613201,103,0,0,1,1
9613104,9613202,98,0,0,1,2
9613202,9613240,38,1,0,0,1
9613203,9613235,32,1,0,0,2
9613236,9613779,543,0,0,1,2
9613241,9613414,173,0,0,1,1
9613415,9613423,8,1,0,0,1
9613424,9613778,354,0,0,1,1
9613779,9613794,15,1,0,0,1
9613780,9613798,18,1,0,0,2
9613795,9614026,231,0,0,1,1
9613799,9614021,222,0,0,1,2
9614022,9614039,17,1,0,0,2
9614027,9614038,11,1,0,0,1
9614039,9615105,1066,0,0,1,1
9614040,9615105,1065,0,0,1,2
9615106,9615157,51,1,0,0,1
9615106,9615160,54,1,0,0,2
9615158,9615293,135,0,0,1,1
9615161,9615295,134,0,0,1,2
9615294,9615303,9,1,0,0,1
9615296,9615306,10,1,0,0,2
9615304,9616218,914,0,0,1,1
9615307,9616219,912,0,0,1,2
9616219,9616237,18,1,0,0,1
9616220,9616239,19,1,0,0,2
9616238,9616405,167,0,0,1,1
9616240,9616404,164,0,0,1,2
9616405,9616426,21,1,0,0,2
9616406,9616424,18,1,0,0,1
9616425,9617408,983,0,0,1,1
9616427,9617408,981,0,0,1,2
9617409,9617744,335,1,0,0,1
9617409,9617881,472,1,0,0,2
9617501,9617759,258,0,1,0,2
9617530,9617665,135,0,1,0,1
9617745,9617824,79,0,0,1,1
9617825,9617842,17,1,0,0,1
9617843,9618018,175,0,0,1,1
9617882,9618019,137,0,0,1,2
9618019,9618039,20,1,0,0,1
9618020,9618043,23,1,0,0,2
9618040,9618883,843,0,0,1,1
9618044,9618882,838,0,0,1,2
9618883,9618913,30,1,0,0,2
9618884,9618902,18,1,0,0,1
9618903,9619022,119,0,0,1,1
9618914,9619020,106,0,0,1,2
9619021,9619046,25,1,0,0,2
9619023,9619037,14,1,0,0,1
9619038,9619506,468,0,0,1,1
9619047,9619257,210,0,0,1,2
9619258,9619272,14,1,0,0,2
9619273,9619504,231,0,0,1,2
9619505,9619536,31,1,0,0,2
9619507,9619535,28,1,0,0,1
9619536,9619825,289,0,0,1,1
9619537,9619825,288,0,0,1,2
9619826,9619871,45,1,0,0,1
9619826,9619974,148,1,0,0,2
9619872,9620003,131,0,0,1,1
9619975,9621971,1996,0,0,1,2
9620004,9620029,25,1,0,0,1
9620030,9620205,175,0,0,1,1
9620206,9620241,35,1,0,0,1
9620242,9620374,132,0,0,1,1
9620375,9620393,18,1,0,0,1
9620394,9620907,513,0,0,1,1
9620908,9620919,11,1,0,0,1
9620920,9621539,619,0,0,1,1
9621540,9621564,24,1,0,0,1
9621565,9621973,408,0,0,1,1
9621972,9622365,393,1,0,0,2
9621974,9622053,79,1,0,0,1
9622054,9622075,21,0,0,1,1
9622076,9622175,99,1,0,0,1
9622176,9622197,21,0,0,1,1
9622198,9622203,5,1,0,0,1
9622204,9622318,114,0,0,1,1
9622319,9623822,1503,1,0,0,1
9622351,9622353,2,0,1,0,1
9622366,9622436,70,0,0,1,2
9622406,9623738,1332,0,1,0,1
9622437,9623872,1435,1,0,0,2
9622503,9622609,106,0,1,0,2
9622756,9622758,2,0,1,0,2
9622887,9622958,71,0,1,0,2
9623027,9623762,735,0,1,0,2
9623823,9624168,345,0,0,1,1
9623873,9624142,269,0,0,1,2
9624143,9624244,101,1,0,0,2
9624169,9624258,89,1,0,0,1
9624245,9624791,546,0,0,1,2
9624259,9624797,538,0,0,1,1
9624792,9624811,19,1,0,0,2
9624798,9624815,17,1,0,0,1
9624812,9625044,232,0,0,1,2
9624816,9625050,234,0,0,1,1
9625045,9625078,33,1,0,0,2
9625051,9625068,17,1,0,0,1
9625069,9625259,190,0,0,1,1
9625079,9625251,172,0,0,1,2
9625252,9625270,18,1,0,0,2
9625260,9625269,9,1,0,0,1
9625270,9626387,1117,0,0,1,1
9625271,9626388,1117,0,0,1,2
9626388,9626446,58,1,0,0,1
9626389,9626448,59,1,0,0,2
9626447,9626565,118,0,0,1,1
9626449,9626566,117,0,0,1,2
9626566,9626603,37,1,0,0,1
9626567,9626598,31,1,0,0,2
9626599,9626742,143,0,0,1,2
9626604,9626743,139,0,0,1,1
9626743,9626765,22,1,0,0,2
9626744,9626771,27,1,0,0,1
9626766,9626962,196,0,0,1,2
9626772,9626963,191,0,0,1,1
9626963,9626979,16,1,0,0,2
9626964,9626981,17,1,0,0,1
9626980,9628075,1095,0,0,1,2
9626982,9628074,1092,0,0,1,1
9628075,9628112,37,1,0,0,1
9628076,9628165,89,1,0,0,2
9628113,9628525,412,0,0,1,1
9628166,9628222,56,0,0,1,2
9628223,9628464,241,1,0,0,2
9628465,9628496,31,0,0,1,2
9628497,9631471,2974,1,0,0,2
9628526,9628611,85,1,0,0,1
9628612,9628736,124,0,0,1,1
9628737,9628811,74,1,0,0,1
9628812,9628843,31,0,0,1,1
9628844,9630650,1806,1,0,0,1
9628884,9629767,883,0,1,0,1
9629315,9629329,14,0,1,0,2
9629859,9630011,152,0,1,0,1
9630066,9630105,39,0,1,0,1
9630175,9630217,42,0,1,0,1
9630255,9630325,70,0,1,0,1
9630577,9630584,7,0,1,0,1
9630651,9630726,75,0,0,1,1
9630727,9630945,218,1,0,0,1
9630765,9630888,123,0,1,0,2
9630803,9630845,42,0,1,0,1
9630946,9631055,109,0,0,1,1
9631056,9631072,16,1,0,0,1
9631073,9632109,1036,0,0,1,1
9631472,9631767,295,0,0,1,2
9631768,9631804,36,1,0,0,2
9631805,9632102,297,0,0,1,2
9632103,9632122,19,1,0,0,2
9632110,9632123,13,1,0,0,1
9632123,9632248,125,0,0,1,2
9632124,9632250,126,0,0,1,1
9632249,9632351,102,1,0,0,2
9632251,9632268,17,1,0,0,1
9632269,9632776,507,0,0,1,1
9632352,9632373,21,0,0,1,2
9632374,9632450,76,1,0,0,2
9632451,9632475,24,0,0,1,2
9632476,9632497,21,1,0,0,2
9632498,9632562,64,0,0,1,2
9632563,9632697,134,1,0,0,2
9632698,9632735,37,0,0,1,2
9632736,9632866,130,1,0,0,2
9632777,9632832,55,1,0,0,1
9632833,9633149,316,0,0,1,1
9632867,9633149,282,0,0,1,2
9633150,9633199,49,1,0,0,1
9633150,9635824,2674,1,0,0,2
9633200,9633318,118,0,0,1,1
9633319,9633349,30,1,0,0,1
9633350,9633887,537,0,0,1,1
9633888,9633909,21,1,0,0,1
9633910,9634047,137,0,0,1,1
9634048,9634077,29,1,0,0,1
9634078,9634405,327,0,0,1,1
9634406,9634439,33,1,0,0,1
9634440,9634640,200,0,0,1,1
9634641,9634733,92,1,0,0,1
9634734,9634803,69,0,0,1,1
9634804,9634935,131,1,0,0,1
9634936,9635669,733,0,0,1,1
9635670,9635820,150,1,0,0,1
9635821,9635900,79,0,0,1,1
9635825,9635896,71,0,0,1,2
9635897,9635932,35,1,0,0,2
9635901,9635933,32,1,0,0,1
9635933,9638248,2315,0,0,1,2
9635934,9636356,422,0,0,1,1
9636357,9636365,8,1,0,0,1
9636366,9638249,1883,0,0,1,1
9638249,9638321,72,1,0,0,2
9638250,9638314,64,1,0,0,1
9638315,9638441,126,0,0,1,1
9638322,9638438,116,0,0,1,2
9638439,9638484,45,1,0,0,2
9638442,9638488,46,1,0,0,1
9638485,9638743,258,0,0,1,2
9638489,9638742,253,0,0,1,1
9638743,9638756,13,1,0,0,1
9638744,9638753,9,1,0,0,2
9638754,9639374,620,0,0,1,2
9638757,9639374,617,0,0,1,1
9639375,9639393,18,1,0,0,1
9639375,9639395,20,1,0,0,2
9639394,9639566,172,0,0,1,1
9639396,9639564,168,0,0,1,2
9639565,9639582,17,1,0,0,2
9639567,9639580,13,1,0,0,1
9639581,9640658,1077,0,0,1,1
9639583,9640657,1074,0,0,1,2
9640658,9640711,53,1,0,0,2
9640659,9640706,47,1,0,0,1
9640707,9640821,114,0,0,1,1
9640712,9640818,106,0,0,1,2
9640819,9640849,30,1,0,0,2
9640822,9640849,27,1,0,0,1
9640850,9641064,214,0,0,1,1
9640850,9642009,1159,0,0,1,2
9641065,9641071,6,1,0,0,1
9641072,9642001,929,0,0,1,1
9642002,9642013,11,1,0,0,1
9642010,9642016,6,1,0,0,2
9642014,9642794,780,0,0,1,1
9642017,9642795,778,0,0,1,2
9642795,9642824,29,1,0,0,1
9642796,9642832,36,1,0,0,2
9642825,9643039,214,0,0,1,1
9642833,9643050,217,0,0,1,2
9643040,9643238,198,1,0,0,1
9643051,9646397,3346,1,0,0,2
9643239,9643325,86,0,0,1,1
9643326,9645594,2268,1,0,0,1
9645548,9645548,0,0,1,0,2
9645595,9645736,141,0,0,1,1
9645737,9645763,26,1,0,0,1
9645764,9646057,293,0,0,1,1
9646058,9646079,21,1,0,0,1
9646080,9646239,159,0,0,1,1
9646240,9646260,20,1,0,0,1
9646261,9646859,598,0,0,1,1
9646398,9646430,32,0,0,1,2
9646431,9649653,3222,1,0,0,2
9646860,9646886,26,1,0,0,1
9646887,9647659,772,0,0,1,1
9647660,9647709,49,1,0,0,1
9647710,9648122,412,0,0,1,1
9648123,9648232,109,1,0,0,1
9648233,9648295,62,0,0,1,1
9648296,9650942,2646,1,0,0,1
9648322,9650809,2487,0,1,0,1
9648422,9649583,1161,0,1,0,2
9649654,9649826,172,0,0,1,2
9649827,9649916,89,1,0,0,2
9649917,9649958,41,0,0,1,2
9649959,9650013,54,1,0,0,2
9650014,9650040,26,0,0,1,2
9650041,9650530,489,1,0,0,2
9650531,9650611,80,0,0,1,2
9650612,9651063,451,1,0,0,2
9650943,9650986,43,0,0,1,1
9650987,9651077,90,1,0,0,1
9651064,9651169,105,0,0,1,2
9651078,9651173,95,0,0,1,1
9651170,9651211,41,1,0,0,2
9651174,9651239,65,1,0,0,1
9651212,9651328,116,0,0,1,2
9651240,9651348,108,0,0,1,1
9651329,9651970,641,1,0,0,2
9651349,9651946,597,1,0,0,1
9651373,9651944,571,0,1,0,2
9651378,9651764,386,0,1,0,1
9651827,9651862,35,0,1,0,1
9651947,9652126,179,0,0,1,1
9651971,9652009,38,0,0,1,2
9652010,9657018,5008,1,0,0,2
9652127,9652144,17,1,0,0,1
9652145,9653529,1384,0,0,1,1
9653530,9653561,31,1,0,0,1
9653562,9653797,235,0,0,1,1
9653798,9653823,25,1,0,0,1
9653824,9654160,336,0,0,1,1
9654161,9654217,56,1,0,0,1
9654214,9654748,534,0,1,0,2
9654218,9654947,729,0,0,1,1
9654780,9654823,43,0,1,0,2
9654948,9654957,9,1,0,0,1
9654948,9655831,883,0,1,0,2
9654958,9655611,653,0,0,1,1
9655612,9655637,25,1,0,0,1
9655638,9655862,224,0,0,1,1
9655863,9655874,11,0,1,0,2
9655863,9655918,55,1,0,0,1
9655910,9656097,187,0,1,0,2
9655919,9656046,127,0,0,1,1
9656047,9656132,85,1,0,0,1
9656123,9656335,212,0,1,0,2
9656133,9656197,64,0,0,1,1
9656198,9656263,65,1,0,0,1
9656264,9656304,40,0,0,1,1
9656305,9656311,6,1,0,0,1
9656312,9656439,127,0,0,1,1
9656397,9656454,57,0,1,0,2
9656440,9656710,270,1,0,0,1
9656490,9656499,9,0,1,0,1
9656496,9656626,130,0,1,0,2
9656678,9656702,24,0,1,0,2
9656711,9656876,165,0,0,1,1
9656729,9656794,65,0,1,0,2
9656877,9657013,136,1,0,0,1
9656884,9656887,3,0,1,0,2
9657014,9657099,85,0,0,1,1
9657019,9657093,74,0,0,1,2
9657094,9657119,25,1,0,0,2
9657100,9657123,23,1,0,0,1
9657120,9657803,683,0,0,1,2
9657124,9657541,417,0,0,1,1
9657542,9657558,16,1,0,0,1
9657559,9657804,245,0,0,1,1
9657804,9657822,18,1,0,0,2
9657805,9657821,16,1,0,0,1
9657822,9658000,178,0,0,1,1
9657823,9657997,174,0,0,1,2
9657998,9658004,6,1,0,0,2
9658001,9658010,9,1,0,0,1
9658005,9658261,256,0,0,1,2
9658011,9658261,250,0,0,1,1
9658262,9658279,17,1,0,0,2
9658262,9658281,19,1,0,0,1
9658280,9658437,157,0,0,1,2
9658282,9658439,157,0,0,1,1
9658438,9658461,23,1,0,0,2
9658440,9658459,19,1,0,0,1
9658460,9659227,767,0,0,1,1
9658462,9659227,765,0,0,1,2
9659228,9659308,80,1,0,0,1
9659228,9659316,88,1,0,0,2
9659309,9659389,80,0,0,1,1
9659317,9659387,70,0,0,1,2
9659388,9659426,38,1,0,0,2
9659390,9659831,441,1,0,0,1
9659417,9659417,0,0,1,0,1
9659427,9659552,125,0,0,1,2
9659439,9659540,101,0,1,0,1
9659553,9659846,293,1,0,0,2
9659597,9659788,191,0,1,0,2
9659611,9659765,154,0,1,0,1
9659832,9659955,123,0,0,1,1
9659847,9659951,104,0,0,1,2
9659952,9659987,35,1,0,0,2
9659956,9659976,20,1,0,0,1
9659977,9660143,166,0,0,1,1
9659988,9660166,178,0,0,1,2
9660154,9660559,405,0,1,0,1
9660167,9660195,28,1,0,0,2
9660196,9660680,484,0,0,1,2
9660569,9660569,0,1,0,0,1
9660570,9660684,114,0,0,1,1
9660681,9660746,65,1,0,0,2
9660685,9660702,17,1,0,0,1
9660703,9660849,146,0,0,1,1
9660747,9660770,23,0,0,1,2
9660771,9660793,22,1,0,0,2
9660794,9660842,48,0,0,1,2
9660843,9660864,21,1,0,0,2
9660850,9660862,12,1,0,0,1
9660863,9661489,626,0,0,1,1
9660865,9660950,85,0,0,1,2
9660951,9660973,22,1,0,0,2
9660974,9661132,158,0,0,1,2
9661133,9661149,16,1,0,0,2
9661150,9661487,337,0,0,1,2
9661488,9661523,35,1,0,0,2
9661490,9661514,24,1,0,0,1
9661515,9661903,388,0,0,1,1
9661524,9661903,379,0,0,1,2
9661904,9662014,110,1,0,0,2
9661904,9662016,112,1,0,0,1
9662015,9662100,85,0,0,1,2
9662017,9662093,76,0,0,1,1
9662094,9662886,792,1,0,0,1
9662101,9662657,556,1,0,0,2
9662143,9662373,230,0,1,0,2
9662151,9662440,289,0,1,0,1
9662447,9662526,79,0,1,0,2
9662507,9662593,86,0,1,0,1
9662658,9662708,50,0,0,1,2
9662709,9662748,39,1,0,0,2
9662749,9662772,23,0,0,1,2
9662773,9663058,285,1,0,0,2
9662887,9663150,263,0,0,1,1
9663059,9663146,87,0,0,1,2
9663147,9663157,10,1,0,0,2
9663151,9663155,4,1,0,0,1
9663156,9663786,630,0,0,1,1
9663158,9663788,630,0,0,1,2
9663787,9663796,9,1,0,0,1
9663789,9663803,14,1,0,0,2
9663797,9664479,682,0,0,1,1
9663804,9664479,675,0,0,1,2
9664480,9664521,41,1,0,0,2
9664480,9664522,42,1,0,0,1
9664522,9665010,488,0,0,1,2
9664523,9665008,485,0,0,1,1
9665009,9665052,43,1,0,0,1
9665011,9665056,45,1,0,0,2
9665053,9665711,658,0,0,1,1
9665057,9665711,654,0,0,1,2
9665712,9665732,20,1,0,0,1
9665712,9665743,31,1,0,0,2
9665733,9665841,108,0,0,1,1
9665744,9665844,100,0,0,1,2
9665842,9665864,22,1,0,0,1
9665845,9665865,20,1,0,0,2
9665865,9666673,808,0,0,1,1
9665866,9666674,808,0,0,1,2
9666674,9666696,22,1,0,0,1
9666675,9666698,23,1,0,0,2
9666697,9666817,120,0,0,1,1
9666699,9666814,115,0,0,1,2
9666815,9666840,25,1,0,0,2
9666818,9666839,21,1,0,0,1
9666840,9667086,246,0,0,1,1
9666841,9667088,247,0,0,1,2
9667087,9667132,45,1,0,0,1
9667089,9667114,25,1,0,0,2
9667115,9667522,407,0,0,1,2
9667133,9667524,391,0,0,1,1
9667523,9667599,76,1,0,0,2
9667525,9667593,68,1,0,0,1
9667594,9667701,107,0,0,1,1
9667600,9667703,103,0,0,1,2
9667702,9667735,33,1,0,0,1
9667704,9667731,27,1,0,0,2
9667732,9667974,242,0,0,1,2
9667736,9667976,240,0,0,1,1
9667975,9667997,22,1,0,0,2
9667977,9667996,19,1,0,0,1
9667997,9668184,187,0,0,1,1
9667998,9668189,191,0,0,1,2
9668185,9668212,27,1,0,0,1
9668190,9668202,12,1,0,0,2
9668203,9668391,188,0,0,1,2
9668213,9668390,177,0,0,1,1
9668391,9668410,19,1,0,0,1
9668392,9668409,17,1,0,0,2
9668410,9668820,410,0,0,1,2
9668411,9668840,429,0,0,1,1
9668821,9669057,236,1,0,0,2
9668841,9668871,30,1,0,0,1
9668872,9669605,733,0,0,1,1
9669058,9669082,24,0,0,1,2
9669083,9669176,93,1,0,0,2
9669177,9669607,430,0,0,1,2
9669606,9669636,30,1,0,0,1
9669608,9669635,27,1,0,0,2
9669636,9669934,298,0,0,1,2
9669637,9669933,296,0,0,1,1
9669934,9669987,53,1,0,0,1
9669935,9669988,53,1,0,0,2
9669988,9670080,92,0,0,1,1
9669989,9670079,90,0,0,1,2
9670080,9671052,972,1,0,0,2
9670081,9670200,119,1,0,0,1
9670201,9670260,59,0,0,1,1
9670261,9670527,266,1,0,0,1
9670300,9670455,155,0,1,0,1
9670306,9670515,209,0,1,0,2
9670528,9670611,83,0,0,1,1
9670612,9670633,21,1,0,0,1
9670624,9670624,0,0,1,0,1
9670634,9671240,606,0,0,1,1
9671053,9671073,20,0,0,1,2
9671074,9672288,1214,1,0,0,2
9671241,9671253,12,1,0,0,1
9671254,9671913,659,0,0,1,1
9671914,9672156,242,1,0,0,1
9671927,9672142,215,0,1,0,2
9671940,9672072,132,0,1,0,1
9672157,9672394,237,0,0,1,1
9672289,9672395,106,0,0,1,2
9672395,9672459,64,1,0,0,1
9672396,9672472,76,1,0,0,2
9672460,9672555,95,0,0,1,1
9672473,9672554,81,0,0,1,2
9672555,9672588,33,1,0,0,2
9672556,9672589,33,1,0,0,1
9672589,9672743,154,0,0,1,2
9672590,9672748,158,0,0,1,1
9672744,9672778,34,1,0,0,2
9672749,9672766,17,1,0,0,1
9672767,9672829,62,0,0,1,1
9672779,9672819,40,0,0,1,2
9672820,9673094,274,1,0,0,2
9672830,9673098,268,1,0,0,1
9672867,9673042,175,0,1,0,2
9672873,9673035,162,0,1,0,1
9673095,9673243,148,0,0,1,2
9673099,9673243,144,0,0,1,1
9673244,9673265,21,1,0,0,1
9673244,9673276,32,1,0,0,2
9673266,9673601,335,0,0,1,1
9673277,9673602,325,0,0,1,2
9673602,9673626,24,1,0,0,1
9673603,9673622,19,1,0,0,2
9673623,9674968,1345,0,0,1,2
9673627,9674964,1337,0,0,1,1
9674965,9675052,87,1,0,0,1
9674969,9675049,80,1,0,0,2
9675050,9675391,341,0,0,1,2
9675053,9675390,337,0,0,1,1
9675391,9675444,53,1,0,0,1
9675392,9675443,51,1,0,0,2
9675444,9675598,154,0,0,1,2
9675445,9675599,154,0,0,1,1
9675599,9675621,22,1,0,0,2
9675600,9675618,18,1,0,0,1
9675619,9676504,885,0,0,1,1
9675622,9676168,546,0,0,1,2
9676169,9676174,5,1,0,0,2
9676175,9676500,325,0,0,1,2
9676501,9676516,15,1,0,0,2
9676505,9676515,10,1,0,0,1
9676516,9677163,647,0,0,1,1
9676517,9676781,264,0,0,1,2
9676782,9676792,10,1,0,0,2
9676793,9677156,363,0,0,1,2
9677157,9677405,248,1,0,0,2
9677164,9677362,198,1,0,0,1
9677189,9677275,86,0,1,0,2
9677194,9677206,12,0,1,0,1
9677245,9677258,13,0,1,0,1
9677363,9677643,280,0,0,1,1
9677406,9677438,32,0,0,1,2
9677439,9677515,76,1,0,0,2
9677516,9677645,129,0,0,1,2
9677644,9677719,75,1,0,0,1
9677646,9677924,278,1,0,0,2
9677720,9678533,813,0,0,1,1
9677925,9677960,35,0,0,1,2
9677961,9677978,17,1,0,0,2
9677979,9678000,21,0,0,1,2
9678001,9682499,4498,1,0,0,2
9678111,9678190,79,0,1,0,2
9678218,9678219,1,0,1,0,2
9678248,9678341,93,0,1,0,2
9678371,9678383,12,0,1,0,2
9678416,9678425,9,0,1,0,2
9678472,9678477,5,0,1,0,2
9678534,9678542,8,1,0,0,1
9678543,9678583,40,0,0,1,1
9678594,9679983,1389,0,1,0,1
9679157,9679157,0,0,1,0,2
9679557,9679559,2,0,1,0,2
9679585,9679588,3,0,1,0,2
9679618,9679950,332,0,1,0,2
9679993,9682485,2492,1,0,0,1
9682486,9682956,470,0,0,1,1
9682500,9682648,148,0,0,1,2
9682649,9682780,131,1,0,0,2
9682781,9682952,171,0,0,1,2
9682953,9683294,341,1,0,0,2
9682957,9683128,171,1,0,0,1
9683004,9683097,93,0,1,0,2
9683129,9683201,72,0,0,1,1
9683202,9683215,13,1,0,0,1
9683216,9683245,29,0,0,1,1
9683246,9683286,40,1,0,0,1
9683287,9683427,140,0,0,1,1
9683295,9683429,134,0,0,1,2
9683428,9683449,21,1,0,0,1
9683430,9683460,30,1,0,0,2
9683450,9684625,1175,0,0,1,1
9683461,9684182,721,0,0,1,2
9684183,9684197,14,1,0,0,2
9684198,9684621,423,0,0,1,2
9684622,9684660,38,1,0,0,2
9684626,9684648,22,1,0,0,1
9684649,9684766,117,0,0,1,1
9684661,9684762,101,0,0,1,2
9684763,9684788,25,1,0,0,2
9684767,9684788,21,1,0,0,1
9684789,9685018,229,0,0,1,2
9684789,9685021,232,0,0,1,1
9685019,9685053,34,1,0,0,2
9685022,9685042,20,1,0,0,1
9685043,9685209,166,0,0,1,1
9685054,9685204,150,0,0,1,2
9685205,9685232,27,1,0,0,2
9685210,9685229,19,1,0,0,1
9685230,9685440,210,0,0,1,1
9685233,9685436,203,0,0,1,2
9685437,9685476,39,1,0,0,2
9685441,9685463,22,1,0,0,1
9685464,9685911,447,0,0,1,1
9685477,9685911,434,0,0,1,2
9685912,9685978,66,1,0,0,2
9685912,9685979,67,1,0,0,1
9685979,9686105,126,0,0,1,2
9685980,9686100,120,0,0,1,1
9686101,9686414,313,1,0,0,1
9686106,9686184,78,1,0,0,2
9686185,9686331,146,0,0,1,2
9686332,9686354,22,1,0,0,2
9686355,9686500,145,0,0,1,2
9686415,9686495,80,0,0,1,1
9686496,9686529,33,1,0,0,1
9686501,9686522,21,1,0,0,2
9686523,9687055,532,0,0,1,2
9686530,9687049,519,0,0,1,1
9687050,9687088,38,1,0,0,1
9687056,9687084,28,1,0,0,2
9687085,9687283,198,0,0,1,2
9687089,9687230,141,0,0,1,1
9687231,9687670,439,1,0,0,1
9687284,9687308,24,1,0,0,2
9687309,9687434,125,0,0,1,2
9687435,9687463,28,1,0,0,2
9687464,9687630,166,0,0,1,2
9687631,9687647,16,1,0,0,2
9687648,9687791,143,0,0,1,2
9687671,9687701,30,0,0,1,1
9687702,9688161,459,1,0,0,1
9687792,9687812,20,1,0,0,2
9687813,9688114,301,0,0,1,2
9688115,9688158,43,1,0,0,2
9688159,9688430,271,0,0,1,2
9688162,9688436,274,0,0,1,1
9688431,9688511,80,1,0,0,2
9688437,9688508,71,1,0,0,1
9688509,9688631,122,0,0,1,1
9688512,9688606,94,0,0,1,2
9688607,9690163,1556,1,0,0,2
9688632,9688664,32,1,0,0,1
9688665,9688939,274,0,0,1,1
9688940,9688963,23,1,0,0,1
9688964,9689118,154,0,0,1,1
9689119,9689137,18,1,0,0,1
9689138,9689526,388,0,0,1,1
9689527,9689548,21,1,0,0,1
9689549,9689706,157,0,0,1,1
9689707,9689730,23,1,0,0,1
9689731,9690093,362,0,0,1,1
9690094,9690150,56,1,0,0,1
9690151,9690429,278,0,0,1,1
9690164,9690385,221,0,0,1,2
9690386,9690418,32,1,0,0,2
9690419,9690485,66,0,0,1,2
9690430,9690460,30,1,0,0,1
9690461,9690483,22,0,0,1,1
9690484,9690535,51,1,0,0,1
9690486,9690555,69,1,0,0,2
9690536,9690673,137,0,0,1,1
9690556,9690668,112,0,0,1,2
9690669,9690685,16,1,0,0,2
9690674,9690687,13,1,0,0,1
9690686,9690895,209,0,0,1,2
9690688,9690891,203,0,0,1,1
9690892,9690926,34,1,0,0,1
9690896,9690912,16,1,0,0,2
9690913,9690964,51,0,0,1,2
9690927,9691061,134,0,0,1,1
9690965,9690970,5,1,0,0,2
9690971,9691001,30,0,0,1,2
9691002,9692384,1382,1,0,0,2
9691062,9691077,15,1,0,0,1
9691078,9691682,604,0,0,1,1
9691683,9691688,5,1,0,0,1
9691689,9691908,219,0,0,1,1
9691909,9691955,46,1,0,0,1
9691956,9692154,198,0,0,1,1
9692155,9692187,32,1,0,0,1
9692188,9692776,588,0,0,1,1
9692385,9692435,50,0,0,1,2
9692436,9692627,191,1,0,0,2
9692628,9692770,142,0,0,1,2
9692771,9694613,1842,1,0,0,2
9692777,9693237,460,1,0,0,1
9692807,9692964,157,0,1,0,2
9692818,9693163,345,0,1,0,1
9693034,9693086,52,0,1,0,2
9693146,9693183,37,0,1,0,2
9693238,9693400,162,0,0,1,1
9693401,9694522,1121,1,0,0,1
9693427,9693968,541,0,1,0,1
9693436,9694208,772,0,1,0,2
9693995,9694228,233,0,1,0,1
9694279,9694415,136,0,1,0,2
9694281,9694453,172,0,1,0,1
9694446,9694483,37,0,1,0,2
9694478,9694493,15,0,1,0,1
9694523,9694567,44,0,0,1,1
9694568,9694584,16,1,0,0,1
9694585,9694828,243,0,0,1,1
9694614,9694829,215,0,0,1,2
9694829,9694849,20,1,0,0,1
9694830,9694846,16,1,0,0,2
9694847,9696734,1887,0,0,1,2
9694850,9697031,2181,0,0,1,1
9696735,9696763,28,1,0,0,2
9696764,9696979,215,0,0,1,2
9696980,9697125,145,1,0,0,2
9697032,9697094,62,1,0,0,1
9697095,9697477,382,0,0,1,1
9697126,9697476,350,0,0,1,2
9697477,9697497,20,1,0,0,2
9697478,9697497,19,1,0,0,1
9697498,9699231,1733,0,0,1,2
9697498,9699243,1745,0,0,1,1
9699232,9699996,764,1,0,0,2
9699244,9699703,459,1,0,0,1
9699278,9699550,272,0,1,0,2
9699288,9699641,353,0,1,0,1
9699585,9699641,56,0,1,0,2
9699675,9699679,4,0,1,0,2
9699704,9699850,146,0,0,1,1
9699851,9699894,43,1,0,0,1
9699895,9700444,549,0,0,1,1
9699997,9700442,445,0,0,1,2
9700443,9700479,36,1,0,0,2
9700445,9700480,35,1,0,0,1
9700480,9701036,556,0,0,1,2
9700481,9701038,557,0,0,1,1
9701037,9701112,75,1,0,0,2
9701039,9701123,84,1,0,0,1
9701113,9701230,117,0,0,1,2
9701124,9701230,106,0,0,1,1
9701231,9701252,21,1,0,0,1
9701231,9703503,2272,1,0,0,2
9701253,9701426,173,0,0,1,1
9701427,9701448,21,1,0,0,1
9701449,9702039,590,0,0,1,1
9702040,9702049,9,1,0,0,1
9702050,9702599,549,0,0,1,1
9702600,9702617,17,1,0,0,1
9702618,9702758,140,0,0,1,1
9702759,9702785,26,1,0,0,1
9702786,9703410,624,0,0,1,1
9703411,9703452,41,1,0,0,1
9703453,9703621,168,0,0,1,1
9703504,9703611,107,0,0,1,2
9703612,9703659,47,1,0,0,2
9703622,9703638,16,1,0,0,1
9703639,9705453,1814,0,0,1,1
9703660,9705438,1778,0,0,1,2
9705439,9706129,690,1,0,0,2
9705454,9705969,515,1,0,0,1
9705476,9705941,465,0,1,0,2
9705477,9705480,3,0,1,0,1
9705530,9705876,346,0,1,0,1
9705970,9706101,131,0,0,1,1
9706102,9706128,26,1,0,0,1
9706129,9706301,172,0,0,1,1
9706130,9706273,143,0,0,1,2
9706274,9706341,67,1,0,0,2
9706302,9706333,31,1,0,0,1
9706334,9706463,129,0,0,1,1
9706342,9706459,117,0,0,1,2
9706460,9706500,40,1,0,0,2
9706464,9706494,30,1,0,0,1
9706495,9707115,620,0,0,1,1
9706501,9707113,612,0,0,1,2
9707114,9707143,29,1,0,0,2
9707116,9707144,28,1,0,0,1
9707144,9707352,208,0,0,1,2
9707145,9707355,210,0,0,1,1
9707353,9707426,73,1,0,0,2
9707356,9707424,68,1,0,0,1
9707425,9707565,140,0,0,1,1
9707427,9707489,62,0,0,1,2
9707490,9707496,6,1,0,0,2
9707497,9707568,71,0,0,1,2
9707566,9707587,21,1,0,0,1
9707569,9707590,21,1,0,0,2
9707588,9707716,128,0,0,1,1
9707591,9707707,116,0,0,1,2
9707708,9708362,654,1,0,0,2
9707717,9708116,399,1,0,0,1
9707759,9708015,256,0,1,0,2
9707779,9707959,180,0,1,0,1
9708117,9708577,460,0,0,1,1
9708363,9708578,215,0,0,1,2
9708578,9708592,14,1,0,0,1
9708579,9708589,10,1,0,0,2
9708590,9709645,1055,0,0,1,2
9708593,9709641,1048,0,0,1,1
9709642,9709687,45,1,0,0,1
9709646,9709682,36,1,0,0,2
9709683,9710142,459,0,0,1,2
9709688,9710138,450,0,0,1,1
9710139,9710158,19,1,0,0,1
9710143,9710178,35,1,0,0,2
9710159,9710460,301,0,0,1,1
9710179,9710463,284,0,0,1,2
9710461,9710483,22,1,0,0,1
9710464,9710500,36,1,0,0,2
9710484,9710650,166,0,0,1,1
9710501,9710651,150,0,0,1,2
9710651,9710680,29,1,0,0,1
9710652,9712702,2050,1,0,0,2
9710681,9710832,151,0,0,1,1
9710833,9710857,24,1,0,0,1
9710858,9710970,112,0,0,1,1
9710971,9710998,27,1,0,0,1
9710999,9711164,165,0,0,1,1
9711165,9711195,30,1,0,0,1
9711196,9711370,174,0,0,1,1
9711371,9711401,30,1,0,0,1
9711402,9711740,338,0,0,1,1
9711741,9711779,38,1,0,0,1
9711780,9711928,148,0,0,1,1
9711929,9712454,525,1,0,0,1
9712015,9712387,372,0,1,0,2
9712016,9712302,286,0,1,0,1
9712455,9712537,82,0,0,1,1
9712538,9712662,124,1,0,0,1
9712663,9712808,145,0,0,1,1
9712703,9712807,104,0,0,1,2
9712808,9713213,405,1,0,0,2
9712809,9712844,35,1,0,0,1
9712845,9713178,333,0,0,1,1
9713179,9713219,40,1,0,0,1
9713214,9713340,126,0,0,1,2
9713220,9713338,118,0,0,1,1
9713339,9713355,16,1,0,0,1
9713341,9713359,18,1,0,0,2
9713356,9713885,529,0,0,1,1
9713360,9715014,1654,0,0,1,2
9713886,9713890,4,1,0,0,1
9713891,9715019,1128,0,0,1,1
9715015,9715044,29,1,0,0,2
9715020,9715040,20,1,0,0,1
9715041,9715245,204,0,0,1,1
9715045,9715244,199,0,0,1,2
9715245,9715301,56,1,0,0,2
9715246,9715318,72,1,0,0,1
9715302,9716919,1617,0,0,1,2
9715319,9716920,1601,0,0,1,1
9716920,9716961,41,1,0,0,2
9716921,9716964,43,1,0,0,1
9716962,9717282,320,0,0,1,2
9716965,9717297,332,0,0,1,1
9717283,9717763,480,1,0,0,2
9717298,9717699,401,1,0,0,1
9717339,9717602,263,0,1,0,2
9717344,9717600,256,0,1,0,1
9717700,9718516,816,0,0,1,1
9717764,9717805,41,0,0,1,2
9717806,9718118,312,1,0,0,2
9718119,9718515,396,0,0,1,2
9718516,9725902,7386,1,0,0,2
9718517,9718583,66,1,0,0,1
9718584,9719243,659,0,0,1,1
9719244,9719258,14,1,0,0,1
9719259,9719507,248,0,0,1,1
9719508,9719544,36,1,0,0,1
9719545,9719859,314,0,0,1,1
9719860,9719869,9,1,0,0,1
9719870,9720274,404,0,0,1,1
9720275,9721644,1369,1,0,0,1
9720709,9721408,699,0,1,0,2
9721607,9721642,35,0,1,0,2
9721645,9721691,46,0,0,1,1
9721692,9721725,33,1,0,0,1
9721726,9721987,261,0,0,1,1
9721988,9722054,66,1,0,0,1
9722055,9722110,55,0,0,1,1
9722111,9722232,121,1,0,0,1
9722119,9722751,632,0,1,0,2
9722233,9722265,32,0,0,1,1
9722266,9722270,4,1,0,0,1
9722271,9722396,125,0,0,1,1
9722397,9722487,90,1,0,0,1
9722488,9722595,107,0,0,1,1
9722596,9722626,30,1,0,0,1
9722627,9722745,118,0,0,1,1
9722746,9722781,35,1,0,0,1
9722782,9722904,122,0,0,1,1
9722905,9724218,1313,1,0,0,1
9722916,9723375,459,0,1,0,1
9722929,9722929,0,0,1,0,2
9723019,9723052,33,0,1,0,2
9723077,9723101,24,0,1,0,2
9723147,9723421,274,0,1,0,2
9723454,9723888,434,0,1,0,1
9723656,9723656,0,0,1,0,2
9723708,9723713,5,0,1,0,2
9723750,9724027,277,0,1,0,2
9724219,9724490,271,0,0,1,1
9724491,9724526,35,1,0,0,1
9724527,9724814,287,0,0,1,1
9724815,9724852,37,1,0,0,1
9724853,9725106,253,0,0,1,1
9725107,9725127,20,1,0,0,1
9725128,9725231,103,0,0,1,1
9725232,9725265,33,1,0,0,1
9725266,9725514,248,0,0,1,1
9725515,9725588,73,1,0,0,1
9725589,9725721,132,0,0,1,1
9725722,9725747,25,1,0,0,1
9725748,9725980,232,0,0,1,1
9725903,9725983,80,0,0,1,2
9725981,9726000,19,1,0,0,1
9725984,9726000,16,1,0,0,2
9726001,9726154,153,0,0,1,2
9726001,9726284,283,0,0,1,1
9726155,9726902,747,1,0,0,2
9726285,9726295,10,1,0,0,1
9726296,9726559,263,0,0,1,1
9726560,9726571,11,1,0,0,1
9726572,9727423,851,0,0,1,1
9726903,9726927,24,0,0,1,2
9726928,9726963,35,1,0,0,2
9726964,9727005,41,0,0,1,2
9727006,9727683,677,1,0,0,2
9727424,9727467,43,1,0,0,1
9727468,9727804,336,0,0,1,1
9727684,9727716,32,0,0,1,2
9727717,9727854,137,1,0,0,2
9727805,9727854,49,1,0,0,1
9727855,9727880,25,0,0,1,2
9727855,9728210,355,0,0,1,1
9727881,9728911,1030,1,0,0,2
9728211,9728581,370,1,0,0,1
9728233,9728605,372,0,1,0,2
9728248,9728538,290,0,1,0,1
9728582,9728701,119,0,0,1,1
9728702,9728723,21,1,0,0,1
9728724,9728968,244,0,0,1,1
9728912,9728946,34,0,0,1,2
9728947,9730458,1511,1,0,0,2
9728969,9728987,18,1,0,0,1
9728988,9729189,201,0,0,1,1
9729190,9729208,18,1,0,0,1
9729209,9730036,827,0,0,1,1
9730037,9730066,29,1,0,0,1
9730067,9730358,291,0,0,1,1
9730359,9730407,48,1,0,0,1
9730408,9730734,326,0,0,1,1
9730459,9730621,162,0,0,1,2
9730622,9730764,142,1,0,0,2
9730735,9730761,26,1,0,0,1
9730762,9730988,226,0,0,1,1
9730765,9730987,222,0,0,1,2
9730988,9731055,67,1,0,0,2
9730989,9731018,29,1,0,0,1
9731019,9731620,601,0,0,1,1
9731056,9731438,382,0,0,1,2
9731439,9731462,23,1,0,0,2
9731463,9731619,156,0,0,1,2
9731620,9731702,82,1,0,0,2
9731621,9731699,78,1,0,0,1
9731700,9731821,121,0,0,1,1
9731703,9731819,116,0,0,1,2
9731820,9731856,36,1,0,0,2
9731822,9731852,30,1,0,0,1
9731853,9734001,2148,0,0,1,1
9731857,9732667,810,0,0,1,2
9732668,9732673,5,1,0,0,2
9732674,9733576,902,0,0,1,2
9733577,9733593,16,1,0,0,2
9733594,9734000,406,0,0,1,2
9734001,9734063,62,1,0,0,2
9734002,9734040,38,1,0,0,1
9734041,9734390,349,0,0,1,1
9734064,9734388,324,0,0,1,2
9734389,9734413,24,1,0,0,2
9734391,9734413,22,1,0,0,1
9734414,9735352,938,0,0,1,2
9734414,9735353,939,0,0,1,1
9735353,9735390,37,1,0,0,2
9735354,9735370,16,1,0,0,1
9735371,9735511,140,0,0,1,1
9735391,9735504,113,0,0,1,2
9735505,9735542,37,1,0,0,2
9735512,9735524,12,1,0,0,1
9735525,9736009,484,0,0,1,1
9735543,9736008,465,0,0,1,2
9736009,9736630,621,1,0,0,2
9736010,9736434,424,1,0,0,1
9736099,9736407,308,0,1,0,2
9736125,9736369,244,0,1,0,1
9736435,9736597,162,0,0,1,1
9736598,9736637,39,1,0,0,1
9736631,9737099,468,0,0,1,2
9736638,9737101,463,0,0,1,1
9737100,9737133,33,1,0,0,2
9737102,9737147,45,1,0,0,1
9737134,9737313,179,0,0,1,2
9737148,9737593,445,0,0,1,1
9737314,9737323,9,1,0,0,2
9737324,9737592,268,0,0,1,2
9737593,9737629,36,1,0,0,2
9737594,9737619,25,1,0,0,1
9737620,9738406,786,0,0,1,1
9737630,9737904,274,0,0,1,2
9737905,9737927,22,1,0,0,2
9737928,9738047,119,0,0,1,2
9738048,9738052,4,1,0,0,2
9738053,9738394,341,0,0,1,2
9738395,9738423,28,1,0,0,2
9738407,9738411,4,1,0,0,1
9738412,9739297,885,0,0,1,1
9738424,9739199,775,0,0,1,2
9739200,9739209,9,1,0,0,2
9739210,9739295,85,0,0,1,2
9739296,9739337,41,1,0,0,2
9739298,9739326,28,1,0,0,1
9739327,9739582,255,0,0,1,1
9739338,9739583,245,0,0,1,2
9739583,9739614,31,1,0,0,1
9739584,9739626,42,1,0,0,2
9739615,9739893,278,0,0,1,1
9739627,9739892,265,0,0,1,2
9739893,9739959,66,1,0,0,2
9739894,9739961,67,1,0,0,1
9739960,9740068,108,0,0,1,2
9739962,9740068,106,0,0,1,1
9740069,9740095,26,1,0,0,1
9740069,9740099,30,1,0,0,2
9740096,9740358,262,0,0,1,1
9740100,9740357,257,0,0,1,2
9740358,9740374,16,1,0,0,2
9740359,9740370,11,1,0,0,1
9740371,9742034,1663,0,0,1,1
9740375,9742025,1650,0,0,1,2
9742026,9742786,760,1,0,0,2
9742035,9742568,533,1,0,0,1
9742092,9742537,445,0,1,0,2
9742100,9742522,422,0,1,0,1
9742569,9742682,113,0,0,1,1
9742683,9742725,42,1,0,0,1
9742726,9743108,382,0,0,1,1
9742787,9742883,96,0,0,1,2
9742884,9742934,50,1,0,0,2
9742935,9743031,96,0,0,1,2
9743032,9743061,29,1,0,0,2
9743062,9743110,48,0,0,1,2
9743109,9743130,21,1,0,0,1
9743111,9743145,34,1,0,0,2
9743131,9743427,296,0,0,1,1
9743146,9743426,280,0,0,1,2
9743427,9745190,1763,1,0,0,2
9743428,9743490,62,1,0,0,1
9743491,9743613,122,0,0,1,1
9743614,9743640,26,1,0,0,1
9743641,9744148,507,0,0,1,1
9744149,9744170,21,1,0,0,1
9744171,9744306,135,0,0,1,1
9744307,9744326,19,1,0,0,1
9744327,9744651,324,0,0,1,1
9744652,9744672,20,1,0,0,1
9744673,9744847,174,0,0,1,1
9744848,9744864,16,1,0,0,1
9744865,9745116,251,0,0,1,1
9745117,9745177,60,1,0,0,1
9745178,9745583,405,0,0,1,1
9745191,9745582,391,0,0,1,2
9745583,9745608,25,1,0,0,2
9745584,9745604,20,1,0,0,1
9745605,9745975,370,0,0,1,1
9745609,9745975,366,0,0,1,2
9745976,9745995,19,1,0,0,1
9745976,9745997,21,1,0,0,2
9745996,9747484,1488,0,0,1,1
9745998,9746479,481,0,0,1,2
9746480,9746484,4,1,0,0,2
9746485,9747495,1010,0,0,1,2
9747485,9747507,22,1,0,0,1
9747496,9747513,17,1,0,0,2
9747508,9747660,152,0,0,1,1
9747514,9747634,120,0,0,1,2
9747635,9748679,1044,1,0,0,2
9747661,9748309,648,1,0,0,1
9747730,9748138,408,0,1,0,2
9747739,9748113,374,0,1,0,1
9748310,9748550,240,0,0,1,1
9748551,9748590,39,1,0,0,1
9748591,9748754,163,0,0,1,1
9748680,9748730,50,0,0,1,2
9748731,9749571,840,1,0,0,2
9748755,9754044,5289,1,0,0,1
9749054,9749103,49,0,1,0,1
9749102,9749121,19,0,1,0,2
9749130,9749302,172,0,1,0,1
9749161,9749290,129,0,1,0,2
9749333,9749398,65,0,1,0,1
9749397,9749499,102,0,1,0,2
9749554,9749565,11,0,1,0,1
9749572,9749625,53,0,0,1,2
9749618,9749672,54,0,1,0,1
9749626,9749665,39,1,0,0,2
9749666,9749741,75,0,0,1,2
9749695,9749743,48,0,1,0,1
9749742,9750834,1092,1,0,0,2
9749782,9749814,32,0,1,0,1
9749846,9749887,41,0,1,0,1
9749993,9750039,46,0,1,0,1
9750084,9750366,282,0,1,0,1
9750390,9750423,33,0,1,0,1
9750448,9750460,12,0,1,0,1
9750517,9750520,3,0,1,0,1
9750559,9750600,41,0,1,0,1
9750628,9750750,122,0,1,0,1
9750835,9750914,79,0,0,1,2
9750915,9750954,39,1,0,0,2
9750955,9751018,63,0,0,1,2
9751019,9751027,8,1,0,0,2
9751028,9751221,193,0,0,1,2
9751222,9751268,46,1,0,0,2
9751247,9751257,10,0,1,0,2
9751269,9751296,27,0,0,1,2
9751297,9751353,56,1,0,0,2
9751309,9751323,14,0,1,0,2
9751320,9751320,0,0,1,0,1
9751354,9751430,76,0,0,1,2
9751431,9751557,126,1,0,0,2
9751470,9751563,93,0,1,0,1
9751558,9751610,52,0,0,1,2
9751611,9752932,1321,1,0,0,2
9752933,9752969,36,0,0,1,2
9752970,9753336,366,1,0,0,2
9753099,9753188,89,0,1,0,1
9753337,9753373,36,0,0,1,2
9753374,9754300,926,1,0,0,2
9753573,9753591,18,0,1,0,1
9753585,9753849,264,0,1,0,2
9753619,9753937,318,0,1,0,1
9753870,9754030,160,0,1,0,2
9754045,9754198,153,0,0,1,1
9754199,9754232,33,1,0,0,1
9754233,9754348,115,0,0,1,1
9754301,9754347,46,0,0,1,2
9754348,9754384,36,1,0,0,2
9754349,9754389,40,1,0,0,1
9754385,9754591,206,0,0,1,2
9754390,9754589,199,0,0,1,1
9754590,9754631,41,1,0,0,1
9754592,9754634,42,1,0,0,2
9754632,9754762,130,0,0,1,1
9754635,9754759,124,0,0,1,2
9754760,9754840,80,1,0,0,2
9754763,9754843,80,1,0,0,1
9754841,9754964,123,0,0,1,2
9754844,9754963,119,0,0,1,1
9754964,9755004,40,1,0,0,1
9754965,9755020,55,1,0,0,2
9755005,9755209,204,0,0,1,1
9755021,9755210,189,0,0,1,2
9755210,9755231,21,1,0,0,1
9755211,9755231,20,1,0,0,2
9755232,9755446,214,0,0,1,1
9755232,9755448,216,0,0,1,2
9755447,9755464,17,1,0,0,1
9755449,9755464,15,1,0,0,2
9755465,9755662,197,0,0,1,2
9755465,9755708,243,0,0,1,1
9755663,9755750,87,1,0,0,2
9755709,9755722,13,1,0,0,1
9755723,9755994,271,0,0,1,1
9755751,9755992,241,0,0,1,2
9755993,9756014,21,1,0,0,2
9755995,9756015,20,1,0,0,1
9756015,9756152,137,0,0,1,2
9756016,9756151,135,0,0,1,1
9756152,9756170,18,1,0,0,1
9756153,9756170,17,1,0,0,2
9756171,9756981,810,0,0,1,2
9756171,9757172,1001,0,0,1,1
9756982,9756986,4,1,0,0,2
9756987,9757172,185,0,0,1,2
9757173,9757218,45,1,0,0,2
9757173,9757227,54,1,0,0,1
9757219,9757362,143,0,0,1,2
9757228,9757362,134,0,0,1,1
9757363,9757390,27,1,0,0,1
9757363,9757391,28,1,0,0,2
9757391,9759294,1903,0,0,1,1
9757392,9759115,1723,0,0,1,2
9759116,9759186,70,1,0,0,2
9759187,9759292,105,0,0,1,2
9759293,9759357,64,1,0,0,2
9759295,9759318,23,1,0,0,1
9759319,9759421,102,0,0,1,1
9759358,9759410,52,0,0,1,2
9759411,9759874,463,1,0,0,2
9759422,9759564,142,1,0,0,1
9759469,9759548,79,0,1,0,2
9759565,9759795,230,0,0,1,1
9759796,9759873,77,1,0,0,1
9759874,9760008,134,0,0,1,1
9759875,9759980,105,0,0,1,2
9759981,9760466,485,1,0,0,2
9760009,9760306,297,1,0,0,1
9760048,9760248,200,0,1,0,2
9760050,9760248,198,0,1,0,1
9760307,9760434,127,0,0,1,1
9760435,9760465,30,1,0,0,1
9760466,9760692,226,0,0,1,1
9760467,9760689,222,0,0,1,2
9760690,9760721,31,1,0,0,2
9760693,9760720,27,1,0,0,1
9760721,9760901,180,0,0,1,1
9760722,9760898,176,0,0,1,2
9760899,9760959,60,1,0,0,2
9760902,9760970,68,1,0,0,1
9760960,9761736,776,0,0,1,2
9760971,9761736,765,0,0,1,1
9761737,9761754,17,1,0,0,1
9761737,9761756,19,1,0,0,2
9761755,9761894,139,0,0,1,1
9761757,9761894,137,0,0,1,2
9761895,9761912,17,1,0,0,1
9761895,9761921,26,1,0,0,2
9761913,9762151,238,0,0,1,1
9761922,9762148,226,0,0,1,2
9762149,9762168,19,1,0,0,2
9762152,9762165,13,1,0,0,1
9762166,9762329,163,0,0,1,1
9762169,9762329,160,0,0,1,2
9762330,9762345,15,1,0,0,1
9762330,9762351,21,1,0,0,2
9762346,9762549,203,0,0,1,1
9762352,9762547,195,0,0,1,2
9762548,9762566,18,1,0,0,2
9762550,9762565,15,1,0,0,1
9762566,9762992,426,0,0,1,1
9762567,9762994,427,0,0,1,2
9762993,9763015,22,1,0,0,1
9762995,9763015,20,1,0,0,2
9763016,9763162,146,0,0,1,2
9763016,9763163,147,0,0,1,1
9763163,9763214,51,1,0,0,2
9763164,9763213,49,1,0,0,1
9763214,9763365,151,0,0,1,1
9763215,9763364,149,0,0,1,2
9763365,9763394,29,1,0,0,2
9763366,9763385,19,1,0,0,1
9763386,9763954,568,0,0,1,1
9763395,9763952,557,0,0,1,2
9763953,9764010,57,1,0,0,2
9763955,9763975,20,1,0,0,1
9763976,9764430,454,0,0,1,1
9764011,9764429,418,0,0,1,2
9764430,9764454,24,1,0,0,2
9764431,9764455,24,1,0,0,1
9764455,9764685,230,0,0,1,2
9764456,9764684,228,0,0,1,1
9764685,9764710,25,1,0,0,1
9764686,9764718,32,1,0,0,2
9764711,9764900,189,0,0,1,1
9764719,9764899,180,0,0,1,2
9764900,9764924,24,1,0,0,2
9764901,9764924,23,1,0,0,1
9764925,9765203,278,0,0,1,1
9764925,9765204,279,0,0,1,2
9765204,9765230,26,1,0,0,1
9765205,9765254,49,1,0,0,2
9765231,9765365,134,0,0,1,1
9765255,9765362,107,0,0,1,2
9765363,9765409,46,1,0,0,2
9765366,9765414,48,1,0,0,1
9765410,9765548,138,0,0,1,2
9765415,9765544,129,0,0,1,1
9765545,9765571,26,1,0,0,1
9765549,9765592,43,1,0,0,2
9765572,9765737,165,0,0,1,1
9765593,9765738,145,0,0,1,2
9765738,9765772,34,1,0,0,1
9765739,9765785,46,1,0,0,2
9765773,9765952,179,0,0,1,1
9765786,9765950,164,0,0,1,2
9765951,9765997,46,1,0,0,2
9765953,9765984,31,1,0,0,1
9765985,9766113,128,0,0,1,1
9765998,9766088,90,0,0,1,2
9766089,9766441,352,1,0,0,2
9766114,9766410,296,1,0,0,1
9766148,9766305,157,0,1,0,2
9766154,9766308,154,0,1,0,1
9766339,9766353,14,0,1,0,1
9766411,9766716,305,0,0,1,1
9766442,9766715,273,0,0,1,2
9766716,9766785,69,1,0,0,2
9766717,9766792,75,1,0,0,1
9766786,9766914,128,0,0,1,2
9766793,9766914,121,0,0,1,1
9766915,9766933,18,1,0,0,2
9766915,9766935,20,1,0,0,1
9766934,9767278,344,0,0,1,2
9766936,9767609,673,0,0,1,1
9767279,9767288,9,1,0,0,2
9767289,9767608,319,0,0,1,2
9767609,9767623,14,1,0,0,2
9767610,9767616,6,1,0,0,1
9767617,9767894,277,0,0,1,1
9767624,9767894,270,0,0,1,2
9767895,9767906,11,1,0,0,1
9767895,9767909,14,1,0,0,2
9767907,9769241,1334,0,0,1,1
9767910,9769241,1331,0,0,1,2
9769242,9769293,51,1,0,0,1
9769242,9769300,58,1,0,0,2
9769294,9769417,123,0,0,1,1
9769301,9769418,117,0,0,1,2
9769418,9769452,34,1,0,0,1
9769419,9769442,23,1,0,0,2
9769443,9770467,1024,0,0,1,2
9769453,9770662,1209,0,0,1,1
9770468,9770479,11,1,0,0,2
9770480,9770666,186,0,0,1,2
9770663,9770680,17,1,0,0,1
9770667,9770682,15,1,0,0,2
9770681,9770839,158,0,0,1,1
9770683,9770838,155,0,0,1,2
9770839,9770863,24,1,0,0,2
9770840,9770861,21,1,0,0,1
9770862,9770997,135,0,0,1,1
9770864,9771000,136,0,0,1,2
9770998,9771016,18,1,0,0,1
9771001,9771018,17,1,0,0,2
9771017,9771979,962,0,0,1,1
9771019,9771972,953,0,0,1,2
9771973,9772014,41,1,0,0,2
9771980,9772008,28,1,0,0,1
9772009,9772129,120,0,0,1,1
9772015,9772129,114,0,0,1,2
9772130,9772152,22,1,0,0,2
9772130,9772153,23,1,0,0,1
9772153,9772805,652,0,0,1,2
9772154,9772804,650,0,0,1,1
9772805,9772845,40,1,0,0,1
9772806,9772853,47,1,0,0,2
9772846,9774353,1507,0,0,1,1
9772854,9774351,1497,0,0,1,2
9774352,9774371,19,1,0,0,2
9774354,9774372,18,1,0,0,1
9774372,9774529,157,0,0,1,2
9774373,9774524,151,0,0,1,1
9774525,9774534,9,1,0,0,1
9774530,9774554,24,1,0,0,2
9774535,9774821,286,0,0,1,1
9774555,9774817,262,0,0,1,2
9774818,9774868,50,1,0,0,2
9774822,9774869,47,1,0,0,1
9774869,9774924,55,0,0,1,2
9774870,9774929,59,0,0,1,1
9774925,9775457,532,1,0,0,2
9774930,9775366,436,1,0,0,1
9774949,9775164,215,0,1,0,2
9774972,9775240,268,0,1,0,1
9775242,9775367,125,0,1,0,2
9775307,9775329,22,0,1,0,1
9775367,9775481,114,0,0,1,1
9775458,9775479,21,0,0,1,2
9775480,9775822,342,1,0,0,2
9775482,9775509,27,1,0,0,1
9775510,9776372,862,0,0,1,1
9775823,9775858,35,0,0,1,2
9775859,9776529,670,1,0,0,2
9776373,9776406,33,1,0,0,1
9776407,9776545,138,0,0,1,1
9776530,9776550,20,0,0,1,2
9776546,9776568,22,1,0,0,1
9776551,9776732,181,1,0,0,2
9776569,9776877,308,0,0,1,1
9776733,9776842,109,0,0,1,2
9776843,9777499,656,1,0,0,2
9776878,9776904,26,1,0,0,1
9776905,9777148,243,0,0,1,1
9777149,9777176,27,1,0,0,1
9777177,9777256,79,0,0,1,1
9777257,9777313,56,1,0,0,1
9777314,9777372,58,0,0,1,1
9777373,9777391,18,1,0,0,1
9777392,9777884,492,0,0,1,1
9777500,9777881,381,0,0,1,2
9777882,9777915,33,1,0,0,2
9777885,9777915,30,1,0,0,1
9777916,9778075,159,0,0,1,2
9777916,9778084,168,0,0,1,1
9778076,9778091,15,1,0,0,2
9778085,9778089,4,1,0,0,1
9778090,9778414,324,0,0,1,1
9778092,9778412,320,0,0,1,2
9778413,9778452,39,1,0,0,2
9778415,9778443,28,1,0,0,1
9778444,9778581,137,0,0,1,1
9778453,9778582,129,0,0,1,2
9778582,9778634,52,1,0,0,1
9778583,9778642,59,1,0,0,2
9778635,9779441,806,0,0,1,1
9778643,9779442,799,0,0,1,2
9779442,9779452,10,1,0,0,1
9779443,9779464,21,1,0,0,2
9779453,9779721,268,0,0,1,1
9779465,9779721,256,0,0,1,2
9779722,9779739,17,1,0,0,1
9779722,9779739,17,1,0,0,2
9779740,9779909,169,0,0,1,1
9779740,9779912,172,0,0,1,2
9779910,9779925,15,1,0,0,1
9779913,9779928,15,1,0,0,2
9779926,9780471,545,0,0,1,1
9779929,9780469,540,0,0,1,2
9780470,9780500,30,1,0,0,2
9780472,9780489,17,1,0,0,1
9780490,9780640,150,0,0,1,1
9780501,9780639,138,0,0,1,2
9780640,9780672,32,1,0,0,2
9780641,9780656,15,1,0,0,1
9780657,9780930,273,0,0,1,1
9780673,9780928,255,0,0,1,2
9780929,9783988,3059,1,0,0,2
9780931,9781009,78,1,0,0,1
9781010,9781070,60,0,0,1,1
9781071,9782322,1251,1,0,0,1
9782323,9782348,25,0,0,1,1
9782349,9782489,140,1,0,0,1
9782490,9782538,48,0,0,1,1
9782539,9782801,262,1,0,0,1
9782802,9782922,120,0,0,1,1
9782923,9783306,383,1,0,0,1
9782941,9783182,241,0,1,0,1
9782950,9782953,3,0,1,0,2
9782979,9783243,264,0,1,0,2
9783212,9783231,19,0,1,0,1
9783269,9783272,3,0,1,0,2
9783307,9783330,23,0,0,1,1
9783331,9783342,11,1,0,0,1
9783343,9783402,59,0,0,1,1
9783403,9783952,549,1,0,0,1
9783432,9783923,491,0,1,0,2
9783441,9783912,471,0,1,0,1
9783953,9784153,200,0,0,1,1
9783989,9784150,161,0,0,1,2
9784151,9784193,42,1,0,0,2
9784154,9784193,39,1,0,0,1
9784194,9784316,122,0,0,1,1
9784194,9784316,122,0,0,1,2
9784317,9784549,232,1,0,0,1
9784317,9784586,269,1,0,0,2
9784353,9784499,146,0,1,0,2
9784357,9784492,135,0,1,0,1
9784550,9784609,59,0,0,1,1
9784587,9784608,21,0,0,1,2
9784609,9784641,32,1,0,0,2
9784610,9784635,25,1,0,0,1
9784636,9785692,1056,0,0,1,1
9784642,9785780,1138,0,0,1,2
9785693,9785709,16,1,0,0,1
9785710,9785778,68,0,0,1,1
9785779,9785805,26,1,0,0,1
9785781,9785795,14,1,0,0,2
9785796,9785921,125,0,0,1,2
9785806,9785920,114,0,0,1,1
9785921,9785943,22,1,0,0,1
9785922,9785941,19,1,0,0,2
9785942,9786200,258,0,0,1,2
9785944,9786311,367,0,0,1,1
9786201,9786229,28,1,0,0,2
9786230,9786544,314,0,0,1,2
9786312,9786325,13,1,0,0,1
9786326,9786538,212,0,0,1,1
9786539,9786561,22,1,0,0,1
9786545,9786557,12,1,0,0,2
9786558,9787021,463,0,0,1,2
9786562,9787549,987,0,0,1,1
9787022,9787041,19,1,0,0,2
9787042,9787072,30,0,0,1,2
9787073,9787158,85,1,0,0,2
9787159,9787548,389,0,0,1,2
9787549,9787603,54,1,0,0,2
9787550,9787583,33,1,0,0,1
9787584,9787714,130,0,0,1,1
9787604,9787714,110,0,0,1,2
9787715,9787742,27,1,0,0,1
9787715,9787742,27,1,0,0,2
9787743,9787854,111,0,0,1,2
9787743,9787891,148,0,0,1,1
9787855,9787914,59,1,0,0,2
9787892,9787898,6,1,0,0,1
9787899,9788360,461,0,0,1,1
9787915,9788361,446,0,0,1,2
9788361,9788380,19,1,0,0,1
9788362,9788458,96,1,0,0,2
9788381,9788526,145,0,0,1,1
9788459,9788528,69,0,0,1,2
9788527,9788546,19,1,0,0,1
9788529,9788583,54,1,0,0,2
9788547,9788880,333,0,0,1,1
9788584,9788624,40,0,0,1,2
9788625,9788634,9,1,0,0,2
9788635,9788720,85,0,0,1,2
9788721,9788748,27,1,0,0,2
9788749,9788858,109,0,0,1,2
9788859,9788959,100,1,0,0,2
9788881,9788912,31,1,0,0,1
9788913,9788986,73,0,0,1,1
9788960,9788986,26,0,0,1,2
9788987,9789009,22,1,0,0,1
9788987,9789069,82,1,0,0,2
9789010,9789208,198,0,0,1,1
9789070,9789113,43,0,0,1,2
9789114,9790272,1158,1,0,0,2
9789209,9789231,22,1,0,0,1
9789232,9789327,95,0,0,1,1
9789328,9789369,41,1,0,0,1
9789370,9789633,263,0,0,1,1
9789634,9789947,313,1,0,0,1
9789731,9789929,198,0,1,0,2
9789742,9789765,23,0,1,0,1
9789789,9789830,41,0,1,0,1
9789852,9789886,34,0,1,0,1
9789948,9790118,170,0,0,1,1
9790119,9790136,17,1,0,0,1
9790137,9790484,347,0,0,1,1
9790273,9790305,32,0,0,1,2
9790306,9790332,26,1,0,0,2
9790333,9790362,29,0,0,1,2
9790363,9790393,30,1,0,0,2
9790394,9790445,51,0,0,1,2
9790446,9790567,121,1,0,0,2
9790485,9790499,14,1,0,0,1
9790500,9790846,346,0,0,1,1
9790568,9790611,43,0,0,1,2
9790612,9790867,255,1,0,0,2
9790847,9790864,17,1,0,0,1
9790865,9791180,315,0,0,1,1
9790868,9790896,28,0,0,1,2
9790897,9790990,93,1,0,0,2
9790991,9791069,78,0,0,1,2
9791070,9791092,22,1,0,0,2
9791093,9791177,84,0,0,1,2
9791178,9791209,31,1,0,0,2
9791181,9791212,31,1,0,0,1
9791210,9791508,298,0,0,1,2
9791213,9791513,300,0,0,1,1
9791509,9791800,291,1,0,0,2
9791514,9791772,258,1,0,0,1
9791545,9791713,168,0,1,0,2
9791550,9791711,161,0,1,0,1
9791773,9791854,81,0,0,1,1
9791801,9791855,54,0,0,1,2
9791855,9791879,24,1,0,0,1
9791856,9791868,12,1,0,0,2
9791869,9792279,410,0,0,1,2
9791880,9792036,156,0,0,1,1
9792037,9792042,5,1,0,0,1
9792043,9792282,239,0,0,1,1
9792280,9792300,20,1,0,0,2
9792283,9792298,15,1,0,0,1
9792299,9792506,207,0,0,1,1
9792301,9792498,197,0,0,1,2
9792499,9792517,18,1,0,0,2
9792507,9792517,10,1,0,0,1
9792518,9793779,1261,0,0,1,1
9792518,9793782,1264,0,0,1,2
9793780,9793818,38,1,0,0,1
9793783,9793818,35,1,0,0,2
9793819,9793930,111,0,0,1,2
9793819,9793931,112,0,0,1,1
9793931,9793963,32,1,0,0,2
9793932,9793963,31,1,0,0,1
9793964,9794958,994,0,0,1,2
9793964,9794963,999,0,0,1,1
9794959,9794976,17,1,0,0,2
9794964,9794974,10,1,0,0,1
9794975,9795217,242,0,0,1,1
9794977,9795217,240,0,0,1,2
9795218,9795237,19,1,0,0,1
9795218,9795238,20,1,0,0,2
9795238,9795385,147,0,0,1,1
9795239,9795388,149,0,0,1,2
9795386,9795405,19,1,0,0,1
9795389,9795406,17,1,0,0,2
9795406,9795924,518,0,0,1,1
9795407,9795923,516,0,0,1,2
9795924,9795945,21,1,0,0,2
9795925,9795946,21,1,0,0,1
9795946,9796104,158,0,0,1,2
9795947,9796105,158,0,0,1,1
9796105,9796140,35,1,0,0,2
9796106,9796134,28,1,0,0,1
9796135,9796584,449,0,0,1,1
9796141,9796253,112,0,0,1,2
9796254,9796267,13,1,0,0,2
9796268,9796577,309,0,0,1,2
9796578,9796594,16,1,0,0,2
9796585,9796592,7,1,0,0,1
9796593,9796799,206,0,0,1,1
9796595,9796800,205,0,0,1,2
9796800,9796828,28,1,0,0,1
9796801,9796832,31,1,0,0,2
9796829,9797544,715,0,0,1,1
9796833,9797546,713,0,0,1,2
9797545,9797644,99,1,0,0,1
9797547,9797645,98,1,0,0,2
9797645,9797750,105,0,0,1,1
9797646,9797736,90,0,0,1,2
9797737,9803288,5551,1,0,0,2
9797751,9797842,91,1,0,0,1
9797843,9797910,67,0,0,1,1
9797911,9797945,34,1,0,0,1
9797946,9797981,35,0,0,1,1
9797982,9798942,960,1,0,0,1
9798005,9798268,263,0,1,0,2
9798025,9798416,391,0,1,0,1
9798361,9798864,503,0,1,0,2
9798671,9798842,171,0,1,0,1
9798916,9798951,35,0,1,0,2
9798943,9799071,128,0,0,1,1
9798985,9799034,49,0,1,0,2
9799055,9799068,13,0,1,0,2
9799072,9799076,4,1,0,0,1
9799077,9799277,200,0,0,1,1
9799191,9799248,57,0,1,0,2
9799278,9799340,62,1,0,0,1
9799341,9799466,125,0,0,1,1
9799467,9799645,178,1,0,0,1
9799535,9799565,30,0,1,0,2
9799605,9799643,38,0,1,0,2
9799646,9799686,40,0,0,1,1
9799687,9801475,1788,1,0,0,1
9799729,9800329,600,0,1,0,2
9799770,9800618,848,0,1,0,1
9800369,9800372,3,0,1,0,2
9800419,9800566,147,0,1,0,2
9801476,9801504,28,0,0,1,1
9801505,9801551,46,1,0,0,1
9801552,9801585,33,0,0,1,1
9801586,9801774,188,1,0,0,1
9801775,9801801,26,0,0,1,1
9801802,9802365,563,1,0,0,1
9802366,9802414,48,0,0,1,1
9802415,9803147,732,1,0,0,1
9802808,9803148,340,0,1,0,2
9802811,9803107,296,0,1,0,1
9803148,9803226,78,0,0,1,1
9803227,9803258,31,1,0,0,1
9803259,9803592,333,0,0,1,1
9803289,9803591,302,0,0,1,2
9803592,9803675,83,1,0,0,2
9803593,9803666,73,1,0,0,1
9803667,9804133,466,0,0,1,1
9803676,9804134,458,0,0,1,2
9804134,9804210,76,1,0,0,1
9804135,9804209,74,1,0,0,2
9804210,9804360,150,0,0,1,2
9804211,9804361,150,0,0,1,1
9804361,9804402,41,1,0,0,2
9804362,9804409,47,1,0,0,1
9804403,9804558,155,0,0,1,2
9804410,9804560,150,0,0,1,1
9804559,9804578,19,1,0,0,2
9804561,9804581,20,1,0,0,1
9804579,9805461,882,0,0,1,2
9804582,9805467,885,0,0,1,1
9805462,9805489,27,1,0,0,2
9805468,9805480,12,1,0,0,1
9805481,9806372,891,0,0,1,1
9805490,9806369,879,0,0,1,2
9806370,9806384,14,1,0,0,2
9806373,9806383,10,1,0,0,1
9806384,9806679,295,0,0,1,1
9806385,9806679,294,0,0,1,2
9806680,9806745,65,1,0,0,1
9806680,9806756,76,1,0,0,2
9806746,9806917,171,0,0,1,1
9806757,9806790,33,0,0,1,2
9806791,9806795,4,1,0,0,2
9806796,9806848,52,0,0,1,2
9806849,9808051,1202,1,0,0,2
9806918,9806937,19,1,0,0,1
9806938,9807102,164,0,0,1,1
9807103,9807115,12,1,0,0,1
9807116,9807537,421,0,0,1,1
9807538,9807557,19,1,0,0,1
9807558,9807785,227,0,0,1,1
9807786,9807808,22,1,0,0,1
9807809,9807964,155,0,0,1,1
9807965,9807975,10,1,0,0,1
9807976,9808881,905,0,0,1,1
9808052,9808116,64,0,0,1,2
9808117,9808139,22,1,0,0,2
9808140,9808160,20,0,0,1,2
9808161,9809367,1206,1,0,0,2
9808882,9809545,663,1,0,0,1
9808936,9808949,13,0,1,0,1
9808937,9808968,31,0,1,0,2
9808976,9809258,282,0,1,0,1
9809035,9809057,22,0,1,0,2
9809088,9809339,251,0,1,0,2
9809368,9809489,121,0,0,1,2
9809490,9812574,3084,1,0,0,2
9809546,9809741,195,0,0,1,1
9809742,9809762,20,1,0,0,1
9809763,9810076,313,0,0,1,1
9810077,9810130,53,1,0,0,1
9810131,9811075,944,0,0,1,1
9811076,9811085,9,1,0,0,1
9811086,9811290,204,0,0,1,1
9811291,9811301,10,1,0,0,1
9811302,9811479,177,0,0,1,1
9811480,9811507,27,1,0,0,1
9811508,9811657,149,0,0,1,1
9811658,9811679,21,1,0,0,1
9811680,9811866,186,0,0,1,1
9811867,9811891,24,1,0,0,1
9811892,9811962,70,0,0,1,1
9811963,9811978,15,1,0,0,1
9811979,9812048,69,0,0,1,1
9812049,9812069,20,1,0,0,1
9812070,9812504,434,0,0,1,1
9812505,9812588,83,1,0,0,1
9812575,9812604,29,0,0,1,2
9812589,9812610,21,0,0,1,1
9812605,9812634,29,1,0,0,2
9812611,9812618,7,1,0,0,1
9812619,9813218,599,0,0,1,1
9812635,9813230,595,0,0,1,2
9813219,9813504,285,1,0,0,1
9813231,9813528,297,1,0,0,2
9813269,9813444,175,0,1,0,2
9813287,9813443,156,0,1,0,1
9813505,9813878,373,0,0,1,1
9813529,9813872,343,0,0,1,2
9813873,9813893,20,1,0,0,2
9813879,9813883,4,1,0,0,1
9813884,9814283,399,0,0,1,1
9813894,9814279,385,0,0,1,2
9814280,9814300,20,1,0,0,2
9814284,9814299,15,1,0,0,1
9814300,9814696,396,0,0,1,1
9814301,9814696,395,0,0,1,2
9814697,9814767,70,1,0,0,1
9814697,9815654,957,1,0,0,2
9814768,9814896,128,0,0,1,1
9814897,9815392,495,1,0,0,1
9814924,9815440,516,0,1,0,2
9814933,9815360,427,0,1,0,1
9815393,9815428,35,0,0,1,1
9815429,9815477,48,1,0,0,1
9815478,9815585,107,0,0,1,1
9815586,9815652,66,1,0,0,1
9815653,9815771,118,0,0,1,1
9815655,9815695,40,0,0,1,2
9815696,9815707,11,1,0,0,2
9815708,9815767,59,0,0,1,2
9815768,9815850,82,1,0,0,2
9815772,9815821,49,1,0,0,1
9815822,9816082,260,0,0,1,1
9815851,9816083,232,0,0,1,2
9816083,9816115,32,1,0,0,1
9816084,9816133,49,1,0,0,2
9816116,9816276,160,0,0,1,1
9816134,9816274,140,0,0,1,2
9816275,9816302,27,1,0,0,2
9816277,9816306,29,1,0,0,1
9816303,9816433,130,0,0,1,2
9816307,9816433,126,0,0,1,1
9816434,9816512,78,1,0,0,1
9816434,9819307,2873,1,0,0,2
9816513,9816668,155,0,0,1,1
9816669,9816692,23,1,0,0,1
9816693,9816851,158,0,0,1,1
9816852,9816867,15,1,0,0,1
9816868,9816966,98,0,0,1,1
9816967,9820598,3631,1,0,0,1
9817045,9820502,3457,0,1,0,1
9818648,9818650,2,0,1,0,2
9818698,9818793,95,0,1,0,2
9818829,9818959,130,0,1,0,2
9819013,9819180,167,0,1,0,2
9819239,9819292,53,0,1,0,2
9819308,9819338,30,0,0,1,2
9819339,9819445,106,1,0,0,2
9819446,9819497,51,0,0,1,2
9819498,9820198,700,1,0,0,2
9820199,9820229,30,0,0,1,2
9820230,9823514,3284,1,0,0,2
9820272,9820290,18,0,1,0,2
9820313,9820399,86,0,1,0,2
9820469,9820519,50,0,1,0,2
9820599,9820722,123,0,0,1,1
9820723,9820791,68,1,0,0,1
9820792,9821275,483,0,0,1,1
9820801,9822004,1203,0,1,0,2
9821276,9821301,25,1,0,0,1
9821302,9821475,173,0,0,1,1
9821476,9821613,137,1,0,0,1
9821614,9821698,84,0,0,1,1
9821699,9821733,34,1,0,0,1
9821734,9821929,195,0,0,1,1
9821930,9821950,20,1,0,0,1
9821951,9822129,178,0,0,1,1
9822048,9822077,29,0,1,0,2
9822130,9822150,20,1,0,0,1
9822135,9823031,896,0,1,0,2
9822151,9822292,141,0,0,1,1
9822293,9822322,29,1,0,0,1
9822323,9822483,160,0,0,1,1
9822484,9822580,96,1,0,0,1
9822581,9822601,20,0,0,1,1
9822602,9822631,29,1,0,0,1
9822632,9822813,181,0,0,1,1
9822824,9822925,101,0,1,0,1
9822935,9823516,581,1,0,0,1
9822969,9823385,416,0,1,0,1
9823078,9823287,209,0,1,0,2
9823318,9823441,123,0,1,0,2
9823515,9823611,96,0,0,1,2
9823517,9823639,122,0,0,1,1
9823612,9823708,96,1,0,0,2
9823640,9823677,37,1,0,0,1
9823678,9823882,204,0,0,1,1
9823709,9823780,71,0,0,1,2
9823781,9823835,54,1,0,0,2
9823836,9823881,45,0,0,1,2
9823882,9823910,28,1,0,0,2
9823883,9823919,36,1,0,0,1
9823911,9823949,38,0,0,1,2
9823920,9824038,118,0,0,1,1
9823950,9823971,21,1,0,0,2
9823972,9824037,65,0,0,1,2
9824038,9824133,95,1,0,0,2
9824039,9824124,85,1,0,0,1
9824125,9824224,99,0,0,1,1
9824134,9824205,71,0,0,1,2
9824206,9824653,447,1,0,0,2
9824225,9824288,63,1,0,0,1
9824289,9824309,20,0,0,1,1
9824310,9824334,24,1,0,0,1
9824335,9824368,33,0,0,1,1
9824369,9824473,104,1,0,0,1
9824434,9824436,2,0,1,0,2
9824473,9824478,5,0,1,0,2
9824474,9824618,144,0,0,1,1
9824619,9824640,21,1,0,0,1
9824641,9824879,238,0,0,1,1
9824654,9824881,227,0,0,1,2
9824880,9824896,16,1,0,0,1
9824882,9824897,15,1,0,0,2
9824897,9826331,1434,0,0,1,1
9824898,9826107,1209,0,0,1,2
9826108,9826121,13,1,0,0,2
9826122,9826142,20,0,0,1,2
9826143,9826862,719,1,0,0,2
9826332,9826350,18,1,0,0,1
9826351,9826725,374,0,0,1,1
9826726,9826787,61,1,0,0,1
9826788,9826936,148,0,0,1,1
9826863,9826936,73,0,0,1,2
9826937,9826967,30,1,0,0,2
9826937,9826975,38,1,0,0,1
9826968,9827044,76,0,0,1,2
9826976,9827566,590,0,0,1,1
9827045,9827221,176,1,0,0,2
9827222,9827566,344,0,0,1,2
9827567,9827583,16,1,0,0,1
9827567,9827584,17,1,0,0,2
9827584,9829764,2180,0,0,1,1
9827585,9827847,262,0,0,1,2
9827848,9828054,206,1,0,0,2
9828055,9828127,72,0,0,1,2
9828128,9828631,503,1,0,0,2
9828632,9828656,24,0,0,1,2
9828657,9828868,211,1,0,0,2
9828869,9828917,48,0,0,1,2
9828918,9833781,4863,1,0,0,2
9829765,9829799,34,1,0,0,1
9829800,9830004,204,0,0,1,1
9830005,9830029,24,1,0,0,1
9830030,9830203,173,0,0,1,1
9830204,9830234,30,1,0,0,1
9830235,9830275,40,0,0,1,1
9830276,9830318,42,1,0,0,1
9830319,9830554,235,0,0,1,1
9830555,9830640,85,1,0,0,1
9830641,9830745,104,0,0,1,1
9830745,9831221,476,0,1,0,2
9830746,9830752,6,1,0,0,1
9830753,9830789,36,0,0,1,1
9830790,9831429,639,1,0,0,1
9830930,9831161,231,0,1,0,1
9831183,9831399,216,0,1,0,1
9831267,9831750,483,0,1,0,2
9831430,9831513,83,0,0,1,1
9831514,9831526,12,1,0,0,1
9831527,9831564,37,0,0,1,1
9831565,9831606,41,1,0,0,1
9831607,9832555,948,0,0,1,1
9832406,9832407,1,0,1,0,2
9832478,9832568,90,0,1,0,2
9832556,9832562,6,1,0,0,1
9832563,9832780,217,0,0,1,1
9832597,9832718,121,0,1,0,2
9832743,9832824,81,0,1,0,2
9832781,9832797,16,1,0,0,1
9832798,9833024,226,0,0,1,1
9832957,9832964,7,0,1,0,2
9833011,9833310,299,0,1,0,2
9833025,9833068,43,1,0,0,1
9833069,9833227,158,0,0,1,1
9833228,9833257,29,1,0,0,1
9833258,9833614,356,0,0,1,1
9833615,9833637,22,1,0,0,1
9833638,9833861,223,0,0,1,1
9833782,9833802,20,0,0,1,2
9833803,9835915,2112,1,0,0,2
9833862,9833880,18,1,0,0,1
9833881,9834066,185,0,0,1,1
9834067,9834097,30,1,0,0,1
9834091,9835457,1366,0,1,0,2
9834098,9834242,144,0,0,1,1
9834243,9834258,15,1,0,0,1
9834259,9834400,141,0,0,1,1
9834401,9834417,16,1,0,0,1
9834418,9834540,122,0,0,1,1
9834541,9834560,19,1,0,0,1
9834561,9834682,121,0,0,1,1
9834683,9834701,18,1,0,0,1
9834702,9834833,131,0,0,1,1
9834834,9834844,10,1,0,0,1
9834845,9835142,297,0,0,1,1
9835143,9835778,635,1,0,0,1
9835238,9835674,436,0,1,0,1
9835507,9835754,247,0,1,0,2
9835779,9835871,92,0,0,1,1
9835872,9835929,57,1,0,0,1
9835916,9836015,99,0,0,1,2
9835930,9836013,83,0,0,1,1
9836014,9836042,28,1,0,0,1
9836016,9836074,58,1,0,0,2
9836043,9836439,396,0,0,1,1
9836075,9836200,125,0,0,1,2
9836201,9836215,14,1,0,0,2
9836216,9836439,223,0,0,1,2
9836440,9836504,64,1,0,0,1
9836440,9836516,76,1,0,0,2
9836505,9836616,111,0,0,1,1
9836517,9836616,99,0,0,1,2
9836617,9836715,98,1,0,0,1
9836617,9841441,4824,1,0,0,2
9836716,9836765,49,0,0,1,1
9836766,9836923,157,1,0,0,1
9836924,9837229,305,0,0,1,1
9837230,9837249,19,1,0,0,1
9837250,9837420,170,0,0,1,1
9837421,9837428,7,1,0,0,1
9837429,9837602,173,0,0,1,1
9837603,9837643,40,1,0,0,1
9837644,9838120,476,0,0,1,1
9838121,9838493,372,1,0,0,1
9838133,9838139,6,0,1,0,1
9838147,9838441,294,0,1,0,2
9838179,9838243,64,0,1,0,1
9838494,9838580,86,0,0,1,1
9838581,9838629,48,1,0,0,1
9838630,9838871,241,0,0,1,1
9838641,9838680,39,0,1,0,2
9838704,9838882,178,0,1,0,2
9838872,9838895,23,1,0,0,1
9838896,9839408,512,0,0,1,1
9838972,9839437,465,0,1,0,2
9839409,9839433,24,1,0,0,1
9839434,9839659,225,0,0,1,1
9839538,9839561,23,0,1,0,2
9839655,9839837,182,0,1,0,2
9839660,9839685,25,1,0,0,1
9839686,9839860,174,0,0,1,1
9839860,9840478,618,0,1,0,2
9839861,9839894,33,1,0,0,1
9839895,9840038,143,0,0,1,1
9840039,9840072,33,1,0,0,1
9840073,9840123,50,0,0,1,1
9840124,9841363,1239,1,0,0,1
9840185,9841097,912,0,1,0,1
9840537,9840553,16,0,1,0,2
9840697,9840727,30,0,1,0,2
9840761,9840868,107,0,1,0,2
9840937,9840940,3,0,1,0,2
9841024,9841024,0,0,1,0,2
9841062,9841319,257,0,1,0,2
9841131,9841273,142,0,1,0,1
9841364,9841818,454,0,0,1,1
9841442,9841773,331,0,0,1,2
9841774,9841778,4,1,0,0,2
9841779,9841818,39,0,0,1,2
9841819,9841862,43,1,0,0,1
9841819,9841879,60,1,0,0,2
9841863,9841998,135,0,0,1,1
9841880,9842000,120,0,0,1,2
9841999,9842054,55,1,0,0,1
9842001,9842052,51,1,0,0,2
9842053,9842283,230,0,0,1,2
9842055,9842284,229,0,0,1,1
9842284,9842302,18,1,0,0,2
9842285,9842308,23,1,0,0,1
9842303,9842444,141,0,0,1,2
9842309,9842445,136,0,0,1,1
9842445,9842503,58,1,0,0,2
9842446,9842505,59,1,0,0,1
9842504,9842657,153,0,0,1,2
9842506,9842657,151,0,0,1,1
9842658,9842678,20,1,0,0,1
9842658,9842690,32,1,0,0,2
9842679,9842870,191,0,0,1,1
9842691,9842869,178,0,0,1,2
9842870,9842887,17,1,0,0,2
9842871,9842886,15,1,0,0,1
9842887,9843061,174,0,0,1,1
9842888,9843061,173,0,0,1,2
9843062,9843079,17,1,0,0,1
9843062,9843082,20,1,0,0,2
9843080,9843712,632,0,0,1,1
9843083,9843711,628,0,0,1,2
9843712,9843730,18,1,0,0,2
9843713,9843728,15,1,0,0,1
9843729,9843888,159,0,0,1,1
9843731,9843884,153,0,0,1,2
9843885,9843905,20,1,0,0,2
9843889,9843903,14,1,0,0,1
9843904,9844547,643,0,0,1,1
9843906,9844094,188,0,0,1,2
9844095,9844106,11,1,0,0,2
9844107,9844544,437,0,0,1,2
9844545,9844565,20,1,0,0,2
9844548,9844563,15,1,0,0,1
9844564,9844714,150,0,0,1,1
9844566,9844711,145,0,0,1,2
9844712,9844749,37,1,0,0,2
9844715,9844720,5,1,0,0,1
9844721,9844976,255,0,0,1,1
9844750,9844973,223,0,0,1,2
9844974,9845021,47,1,0,0,2
9844977,9845025,48,1,0,0,1
9845022,9845477,455,0,0,1,2
9845026,9845493,467,0,0,1,1
9845478,9845953,475,1,0,0,2
9845494,9845810,316,1,0,0,1
9845530,9845703,173,0,1,0,1
9845531,9845718,187,0,1,0,2
9845725,9845729,4,0,1,0,1
9845811,9845863,52,0,0,1,1
9845864,9845879,15,1,0,0,1
9845880,9846069,189,0,0,1,1
9845954,9846063,109,0,0,1,2
9846064,9846089,25,1,0,0,2
9846070,9846093,23,1,0,0,1
9846090,9846306,216,0,0,1,2
9846094,9846310,216,0,0,1,1
9846307,9846331,24,1,0,0,2
9846311,9846327,16,1,0,0,1
9846328,9847034,706,0,0,1,1
9846332,9847033,701,0,0,1,2
9847034,9847061,27,1,0,0,2
9847035,9847043,8,1,0,0,1
9847044,9847200,156,0,0,1,1
9847062,9847170,108,0,0,1,2
9847171,9847215,44,1,0,0,2
9847201,9847228,27,1,0,0,1
9847216,9847314,98,0,0,1,2
9847229,9847380,151,0,0,1,1
9847315,9848220,905,1,0,0,2
9847381,9847386,5,1,0,0,1
9847387,9847471,84,0,0,1,1
9847472,9847972,500,1,0,0,1
9847560,9847752,192,0,1,0,1
9847574,9847760,186,0,1,0,2
9847785,9847791,6,0,1,0,1
9847973,9848111,138,0,0,1,1
9848112,9848153,41,1,0,0,1
9848154,9848408,254,0,0,1,1
9848221,9848274,53,0,0,1,2
9848275,9848283,8,1,0,0,2
9848284,9848316,32,0,0,1,2
9848317,9848321,4,1,0,0,2
9848322,9848406,84,0,0,1,2
9848407,9852867,4460,1,0,0,2
9848409,9848503,94,1,0,0,1
9848504,9848608,104,0,0,1,1
9848609,9848677,68,1,0,0,1
9848678,9848771,93,0,0,1,1
9848772,9849194,422,1,0,0,1
9848799,9849005,206,0,1,0,2
9848803,9849068,265,0,1,0,1
9849036,9849160,124,0,1,0,2
9849109,9849126,17,0,1,0,1
9849195,9849262,67,0,0,1,1
9849263,9849293,30,1,0,0,1
9849294,9849438,144,0,0,1,1
9849439,9849456,17,1,0,0,1
9849457,9849647,190,0,0,1,1
9849648,9849697,49,1,0,0,1
9849698,9849850,152,0,0,1,1
9849851,9849865,14,1,0,0,1
9849866,9850037,171,0,0,1,1
9850038,9850083,45,1,0,0,1
9850084,9850126,42,0,0,1,1
9850127,9850163,36,1,0,0,1
9850164,9850278,114,0,0,1,1
9850184,9850453,269,0,1,0,2
9850279,9850382,103,1,0,0,1
9850383,9850632,249,0,0,1,1
9850633,9850677,44,1,0,0,1
9850638,9850915,277,0,1,0,2
9850678,9850724,46,0,0,1,1
9850725,9850884,159,1,0,0,1
9850885,9850932,47,0,0,1,1
9850933,9850961,28,1,0,0,1
9850962,9851047,85,0,0,1,1
9851048,9851123,75,1,0,0,1
9851124,9851357,233,0,0,1,1
9851358,9851362,4,1,0,0,1
9851363,9851514,151,0,0,1,1
9851515,9851570,55,1,0,0,1
9851571,9851771,200,0,0,1,1
9851772,9851803,31,1,0,0,1
9851804,9852706,902,0,0,1,1
9852707,9852728,21,1,0,0,1
9852729,9852829,100,0,0,1,1
9852830,9852834,4,1,0,0,1
9852835,9853719,884,0,0,1,1
9852868,9853055,187,0,0,1,2
9853056,9853244,188,1,0,0,2
9853245,9853420,175,0,0,1,2
9853421,9853601,180,1,0,0,2
9853602,9853624,22,0,0,1,2
9853625,9854250,625,1,0,0,2
9853720,9854133,413,1,0,0,1
9853743,9854070,327,0,1,0,2
9853757,9853994,237,0,1,0,1
9854031,9854042,11,0,1,0,1
9854134,9854200,66,0,0,1,1
9854201,9854242,41,1,0,0,1
9854243,9854376,133,0,0,1,1
9854251,9854308,57,0,0,1,2
9854309,9854340,31,1,0,0,2
9854341,9854373,32,0,0,1,2
9854374,9854414,40,1,0,0,2
9854377,9854419,42,1,0,0,1
9854415,9854611,196,0,0,1,2
9854420,9854610,190,0,0,1,1
9854611,9854658,47,1,0,0,1
9854612,9854659,47,1,0,0,2
9854659,9854801,142,0,0,1,1
9854660,9854799,139,0,0,1,2
9854800,9854957,157,1,0,0,2
9854802,9854959,157,1,0,0,1
9854958,9855016,58,0,0,1,2
9854960,9855018,58,0,0,1,1
9855017,9855027,10,1,0,0,2
9855019,9855032,13,1,0,0,1
9855028,9855213,185,0,0,1,2
9855033,9855210,177,0,0,1,1
9855211,9855245,34,1,0,0,1
9855214,9855242,28,1,0,0,2
9855243,9855373,130,0,0,1,2
9855246,9855385,139,0,0,1,1
9855374,9855822,448,1,0,0,2
9855386,9855768,382,1,0,0,1
9855434,9855657,223,0,1,0,1
9855438,9855660,222,0,1,0,2
9855691,9855693,2,0,1,0,1
9855769,9855903,134,0,0,1,1
9855823,9855908,85,0,0,1,2
9855904,9855973,69,1,0,0,1
9855909,9856489,580,1,0,0,2
9855974,9856110,136,0,0,1,1
9856111,9856147,36,1,0,0,1
9856148,9856302,154,0,0,1,1
9856218,9856324,106,0,1,0,2
9856303,9856343,40,1,0,0,1
9856344,9856799,455,0,0,1,1
9856490,9856551,61,0,0,1,2
9856552,9858051,1499,1,0,0,2
9856766,9857358,592,0,1,0,2
9856800,9856804,4,1,0,0,1
9856805,9857776,971,0,0,1,1
9857417,9857752,335,0,1,0,2
9857777,9857911,134,1,0,0,1
9857787,9857808,21,0,1,0,2
9857912,9857943,31,0,0,1,1
9857944,9857992,48,1,0,0,1
9857993,9858116,123,0,0,1,1
9858052,9858117,65,0,0,1,2
9858117,9858160,43,1,0,0,1
9858118,9858190,72,1,0,0,2
9858161,9860010,1849,0,0,1,1
9858191,9858283,92,0,0,1,2
9858284,9858290,6,1,0,0,2
9858291,9858964,673,0,0,1,2
9858965,9858969,4,1,0,0,2
9858970,9860009,1039,0,0,1,2
9860010,9860030,20,1,0,0,2
9860011,9860029,18,1,0,0,1
9860030,9860191,161,0,0,1,1
9860031,9860192,161,0,0,1,2
9860192,9860216,24,1,0,0,1
9860193,9860216,23,1,0,0,2
9860217,9860396,179,0,0,1,2
9860217,9860407,190,0,0,1,1
9860397,9860437,40,1,0,0,2
9860408,9860444,36,1,0,0,1
9860438,9860554,116,0,0,1,2
9860445,9860584,139,0,0,1,1
9860555,9860561,6,1,0,0,2
9860562,9860583,21,0,0,1,2
9860584,9860711,127,1,0,0,2
9860585,9860633,48,1,0,0,1
9860634,9860751,117,0,0,1,1
9860712,9860736,24,0,0,1,2
9860737,9861164,427,1,0,0,2
9860752,9860779,27,1,0,0,1
9860780,9860973,193,0,0,1,1
9860974,9861057,83,1,0,0,1
9861058,9861223,165,0,0,1,1
9861165,9861188,23,0,0,1,2
9861189,9861318,129,1,0,0,2
9861224,9861314,90,1,0,0,1
9861315,9861461,146,0,0,1,1
9861319,9861461,142,0,0,1,2
9861462,9861474,12,1,0,0,2
9861462,9861482,20,1,0,0,1
9861475,9861514,39,0,0,1,2
9861483,9861520,37,0,0,1,1
9861515,9861770,255,1,0,0,2
9861521,9861746,225,1,0,0,1
9861542,9861673,131,0,1,0,2
9861543,9861673,130,0,1,0,1
9861747,9862072,325,0,0,1,1
9861771,9862075,304,0,0,1,2
9862073,9862093,20,1,0,0,1
9862076,9862093,17,1,0,0,2
9862094,9862258,164,0,0,1,2
9862094,9862259,165,0,0,1,1
9862259,9862278,19,1,0,0,2
9862260,9862277,17,1,0,0,1
9862278,9862803,525,0,0,1,1
9862279,9862799,520,0,0,1,2
9862800,9862825,25,1,0,0,2
9862804,9862814,10,1,0,0,1
9862815,9863032,217,0,0,1,1
9862826,9863028,202,0,0,1,2
9863029,9863051,22,1,0,0,2
9863033,9863048,15,1,0,0,1
9863049,9863998,949,0,0,1,1
9863052,9863997,945,0,0,1,2
9863998,9864066,68,1,0,0,2
9863999,9864051,52,1,0,0,1
9864052,9864213,161,0,0,1,1
9864067,9864212,145,0,0,1,2
9864213,9864239,26,1,0,0,2
9864214,9864241,27,1,0,0,1
9864240,9866222,1982,0,0,1,2
9864242,9866219,1977,0,0,1,1
9866220,9867083,863,1,0,0,1
9866223,9867749,1526,1,0,0,2
9866316,9866820,504,0,1,0,2
9866342,9866735,393,0,1,0,1
9866818,9866885,67,0,1,0,1
9867084,9867247,163,0,0,1,1
9867248,9867281,33,1,0,0,1
9867282,9867421,139,0,0,1,1
9867422,9867466,44,1,0,0,1
9867467,9867641,174,0,0,1,1
9867642,9867677,35,1,0,0,1
9867678,9867890,212,0,0,1,1
9867750,9867890,140,0,0,1,2
9867891,9867921,30,1,0,0,1
9867891,9867939,48,1,0,0,2
9867922,9868118,196,0,0,1,1
9867940,9868118,178,0,0,1,2
9868119,9868142,23,1,0,0,1
9868119,9868149,30,1,0,0,2
9868143,9868312,169,0,0,1,1
9868150,9868311,161,0,0,1,2
9868312,9868342,30,1,0,0,2
9868313,9868340,27,1,0,0,1
9868341,9868616,275,0,0,1,1
9868343,9868615,272,0,0,1,2
9868616,9868661,45,1,0,0,2
9868617,9868650,33,1,0,0,1
9868651,9868963,312,0,0,1,1
9868662,9868962,300,0,0,1,2
9868963,9869003,40,1,0,0,2
9868964,9869003,39,1,0,0,1
9869004,9869205,201,0,0,1,2
9869004,9869206,202,0,0,1,1
9869206,9869233,27,1,0,0,2
9869207,9869232,25,1,0,0,1
9869233,9869475,242,0,0,1,1
9869234,9869474,240,0,0,1,2
9869475,9869508,33,1,0,0,2
9869476,9869505,29,1,0,0,1
9869506,9869769,263,0,0,1,1
9869509,9869769,260,0,0,1,2
9869770,9869795,25,1,0,0,2
9869770,9869796,26,1,0,0,1
9869796,9869968,172,0,0,1,2
9869797,9869968,171,0,0,1,1
9869969,9870007,38,1,0,0,1
9869969,9870026,57,1,0,0,2
9870008,9870239,231,0,0,1,1
9870027,9870237,210,0,0,1,2
9870238,9870270,32,1,0,0,2
9870240,9870272,32,1,0,0,1
9870271,9870316,45,0,0,1,2
9870273,9870327,54,0,0,1,1
9870317,9870652,335,1,0,0,2
9870328,9870607,279,1,0,0,1
9870360,9870543,183,0,1,0,2
9870370,9870552,182,0,1,0,1
9870608,9870744,136,0,0,1,1
9870653,9870744,91,0,0,1,2
9870745,9870765,20,1,0,0,1
9870745,9870769,24,1,0,0,2
9870766,9871001,235,0,0,1,1
9870770,9871001,231,0,0,1,2
9871002,9871032,30,1,0,0,2
9871002,9871034,32,1,0,0,1
9871033,9871299,266,0,0,1,2
9871035,9871353,318,0,0,1,1
9871300,9872039,739,1,0,0,2
9871354,9871899,545,1,0,0,1
9871402,9871790,388,0,1,0,2
9871411,9871822,411,0,1,0,1
9871900,9871936,36,0,0,1,1
9871937,9871976,39,1,0,0,1
9871977,9872178,201,0,0,1,1
9872040,9872082,42,0,0,1,2
9872083,9872107,24,1,0,0,2
9872108,9872178,70,0,0,1,2
9872179,9872208,29,1,0,0,1
9872179,9872232,53,1,0,0,2
9872209,9872487,278,0,0,1,1
9872233,9872484,251,0,0,1,2
9872485,9872521,36,1,0,0,2
9872488,9872515,27,1,0,0,1
9872516,9872810,294,0,0,1,1
9872522,9872809,287,0,0,1,2
9872810,9872838,28,1,0,0,2
9872811,9872841,30,1,0,0,1
9872839,9873011,172,0,0,1,2
9872842,9873032,190,0,0,1,1
9873012,9873864,852,1,0,0,2
9873033,9873746,713,1,0,0,1
9873067,9873683,616,0,1,0,1
9873068,9873729,661,0,1,0,2
9873747,9873774,27,0,0,1,1
9873775,9873861,86,1,0,0,1
9873862,9874001,139,0,0,1,1
9873865,9874007,142,0,0,1,2
9874002,9874013,11,1,0,0,1
9874008,9874375,367,1,0,0,2
9874014,9874057,43,0,0,1,1
9874058,9874304,246,1,0,0,1
9874090,9874253,163,0,1,0,1
9874092,9874176,84,0,1,0,2
9874201,9874276,75,0,1,0,2
9874305,9874511,206,0,0,1,1
9874376,9874511,135,0,0,1,2
9990453,9990557,104,0,0,1,2
9990453,9990558,105,0,0,1,1
9990558,9990611,53,1,0,0,2
9990559,9990747,188,1,0,0,1
9990612,9990703,91,0,0,1,2
9990704,9990743,39,1,0,0,2
9990744,9990874,130,0,0,1,2
9990748,9990882,134,0,0,1,1
9990875,9990895,20,1,0,0,2
9990883,9990918,35,1,0,0,1
9990896,9991066,170,0,0,1,2
9990919,9991505,586,0,0,1,1
9991067,9991076,9,1,0,0,2
9991077,9993852,2775,0,0,1,2
9991506,9991520,14,1,0,0,1
9991521,9991744,223,0,0,1,1
9991745,9991783,38,1,0,0,1
9991784,9992322,538,0,0,1,1
9992323,9992419,96,1,0,0,1
9992420,9992590,170,0,0,1,1
9992591,9992607,16,1,0,0,1
9992608,9992665,57,0,0,1,1
9992666,9992896,230,1,0,0,1
9992897,9992939,42,0,0,1,1
9992940,9992993,53,1,0,0,1
9992994,9993199,205,0,0,1,1
9993200,9993318,118,1,0,0,1
9993319,9993377,58,0,0,1,1
9993378,9993398,20,1,0,0,1
9993399,9993556,157,0,0,1,1
9993557,9993579,22,1,0,0,1
9993580,9993672,92,0,0,1,1
9993673,9993784,111,1,0,0,1
9993785,9993845,60,0,0,1,1
9993846,9993854,8,1,0,0,1
9993853,9993857,4,1,0,0,2
9993855,9995430,1575,0,0,1,1
9993858,9996043,2185,0,0,1,2
9995431,9995443,12,1,0,0,1
9995444,9995984,540,0,0,1,1
9995985,9996212,227,1,0,0,1
9996044,9996144,100,1,0,0,2
9996145,9996261,116,0,0,1,2
9996213,9996266,53,0,0,1,1
9996262,9996300,38,1,0,0,2
9996267,9996442,175,1,0,0,1
9996301,9996578,277,0,0,1,2
9996443,9996577,134,0,0,1,1
9996578,9996595,17,1,0,0,1
9996579,9996588,9,1,0,0,2
9996589,9997214,625,0,0,1,2
9996596,9996719,123,0,0,1,1
9996720,9996786,66,1,0,0,1
9996787,9997138,351,0,0,1,1
9997139,9997165,26,1,0,0,1
9997166,9997205,39,0,0,1,1
9997206,9997266,60,1,0,0,1
9997215,9997224,9,1,0,0,2
9997225,9999272,2047,0,0,1,2
9997267,9997642,375,0,0,1,1
9997643,9997663,20,1,0,0,1
9997664,9997886,222,0,0,1,1
9997887,9997908,21,1,0,0,1
9997909,9999271,1362,0,0,1,1
9999272,9999340,68,1,0,0,1
9999273,9999310,37,1,0,0,2
9999311,9999439,128,0,0,1,2
9999341,9999432,91,0,0,1,1
9999433,9999467,34,1,0,0,1
9999440,9999454,14,1,0,0,2
9999455,9999997,542,0,0,1,2
9999468,9999681,213,0,0,1,1
9999682,9999698,16,1,0,0,1
9999699,9999990,291,0,0,1,1
9999991,10000025,34,1,0,0,1
9999998,10000006,8,1,0,0,2
10000007,10001389,1382,0,0,1,2
10000026,10001173,1147,0,0,1,1
10001174,10001228,54,1,0,0,1
10001229,10001387,158,0,0,1,1
10001388,10001426,38,1,0,0,1
10001390,10001429,39,1,0,0,2
10001427,10001627,200,0,0,1,1
10001430,10001786,356,0,0,1,2
10001628,10001665,37,1,0,0,1
10001666,10001786,120,0,0,1,1
10001787,10001865,78,1,0,0,2
10001787,10001884,97,1,0,0,1
10001866,10001979,113,0,0,1,2
10001885,10001979,94,0,0,1,1
10001980,10002011,31,1,0,0,2
10001980,10002023,43,1,0,0,1
10002012,10002219,207,0,0,1,2
10002024,10002219,195,0,0,1,1
10002220,10002235,15,1,0,0,2
10002220,10002283,63,1,0,0,1
10002236,10002506,270,0,0,1,2
10002284,10002505,221,0,0,1,1
10002506,10002523,17,1,0,0,1
10002507,10002522,15,1,0,0,2
10002523,10002718,195,0,0,1,2
10002524,10002718,194,0,0,1,1
10002719,10002734,15,1,0,0,1
10002719,10002735,16,1,0,0,2
10002735,10004630,1895,0,0,1,1
10002736,10004630,1894,0,0,1,2
10004631,10004676,45,1,0,0,2
10004631,10004685,54,1,0,0,1
10004677,10004773,96,0,0,1,2
10004686,10004773,87,0,0,1,1
10004774,10004806,32,1,0,0,2
10004774,10004811,37,1,0,0,1
10004807,10007235,2428,0,0,1,2
10004812,10007248,2436,0,0,1,1
10007236,10007305,69,1,0,0,2
10007249,10007509,260,1,0,0,1
10007306,10007454,148,0,0,1,2
10007455,10007489,34,1,0,0,2
10007490,10007726,236,0,0,1,2
10007510,10007533,23,0,0,1,1
10007534,10007602,68,1,0,0,1
10007603,10007652,49,0,0,1,1
10007653,10008201,548,1,0,0,1
10007727,10007743,16,1,0,0,2
10007744,10008091,347,0,0,1,2
10008092,10008099,7,1,0,0,2
10008100,10009780,1680,0,0,1,2
10008202,10008244,42,0,0,1,1
10008245,10008337,92,1,0,0,1
10008338,10008372,34,0,0,1,1
10008373,10008557,184,1,0,0,1
10008558,10008589,31,0,0,1,1
10008590,10008621,31,1,0,0,1
10008622,10008658,36,0,0,1,1
10008659,10009834,1175,1,0,0,1
10009781,10009829,48,1,0,0,2
10009830,10009944,114,0,0,1,2
10009835,10009946,111,0,0,1,1
10009945,10009983,38,1,0,0,2
10009947,10010003,56,1,0,0,1
10009984,10012089,2105,0,0,1,2
10010004,10010290,286,0,0,1,1
10010291,10010307,16,1,0,0,1
10010308,10010915,607,0,0,1,1
10010916,10010929,13,1,0,0,1
10010930,10012090,1160,0,0,1,1
10012090,10012185,95,1,0,0,2
10012091,10012184,93,1,0,0,1
10012185,10012295,110,0,0,1,1
10012186,10012296,110,0,0,1,2
10012296,10012331,35,1,0,0,1
10012297,10012356,59,1,0,0,2
10012332,10012541,209,0,0,1,1
10012357,10012426,69,0,0,1,2
10012427,10012456,29,1,0,0,2
10012457,10012548,91,0,0,1,2
10012542,10012584,42,1,0,0,1
10012549,10012752,203,1,0,0,2
10012585,10012819,234,0,0,1,1
10012753,10012835,82,0,0,1,2
10012820,10012850,30,1,0,0,1
10012836,10012910,74,1,0,0,2
10012851,10014317,1466,0,0,1,1
10012911,10013336,425,0,0,1,2
10013337,10013354,17,1,0,0,2
10013355,10013503,148,0,0,1,2
10013504,10014823,1319,1,0,0,2
10014318,10014332,14,1,0,0,1
10014333,10014543,210,0,0,1,1
10014544,10014600,56,1,0,0,1
10014601,10014632,31,0,0,1,1
10014633,10014804,171,1,0,0,1
10014670,10014745,75,0,1,0,2
10014805,10015014,209,0,0,1,1
10014824,10015012,188,0,0,1,2
10015013,10015036,23,1,0,0,2
10015015,10015045,30,1,0,0,1
10015037,10015211,174,0,0,1,2
10015046,10015207,161,0,0,1,1
10015208,10015223,15,1,0,0,1
10015212,10015223,11,1,0,0,2
10015224,10015414,190,0,0,1,2
10015224,10015415,191,0,0,1,1
10015415,10015433,18,1,0,0,2
10015416,10015433,17,1,0,0,1
10015434,10015729,295,0,0,1,2
10015434,10015730,296,0,0,1,1
10015730,10015749,19,1,0,0,2
10015731,10015744,13,1,0,0,1
10015745,10015922,177,0,0,1,1
10015750,10015921,171,0,0,1,2
10015922,10015946,24,1,0,0,2
10015923,10015949,26,1,0,0,1
10015947,10016269,322,0,0,1,2
10015950,10016272,322,0,0,1,1
10016270,10016282,12,1,0,0,2
10016273,10016283,10,1,0,0,1
10016283,10017927,1644,0,0,1,2
10016284,10017919,1635,0,0,1,1
10017920,10018337,417,1,0,0,1
10017928,10021479,3551,1,0,0,2
10018338,10018446,108,0,0,1,1
10018447,10018542,95,1,0,0,1
10018543,10018708,165,0,0,1,1
10018709,10018905,196,1,0,0,1
10018906,10019007,101,0,0,1,1
10019008,10021473,2465,1,0,0,1
10021474,10021516,42,0,0,1,1
10021480,10021518,38,0,0,1,2
10021517,10021602,85,1,0,0,1
10021519,10021590,71,1,0,0,2
10021591,10021766,175,0,0,1,2
10021603,10021769,166,0,0,1,1
10021767,10021794,27,1,0,0,2
10021770,10021790,20,1,0,0,1
10021791,10022010,219,0,0,1,1
10021795,10022009,214,0,0,1,2
10022010,10022034,24,1,0,0,2
10022011,10022031,20,1,0,0,1
10022032,10022236,204,0,0,1,1
10022035,10022236,201,0,0,1,2
10022237,10022259,22,1,0,0,2
10022237,10022263,26,1,0,0,1
10022260,10022512,252,0,0,1,2
10022264,10022511,247,0,0,1,1
10022512,10022532,20,1,0,0,1
10022513,10022533,20,1,0,0,2
10022533,10023131,598,0,0,1,1
10022534,10022737,203,0,0,1,2
10022738,10022751,13,1,0,0,2
10022752,10023128,376,0,0,1,2
10023129,10023152,23,1,0,0,2
10023132,10023157,25,1,0,0,1
10023153,10023307,154,0,0,1,2
10023158,10023305,147,0,0,1,1
10023306,10023333,27,1,0,0,1
10023308,10023323,15,1,0,0,2
10023324,10024707,1383,0,0,1,2
10023334,10024701,1367,0,0,1,1
10024702,10024856,154,1,0,0,1
10024708,10024765,57,1,0,0,2
10024766,10024876,110,0,0,1,2
10024857,10024893,36,0,0,1,1
10024877,10025466,589,1,0,0,2
10024894,10025321,427,1,0,0,1
10025007,10025035,28,0,1,0,2
10025322,10025363,41,0,0,1,1
10025364,10025521,157,1,0,0,1
10025467,10025601,134,0,0,1,2
10025522,10025572,50,0,0,1,1
10025573,10025646,73,1,0,0,1
10025602,10025611,9,1,0,0,2
10025612,10025716,104,0,0,1,2
10025647,10025730,83,0,0,1,1
10025717,10025957,240,1,0,0,2
10025731,10025747,16,1,0,0,1
10025748,10025785,37,0,0,1,1
10025786,10025818,32,1,0,0,1
10025819,10025903,84,0,0,1,1
10025904,10026246,342,1,0,0,1
10025958,10026261,303,0,0,1,2
10026247,10026305,58,0,0,1,1
10026262,10026299,37,1,0,0,2
10026300,10026422,122,0,0,1,2
10026306,10026414,108,1,0,0,1
10026415,10026505,90,0,0,1,1
10026423,10026517,94,1,0,0,2
10026506,10026707,201,1,0,0,1
10026518,10026588,70,0,0,1,2
10026589,10027322,733,1,0,0,2
10026708,10026798,90,0,0,1,1
10026799,10027784,985,1,0,0,1
10027323,10027520,197,0,0,1,2
10027521,10027584,63,1,0,0,2
10027585,10027745,160,0,0,1,2
10027746,10027757,11,1,0,0,2
10027758,10029763,2005,0,0,1,2
10027785,10027832,47,0,0,1,1
10027833,10027893,60,1,0,0,1
10027894,10027941,47,0,0,1,1
10027942,10028001,59,1,0,0,1
10028002,10028050,48,0,0,1,1
10028051,10028515,464,1,0,0,1
10028516,10028592,76,0,0,1,1
10028593,10028724,131,1,0,0,1
10028725,10028865,140,0,0,1,1
10028866,10028901,35,1,0,0,1
10028902,10029066,164,0,0,1,1
10029067,10029282,215,1,0,0,1
10029283,10029312,29,0,0,1,1
10029313,10029317,4,1,0,0,1
10029318,10029363,45,0,0,1,1
10029364,10029836,472,1,0,0,1
10029764,10029825,61,1,0,0,2
10029826,10030195,369,0,0,1,2
10029837,10029965,128,0,0,1,1
10029966,10029982,16,1,0,0,1
10029983,10030196,213,0,0,1,1
10030196,10033673,3477,1,0,0,2
10030197,10031278,1081,1,0,0,1
10030270,10030374,104,0,1,0,2
10031279,10031358,79,0,0,1,1
10031359,10031516,157,1,0,0,1
10031517,10031541,24,0,0,1,1
10031542,10031602,60,1,0,0,1
10031603,10031712,109,0,0,1,1
10031713,10031854,141,1,0,0,1
10031855,10031911,56,0,0,1,1
10031912,10031925,13,1,0,0,1
10031926,10031991,65,0,0,1,1
10031992,10032319,327,1,0,0,1
10032320,10032359,39,0,0,1,1
10032360,10033605,1245,1,0,0,1
10033353,10033486,133,0,1,0,1
10033362,10033478,116,0,1,0,2
10033606,10033639,33,0,0,1,1
10033640,10033678,38,1,0,0,1
10033674,10034157,483,0,0,1,2
10033679,10034150,471,0,0,1,1
10034151,10034175,24,1,0,0,1
10034158,10034165,7,1,0,0,2
10034166,10034496,330,0,0,1,2
10034176,10034498,322,0,0,1,1
10034497,10034517,20,1,0,0,2
10034499,10034570,71,1,0,0,1
10034518,10035256,738,0,0,1,2
10034571,10034674,103,0,0,1,1
10034675,10034707,32,1,0,0,1
10034708,10035256,548,0,0,1,1
10035257,10035274,17,1,0,0,1
10035257,10035275,18,1,0,0,2
10035275,10035461,186,0,0,1,1
10035276,10035469,193,0,0,1,2
10035462,10035499,37,1,0,0,1
10035470,10035482,12,1,0,0,2
10035483,10036114,631,0,0,1,2
10035500,10036114,614,0,0,1,1
10036115,10036187,72,1,0,0,2
10036115,10036191,76,1,0,0,1
10036188,10036316,128,0,0,1,2
10036192,10036316,124,0,0,1,1
10036317,10036369,52,1,0,0,2
10036317,10036372,55,1,0,0,1
10036370,10036541,171,0,0,1,2
10036373,10036542,169,0,0,1,1
10036542,10036565,23,1,0,0,2
10036543,10036563,20,1,0,0,1
10036564,10036755,191,0,0,1,1
10036566,10036755,189,0,0,1,2
10036756,10036765,9,1,0,0,2
10036756,10036766,10,1,0,0,1
10036766,10036990,224,0,0,1,2
10036767,10037222,455,0,0,1,1
10036991,10037710,719,1,0,0,2
10037223,10037233,10,1,0,0,1
10037234,10038122,888,0,0,1,1
10037711,10037733,22,0,0,1,2
10037734,10037921,187,1,0,0,2
10037922,10038012,90,0,0,1,2
10038013,10038866,853,1,0,0,2
10038123,10038143,20,1,0,0,1
10038144,10038315,171,0,0,1,1
10038316,10038324,8,1,0,0,1
10038325,10039888,1563,0,0,1,1
10038867,10039600,733,0,0,1,2
10039601,10039610,9,1,0,0,2
10039611,10039639,28,0,0,1,2
10039640,10039660,20,1,0,0,2
10039661,10039886,225,0,0,1,2
10039887,10039951,64,1,0,0,2
10039889,10039953,64,1,0,0,1
10039952,10039981,29,0,0,1,2
10039954,10039982,28,0,0,1,1
10039982,10040021,39,1,0,0,2
10039983,10040112,129,1,0,0,1
10040022,10040075,53,0,0,1,2
10040076,10040101,25,1,0,0,2
10040102,10040366,264,0,0,1,2
10040113,10040363,250,0,0,1,1
10040364,10040384,20,1,0,0,1
10040367,10040385,18,1,0,0,2
10040385,10040562,177,0,0,1,1
10040386,10040560,174,0,0,1,2
10040561,10040577,16,1,0,0,2
10040563,10040577,14,1,0,0,1
10040578,10040822,244,0,0,1,2
10040578,10040826,248,0,0,1,1
10040823,10040846,23,1,0,0,2
10040827,10040839,12,1,0,0,1
10040840,10041593,753,0,0,1,1
10040847,10041594,747,0,0,1,2
10041594,10041611,17,1,0,0,1
10041595,10041611,16,1,0,0,2
10041612,10041770,158,0,0,1,2
10041612,10041773,161,0,0,1,1
10041771,10041786,15,1,0,0,2
10041774,10041800,26,1,0,0,1
10041787,10042725,938,0,0,1,2
10041801,10042726,925,0,0,1,1
10042726,10042778,52,1,0,0,2
10042727,10042796,69,1,0,0,1
10042779,10042917,138,0,0,1,2
10042797,10042917,120,0,0,1,1
10042918,10042947,29,1,0,0,2
10042918,10042954,36,1,0,0,1
10042948,10043801,853,0,0,1,2
10042955,10043190,235,0,0,1,1
10043191,10043201,10,1,0,0,1
10043202,10043334,132,0,0,1,1
10043335,10043372,37,1,0,0,1
10043373,10043468,95,0,0,1,1
10043469,10043485,16,1,0,0,1
10043486,10043799,313,0,0,1,1
10043800,10043826,26,1,0,0,1
10043802,10043813,11,1,0,0,2
10043814,10044114,300,0,0,1,2
10043827,10044113,286,0,0,1,1
10044114,10044130,16,1,0,0,1
10044115,10044131,16,1,0,0,2
10044131,10044162,31,0,0,1,1
10044132,10044316,184,0,0,1,2
10044163,10044176,13,1,0,0,1
10044177,10044313,136,0,0,1,1
10044314,10044356,42,1,0,0,1
10044317,10044337,20,1,0,0,2
10044338,10044492,154,0,0,1,2
10044357,10044484,127,0,0,1,1
10044485,10044542,57,1,0,0,1
10044493,10044505,12,1,0,0,2
10044506,10044711,205,0,0,1,2
10044543,10044710,167,0,0,1,1
10044711,10044738,27,1,0,0,1
10044712,10044736,24,1,0,0,2
10044737,10045128,391,0,0,1,2
10044739,10045129,390,0,0,1,1
10045129,10045212,83,1,0,0,2
10045130,10045212,82,1,0,0,1
10045213,10045318,105,0,0,1,2
10045213,10045319,106,0,0,1,1
10045319,10045366,47,1,0,0,2
10045320,10045377,57,1,0,0,1
10045367,10045814,447,0,0,1,2
10045378,10046352,974,0,0,1,1
10045815,10045833,18,1,0,0,2
10045834,10046047,213,0,0,1,2
10046048,10046055,7,1,0,0,2
10046056,10047308,1252,0,0,1,2
10046353,10046360,7,1,0,0,1
10046361,10046473,112,0,0,1,1
10046474,10046479,5,1,0,0,1
10046480,10047308,828,0,0,1,1
10047309,10047356,47,1,0,0,2
10047309,10047385,76,1,0,0,1
10047357,10047674,317,0,0,1,2
10047386,10047743,357,0,0,1,1
10047675,10047707,32,1,0,0,2
10047708,10047731,23,0,0,1,2
10047732,10047847,115,1,0,0,2
10047744,10047867,123,1,0,0,1
10047848,10047928,80,0,0,1,2
10047868,10047913,45,0,0,1,1
10047914,10048083,169,1,0,0,1
10047929,10047953,24,1,0,0,2
10047954,10048006,52,0,0,1,2
10048007,10048025,18,1,0,0,2
10048026,10048951,925,0,0,1,2
10048084,10048549,465,0,0,1,1
10048550,10048599,49,1,0,0,1
10048600,10048631,31,0,0,1,1
10048632,10048642,10,1,0,0,1
10048643,10048942,299,0,0,1,1
10048943,10048984,41,1,0,0,1
10048952,10048959,7,1,0,0,2
10048960,10049584,624,0,0,1,2
10048985,10049173,188,0,0,1,1
10049174,10049195,21,1,0,0,1
10049196,10049582,386,0,0,1,1
10049583,10049617,34,1,0,0,1
10049585,10049605,20,1,0,0,2
10049606,10049938,332,0,0,1,2
10049618,10049931,313,0,0,1,1
10049932,10050022,90,1,0,0,1
10049939,10050002,63,1,0,0,2
10050003,10050118,115,0,0,1,2
10050023,10050164,141,0,0,1,1
10050119,10050131,12,1,0,0,2
10050132,10050154,22,0,0,1,2
10050155,10050205,50,1,0,0,2
10050165,10051245,1080,1,0,0,1
10050206,10050281,75,0,0,1,2
10050282,10051442,1160,1,0,0,2
10051246,10051306,60,0,0,1,1
10051307,10051769,462,1,0,0,1
10051443,10051481,38,0,0,1,2
10051482,10051743,261,1,0,0,2
10051744,10051790,46,0,0,1,2
10051770,10051807,37,0,0,1,1
10051791,10051812,21,1,0,0,2
10051808,10053149,1341,1,0,0,1
10051813,10051846,33,0,0,1,2
10051847,10053082,1235,1,0,0,2
10052933,10052978,45,0,1,0,1
10053083,10053115,32,0,0,1,2
10053116,10053229,113,1,0,0,2
10053150,10053172,22,0,0,1,1
10053173,10053257,84,1,0,0,1
10053230,10053292,62,0,0,1,2
10053258,10053293,35,0,0,1,1
10053293,10053330,37,1,0,0,2
10053294,10053337,43,1,0,0,1
10053331,10053561,230,0,0,1,2
10053338,10053558,220,0,0,1,1
10053559,10053588,29,1,0,0,1
10053562,10053583,21,1,0,0,2
10053584,10053781,197,0,0,1,2
10053589,10053779,190,0,0,1,1
10053780,10053804,24,1,0,0,1
10053782,10053798,16,1,0,0,2
10053799,10053905,106,0,0,1,2
10053805,10053904,99,0,0,1,1
10053905,10053934,29,1,0,0,1
10053906,10053930,24,1,0,0,2
10053931,10054448,517,0,0,1,2
10053935,10053997,62,0,0,1,1
10053998,10054013,15,1,0,0,1
10054014,10054446,432,0,0,1,1
10054447,10054465,18,1,0,0,1
10054449,10054466,17,1,0,0,2
10054466,10054673,207,0,0,1,1
10054467,10054678,211,0,0,1,2
10054674,10054726,52,1,0,0,1
10054679,10054691,12,1,0,0,2
10054692,10055595,903,0,0,1,2
10054727,10055066,339,0,0,1,1
10055067,10055076,9,1,0,0,1
10055077,10055511,434,0,0,1,1
10055512,10055526,14,1,0,0,1
10055527,10055591,64,0,0,1,1
10055592,10055724,132,1,0,0,1
10055596,10055710,114,1,0,0,2
10055711,10055885,174,0,0,1,2
10055725,10055885,160,0,0,1,1
10055886,10055929,43,1,0,0,1
10055886,10055930,44,1,0,0,2
10055930,10056076,146,0,0,1,1
10055931,10056077,146,0,0,1,2
10056077,10056232,155,1,0,0,1
10056078,10056376,298,1,0,0,2
10056233,10056270,37,0,0,1,1
10056271,10056532,261,1,0,0,1
10056377,10056509,132,0,0,1,2
10056510,10056540,30,1,0,0,2
10056533,10056603,70,0,0,1,1
10056541,10056652,111,0,0,1,2
10056604,10057576,972,1,0,0,1
10056653,10056853,200,1,0,0,2
10056854,10057052,198,0,0,1,2
10057053,10057768,715,1,0,0,2
10057577,10057602,25,0,0,1,1
10057603,10058736,1133,1,0,0,1
10057769,10057806,37,0,0,1,2
10057807,10058793,986,1,0,0,2
10058737,10059014,277,0,0,1,1
10058794,10059010,216,0,0,1,2
10059011,10060857,1846,1,0,0,2
10059015,10059118,103,1,0,0,1
10059119,10059201,82,0,0,1,1
10059202,10059218,16,1,0,0,1
10059219,10059255,36,0,0,1,1
10059256,10059307,51,1,0,0,1
10059308,10059583,275,0,0,1,1
10059584,10059607,23,1,0,0,1
10059608,10059751,143,0,0,1,1
10059752,10059840,88,1,0,0,1
10059841,10060323,482,0,0,1,1
10060324,10060385,61,1,0,0,1
10060386,10061447,1061,0,0,1,1
10060858,10061092,234,0,0,1,2
10061093,10061231,138,1,0,0,2
10061232,10061450,218,0,0,1,2
10061448,10061531,83,1,0,0,1
10061451,10061712,261,1,0,0,2
10061532,10061627,95,0,0,1,1
10061628,10061754,126,1,0,0,1
10061713,10061959,246,0,0,1,2
10061755,10061961,206,0,0,1,1
10061960,10061979,19,1,0,0,2
10061962,10061997,35,1,0,0,1
10061980,10062836,856,0,0,1,2
10061998,10062079,81,0,0,1,1
10062080,10062132,52,1,0,0,1
10062133,10062381,248,0,0,1,1
10062382,10062430,48,1,0,0,1
10062431,10062997,566,0,0,1,1
10062837,10062856,19,1,0,0,2
10062857,10062999,142,0,0,1,2
10062998,10063028,30,1,0,0,1
10063000,10063016,16,1,0,0,2
10063017,10063563,546,0,0,1,2
10063029,10063291,262,0,0,1,1
10063292,10063361,69,1,0,0,1
10063362,10064172,810,0,0,1,1
10063564,10063568,4,1,0,0,2
10063569,10063756,187,0,0,1,2
10063757,10063780,23,1,0,0,2
10063781,10064259,478,0,0,1,2
10064173,10064340,167,1,0,0,1
10064260,10064362,102,1,0,0,2
10064341,10064449,108,0,0,1,1
10064363,10064446,83,0,0,1,2
10064447,10064490,43,1,0,0,2
10064450,10064482,32,1,0,0,1
10064483,10064679,196,0,0,1,1
10064491,10064674,183,0,0,1,2
10064675,10064695,20,1,0,0,2
10064680,10064691,11,1,0,0,1
10064692,10065892,1200,0,0,1,1
10064696,10064932,236,0,0,1,2
10064933,10064952,19,1,0,0,2
10064953,10065888,935,0,0,1,2
10065889,10065932,43,1,0,0,2
10065893,10065930,37,1,0,0,1
10065931,10066296,365,0,0,1,1
10065933,10066297,364,0,0,1,2
10066297,10066374,77,1,0,0,1
10066298,10066367,69,1,0,0,2
10066368,10066597,229,0,0,1,2
10066375,10066495,120,0,0,1,1
10066496,10066516,20,1,0,0,1
10066517,10066597,80,0,0,1,1
10066598,10066615,17,1,0,0,2
10066598,10066647,49,1,0,0,1
10066616,10067375,759,0,0,1,2
10066648,10067373,725,0,0,1,1
10067374,10067392,18,1,0,0,1
10067376,10067394,18,1,0,0,2
10067393,10067538,145,0,0,1,1
10067395,10067982,587,0,0,1,2
10067539,10067552,13,1,0,0,1
10067553,10067598,45,0,0,1,1
10067599,10067628,29,1,0,0,1
10067629,10067932,303,0,0,1,1
10067933,10067952,19,1,0,0,1
10067953,10067982,29,0,0,1,1
10067983,10068008,25,1,0,0,2
10067983,10068021,38,1,0,0,1
10068009,10068434,425,0,0,1,2
10068022,10068433,411,0,0,1,1
10068434,10069109,675,1,0,0,1
10068435,10068505,70,1,0,0,2
10068506,10068609,103,0,0,1,2
10068610,10068667,57,1,0,0,2
10068668,10068767,99,0,0,1,2
10068768,10068804,36,1,0,0,2
10068805,10068884,79,0,0,1,2
10068885,10069014,129,1,0,0,2
10069015,10069036,21,0,0,1,2
10069037,10069450,413,1,0,0,2
10069110,10069202,92,0,0,1,1
10069203,10071069,1866,1,0,0,1
10069451,10069670,219,0,0,1,2
10069671,10069686,15,1,0,0,2
10069687,10069720,33,0,0,1,2
10069721,10069810,89,1,0,0,2
10069811,10069859,48,0,0,1,2
10069860,10069876,16,1,0,0,2
10069877,10070007,130,0,0,1,2
10070008,10071678,1670,1,0,0,2
10070738,10070754,16,0,1,0,2
10071070,10071168,98,0,0,1,1
10071169,10071912,743,1,0,0,1
10071210,10071541,331,0,1,0,2
10071220,10071505,285,0,1,0,1
10071575,10071578,3,0,1,0,2
10071679,10071716,37,0,0,1,2
10071717,10072310,593,1,0,0,2
10071913,10072117,204,0,0,1,1
10072118,10072277,159,1,0,0,1
10072278,10072317,39,0,0,1,1
10072311,10072341,30,0,0,1,2
10072318,10072414,96,1,0,0,1
10072342,10073926,1584,1,0,0,2
10072415,10072475,60,0,0,1,1
10072476,10072670,194,1,0,0,1
10072671,10072697,26,0,0,1,1
10072698,10072774,76,1,0,0,1
10072775,10072801,26,0,0,1,1
10072802,10073929,1127,1,0,0,1
10073072,10073748,676,0,1,0,1
10073406,10073491,85,0,1,0,2
10073569,10073713,144,0,1,0,2
10073927,10074019,92,0,0,1,2
10073930,10074016,86,0,0,1,1
10074017,10074056,39,1,0,0,1
10074020,10074058,38,1,0,0,2
10074057,10074128,71,0,0,1,1
10074059,10074125,66,0,0,1,2
10074126,10074143,17,1,0,0,2
10074129,10074135,6,1,0,0,1
10074136,10074375,239,0,0,1,1
10074144,10074374,230,0,0,1,2
10074375,10074390,15,1,0,0,2
10074376,10074391,15,1,0,0,1
10074391,10074787,396,0,0,1,2
10074392,10074788,396,0,0,1,1
10074788,10074806,18,1,0,0,2
10074789,10074810,21,1,0,0,1
10074807,10075040,233,0,0,1,2
10074811,10075035,224,0,0,1,1
10075036,10075057,21,1,0,0,1
10075041,10075053,12,1,0,0,2
10075054,10075341,287,0,0,1,2
10075058,10075343,285,0,0,1,1
10075342,10075364,22,1,0,0,2
10075344,10075362,18,1,0,0,1
10075363,10075515,152,0,0,1,1
10075365,10075519,154,0,0,1,2
10075516,10075537,21,1,0,0,1
10075520,10075539,19,1,0,0,2
10075538,10076211,673,0,0,1,1
10075540,10076209,669,0,0,1,2
10076210,10076309,99,1,0,0,2
10076212,10076305,93,1,0,0,1
10076306,10076405,99,0,0,1,1
10076310,10076404,94,0,0,1,2
10076405,10076444,39,1,0,0,2
10076406,10076443,37,1,0,0,1
10076444,10076723,279,0,0,1,1
10076445,10076719,274,0,0,1,2
10076720,10076735,15,1,0,0,2
10076724,10076733,9,1,0,0,1
10076734,10077632,898,0,0,1,1
10076736,10077494,758,0,0,1,2
10077495,10077515,20,1,0,0,2
10077516,10077635,119,0,0,1,2
10077633,10077686,53,1,0,0,1
10077636,10077659,23,1,0,0,2
10077660,10077852,192,0,0,1,2
10077687,10077850,163,0,0,1,1
10077851,10077875,24,1,0,0,1
10077853,10077867,14,1,0,0,2
10077868,10078463,595,0,0,1,2
10077876,10078026,150,0,0,1,1
10078027,10078107,80,1,0,0,1
10078108,10078305,197,0,0,1,1
10078306,10078338,32,1,0,0,1
10078339,10078466,127,0,0,1,1
10078464,10078560,96,1,0,0,2
10078467,10078543,76,1,0,0,1
10078544,10078903,359,0,0,1,1
10078561,10078906,345,0,0,1,2
10078904,10081385,2481,1,0,0,1
10078907,10078992,85,1,0,0,2
10078993,10079123,130,0,0,1,2
10079124,10079473,349,1,0,0,2
10079474,10079548,74,0,0,1,2
10079549,10079762,213,1,0,0,2
10079763,10079834,71,0,0,1,2
10079835,10079847,12,1,0,0,2
10079848,10079918,70,0,0,1,2
10079919,10080583,664,1,0,0,2
10080584,10080609,25,0,0,1,2
10080610,10081355,745,1,0,0,2
10081356,10081608,252,0,0,1,2
10081386,10081487,101,0,0,1,1
10081488,10081504,16,1,0,0,1
10081505,10081609,104,0,0,1,1
10081609,10081674,65,1,0,0,2
10081610,10081667,57,1,0,0,1
10081668,10081789,121,0,0,1,1
10081675,10081787,112,0,0,1,2
10081788,10081826,38,1,0,0,2
10081790,10081827,37,1,0,0,1
10081827,10082222,395,0,0,1,2
10081828,10082226,398,0,0,1,1
10082223,10082239,16,1,0,0,2
10082227,10082242,15,1,0,0,1
10082240,10082402,162,0,0,1,2
10082243,10082402,159,0,0,1,1
10082403,10082428,25,1,0,0,1
10082403,10082429,26,1,0,0,2
10082429,10082851,422,0,0,1,1
10082430,10082851,421,0,0,1,2
10082852,10082868,16,1,0,0,1
10082852,10082868,16,1,0,0,2
10082869,10083073,204,0,0,1,1
10082869,10083075,206,0,0,1,2
10083074,10083130,56,1,0,0,1
10083076,10083096,20,1,0,0,2
10083097,10083263,166,0,0,1,2
10083131,10083257,126,0,0,1,1
10083258,10083285,27,1,0,0,1
10083264,10083282,18,1,0,0,2
10083283,10083537,254,0,0,1,2
10083286,10083534,248,0,0,1,1
10083535,10083558,23,1,0,0,1
10083538,10083561,23,1,0,0,2
10083559,10083677,118,0,0,1,1
10083562,10083678,116,0,0,1,2
10083678,10083761,83,1,0,0,1
10083679,10083734,55,1,0,0,2
10083735,10083883,148,0,0,1,2
10083762,10083882,120,0,0,1,1
10083883,10084058,175,1,0,0,1
10083884,10083936,52,1,0,0,2
10083937,10084093,156,0,0,1,2
10084059,10084095,36,0,0,1,1
10084094,10084194,100,1,0,0,2
10084096,10084175,79,1,0,0,1
10084176,10084257,81,0,0,1,1
10084195,10084258,63,0,0,1,2
10084258,10084270,12,1,0,0,1
10084259,10084282,23,1,0,0,2
10084271,10084352,81,0,0,1,1
10084283,10084346,63,0,0,1,2
10084347,10084378,31,1,0,0,2
10084353,10084377,24,1,0,0,1
10084378,10084529,151,0,0,1,1
10084379,10084523,144,0,0,1,2
10084524,10084553,29,1,0,0,2
10084530,10084574,44,1,0,0,1
10084554,10084752,198,0,0,1,2
10084575,10086152,1577,0,0,1,1
10084753,10084770,17,1,0,0,2
10084771,10085067,296,0,0,1,2
10085068,10085091,23,1,0,0,2
10085092,10085268,176,0,0,1,2
10085269,10085281,12,1,0,0,2
10085282,10085638,356,0,0,1,2
10085639,10085658,19,1,0,0,2
10085659,10085948,289,0,0,1,2
10085949,10085972,23,1,0,0,2
10085973,10086145,172,0,0,1,2
10086146,10086183,37,1,0,0,2
10086153,10086202,49,1,0,0,1
10086184,10086556,372,0,0,1,2
10086203,10086554,351,0,0,1,1
10086555,10086638,83,1,0,0,1
10086557,10086620,63,1,0,0,2
10086621,10086730,109,0,0,1,2
10086639,10086738,99,0,0,1,1
10086731,10086770,39,1,0,0,2
10086739,10086776,37,1,0,0,1
10086771,10087057,286,0,0,1,2
10086777,10087071,294,0,0,1,1
10087058,10087074,16,1,0,0,2
10087072,10087097,25,1,0,0,1
10087075,10087338,263,0,0,1,2
10087098,10087261,163,0,0,1,1
10087262,10087336,74,1,0,0,1
10087337,10087501,164,0,0,1,1
10087339,10087345,6,1,0,0,2
10087346,10087528,182,0,0,1,2
10087502,10087587,85,1,0,0,1
10087529,10087544,15,1,0,0,2
10087545,10088101,556,0,0,1,2
10087588,10088257,669,0,0,1,1
10088102,10088108,6,1,0,0,2
10088109,10088253,144,0,0,1,2
10088254,10088270,16,1,0,0,2
10088258,10088304,46,1,0,0,1
10088271,10088777,506,0,0,1,2
10088305,10088783,478,0,0,1,1
10088778,10088829,51,1,0,0,2
10088784,10088820,36,1,0,0,1
10088821,10089179,358,0,0,1,1
10088830,10089180,350,0,0,1,2
10089180,10089250,70,1,0,0,1
10089181,10089306,125,1,0,0,2
10089251,10089439,188,0,0,1,1
10089307,10089442,135,0,0,1,2
10089440,10089468,28,1,0,0,1
10089443,10089473,30,1,0,0,2
10089469,10089730,261,0,0,1,1
10089474,10090428,954,0,0,1,2
10089731,10089750,19,1,0,0,1
10089751,10089977,226,0,0,1,1
10089978,10089998,20,1,0,0,1
10089999,10090419,420,0,0,1,1
10090420,10090439,19,1,0,0,1
10090429,10090436,7,1,0,0,2
10090437,10090576,139,0,0,1,2
10090440,10090569,129,0,0,1,1
10090570,10090592,22,1,0,0,1
10090577,10090590,13,1,0,0,2
10090591,10090722,131,0,0,1,2
10090593,10090773,180,0,0,1,1
10090723,10090863,140,1,0,0,2
10090774,10090795,21,1,0,0,1
10090796,10091042,246,0,0,1,1
10090864,10090917,53,0,0,1,2
10090918,10090990,72,1,0,0,2
10090991,10091045,54,0,0,1,2
10091043,10091182,139,1,0,0,1
10091046,10091117,71,1,0,0,2
10091118,10091340,222,0,0,1,2
10091183,10091312,129,0,0,1,1
10091313,10091463,150,1,0,0,1
10091341,10091376,35,1,0,0,2
10091377,10091507,130,0,0,1,2
10091464,10091490,26,0,0,1,1
10091491,10091607,116,1,0,0,1
10091508,10091600,92,1,0,0,2
10091601,10092249,648,0,0,1,2
10091608,10092070,462,0,0,1,1
10092071,10092092,21,1,0,0,1
10092093,10092497,404,0,0,1,1
10092250,10092255,5,1,0,0,2
10092256,10092495,239,0,0,1,2
10092496,10092514,18,1,0,0,2
10092498,10092518,20,1,0,0,1
10092515,10092705,190,0,0,1,2
10092519,10092709,190,0,0,1,1
10092706,10092726,20,1,0,0,2
10092710,10092722,12,1,0,0,1
10092723,10093372,649,0,0,1,1
10092727,10093372,645,0,0,1,2
10093373,10093464,91,1,0,0,2
10093373,10093465,92,1,0,0,1
10093465,10093701,236,0,0,1,2
10093466,10093701,235,0,0,1,1
10093702,10093749,47,1,0,0,2
10093702,10093764,62,1,0,0,1
10093750,10093865,115,0,0,1,2
10093765,10093866,101,0,0,1,1
10093866,10093917,51,1,0,0,2
10093867,10093936,69,1,0,0,1
10093918,10094065,147,0,0,1,2
10093937,10094067,130,0,0,1,1
10094066,10094086,20,1,0,0,2
10094068,10094100,32,1,0,0,1
10094087,10094271,184,0,0,1,2
10094101,10094277,176,0,0,1,1
10094272,10094292,20,1,0,0,2
10094278,10094298,20,1,0,0,1
10094293,10094469,176,0,0,1,2
10094299,10094643,344,0,0,1,1
10094470,10094492,22,1,0,0,2
10094493,10094631,138,0,0,1,2
10094632,10094652,20,1,0,0,2
10094644,10094657,13,1,0,0,1
10094653,10094776,123,0,0,1,2
10094658,10094787,129,0,0,1,1
10094777,10094803,26,1,0,0,2
10094788,10094796,8,1,0,0,1
10094797,10094916,119,0,0,1,1
10094804,10094906,102,0,0,1,2
10094907,10094930,23,1,0,0,2
10094917,10094926,9,1,0,0,1
10094927,10095096,169,0,0,1,1
10094931,10095083,152,0,0,1,2
10095084,10095102,18,1,0,0,2
10095097,10095106,9,1,0,0,1
10095103,10095211,108,0,0,1,2
10095107,10095218,111,0,0,1,1
10095212,10095239,27,1,0,0,2
10095219,10095242,23,1,0,0,1
10095240,10095395,155,0,0,1,2
10095243,10095312,69,0,0,1,1
10095313,10095317,4,1,0,0,1
10095318,10095578,260,0,0,1,1
10095396,10095406,10,1,0,0,2
10095407,10095566,159,0,0,1,2
10095567,10095591,24,1,0,0,2
10095579,10095595,16,1,0,0,1
10095592,10095750,158,0,0,1,2
10095596,10095739,143,0,0,1,1
10095740,10095778,38,1,0,0,1
10095751,10095769,18,1,0,0,2
10095770,10095981,211,0,0,1,2
10095779,10095843,64,0,0,1,1
10095844,10095861,17,1,0,0,1
10095862,10095982,120,0,0,1,1
10095982,10096090,108,1,0,0,2
10095983,10096100,117,1,0,0,1
10096091,10096648,557,0,0,1,2
10096101,10096218,117,0,0,1,1
10096219,10096251,32,1,0,0,1
10096252,10096391,139,0,0,1,1
10096392,10096434,42,1,0,0,1
10096435,10096647,212,0,0,1,1
10096648,10096671,23,1,0,0,1
10096649,10096671,22,1,0,0,2
10096672,10096793,121,0,0,1,2
10096672,10096794,122,0,0,1,1
10096794,10096815,21,1,0,0,2
10096795,10096830,35,1,0,0,1
10096816,10097348,532,0,0,1,2
10096831,10097346,515,0,0,1,1
10097347,10097385,38,1,0,0,1
10097349,10097370,21,1,0,0,2
10097371,10097577,206,0,0,1,2
10097386,10097572,186,0,0,1,1
10097573,10097586,13,1,0,0,1
10097578,10097586,8,1,0,0,2
10097587,10097771,184,0,0,1,2
10097587,10097774,187,0,0,1,1
10097772,10097795,23,1,0,0,2
10097775,10097790,15,1,0,0,1
10097791,10098131,340,0,0,1,1
10097796,10098135,339,0,0,1,2
10098132,10098228,96,1,0,0,1
10098136,10098208,72,1,0,0,2
10098209,10098322,113,0,0,1,2
10098229,10098320,91,0,0,1,1
10098321,10098369,48,1,0,0,1
10098323,10098356,33,1,0,0,2
10098357,10098555,198,0,0,1,2
10098370,10098556,186,0,0,1,1
10098556,10098575,19,1,0,0,2
10098557,10098585,28,1,0,0,1
10098576,10098854,278,0,0,1,2
10098586,10098648,62,0,0,1,1
10098649,10098657,8,1,0,0,1
10098658,10098856,198,0,0,1,1
10098855,10098872,17,1,0,0,2
10098857,10098872,15,1,0,0,1
10098873,10099368,495,0,0,1,1
10098873,10100602,1729,0,0,1,2
10099369,10099378,9,1,0,0,1
10099379,10099996,617,0,0,1,1
10099997,10100028,31,1,0,0,1
10100029,10100605,576,0,0,1,1
10100603,10100692,89,1,0,0,2
10100606,10100690,84,1,0,0,1
10100691,10100739,48,0,0,1,1
10100693,10100738,45,0,0,1,2
10100739,10100778,39,1,0,0,2
10100740,10100776,36,1,0,0,1
10100777,10100975,198,0,0,1,1
10100779,10100977,198,0,0,1,2
10100976,10101004,28,1,0,0,1
10100978,10100995,17,1,0,0,2
10100996,10101168,172,0,0,1,2
10101005,10101165,160,0,0,1,1
10101166,10101185,19,1,0,0,1
10101169,10101183,14,1,0,0,2
10101184,10101393,209,0,0,1,2
10101186,10101390,204,0,0,1,1
10101391,10101411,20,1,0,0,1
10101394,10101409,15,1,0,0,2
10101410,10101602,192,0,0,1,2
10101412,10101603,191,0,0,1,1
10101603,10101623,20,1,0,0,2
10101604,10101636,32,1,0,0,1
10101624,10101820,196,0,0,1,2
10101637,10101815,178,0,0,1,1
10101816,10101844,28,1,0,0,1
10101821,10101832,11,1,0,0,2
10101833,10102124,291,0,0,1,2
10101845,10102124,279,0,0,1,1
10102125,10102142,17,1,0,0,2
10102125,10102159,34,1,0,0,1
10102143,10102287,144,0,0,1,2
10102160,10102283,123,0,0,1,1
10102284,10102310,26,1,0,0,1
10102288,10102308,20,1,0,0,2
10102309,10102473,164,0,0,1,2
10102311,10102470,159,0,0,1,1
10102471,10102495,24,1,0,0,1
10102474,10102494,20,1,0,0,2
10102495,10102715,220,0,0,1,2
10102496,10102716,220,0,0,1,1
10102716,10102773,57,1,0,0,2
10102717,10102774,57,1,0,0,1
10102774,10103184,410,0,0,1,2
10102775,10103184,409,0,0,1,1
10103185,10103245,60,1,0,0,1
10103185,10103258,73,1,0,0,2
10103246,10103341,95,0,0,1,1
10103259,10103339,80,0,0,1,2
10103340,10103380,40,1,0,0,2
10103342,10103375,33,1,0,0,1
10103376,10103737,361,0,0,1,1
10103381,10103411,30,0,0,1,2
10103412,10103604,192,1,0,0,2
10103605,10103625,20,0,0,1,2
10103626,10106008,2382,1,0,0,2
10103738,10103772,34,1,0,0,1
10103773,10104038,265,0,0,1,1
10104039,10104072,33,1,0,0,1
10104073,10104202,129,0,0,1,1
10104203,10104374,171,1,0,0,1
10104375,10104808,433,0,0,1,1
10104809,10104839,30,1,0,0,1
10104840,10104966,126,0,0,1,1
10104967,10104988,21,1,0,0,1
10104989,10105316,327,0,0,1,1
10105317,10105341,24,1,0,0,1
10105342,10105466,124,0,0,1,1
10105467,10105481,14,1,0,0,1
10105482,10105755,273,0,0,1,1
10105756,10108372,2616,1,0,0,1
10106009,10106095,86,0,0,1,2
10106096,10106180,84,1,0,0,2
10106181,10106216,35,0,0,1,2
10106217,10106240,23,1,0,0,2
10106241,10106359,118,0,0,1,2
10106360,10107021,661,1,0,0,2
10107022,10107052,30,0,0,1,2
10107053,10107139,86,1,0,0,2
10107140,10107222,82,0,0,1,2
10107223,10107353,130,1,0,0,2
10107234,10107344,110,0,1,0,2
10107354,10107436,82,0,0,1,2
10107437,10107656,219,1,0,0,2
10107454,10107588,134,0,1,0,2
10107657,10107777,120,0,0,1,2
10107778,10108371,593,1,0,0,2
10108372,10108452,80,0,0,1,2
10108373,10108455,82,0,0,1,1
10108453,10108479,26,1,0,0,2
10108456,10108500,44,1,0,0,1
10108480,10108625,145,0,0,1,2
10108501,10108626,125,0,0,1,1
10108626,10108652,26,1,0,0,2
10108627,10108759,132,1,0,0,1
10108653,10108818,165,0,0,1,2
10108760,10108808,48,0,0,1,1
10108809,10108853,44,1,0,0,1
10108819,10108829,10,1,0,0,2
10108830,10109129,299,0,0,1,2
10108854,10109307,453,0,0,1,1
10109130,10109149,19,1,0,0,2
10109150,10109301,151,0,0,1,2
10109302,10109320,18,1,0,0,2
10109308,10109346,38,1,0,0,1
10109321,10109660,339,0,0,1,2
10109347,10109466,119,0,0,1,1
10109467,10109514,47,1,0,0,1
10109515,10109879,364,0,0,1,1
10109661,10109677,16,1,0,0,2
10109678,10109871,193,0,0,1,2
10109872,10109900,28,1,0,0,2
10109880,10109926,46,1,0,0,1
10109901,10110216,315,0,0,1,2
10109927,10110216,289,0,0,1,1
10110217,10110221,4,1,0,0,2
10110217,10110233,16,1,0,0,1
10110222,10110341,119,0,0,1,2
10110234,10110337,103,0,0,1,1
10110338,10110367,29,1,0,0,1
10110342,10110365,23,1,0,0,2
10110366,10110508,142,0,0,1,2
10110368,10110514,146,0,0,1,1
10110509,10110532,23,1,0,0,2
10110515,10110540,25,1,0,0,1
10110533,10110671,138,0,0,1,2
10110541,10110663,122,0,0,1,1
10110664,10110687,23,1,0,0,1
10110672,10110685,13,1,0,0,2
10110686,10110945,259,0,0,1,2
10110688,10110945,257,0,0,1,1
10110946,10111009,63,1,0,0,1
10110946,10111010,64,1,0,0,2
10111010,10111151,141,0,0,1,1
10111011,10111153,142,0,0,1,2
10111152,10111159,7,1,0,0,1
10111154,10111161,7,1,0,0,2
10111160,10111346,186,0,0,1,1
10111162,10111337,175,0,0,1,2
10111338,10111363,25,1,0,0,2
10111347,10111365,18,1,0,0,1
10111364,10111588,224,0,0,1,2
10111366,10111591,225,0,0,1,1
10111589,10111597,8,1,0,0,2
10111592,10111596,4,1,0,0,1
10111597,10111735,138,0,0,1,1
10111598,10111729,131,0,0,1,2
10111730,10111756,26,1,0,0,2
10111736,10111759,23,1,0,0,1
10111757,10111914,157,0,0,1,2
10111760,10111912,152,0,0,1,1
10111913,10111938,25,1,0,0,1
10111915,10111939,24,1,0,0,2
10111939,10112001,62,0,0,1,1
10111940,10111994,54,0,0,1,2
10111995,10112014,19,1,0,0,2
10112002,10112016,14,1,0,0,1
10112015,10112297,282,0,0,1,2
10112017,10112303,286,0,0,1,1
10112298,10112320,22,1,0,0,2
10112304,10112315,11,1,0,0,1
10112316,10112462,146,0,0,1,1
10112321,10112778,457,0,0,1,2
10112463,10112478,15,1,0,0,1
10112479,10112779,300,0,0,1,1
10112779,10112790,11,1,0,0,2
10112780,10112793,13,1,0,0,1
10112791,10112917,126,0,0,1,2
10112794,10113092,298,0,0,1,1
10112918,10112936,18,1,0,0,2
10112937,10113099,162,0,0,1,2
10113093,10113108,15,1,0,0,1
10113100,10113110,10,1,0,0,2
10113109,10113257,148,0,0,1,1
10113111,10113733,622,0,0,1,2
10113258,10113264,6,1,0,0,1
10113265,10113741,476,0,0,1,1
10113734,10113826,92,1,0,0,2
10113742,10113823,81,1,0,0,1
10113824,10113868,44,0,0,1,1
10113827,10113931,104,0,0,1,2
10113869,10113892,23,1,0,0,1
10113893,10113924,31,0,0,1,1
10113925,10113930,5,1,0,0,1
10113931,10113952,21,0,0,1,1
10113932,10114353,421,1,0,0,2
10113953,10114525,572,1,0,0,1
10113989,10114156,167,0,1,0,2
10113993,10114155,162,0,1,0,1
10114354,10114499,145,0,0,1,2
10114500,10114539,39,1,0,0,2
10114526,10114766,240,0,0,1,1
10114540,10114708,168,0,0,1,2
10114709,10114734,25,1,0,0,2
10114735,10114860,125,0,0,1,2
10114767,10114798,31,1,0,0,1
10114799,10114842,43,0,0,1,1
10114843,10114860,17,1,0,0,1
10114861,10114896,35,1,0,0,2
10114861,10114996,135,0,0,1,1
10114897,10115138,241,0,0,1,2
10114997,10115038,41,1,0,0,1
10115039,10115129,90,0,0,1,1
10115130,10115167,37,1,0,0,1
10115139,10115147,8,1,0,0,2
10115148,10115284,136,0,0,1,2
10115168,10115288,120,0,0,1,1
10115285,10119995,4710,1,0,0,2
10115289,10115921,632,1,0,0,1
10115922,10115980,58,0,0,1,1
10115981,10116163,182,1,0,0,1
10116164,10116187,23,0,0,1,1
10116188,10120007,3819,1,0,0,1
10117234,10117281,47,0,1,0,1
10118518,10118912,394,0,1,0,1
10119083,10119352,269,0,1,0,1
10119996,10120134,138,0,0,1,2
10120008,10120130,122,0,0,1,1
10120131,10120167,36,1,0,0,1
10120135,10120167,32,1,0,0,2
10120168,10120301,133,0,0,1,1
10120168,10120306,138,0,0,1,2
10120302,10120320,18,1,0,0,1
10120307,10120323,16,1,0,0,2
10120321,10120872,551,0,0,1,1
10120324,10120695,371,0,0,1,2
10120696,10120701,5,1,0,0,2
10120702,10120872,170,0,0,1,2
10120873,10120889,16,1,0,0,1
10120873,10120892,19,1,0,0,2
10120890,10121589,699,0,0,1,1
10120893,10121583,690,0,0,1,2
10121584,10121601,17,1,0,0,2
10121590,10121602,12,1,0,0,1
10121602,10121772,170,0,0,1,2
10121603,10122477,874,0,0,1,1
10121773,10121790,17,1,0,0,2
10121791,10122479,688,0,0,1,2
10122478,10125922,3444,1,0,0,1
10122480,10123390,910,1,0,0,2
10122666,10122843,177,0,1,0,2
10122682,10122997,315,0,1,0,1
10122878,10123071,193,0,1,0,2
10123391,10123414,23,0,0,1,2
10123415,10126022,2607,1,0,0,2
10124083,10124753,670,0,1,0,1
10124712,10124791,79,0,1,0,2
10124834,10124886,52,0,1,0,2
10124850,10124888,38,0,1,0,1
10124924,10125046,122,0,1,0,2
10124934,10124937,3,0,1,0,1
10125049,10125077,28,0,1,0,1
10125923,10126024,101,0,0,1,1
10126023,10127588,1565,0,0,1,2
10126025,10126074,49,1,0,0,1
10126075,10126241,166,0,0,1,1
10126242,10126549,307,1,0,0,1
10126550,10126574,24,0,0,1,1
10126575,10126593,18,1,0,0,1
10126594,10126647,53,0,0,1,1
10126648,10126658,10,1,0,0,1
10126659,10126794,135,0,0,1,1
10126795,10126815,20,1,0,0,1
10126816,10126856,40,0,0,1,1
10126857,10127860,1003,1,0,0,1
10127589,10127593,4,1,0,0,2
10127594,10128532,938,0,0,1,2
10127861,10127970,109,0,0,1,1
10127971,10128301,330,1,0,0,1
10128302,10128358,56,0,0,1,1
10128359,10128426,67,1,0,0,1
10128427,10128462,35,0,0,1,1
10128463,10128591,128,1,0,0,1
10128533,10128596,63,1,0,0,2
10128592,10129004,412,0,0,1,1
10128597,10129005,408,0,0,1,2
10129005,10129016,11,1,0,0,1
10129006,10129015,9,1,0,0,2
10129016,10132375,3359,0,0,1,2
10129017,10131391,2374,0,0,1,1
10131392,10131396,4,1,0,0,1
10131397,10132375,978,0,0,1,1
10132376,10132442,66,1,0,0,2
10132376,10132450,74,1,0,0,1
10132443,10132588,145,0,0,1,2
10132451,10132587,136,0,0,1,1
10132588,10132647,59,1,0,0,1
10132589,10132649,60,1,0,0,2
10132648,10132803,155,0,0,1,1
10132650,10132802,152,0,0,1,2
10132803,10132822,19,1,0,0,2
10132804,10132823,19,1,0,0,1
10132823,10133242,419,0,0,1,2
10132824,10133243,419,0,0,1,1
10133243,10133261,18,1,0,0,2
10133244,10133264,20,1,0,0,1
10133262,10133476,214,0,0,1,2
10133265,10133477,212,0,0,1,1
10133477,10133495,18,1,0,0,2
10133478,10133496,18,1,0,0,1
10133496,10134161,665,0,0,1,2
10133497,10134161,664,0,0,1,1
10134162,10134181,19,1,0,0,2
10134162,10134183,21,1,0,0,1
10134182,10134343,161,0,0,1,2
10134184,10134345,161,0,0,1,1
10134344,10134366,22,1,0,0,2
10134346,10134364,18,1,0,0,1
10134365,10134897,532,0,0,1,1
10134367,10134897,530,0,0,1,2
10134898,10134960,62,1,0,0,1
10134898,10134967,69,1,0,0,2
10134961,10135249,288,0,0,1,1
10134968,10135247,279,0,0,1,2
10135248,10135268,20,1,0,0,2
10135250,10135267,17,1,0,0,1
10135268,10135932,664,0,0,1,1
10135269,10135931,662,0,0,1,2
10135932,10135952,20,1,0,0,2
10135933,10135951,18,1,0,0,1
10135952,10136346,394,0,0,1,1
10135953,10136345,392,0,0,1,2
10136346,10136370,24,1,0,0,2
10136347,10136371,24,1,0,0,1
10136371,10136556,185,0,0,1,2
10136372,10136558,186,0,0,1,1
10136557,10136580,23,1,0,0,2
10136559,10136581,22,1,0,0,1
10136581,10136946,365,0,0,1,2
10136582,10136947,365,0,0,1,1
10136947,10136974,27,1,0,0,2
10136948,10136974,26,1,0,0,1
10136975,10137508,533,0,0,1,1
10136975,10137508,533,0,0,1,2
10137509,10137541,32,1,0,0,1
10137509,10137542,33,1,0,0,2
10137542,10138014,472,0,0,1,1
10137543,10138013,470,0,0,1,2
10138014,10138066,52,1,0,0,2
10138015,10138083,68,1,0,0,1
10138067,10138605,538,0,0,1,2
10138084,10138602,518,0,0,1,1
10138603,10138676,73,1,0,0,1
10138606,10138677,71,1,0,0,2
10138677,10138847,170,0,0,1,1
10138678,10138849,171,0,0,1,2
10138848,10138862,14,1,0,0,1
10138850,10138859,9,1,0,0,2
10138860,10139234,374,0,0,1,2
10138863,10139233,370,0,0,1,1
10139234,10139245,11,1,0,0,1
10139235,10139246,11,1,0,0,2
10139246,10139515,269,0,0,1,1
10139247,10139513,266,0,0,1,2
10139514,10139525,11,1,0,0,2
10139516,10139531,15,1,0,0,1
10139526,10140303,777,0,0,1,2
10139532,10141114,1582,0,0,1,1
10140304,10140313,9,1,0,0,2
10140314,10141114,800,0,0,1,2
10141115,10141178,63,1,0,0,1
10141115,10141180,65,1,0,0,2
10141179,10141511,332,0,0,1,1
10141181,10141511,330,0,0,1,2
10141512,10141537,25,1,0,0,2
10141512,10141538,26,1,0,0,1
10141538,10142910,1372,0,0,1,2
10141539,10142911,1372,0,0,1,1
10142911,10142917,6,1,0,0,2
10142912,10142924,12,1,0,0,1
10142918,10143219,301,0,0,1,2
10142925,10143225,300,0,0,1,1
10143220,10143544,324,1,0,0,2
10143226,10143493,267,1,0,0,1
10143311,10143401,90,0,1,0,2
10143319,10143326,7,0,1,0,1
10143357,10143366,9,0,1,0,1
10143494,10143618,124,0,0,1,1
10143545,10143620,75,0,0,1,2
10143619,10143646,27,1,0,0,1
10143621,10143646,25,1,0,0,2
10143647,10143949,302,0,0,1,1
10143647,10143950,303,0,0,1,2
10143950,10143980,30,1,0,0,1
10143951,10143980,29,1,0,0,2
10143981,10144314,333,0,0,1,1
10143981,10144314,333,0,0,1,2
10144315,10144341,26,1,0,0,1
10144315,10144343,28,1,0,0,2
10144342,10144730,388,0,0,1,1
10144344,10144730,386,0,0,1,2
10144731,10144793,62,1,0,0,1
10144731,10144802,71,1,0,0,2
10144794,10145033,239,0,0,1,1
10144803,10145033,230,0,0,1,2
10145034,10145108,74,1,0,0,2
10145034,10145143,109,1,0,0,1
10145109,10145280,171,0,0,1,2
10145144,10145183,39,0,0,1,1
10145184,10145216,32,1,0,0,1
10145217,10145285,68,0,0,1,1
10145281,10145363,82,1,0,0,2
10145286,10145356,70,1,0,0,1
10145357,10145578,221,0,0,1,1
10145364,10145583,219,0,0,1,2
10145579,10145602,23,1,0,0,1
10145584,10145589,5,1,0,0,2
10145590,10145908,318,0,0,1,2
10145603,10145902,299,0,0,1,1
10145903,10145916,13,1,0,0,1
10145909,10145913,4,1,0,0,2
10145914,10146341,427,0,0,1,2
10145917,10146106,189,0,0,1,1
10146107,10146114,7,1,0,0,1
10146115,10147083,968,0,0,1,1
10146342,10148111,1769,1,0,0,2
10147084,10147110,26,1,0,0,1
10147111,10148043,932,0,0,1,1
10148044,10148099,55,1,0,0,1
10148100,10149041,941,0,0,1,1
10148112,10149041,929,0,0,1,2
10149042,10149063,21,1,0,0,1
10149042,10149063,21,1,0,0,2
10149064,10149249,185,0,0,1,1
10149064,10149251,187,0,0,1,2
10149250,10149274,24,1,0,0,1
10149252,10149270,18,1,0,0,2
10149271,10149557,286,0,0,1,2
10149275,10149555,280,0,0,1,1
10149556,10149575,19,1,0,0,1
10149558,10149577,19,1,0,0,2
10149576,10149873,297,0,0,1,1
10149578,10149871,293,0,0,1,2
10149872,10149897,25,1,0,0,2
10149874,10149900,26,1,0,0,1
10149898,10150045,147,0,0,1,2
10149901,10150095,194,0,0,1,1
10150046,10150682,636,1,0,0,2
10150096,10150135,39,1,0,0,1
10150136,10150335,199,0,0,1,1
10150336,10150359,23,1,0,0,1
10150360,10150392,32,0,0,1,1
10150393,10150549,156,1,0,0,1
10150550,10150637,87,0,0,1,1
10150638,10150682,44,1,0,0,1
10150683,10151153,470,0,0,1,1
10150683,10151157,474,0,0,1,2
10151154,10151193,39,1,0,0,1
10151158,10151185,27,1,0,0,2
10151186,10152123,937,0,0,1,2
10151194,10152119,925,0,0,1,1
10152120,10152194,74,1,0,0,1
10152124,10154845,2721,1,0,0,2
10152195,10152321,126,0,0,1,1
10152322,10152365,43,1,0,0,1
10152366,10152410,44,0,0,1,1
10152411,10152424,13,1,0,0,1
10152425,10152866,441,0,0,1,1
10152867,10152908,41,1,0,0,1
10152909,10153051,142,0,0,1,1
10153052,10153085,33,1,0,0,1
10153086,10153162,76,0,0,1,1
10153163,10153167,4,1,0,0,1
10153168,10153235,67,0,0,1,1
10153236,10153275,39,1,0,0,1
10153276,10153298,22,0,0,1,1
10153299,10153313,14,1,0,0,1
10153314,10153354,40,0,0,1,1
10153355,10154811,1456,1,0,0,1
10154812,10154955,143,0,0,1,1
10154846,10154960,114,0,0,1,2
10154956,10154993,37,1,0,0,1
10154961,10155146,185,1,0,0,2
10154994,10155036,42,0,0,1,1
10155037,10155075,38,1,0,0,1
10155076,10155294,218,0,0,1,1
10155147,10155257,110,0,0,1,2
10155258,10155280,22,1,0,0,2
10155281,10155305,24,0,0,1,2
10155295,10155353,58,1,0,0,1
10155306,10155824,518,1,0,0,2
10155354,10155632,278,0,0,1,1
10155633,10155723,90,1,0,0,1
10155724,10155839,115,0,0,1,1
10155825,10155867,42,0,0,1,2
10155840,10155992,152,1,0,0,1
10155868,10155945,77,1,0,0,2
10155946,10156076,130,0,0,1,2
10155993,10156020,27,0,0,1,1
10156021,10156245,224,1,0,0,1
10156077,10156098,21,1,0,0,2
10156099,10156201,102,0,0,1,2
10156202,10156516,314,1,0,0,2
10156246,10156285,39,0,0,1,1
10156286,10158804,2518,1,0,0,1
10156517,10156594,77,0,0,1,2
10156595,10156667,72,1,0,0,2
10156668,10156723,55,0,0,1,2
10156724,10156852,128,1,0,0,2
10156853,10156895,42,0,0,1,2
10156896,10161995,5099,1,0,0,2
10158805,10158913,108,0,0,1,1
10158914,10158978,64,1,0,0,1
10158979,10159188,209,0,0,1,1
10159189,10159225,36,1,0,0,1
10159226,10159378,152,0,0,1,1
10159379,10159426,47,1,0,0,1
10159427,10159486,59,0,0,1,1
10159487,10159496,9,1,0,0,1
10159497,10159530,33,0,0,1,1
10159531,10159621,90,1,0,0,1
10159622,10159757,135,0,0,1,1
10159758,10159838,80,1,0,0,1
10159839,10159863,24,0,0,1,1
10159864,10159878,14,1,0,0,1
10159879,10159902,23,0,0,1,1
10159903,10160085,182,1,0,0,1
10160086,10160133,47,0,0,1,1
10160134,10160143,9,1,0,0,1
10160144,10160353,209,0,0,1,1
10160354,10160387,33,1,0,0,1
10160388,10160540,152,0,0,1,1
10160541,10160560,19,1,0,0,1
10160561,10160586,25,0,0,1,1
10160587,10161968,1381,1,0,0,1
10161969,10162004,35,0,0,1,1
10161996,10162053,57,0,0,1,2
10162005,10163252,1247,1,0,0,1
10162054,10163541,1487,1,0,0,2
10162743,10163020,277,0,1,0,2
10162744,10162745,1,0,1,0,1
10162766,10163089,323,0,1,0,1
10163253,10163485,232,0,0,1,1
10163486,10163552,66,1,0,0,1
10163542,10163570,28,0,0,1,2
10163553,10163640,87,0,0,1,1
10163571,10163592,21,1,0,0,2
10163593,10163639,46,0,0,1,2
10163640,10163721,81,1,0,0,2
10163641,10163710,69,1,0,0,1
10163711,10163745,34,0,0,1,1
10163722,10163773,51,0,0,1,2
10163746,10163771,25,1,0,0,1
10163772,10163822,50,0,0,1,1
10163774,10163780,6,1,0,0,2
10163781,10164035,254,0,0,1,2
10163823,10163844,21,1,0,0,1
10163845,10164035,190,0,0,1,1
10164036,10164081,45,1,0,0,2
10164036,10164151,115,1,0,0,1
10164082,10164248,166,0,0,1,2
10164152,10164249,97,0,0,1,1
10164249,10164299,50,1,0,0,2
10164250,10164292,42,1,0,0,1
10164293,10164373,80,0,0,1,1
10164300,10164372,72,0,0,1,2
10164373,10164415,42,1,0,0,2
10164374,10164439,65,1,0,0,1
10164416,10164590,174,0,0,1,2
10164440,10164595,155,0,0,1,1
10164591,10164613,22,1,0,0,2
10164596,10164611,15,1,0,0,1
10164612,10165024,412,0,0,1,1
10164614,10165027,413,0,0,1,2
10165025,10165039,14,1,0,0,1
10165028,10165039,11,1,0,0,2
10165040,10165516,476,0,0,1,1
10165040,10165784,744,0,0,1,2
10165517,10165542,25,1,0,0,1
10165543,10165782,239,0,0,1,1
10165783,10165803,20,1,0,0,1
10165785,10165802,17,1,0,0,2
10165803,10165977,174,0,0,1,2
10165804,10166369,565,0,0,1,1
10165978,10165983,5,1,0,0,2
10165984,10166367,383,0,0,1,2
10166368,10166428,60,1,0,0,2
10166370,10166439,69,1,0,0,1
10166429,10166799,370,0,0,1,2
10166440,10166799,359,0,0,1,1
10166800,10166821,21,1,0,0,1
10166800,10166821,21,1,0,0,2
10166822,10167036,214,0,0,1,1
10166822,10167037,215,0,0,1,2
10167037,10167086,49,1,0,0,1
10167038,10167059,21,1,0,0,2
10167060,10167261,201,0,0,1,2
10167087,10167262,175,0,0,1,1
10167262,10167286,24,1,0,0,2
10167263,10167298,35,1,0,0,1
10167287,10167491,204,0,0,1,2
10167299,10167490,191,0,0,1,1
10167491,10167526,35,1,0,0,1
10167492,10167514,22,1,0,0,2
10167515,10167673,158,0,0,1,2
10167527,10167846,319,0,0,1,1
10167674,10167685,11,1,0,0,2
10167686,10167844,158,0,0,1,2
10167845,10167859,14,1,0,0,2
10167847,10167869,22,1,0,0,1
10167860,10168564,704,0,0,1,2
10167870,10168290,420,0,0,1,1
10168291,10168302,11,1,0,0,1
10168303,10168550,247,0,0,1,1
10168551,10168591,40,1,0,0,1
10168565,10168580,15,1,0,0,2
10168581,10168667,86,0,0,1,2
10168592,10168661,69,0,0,1,1
10168662,10168690,28,1,0,0,1
10168668,10168708,40,1,0,0,2
10168691,10168711,20,0,0,1,1
10168709,10168823,114,0,0,1,2
10168712,10168722,10,1,0,0,1
10168723,10168763,40,0,0,1,1
10168764,10168777,13,1,0,0,1
10168778,10168838,60,0,0,1,1
10168824,10168895,71,1,0,0,2
10168839,10168862,23,1,0,0,1
10168863,10168917,54,0,0,1,1
10168896,10169135,239,0,0,1,2
10168918,10168931,13,1,0,0,1
10168932,10169002,70,0,0,1,1
10169003,10169041,38,1,0,0,1
10169042,10169110,68,0,0,1,1
10169111,10169202,91,1,0,0,1
10169136,10169142,6,1,0,0,2
10169143,10169164,21,0,0,1,2
10169165,10169199,34,1,0,0,2
10169200,10169577,377,0,0,1,2
10169203,10169580,377,0,0,1,1
10169578,10169653,75,1,0,0,2
10169581,10169658,77,1,0,0,1
10169654,10169743,89,0,0,1,2
10169659,10169736,77,0,0,1,1
10169737,10169804,67,1,0,0,1
10169744,10169813,69,1,0,0,2
10169805,10169913,108,0,0,1,1
10169814,10169915,101,0,0,1,2
10169914,10169952,38,1,0,0,1
10169916,10169950,34,1,0,0,2
10169951,10171083,1132,0,0,1,2
10169953,10171303,1350,0,0,1,1
10171084,10171094,10,1,0,0,2
10171095,10171305,210,0,0,1,2
10171304,10171323,19,1,0,0,1
10171306,10171329,23,1,0,0,2
10171324,10171365,41,0,0,1,1
10171330,10171520,190,0,0,1,2
10171366,10171412,46,1,0,0,1
10171413,10171519,106,0,0,1,1
10171520,10171549,29,1,0,0,1
10171521,10171551,30,1,0,0,2
10171550,10171698,148,0,0,1,1
10171552,10171696,144,0,0,1,2
10171697,10171740,43,1,0,0,2
10171699,10171746,47,1,0,0,1
10171741,10171969,228,0,0,1,2
10171747,10171972,225,0,0,1,1
10171970,10171990,20,1,0,0,2
10171973,10172027,54,1,0,0,1
10171991,10172219,228,0,0,1,2
10172028,10172131,103,0,0,1,1
10172132,10172142,10,1,0,0,1
10172143,10172175,32,0,0,1,1
10172176,10172265,89,1,0,0,1
10172220,10172250,30,1,0,0,2
10172251,10172866,615,0,0,1,2
10172266,10172626,360,0,0,1,1
10172627,10172631,4,1,0,0,1
10172632,10173474,842,0,0,1,1
10172867,10172880,13,1,0,0,2
10172881,10173467,586,0,0,1,2
10173468,10173480,12,1,0,0,2
10173475,10173536,61,1,0,0,1
10173481,10173767,286,0,0,1,2
10173537,10173573,36,0,0,1,1
10173574,10173828,254,1,0,0,1
10173768,10173775,7,1,0,0,2
10173776,10174033,257,0,0,1,2
10173829,10173849,20,0,0,1,1
10173850,10173877,27,1,0,0,1
10173878,10173914,36,0,0,1,1
10173915,10173939,24,1,0,0,1
10173940,10174032,92,0,0,1,1
10174033,10174337,304,1,0,0,1
10174034,10174396,362,1,0,0,2
10174100,10174216,116,0,1,0,2
10174102,10174223,121,0,1,0,1
10174244,10174250,6,0,1,0,1
10174338,10174599,261,0,0,1,1
10174397,10174601,204,0,0,1,2
10174600,10174645,45,1,0,0,1
10174602,10174643,41,1,0,0,2
10174644,10175095,451,0,0,1,2
10174646,10175096,450,0,0,1,1
10175096,10175149,53,1,0,0,2
10175097,10175150,53,1,0,0,1
10175150,10175259,109,0,0,1,2
10175151,10175255,104,0,0,1,1
10175256,10175367,111,1,0,0,1
10175260,10175337,77,1,0,0,2
10175338,10175480,142,0,0,1,2
10175368,10175480,112,0,0,1,1
10175481,10175555,74,1,0,0,1
10175481,10175561,80,1,0,0,2
10175556,10175694,138,0,0,1,1
10175562,10175696,134,0,0,1,2
10175695,10175720,25,1,0,0,1
10175697,10175721,24,1,0,0,2
10175721,10175919,198,0,0,1,1
10175722,10175921,199,0,0,1,2
10175920,10175938,18,1,0,0,1
10175922,10175941,19,1,0,0,2
10175939,10176122,183,0,0,1,1
10175942,10176121,179,0,0,1,2
10176122,10176130,8,1,0,0,2
10176123,10176133,10,1,0,0,1
10176131,10176583,452,0,0,1,2
10176134,10176575,441,0,0,1,1
10176576,10176593,17,1,0,0,1
10176584,10176592,8,1,0,0,2
10176593,10176776,183,0,0,1,2
10176594,10176770,176,0,0,1,1
10176771,10176790,19,1,0,0,1
10176777,10176792,15,1,0,0,2
10176791,10176957,166,0,0,1,1
10176793,10176964,171,0,0,1,2
10176958,10176977,19,1,0,0,1
10176965,10176974,9,1,0,0,2
10176975,10177168,193,0,0,1,2
10176978,10177648,670,0,0,1,1
10177169,10177173,4,1,0,0,2
10177174,10177649,475,0,0,1,2
10177649,10177661,12,1,0,0,1
10177650,10177660,10,1,0,0,2
10177661,10177799,138,0,0,1,2
10177662,10177792,130,0,0,1,1
10177793,10177866,73,1,0,0,1
10177800,10177889,89,1,0,0,2
10177867,10177970,103,0,0,1,1
10177890,10177965,75,0,0,1,2
10177966,10178051,85,1,0,0,2
10177971,10178042,71,1,0,0,1
10178043,10178176,133,0,0,1,1
10178052,10178173,121,0,0,1,2
10178174,10178201,27,1,0,0,2
10178177,10178196,19,1,0,0,1
10178197,10178538,341,0,0,1,1
10178202,10178450,248,0,0,1,2
10178451,10178581,130,1,0,0,2
10178539,10178556,17,1,0,0,1
10178557,10178732,175,0,0,1,1
10178582,10178728,146,0,0,1,2
10178729,10180500,1771,1,0,0,2
10178733,10178751,18,1,0,0,1
10178752,10179358,606,0,0,1,1
10179359,10179380,21,1,0,0,1
10179381,10179570,189,0,0,1,1
10179571,10179586,15,1,0,0,1
10179587,10179854,267,0,0,1,1
10179855,10179866,11,1,0,0,1
10179867,10180084,217,0,0,1,1
10180085,10180528,443,1,0,0,1
10180151,10180291,140,0,1,0,1
10180160,10180269,109,0,1,0,2
10180316,10180324,8,0,1,0,1
10180501,10180778,277,0,0,1,2
10180529,10180587,58,0,0,1,1
10180588,10180601,13,1,0,0,1
10180602,10180776,174,0,0,1,1
10180777,10180822,45,1,0,0,1
10180779,10180822,43,1,0,0,2
10180823,10181050,227,0,0,1,1
10180823,10181051,228,0,0,1,2
10181051,10181112,61,1,0,0,1
10181052,10181099,47,1,0,0,2
10181100,10181784,684,0,0,1,2
10181113,10181793,680,0,0,1,1
10181785,10181816,31,1,0,0,2
10181794,10181806,12,1,0,0,1
10181807,10182131,324,0,0,1,1
10181817,10181941,124,0,0,1,2
10181942,10181981,39,1,0,0,2
10181982,10182127,145,0,0,1,2
10182128,10182151,23,1,0,0,2
10182132,10182163,31,1,0,0,1
10182152,10182267,115,0,0,1,2
10182164,10182278,114,0,0,1,1
10182268,10182292,24,1,0,0,2
10182279,10182293,14,1,0,0,1
10182293,10182422,129,0,0,1,2
10182294,10182626,332,0,0,1,1
10182423,10182436,13,1,0,0,2
10182437,10182615,178,0,0,1,2
10182616,10182640,24,1,0,0,2
10182627,10182662,35,1,0,0,1
10182641,10182780,139,0,0,1,2
10182663,10182784,121,0,0,1,1
10182781,10182793,12,1,0,0,2
10182785,10182804,19,1,0,0,1
10182794,10183052,258,0,0,1,2
10182805,10183052,247,0,0,1,1
10183053,10183106,53,1,0,0,2
10183053,10183145,92,1,0,0,1
10183107,10183248,141,0,0,1,2
10183146,10183248,102,0,0,1,1
10183249,10183272,23,1,0,0,2
10183249,10183303,54,1,0,0,1
10183273,10183470,197,0,0,1,2
10183304,10183389,85,0,0,1,1
10183390,10183411,21,1,0,0,1
10183412,10183470,58,0,0,1,1
10183471,10183491,20,1,0,0,1
10183471,10183491,20,1,0,0,2
10183492,10183686,194,0,0,1,1
10183492,10184302,810,0,0,1,2
10183687,10183702,15,1,0,0,1
10183703,10184306,603,0,0,1,1
10184303,10184324,21,1,0,0,2
10184307,10184323,16,1,0,0,1
10184324,10185201,877,0,0,1,1
10184325,10184573,248,0,0,1,2
10184574,10184578,4,1,0,0,2
10184579,10185387,808,0,0,1,2
10185202,10185281,79,1,0,0,1
10185282,10185396,114,0,0,1,1
10185388,10185552,164,1,0,0,2
10185397,10185423,26,1,0,0,1
10185424,10185491,67,0,0,1,1
10185492,10185580,88,1,0,0,1
10185553,10185573,20,0,0,1,2
10185574,10185614,40,1,0,0,2
10185581,10186084,503,0,0,1,1
10185615,10185689,74,0,0,1,2
10185690,10185697,7,1,0,0,2
10185698,10186078,380,0,0,1,2
10186079,10186130,51,1,0,0,2
10186085,10186118,33,1,0,0,1
10186119,10186380,261,0,0,1,1
10186131,10186229,98,0,0,1,2
10186230,10186235,5,1,0,0,2
10186236,10186382,146,0,0,1,2
10186381,10186404,23,1,0,0,1
10186383,10186401,18,1,0,0,2
10186402,10186521,119,0,0,1,2
10186405,10186525,120,0,0,1,1
10186522,10186572,50,1,0,0,2
10186526,10186567,41,1,0,0,1
10186568,10186718,150,0,0,1,1
10186573,10186717,144,0,0,1,2
10186718,10186744,26,1,0,0,2
10186719,10186744,25,1,0,0,1
10186745,10186936,191,0,0,1,2
10186745,10187107,362,0,0,1,1
10186937,10186946,9,1,0,0,2
10186947,10187101,154,0,0,1,2
10187102,10187124,22,1,0,0,2
10187108,10187125,17,1,0,0,1
10187125,10187307,182,0,0,1,2
10187126,10187306,180,0,0,1,1
10187307,10187333,26,1,0,0,1
10187308,10187342,34,1,0,0,2
10187334,10187474,140,0,0,1,1
10187343,10187469,126,0,0,1,2
10187470,10187496,26,1,0,0,2
10187475,10187494,19,1,0,0,1
10187495,10187652,157,0,0,1,1
10187497,10187649,152,0,0,1,2
10187650,10187675,25,1,0,0,2
10187653,10187674,21,1,0,0,1
10187675,10187847,172,0,0,1,1
10187676,10187842,166,0,0,1,2
10187843,10187864,21,1,0,0,2
10187848,10187864,16,1,0,0,1
10187865,10188105,240,0,0,1,2
10187865,10188114,249,0,0,1,1
10188106,10188127,21,1,0,0,2
10188115,10188146,31,1,0,0,1
10188128,10188293,165,0,0,1,2
10188147,10188303,156,0,0,1,1
10188294,10188319,25,1,0,0,2
10188304,10188316,12,1,0,0,1
10188317,10188482,165,0,0,1,1
10188320,10188484,164,0,0,1,2
10188483,10188487,4,1,0,0,1
10188485,10188499,14,1,0,0,2
10188488,10188771,283,0,0,1,1
10188500,10188768,268,0,0,1,2
10188769,10188796,27,1,0,0,2
10188772,10188802,30,1,0,0,1
10188797,10188944,147,0,0,1,2
10188803,10189118,315,0,0,1,1
10188945,10188958,13,1,0,0,2
10188959,10189123,164,0,0,1,2
10189119,10189135,16,1,0,0,1
10189124,10189130,6,1,0,0,2
10189131,10189279,148,0,0,1,2
10189136,10189283,147,0,0,1,1
10189280,10189395,115,1,0,0,2
10189284,10189347,63,1,0,0,1
10189348,10190051,703,0,0,1,1
10189396,10190045,649,0,0,1,2
10190046,10190080,34,1,0,0,2
10190052,10190062,10,1,0,0,1
10190063,10190438,375,0,0,1,1
10190081,10190144,63,0,0,1,2
10190145,10190167,22,1,0,0,2
10190168,10190359,191,0,0,1,2
10190360,10190401,41,1,0,0,2
10190402,10190432,30,0,0,1,2
10190433,10190463,30,1,0,0,2
10190439,10190459,20,1,0,0,1
10190460,10190654,194,0,0,1,1
10190464,10190598,134,0,0,1,2
10190599,10190686,87,1,0,0,2
10190655,10190663,8,1,0,0,1
10190664,10190826,162,0,0,1,1
10190687,10190825,138,0,0,1,2
10190826,10190855,29,1,0,0,2
10190827,10190853,26,1,0,0,1
10190854,10190982,128,0,0,1,1
10190856,10190968,112,0,0,1,2
10190969,10191464,495,1,0,0,2
10190983,10191020,37,1,0,0,1
10191021,10191141,120,0,0,1,1
10191142,10191160,18,1,0,0,1
10191161,10191309,148,0,0,1,1
10191310,10191328,18,1,0,0,1
10191329,10191518,189,0,0,1,1
10191465,10191506,41,0,0,1,2
10191507,10191912,405,1,0,0,2
10191519,10191955,436,1,0,0,1
10191558,10191793,235,0,1,0,1
10191560,10191769,209,0,1,0,2
10191818,10191828,10,0,1,0,1
10191913,10192239,326,0,0,1,2
10191956,10192239,283,0,0,1,1
10192240,10192282,42,1,0,0,1
10192240,10192284,44,1,0,0,2
10192283,10193229,946,0,0,1,1
10192285,10193225,940,0,0,1,2
10193226,10193282,56,1,0,0,2
10193230,10193275,45,1,0,0,1
10193276,10193424,148,0,0,1,1
10193283,10193424,141,0,0,1,2
10193425,10193443,18,1,0,0,1
10193425,10193444,19,1,0,0,2
10193444,10193605,161,0,0,1,1
10193445,10193597,152,0,0,1,2
10193598,10193615,17,1,0,0,2
10193606,10193617,11,1,0,0,1
10193616,10194561,945,0,0,1,2
10193618,10193828,210,0,0,1,1
10193829,10193834,5,1,0,0,1
10193835,10194568,733,0,0,1,1
10194562,10194580,18,1,0,0,2
10194569,10194579,10,1,0,0,1
10194580,10194773,193,0,0,1,1
10194581,10194775,194,0,0,1,2
10194774,10194802,28,1,0,0,1
10194776,10194800,24,1,0,0,2
10194801,10194911,110,0,0,1,2
10194803,10194910,107,0,0,1,1
10194911,10194925,14,1,0,0,1
10194912,10194933,21,1,0,0,2
10194926,10195221,295,0,0,1,1
10194934,10195221,287,0,0,1,2
10195222,10195265,43,1,0,0,2
10195222,10195292,70,1,0,0,1
10195266,10195467,201,0,0,1,2
10195293,10195472,179,0,0,1,1
10195468,10195499,31,1,0,0,2
10195473,10195501,28,1,0,0,1
10195500,10197249,1749,0,0,1,2
10195502,10197240,1738,0,0,1,1
10197241,10197732,491,1,0,0,1
10197250,10197737,487,1,0,0,2
10197302,10197601,299,0,1,0,2
10197305,10197596,291,0,1,0,1
10197733,10197854,121,0,0,1,1
10197738,10197857,119,0,0,1,2
10197855,10197914,59,1,0,0,1
10197858,10197909,51,1,0,0,2
10197910,10198030,120,0,0,1,2
10197915,10198037,122,0,0,1,1
10198031,10198610,579,1,0,0,2
10198038,10198625,587,1,0,0,1
10198103,10198545,442,0,1,0,2
10198103,10198552,449,0,1,0,1
10198611,10198802,191,0,0,1,2
10198626,10198803,177,0,0,1,1
10198803,10199134,331,1,0,0,2
10198804,10199103,299,1,0,0,1
10198841,10199050,209,0,1,0,1
10198844,10199043,199,0,1,0,2
10199104,10199283,179,0,0,1,1
10199135,10199284,149,0,0,1,2
10199284,10199367,83,1,0,0,1
10199285,10199350,65,1,0,0,2
10199351,10199532,181,0,0,1,2
10199368,10199533,165,0,0,1,1
10199533,10199565,32,1,0,0,2
10199534,10199584,50,1,0,0,1
10199566,10199609,43,0,0,1,2
10199585,10199700,115,0,0,1,1
10199610,10199657,47,1,0,0,2
10199658,10199704,46,0,0,1,2
10199701,10199724,23,1,0,0,1
10199705,10200918,1213,1,0,0,2
10199725,10200028,303,0,0,1,1
10200029,10200437,408,1,0,0,1
10200050,10200459,409,0,1,0,2
10200064,10200334,270,0,1,0,1
10200438,10200634,196,0,0,1,1
10200635,10200663,28,1,0,0,1
10200664,10200954,290,0,0,1,1
10200919,10201073,154,0,0,1,2
10200955,10200983,28,1,0,0,1
10200984,10201162,178,0,0,1,1
10201074,10205186,4112,1,0,0,2
10201163,10201174,11,1,0,0,1
10201175,10201378,203,0,0,1,1
10201379,10201397,18,1,0,0,1
10201398,10201697,299,0,0,1,1
10201698,10201716,18,1,0,0,1
10201717,10201882,165,0,0,1,1
10201883,10201905,22,1,0,0,1
10201906,10202516,610,0,0,1,1
10202517,10202562,45,1,0,0,1
10202538,10202803,265,0,1,0,2
10202563,10202697,134,0,0,1,1
10202698,10202728,30,1,0,0,1
10202729,10202816,87,0,0,1,1
10202817,10202835,18,1,0,0,1
10202827,10203613,786,0,1,0,2
10202836,10202923,87,0,0,1,1
10202924,10202931,7,1,0,0,1
10202932,10202968,36,0,0,1,1
10202969,10203016,47,1,0,0,1
10203017,10203348,331,0,0,1,1
10203349,10203364,15,1,0,0,1
10203365,10203661,296,0,0,1,1
10203662,10203687,25,1,0,0,1
10203670,10203692,22,0,1,0,2
10203688,10204192,504,0,0,1,1
10203713,10203733,20,0,1,0,2
10203773,10203829,56,0,1,0,2
10203902,10204192,290,0,1,0,2
10204193,10204211,18,1,0,0,1
10204212,10204364,152,0,0,1,1
10204226,10204964,738,0,1,0,2
10204365,10204393,28,1,0,0,1
10204394,10204545,151,0,0,1,1
10204546,10205174,628,1,0,0,1
10204720,10204970,250,0,1,0,1
10205175,10205360,185,0,0,1,1
10205187,10205362,175,0,0,1,2
10205361,10205406,45,1,0,0,1
10205363,10205402,39,1,0,0,2
10205403,10205659,256,0,0,1,2
10205407,10205492,85,0,0,1,1
10205493,10205537,44,1,0,0,1
10205538,10205634,96,0,0,1,1
10205635,10205700,65,1,0,0,1
10205660,10205697,37,1,0,0,2
10205698,10205782,84,0,0,1,2
10205701,10205780,79,0,0,1,1
10205781,10205847,66,1,0,0,1
10205783,10205831,48,1,0,0,2
10205832,10206009,177,0,0,1,2
10205848,10206009,161,0,0,1,1
10206010,10206063,53,1,0,0,1
10206010,10206087,77,1,0,0,2
10206064,10206264,200,0,0,1,1
10206088,10206263,175,0,0,1,2
10206264,10206288,24,1,0,0,2
10206265,10206287,22,1,0,0,1
10206288,10206811,523,0,0,1,1
10206289,10206781,492,0,0,1,2
10206782,10208699,1917,1,0,0,2
10206812,10207148,336,1,0,0,1
10206831,10207033,202,0,1,0,2
10206835,10207000,165,0,1,0,1
10207149,10207326,177,0,0,1,1
10207327,10207337,10,1,0,0,1
10207338,10207523,185,0,0,1,1
10207524,10207558,34,1,0,0,1
10207559,10207753,194,0,0,1,1
10207754,10207768,14,1,0,0,1
10207769,10208338,569,0,0,1,1
10208339,10208360,21,1,0,0,1
10208361,10208584,223,0,0,1,1
10208585,10208652,67,1,0,0,1
10208653,10208770,117,0,0,1,1
10208700,10208771,71,0,0,1,2
10208771,10208812,41,1,0,0,1
10208772,10208803,31,1,0,0,2
10208804,10209024,220,0,0,1,2
10208813,10209025,212,0,0,1,1
10209025,10209050,25,1,0,0,2
10209026,10209051,25,1,0,0,1
10209051,10209258,207,0,0,1,2
10209052,10209252,200,0,0,1,1
10209253,10209275,22,1,0,0,1
10209259,10209289,30,1,0,0,2
10209276,10209398,122,0,0,1,1
10209290,10209405,115,0,0,1,2
10209399,10209430,31,1,0,0,1
10209406,10209429,23,1,0,0,2
10209430,10210347,917,0,0,1,2
10209431,10209582,151,0,0,1,1
10209583,10209594,11,1,0,0,1
10209595,10210348,753,0,0,1,1
10210348,10210382,34,1,0,0,2
10210349,10210369,20,1,0,0,1
10210370,10211451,1081,0,0,1,1
10210383,10210728,345,0,0,1,2
10210729,10210761,32,1,0,0,2
10210762,10210843,81,0,0,1,2
10210844,10210849,5,1,0,0,2
10210850,10210879,29,0,0,1,2
10210880,10210940,60,1,0,0,2
10210941,10210979,38,0,0,1,2
10210980,10211499,519,1,0,0,2
10211452,10211518,66,1,0,0,1
10211500,10211599,99,0,0,1,2
10211519,10211598,79,0,0,1,1
10211599,10212054,455,1,0,0,1
10211600,10221244,9644,1,0,0,2
10211735,10211948,213,0,1,0,2
10211739,10211956,217,0,1,0,1
10212055,10212196,141,0,0,1,1
10212197,10212219,22,1,0,0,1
10212220,10212365,145,0,0,1,1
10212366,10212382,16,1,0,0,1
10212383,10212696,313,0,0,1,1
10212697,10212709,12,1,0,0,1
10212710,10213122,412,0,0,1,1
10213123,10213133,10,1,0,0,1
10213134,10213631,497,0,0,1,1
10213632,10213650,18,1,0,0,1
10213651,10213837,186,0,0,1,1
10213838,10213853,15,1,0,0,1
10213854,10214594,740,0,0,1,1
10214595,10214630,35,1,0,0,1
10214631,10214830,199,0,0,1,1
10214831,10214842,11,1,0,0,1
10214843,10215218,375,0,0,1,1
10215219,10215288,69,1,0,0,1
10215289,10215346,57,0,0,1,1
10215347,10215439,92,1,0,0,1
10215440,10215592,152,0,0,1,1
10215593,10215617,24,1,0,0,1
10215618,10215963,345,0,0,1,1
10215964,10215985,21,1,0,0,1
10215986,10216644,658,0,0,1,1
10216645,10216667,22,1,0,0,1
10216668,10216812,144,0,0,1,1
10216813,10216869,56,1,0,0,1
10216870,10216954,84,0,0,1,1
10216955,10218508,1553,1,0,0,1
10217053,10217504,451,0,1,0,2
10217241,10217526,285,0,1,0,1
10217575,10217707,132,0,1,0,1
10218509,10218543,34,0,0,1,1
10218544,10218736,192,1,0,0,1
10218737,10218872,135,0,0,1,1
10218873,10218969,96,1,0,0,1
10218970,10218999,29,0,0,1,1
10219000,10219017,17,1,0,0,1
10219018,10219083,65,0,0,1,1
10219084,10219311,227,1,0,0,1
10219312,10219341,29,0,0,1,1
10219342,10219388,46,1,0,0,1
10219389,10219472,83,0,0,1,1
10219473,10219748,275,1,0,0,1
10219749,10219899,150,0,0,1,1
10219900,10220150,250,1,0,0,1
10220151,10220211,60,0,0,1,1
10220212,10220631,419,1,0,0,1
10220632,10220661,29,0,0,1,1
10220662,10221693,1031,1,0,0,1
10221245,10221272,27,0,0,1,2
10221273,10221299,26,1,0,0,2
10221300,10221365,65,0,0,1,2
10221366,10221430,64,1,0,0,2
10221431,10221505,74,0,0,1,2
10221506,10221526,20,1,0,0,2
10221527,10221558,31,0,0,1,2
10221559,10224119,2560,1,0,0,2
10221591,10222242,651,0,1,0,2
10221605,10221683,78,0,1,0,1
10221694,10221747,53,0,0,1,1
10221748,10222640,892,1,0,0,1
10221759,10221763,4,0,1,0,1
10222641,10222717,76,0,0,1,1
10222718,10222955,237,1,0,0,1
10222956,10223010,54,0,0,1,1
10223011,10223034,23,1,0,0,1
10223035,10223133,98,0,0,1,1
10223134,10223278,144,1,0,0,1
10223279,10223324,45,0,0,1,1
10223325,10224167,842,1,0,0,1
10223729,10223738,9,0,1,0,2
10223780,10224018,238,0,1,0,2
10223805,10224021,216,0,1,0,1
10224045,10224051,6,0,1,0,1
10224120,10224496,376,0,0,1,2
10224168,10224476,308,0,0,1,1
10224477,10224547,70,1,0,0,1
10224497,10224537,40,1,0,0,2
10224538,10225081,543,0,0,1,2
10224548,10225080,532,0,0,1,1
10225081,10225146,65,1,0,0,1
10225082,10225118,36,1,0,0,2
10225119,10225362,243,0,0,1,2
10225147,10225265,118,0,0,1,1
10225266,10225278,12,1,0,0,1
10225279,10225364,85,0,0,1,1
10225363,10225433,70,1,0,0,2
10225365,10227315,1950,1,0,0,1
10225434,10225551,117,0,0,1,2
10225552,10225575,23,1,0,0,2
10225576,10225917,341,0,0,1,2
10225918,10226251,333,1,0,0,2
10226252,10226316,64,0,0,1,2
10226317,10226680,363,1,0,0,2
10226681,10226849,168,0,0,1,2
10226850,10226937,87,1,0,0,2
10226938,10226977,39,0,0,1,2
10226978,10229654,2676,1,0,0,2
10227089,10227096,7,0,1,0,2
10227316,10227409,93,0,0,1,1
10227410,10227540,130,1,0,0,1
10227541,10227633,92,0,0,1,1
10227634,10227788,154,1,0,0,1
10227789,10227819,30,0,0,1,1
10227820,10227942,122,1,0,0,1
10227943,10228020,77,0,0,1,1
10228021,10228329,308,1,0,0,1
10228090,10228129,39,0,1,0,2
10228330,10228354,24,0,0,1,1
10228355,10228404,49,1,0,0,1
10228405,10228435,30,0,0,1,1
10228436,10229612,1176,1,0,0,1
10228497,10229451,954,0,1,0,2
10228818,10229428,610,0,1,0,1
10229454,10229466,12,0,1,0,1
10229613,10230077,464,0,0,1,1
10229655,10230315,660,0,0,1,2
10230078,10230097,19,1,0,0,1
10230098,10230312,214,0,0,1,1
10230313,10230361,48,1,0,0,1
10230316,10230364,48,1,0,0,2
10230362,10230450,88,0,0,1,1
10230365,10230444,79,0,0,1,2
10230445,10230486,41,1,0,0,2
10230451,10230481,30,1,0,0,1
10230482,10230710,228,0,0,1,1
10230487,10230708,221,0,0,1,2
10230709,10230726,17,1,0,0,2
10230711,10230726,15,1,0,0,1
10230727,10231210,483,0,0,1,2
10230727,10231215,488,0,0,1,1
10231211,10231225,14,1,0,0,2
10231216,10231220,4,1,0,0,1
10231221,10231664,443,0,0,1,1
10231226,10231657,431,0,0,1,2
10231658,10231677,19,1,0,0,2
10231665,10231676,11,1,0,0,1
10231677,10232298,621,0,0,1,1
10231678,10231834,156,0,0,1,2
10231835,10231844,9,1,0,0,2
10231845,10232292,447,0,0,1,2
10232293,10232393,100,1,0,0,2
10232299,10232403,104,1,0,0,1
10232394,10232706,312,0,0,1,2
10232404,10232505,101,0,0,1,1
10232506,10232513,7,1,0,0,1
10232514,10232696,182,0,0,1,1
10232697,10232776,79,1,0,0,1
10232707,10232726,19,1,0,0,2
10232727,10232954,227,0,0,1,2
10232777,10232909,132,0,0,1,1
10232910,10233055,145,1,0,0,1
10232955,10232973,18,1,0,0,2
10232974,10233461,487,0,0,1,2
10233056,10233100,44,0,0,1,1
10233101,10233216,115,1,0,0,1
10233217,10233452,235,0,0,1,1
10233453,10233537,84,1,0,0,1
10233462,10233476,14,1,0,0,2
10233477,10233566,89,0,0,1,2
10233538,10233629,91,0,0,1,1
10233567,10233768,201,1,0,0,2
10233630,10233931,301,1,0,0,1
10233769,10233884,115,0,0,1,2
10233885,10233943,58,1,0,0,2
10233932,10233999,67,0,0,1,1
10233944,10233994,50,0,0,1,2
10233995,10235368,1373,1,0,0,2
10234000,10234928,928,1,0,0,1
10234470,10234840,370,0,1,0,1
10234477,10234811,334,0,1,0,2
10234929,10234970,41,0,0,1,1
10234971,10234989,18,1,0,0,1
10234990,10235106,116,0,0,1,1
10235107,10235173,66,1,0,0,1
10235174,10235318,144,0,0,1,1
10235319,10235368,49,1,0,0,1
10235369,10235698,329,0,0,1,1
10235369,10235699,330,0,0,1,2
10235699,10235752,53,1,0,0,1
10235700,10235746,46,1,0,0,2
10235747,10235868,121,0,0,1,2
10235753,10235870,117,0,0,1,1
10235869,10235905,36,1,0,0,2
10235871,10235924,53,1,0,0,1
10235906,10236017,111,0,0,1,2
10235925,10236023,98,0,0,1,1
10236018,10236095,77,1,0,0,2
10236024,10236100,76,1,0,0,1
10236096,10236735,639,0,0,1,2
10236101,10237057,956,0,0,1,1
10236736,10236754,18,1,0,0,2
10236755,10237053,298,0,0,1,2
10237054,10237078,24,1,0,0,2
10237058,10237078,20,1,0,0,1
10237079,10237196,117,0,0,1,2
10237079,10237199,120,0,0,1,1
10237197,10237222,25,1,0,0,2
10237200,10237219,19,1,0,0,1
10237220,10237514,294,0,0,1,1
10237223,10237407,184,0,0,1,2
10237408,10237418,10,1,0,0,2
10237419,10237512,93,0,0,1,2
10237513,10237535,22,1,0,0,2
10237515,10237529,14,1,0,0,1
10237530,10237724,194,0,0,1,1
10237536,10237723,187,0,0,1,2
10237724,10237749,25,1,0,0,2
10237725,10237748,23,1,0,0,1
10237749,10237905,156,0,0,1,1
10237750,10237903,153,0,0,1,2
10237904,10237936,32,1,0,0,2
10237906,10237931,25,1,0,0,1
10237932,10238059,127,0,0,1,1
10237937,10238055,118,0,0,1,2
10238056,10238085,29,1,0,0,2
10238060,10238085,25,1,0,0,1
10238086,10238234,148,0,0,1,2
10238086,10238236,150,0,0,1,1
10238235,10238530,295,1,0,0,2
10238237,10238388,151,1,0,0,1
10238389,10238742,353,0,0,1,1
10238531,10238555,24,0,0,1,2
10238556,10238661,105,1,0,0,2
10238662,10238708,46,0,0,1,2
10238709,10240930,2221,1,0,0,2
10238743,10238755,12,1,0,0,1
10238756,10239023,267,0,0,1,1
10239024,10239050,26,1,0,0,1
10239051,10239363,312,0,0,1,1
10239364,10239440,76,1,0,0,1
10239441,10239544,103,0,0,1,1
10239545,10239592,47,1,0,0,1
10239593,10239637,44,0,0,1,1
10239638,10239702,64,1,0,0,1
10239703,10239768,65,0,0,1,1
10239769,10239807,38,1,0,0,1
10239808,10239918,110,0,0,1,1
10239919,10239957,38,1,0,0,1
10239958,10239991,33,0,0,1,1
10239992,10240045,53,1,0,0,1
10240046,10240172,126,0,0,1,1
10240173,10240189,16,1,0,0,1
10240190,10240228,38,0,0,1,1
10240229,10240287,58,1,0,0,1
10240288,10240321,33,0,0,1,1
10240322,10240930,608,1,0,0,1
10240416,10240604,188,0,1,0,1
10240418,10240543,125,0,1,0,2
10240931,10241117,186,0,0,1,2
10240931,10241121,190,0,0,1,1
10241118,10241148,30,1,0,0,2
10241122,10241157,35,1,0,0,1
10241149,10241480,331,0,0,1,2
10241158,10241481,323,0,0,1,1
10241481,10241518,37,1,0,0,2
10241482,10241518,36,1,0,0,1
10241519,10241662,143,0,0,1,1
10241519,10241663,144,0,0,1,2
10241663,10241688,25,1,0,0,1
10241664,10241685,21,1,0,0,2
10241686,10242037,351,0,0,1,2
10241689,10242037,348,0,0,1,1
10242038,10242083,45,1,0,0,2
10242038,10242087,49,1,0,0,1
10242084,10242220,136,0,0,1,2
10242088,10242219,131,0,0,1,1
10242220,10242242,22,1,0,0,1
10242221,10242241,20,1,0,0,2
10242242,10242484,242,0,0,1,2
10242243,10242486,243,0,0,1,1
10242485,10242502,17,1,0,0,2
10242487,10242503,16,1,0,0,1
10242503,10242648,145,0,0,1,2
10242504,10242652,148,0,0,1,1
10242649,10242665,16,1,0,0,2
10242653,10242665,12,1,0,0,1
10242666,10242820,154,0,0,1,1
10242666,10242825,159,0,0,1,2
10242821,10242842,21,1,0,0,1
10242826,10242842,16,1,0,0,2
10242843,10242970,127,0,0,1,2
10242843,10242973,130,0,0,1,1
10242971,10242993,22,1,0,0,2
10242974,10242992,18,1,0,0,1
10242993,10243142,149,0,0,1,1
10242994,10243141,147,0,0,1,2
10243142,10243159,17,1,0,0,2
10243143,10243158,15,1,0,0,1
10243159,10243665,506,0,0,1,1
10243160,10243554,394,0,0,1,2
10243555,10243764,209,1,0,0,2
10243666,10243741,75,1,0,0,1
10243742,10243874,132,0,0,1,1
10243765,10243869,104,0,0,1,2
10243870,10243888,18,1,0,0,2
10243875,10243891,16,1,0,0,1
10243889,10244059,170,0,0,1,2
10243892,10244057,165,0,0,1,1
10244058,10244076,18,1,0,0,1
10244060,10244079,19,1,0,0,2
10244077,10245350,1273,0,0,1,1
10244080,10245339,1259,0,0,1,2
10245340,10246035,695,1,0,0,2
10245351,10245355,4,1,0,0,1
10245356,10245497,141,0,0,1,1
10245498,10245696,198,1,0,0,1
10245697,10245892,195,0,0,1,1
10245893,10245944,51,1,0,0,1
10245945,10246128,183,0,0,1,1
10246036,10246130,94,0,0,1,2
10246129,10246199,70,1,0,0,1
10246131,10246195,64,1,0,0,2
10246196,10246293,97,0,0,1,2
10246200,10246388,188,0,0,1,1
10246294,10246338,44,1,0,0,2
10246339,10246544,205,0,0,1,2
10246389,10246399,10,1,0,0,1
10246400,10246547,147,0,0,1,1
10246545,10246589,44,1,0,0,2
10246548,10246586,38,1,0,0,1
10246587,10246742,155,0,0,1,1
10246590,10246741,151,0,0,1,2
10246742,10246783,41,1,0,0,2
10246743,10246798,55,1,0,0,1
10246784,10246959,175,0,0,1,2
10246799,10246960,161,0,0,1,1
10246960,10249876,2916,1,0,0,2
10246961,10247091,130,1,0,0,1
10247092,10247182,90,0,0,1,1
10247183,10247212,29,1,0,0,1
10247213,10247380,167,0,0,1,1
10247381,10247680,299,1,0,0,1
10247403,10247652,249,0,1,0,2
10247407,10247604,197,0,1,0,1
10247681,10247765,84,0,0,1,1
10247766,10247786,20,1,0,0,1
10247787,10248375,588,0,0,1,1
10248376,10248447,71,1,0,0,1
10248448,10248564,116,0,0,1,1
10248565,10248576,11,1,0,0,1
10248577,10248956,379,0,0,1,1
10248957,10248988,31,1,0,0,1
10248989,10249104,115,0,0,1,1
10249105,10249133,28,1,0,0,1
10249134,10249501,367,0,0,1,1
10249502,10249546,44,1,0,0,1
10249547,10249668,121,0,0,1,1
10249669,10249709,40,1,0,0,1
10249710,10250189,479,0,0,1,1
10249877,10249910,33,0,0,1,2
10249911,10250267,356,1,0,0,2
10250190,10250208,18,1,0,0,1
10250209,10250397,188,0,0,1,1
10250268,10250296,28,0,0,1,2
10250297,10250457,160,1,0,0,2
10250398,10250420,22,1,0,0,1
10250421,10250511,90,0,0,1,1
10250458,10250483,25,0,0,1,2
10250484,10250623,139,1,0,0,2
10250512,10250527,15,1,0,0,1
10250528,10250562,34,0,0,1,1
10250563,10250587,24,1,0,0,1
10250588,10250736,148,0,0,1,1
10250624,10250645,21,0,0,1,2
10250646,10252071,1425,1,0,0,2
10250737,10250759,22,1,0,0,1
10250760,10250899,139,0,0,1,1
10250900,10250939,39,1,0,0,1
10250940,10251184,244,0,0,1,1
10251185,10251197,12,1,0,0,1
10251198,10251387,189,0,0,1,1
10251388,10251422,34,1,0,0,1
10251423,10251563,140,0,0,1,1
10251564,10252128,564,1,0,0,1
10251599,10251838,239,0,1,0,2
10251607,10251827,220,0,1,0,1
10251854,10251862,8,0,1,0,1
10252072,10252242,170,0,0,1,2
10252129,10252256,127,0,0,1,1
10252243,10252292,49,1,0,0,2
10252257,10252361,104,1,0,0,1
10252293,10252431,138,0,0,1,2
10252362,10252460,98,0,0,1,1
10252432,10252715,283,1,0,0,2
10252461,10252489,28,1,0,0,1
10252490,10252636,146,0,0,1,1
10252637,10252676,39,1,0,0,1
10252677,10252821,144,0,0,1,1
10252716,10252824,108,0,0,1,2
10252822,10252867,45,1,0,0,1
10252825,10252879,54,1,0,0,2
10252868,10252965,97,0,0,1,1
10252880,10252905,25,0,0,1,2
10252906,10252916,10,1,0,0,2
10252917,10252966,49,0,0,1,2
10252966,10256259,3293,1,0,0,1
10252967,10256426,3459,1,0,0,2
10253579,10253583,4,0,1,0,2
10253619,10256222,2603,0,1,0,2
10253759,10253817,58,0,1,0,1
10254553,10254565,12,0,1,0,1
10254713,10256116,1403,0,1,0,1
10256260,10256290,30,0,0,1,1
10256291,10256357,66,1,0,0,1
10256358,10256568,210,0,0,1,1
10256427,10256540,113,0,0,1,2
10256541,10256578,37,1,0,0,2
10256569,10256573,4,1,0,0,1
10256574,10256798,224,0,0,1,1
10256579,10256797,218,0,0,1,2
10256798,10256817,19,1,0,0,2
10256799,10256829,30,1,0,0,1
10256818,10256989,171,0,0,1,2
10256830,10256993,163,0,0,1,1
10256990,10257041,51,1,0,0,2
10256994,10257044,50,1,0,0,1
10257042,10257155,113,0,0,1,2
10257045,10257151,106,0,0,1,1
10257152,10257169,17,1,0,0,1
10257156,10257172,16,1,0,0,2
10257170,10257232,62,0,0,1,1
10257173,10257238,65,0,0,1,2
10257233,10257280,47,1,0,0,1
10257239,10257281,42,1,0,0,2
10257281,10257406,125,0,0,1,1
10257282,10257400,118,0,0,1,2
10257401,10257416,15,1,0,0,2
10257407,10257424,17,1,0,0,1
10257417,10257454,37,0,0,1,2
10257425,10257508,83,0,0,1,1
10257455,10257460,5,1,0,0,2
10257461,10257592,131,0,0,1,2
10257509,10257613,104,1,0,0,1
10257593,10258832,1239,1,0,0,2
10257614,10257715,101,0,0,1,1
10257716,10258828,1112,1,0,0,1
10257862,10258643,781,0,1,0,2
10257877,10257974,97,0,1,0,1
10258406,10258634,228,0,1,0,1
10258663,10258665,2,0,1,0,1
10258829,10259228,399,0,0,1,1
10258833,10259219,386,0,0,1,2
10259220,10259236,16,1,0,0,2
10259229,10259272,43,1,0,0,1
10259237,10259262,25,0,0,1,2
10259263,10259275,12,1,0,0,2
10259273,10259336,63,0,0,1,1
10259276,10259329,53,0,0,1,2
10259330,10259335,5,1,0,0,2
10259336,10259652,316,0,0,1,2
10259337,10259405,68,1,0,0,1
10259406,10259651,245,0,0,1,1
10259652,10259691,39,1,0,0,1
10259653,10259699,46,1,0,0,2
10259692,10259861,169,0,0,1,1
10259700,10259856,156,0,0,1,2
10259857,10259892,35,1,0,0,2
10259862,10259893,31,1,0,0,1
10259893,10260179,286,0,0,1,2
10259894,10260180,286,0,0,1,1
10260180,10260249,69,1,0,0,2
10260181,10260250,69,1,0,0,1
10260250,10260395,145,0,0,1,2
10260251,10260396,145,0,0,1,1
10260396,10260433,37,1,0,0,2
10260397,10260442,45,1,0,0,1
10260434,10260683,249,0,0,1,2
10260443,10260681,238,0,0,1,1
10260682,10260701,19,1,0,0,1
10260684,10260701,17,1,0,0,2
10260702,10260884,182,0,0,1,2
10260702,10260886,184,0,0,1,1
10260885,10260903,18,1,0,0,2
10260887,10260903,16,1,0,0,1
10260904,10261803,899,0,0,1,1
10260904,10261810,906,0,0,1,2
10261804,10261827,23,1,0,0,1
10261811,10261823,12,1,0,0,2
10261824,10261952,128,0,0,1,2
10261828,10261954,126,0,0,1,1
10261953,10261969,16,1,0,0,2
10261955,10261969,14,1,0,0,1
10261970,10262477,507,0,0,1,1
10261970,10262478,508,0,0,1,2
10262478,10262545,67,1,0,0,1
10262479,10262541,62,1,0,0,2
10262542,10262637,95,0,0,1,2
10262546,10262636,90,0,0,1,1
10262637,10262661,24,1,0,0,1
10262638,10262669,31,1,0,0,2
10262662,10264251,1589,0,0,1,1
10262670,10263944,1274,0,0,1,2
10263945,10263952,7,1,0,0,2
10263953,10264251,298,0,0,1,2
10264252,10264270,18,1,0,0,2
10264252,10264271,19,1,0,0,1
10264271,10264583,312,0,0,1,2
10264272,10264575,303,0,0,1,1
10264576,10265198,622,1,0,0,1
10264584,10265173,589,1,0,0,2
10264692,10265063,371,0,1,0,2
10264705,10264721,16,0,1,0,1
10264765,10265052,287,0,1,0,1
10265079,10265082,3,0,1,0,1
10265174,10265357,183,0,0,1,2
10265199,10265358,159,0,0,1,1
10265358,10265386,28,1,0,0,2
10265359,10265386,27,1,0,0,1
10265387,10265586,199,0,0,1,1
10265387,10265587,200,0,0,1,2
10265587,10265627,40,1,0,0,1
10265588,10265617,29,1,0,0,2
10265618,10266161,543,0,0,1,2
10265628,10266166,538,0,0,1,1
10266162,10266230,68,1,0,0,2
10266167,10266240,73,1,0,0,1
10266231,10266352,121,0,0,1,2
10266241,10266355,114,0,0,1,1
10266353,10266433,80,1,0,0,2
10266356,10266382,26,1,0,0,1
10266383,10266554,171,0,0,1,1
10266434,10266538,104,0,0,1,2
10266539,10266643,104,1,0,0,2
10266555,10266560,5,1,0,0,1
10266561,10266750,189,0,0,1,1
10266644,10266715,71,0,0,1,2
10266716,10266822,106,1,0,0,2
10266751,10266769,18,1,0,0,1
10266770,10266959,189,0,0,1,1
10266823,10266862,39,0,0,1,2
10266863,10268514,1651,1,0,0,2
10266960,10267004,44,1,0,0,1
10267005,10267135,130,0,0,1,1
10267136,10267148,12,1,0,0,1
10267149,10267458,309,0,0,1,1
10267459,10267472,13,1,0,0,1
10267473,10267875,402,0,0,1,1
10267876,10267927,51,1,0,0,1
10267928,10268368,440,0,0,1,1
10268369,10268456,87,1,0,0,1
10268457,10268799,342,0,0,1,1
10268515,10268803,288,0,0,1,2
10268800,10268845,45,1,0,0,1
10268804,10268850,46,1,0,0,2
10268846,10268975,129,0,0,1,1
10268851,10268971,120,0,0,1,2
10268972,10268995,23,1,0,0,2
10268976,10268993,17,1,0,0,1
10268994,10269435,441,0,0,1,1
10268996,10269078,82,0,0,1,2
10269079,10269200,121,1,0,0,2
10269201,10269411,210,0,0,1,2
10269412,10270191,779,1,0,0,2
10269436,10269476,40,1,0,0,1
10269477,10269622,145,0,0,1,1
10269623,10269978,355,1,0,0,1
10269660,10269848,188,0,1,0,2
10269668,10269792,124,0,1,0,1
10269814,10269834,20,0,1,0,1
10269979,10270015,36,0,0,1,1
10270016,10270031,15,1,0,0,1
10270032,10270537,505,0,0,1,1
10270192,10270546,354,0,0,1,2
10270538,10270631,93,1,0,0,1
10270547,10270563,16,1,0,0,2
10270564,10270626,62,0,0,1,2
10270627,10271034,407,1,0,0,2
10270632,10270658,26,0,0,1,1
10270659,10270680,21,1,0,0,1
10270681,10270710,29,0,0,1,1
10270711,10271051,340,1,0,0,1
10270757,10270948,191,0,1,0,2
10270761,10270973,212,0,1,0,1
10271035,10271245,210,0,0,1,2
10271052,10271222,170,0,0,1,1
10271223,10271264,41,1,0,0,1
10271246,10271253,7,1,0,0,2
10271254,10271302,48,0,0,1,2
10271265,10271293,28,0,0,1,1
10271294,10271606,312,1,0,0,1
10271303,10271600,297,1,0,0,2
10271326,10271523,197,0,1,0,2
10271327,10271513,186,0,1,0,1
10271601,10271684,83,0,0,1,2
10271607,10271653,46,0,0,1,1
10271654,10271734,80,1,0,0,1
10271685,10271721,36,1,0,0,2
10271722,10272057,335,0,0,1,2
10271735,10272058,323,0,0,1,1
10272058,10272103,45,1,0,0,2
10272059,10272196,137,1,0,0,1
10272104,10272379,275,0,0,1,2
10272197,10272380,183,0,0,1,1
10272380,10272417,37,1,0,0,2
10272381,10272421,40,1,0,0,1
10272418,10272578,160,0,0,1,2
10272422,10272580,158,0,0,1,1
10272579,10272634,55,1,0,0,2
10272581,10272671,90,1,0,0,1
10272635,10272791,156,0,0,1,2
10272672,10272733,61,0,0,1,1
10272734,10272866,132,1,0,0,1
10272792,10272816,24,1,0,0,2
10272817,10273643,826,0,0,1,2
10272867,10273643,776,0,0,1,1
10273644,10273654,10,1,0,0,2
10273644,10273708,64,1,0,0,1
10273655,10274226,571,0,0,1,2
10273709,10274025,316,0,0,1,1
10274026,10274075,49,1,0,0,1
10274076,10274229,153,0,0,1,1
10274227,10274238,11,1,0,0,2
10274230,10274297,67,1,0,0,1
10274239,10274538,299,0,0,1,2
10274298,10274345,47,0,0,1,1
10274346,10274372,26,1,0,0,1
10274373,10274502,129,0,0,1,1
10274503,10274796,293,1,0,0,1
10274539,10274580,41,1,0,0,2
10274581,10274713,132,0,0,1,2
10274714,10277285,2571,1,0,0,2
10274797,10275573,776,0,0,1,1
10275574,10275594,20,1,0,0,1
10275595,10275790,195,0,0,1,1
10275791,10275817,26,1,0,0,1
10275818,10275982,164,0,0,1,1
10275983,10276006,23,1,0,0,1
10276007,10276105,98,0,0,1,1
10276106,10276139,33,1,0,0,1
10276140,10276289,149,0,0,1,1
10276290,10276308,18,1,0,0,1
10276309,10276701,392,0,0,1,1
10276702,10277332,630,1,0,0,1
10276774,10277182,408,0,1,0,2
10276809,10276822,13,0,1,0,1
10276851,10277120,269,0,1,0,1
10277151,10277156,5,0,1,0,1
10277286,10277606,320,0,0,1,2
10277333,10277610,277,0,0,1,1
10277607,10277647,40,1,0,0,2
10277611,10277640,29,1,0,0,1
10277641,10277829,188,0,0,1,1
10277648,10277826,178,0,0,1,2
10277827,10277873,46,1,0,0,2
10277830,10277882,52,1,0,0,1
10277874,10278222,348,0,0,1,2
10277883,10278220,337,0,0,1,1
10278221,10278287,66,1,0,0,1
10278223,10278274,51,1,0,0,2
10278275,10278983,708,0,0,1,2
10278288,10278505,217,0,0,1,1
10278506,10278540,34,1,0,0,1
10278541,10278928,387,0,0,1,1
10278929,10278969,40,1,0,0,1
10278970,10279053,83,0,0,1,1
10278984,10279000,16,1,0,0,2
10279001,10279510,509,0,0,1,2
10279054,10279071,17,1,0,0,1
10279072,10279122,50,0,0,1,1
10279123,10279134,11,1,0,0,1
10279135,10279393,258,0,0,1,1
10279394,10279408,14,1,0,0,1
10279409,10279725,316,0,0,1,1
10279511,10279522,11,1,0,0,2
10279523,10279616,93,0,0,1,2
10279617,10279689,72,1,0,0,2
10279690,10279733,43,0,0,1,2
10279726,10283311,3585,1,0,0,1
10279734,10279848,114,1,0,0,2
10279849,10279990,141,0,0,1,2
10279991,10280084,93,1,0,0,2
10280085,10280182,97,0,0,1,2
10280183,10280207,24,1,0,0,2
10280208,10280764,556,0,0,1,2
10280765,10280844,79,1,0,0,2
10280845,10280899,54,0,0,1,2
10280900,10280937,37,1,0,0,2
10280938,10281060,122,0,0,1,2
10281061,10283679,2618,1,0,0,2
10282249,10282512,263,0,1,0,1
10282251,10282814,563,0,1,0,2
10282692,10282751,59,0,1,0,1
10283312,10283343,31,0,0,1,1
10283344,10283476,132,1,0,0,1
10283477,10283526,49,0,0,1,1
10283527,10283841,314,1,0,0,1
10283680,10283758,78,0,0,1,2
10283759,10283795,36,1,0,0,2
10283796,10283904,108,0,0,1,2
10283842,10283902,60,0,0,1,1
10283903,10284058,155,1,0,0,1
10283905,10283925,20,1,0,0,2
10283926,10284713,787,0,0,1,2
10284059,10284146,87,0,0,1,1
10284147,10284557,410,1,0,0,1
10284558,10284583,25,0,0,1,1
10284584,10284958,374,1,0,0,1
10284714,10284723,9,1,0,0,2
10284724,10284903,179,0,0,1,2
10284904,10284930,26,1,0,0,2
10284931,10285027,96,0,0,1,2
10284959,10285021,62,0,0,1,1
10285022,10285384,362,1,0,0,1
10285028,10285049,21,1,0,0,2
10285050,10285312,262,0,0,1,2
10285313,10285330,17,1,0,0,2
10285331,10285793,462,0,0,1,2
10285385,10285435,50,0,0,1,1
10285436,10285615,179,1,0,0,1
10285616,10285655,39,0,0,1,1
10285656,10286100,444,1,0,0,1
10285794,10285800,6,1,0,0,2
10285801,10286074,273,0,0,1,2
10286075,10286100,25,1,0,0,2
10286101,10286143,42,0,0,1,1
10286101,10286239,138,0,0,1,2
10286144,10286338,194,1,0,0,1
10286240,10286264,24,1,0,0,2
10286265,10286417,152,0,0,1,2
10286339,10286399,60,0,0,1,1
10286400,10286490,90,1,0,0,1
10286418,10286443,25,1,0,0,2
10286444,10286632,188,0,0,1,2
10286491,10286565,74,0,0,1,1
10286566,10286971,405,1,0,0,1
10286633,10286643,10,1,0,0,2
10286644,10287175,531,0,0,1,2
10286972,10287072,100,0,0,1,1
10287073,10289194,2121,1,0,0,1
10287176,10287222,46,1,0,0,2
10287223,10287350,127,0,0,1,2
10287351,10287376,25,1,0,0,2
10287377,10287543,166,0,0,1,2
10287544,10287567,23,1,0,0,2
10287568,10288456,888,0,0,1,2
10288457,10289068,611,1,0,0,2
10288518,10288713,195,0,1,0,2
10288525,10288656,131,0,1,0,1
10289069,10289416,347,0,0,1,2
10289195,10289423,228,0,0,1,1
10289417,10289814,397,1,0,0,2
10289424,10289730,306,1,0,0,1
10289465,10289660,195,0,1,0,2
10289478,10289644,166,0,1,0,1
10289731,10289780,49,0,0,1,1
10289781,10289815,34,1,0,0,1
10289815,10289908,93,0,0,1,2
10289816,10289915,99,0,0,1,1
10289909,10289977,68,1,0,0,2
10289916,10289953,37,1,0,0,1
10289954,10290083,129,0,0,1,1
10289978,10290089,111,0,0,1,2
10290084,10290134,50,1,0,0,1
10290090,10290131,41,1,0,0,2
10290132,10290279,147,0,0,1,2
10290135,10290277,142,0,0,1,1
10290278,10290314,36,1,0,0,1
10290280,10290317,37,1,0,0,2
10290315,10290466,151,0,0,1,1
10290318,10290464,146,0,0,1,2
10290465,10290530,65,1,0,0,2
10290467,10290518,51,1,0,0,1
10290519,10290881,362,0,0,1,1
10290531,10290922,391,0,0,1,2
10290882,10290893,11,1,0,0,1
10290894,10290926,32,0,0,1,1
10290923,10296246,5323,1,0,0,2
10290927,10291203,276,1,0,0,1
10291204,10291229,25,0,0,1,1
10291230,10291745,515,1,0,0,1
10291357,10291363,6,0,1,0,2
10291536,10291614,78,0,1,0,2
10291746,10291775,29,0,0,1,1
10291776,10296233,4457,1,0,0,1
10291892,10291912,20,0,1,0,2
10291999,10292189,190,0,1,0,2
10292210,10294072,1862,0,1,0,2
10292924,10293579,655,0,1,0,1
10293791,10293948,157,0,1,0,1
10294021,10294044,23,0,1,0,1
10295599,10296208,609,0,1,0,2
10295721,10296188,467,0,1,0,1
10296234,10296298,64,0,0,1,1
10296247,10296300,53,0,0,1,2
10296299,10296330,31,1,0,0,1
10296301,10296324,23,1,0,0,2
10296325,10296409,84,0,0,1,2
10296331,10296416,85,0,0,1,1
10296410,10296954,544,1,0,0,2
10296417,10296867,450,1,0,0,1
10296453,10296675,222,0,1,0,2
10296455,10296649,194,0,1,0,1
10296673,10296675,2,0,1,0,1
10296868,10297114,246,0,0,1,1
10296955,10297085,130,0,0,1,2
10297086,10297163,77,1,0,0,2
10297115,10297164,49,1,0,0,1
10297164,10297296,132,0,0,1,2
10297165,10297299,134,0,0,1,1
10297297,10297335,38,1,0,0,2
10297300,10297337,37,1,0,0,1
10297336,10297496,160,0,0,1,2
10297338,10297494,156,0,0,1,1
10297495,10297547,52,1,0,0,1
10297497,10297597,100,1,0,0,2
10297548,10297819,271,0,0,1,1
10297598,10297619,21,0,0,1,2
10297620,10297800,180,1,0,0,2
10297801,10297822,21,0,0,1,2
10297820,10297850,30,1,0,0,1
10297823,10297871,48,1,0,0,2
10297851,10297988,137,0,0,1,1
10297872,10297952,80,0,0,1,2
10297953,10298033,80,1,0,0,2
10297989,10298010,21,1,0,0,1
10298011,10298050,39,0,0,1,1
10298034,10298273,239,0,0,1,2
10298051,10298066,15,1,0,0,1
10298067,10298273,206,0,0,1,1
10298274,10298301,27,1,0,0,1
10298274,10298303,29,1,0,0,2
10298302,10298430,128,0,0,1,1
10298304,10298431,127,0,0,1,2
10298431,10298490,59,1,0,0,1
10298432,10298679,247,1,0,0,2
10298491,10298656,165,0,0,1,1
10298657,10298774,117,1,0,0,1
10298680,10298707,27,0,0,1,2
10298708,10299723,1015,1,0,0,2
10298775,10298968,193,0,0,1,1
10298969,10298994,25,1,0,0,1
10298995,10299074,79,0,0,1,1
10299075,10299129,54,1,0,0,1
10299130,10299177,47,0,0,1,1
10299178,10299818,640,1,0,0,1
10299225,10299709,484,0,1,0,2
10299254,10299574,320,0,1,0,1
10299630,10299643,13,0,1,0,1
10299724,10299770,46,0,0,1,2
10299771,10299821,50,1,0,0,2
10299819,10299847,28,0,0,1,1
10299822,10299889,67,0,0,1,2
10299848,10299918,70,1,0,0,1
10299890,10299920,30,1,0,0,2
10299919,10299966,47,0,0,1,1
10299921,10299945,24,0,0,1,2
10299946,10299980,34,1,0,0,2
10299967,10299983,16,1,0,0,1
10299981,10300126,145,0,0,1,2
10299984,10300126,142,0,0,1,1
10300127,10300175,48,1,0,0,1
10300127,10300214,87,1,0,0,2
10300176,10300270,94,0,0,1,1
10300215,10300253,38,0,0,1,2
10300254,10302909,2655,1,0,0,2
10300271,10300957,686,1,0,0,1
10300335,10300889,554,0,1,0,2
10300348,10300807,459,0,1,0,1
10300842,10300849,7,0,1,0,1
10300958,10301119,161,0,0,1,1
10301120,10303261,2141,1,0,0,1
10301168,10302870,1702,0,1,0,2
10301170,10303093,1923,0,1,0,1
10302910,10303227,317,0,0,1,2
10303228,10303258,30,1,0,0,2
10303259,10303556,297,0,0,1,2
10303262,10303548,286,0,0,1,1
10303549,10303978,429,1,0,0,1
10303557,10303994,437,1,0,0,2
10303581,10303949,368,0,1,0,1
10303611,10303907,296,0,1,0,2
10303979,10304003,24,0,0,1,1
10303995,10304035,40,0,0,1,2
10304004,10304011,7,1,0,0,1
10304012,10304034,22,0,0,1,1
10304035,10304070,35,1,0,0,1
10304036,10304074,38,1,0,0,2
10304071,10304382,311,0,0,1,1
10304075,10304396,321,0,0,1,2
10304383,10304447,64,1,0,0,1
10304397,10304429,32,1,0,0,2
10304430,10304648,218,0,0,1,2
10304448,10304571,123,0,0,1,1
10304572,10304682,110,1,0,0,1
10304649,10304686,37,1,0,0,2
10304683,10305000,317,0,0,1,1
10304687,10304998,311,0,0,1,2
10304999,10305032,33,1,0,0,2
10305001,10305029,28,1,0,0,1
10305030,10305206,176,0,0,1,1
10305033,10305204,171,0,0,1,2
10305205,10305233,28,1,0,0,2
10305207,10305233,26,1,0,0,1
10305234,10305390,156,0,0,1,1
10305234,10305390,156,0,0,1,2
10523398,10523410,12,0,0,1,1
10523411,10523415,4,1,0,0,1
10523416,10523607,191,0,0,1,1
10523460,10523570,110,0,0,1,2
10523571,10523719,148,1,0,0,2
10523608,10523680,72,1,0,0,1
10523681,10523785,104,0,0,1,1
10523720,10523765,45,0,0,1,2
10523766,10525053,1287,1,0,0,2
10523786,10523809,23,1,0,0,1
10523810,10523954,144,0,0,1,1
10523955,10524808,853,1,0,0,1
10524021,10524774,753,0,1,0,2
10524048,10524123,75,0,1,0,1
10524173,10524622,449,0,1,0,1
10524648,10524741,93,0,1,0,1
10524809,10524927,118,0,0,1,1
10524928,10524968,40,1,0,0,1
10524969,10525122,153,0,0,1,1
10525054,10525120,66,0,0,1,2
10525121,10525150,29,1,0,0,2
10525123,10525148,25,1,0,0,1
10525149,10525393,244,0,0,1,1
10525151,10525391,240,0,0,1,2
10525392,10525414,22,1,0,0,2
10525394,10525414,20,1,0,0,1
10525415,10525859,444,0,0,1,2
10525415,10525860,445,0,0,1,1
10525860,10525912,52,1,0,0,2
10525861,10525907,46,1,0,0,1
10525908,10525988,80,0,0,1,1
10525913,10525990,77,0,0,1,2
10525989,10526030,41,1,0,0,1
10525991,10526034,43,1,0,0,2
10526031,10526071,40,0,0,1,1
10526035,10526071,36,0,0,1,2
10526072,10526122,50,1,0,0,1
10526072,10526704,632,1,0,0,2
10526123,10526438,315,0,0,1,1
10526439,10526461,22,1,0,0,1
10526462,10526641,179,0,0,1,1
10526642,10526663,21,1,0,0,1
10526664,10526896,232,0,0,1,1
10526705,10526854,149,0,0,1,2
10526855,10527012,157,1,0,0,2
10526897,10526916,19,1,0,0,1
10526917,10527076,159,0,0,1,1
10527013,10527072,59,0,0,1,2
10527073,10527134,61,1,0,0,2
10527077,10527099,22,1,0,0,1
10527100,10527320,220,0,0,1,1
10527135,10527235,100,0,0,1,2
10527236,10527269,33,1,0,0,2
10527270,10527297,27,0,0,1,2
10527298,10527392,94,1,0,0,2
10527321,10527341,20,1,0,0,1
10527342,10527590,248,0,0,1,1
10527393,10527539,146,0,0,1,2
10527540,10528007,467,1,0,0,2
10527591,10527617,26,1,0,0,1
10527618,10527644,26,0,0,1,1
10527645,10527881,236,1,0,0,1
10527672,10527780,108,0,1,0,1
10527672,10527850,178,0,1,0,2
10527802,10527821,19,0,1,0,1
10527882,10527951,69,0,0,1,1
10527952,10527975,23,1,0,0,1
10527976,10528233,257,0,0,1,1
10528008,10528238,230,0,0,1,2
10528234,10528251,17,1,0,0,1
10528239,10528250,11,1,0,0,2
10528251,10530351,2100,0,0,1,2
10528252,10530353,2101,0,0,1,1
10530352,10530432,80,1,0,0,2
10530354,10530432,78,1,0,0,1
10530433,10530572,139,0,0,1,2
10530433,10530573,140,0,0,1,1
10530573,10530602,29,1,0,0,2
10530574,10530597,23,1,0,0,1
10530598,10531200,602,0,0,1,1
10530603,10531201,598,0,0,1,2
10531201,10531214,13,1,0,0,1
10531202,10531207,5,1,0,0,2
10531208,10532643,1435,0,0,1,2
10531215,10532644,1429,0,0,1,1
10532644,10532688,44,1,0,0,2
10532645,10532691,46,1,0,0,1
10532689,10532869,180,0,0,1,2
10532692,10532873,181,0,0,1,1
10532870,10532893,23,1,0,0,2
10532874,10532890,16,1,0,0,1
10532891,10534487,1596,0,0,1,1
10532894,10533094,200,0,0,1,2
10533095,10533104,9,1,0,0,2
10533105,10534490,1385,0,0,1,2
10534488,10535077,589,1,0,0,1
10534491,10535053,562,1,0,0,2
10534619,10534911,292,0,1,0,2
10534636,10534882,246,0,1,0,1
10535054,10535610,556,0,0,1,2
10535078,10535473,395,0,0,1,1
10535474,10535478,4,1,0,0,1
10535479,10535619,140,0,0,1,1
10535611,10535639,28,1,0,0,2
10535620,10535667,47,1,0,0,1
10535640,10535790,150,0,0,1,2
10535668,10535792,124,0,0,1,1
10535791,10535854,63,1,0,0,2
10535793,10535813,20,1,0,0,1
10535814,10536025,211,0,0,1,1
10535855,10536636,781,0,0,1,2
10536026,10536044,18,1,0,0,1
10536045,10536613,568,0,0,1,1
10536614,10536785,171,1,0,0,1
10536637,10536647,10,1,0,0,2
10536648,10536830,182,0,0,1,2
10536786,10536828,42,0,0,1,1
10536829,10537371,542,1,0,0,1
10536831,10539218,2387,1,0,0,2
10536864,10536929,65,0,1,0,2
10536901,10536901,0,0,1,0,1
10536950,10539163,2213,0,1,0,2
10537372,10537396,24,0,0,1,1
10537397,10539191,1794,1,0,0,1
10539192,10539255,63,0,0,1,1
10539219,10539282,63,0,0,1,2
10539256,10539342,86,1,0,0,1
10539283,10539318,35,1,0,0,2
10539319,10539538,219,0,0,1,2
10539343,10539538,195,0,0,1,1
10539539,10539556,17,1,0,0,1
10539539,10539558,19,1,0,0,2
10539557,10539922,365,0,0,1,1
10539559,10539920,361,0,0,1,2
10539921,10539943,22,1,0,0,2
10539923,10539939,16,1,0,0,1
10539940,10540108,168,0,0,1,1
10539944,10540108,164,0,0,1,2
10540109,10540124,15,1,0,0,1
10540109,10540125,16,1,0,0,2
10540125,10541423,1298,0,0,1,1
10540126,10541006,880,0,0,1,2
10541007,10541023,16,1,0,0,2
10541024,10541422,398,0,0,1,2
10541423,10541486,63,1,0,0,2
10541424,10541527,103,1,0,0,1
10541487,10541628,141,0,0,1,2
10541528,10541624,96,0,0,1,1
10541625,10541686,61,1,0,0,1
10541629,10541656,27,1,0,0,2
10541657,10541853,196,0,0,1,2
10541687,10541791,104,0,0,1,1
10541792,10542016,224,1,0,0,1
10541854,10541870,16,1,0,0,2
10541871,10542678,807,0,0,1,2
10542017,10542039,22,0,0,1,1
10542040,10542205,165,1,0,0,1
10542206,10542293,87,0,0,1,1
10542294,10542922,628,1,0,0,1
10542679,10542697,18,1,0,0,2
10542698,10542785,87,0,0,1,2
10542786,10542959,173,1,0,0,2
10542923,10543266,343,0,0,1,1
10542960,10543264,304,0,0,1,2
10543265,10543326,61,1,0,0,2
10543267,10543350,83,1,0,0,1
10543327,10543502,175,0,0,1,2
10543351,10543504,153,0,0,1,1
10543503,10543527,24,1,0,0,2
10543505,10543521,16,1,0,0,1
10543522,10543669,147,0,0,1,1
10543528,10543664,136,0,0,1,2
10543665,10543687,22,1,0,0,2
10543670,10543717,47,1,0,0,1
10543688,10543968,280,0,0,1,2
10543718,10544233,515,0,0,1,1
10543969,10543989,20,1,0,0,2
10543990,10544229,239,0,0,1,2
10544230,10544246,16,1,0,0,2
10544234,10544238,4,1,0,0,1
10544239,10544538,299,0,0,1,1
10544247,10544634,387,0,0,1,2
10544539,10544562,23,1,0,0,1
10544563,10544634,71,0,0,1,1
10544635,10544738,103,1,0,0,1
10544635,10544774,139,1,0,0,2
10544739,10544913,174,0,0,1,1
10544775,10544913,138,0,0,1,2
10544914,10544967,53,1,0,0,1
10544914,10544971,57,1,0,0,2
10544968,10545064,96,0,0,1,1
10544972,10545160,188,0,0,1,2
10545065,10545203,138,1,0,0,1
10545161,10545190,29,1,0,0,2
10545191,10545372,181,0,0,1,2
10545204,10545956,752,0,0,1,1
10545373,10545378,5,1,0,0,2
10545379,10545982,603,0,0,1,2
10545957,10546003,46,1,0,0,1
10545983,10546006,23,1,0,0,2
10546004,10546261,257,0,0,1,1
10546007,10546262,255,0,0,1,2
10546262,10546544,282,1,0,0,1
10546263,10546571,308,1,0,0,2
10546296,10546504,208,0,1,0,2
10546311,10546465,154,0,1,0,1
10546545,10547126,581,0,0,1,1
10546572,10547126,554,0,0,1,2
10547127,10547160,33,1,0,0,1
10547127,10547170,43,1,0,0,2
10547161,10547218,57,0,0,1,1
10547171,10547217,46,0,0,1,2
10547218,10547345,127,1,0,0,2
10547219,10547342,123,1,0,0,1
10547343,10547521,178,0,0,1,1
10547346,10547517,171,0,0,1,2
10547518,10547542,24,1,0,0,2
10547522,10547540,18,1,0,0,1
10547541,10547717,176,0,0,1,1
10547543,10547716,173,0,0,1,2
10547717,10547739,22,1,0,0,2
10547718,10547740,22,1,0,0,1
10547740,10547923,183,0,0,1,2
10547741,10547925,184,0,0,1,1
10547924,10547940,16,1,0,0,2
10547926,10547941,15,1,0,0,1
10547941,10548704,763,0,0,1,2
10547942,10548703,761,0,0,1,1
10548704,10548722,18,1,0,0,1
10548705,10548721,16,1,0,0,2
10548722,10549066,344,0,0,1,2
10548723,10549065,342,0,0,1,1
10549066,10549092,26,1,0,0,1
10549067,10549090,23,1,0,0,2
10549091,10549374,283,0,0,1,2
10549093,10549374,281,0,0,1,1
10549375,10549459,84,1,0,0,1
10549375,10549460,85,1,0,0,2
10549460,10549493,33,0,0,1,1
10549461,10549495,34,0,0,1,2
10549494,10549529,35,1,0,0,1
10549496,10550191,695,1,0,0,2
10549530,10549555,25,0,0,1,1
10549556,10549842,286,1,0,0,1
10549585,10549856,271,0,1,0,2
10549598,10549711,113,0,1,0,1
10549843,10549917,74,0,0,1,1
10549918,10549958,40,1,0,0,1
10549959,10550155,196,0,0,1,1
10550156,10550177,21,1,0,0,1
10550178,10550357,179,0,0,1,1
10550192,10550301,109,0,0,1,2
10550302,10550782,480,1,0,0,2
10550358,10550373,15,1,0,0,1
10550374,10551685,1311,0,0,1,1
10550783,10550964,181,0,0,1,2
10550965,10550969,4,1,0,0,2
10550970,10550997,27,0,0,1,2
10550998,10551099,101,1,0,0,2
10551100,10551197,97,0,0,1,2
10551198,10551234,36,1,0,0,2
10551235,10551291,56,0,0,1,2
10551292,10551330,38,1,0,0,2
10551331,10551521,190,0,0,1,2
10551522,10551591,69,1,0,0,2
10551592,10551656,64,0,0,1,2
10551657,10551770,113,1,0,0,2
10551686,10551709,23,1,0,0,1
10551710,10552318,608,0,0,1,1
10551771,10551800,29,0,0,1,2
10551801,10551821,20,1,0,0,2
10551822,10551926,104,0,0,1,2
10551927,10552498,571,1,0,0,2
10552319,10552499,180,1,0,0,1
10552499,10552541,42,0,0,1,2
10552500,10552536,36,0,0,1,1
10552537,10552571,34,1,0,0,1
10552542,10552572,30,1,0,0,2
10552572,10552710,138,0,0,1,1
10552573,10552710,137,0,0,1,2
10552711,10552731,20,1,0,0,1
10552711,10552731,20,1,0,0,2
10552732,10552988,256,0,0,1,2
10552732,10552994,262,0,0,1,1
10552989,10553005,16,1,0,0,2
10552995,10553004,9,1,0,0,1
10553005,10553198,193,0,0,1,1
10553006,10553194,188,0,0,1,2
10553195,10553225,30,1,0,0,2
10553199,10553217,18,1,0,0,1
10553218,10553345,127,0,0,1,1
10553226,10553342,116,0,0,1,2
10553343,10553361,18,1,0,0,2
10553346,10553362,16,1,0,0,1
10553362,10553627,265,0,0,1,2
10553363,10553635,272,0,0,1,1
10553628,10553648,20,1,0,0,2
10553636,10553648,12,1,0,0,1
10553649,10553844,195,0,0,1,2
10553649,10553849,200,0,0,1,1
10553845,10553866,21,1,0,0,2
10553850,10553865,15,1,0,0,1
10553866,10554121,255,0,0,1,1
10553867,10554116,249,0,0,1,2
10554117,10554140,23,1,0,0,2
10554122,10554140,18,1,0,0,1
10554141,10554271,130,0,0,1,2
10554141,10554273,132,0,0,1,1
10554272,10554309,37,1,0,0,2
10554274,10554297,23,1,0,0,1
10554298,10554327,29,0,0,1,1
10554310,10554339,29,0,0,1,2
10554328,10554345,17,1,0,0,1
10554340,10554381,41,1,0,0,2
10554346,10554441,95,0,0,1,1
10554382,10554472,90,0,0,1,2
10554442,10554451,9,1,0,0,1
10554452,10554604,152,0,0,1,1
10554473,10554482,9,1,0,0,2
10554483,10554534,51,0,0,1,2
10554535,10554860,325,1,0,0,2
10554605,10554861,256,1,0,0,1
10554635,10554768,133,0,1,0,1
10554635,10554800,165,0,1,0,2
10554861,10554956,95,0,0,1,2
10554862,10554955,93,0,0,1,1
10554956,10555018,62,1,0,0,1
10554957,10555011,54,1,0,0,2
10555012,10555149,137,0,0,1,2
10555019,10555152,133,0,0,1,1
10555150,10555171,21,1,0,0,2
10555153,10555170,17,1,0,0,1
10555171,10555458,287,0,0,1,1
10555172,10555459,287,0,0,1,2
10555459,10555465,6,1,0,0,1
10555460,10555468,8,1,0,0,2
10555466,10556610,1144,0,0,1,1
10555469,10556322,853,0,0,1,2
10556323,10556327,4,1,0,0,2
10556328,10556605,277,0,0,1,2
10556606,10556634,28,1,0,0,2
10556611,10556633,22,1,0,0,1
10556634,10557051,417,0,0,1,1
10556635,10557052,417,0,0,1,2
10557052,10557131,79,1,0,0,1
10557053,10557166,113,1,0,0,2
10557132,10557261,129,0,0,1,1
10557167,10557258,91,0,0,1,2
10557259,10557291,32,1,0,0,2
10557262,10557294,32,1,0,0,1
10557292,10557489,197,0,0,1,2
10557295,10557491,196,0,0,1,1
10557490,10557510,20,1,0,0,2
10557492,10557510,18,1,0,0,1
10557511,10558195,684,0,0,1,2
10557511,10558202,691,0,0,1,1
10558196,10558220,24,1,0,0,2
10558203,10558216,13,1,0,0,1
10558217,10558374,157,0,0,1,1
10558221,10558378,157,0,0,1,2
10558375,10558396,21,1,0,0,1
10558379,10558395,16,1,0,0,2
10558396,10558514,118,0,0,1,2
10558397,10558726,329,0,0,1,1
10558515,10558594,79,1,0,0,2
10558595,10558647,52,0,0,1,2
10558648,10558663,15,1,0,0,2
10558664,10558728,64,0,0,1,2
10558727,10558745,18,1,0,0,1
10558729,10558739,10,1,0,0,2
10558740,10558823,83,0,0,1,2
10558746,10559225,479,0,0,1,1
10558824,10558834,10,1,0,0,2
10558835,10559211,376,0,0,1,2
10559212,10559430,218,1,0,0,2
10559226,10559244,18,1,0,0,1
10559245,10559269,24,0,0,1,1
10559270,10559429,159,1,0,0,1
10559430,10560028,598,0,0,1,1
10559431,10560028,597,0,0,1,2
10560029,10560034,5,1,0,0,1
10560029,10560035,6,1,0,0,2
10560035,10561318,1283,0,0,1,1
10560036,10561318,1282,0,0,1,2
10561319,10561335,16,1,0,0,1
10561319,10561338,19,1,0,0,2
10561336,10561595,259,0,0,1,1
10561339,10561734,395,0,0,1,2
10561596,10561601,5,1,0,0,1
10561602,10561735,133,0,0,1,1
10561735,10561838,103,1,0,0,2
10561736,10561840,104,1,0,0,1
10561839,10561974,135,0,0,1,2
10561841,10561975,134,0,0,1,1
10561975,10562004,29,1,0,0,2
10561976,10562004,28,1,0,0,1
10562005,10562173,168,0,0,1,2
10562005,10562175,170,0,0,1,1
10562174,10562195,21,1,0,0,2
10562176,10562195,19,1,0,0,1
10562196,10562645,449,0,0,1,2
10562196,10562650,454,0,0,1,1
10562646,10562663,17,1,0,0,2
10562651,10562662,11,1,0,0,1
10562663,10562908,245,0,0,1,1
10562664,10562903,239,0,0,1,2
10562904,10562918,14,1,0,0,2
10562909,10562917,8,1,0,0,1
10562918,10563107,189,0,0,1,1
10562919,10563101,182,0,0,1,2
10563102,10563122,20,1,0,0,2
10563108,10563117,9,1,0,0,1
10563118,10563348,230,0,0,1,1
10563123,10563341,218,0,0,1,2
10563342,10563358,16,1,0,0,2
10563349,10563354,5,1,0,0,1
10563355,10564085,730,0,0,1,1
10563359,10563547,188,0,0,1,2
10563548,10563566,18,1,0,0,2
10563567,10563893,326,0,0,1,2
10563894,10563934,40,1,0,0,2
10563935,10564132,197,0,0,1,2
10564086,10564111,25,1,0,0,1
10564112,10564187,75,0,0,1,1
10564133,10564156,23,1,0,0,2
10564157,10564177,20,0,0,1,2
10564178,10564989,811,1,0,0,2
10564188,10564637,449,1,0,0,1
10564204,10564687,483,0,1,0,2
10564214,10564518,304,0,1,0,1
10564638,10564659,21,0,0,1,1
10564660,10564715,55,1,0,0,1
10564716,10564954,238,0,0,1,1
10564955,10564985,30,1,0,0,1
10564986,10565145,159,0,0,1,1
10564990,10565143,153,0,0,1,2
10565144,10565170,26,1,0,0,2
10565146,10565171,25,1,0,0,1
10565171,10565360,189,0,0,1,2
10565172,10565361,189,0,0,1,1
10565361,10565384,23,1,0,0,2
10565362,10565381,19,1,0,0,1
10565382,10566417,1035,0,0,1,1
10565385,10565671,286,0,0,1,2
10565672,10565688,16,1,0,0,2
10565689,10565910,221,0,0,1,2
10565911,10565926,15,1,0,0,2
10565927,10566173,246,0,0,1,2
10566174,10566813,639,1,0,0,2
10566418,10566434,16,1,0,0,1
10566435,10566595,160,0,0,1,1
10566596,10566651,55,1,0,0,1
10566652,10566879,227,0,0,1,1
10566814,10566836,22,0,0,1,2
10566837,10567260,423,1,0,0,2
10566880,10566890,10,1,0,0,1
10566891,10566914,23,0,0,1,1
10566915,10566932,17,1,0,0,1
10566933,10567064,131,0,0,1,1
10567065,10567638,573,1,0,0,1
10567136,10567170,34,0,1,0,2
10567261,10567291,30,0,0,1,2
10567292,10570608,3316,1,0,0,2
10567307,10570322,3015,0,1,0,2
10567639,10567684,45,0,0,1,1
10567685,10567750,65,1,0,0,1
10567751,10567816,65,0,0,1,1
10567817,10567826,9,1,0,0,1
10567827,10567895,68,0,0,1,1
10567896,10567924,28,1,0,0,1
10567925,10568193,268,0,0,1,1
10568194,10568264,70,1,0,0,1
10568265,10568354,89,0,0,1,1
10568355,10568378,23,1,0,0,1
10568379,10568414,35,0,0,1,1
10568415,10570321,1906,1,0,0,1
10570037,10570044,7,0,1,0,1
10570080,10570102,22,0,1,0,1
10570322,10570542,220,0,0,1,1
10570543,10570561,18,1,0,0,1
10570562,10570735,173,0,0,1,1
10570609,10570648,39,0,0,1,2
10570649,10570664,15,1,0,0,2
10570665,10570730,65,0,0,1,2
10570731,10572460,1729,1,0,0,2
10570736,10570752,16,1,0,0,1
10570753,10570962,209,0,0,1,1
10570963,10570974,11,1,0,0,1
10570975,10571209,234,0,0,1,1
10571210,10571215,5,1,0,0,1
10571216,10571430,214,0,0,1,1
10571431,10571443,12,1,0,0,1
10571444,10571697,253,0,0,1,1
10571698,10571708,10,1,0,0,1
10571709,10572022,313,0,0,1,1
10572023,10572028,5,1,0,0,1
10572029,10572175,146,0,0,1,1
10572176,10572217,41,1,0,0,1
10572218,10572250,32,0,0,1,1
10572251,10572306,55,1,0,0,1
10572307,10572726,419,0,0,1,1
10572461,10572729,268,0,0,1,2
10572727,10572811,84,1,0,0,1
10572730,10572816,86,1,0,0,2
10572812,10572858,46,0,0,1,1
10572817,10572857,40,0,0,1,2
10572858,10572877,19,1,0,0,2
10572859,10572890,31,1,0,0,1
10572878,10573637,759,0,0,1,2
10572891,10573635,744,0,0,1,1
10573636,10573659,23,1,0,0,1
10573638,10573658,20,1,0,0,2
10573659,10573833,174,0,0,1,2
10573660,10573830,170,0,0,1,1
10573831,10573851,20,1,0,0,1
10573834,10573853,19,1,0,0,2
10573852,10574642,790,0,0,1,1
10573854,10574642,788,0,0,1,2
10574643,10574655,12,1,0,0,2
10574643,10574667,24,1,0,0,1
10574656,10574915,259,0,0,1,2
10574668,10575066,398,0,0,1,1
10574916,10574924,8,1,0,0,2
10574925,10575023,98,0,0,1,2
10575024,10575054,30,1,0,0,2
10575055,10575088,33,0,0,1,2
10575067,10575331,264,1,0,0,1
10575089,10575482,393,1,0,0,2
10575129,10575263,134,0,1,0,2
10575144,10575205,61,0,1,0,1
10575332,10575379,47,0,0,1,1
10575380,10575482,102,1,0,0,1
10575483,10575580,97,0,0,1,1
10575483,10575581,98,0,0,1,2
10575581,10575617,36,1,0,0,1
10575582,10575636,54,1,0,0,2
10575618,10575789,171,0,0,1,1
10575637,10575791,154,0,0,1,2
10575790,10575815,25,1,0,0,1
10575792,10575814,22,1,0,0,2
10575815,10576062,247,0,0,1,2
10575816,10576066,250,0,0,1,1
10576063,10576082,19,1,0,0,2
10576067,10576096,29,1,0,0,1
10576083,10576319,236,0,0,1,2
10576097,10576319,222,0,0,1,1
10576320,10576335,15,1,0,0,2
10576320,10576338,18,1,0,0,1
10576336,10577036,700,0,0,1,2
10576339,10576965,626,0,0,1,1
10576966,10577009,43,1,0,0,1
10577010,10577136,126,0,0,1,1
10577037,10577073,36,1,0,0,2
10577074,10577107,33,0,0,1,2
10577108,10577263,155,1,0,0,2
10577137,10577233,96,1,0,0,1
10577234,10577307,73,0,0,1,1
10577264,10577286,22,0,0,1,2
10577287,10577535,248,1,0,0,2
10577308,10577736,428,1,0,0,1
10577536,10577640,104,0,0,1,2
10577641,10578304,663,1,0,0,2
10577737,10577789,52,0,0,1,1
10577790,10578258,468,1,0,0,1
10577850,10578259,409,0,1,0,2
10577856,10578157,301,0,1,0,1
10578259,10578343,84,0,0,1,1
10578305,10578346,41,0,0,1,2
10578344,10578374,30,1,0,0,1
10578347,10578381,34,1,0,0,2
10578375,10578719,344,0,0,1,1
10578382,10578512,130,0,0,1,2
10578513,10578533,20,1,0,0,2
10578534,10578720,186,0,0,1,2
10578720,10578739,19,1,0,0,1
10578721,10578741,20,1,0,0,2
10578740,10578950,210,0,0,1,1
10578742,10578953,211,0,0,1,2
10578951,10578971,20,1,0,0,1
10578954,10578970,16,1,0,0,2
10578971,10579277,306,0,0,1,2
10578972,10579276,304,0,0,1,1
10579277,10579300,23,1,0,0,1
10579278,10579299,21,1,0,0,2
10579300,10579434,134,0,0,1,2
10579301,10579434,133,0,0,1,1
10579435,10579450,15,1,0,0,1
10579435,10579450,15,1,0,0,2
10579451,10579626,175,0,0,1,1
10579451,10579628,177,0,0,1,2
10579627,10579652,25,1,0,0,1
10579629,10579652,23,1,0,0,2
10579653,10579769,116,0,0,1,1
10579653,10579770,117,0,0,1,2
10579770,10579790,20,1,0,0,1
10579771,10579792,21,1,0,0,2
10579791,10579938,147,0,0,1,1
10579793,10579939,146,0,0,1,2
10579939,10579964,25,1,0,0,1
10579940,10579969,29,1,0,0,2
10579965,10580124,159,0,0,1,1
10579970,10580004,34,0,0,1,2
10580005,10580195,190,1,0,0,2
10580125,10580134,9,1,0,0,1
10580135,10580254,119,0,0,1,1
10580196,10580257,61,0,0,1,2
10580255,10580268,13,1,0,0,1
10580258,10580333,75,1,0,0,2
10580269,10580437,168,0,0,1,1
10580334,10580428,94,0,0,1,2
10580429,10580464,35,1,0,0,2
10580438,10580482,44,1,0,0,1
10580465,10580578,113,0,0,1,2
10580483,10580595,112,0,0,1,1
10580579,10585992,5413,1,0,0,2
10580596,10581044,448,1,0,0,1
10580637,10583175,2538,0,1,0,2
10580652,10580736,84,0,1,0,1
10580763,10580775,12,0,1,0,1
10580812,10580812,0,0,1,0,1
10581045,10581322,277,0,0,1,1
10581323,10581341,18,1,0,0,1
10581342,10581534,192,0,0,1,1
10581535,10581542,7,1,0,0,1
10581543,10581853,310,0,0,1,1
10581854,10581874,20,1,0,0,1
10581875,10582014,139,0,0,1,1
10582015,10582029,14,1,0,0,1
10582030,10582327,297,0,0,1,1
10582328,10582347,19,1,0,0,1
10582348,10582496,148,0,0,1,1
10582497,10582667,170,1,0,0,1
10582668,10582710,42,0,0,1,1
10582711,10583195,484,1,0,0,1
10583196,10583302,106,0,0,1,1
10583303,10585871,2568,1,0,0,1
10583383,10585865,2482,0,1,0,2
10585097,10585151,54,0,1,0,1
10585453,10585467,14,0,1,0,1
10585872,10585909,37,0,0,1,1
10585910,10585918,8,1,0,0,1
10585919,10585956,37,0,0,1,1
10585957,10585981,24,1,0,0,1
10585982,10586245,263,0,0,1,1
10585993,10586245,252,0,0,1,2
10586246,10586265,19,1,0,0,1
10586246,10586280,34,1,0,0,2
10586266,10586500,234,0,0,1,1
10586281,10586493,212,0,0,1,2
10586494,10586506,12,1,0,0,2
10586501,10586507,6,1,0,0,1
10586507,10587187,680,0,0,1,2
10586508,10587188,680,0,0,1,1
10587188,10587210,22,1,0,0,2
10587189,10587198,9,1,0,0,1
10587199,10587758,559,0,0,1,1
10587211,10587755,544,0,0,1,2
10587756,10587764,8,1,0,0,2
10587759,10587773,14,1,0,0,1
10587765,10587949,184,0,0,1,2
10587774,10587952,178,0,0,1,1
10587950,10587968,18,1,0,0,2
10587953,10587969,16,1,0,0,1
10587969,10588134,165,0,0,1,2
10587970,10588274,304,0,0,1,1
10588135,10588701,566,1,0,0,2
10588275,10588287,12,1,0,0,1
10588288,10588370,82,0,0,1,1
10588371,10588603,232,1,0,0,1
10588404,10588587,183,0,1,0,2
10588424,10588531,107,0,1,0,1
10588604,10588632,28,0,0,1,1
10588633,10588640,7,1,0,0,1
10588641,10588695,54,0,0,1,1
10588696,10588711,15,1,0,0,1
10588702,10588748,46,0,0,1,2
10588712,10588738,26,0,0,1,1
10588739,10588764,25,1,0,0,1
10588749,10588761,12,1,0,0,2
10588762,10588830,68,0,0,1,2
10588765,10588829,64,0,0,1,1
10588830,10588860,30,1,0,0,1
10588831,10588858,27,1,0,0,2
10588859,10589047,188,0,0,1,2
10588861,10589046,185,0,0,1,1
10589047,10589069,22,1,0,0,1
10589048,10589068,20,1,0,0,2
10589069,10589416,347,0,0,1,2
10589070,10590019,949,0,0,1,1
10589417,10589438,21,1,0,0,2
10589439,10589647,208,0,0,1,2
10589648,10589657,9,1,0,0,2
10589658,10590012,354,0,0,1,2
10590013,10590036,23,1,0,0,2
10590020,10590036,16,1,0,0,1
10590037,10590151,114,0,0,1,2
10590037,10590163,126,0,0,1,1
10590152,10590183,31,1,0,0,2
10590164,10590173,9,1,0,0,1
10590174,10590589,415,0,0,1,1
10590184,10590246,62,0,0,1,2
10590247,10590292,45,1,0,0,2
10590293,10590373,80,0,0,1,2
10590374,10590392,18,1,0,0,2
10590393,10590487,94,0,0,1,2
10590488,10590509,21,1,0,0,2
10590510,10590578,68,0,0,1,2
10590579,10590603,24,1,0,0,2
10590590,10590596,6,1,0,0,1
10590597,10590631,34,0,0,1,1
10590604,10590650,46,0,0,1,2
10590632,10590666,34,1,0,0,1
10590651,10590713,62,1,0,0,2
10590667,10590785,118,0,0,1,1
10590714,10590791,77,0,0,1,2
10590786,10591296,510,1,0,0,1
10590792,10592911,2119,1,0,0,2
10590887,10591333,446,0,1,0,2
10590907,10591043,136,0,1,0,1
10591297,10591735,438,0,0,1,1
10591736,10591749,13,1,0,0,1
10591750,10591914,164,0,0,1,1
10591915,10591925,10,1,0,0,1
10591926,10592834,908,0,0,1,1
10592350,10592350,0,0,1,0,2
10592835,10592911,76,1,0,0,1
10592912,10593050,138,0,0,1,1
10592912,10593050,138,0,0,1,2
10593051,10593090,39,1,0,0,1
10593051,10593130,79,1,0,0,2
10593091,10593199,108,0,0,1,1
10593131,10593200,69,0,0,1,2
10593200,10593220,20,1,0,0,1
10593201,10593220,19,1,0,0,2
10593221,10593562,341,0,0,1,1
10593221,10593568,347,0,0,1,2
10593563,10593579,16,1,0,0,1
10593569,10593578,9,1,0,0,2
10593579,10594437,858,0,0,1,2
10593580,10595175,1595,0,0,1,1
10594438,10594790,352,1,0,0,2
10594791,10595173,382,0,0,1,2
10595174,10595372,198,1,0,0,2
10595176,10595220,44,1,0,0,1
10595221,10595342,121,0,0,1,1
10595343,10595374,31,1,0,0,1
10595373,10595589,216,0,0,1,2
10595375,10595592,217,0,0,1,1
10595590,10595698,108,1,0,0,2
10595593,10595610,17,1,0,0,1
10595611,10596014,403,0,0,1,1
10595699,10595773,74,0,0,1,2
10595774,10595843,69,1,0,0,2
10595844,10595867,23,0,0,1,2
10595868,10595960,92,1,0,0,2
10595961,10595999,38,0,0,1,2
10596000,10596137,137,1,0,0,2
10596015,10596033,18,1,0,0,1
10596034,10596221,187,0,0,1,1
10596138,10596161,23,0,0,1,2
10596162,10596278,116,1,0,0,2
10596222,10596240,18,1,0,0,1
10596241,10596637,396,0,0,1,1
10596279,10596383,104,0,0,1,2
10596384,10597473,1089,1,0,0,2
10596638,10596657,19,1,0,0,1
10596658,10597030,372,0,0,1,1
10597031,10597053,22,1,0,0,1
10597054,10597507,453,0,0,1,1
10597474,10597507,33,0,0,1,2
10597508,10597558,50,1,0,0,1
10597508,10597621,113,1,0,0,2
10597559,10597678,119,0,0,1,1
10597622,10597678,56,0,0,1,2
10597679,10597778,99,1,0,0,1
10597679,10600448,2769,1,0,0,2
10597742,10597745,3,0,1,0,2
10597779,10597803,24,0,0,1,1
10597804,10597818,14,1,0,0,1
10597815,10600335,2520,0,1,0,2
10597819,10597860,41,0,0,1,1
10597861,10599241,1380,1,0,0,1
10597880,10597880,0,0,1,0,1
10599242,10599273,31,0,0,1,1
10599274,10600379,1105,1,0,0,1
10600380,10600420,40,0,0,1,1
10600421,10600456,35,1,0,0,1
10600449,10600623,174,0,0,1,2
10600457,10600619,162,0,0,1,1
10600620,10600642,22,1,0,0,1
10600624,10600642,18,1,0,0,2
10600643,10600892,249,0,0,1,1
10600643,10600892,249,0,0,1,2
10600893,10600911,18,1,0,0,2
10600893,10600914,21,1,0,0,1
10600912,10601088,176,0,0,1,2
10600915,10601095,180,0,0,1,1
10601089,10601111,22,1,0,0,2
10601096,10601112,16,1,0,0,1
10601112,10601230,118,0,0,1,2
10601113,10601237,124,0,0,1,1
10601231,10601262,31,1,0,0,2
10601238,10601253,15,1,0,0,1
10601254,10601650,396,0,0,1,1
10601263,10601476,213,0,0,1,2
10601477,10601489,12,1,0,0,2
10601490,10601646,156,0,0,1,2
10601647,10601678,31,1,0,0,2
10601651,10601667,16,1,0,0,1
10601668,10602020,352,0,0,1,1
10601679,10601888,209,0,0,1,2
10601889,10602070,181,1,0,0,2
10602021,10602040,19,1,0,0,1
10602041,10602222,181,0,0,1,1
10602071,10602219,148,0,0,1,2
10602220,10602280,60,1,0,0,2
10602223,10602234,11,1,0,0,1
10602235,10602463,228,0,0,1,1
10602281,10602321,40,0,0,1,2
10602322,10602360,38,1,0,0,2
10602361,10602424,63,0,0,1,2
10602425,10602548,123,1,0,0,2
10602464,10602756,292,1,0,0,1
10602549,10602689,140,0,0,1,2
10602690,10602724,34,1,0,0,2
10602725,10602920,195,0,0,1,2
10602757,10602917,160,0,0,1,1
10602918,10602938,20,1,0,0,1
10602921,10602939,18,1,0,0,2
10602939,10602966,27,0,0,1,1
10602940,10603557,617,0,0,1,2
10602967,10603097,130,1,0,0,1
10603098,10603559,461,0,0,1,1
10603558,10603579,21,1,0,0,2
10603560,10603580,20,1,0,0,1
10603580,10603740,160,0,0,1,2
10603581,10603740,159,0,0,1,1
10603741,10603763,22,1,0,0,1
10603741,10603790,49,1,0,0,2
10603764,10604261,497,0,0,1,1
10603791,10604260,469,0,0,1,2
10604261,10604281,20,1,0,0,2
10604262,10604287,25,1,0,0,1
10604282,10604402,120,0,0,1,2
10604288,10604404,116,0,0,1,1
10604403,10604470,67,1,0,0,2
10604405,10604458,53,1,0,0,1
10604459,10604829,370,0,0,1,1
10604471,10604672,201,0,0,1,2
10604673,10604686,13,1,0,0,2
10604687,10604830,143,0,0,1,2
10604830,10604889,59,1,0,0,1
10604831,10605091,260,1,0,0,2
10604890,10605008,118,0,0,1,1
10605009,10605036,27,1,0,0,1
10605037,10605295,258,0,0,1,1
10605092,10605295,203,0,0,1,2
10605296,10605315,19,1,0,0,2
10605296,10605316,20,1,0,0,1
10605316,10605674,358,0,0,1,2
10605317,10605670,353,0,0,1,1
10605671,10605688,17,1,0,0,1
10605675,10605685,10,1,0,0,2
10605686,10605809,123,0,0,1,2
10605689,10605864,175,0,0,1,1
10605810,10606062,252,1,0,0,2
10605865,10605883,18,1,0,0,1
10605884,10606042,158,0,0,1,1
10606043,10606060,17,1,0,0,1
10606061,10606241,180,0,0,1,1
10606063,10606124,61,0,0,1,2
10606125,10606291,166,1,0,0,2
10606242,10606255,13,1,0,0,1
10606256,10606720,464,0,0,1,1
10606292,10606368,76,0,0,1,2
10606369,10606420,51,1,0,0,2
10606421,10606607,186,0,0,1,2
10606608,10606660,52,1,0,0,2
10606661,10606717,56,0,0,1,2
10606718,10607020,302,1,0,0,2
10606721,10606776,55,1,0,0,1
10606777,10606811,34,0,0,1,1
10606812,10606816,4,1,0,0,1
10606817,10606882,65,0,0,1,1
10606883,10606972,89,1,0,0,1
10606973,10607043,70,0,0,1,1
10607021,10607045,24,0,0,1,2
10607044,10607072,28,1,0,0,1
10607046,10607124,78,1,0,0,2
10607073,10607201,128,0,0,1,1
10607125,10607161,36,0,0,1,2
10607162,10607177,15,1,0,0,2
10607178,10607200,22,0,0,1,2
10607201,10608989,1788,1,0,0,2
10607202,10607282,80,1,0,0,1
10607283,10607406,123,0,0,1,1
10607407,10607444,37,1,0,0,1
10607445,10607671,226,0,0,1,1
10607672,10607694,22,1,0,0,1
10607695,10608183,488,0,0,1,1
10608184,10608204,20,1,0,0,1
10608205,10608320,115,0,0,1,1
10608321,10608344,23,1,0,0,1
10608345,10609252,907,0,0,1,1
10608990,10609012,22,0,0,1,2
10609013,10612622,3609,1,0,0,2
10609253,10609289,36,1,0,0,1
10609290,10609702,412,0,0,1,1
10609703,10610266,563,1,0,0,1
10609789,10612442,2653,0,1,0,2
10609816,10610030,214,0,1,0,1
10610267,10610314,47,0,0,1,1
10610315,10610867,552,1,0,0,1
10610394,10610769,375,0,1,0,1
10610790,10610799,9,0,1,0,1
10610868,10610939,71,0,0,1,1
10610940,10610969,29,1,0,0,1
10610970,10611102,132,0,0,1,1
10611103,10611128,25,1,0,0,1
10611129,10611284,155,0,0,1,1
10611285,10611312,27,1,0,0,1
10611313,10611635,322,0,0,1,1
10611636,10611782,146,1,0,0,1
10611783,10611892,109,0,0,1,1
10611893,10611922,29,1,0,0,1
10611923,10612564,641,0,0,1,1
10612565,10612577,12,1,0,0,1
10612578,10612742,164,0,0,1,1
10612623,10612667,44,0,0,1,2
10612668,10613960,1292,1,0,0,2
10612743,10612761,18,1,0,0,1
10612750,10613794,1044,0,1,0,2
10612762,10612921,159,0,0,1,1
10612922,10612942,20,1,0,0,1
10612943,10613212,269,0,0,1,1
10613213,10613232,19,1,0,0,1
10613233,10613511,278,0,0,1,1
10613512,10613554,42,1,0,0,1
10613555,10613716,161,0,0,1,1
10613717,10613862,145,1,0,0,1
10613863,10613883,20,0,0,1,1
10613884,10613954,70,1,0,0,1
10613955,10614154,199,0,0,1,1
10613961,10614008,47,0,0,1,2
10614009,10614037,28,1,0,0,2
10614028,10614028,0,0,1,0,2
10614038,10614150,112,0,0,1,2
10614151,10614178,27,1,0,0,2
10614155,10614179,24,1,0,0,1
10614179,10614616,437,0,0,1,2
10614180,10615140,960,0,0,1,1
10614617,10614639,22,1,0,0,2
10614640,10614795,155,0,0,1,2
10614796,10614811,15,1,0,0,2
10614812,10614991,179,0,0,1,2
10614992,10615011,19,1,0,0,2
10615012,10615467,455,0,0,1,2
10615141,10615148,7,1,0,0,1
10615149,10615666,517,0,0,1,1
10615468,10615497,29,1,0,0,2
10615498,10615668,170,0,0,1,2
10615667,10615672,5,1,0,0,1
10615669,10615674,5,1,0,0,2
10615673,10615721,48,0,0,1,1
10615675,10615717,42,0,0,1,2
10615718,10615732,14,1,0,0,2
10615722,10615734,12,1,0,0,1
10615733,10615814,81,0,0,1,2
10615735,10615827,92,0,0,1,1
10615815,10615838,23,1,0,0,2
10615828,10615834,6,1,0,0,1
10615835,10616098,263,0,0,1,1
10615839,10616098,259,0,0,1,2
10616099,10616137,38,1,0,0,1
10616099,10616139,40,1,0,0,2
10616138,10616335,197,0,0,1,1
10616140,10616335,195,0,0,1,2
10616336,10616353,17,1,0,0,1
10616336,10616356,20,1,0,0,2
10616354,10616633,279,0,0,1,1
10616357,10616633,276,0,0,1,2
10616634,10616654,20,1,0,0,1
10616634,10616655,21,1,0,0,2
10616655,10616765,110,0,0,1,1
10616656,10616763,107,0,0,1,2
10616764,10616784,20,1,0,0,2
10616766,10616782,16,1,0,0,1
10616783,10616927,144,0,0,1,1
10616785,10616926,141,0,0,1,2
10616927,10616949,22,1,0,0,2
10616928,10616949,21,1,0,0,1
10616950,10617238,288,0,0,1,1
10616950,10617239,289,0,0,1,2
10617239,10617260,21,1,0,0,1
10617240,10617251,11,1,0,0,2
10617252,10617362,110,0,0,1,2
10617261,10617365,104,0,0,1,1
10617363,10617386,23,1,0,0,2
10617366,10617387,21,1,0,0,1
10617387,10617515,128,0,0,1,2
10617388,10617965,577,0,0,1,1
10617516,10617525,9,1,0,0,2
10617526,10617972,446,0,0,1,2
10617966,10618090,124,1,0,0,1
10617973,10619880,1907,1,0,0,2
10618091,10618144,53,0,0,1,1
10618145,10618979,834,1,0,0,1
10618168,10619735,1567,0,1,0,2
10618216,10618474,258,0,1,0,1
10618980,10619094,114,0,0,1,1
10619095,10619219,124,1,0,0,1
10619220,10619294,74,0,0,1,1
10619295,10619393,98,1,0,0,1
10619394,10619417,23,0,0,1,1
10619418,10619457,39,1,0,0,1
10619458,10619489,31,0,0,1,1
10619490,10619719,229,1,0,0,1
10619720,10619819,99,0,0,1,1
10619820,10619848,28,1,0,0,1
10619849,10619980,131,0,0,1,1
10619881,10620053,172,0,0,1,2
10619981,10620167,186,1,0,0,1
10620054,10622117,2063,1,0,0,2
10620136,10622067,1931,0,1,0,2
10620168,10620210,42,0,0,1,1
10620211,10620218,7,1,0,0,1
10620219,10620479,260,0,0,1,1
10620480,10620513,33,1,0,0,1
10620514,10620664,150,0,0,1,1
10620665,10620705,40,1,0,0,1
10620706,10620893,187,0,0,1,1
10620894,10620990,96,1,0,0,1
10620991,10621085,94,0,0,1,1
10621086,10622340,1254,1,0,0,1
10621592,10621733,141,0,1,0,1
10622118,10622486,368,0,0,1,2
10622341,10622374,33,0,0,1,1
10622375,10622534,159,1,0,0,1
10622487,10622514,27,1,0,0,2
10622515,10622700,185,0,0,1,2
10622535,10622703,168,0,0,1,1
10622701,10622726,25,1,0,0,2
10622704,10622729,25,1,0,0,1
10622727,10623525,798,0,0,1,2
10622730,10622917,187,0,0,1,1
10622918,10623440,522,1,0,0,1
10623441,10623515,74,0,0,1,1
10623516,10623876,360,1,0,0,1
10623526,10624094,568,1,0,0,2
10623637,10623847,210,0,1,0,2
10623652,10623775,123,0,1,0,1
10623877,10623996,119,0,0,1,1
10623997,10624099,102,1,0,0,1
10624095,10624154,59,0,0,1,2
10624100,10624160,60,0,0,1,1
10624155,10624251,96,1,0,0,2
10624161,10624247,86,1,0,0,1
10624248,10624515,267,0,0,1,1
10624252,10624512,260,0,0,1,2
10624513,10624540,27,1,0,0,2
10624516,10624538,22,1,0,0,1
10624539,10624808,269,0,0,1,1
10624541,10624808,267,0,0,1,2
10624809,10624830,21,1,0,0,2
10624809,10624835,26,1,0,0,1
10624831,10625006,175,0,0,1,2
10624836,10625008,172,0,0,1,1
10625007,10625024,17,1,0,0,2
10625009,10625024,15,1,0,0,1
10625025,10625475,450,0,0,1,1
10625025,10625476,451,0,0,1,2
10625476,10625489,13,1,0,0,1
10625477,10625488,11,1,0,0,2
10625489,10626077,588,0,0,1,2
10625490,10625623,133,0,0,1,1
10625624,10625643,19,1,0,0,1
10625644,10626075,431,0,0,1,1
10626076,10626104,28,1,0,0,1
10626078,10626093,15,1,0,0,2
10626094,10626378,284,0,0,1,2
10626105,10626213,108,0,0,1,1
10626214,10626219,5,1,0,0,1
10626220,10626377,157,0,0,1,1
10626378,10626390,12,1,0,0,1
10626379,10626388,9,1,0,0,2
10626389,10626463,74,0,0,1,2
10626391,10626466,75,0,0,1,1
10626464,10626597,133,1,0,0,2
10626467,10626599,132,1,0,0,1
10626598,10626631,33,0,0,1,2
10626600,10626636,36,0,0,1,1
10626632,10626673,41,1,0,0,2
10626637,10626674,37,1,0,0,1
10626674,10626869,195,0,0,1,2
10626675,10626873,198,0,0,1,1
10626870,10626897,27,1,0,0,2
10626874,10626895,21,1,0,0,1
10626896,10627407,511,0,0,1,1
10626898,10627400,502,0,0,1,2
10627401,10627420,19,1,0,0,2
10627408,10627430,22,1,0,0,1
10627421,10627669,248,0,0,1,2
10627431,10627672,241,0,0,1,1
10627670,10627691,21,1,0,0,2
10627673,10627691,18,1,0,0,1
10627692,10627834,142,0,0,1,2
10627692,10627837,145,0,0,1,1
10627835,10627851,16,1,0,0,2
10627838,10627855,17,1,0,0,1
10627852,10628032,180,0,0,1,2
10627856,10628035,179,0,0,1,1
10628033,10628048,15,1,0,0,2
10628036,10628048,12,1,0,0,1
10628049,10628824,775,0,0,1,2
10628049,10628953,904,0,0,1,1
10628825,10629231,406,1,0,0,2
10628954,10628958,4,1,0,0,1
10628959,10629002,43,0,0,1,1
10629003,10629167,164,1,0,0,1
10629168,10629190,22,0,0,1,1
10629191,10629231,40,1,0,0,1
10629232,10629463,231,0,0,1,1
10629232,10629469,237,0,0,1,2
10629464,10629490,26,1,0,0,1
10629470,10629492,22,1,0,0,2
10629491,10629700,209,0,0,1,1
10629493,10629695,202,0,0,1,2
10629696,10629716,20,1,0,0,2
10629701,10629711,10,1,0,0,1
10629712,10629912,200,0,0,1,1
10629717,10630019,302,0,0,1,2
10629913,10630043,130,1,0,0,1
10630020,10630045,25,1,0,0,2
10630044,10630177,133,0,0,1,1
10630046,10630180,134,0,0,1,2
10630178,10630207,29,1,0,0,1
10630181,10630210,29,1,0,0,2
10630208,10630473,265,0,0,1,1
10630211,10630474,263,0,0,1,2
10630474,10630500,26,1,0,0,1
10630475,10630499,24,1,0,0,2
10630500,10632313,1813,0,0,1,2
10630501,10631651,1150,0,0,1,1
10631652,10631671,19,1,0,0,1
10631672,10631736,64,0,0,1,1
10631737,10631813,76,1,0,0,1
10631814,10631836,22,0,0,1,1
10631837,10631878,41,1,0,0,1
10631879,10631943,64,0,0,1,1
10631944,10632016,72,1,0,0,1
10632017,10632041,24,0,0,1,1
10632042,10632197,155,1,0,0,1
10632198,10632315,117,0,0,1,1
10632314,10632332,18,1,0,0,2
10632316,10632331,15,1,0,0,1
10632332,10632397,65,0,0,1,1
10632333,10632397,64,0,0,1,2
10632398,10632935,537,1,0,0,1
10632398,10634890,2492,1,0,0,2
10632455,10634657,2202,0,1,0,2
10632478,10632667,189,0,1,0,1
10632702,10632703,1,0,1,0,1
10632936,10633555,619,0,0,1,1
10633556,10633584,28,1,0,0,1
10633585,10633649,64,0,0,1,1
10633650,10633660,10,1,0,0,1
10633661,10633755,94,0,0,1,1
10633756,10633982,226,1,0,0,1
10633768,10633857,89,0,1,0,1
10633881,10633934,53,0,1,0,1
10633983,10634023,40,0,0,1,1
10634024,10634067,43,1,0,0,1
10634068,10634148,80,0,0,1,1
10634149,10634729,580,1,0,0,1
10634730,10634787,57,0,0,1,1
10634788,10634846,58,1,0,0,1
10634847,10635005,158,0,0,1,1
10634891,10635005,114,0,0,1,2
10635006,10635029,23,1,0,0,1
10635006,10635029,23,1,0,0,2
10635030,10635159,129,0,0,1,2
10635030,10635167,137,0,0,1,1
10635160,10635267,107,1,0,0,2
10635168,10635182,14,1,0,0,1
10635183,10635470,287,0,0,1,1
10635268,10635368,100,0,0,1,2
10635369,10635381,12,1,0,0,2
10635382,10635467,85,0,0,1,2
10635468,10635485,17,1,0,0,2
10635471,10635484,13,1,0,0,1
10635485,10636345,860,0,0,1,1
10635486,10636166,680,0,0,1,2
10636167,10636294,127,1,0,0,2
10636295,10636338,43,0,0,1,2
10636339,10636422,83,1,0,0,2
10636346,10636360,14,1,0,0,1
10636361,10636740,379,0,0,1,1
10636423,10636741,318,0,0,1,2
10636741,10636771,30,1,0,0,1
10636742,10636773,31,1,0,0,2
10636772,10636951,179,0,0,1,1
10636774,10636933,159,0,0,1,2
10636934,10637008,74,1,0,0,2
10636952,10636987,35,1,0,0,1
10636988,10637081,93,0,0,1,1
10637009,10637087,78,0,0,1,2
10637082,10637125,43,1,0,0,1
10637088,10637110,22,1,0,0,2
10637111,10637174,63,0,0,1,2
10637126,10637218,92,0,0,1,1
10637175,10637197,22,1,0,0,2
10637198,10637219,21,0,0,1,2
10637219,10637297,78,1,0,0,1
10637220,10637298,78,1,0,0,2
10637298,10637427,129,0,0,1,1
10637299,10637430,131,0,0,1,2
10637428,10637452,24,1,0,0,1
10637431,10637451,20,1,0,0,2
10637452,10637781,329,0,0,1,2
10637453,10637786,333,0,0,1,1
10637782,10637791,9,1,0,0,2
10637787,10637792,5,1,0,0,1
10637792,10637953,161,0,0,1,2
10637793,10637959,166,0,0,1,1
10637954,10637975,21,1,0,0,2
10637960,10637972,12,1,0,0,1
10637973,10638145,172,0,0,1,1
10637976,10638138,162,0,0,1,2
10638139,10638161,22,1,0,0,2
10638146,10638161,15,1,0,0,1
10638162,10639192,1030,0,0,1,2
10638162,10639336,1174,0,0,1,1
10639193,10639206,13,1,0,0,2
10639207,10639337,130,0,0,1,2
10639337,10639839,502,1,0,0,1
10639338,10649004,9666,1,0,0,2
10639437,10639771,334,0,1,0,2
10639445,10639531,86,0,1,0,1
10639840,10639937,97,0,0,1,1
10639938,10639970,32,1,0,0,1
10639971,10640172,201,0,0,1,1
10640173,10640193,20,1,0,0,1
10640194,10640428,234,0,0,1,1
10640429,10640446,17,1,0,0,1
10640447,10640554,107,0,0,1,1
10640555,10640573,18,1,0,0,1
10640574,10640715,141,0,0,1,1
10640716,10640723,7,1,0,0,1
10640724,10640928,204,0,0,1,1
10640929,10640995,66,1,0,0,1
10640996,10641149,153,0,0,1,1
10641150,10641247,97,1,0,0,1
10641162,10641203,41,0,1,0,2
10641246,10641246,0,0,1,0,2
10641248,10641300,52,0,0,1,1
10641277,10641313,36,0,1,0,2
10641301,10644036,2735,1,0,0,1
10641409,10641511,102,0,1,0,2
10641805,10641823,18,0,1,0,2
10641848,10644041,2193,0,1,0,2
10644037,10644173,136,0,0,1,1
10644174,10644278,104,1,0,0,1
10644196,10647640,3444,0,1,0,2
10644279,10644340,61,0,0,1,1
10644341,10644395,54,1,0,0,1
10644396,10644483,87,0,0,1,1
10644484,10645490,1006,1,0,0,1
10644583,10644586,3,0,1,0,1
10644618,10644918,300,0,1,0,1
10645491,10645585,94,0,0,1,1
10645586,10645843,257,1,0,0,1
10645844,10645867,23,0,0,1,1
10645868,10645886,18,1,0,0,1
10645887,10645912,25,0,0,1,1
10645913,10647607,1694,1,0,0,1
10646031,10646032,1,0,1,0,1
10646067,10646120,53,0,1,0,1
10646217,10646219,2,0,1,0,1
10646261,10646288,27,0,1,0,1
10647608,10647688,80,0,0,1,1
10647689,10648018,329,1,0,0,1
10647710,10648898,1188,0,1,0,2
10647780,10647926,146,0,1,0,1
10648019,10648260,241,0,0,1,1
10648261,10648937,676,1,0,0,1
10648295,10648924,629,0,1,0,1
10648938,10649060,122,0,0,1,1
10649005,10649064,59,0,0,1,2
10649061,10649378,317,1,0,0,1
10649065,10649425,360,1,0,0,2
10649089,10649361,272,0,1,0,2
10649095,10649336,241,0,1,0,1
10649379,10649476,97,0,0,1,1
10649426,10649472,46,0,0,1,2
10649473,10650441,968,1,0,0,2
10649477,10649688,211,1,0,0,1
10649499,10649664,165,0,1,0,2
10649508,10649634,126,0,1,0,1
10649689,10649774,85,0,0,1,1
10649775,10649995,220,1,0,0,1
10649784,10649972,188,0,1,0,2
10649796,10649920,124,0,1,0,1
10649996,10650034,38,0,0,1,1
10650035,10650361,326,1,0,0,1
10650055,10650298,243,0,1,0,2
10650061,10650193,132,0,1,0,1
10650362,10650603,241,0,0,1,1
10650442,10650602,160,0,0,1,2
10650603,10650640,37,1,0,0,2
10650604,10650621,17,1,0,0,1
10650622,10651066,444,0,0,1,1
10650641,10651067,426,0,0,1,2
10651067,10651085,18,1,0,0,1
10651068,10651087,19,1,0,0,2
10651086,10651129,43,0,0,1,1
10651088,10651120,32,0,0,1,2
10651121,10651798,677,1,0,0,2
10651130,10651469,339,1,0,0,1
10651153,10651487,334,0,1,0,2
10651168,10651322,154,0,1,0,1
10651470,10651663,193,0,0,1,1
10651664,10651682,18,1,0,0,1
10651683,10652121,438,0,0,1,1
10651799,10652101,302,0,0,1,2
10652102,10652983,881,1,0,0,2
10652122,10652403,281,1,0,0,1
10652146,10652353,207,0,1,0,2
10652163,10652282,119,0,1,0,1
10652404,10652529,125,0,0,1,1
10652530,10652929,399,1,0,0,1
10652541,10652948,407,0,1,0,2
10652552,10652898,346,0,1,0,1
10652930,10653090,160,0,0,1,1
10652984,10653088,104,0,0,1,2
10653089,10653351,262,1,0,0,2
10653091,10653302,211,1,0,0,1
10653129,10653264,135,0,1,0,2
10653134,10653204,70,0,1,0,1
10653303,10653412,109,0,0,1,1
10653352,10653405,53,0,0,1,2
10653406,10653527,121,1,0,0,2
10653413,10653482,69,1,0,0,1
10653483,10653625,142,0,0,1,1
10653528,10653562,34,0,0,1,2
10653563,10653681,118,1,0,0,2
10653626,10653652,26,1,0,0,1
10653653,10654086,433,0,0,1,1
10653682,10654086,404,0,0,1,2
10654087,10654104,17,1,0,0,1
10654087,10654104,17,1,0,0,2
10654105,10654508,403,0,0,1,1
10654105,10654815,710,0,0,1,2
10654509,10654518,9,1,0,0,1
10654519,10655527,1008,0,0,1,1
10654816,10654829,13,1,0,0,2
10654830,10654868,38,0,0,1,2
10654869,10654891,22,1,0,0,2
10654892,10654961,69,0,0,1,2
10654962,10654989,27,1,0,0,2
10654990,10655067,77,0,0,1,2
10655068,10655186,118,1,0,0,2
10655187,10655249,62,0,0,1,2
10655250,10655271,21,1,0,0,2
10655272,10655299,27,0,0,1,2
10655300,10655329,29,1,0,0,2
10655330,10655388,58,0,0,1,2
10655389,10655409,20,1,0,0,2
10655410,10655493,83,0,0,1,2
10655494,10655507,13,1,0,0,2
10655508,10655529,21,0,0,1,2
10655528,10655577,49,1,0,0,1
10655530,10655629,99,1,0,0,2
10655578,10655775,197,0,0,1,1
10655630,10655775,145,0,0,1,2
10655776,10655804,28,1,0,0,2
10655776,10655834,58,1,0,0,1
10655805,10656139,334,0,0,1,2
10655835,10656457,622,0,0,1,1
10656140,10656170,30,1,0,0,2
10656171,10656457,286,0,0,1,2
10656458,10656476,18,1,0,0,1
10656458,10656512,54,1,0,0,2
10656477,10657580,1103,0,0,1,1
10656513,10657148,635,0,0,1,2
10657149,10657174,25,1,0,0,2
10657175,10657318,143,0,0,1,2
10657319,10657384,65,1,0,0,2
10657385,10657572,187,0,0,1,2
10657573,10658436,863,1,0,0,2
10657581,10658184,603,1,0,0,1
10657591,10657926,335,0,1,0,2
10658185,10658256,71,0,0,1,1
10658257,10658339,82,1,0,0,1
10658340,10658635,295,0,0,1,1
10658437,10658483,46,0,0,1,2
10658484,10658506,22,1,0,0,2
10658507,10658527,20,0,0,1,2
10658528,10658552,24,1,0,0,2
10658553,10658620,67,0,0,1,2
10658621,10658729,108,1,0,0,2
10658636,10658686,50,1,0,0,1
10658687,10659000,313,0,0,1,1
10658730,10659002,272,0,0,1,2
10659001,10659031,30,1,0,0,1
10659003,10659042,39,1,0,0,2
10659032,10659126,94,0,0,1,1
10659043,10659125,82,0,0,1,2
10659126,10659194,68,1,0,0,2
10659127,10659200,73,1,0,0,1
10659195,10659325,130,0,0,1,2
10659201,10659289,88,0,0,1,1
10659290,10659376,86,1,0,0,1
10659326,10659388,62,1,0,0,2
10659377,10659618,241,0,0,1,1
10659389,10659614,225,0,0,1,2
10659615,10659633,18,1,0,0,2
10659619,10659623,4,1,0,0,1
10659624,10659909,285,0,0,1,1
10659634,10659658,24,0,0,1,2
10659659,10660032,373,1,0,0,2
10659910,10659941,31,1,0,0,1
10659942,10660622,680,0,0,1,1
10660033,10660074,41,0,0,1,2
10660075,10660158,83,1,0,0,2
10660159,10660276,117,0,0,1,2
10660277,10661496,1219,1,0,0,2
10660458,10660500,42,0,1,0,2
10660548,10661465,917,0,1,0,2
10660623,10660676,53,1,0,0,1
10660677,10661312,635,0,0,1,1
10661313,10661522,209,1,0,0,1
10661497,10661645,148,0,0,1,2
10661523,10661641,118,0,0,1,1
10661642,10662235,593,1,0,0,1
10661646,10661693,47,1,0,0,2
10661694,10661955,261,0,0,1,2
10661956,10661976,20,1,0,0,2
10661977,10662100,123,0,0,1,2
10662101,10662117,16,1,0,0,2
10662118,10662213,95,0,0,1,2
10662214,10662236,22,1,0,0,2
10662236,10662334,98,0,0,1,1
10662237,10662334,97,0,0,1,2
10662335,10662358,23,1,0,0,1
10662335,10662358,23,1,0,0,2
10662359,10662443,84,0,0,1,2
10662359,10662473,114,0,0,1,1
10662444,10662611,167,1,0,0,2
10662474,10662502,28,1,0,0,1
10662503,10662592,89,0,0,1,1
10662593,10662628,35,1,0,0,1
10662612,10662721,109,0,0,1,2
10662629,10662727,98,0,0,1,1
10662722,10662742,20,1,0,0,2
10662728,10662741,13,1,0,0,1
10662742,10662881,139,0,0,1,1
10662743,10662827,84,0,0,1,2
10662828,10662845,17,1,0,0,2
10662846,10662878,32,0,0,1,2
10662879,10662907,28,1,0,0,2
10662882,10662904,22,1,0,0,1
10662905,10663220,315,0,0,1,1
10662908,10663222,314,0,0,1,2
10663221,10663240,19,1,0,0,1
10663223,10663313,90,1,0,0,2
10663241,10663698,457,0,0,1,1
10663314,10663537,223,0,0,1,2
10663538,10663570,32,1,0,0,2
10663571,10663679,108,0,0,1,2
10663680,10664174,494,1,0,0,2
10663699,10664034,335,1,0,0,1
10663746,10663990,244,0,1,0,2
10663754,10663894,140,0,1,0,1
10664035,10664313,278,0,0,1,1
10664175,10664310,135,0,0,1,2
10664311,10664410,99,1,0,0,2
10664314,10664361,47,1,0,0,1
10664362,10664463,101,0,0,1,1
10664411,10664460,49,0,0,1,2
10664461,10664930,469,1,0,0,2
10664464,10664481,17,1,0,0,1
10664482,10664516,34,0,0,1,1
10664517,10664804,287,1,0,0,1
10664541,10664770,229,0,1,0,2
10664552,10664723,171,0,1,0,1
10664805,10665243,438,0,0,1,1
10664931,10665044,113,0,0,1,2
10665045,10665144,99,1,0,0,2
10665145,10665242,97,0,0,1,2
10665243,10665301,58,1,0,0,2
10665244,10665293,49,1,0,0,1
10665294,10665400,106,0,0,1,1
10665302,10665348,46,0,0,1,2
10665349,10665476,127,1,0,0,2
10665401,10665478,77,1,0,0,1
10665477,10665710,233,0,0,1,2
10665479,10665712,233,0,0,1,1
10665711,10665732,21,1,0,0,2
10665713,10665733,20,1,0,0,1
10665733,10666855,1122,0,0,1,2
10665734,10666847,1113,0,0,1,1
10666848,10666937,89,1,0,0,1
10666856,10666869,13,1,0,0,2
10666870,10667040,170,0,0,1,2
10666938,10667250,312,0,0,1,1
10667041,10667058,17,1,0,0,2
10667059,10667240,181,0,0,1,2
10667241,10667261,20,1,0,0,2
10667251,10667266,15,1,0,0,1
10667262,10667408,146,0,0,1,2
10667267,10667411,144,0,0,1,1
10667409,10667446,37,1,0,0,2
10667412,10667439,27,1,0,0,1
10667440,10667551,111,0,0,1,1
10667447,10667799,352,0,0,1,2
10667552,10667602,50,1,0,0,1
10667603,10667717,114,0,0,1,1
10667718,10667837,119,1,0,0,1
10667800,10667874,74,1,0,0,2
10667838,10667988,150,0,0,1,1
10667875,10668527,652,0,0,1,2
10667989,10668000,11,1,0,0,1
10668001,10668058,57,0,0,1,1
10668059,10668075,16,1,0,0,1
10668076,10668120,44,0,0,1,1
10668121,10668305,184,1,0,0,1
10668306,10668347,41,0,0,1,1
10668348,10668497,149,1,0,0,1
10668498,10668526,28,0,0,1,1
10668527,10668603,76,1,0,0,1
10668528,10668541,13,1,0,0,2
10668542,10668688,146,0,0,1,2
10668604,10668646,42,0,0,1,1
10668647,10668665,18,1,0,0,1
10668666,10668694,28,0,0,1,1
10668689,10668707,18,1,0,0,2
10668695,10669132,437,1,0,0,1
10668708,10668838,130,0,0,1,2
10668839,10668861,22,1,0,0,2
10668862,10668948,86,0,0,1,2
10668949,10668992,43,1,0,0,2
10668993,10669113,120,0,0,1,2
10669114,10669143,29,1,0,0,2
10669133,10669216,83,0,0,1,1
10669144,10669213,69,0,0,1,2
10669214,10669252,38,1,0,0,2
10669217,10669343,126,1,0,0,1
10669253,10669351,98,0,0,1,2
10669344,10669456,112,0,0,1,1
10669352,10669526,174,1,0,0,2
10669457,10669476,19,1,0,0,1
10669477,10669773,296,0,0,1,1
10669527,10669768,241,0,0,1,2
10669769,10670445,676,1,0,0,2
10669774,10670332,558,1,0,0,1
10669826,10670310,484,0,1,0,2
10669856,10670095,239,0,1,0,1
10670333,10670458,125,0,0,1,1
10670446,10671023,577,0,0,1,2
10670459,10670482,23,1,0,0,1
10670483,10671024,541,0,0,1,1
10671024,10671108,84,1,0,0,2
10671025,10671056,31,1,0,0,1
10671057,10671289,232,0,0,1,1
10671109,10671290,181,0,0,1,2
10671290,10671322,32,1,0,0,1
10671291,10671318,27,1,0,0,2
10671319,10671357,38,0,0,1,2
10671323,10671603,280,0,0,1,1
10671358,10671403,45,1,0,0,2
10671404,10671601,197,0,0,1,2
10671602,10676452,4850,1,0,0,2
10671604,10671684,80,1,0,0,1
10671685,10671849,164,0,0,1,1
10671850,10671868,18,1,0,0,1
10671869,10672056,187,0,0,1,1
10672057,10672074,17,1,0,0,1
10672075,10672284,209,0,0,1,1
10672285,10672304,19,1,0,0,1
10672305,10672501,196,0,0,1,1
10672502,10672512,10,1,0,0,1
10672513,10672943,430,0,0,1,1
10672944,10672963,19,1,0,0,1
10672961,10673925,964,0,1,0,2
10672964,10673307,343,0,0,1,1
10673308,10673357,49,1,0,0,1
10673358,10673568,210,0,0,1,1
10673569,10673587,18,1,0,0,1
10673588,10673640,52,0,0,1,1
10673641,10673706,65,1,0,0,1
10673707,10673757,50,0,0,1,1
10673758,10673931,173,1,0,0,1
10673932,10673959,27,0,0,1,1
10673960,10673964,4,1,0,0,1
10673965,10674064,99,0,0,1,1
10674065,10674084,19,1,0,0,1
10674085,10674276,191,0,0,1,1
10674277,10674301,24,1,0,0,1
10674302,10674413,111,0,0,1,1
10674410,10676211,1801,0,1,0,2
10674414,10674446,32,1,0,0,1
10674447,10674592,145,0,0,1,1
10674593,10675268,675,1,0,0,1
10675269,10675304,35,0,0,1,1
10675305,10676233,928,1,0,0,1
10676006,10676133,127,0,1,0,1
10676234,10676715,481,0,0,1,1
10676453,10676507,54,0,0,1,2
10676508,10676536,28,1,0,0,2
10676537,10676579,42,0,0,1,2
10676580,10676683,103,1,0,0,2
10676684,10676716,32,0,0,1,2
10676716,10676763,47,1,0,0,1
10676717,10676795,78,1,0,0,2
10676764,10677123,359,0,0,1,1
10676796,10677123,327,0,0,1,2
10677124,10677157,33,1,0,0,2
10677124,10677161,37,1,0,0,1
10677158,10677339,181,0,0,1,2
10677162,10677420,258,0,0,1,1
10677340,10677490,150,1,0,0,2
10677421,10677486,65,1,0,0,1
10677487,10677628,141,0,0,1,1
10677491,10677627,136,0,0,1,2
10677628,10677653,25,1,0,0,2
10677629,10677652,23,1,0,0,1
10677653,10677924,271,0,0,1,1
10677654,10677919,265,0,0,1,2
10677920,10677934,14,1,0,0,2
10677925,10677932,7,1,0,0,1
10677933,10678132,199,0,0,1,1
10677935,10678131,196,0,0,1,2
10678132,10678149,17,1,0,0,2
10678133,10678149,16,1,0,0,1
10678150,10678352,202,0,0,1,2
10678150,10678354,204,0,0,1,1
10678353,10678368,15,1,0,0,2
10678355,10678362,7,1,0,0,1
10678363,10678625,262,0,0,1,1
10678369,10678625,256,0,0,1,2
10678626,10678644,18,1,0,0,1
10678626,10678646,20,1,0,0,2
10678645,10678866,221,0,0,1,1
10678647,10678866,219,0,0,1,2
10678867,10678876,9,1,0,0,1
10678867,10678881,14,1,0,0,2
10678877,10679101,224,0,0,1,1
10678882,10679101,219,0,0,1,2
10679102,10679119,17,1,0,0,1
10679102,10679120,18,1,0,0,2
10679120,10679241,121,0,0,1,1
10679121,10679243,122,0,0,1,2
10679242,10679323,81,1,0,0,1
10679244,10679325,81,1,0,0,2
10679324,10679403,79,0,0,1,1
10679326,10679402,76,0,0,1,2
10679403,10679431,28,1,0,0,2
10679404,10679434,30,1,0,0,1
10679432,10679511,79,0,0,1,2
10679435,10679550,115,0,0,1,1
10679512,10679520,8,1,0,0,2
10679521,10679554,33,0,0,1,2
10679551,10679570,19,1,0,0,1
10679555,10679578,23,1,0,0,2
10679571,10679803,232,0,0,1,1
10679579,10679611,32,0,0,1,2
10679612,10679653,41,1,0,0,2
10679654,10679763,109,0,0,1,2
10679764,10679884,120,1,0,0,2
10679804,10679822,18,1,0,0,1
10679823,10679980,157,0,0,1,1
10679885,10679968,83,0,0,1,2
10679969,10679992,23,1,0,0,2
10679981,10679990,9,1,0,0,1
10679991,10680133,142,0,0,1,1
10679993,10680138,145,0,0,1,2
10680134,10680147,13,1,0,0,1
10680139,10680573,434,1,0,0,2
10680148,10680176,28,0,0,1,1
10680177,10680540,363,1,0,0,1
10680248,10680451,203,0,1,0,2
10680260,10680287,27,0,1,0,1
10680541,10680655,114,0,0,1,1
10680574,10680653,79,0,0,1,2
10680654,10680710,56,1,0,0,2
10680656,10680676,20,1,0,0,1
10680677,10680775,98,0,0,1,1
10680711,10681088,377,0,0,1,2
10680776,10681173,397,1,0,0,1
10681089,10681093,4,1,0,0,2
10681094,10681313,219,0,0,1,2
10681174,10681508,334,0,0,1,1
10681314,10682276,962,1,0,0,2
10681509,10745850,64341,1,0,0,1
10681532,10682087,555,0,1,0,2
10681548,10745840,64292,0,1,0,1
10682277,10682322,45,0,0,1,2
10682323,10682328,5,1,0,0,2
10682329,10682404,75,0,0,1,2
10682405,10682419,14,1,0,0,2
10682420,10682612,192,0,0,1,2
10682613,10682643,30,1,0,0,2
10682644,10682783,139,0,0,1,2
10682784,10682812,28,1,0,0,2
10682813,10683322,509,0,0,1,2
10683323,10683343,20,1,0,0,2
10683344,10683489,145,0,0,1,2
10683490,10683509,19,1,0,0,2
10683510,10683656,146,0,0,1,2
10683657,10683674,17,1,0,0,2
10683675,10683923,248,0,0,1,2
10683924,10683933,9,1,0,0,2
10683934,10684152,218,0,0,1,2
10684153,10684166,13,1,0,0,2
10684167,10684446,279,0,0,1,2
10684447,10684480,33,1,0,0,2
10684481,10684604,123,0,0,1,2
10684605,10684621,16,1,0,0,2
10684622,10684919,297,0,0,1,2
10684920,10684925,5,1,0,0,2
10684926,10685030,104,0,0,1,2
10685031,10685146,115,1,0,0,2
10685147,10685184,37,0,0,1,2
10685185,10685374,189,1,0,0,2
10685375,10685399,24,0,0,1,2
10685400,10685425,25,1,0,0,2
10685426,10685570,144,0,0,1,2
10685571,10685656,85,1,0,0,2
10685657,10686138,481,0,0,1,2
10686139,10686161,22,1,0,0,2
10686162,10686304,142,0,0,1,2
10686305,10686372,67,1,0,0,2
10686373,10686401,28,0,0,1,2
10686402,10686410,8,1,0,0,2
10686411,10686505,94,0,0,1,2
10686506,10686510,4,1,0,0,2
10686511,10686629,118,0,0,1,2
10686630,10686691,61,1,0,0,2
10686692,10686720,28,0,0,1,2
10686721,10688040,1319,1,0,0,2
10687221,10687779,558,0,1,0,2
10688041,10688530,489,0,0,1,2
10688531,10688616,85,1,0,0,2
10688617,10688665,48,0,0,1,2
10688666,10688688,22,1,0,0,2
10688689,10688713,24,0,0,1,2
10688714,10688731,17,1,0,0,2
10688732,10688856,124,0,0,1,2
10688857,10688919,62,1,0,0,2
10688920,10689159,239,0,0,1,2
10689160,10693345,4185,1,0,0,2
10689970,10690777,807,0,1,0,2
10692746,10693048,302,0,1,0,2
10693346,10693544,198,0,0,1,2
10693545,10693991,446,1,0,0,2
10693992,10694019,27,0,0,1,2
10694020,10694164,144,1,0,0,2
10694165,10694253,88,0,0,1,2
10694254,10694286,32,1,0,0,2
10694287,10694336,49,0,0,1,2
10694337,10694622,285,1,0,0,2
10694623,10694659,36,0,0,1,2
10694660,10694718,58,1,0,0,2
10694719,10694877,158,0,0,1,2
10694878,10694932,54,1,0,0,2
10694933,10694966,33,0,0,1,2
10694967,10695007,40,1,0,0,2
10695008,10695559,551,0,0,1,2
10695560,10695619,59,1,0,0,2
10695620,10695784,164,0,0,1,2
10695785,10695854,69,1,0,0,2
10695855,10695903,48,0,0,1,2
10695904,10698800,2896,1,0,0,2
10696178,10696210,32,0,1,0,2
10696465,10696505,40,0,1,0,2
10696556,10696580,24,0,1,0,2
10696782,10696791,9,0,1,0,2
10696815,10696844,29,0,1,0,2
10696874,10698622,1748,0,1,0,2
10698801,10698972,171,0,0,1,2
10698973,10699050,77,1,0,0,2
10699051,10699096,45,0,0,1,2
10699097,10699305,208,1,0,0,2
10699306,10699354,48,0,0,1,2
10699355,10699743,388,1,0,0,2
10699744,10699774,30,0,0,1,2
10699775,10701344,1569,1,0,0,2
10701345,10701414,69,0,0,1,2
10701415,10701615,200,1,0,0,2
10701616,10701673,57,0,0,1,2
10701674,10704451,2777,1,0,0,2
10703355,10703540,185,0,1,0,2
10704452,10704538,86,0,0,1,2
10704539,10704651,112,1,0,0,2
10704652,10704750,98,0,0,1,2
10704751,10704774,23,1,0,0,2
10704775,10704872,97,0,0,1,2
10704873,10704898,25,1,0,0,2
10704899,10705017,118,0,0,1,2
10705018,10705041,23,1,0,0,2
10705042,10705303,261,0,0,1,2
10705304,10705391,87,1,0,0,2
10705392,10705444,52,0,0,1,2
10705445,10705523,78,1,0,0,2
10705524,10705645,121,0,0,1,2
10705646,10705784,138,1,0,0,2
10705785,10705880,95,0,0,1,2
10705881,10705910,29,1,0,0,2
10705911,10705964,53,0,0,1,2
10705965,10709835,3870,1,0,0,2
10707146,10707311,165,0,1,0,2
10707332,10709657,2325,0,1,0,2
10709836,10709942,106,0,0,1,2
10709943,10709955,12,1,0,0,2
10709956,10710109,153,0,0,1,2
10710110,10710128,18,1,0,0,2
10710129,10710428,299,0,0,1,2
10710429,10710488,59,1,0,0,2
10710489,10710605,116,0,0,1,2
10710606,10710617,11,1,0,0,2
10710618,10711091,473,0,0,1,2
10711092,10711203,111,1,0,0,2
10711204,10711284,80,0,0,1,2
10711285,10711412,127,1,0,0,2
10711413,10711506,93,0,0,1,2
10711507,10711533,26,1,0,0,2
10711534,10711628,94,0,0,1,2
10711629,10712191,562,1,0,0,2
10712192,10712546,354,0,0,1,2
10712547,10712587,40,1,0,0,2
10712588,10712640,52,0,0,1,2
10712641,10712653,12,1,0,0,2
10712654,10712847,193,0,0,1,2
10712848,10712852,4,1,0,0,2
10712853,10712933,80,0,0,1,2
10712934,10713166,232,1,0,0,2
10713167,10713273,106,0,0,1,2
10713274,10713284,10,1,0,0,2
10713285,10713457,172,0,0,1,2
10713458,10713786,328,1,0,0,2
10713787,10713870,83,0,0,1,2
10713871,10716849,2978,1,0,0,2
10716252,10716532,280,0,1,0,2
10716850,10717003,153,0,0,1,2
10717004,10717027,23,1,0,0,2
10717028,10717369,341,0,0,1,2
10717370,10717427,57,1,0,0,2
10717428,10717806,378,0,0,1,2
10717807,10717818,11,1,0,0,2
10717819,10718019,200,0,0,1,2
10718020,10718039,19,1,0,0,2
10718040,10718907,867,0,0,1,2
10718908,10719011,103,1,0,0,2
10719012,10719060,48,0,0,1,2
10719061,10719111,50,1,0,0,2
10719112,10719137,25,0,0,1,2
10719138,10719154,16,1,0,0,2
10719155,10719188,33,0,0,1,2
10719189,10719217,28,1,0,0,2
10719218,10719309,91,0,0,1,2
10719310,10719329,19,1,0,0,2
10719330,10719406,76,0,0,1,2
10719407,10719437,30,1,0,0,2
10719438,10719670,232,0,0,1,2
10719671,10719806,135,1,0,0,2
10719807,10719877,70,0,0,1,2
10719878,10719952,74,1,0,0,2
10719953,10720012,59,0,0,1,2
10720013,10721126,1113,1,0,0,2
10721127,10721153,26,0,0,1,2
10721154,10722371,1217,1,0,0,2
10721252,10721737,485,0,1,0,2
10721793,10721821,28,0,1,0,2
10721843,10721889,46,0,1,0,2
10721913,10721976,63,0,1,0,2
10722005,10722007,2,0,1,0,2
10722372,10722417,45,0,0,1,2
10722418,10722489,71,1,0,0,2
10722490,10722570,80,0,0,1,2
10722571,10722705,134,1,0,0,2
10722706,10722808,102,0,0,1,2
10722809,10734335,11526,1,0,0,2
10722821,10734287,11466,0,1,0,2
10734336,10734411,75,0,0,1,2
10734412,10734709,297,1,0,0,2
10734710,10734762,52,0,0,1,2
10734763,10734800,37,1,0,0,2
10734801,10735086,285,0,0,1,2
10735087,10735109,22,1,0,0,2
10735110,10735258,148,0,0,1,2
10735259,10735272,13,1,0,0,2
10735273,10735422,149,0,0,1,2
10735423,10735441,18,1,0,0,2
10735442,10735969,527,0,0,1,2
10735970,10735983,13,1,0,0,2
10735984,10736054,70,0,0,1,2
10736055,10736086,31,1,0,0,2
10736087,10736214,127,0,0,1,2
10736215,10736370,155,1,0,0,2
10736371,10736445,74,0,0,1,2
10736446,10736469,23,1,0,0,2
10736470,10736806,336,0,0,1,2
10736807,10736818,11,1,0,0,2
10736819,10736925,106,0,0,1,2
10736926,10736951,25,1,0,0,2
10736952,10737158,206,0,0,1,2
10737159,10737215,56,1,0,0,2
10737216,10737288,72,0,0,1,2
10737289,10737299,10,1,0,0,2
10737300,10737321,21,0,0,1,2
10737322,10737337,15,1,0,0,2
10737338,10737868,530,0,0,1,2
10737869,10737927,58,1,0,0,2
10737928,10737963,35,0,0,1,2
10737964,10737971,7,1,0,0,2
10737972,10738083,111,0,0,1,2
10738084,10738177,93,1,0,0,2
10738178,10738230,52,0,0,1,2
10738231,10738305,74,1,0,0,2
10738306,10738394,88,0,0,1,2
10738395,10738413,18,1,0,0,2
10738414,10738758,344,0,0,1,2
10738759,10738965,206,1,0,0,2
10738966,10739288,322,0,0,1,2
10739289,10739343,54,1,0,0,2
10739344,10739378,34,0,0,1,2
10739379,10739523,144,1,0,0,2
10739524,10739634,110,0,0,1,2
10739635,10739651,16,1,0,0,2
10739652,10739714,62,0,0,1,2
10739715,10739725,10,1,0,0,2
10739726,10739881,155,0,0,1,2
10739882,10739998,116,1,0,0,2
10739999,10740070,71,0,0,1,2
10740071,10744399,4328,1,0,0,2
10741138,10744346,3208,0,1,0,2
10744400,10744613,213,0,0,1,2
10744614,10744696,82,1,0,0,2
10744697,10744756,59,0,0,1,2
10744757,10745009,252,1,0,0,2
10745010,10745055,45,0,0,1,2
10745056,10745134,78,1,0,0,2
10745135,10745250,115,0,0,1,2
10745251,10745630,379,1,0,0,2
10745369,10745522,153,0,1,0,2
10745631,10746063,432,0,0,1,2
10745851,10746066,215,0,0,1,1
10746064,10746127,63,1,0,0,2
10746067,10746120,53,1,0,0,1
10746121,10746523,402,0,0,1,1
10746128,10746522,394,0,0,1,2
10746523,10746567,44,1,0,0,2
10746524,10746568,44,1,0,0,1
10746568,10746742,174,0,0,1,2
10746569,10746742,173,0,0,1,1
10746743,10746799,56,1,0,0,1
10746743,10746800,57,1,0,0,2
10746800,10746925,125,0,0,1,1
10746801,10746925,124,0,0,1,2
10746926,10746940,14,1,0,0,2
10746926,10746944,18,1,0,0,1
10746941,10747106,165,0,0,1,2
10746945,10747109,164,0,0,1,1
10747107,10747120,13,1,0,0,2
10747110,10747116,6,1,0,0,1
10747117,10747597,480,0,0,1,1
10747121,10747599,478,0,0,1,2
10747598,10747609,11,1,0,0,1
10747600,10747604,4,1,0,0,2
10747605,10747894,289,0,0,1,2
10747610,10747895,285,0,0,1,1
10747895,10747914,19,1,0,0,2
10747896,10747915,19,1,0,0,1
10747915,10748007,92,0,0,1,2
10747916,10748058,142,0,0,1,1
10748008,10748068,60,1,0,0,2
10748059,10748065,6,1,0,0,1
10748066,10748252,186,0,0,1,1
10748069,10748252,183,0,0,1,2
10748253,10748274,21,1,0,0,1
10748253,10748277,24,1,0,0,2
10748275,10748463,188,0,0,1,1
10748278,10748467,189,0,0,1,2
10748464,10748529,65,1,0,0,1
10748468,10748531,63,1,0,0,2
10748530,10748605,75,0,0,1,1
10748532,10748610,78,0,0,1,2
10748606,10748654,48,1,0,0,1
10748611,10748645,34,1,0,0,2
10748646,10748835,189,0,0,1,2
10748655,10748835,180,0,0,1,1
10748836,10748859,23,1,0,0,2
10748836,10748862,26,1,0,0,1
10748860,10749586,726,0,0,1,2
10748863,10749616,753,0,0,1,1
10749597,10751261,1664,0,1,0,2
10749617,10749635,18,1,0,0,1
10749636,10749731,95,0,0,1,1
10749732,10749745,13,1,0,0,1
10749746,10749931,185,0,0,1,1
10749932,10749938,6,1,0,0,1
10749939,10750305,366,0,0,1,1
10750306,10751154,848,1,0,0,1
10751155,10751424,269,0,0,1,1
10751271,10752343,1072,1,0,0,2
10751391,10751987,596,0,1,0,2
10751425,10751443,18,1,0,0,1
10751444,10751505,61,0,0,1,1
10751506,10751538,32,1,0,0,1
10751539,10751575,36,0,0,1,1
10751576,10752062,486,1,0,0,1
10751646,10751733,87,0,1,0,1
10752063,10752213,150,0,0,1,1
10752214,10752225,11,1,0,0,1
10752226,10752379,153,0,0,1,1
10752344,10752378,34,0,0,1,2
10752379,10758466,6087,1,0,0,2
10752380,10752469,89,1,0,0,1
10752436,10752440,4,0,1,0,2
10752470,10752599,129,0,0,1,1
10752600,10752646,46,1,0,0,1
10752647,10752900,253,0,0,1,1
10752870,10752919,49,0,1,0,2
10752901,10752921,20,1,0,0,1
10752922,10753141,219,0,0,1,1
10753142,10753161,19,1,0,0,1
10753145,10758302,5157,0,1,0,2
10753162,10753329,167,0,0,1,1
10753330,10753340,10,1,0,0,1
10753341,10753474,133,0,0,1,1
10753475,10753564,89,1,0,0,1
10753565,10753752,187,0,0,1,1
10753753,10756675,2922,1,0,0,1
10756676,10756773,97,0,0,1,1
10756774,10756869,95,1,0,0,1
10756870,10756890,20,0,0,1,1
10756891,10757176,285,1,0,0,1
10757177,10757212,35,0,0,1,1
10757213,10757230,17,1,0,0,1
10757231,10757392,161,0,0,1,1
10757393,10757410,17,1,0,0,1
10757411,10757560,149,0,0,1,1
10757561,10757580,19,1,0,0,1
10757581,10757853,272,0,0,1,1
10757854,10758350,496,1,0,0,1
10758138,10758247,109,0,1,0,1
10758351,10758670,319,0,0,1,1
10758467,10758491,24,0,0,1,2
10758492,10758496,4,1,0,0,2
10758497,10758555,58,0,0,1,2
10758556,10758595,39,1,0,0,2
10758596,10758653,57,0,0,1,2
10758654,10758706,52,1,0,0,2
10758671,10758678,7,1,0,0,1
10758679,10758809,130,0,0,1,1
10758707,10758786,79,0,0,1,2
10758787,10758984,197,1,0,0,2
10758810,10758848,38,1,0,0,1
10758849,10759143,294,0,0,1,1
10758985,10759055,70,0,0,1,2
10759056,10759904,848,1,0,0,2
10759144,10759477,333,1,0,0,1
10759180,10759420,240,0,1,0,2
10759199,10759387,188,0,1,0,1
10759478,10759819,341,0,0,1,1
10759820,10759875,55,1,0,0,1
10759876,10759992,116,0,0,1,1
10759905,10759993,88,0,0,1,2
10759993,10760036,43,1,0,0,1
10759994,10765229,5235,1,0,0,2
10760016,10760355,339,0,1,0,2
10760037,10760175,138,0,0,1,1
10760176,10760196,20,1,0,0,1
10760197,10760337,140,0,0,1,1
10760338,10760353,15,1,0,0,1
10760354,10760753,399,0,0,1,1
10760409,10762547,2138,0,1,0,2
10760754,10760772,18,1,0,0,1
10760773,10761264,491,0,0,1,1
10761265,10761278,13,1,0,0,1
10761279,10761807,528,0,0,1,1
10761808,10761867,59,1,0,0,1
10761868,10761905,37,0,0,1,1
10761906,10762214,308,1,0,0,1
10762215,10762878,663,0,0,1,1
10762713,10762715,2,0,1,0,2
10762737,10762748,11,0,1,0,2
10762805,10764833,2028,0,1,0,2
10762879,10762901,22,1,0,0,1
10762902,10763619,717,0,0,1,1
10763620,10763634,14,1,0,0,1
10763635,10763667,32,0,0,1,1
10763668,10763881,213,1,0,0,1
10763882,10764014,132,0,0,1,1
10764015,10764085,70,1,0,0,1
10764086,10764157,71,0,0,1,1
10764158,10764971,813,1,0,0,1
10764355,10764512,157,0,1,0,1
10764885,10764908,23,0,1,0,2
10764972,10765206,234,0,0,1,1
10765207,10765231,24,1,0,0,1
10765230,10765363,133,0,0,1,2
10765232,10765731,499,0,0,1,1
10765364,10765368,4,1,0,0,2
10765369,10765403,34,0,0,1,2
10765404,10765480,76,1,0,0,2
10765481,10765514,33,0,0,1,2
10765515,10765565,50,1,0,0,2
10765566,10765928,362,0,0,1,2
10765732,10765987,255,1,0,0,1
10765929,10766038,109,1,0,0,2
10765988,10766127,139,0,0,1,1
10766039,10766114,75,0,0,1,2
10766115,10766155,40,1,0,0,2
10766128,10766159,31,1,0,0,1
10766156,10766599,443,0,0,1,2
10766160,10766837,677,0,0,1,1
10766600,10766626,26,1,0,0,2
10766627,10766674,47,0,0,1,2
10766675,10766689,14,1,0,0,2
10766690,10766773,83,0,0,1,2
10766774,10766859,85,1,0,0,2
10766838,10766860,22,1,0,0,1
10766860,10766975,115,0,0,1,2
10766861,10767047,186,0,0,1,1
10766976,10767079,103,1,0,0,2
10767048,10767116,68,1,0,0,1
10767080,10767115,35,0,0,1,2
10767116,10767133,17,1,0,0,2
10767117,10767233,116,0,0,1,1
10767134,10767168,34,0,0,1,2
10767169,10767238,69,1,0,0,2
10767234,10767249,15,1,0,0,1
10767239,10767287,48,0,0,1,2
10767250,10767295,45,0,0,1,1
10767288,10767313,25,1,0,0,2
10767296,10767331,35,1,0,0,1
10767314,10767395,81,0,0,1,2
10767332,10767487,155,0,0,1,1
10767396,10767921,525,1,0,0,2
10767488,10767558,70,1,0,0,1
10767559,10767645,86,0,0,1,1
10767646,10767678,32,1,0,0,1
10767679,10767817,138,0,0,1,1
10767818,10767832,14,1,0,0,1
10767833,10768043,210,0,0,1,1
10767922,10768144,222,0,0,1,2
10768044,10768060,16,1,0,0,1
10768061,10768200,139,0,0,1,1
10768145,10768156,11,1,0,0,2
10768157,10768183,26,0,0,1,2
10768184,10768198,14,1,0,0,2
10768199,10768251,52,0,0,1,2
10768201,10768308,107,1,0,0,1
10768252,10770748,2496,1,0,0,2
10768309,10768415,106,0,0,1,1
10768324,10768343,19,0,1,0,2
10768385,10770397,2012,0,1,0,2
10768416,10768431,15,1,0,0,1
10768432,10768457,25,0,0,1,1
10768458,10768714,256,1,0,0,1
10768715,10768796,81,0,0,1,1
10768797,10768922,125,1,0,0,1
10768923,10768954,31,0,0,1,1
10768955,10769053,98,1,0,0,1
10769054,10769139,85,0,0,1,1
10769140,10769229,89,1,0,0,1
10769230,10769351,121,0,0,1,1
10769352,10769510,158,1,0,0,1
10769511,10769569,58,0,0,1,1
10769570,10770532,962,1,0,0,1
10770003,10770248,245,0,1,0,1
10770533,10770619,86,0,0,1,1
10770620,10770665,45,1,0,0,1
10770666,10770832,166,0,0,1,1
10770749,10770778,29,0,0,1,2
10770779,10770948,169,1,0,0,2
10770833,10770899,66,1,0,0,1
10770900,10771021,121,0,0,1,1
10770949,10770985,36,0,0,1,2
10770986,10771059,73,1,0,0,2
10771022,10771058,36,1,0,0,1
10771059,10771301,242,0,0,1,1
10771060,10771306,246,0,0,1,2
10771302,10771325,23,1,0,0,1
10771307,10771323,16,1,0,0,2
10771324,10771500,176,0,0,1,2
10771326,10771500,174,0,0,1,1
10771501,10771524,23,1,0,0,2
10771501,10771525,24,1,0,0,1
10771525,10771653,128,0,0,1,2
10771526,10771654,128,0,0,1,1
10771654,10771667,13,1,0,0,2
10771655,10771668,13,1,0,0,1
10771668,10771842,174,0,0,1,2
10771669,10771905,236,0,0,1,1
10771843,10771851,8,1,0,0,2
10771852,10771904,52,0,0,1,2
10771905,10771978,73,1,0,0,2
10771906,10771929,23,1,0,0,1
10771930,10772083,153,0,0,1,1
10771979,10772014,35,0,0,1,2
10772015,10772195,180,1,0,0,2
10772084,10772103,19,1,0,0,1
10772104,10772605,501,0,0,1,1
10772196,10772372,176,0,0,1,2
10772373,10772479,106,1,0,0,2
10772480,10772537,57,0,0,1,2
10772538,10772564,26,1,0,0,2
10772565,10772605,40,0,0,1,2
10772606,10772627,21,1,0,0,1
10772606,10773029,423,1,0,0,2
10772628,10772805,177,0,0,1,1
10772806,10772829,23,1,0,0,1
10772830,10773064,234,0,0,1,1
10773030,10773071,41,0,0,1,2
10773065,10773081,16,1,0,0,1
10773072,10773136,64,1,0,0,2
10773082,10773212,130,0,0,1,1
10773137,10773166,29,0,0,1,2
10773167,10773182,15,1,0,0,2
10773183,10773204,21,0,0,1,2
10773205,10773250,45,1,0,0,2
10773213,10773226,13,1,0,0,1
10773227,10773451,224,0,0,1,1
10773251,10773335,84,0,0,1,2
10773336,10773340,4,1,0,0,2
10773341,10773389,48,0,0,1,2
10773390,10773404,14,1,0,0,2
10773405,10773455,50,0,0,1,2
10773452,10773501,49,1,0,0,1
10773456,10774132,676,1,0,0,2
10773502,10773926,424,0,0,1,1
10773927,10773936,9,1,0,0,1
10773937,10774460,523,0,0,1,1
10774133,10774160,27,0,0,1,2
10774161,10776819,2658,1,0,0,2
10774461,10774471,10,1,0,0,1
10774472,10775727,1255,0,0,1,1
10775728,10776211,483,1,0,0,1
10775820,10776185,365,0,1,0,2
10775829,10776040,211,0,1,0,1
10776212,10776456,244,0,0,1,1
10776457,10776495,38,1,0,0,1
10776496,10776772,276,0,0,1,1
10776773,10776780,7,1,0,0,1
10776781,10777077,296,0,0,1,1
10776820,10776888,68,0,0,1,2
10776889,10776899,10,1,0,0,2
10776900,10776923,23,0,0,1,2
10776924,10776951,27,1,0,0,2
10776952,10777025,73,0,0,1,2
10777026,10777088,62,1,0,0,2
10777078,10777131,53,1,0,0,1
10777089,10777127,38,0,0,1,2
10777128,10777148,20,1,0,0,2
10777132,10777219,87,0,0,1,1
10777149,10777302,153,0,0,1,2
10777220,10777235,15,1,0,0,1
10777236,10777294,58,0,0,1,1
10777295,10777341,46,1,0,0,1
10777303,10777341,38,1,0,0,2
10777342,10777362,20,0,0,1,2
10777342,10777398,56,0,0,1,1
10777363,10777445,82,1,0,0,2
10777399,10777423,24,1,0,0,1
10777424,10778284,860,0,0,1,1
10777446,10777615,169,0,0,1,2
10777616,10777672,56,1,0,0,2
10777673,10777939,266,0,0,1,2
10777940,10777969,29,1,0,0,2
10777970,10778102,132,0,0,1,2
10778103,10778169,66,1,0,0,2
10778170,10778269,99,0,0,1,2
10778270,10780120,1850,1,0,0,2
10778285,10778319,34,1,0,0,1
10778320,10778734,414,0,0,1,1
10778735,10778893,158,1,0,0,1
10778894,10778963,69,0,0,1,1
10778897,10778900,3,0,1,0,2
10778923,10779033,110,0,1,0,2
10778964,10778989,25,1,0,0,1
10778990,10779147,157,0,0,1,1
10779148,10779188,40,1,0,0,1
10779189,10779243,54,0,0,1,1
10779220,10779304,84,0,1,0,2
10779244,10779291,47,1,0,0,1
10779292,10779320,28,0,0,1,1
10779321,10779427,106,1,0,0,1
10779428,10779605,177,0,0,1,1
10779606,10779612,6,1,0,0,1
10779613,10779678,65,0,0,1,1
10779679,10779727,48,1,0,0,1
10779728,10779847,119,0,0,1,1
10779848,10779868,20,1,0,0,1
10779869,10780019,150,0,0,1,1
10780020,10780025,5,1,0,0,1
10780026,10780208,182,0,0,1,1
10780121,10780208,87,0,0,1,2
10780209,10780234,25,1,0,0,1
10780209,10782850,2641,1,0,0,2
10780235,10780440,205,0,0,1,1
10780441,10780446,5,1,0,0,1
10780447,10780624,177,0,0,1,1
10780625,10780635,10,1,0,0,1
10780636,10781290,654,0,0,1,1
10781291,10781317,26,1,0,0,1
10781318,10781949,631,0,0,1,1
10781950,10782370,420,1,0,0,1
10781974,10782309,335,0,1,0,2
10782013,10782249,236,0,1,0,1
10782371,10782538,167,0,0,1,1
10782539,10782585,46,1,0,0,1
10782586,10782719,133,0,0,1,1
10782720,10782850,130,1,0,0,1
10782851,10782988,137,0,0,1,2
10782851,10783018,167,0,0,1,1
10782989,10783104,115,1,0,0,2
10783019,10783066,47,1,0,0,1
10783067,10783112,45,0,0,1,1
10783105,10783154,49,0,0,1,2
10783113,10826923,43810,1,0,0,1
10783155,10783891,736,1,0,0,2
10783211,10783730,519,0,1,0,2
10783219,10826913,43694,0,1,0,1
10783892,10783930,38,0,0,1,2
10783931,10783969,38,1,0,0,2
10783970,10783993,23,0,0,1,2
10783994,10784060,66,1,0,0,2
10784061,10784099,38,0,0,1,2
10784100,10789993,5893,1,0,0,2
10784359,10788317,3958,0,1,0,2
10788356,10788373,17,0,1,0,2
10788477,10788493,16,0,1,0,2
10788587,10788598,11,0,1,0,2
10788663,10789686,1023,0,1,0,2
10789994,10790064,70,0,0,1,2
10790065,10790300,235,1,0,0,2
10790301,10790350,49,0,0,1,2
10790351,10790479,128,1,0,0,2
10790480,10790503,23,0,0,1,2
10790504,10790598,94,1,0,0,2
10790599,10791241,642,0,0,1,2
10791242,10805203,13961,1,0,0,2
10791828,10791831,3,0,1,0,2
10791874,10796947,5073,0,1,0,2
10797821,10798334,513,0,1,0,2
10799327,10799344,17,0,1,0,2
10800051,10800870,819,0,1,0,2
10801780,10802145,365,0,1,0,2
10802831,10804894,2063,0,1,0,2
10805204,10805342,138,0,0,1,2
10805343,10805434,91,1,0,0,2
10805435,10805492,57,0,0,1,2
10805493,10805548,55,1,0,0,2
10805549,10805660,111,0,0,1,2
10805661,10805826,165,1,0,0,2
10805827,10805961,134,0,0,1,2
10805962,10805979,17,1,0,0,2
10805980,10806264,284,0,0,1,2
10806265,10806288,23,1,0,0,2
10806289,10806415,126,0,0,1,2
10806416,10806625,209,1,0,0,2
10806626,10806703,77,0,0,1,2
10806704,10806712,8,1,0,0,2
10806713,10806787,74,0,0,1,2
10806788,10807171,383,1,0,0,2
10807172,10807248,76,0,0,1,2
10807249,10807309,60,1,0,0,2
10807310,10807412,102,0,0,1,2
10807413,10807477,64,1,0,0,2
10807478,10808453,975,0,0,1,2
10808454,10808461,7,1,0,0,2
10808462,10809226,764,0,0,1,2
10809227,10809249,22,1,0,0,2
10809250,10809380,130,0,0,1,2
10809381,10809420,39,1,0,0,2
10809421,10809698,277,0,0,1,2
10809699,10809781,82,1,0,0,2
10809782,10810019,237,0,0,1,2
10810020,10810325,305,1,0,0,2
10810326,10810436,110,0,0,1,2
10810437,10810525,88,1,0,0,2
10810526,10810601,75,0,0,1,2
10810602,10810647,45,1,0,0,2
10810648,10810921,273,0,0,1,2
10810922,10811006,84,1,0,0,2
10811007,10811088,81,0,0,1,2
10811089,10811113,24,1,0,0,2
10811114,10811331,217,0,0,1,2
10811332,10811355,23,1,0,0,2
10811356,10811453,97,0,0,1,2
10811454,10811682,228,1,0,0,2
10811683,10811749,66,0,0,1,2
10811750,10816123,4373,1,0,0,2
10811974,10812533,559,0,1,0,2
10812586,10812644,58,0,1,0,2
10813432,10813661,229,0,1,0,2
10813865,10816074,2209,0,1,0,2
10816124,10816223,99,0,0,1,2
10816224,10816252,28,1,0,0,2
10816253,10816484,231,0,0,1,2
10816485,10816553,68,1,0,0,2
10816554,10816691,137,0,0,1,2
10816692,10816956,264,1,0,0,2
10816957,10816994,37,0,0,1,2
10816995,10817014,19,1,0,0,2
10817015,10817100,85,0,0,1,2
10817101,10817205,104,1,0,0,2
10817206,10817482,276,0,0,1,2
10817483,10817549,66,1,0,0,2
10817550,10817654,104,0,0,1,2
10817655,10817701,46,1,0,0,2
10817702,10818886,1184,0,0,1,2
10818887,10818909,22,1,0,0,2
10818910,10819032,122,0,0,1,2
10819033,10819053,20,1,0,0,2
10819054,10819386,332,0,0,1,2
10819387,10819406,19,1,0,0,2
10819407,10819850,443,0,0,1,2
10819851,10819899,48,1,0,0,2
10819900,10819968,68,0,0,1,2
10819969,10820144,175,1,0,0,2
10820145,10820205,60,0,0,1,2
10820206,10820432,226,1,0,0,2
10820433,10820464,31,0,0,1,2
10820465,10820706,241,1,0,0,2
10820707,10820764,57,0,0,1,2
10820765,10820904,139,1,0,0,2
10820905,10821042,137,0,0,1,2
10821043,10821064,21,1,0,0,2
10821065,10821199,134,0,0,1,2
10821200,10821224,24,1,0,0,2
10821225,10821337,112,0,0,1,2
10821338,10821414,76,1,0,0,2
10821415,10821503,88,0,0,1,2
10821504,10821602,98,1,0,0,2
10821603,10821648,45,0,0,1,2
10821649,10821712,63,1,0,0,2
10821713,10821938,225,0,0,1,2
10821939,10821979,40,1,0,0,2
10821980,10822185,205,0,0,1,2
10822186,10822269,83,1,0,0,2
10822270,10822348,78,0,0,1,2
10822349,10822385,36,1,0,0,2
10822386,10822562,176,0,0,1,2
10822563,10822608,45,1,0,0,2
10822609,10822767,158,0,0,1,2
10822768,10822834,66,1,0,0,2
10822835,10822996,161,0,0,1,2
10822997,10823002,5,1,0,0,2
10823003,10823188,185,0,0,1,2
10823189,10823229,40,1,0,0,2
10823230,10823361,131,0,0,1,2
10823362,10823453,91,1,0,0,2
10823454,10823497,43,0,0,1,2
10823498,10823695,197,1,0,0,2
10823696,10823738,42,0,0,1,2
10823739,10823933,194,1,0,0,2
10823934,10824145,211,0,0,1,2
10824146,10824186,40,1,0,0,2
10824187,10824460,273,0,0,1,2
10824461,10824776,315,1,0,0,2
10824490,10824631,141,0,1,0,2
10824777,10825008,231,0,0,1,2
10825009,10825034,25,1,0,0,2
10825035,10825242,207,0,0,1,2
10825243,10825707,464,1,0,0,2
10825281,10825467,186,0,1,0,2
10825708,10825770,62,0,0,1,2
10825771,10825781,10,1,0,0,2
10825782,10825999,217,0,0,1,2
10826000,10826057,57,1,0,0,2
10826058,10826237,179,0,0,1,2
10826238,10826319,81,1,0,0,2
10826320,10826375,55,0,0,1,2
10826376,10826396,20,1,0,0,2
10826397,10826421,24,0,0,1,2
10826422,10826429,7,1,0,0,2
10826430,10826473,43,0,0,1,2
10826474,10826916,442,1,0,0,2
10826521,10826759,238,0,1,0,2
10826917,10826942,25,0,0,1,2
10826924,10827100,176,0,0,1,1
10826943,10827467,524,1,0,0,2
10827101,10827170,69,1,0,0,1
10827171,10827207,36,0,0,1,1
10827208,10827242,34,1,0,0,1
10827243,10827316,73,0,0,1,1
10827317,10827361,44,1,0,0,1
10827362,10827822,460,0,0,1,1
10827468,10827686,218,0,0,1,2
10827687,10827870,183,1,0,0,2
10827823,10827848,25,1,0,0,1
10827849,10828137,288,0,0,1,1
10827871,10827901,30,0,0,1,2
10827902,10828091,189,1,0,0,2
10828092,10828136,44,0,0,1,2
10828137,10829170,1033,1,0,0,2
10828138,10828176,38,1,0,0,1
10828177,10828341,164,0,0,1,1
10828342,10828456,114,1,0,0,1
10828457,10828561,104,0,0,1,1
10828562,10828814,252,1,0,0,1
10828590,10828769,179,0,1,0,2
10828599,10828701,102,0,1,0,1
10828815,10828978,163,0,0,1,1
10828979,10829116,137,1,0,0,1
10829117,10829305,188,0,0,1,1
10829171,10829203,32,0,0,1,2
10829204,10829557,353,1,0,0,2
10829306,10829471,165,1,0,0,1
10829472,10829666,194,0,0,1,1
10829558,10829644,86,0,0,1,2
10829645,10830649,1004,1,0,0,2
10829667,10829694,27,1,0,0,1
10829695,10829789,94,0,0,1,1
10829790,10830033,243,1,0,0,1
10829830,10829971,141,0,1,0,2
10829842,10829864,22,0,1,0,1
10830034,10830139,105,0,0,1,1
10830140,10830390,250,1,0,0,1
10830176,10830343,167,0,1,0,2
10830188,10830276,88,0,1,0,1
10830391,10830427,36,0,0,1,1
10830428,10830483,55,1,0,0,1
10830484,10830515,31,0,0,1,1
10830516,10830609,93,1,0,0,1
10830610,10830691,81,0,0,1,1
10830650,10830690,40,0,0,1,2
10830691,10830749,58,1,0,0,2
10830692,10830743,51,1,0,0,1
10830744,10831117,373,0,0,1,1
10830750,10830792,42,0,0,1,2
10830793,10830836,43,1,0,0,2
10830837,10830904,67,0,0,1,2
10830905,10831003,98,1,0,0,2
10831004,10831039,35,0,0,1,2
10831040,10831053,13,1,0,0,2
10831054,10831117,63,0,0,1,2
10918699,10918918,219,0,0,1,2
10918699,10918920,221,0,0,1,1
10918919,10918952,33,1,0,0,2
10918921,10918951,30,1,0,0,1
10918952,10919355,403,0,0,1,1
10918953,10919282,329,0,0,1,2
10919283,10919304,21,1,0,0,2
10919305,10919330,25,0,0,1,2
10919331,10919727,396,1,0,0,2
10919356,10919680,324,1,0,0,1
10919382,10919610,228,0,1,0,2
10919404,10919600,196,0,1,0,1
10919681,10919757,76,0,0,1,1
10919728,10919756,28,0,0,1,2
10919757,10919779,22,1,0,0,2
10919758,10919781,23,1,0,0,1
10919780,10919921,141,0,0,1,2
10919782,10919924,142,0,0,1,1
10919922,10919951,29,1,0,0,2
10919925,10919942,17,1,0,0,1
10919943,10920117,174,0,0,1,1
10919952,10920114,162,0,0,1,2
10920115,10920126,11,1,0,0,2
10920118,10920123,5,1,0,0,1
10920124,10920414,290,0,0,1,1
10920127,10920415,288,0,0,1,2
10920415,10920448,33,1,0,0,1
10920416,10920446,30,1,0,0,2
10920447,10920531,84,0,0,1,2
10920449,10920533,84,0,0,1,1
10920532,10920559,27,1,0,0,2
10920534,10920560,26,1,0,0,1
10920560,10920887,327,0,0,1,2
10920561,10920886,325,0,0,1,1
10920887,10920920,33,1,0,0,1
10920888,10920921,33,1,0,0,2
10920921,10921001,80,0,0,1,1
10920922,10920998,76,0,0,1,2
10920999,10921327,328,1,0,0,2
10921002,10921024,22,1,0,0,1
10921025,10921067,42,0,0,1,1
10921068,10921072,4,1,0,0,1
10921073,10921112,39,0,0,1,1
10921113,10921128,15,1,0,0,1
10921129,10921161,32,0,0,1,1
10921162,10921398,236,1,0,0,1
10921328,10921364,36,0,0,1,2
10921365,10922140,775,1,0,0,2
10921399,10921504,105,0,0,1,1
10921505,10921528,23,1,0,0,1
10921529,10921637,108,0,0,1,1
10921638,10921667,29,1,0,0,1
10921668,10921702,34,0,0,1,1
10921703,10922151,448,1,0,0,1
10921748,10922003,255,0,1,0,1
10921754,10922002,248,0,1,0,2
10922141,10922349,208,0,0,1,2
10922152,10922348,196,0,0,1,1
10922349,10922382,33,1,0,0,1
10922350,10922399,49,1,0,0,2
10922383,10922603,220,0,0,1,1
10922400,10922599,199,0,0,1,2
10922600,10922631,31,1,0,0,2
10922604,10922630,26,1,0,0,1
10922631,10923244,613,0,0,1,1
10922632,10923232,600,0,0,1,2
10923233,10923499,266,1,0,0,2
10923245,10923455,210,1,0,0,1
10923267,10923427,160,0,1,0,2
10923270,10923420,150,0,1,0,1
10923456,10923560,104,0,0,1,1
10923500,10923567,67,0,0,1,2
10923561,10923582,21,1,0,0,1
10923568,10923576,8,1,0,0,2
10923577,10924294,717,0,0,1,2
10923583,10924292,709,0,0,1,1
10924293,10924299,6,1,0,0,1
10924295,10924306,11,1,0,0,2
10924300,10925050,750,0,0,1,1
10924307,10924933,626,0,0,1,2
10924934,10924945,11,1,0,0,2
10924946,10924990,44,0,0,1,2
10924991,10925274,283,1,0,0,2
10925051,10925063,12,1,0,0,1
10925064,10925095,31,0,0,1,1
10925096,10925139,43,1,0,0,1
10925140,10925538,398,0,0,1,1
10925275,10925375,100,0,0,1,2
10925376,10925390,14,1,0,0,2
10925391,10925488,97,0,0,1,2
10925489,10925502,13,1,0,0,2
10925503,10925544,41,0,0,1,2
10925539,10925544,5,1,0,0,1
10925545,10925550,5,1,0,0,2
10925545,10925586,41,0,0,1,1
10925551,10925587,36,0,0,1,2
10925587,10925809,222,1,0,0,1
10925588,10925863,275,1,0,0,2
10925617,10925781,164,0,1,0,1
10925619,10925780,161,0,1,0,2
10925810,10928396,2586,0,0,1,1
10925864,10926698,834,0,0,1,2
10926699,10926712,13,1,0,0,2
10926713,10928394,1681,0,0,1,2
10928395,10928453,58,1,0,0,2
10928397,10928458,61,1,0,0,1
10928454,10928617,163,0,0,1,2
10928459,10928614,155,0,0,1,1
10928615,10928634,19,1,0,0,1
10928618,10928628,10,1,0,0,2
10928629,10928992,363,0,0,1,2
10928635,10928993,358,0,0,1,1
10928993,10929006,13,1,0,0,2
10928994,10929007,13,1,0,0,1
10929007,10929772,765,0,0,1,2
10929008,10929774,766,0,0,1,1
10929773,10929791,18,1,0,0,2
10929775,10929794,19,1,0,0,1
10929792,10930040,248,0,0,1,2
10929795,10930039,244,0,0,1,1
10930040,10930087,47,1,0,0,1
10930041,10930081,40,1,0,0,2
10930082,10930415,333,0,0,1,2
10930088,10930413,325,0,0,1,1
10930414,10930494,80,1,0,0,1
10930416,10930504,88,1,0,0,2
10930495,10930823,328,0,0,1,1
10930505,10930825,320,0,0,1,2
10930824,10930842,18,1,0,0,1
10930826,10930847,21,1,0,0,2
10930843,10931289,446,0,0,1,1
10930848,10931024,176,0,0,1,2
10931025,10931034,9,1,0,0,2
10931035,10931286,251,0,0,1,2
10931287,10931567,280,1,0,0,2
10931290,10931504,214,1,0,0,1
10931316,10931463,147,0,1,0,2
10931323,10931439,116,0,1,0,1
10931505,10931594,89,0,0,1,1
10931568,10931600,32,0,0,1,2
10931595,10931612,17,1,0,0,1
10931601,10931612,11,1,0,0,2
10931613,10932404,791,0,0,1,2
10931613,10932405,792,0,0,1,1
10932405,10932476,71,1,0,0,2
10932406,10932493,87,1,0,0,1
10932477,10932580,103,0,0,1,2
10932494,10932580,86,0,0,1,1
10932581,10932612,31,1,0,0,2
10932581,10932648,67,1,0,0,1
10932613,10932732,119,0,0,1,2
10932649,10932730,81,0,0,1,1
10932731,10932755,24,1,0,0,1
10932733,10932752,19,1,0,0,2
10932753,10933319,566,0,0,1,2
10932756,10932934,178,0,0,1,1
10932935,10932949,14,1,0,0,1
10932950,10933312,362,0,0,1,1
10933313,10933336,23,1,0,0,1
10933320,10933328,8,1,0,0,2
10933329,10935066,1737,0,0,1,2
10933337,10933507,170,0,0,1,1
10933508,10933518,10,1,0,0,1
10933519,10935062,1543,0,0,1,1
10935063,10935191,128,1,0,0,1
10935067,10935196,129,1,0,0,2
10935192,10935222,30,0,0,1,1
10935197,10935222,25,0,0,1,2
10935223,10935268,45,1,0,0,1
10935223,10935272,49,1,0,0,2
10935269,10935416,147,0,0,1,1
10935273,10935417,144,0,0,1,2
10935417,10935440,23,1,0,0,1
10935418,10935438,20,1,0,0,2
10935439,10936440,1001,0,0,1,2
10935441,10936442,1001,0,0,1,1
10936441,10936465,24,1,0,0,2
10936443,10936464,21,1,0,0,1
10936465,10936591,126,0,0,1,1
10936466,10936589,123,0,0,1,2
10936590,10936616,26,1,0,0,2
10936592,10936616,24,1,0,0,1
10936617,10936937,320,0,0,1,2
10936617,10936938,321,0,0,1,1
10936938,10936969,31,1,0,0,2
10936939,10936968,29,1,0,0,1
10936969,10937355,386,0,0,1,1
10936970,10937356,386,0,0,1,2
10937356,10937417,61,1,0,0,1
10937357,10937419,62,1,0,0,2
10937418,10937582,164,0,0,1,1
10937420,10937581,161,0,0,1,2
10937582,10937612,30,1,0,0,2
10937583,10937608,25,1,0,0,1
10937609,10937912,303,0,0,1,1
10937613,10937910,297,0,0,1,2
10937911,10937943,32,1,0,0,2
10937913,10937932,19,1,0,0,1
10937933,10938098,165,0,0,1,1
10937944,10938101,157,0,0,1,2
10938099,10938115,16,1,0,0,1
10938102,10938115,13,1,0,0,2
10938116,10938282,166,0,0,1,1
10938116,10938282,166,0,0,1,2
10938283,10938305,22,1,0,0,1
10938283,10938313,30,1,0,0,2
10938306,10938436,130,0,0,1,1
10938314,10938436,122,0,0,1,2
10938437,10938455,18,1,0,0,1
10938437,10938456,19,1,0,0,2
10938456,10938822,366,0,0,1,1
10938457,10938823,366,0,0,1,2
10938823,10938847,24,1,0,0,1
10938824,10938850,26,1,0,0,2
10938848,10939173,325,0,0,1,1
10938851,10939167,316,0,0,1,2
10939168,10939261,93,1,0,0,2
10939174,10939264,90,1,0,0,1
10939262,10939374,112,0,0,1,2
10939265,10939377,112,0,0,1,1
10939375,10939421,46,1,0,0,2
10939378,10939439,61,1,0,0,1
10939422,10939627,205,0,0,1,2
10939440,10939627,187,0,0,1,1
10939628,10939649,21,1,0,0,2
10939628,10939652,24,1,0,0,1
10939650,10939857,207,0,0,1,2
10939653,10939858,205,0,0,1,1
10939858,10939867,9,1,0,0,2
10939859,10939869,10,1,0,0,1
10939868,10940207,339,0,0,1,2
10939870,10940205,335,0,0,1,1
10940206,10940219,13,1,0,0,1
10940208,10940218,10,1,0,0,2
10940219,10940355,136,0,0,1,2
10940220,10940616,396,0,0,1,1
10940356,10940368,12,1,0,0,2
10940369,10940613,244,0,0,1,2
10940614,10940729,115,1,0,0,2
10940617,10940675,58,1,0,0,1
10940676,10940880,204,0,0,1,1
10940730,10940877,147,0,0,1,2
10940878,10940950,72,1,0,0,2
10940881,10940921,40,1,0,0,1
10940922,10941112,190,0,0,1,1
10940951,10940977,26,0,0,1,2
10940978,10940982,4,1,0,0,2
10940983,10941113,130,0,0,1,2
10941113,10941197,84,1,0,0,1
10941114,10941250,136,1,0,0,2
10941198,10941317,119,0,0,1,1
10941251,10941290,39,0,0,1,2
10941291,10941569,278,1,0,0,2
10941318,10941353,35,1,0,0,1
10941354,10941594,240,0,0,1,1
10941570,10941597,27,0,0,1,2
10941595,10941616,21,1,0,0,1
10941598,10941660,62,1,0,0,2
10941617,10941787,170,0,0,1,1
10941661,10941756,95,0,0,1,2
10941757,10941826,69,1,0,0,2
10941788,10941803,15,1,0,0,1
10941804,10942216,412,0,0,1,1
10941827,10942154,327,0,0,1,2
10942155,10942170,15,1,0,0,2
10942171,10942222,51,0,0,1,2
10942217,10942232,15,1,0,0,1
10942223,10942964,741,1,0,0,2
10942233,10942437,204,0,0,1,1
10942438,10942514,76,1,0,0,1
10942515,10942571,56,0,0,1,1
10942572,10942808,236,1,0,0,1
10942577,10942749,172,0,1,0,2
10942611,10942701,90,0,1,0,1
10942725,10942732,7,0,1,0,1
10942809,10942884,75,0,0,1,1
10942885,10942953,68,1,0,0,1
10942954,10943053,99,0,0,1,1
10942965,10942992,27,0,0,1,2
10942993,10943006,13,1,0,0,2
10943007,10943052,45,0,0,1,2
10943053,10943091,38,1,0,0,2
10943054,10943084,30,1,0,0,1
10943085,10943263,178,0,0,1,1
10943092,10943262,170,0,0,1,2
10943263,10943284,21,1,0,0,2
10943264,10943282,18,1,0,0,1
10943283,10943414,131,0,0,1,1
10943285,10943413,128,0,0,1,2
10943414,10943442,28,1,0,0,2
10943415,10943435,20,1,0,0,1
10943436,10943718,282,0,0,1,1
10943443,10943714,271,0,0,1,2
10943715,10943763,48,1,0,0,2
10943719,10943739,20,1,0,0,1
10943740,10944079,339,0,0,1,1
10943764,10944078,314,0,0,1,2
10944079,10944125,46,1,0,0,2
10944080,10944111,31,1,0,0,1
10944112,10944411,299,0,0,1,1
10944126,10944412,286,0,0,1,2
10944412,10944495,83,1,0,0,1
10944413,10944475,62,1,0,0,2
10944476,10944528,52,0,0,1,2
10944496,10944527,31,0,0,1,1
10944528,10944566,38,1,0,0,1
10944529,10944564,35,1,0,0,2
10944565,10944756,191,0,0,1,2
10944567,10944758,191,0,0,1,1
10944757,10944778,21,1,0,0,2
10944759,10944774,15,1,0,0,1
10944775,10944922,147,0,0,1,1
10944779,10944938,159,0,0,1,2
10944923,10944937,14,1,0,0,1
10944938,10945430,492,0,0,1,1
10944939,10944946,7,1,0,0,2
10944947,10945420,473,0,0,1,2
10945421,10945447,26,1,0,0,2
10945431,10945458,27,1,0,0,1
10945448,10945553,105,0,0,1,2
10945459,10945547,88,0,0,1,1
10945548,10945599,51,1,0,0,1
10945554,10945628,74,1,0,0,2
10945600,10945944,344,0,0,1,1
10945629,10945676,47,0,0,1,2
10945677,10945723,46,1,0,0,2
10945724,10945838,114,0,0,1,2
10945839,10945844,5,1,0,0,2
10945845,10945880,35,0,0,1,2
10945881,10945889,8,1,0,0,2
10945890,10945946,56,0,0,1,2
10945945,10946068,123,1,0,0,1
10945947,10947864,1917,1,0,0,2
10946069,10946107,38,0,0,1,1
10946107,10946147,40,0,1,0,2
10946108,10947896,1788,1,0,0,1
10946182,10947578,1396,0,1,0,2
10946193,10947346,1153,0,1,0,1
10947389,10947565,176,0,1,0,1
10947865,10947896,31,0,0,1,2
10947897,10947915,18,1,0,0,2
10947897,10947927,30,0,0,1,1
10947916,10948022,106,0,0,1,2
10947928,10947951,23,1,0,0,1
10947952,10948288,336,0,0,1,1
10948023,10948033,10,1,0,0,2
10948034,10948285,251,0,0,1,2
10948286,10948309,23,1,0,0,2
10948289,10948308,19,1,0,0,1
10948309,10948435,126,0,0,1,1
10948310,10948434,124,0,0,1,2
10948435,10948460,25,1,0,0,2
10948436,10948461,25,1,0,0,1
10948461,10948651,190,0,0,1,2
10948462,10948655,193,0,0,1,1
10948652,10948678,26,1,0,0,2
10948656,10948673,17,1,0,0,1
10948674,10948844,170,0,0,1,1
10948679,10948846,167,0,0,1,2
10948845,10948867,22,1,0,0,1
10948847,10948867,20,1,0,0,2
10948868,10949077,209,0,0,1,1
10948868,10949079,211,0,0,1,2
10949078,10949097,19,1,0,0,1
10949080,10949098,18,1,0,0,2
10949098,10949268,170,0,0,1,1
10949099,10949268,169,0,0,1,2
10949269,10949279,10,1,0,0,1
10949269,10949280,11,1,0,0,2
10949280,10949868,588,0,0,1,1
10949281,10949702,421,0,0,1,2
10949703,10949712,9,1,0,0,2
10949713,10949867,154,0,0,1,2
10949868,10949921,53,1,0,0,2
10949869,10949922,53,1,0,0,1
10949922,10950068,146,0,0,1,2
10949923,10950071,148,0,0,1,1
10950069,10950130,61,1,0,0,2
10950072,10950143,71,1,0,0,1
10950131,10950151,20,0,0,1,2
10950144,10950211,67,0,0,1,1
10950152,10950156,4,1,0,0,2
10950157,10950212,55,0,0,1,2
10950212,10950249,37,1,0,0,1
10950213,10950355,142,1,0,0,2
10950250,10950376,126,0,0,1,1
10950356,10950377,21,0,0,1,2
10950377,10950406,29,1,0,0,1
10950378,10950409,31,1,0,0,2
10950407,10950520,113,0,0,1,1
10950410,10950485,75,0,0,1,2
10950486,10950607,121,1,0,0,2
10950521,10950540,19,1,0,0,1
10950541,10950757,216,0,0,1,1
10950608,10950766,158,0,0,1,2
10950758,10950773,15,1,0,0,1
10950767,10950807,40,1,0,0,2
10950774,10950945,171,0,0,1,1
10950808,10950936,128,0,0,1,2
10950937,10950988,51,1,0,0,2
10950946,10950959,13,1,0,0,1
10950960,10951090,130,0,0,1,1
10950989,10951085,96,0,0,1,2
10951086,10951112,26,1,0,0,2
10951091,10951109,18,1,0,0,1
10951110,10951274,164,0,0,1,1
10951113,10951272,159,0,0,1,2
10951273,10951317,44,1,0,0,2
10951275,10951292,17,1,0,0,1
10951293,10951466,173,0,0,1,1
10951318,10951726,408,0,0,1,2
10951467,10951478,11,1,0,0,1
10951479,10951990,511,0,0,1,1
10951727,10951742,15,1,0,0,2
10951743,10951852,109,0,0,1,2
10951853,10951873,20,1,0,0,2
10951874,10951990,116,0,0,1,2
10951991,10952010,19,1,0,0,1
10951991,10952010,19,1,0,0,2
10952011,10952134,123,0,0,1,2
10952011,10952135,124,0,0,1,1
10952135,10952660,525,1,0,0,2
10952136,10952160,24,1,0,0,1
10952161,10952310,149,0,0,1,1
10952311,10952325,14,1,0,0,1
10952326,10952352,26,0,0,1,1
10952353,10952362,9,1,0,0,1
10952363,10952592,229,0,0,1,1
10952593,10952618,25,1,0,0,1
10952619,10952815,196,0,0,1,1
10952661,10952813,152,0,0,1,2
10952814,10953064,250,1,0,0,2
10952816,10953027,211,1,0,0,1
10953028,10953130,102,0,0,1,1
10953065,10953128,63,0,0,1,2
10953129,10953163,34,1,0,0,2
10953131,10953158,27,1,0,0,1
10953159,10953262,103,0,0,1,1
10953164,10953263,99,0,0,1,2
10953263,10953288,25,1,0,0,1
10953264,10953287,23,1,0,0,2
10953288,10953525,237,0,0,1,2
10953289,10953521,232,0,0,1,1
10953522,10953541,19,1,0,0,1
10953526,10953532,6,1,0,0,2
10953533,10953684,151,0,0,1,2
10953542,10953683,141,0,0,1,1
10953684,10953721,37,1,0,0,1
10953685,10953703,18,1,0,0,2
10953704,10954173,469,0,0,1,2
10953722,10954176,454,0,0,1,1
10954174,10954179,5,1,0,0,2
10954177,10954182,5,1,0,0,1
10954180,10954386,206,0,0,1,2
10954183,10954297,114,0,0,1,1
10954298,10954305,7,1,0,0,1
10954306,10954598,292,0,0,1,1
10954387,10954472,85,1,0,0,2
10954473,10954593,120,0,0,1,2
10954594,10954830,236,1,0,0,2
10954599,10954698,99,1,0,0,1
10954699,10954743,44,0,0,1,1
10954744,10954758,14,1,0,0,1
10954759,10955060,301,0,0,1,1
10954831,10955058,227,0,0,1,2
10955059,10955841,782,1,0,0,2
10955061,10955417,356,1,0,0,1
10955387,10955796,409,0,1,0,2
10955418,10955445,27,0,0,1,1
10955446,10955513,67,1,0,0,1
10955514,10955643,129,0,0,1,1
10955644,10955668,24,1,0,0,1
10955669,10956007,338,0,0,1,1
10955842,10955905,63,0,0,1,2
10955906,10956071,165,1,0,0,2
10956008,10956041,33,1,0,0,1
10956042,10956199,157,0,0,1,1
10956072,10956193,121,0,0,1,2
10956194,10956677,483,1,0,0,2
10956200,10956656,456,1,0,0,1
10956257,10956666,409,0,1,0,2
10956274,10956622,348,0,1,0,1
10956657,10956696,39,0,0,1,1
10956678,10956698,20,0,0,1,2
10956697,10956737,40,1,0,0,1
10956699,10956729,30,1,0,0,2
10956730,10956892,162,0,0,1,2
10956738,10956894,156,0,0,1,1
10956893,10956918,25,1,0,0,2
10956895,10956920,25,1,0,0,1
10956919,10958114,1195,0,0,1,2
10956921,10957218,297,0,0,1,1
10957219,10957236,17,1,0,0,1
10957237,10957967,730,0,0,1,1
10957968,10957982,14,1,0,0,1
10957983,10958121,138,0,0,1,1
10958115,10958132,17,1,0,0,2
10958122,10958136,14,1,0,0,1
10958133,10958408,275,0,0,1,2
10958137,10958412,275,0,0,1,1
10958409,10958428,19,1,0,0,2
10958413,10958425,12,1,0,0,1
10958426,10958626,200,0,0,1,1
10958429,10958626,197,0,0,1,2
10958627,10958664,37,1,0,0,1
10958627,10959211,584,1,0,0,2
10958665,10958801,136,0,0,1,1
10958802,10958863,61,1,0,0,1
10958864,10958924,60,0,0,1,1
10958925,10959026,101,1,0,0,1
10959027,10959067,40,0,0,1,1
10959068,10959190,122,1,0,0,1
10959191,10959324,133,0,0,1,1
10959212,10959322,110,0,0,1,2
10959323,10959369,46,1,0,0,2
10959325,10959356,31,1,0,0,1
10959357,10959593,236,0,0,1,1
10959370,10959591,221,0,0,1,2
10959592,10959618,26,1,0,0,2
10959594,10959616,22,1,0,0,1
10959617,10959771,154,0,0,1,1
10959619,10959766,147,0,0,1,2
10959767,10959799,32,1,0,0,2
10959772,10959789,17,1,0,0,1
10959790,10959953,163,0,0,1,1
10959800,10960579,779,0,0,1,2
10959954,10959965,11,1,0,0,1
10959966,10960154,188,0,0,1,1
10960155,10960171,16,1,0,0,1
10960172,10960584,412,0,0,1,1
10960580,10960603,23,1,0,0,2
10960585,10960601,16,1,0,0,1
10960602,10960854,252,0,0,1,1
10960604,10960852,248,0,0,1,2
10960853,10960937,84,1,0,0,2
10960855,10960936,81,1,0,0,1
10960937,10960990,53,0,0,1,1
10960938,10960970,32,0,0,1,2
10960971,10961044,73,1,0,0,2
10960991,10961033,42,1,0,0,1
10961034,10961195,161,0,0,1,1
10961045,10961190,145,0,0,1,2
10961191,10961199,8,1,0,0,2
10961196,10961205,9,1,0,0,1
10961200,10961331,131,0,0,1,2
10961206,10961333,127,0,0,1,1
10961332,10961445,113,1,0,0,2
10961334,10961449,115,1,0,0,1
10961446,10961540,94,0,0,1,2
10961450,10961536,86,0,0,1,1
10961537,10961566,29,1,0,0,1
10961541,10961570,29,1,0,0,2
10961567,10961761,194,0,0,1,1
10961571,10961758,187,0,0,1,2
10961759,10961774,15,1,0,0,2
10961762,10961786,24,1,0,0,1
10961775,10961959,184,0,0,1,2
10961787,10961961,174,0,0,1,1
10961960,10961984,24,1,0,0,2
10961962,10961984,22,1,0,0,1
10961985,10962359,374,0,0,1,2
10961985,10962362,377,0,0,1,1
10962360,10962376,16,1,0,0,2
10962363,10962373,10,1,0,0,1
10962374,10963068,694,0,0,1,1
10962377,10962500,123,0,0,1,2
10962501,10962511,10,1,0,0,2
10962512,10962812,300,0,0,1,2
10962813,10962819,6,1,0,0,2
10962820,10963067,247,0,0,1,2
10963068,10963079,11,1,0,0,2
10963069,10963076,7,1,0,0,1
10963077,10963258,181,0,0,1,1
10963080,10963308,228,0,0,1,2
10963259,10963266,7,1,0,0,1
10963267,10963468,201,0,0,1,1
10963309,10963316,7,1,0,0,2
10963317,10963469,152,0,0,1,2
10963469,10963507,38,1,0,0,1
10963470,10963511,41,1,0,0,2
10963508,10963611,103,0,0,1,1
10963512,10963588,76,0,0,1,2
10963589,10963630,41,1,0,0,2
10963612,10963639,27,1,0,0,1
10963631,10963753,122,0,0,1,2
10963640,10963732,92,0,0,1,1
10963733,10963740,7,1,0,0,1
10963741,10963769,28,0,0,1,1
10963754,10964244,490,1,0,0,2
10963770,10964341,571,1,0,0,1
10963830,10964170,340,0,1,0,2
10963842,10964123,281,0,1,0,1
10964245,10964299,54,0,0,1,2
10964300,10964331,31,1,0,0,2
10964332,10964485,153,0,0,1,2
10964342,10964484,142,0,0,1,1
10964485,10964511,26,1,0,0,1
10964486,10964514,28,1,0,0,2
10964512,10964808,296,0,0,1,1
10964515,10964810,295,0,0,1,2
10964809,10964834,25,1,0,0,1
10964811,10964832,21,1,0,0,2
10964833,10964984,151,0,0,1,2
10964835,10964985,150,0,0,1,1
10964985,10965008,23,1,0,0,2
10964986,10965005,19,1,0,0,1
10965006,10965714,708,0,0,1,1
10965009,10965345,336,0,0,1,2
10965346,10965377,31,1,0,0,2
10965378,10965574,196,0,0,1,2
10965575,10965584,9,1,0,0,2
10965585,10965709,124,0,0,1,2
10965710,10965729,19,1,0,0,2
10965715,10965732,17,1,0,0,1
10965730,10965795,65,0,0,1,2
10965733,10965930,197,0,0,1,1
10965796,10968243,2447,1,0,0,2
10965931,10965953,22,1,0,0,1
10965954,10966299,345,0,0,1,1
10966300,10966395,95,1,0,0,1
10966318,10966331,13,0,1,0,2
10966359,10966371,12,0,1,0,2
10966396,10966421,25,0,0,1,1
10966422,10966447,25,1,0,0,1
10966448,10966484,36,0,0,1,1
10966485,10966550,65,1,0,0,1
10966551,10966646,95,0,0,1,1
10966647,10966947,300,1,0,0,1
10966698,10967443,745,0,1,0,2
10966908,10966937,29,0,1,0,1
10966948,10966982,34,0,0,1,1
10966983,10967378,395,1,0,0,1
10966996,10967315,319,0,1,0,1
10967379,10967443,64,0,0,1,1
10967444,10967470,26,1,0,0,1
10967471,10967614,143,0,0,1,1
10967560,10967972,412,0,1,0,2
10967615,10967970,355,1,0,0,1
10967636,10967868,232,0,1,0,1
10967971,10968024,53,0,0,1,1
10968025,10968073,48,1,0,0,1
10968074,10968463,389,0,0,1,1
10968244,10968663,419,0,0,1,2
10968464,10968481,17,1,0,0,1
10968482,10968662,180,0,0,1,1
10968663,10968681,18,1,0,0,1
10968664,10968708,44,1,0,0,2
10968682,10968860,178,0,0,1,1
10968709,10968864,155,0,0,1,2
10968861,10968894,33,1,0,0,1
10968865,10968970,105,1,0,0,2
10968895,10969029,134,0,0,1,1
10968971,10969030,59,0,0,1,2
10969030,10969042,12,1,0,0,1
10969031,10970373,1342,1,0,0,2
10969043,10969200,157,0,0,1,1
10969201,10969220,19,1,0,0,1
10969221,10969335,114,0,0,1,1
10969336,10969347,11,1,0,0,1
10969348,10969489,141,0,0,1,1
10969490,10969502,12,1,0,0,1
10969503,10969557,54,0,0,1,1
10969558,10969610,52,1,0,0,1
10969611,10969670,59,0,0,1,1
10969671,10969718,47,1,0,0,1
10969712,10969712,0,0,1,0,2
10969719,10969739,20,0,0,1,1
10969740,10969837,97,1,0,0,1
10969838,10969888,50,0,0,1,1
10969858,10969914,56,0,1,0,2
10969889,10969940,51,1,0,0,1
10969941,10969985,44,0,0,1,1
10969986,10970354,368,1,0,0,1
10970138,10970315,177,0,1,0,2
10970148,10970325,177,0,1,0,1
10970355,10970442,87,0,0,1,1
10970374,10970648,274,0,0,1,2
10970443,10970455,12,1,0,0,1
10970456,10970646,190,0,0,1,1
10970647,10970677,30,1,0,0,1
10970649,10970680,31,1,0,0,2
10970678,10970821,143,0,0,1,1
10970681,10970820,139,0,0,1,2
10970821,10970851,30,1,0,0,2
10970822,10970850,28,1,0,0,1
10970851,10971011,160,0,0,1,1
10970852,10971009,157,0,0,1,2
10971010,10971035,25,1,0,0,2
10971012,10971036,24,1,0,0,1
10971036,10971513,477,0,0,1,2
10971037,10971276,239,0,0,1,1
10971277,10971281,4,1,0,0,1
10971282,10971514,232,0,0,1,1
10971514,10971519,5,1,0,0,2
10971515,10971523,8,1,0,0,1
10971520,10971685,165,0,0,1,2
10971524,10971785,261,0,0,1,1
10971686,10971695,9,1,0,0,2
10971696,10972109,413,0,0,1,2
10971786,10971794,8,1,0,0,1
10971795,10972325,530,0,0,1,1
10972110,10972121,11,1,0,0,2
10972122,10972162,40,0,0,1,2
10972163,10972235,72,1,0,0,2
10972236,10972402,166,0,0,1,2
10972326,10972332,6,1,0,0,1
10972333,10972617,284,0,0,1,1
10972403,10972968,565,1,0,0,2
10972618,10972729,111,1,0,0,1
10972730,10972803,73,0,0,1,1
10972804,10972908,104,1,0,0,1
10972909,10973007,98,0,0,1,1
10972969,10973165,196,0,0,1,2
10973008,10973015,7,1,0,0,1
10973016,10973164,148,0,0,1,1
10973165,10973184,19,1,0,0,1
10973166,10973196,30,1,0,0,2
10973185,10973321,136,0,0,1,1
10973197,10973319,122,0,0,1,2
10973320,10973343,23,1,0,0,2
10973322,10973339,17,1,0,0,1
10973340,10973659,319,0,0,1,1
10973344,10973658,314,0,0,1,2
10973659,10973678,19,1,0,0,2
10973660,10973675,15,1,0,0,1
10973676,10974146,470,0,0,1,1
10973679,10974141,462,0,0,1,2
10974142,10974160,18,1,0,0,2
10974147,10974159,12,1,0,0,1
10974160,10974313,153,0,0,1,1
10974161,10974313,152,0,0,1,2
10974314,10974328,14,1,0,0,1
10974314,10974332,18,1,0,0,2
10974329,10974415,86,0,0,1,1
10974333,10974411,78,0,0,1,2
10974412,10974428,16,1,0,0,2
10974416,10974426,10,1,0,0,1
10974427,10974559,132,0,0,1,1
10974429,10974559,130,0,0,1,2
10974560,10974569,9,1,0,0,1
10974560,10974570,10,1,0,0,2
10974570,10974685,115,0,0,1,1
10974571,10974684,113,0,0,1,2
10974685,10974708,23,1,0,0,2
10974686,10974704,18,1,0,0,1
10974705,10974818,113,0,0,1,1
10974709,10974819,110,0,0,1,2
10974819,10974830,11,1,0,0,1
10974820,10974830,10,1,0,0,2
10974831,10974896,65,0,0,1,2
10974831,10974902,71,0,0,1,1
10974897,10974968,71,1,0,0,2
10974903,10974941,38,1,0,0,1
10974942,10975097,155,0,0,1,1
10974969,10975097,128,0,0,1,2
10975098,10975140,42,1,0,0,1
10975098,10975147,49,1,0,0,2
10975141,10975250,109,0,0,1,1
10975148,10975250,102,0,0,1,2
10975251,10975301,50,1,0,0,1
10975251,10975301,50,1,0,0,2
10975302,10975369,67,0,0,1,2
10975302,10975373,71,0,0,1,1
10975370,10975507,137,1,0,0,2
10975374,10975491,117,1,0,0,1
10975492,10975585,93,0,0,1,1
10975508,10975584,76,0,0,1,2
10975585,10975614,29,1,0,0,2
10975586,10975619,33,1,0,0,1
10975615,10976030,415,0,0,1,2
10975620,10976029,409,0,0,1,1
10976030,10976050,20,1,0,0,1
10976031,10976053,22,1,0,0,2
10976051,10976198,147,0,0,1,1
10976054,10976190,136,0,0,1,2
10976191,10976222,31,1,0,0,2
10976199,10976213,14,1,0,0,1
10976214,10976332,118,0,0,1,1
10976223,10976330,107,0,0,1,2
10976331,10976345,14,1,0,0,2
10976333,10976347,14,1,0,0,1
10976346,10976482,136,0,0,1,2
10976348,10976951,603,0,0,1,1
10976483,10976505,22,1,0,0,2
10976506,10976783,277,0,0,1,2
10976784,10976814,30,1,0,0,2
10976815,10976944,129,0,0,1,2
10976945,10976968,23,1,0,0,2
10976952,10976959,7,1,0,0,1
10976960,10977350,390,0,0,1,1
10976969,10977238,269,0,0,1,2
10977239,10977270,31,1,0,0,2
10977271,10977352,81,0,0,1,2
10977351,10977393,42,1,0,0,1
10977353,10977372,19,1,0,0,2
10977373,10977398,25,0,0,1,2
10977394,10977464,70,0,0,1,1
10977399,10977413,14,1,0,0,2
10977414,10977509,95,0,0,1,2
10977465,10977470,5,1,0,0,1
10977471,10977492,21,0,0,1,1
10977493,10977561,68,1,0,0,1
10977510,10977560,50,1,0,0,2
10977561,10977627,66,0,0,1,2
10977562,10977665,103,0,0,1,1
10977628,10977758,130,1,0,0,2
10977666,10977677,11,1,0,0,1
10977678,10977808,130,0,0,1,1
10977759,10977807,48,0,0,1,2
10977808,10978550,742,1,0,0,2
10977809,10978549,740,1,0,0,1
10977962,10977972,10,0,1,0,1
10977973,10978420,447,0,1,0,2
10978550,10978573,23,0,0,1,1
10978551,10978583,32,0,0,1,2
10978574,10978982,408,1,0,0,1
10978584,10978962,378,1,0,0,2
10978603,10978831,228,0,1,0,2
10978609,10978812,203,0,1,0,1
10978963,10979110,147,0,0,1,2
10978983,10979110,127,0,0,1,1
10979111,10979135,24,1,0,0,1
10979111,10979151,40,1,0,0,2
10979136,10979299,163,0,0,1,1
10979152,10979300,148,0,0,1,2
10979300,10979322,22,1,0,0,1
10979301,10979318,17,1,0,0,2
10979319,10979496,177,0,0,1,2
10979323,10979345,22,0,0,1,1
10979346,10979359,13,1,0,0,1
10979360,10979496,136,0,0,1,1
10979497,10979518,21,1,0,0,2
10979497,10979578,81,1,0,0,1
10979519,10979706,187,0,0,1,2
10979579,10979621,42,0,0,1,1
10979622,10979653,31,1,0,0,1
10979654,10979705,51,0,0,1,1
10979706,10979818,112,1,0,0,1
10979707,10979727,20,1,0,0,2
10979728,10979785,57,0,0,1,2
10979786,10979838,52,1,0,0,2
10979819,10979876,57,0,0,1,1
10979839,10979859,20,0,0,1,2
10979860,10980996,1136,1,0,0,2
10979877,10979895,18,1,0,0,1
10979896,10979917,21,0,0,1,1
10979918,10980898,980,1,0,0,1
10979961,10979996,35,0,1,0,2
10980256,10980273,17,0,1,0,2
10980403,10980415,12,0,1,0,2
10980436,10980531,95,0,1,0,2
10980444,10980529,85,0,1,0,1
10980560,10980649,89,0,1,0,2
10980671,10980676,5,0,1,0,2
10980740,10980835,95,0,1,0,2
10980899,10981128,229,0,0,1,1
10980997,10981095,98,0,0,1,2
10981096,10981516,420,1,0,0,2
10981129,10981501,372,1,0,0,1
10981154,10981396,242,0,1,0,1
10981155,10981393,238,0,1,0,2
10981502,10981693,191,0,0,1,1
10981517,10981691,174,0,0,1,2
10981692,10981718,26,1,0,0,2
10981694,10981716,22,1,0,0,1
10981717,10982639,922,0,0,1,1
10981719,10982813,1094,0,0,1,2
10982640,10982650,10,1,0,0,1
10982651,10982814,163,0,0,1,1
10982814,10982835,21,1,0,0,2
10982815,10982835,20,1,0,0,1
10982836,10982947,111,0,0,1,1
10982836,10982947,111,0,0,1,2
10982948,10983001,53,1,0,0,1
10982948,10983058,110,1,0,0,2
10983002,10983431,429,0,0,1,1
10983059,10983296,237,0,0,1,2
10983297,10983321,24,1,0,0,2
10983322,10983434,112,0,0,1,2
10983432,10983487,55,1,0,0,1
10983435,10984204,769,1,0,0,2
10983488,10983570,82,0,0,1,1
10983571,10984158,587,1,0,0,1
10983599,10984158,559,0,1,0,2
10983606,10983910,304,0,1,0,1
10984159,10984240,81,0,0,1,1
10984205,10984237,32,0,0,1,2
10984238,10984268,30,1,0,0,2
10984241,10984270,29,1,0,0,1
10984269,10984757,488,0,0,1,2
10984271,10984427,156,0,0,1,1
10984428,10984436,8,1,0,0,1
10984437,10984755,318,0,0,1,1
10984756,10984772,16,1,0,0,1
10984758,10984771,13,1,0,0,2
10984772,10984898,126,0,0,1,2
10984773,10984899,126,0,0,1,1
10984899,10984912,13,1,0,0,2
10984900,10984912,12,1,0,0,1
10984913,10985047,134,0,0,1,2
10984913,10985048,135,0,0,1,1
10985048,10985063,15,1,0,0,2
10985049,10985068,19,1,0,0,1
10985064,10985168,104,0,0,1,2
10985069,10985168,99,0,0,1,1
10985169,10985183,14,1,0,0,2
10985169,10985199,30,1,0,0,1
10985184,10985396,212,0,0,1,2
10985200,10985390,190,0,0,1,1
10985391,10985405,14,1,0,0,1
10985397,10985403,6,1,0,0,2
10985404,10985535,131,0,0,1,2
10985406,10985529,123,0,0,1,1
10985530,10985542,12,1,0,0,1
10985536,10985542,6,1,0,0,2
10985543,10985644,101,0,0,1,2
10985543,10986026,483,0,0,1,1
10985645,10985659,14,1,0,0,2
10985660,10985702,42,0,0,1,2
10985703,10986173,470,1,0,0,2
10986027,10986140,113,1,0,0,1
10986141,10986222,81,0,0,1,1
10986174,10986198,24,0,0,1,2
10986199,10987115,916,1,0,0,2
10986223,10986237,14,1,0,0,1
10986238,10986300,62,0,0,1,1
10986301,10986400,99,1,0,0,1
10986398,10986400,2,0,1,0,2
10986401,10986557,156,0,0,1,1
10986558,10986596,38,1,0,0,1
10986583,10986670,87,0,1,0,2
10986597,10987024,427,0,0,1,1
10986864,10986868,4,0,1,0,2
10987025,10987101,76,1,0,0,1
10987102,10987439,337,0,0,1,1
10987116,10987424,308,0,0,1,2
10987425,10987825,400,1,0,0,2
10987440,10987855,415,1,0,0,1
10987455,10987794,339,0,1,0,2
10987460,10987647,187,0,1,0,1
10987826,10988101,275,0,0,1,2
10987856,10988099,243,0,0,1,1
10988100,10988158,58,1,0,0,1
10988102,10988120,18,1,0,0,2
10988121,10989357,1236,0,0,1,2
10988159,10989057,898,0,0,1,1
10989058,10989079,21,1,0,0,1
10989080,10989341,261,0,0,1,1
10989342,10989378,36,1,0,0,1
10989358,10989383,25,1,0,0,2
10989379,10989724,345,0,0,1,1
10989384,10990147,763,0,0,1,2
10989725,10989735,10,1,0,0,1
10989736,10989881,145,0,0,1,1
10989882,10989917,35,1,0,0,1
10989918,10990086,168,0,0,1,1
10990087,10990121,34,1,0,0,1
10990122,10990150,28,0,0,1,1
10990148,10990363,215,1,0,0,2
10990151,10990348,197,1,0,0,1
10990349,10990533,184,0,0,1,1
10990364,10990454,90,0,0,1,2
10990455,10990752,297,1,0,0,2
10990534,10990749,215,1,0,0,1
10990750,10990800,50,0,0,1,1
10990753,10990800,47,0,0,1,2
10990801,10990819,18,1,0,0,2
10990801,10990820,19,1,0,0,1
10990820,10990891,71,0,0,1,2
10990821,10990897,76,0,0,1,1
10990892,10990930,38,1,0,0,2
10990898,10990925,27,1,0,0,1
10990926,10991191,265,0,0,1,1
10990931,10991190,259,0,0,1,2
10991191,10991207,16,1,0,0,2
10991192,10991211,19,1,0,0,1
10991208,10991369,161,0,0,1,2
10991212,10991368,156,0,0,1,1
10991369,10991390,21,1,0,0,1
10991370,10991391,21,1,0,0,2
10991391,10991761,370,0,0,1,1
10991392,10991760,368,0,0,1,2
10991761,10991779,18,1,0,0,2
10991762,10991781,19,1,0,0,1
10991780,10991959,179,0,0,1,2
10991782,10991962,180,0,0,1,1
10991960,10991977,17,1,0,0,2
10991963,10991976,13,1,0,0,1
10991977,10992306,329,0,0,1,1
10991978,10992316,338,0,0,1,2
10992307,10992314,7,1,0,0,1
10992315,10992625,310,0,0,1,1
10992317,10992321,4,1,0,0,2
10992322,10992555,233,0,0,1,2
10992556,10992582,26,1,0,0,2
10992583,10992621,38,0,0,1,2
10992622,10992633,11,1,0,0,2
10992626,10992636,10,1,0,0,1
10992634,10992745,111,0,0,1,2
10992637,10992825,188,0,0,1,1
10992746,10992753,7,1,0,0,2
10992754,10992810,56,0,0,1,2
10992811,10992840,29,1,0,0,2
10992826,10992838,12,1,0,0,1
10992839,10992931,92,0,0,1,1
10992841,10992913,72,0,0,1,2
10992914,10993068,154,1,0,0,2
10992932,10993079,147,1,0,0,1
10993069,10993197,128,0,0,1,2
10993080,10993210,130,0,0,1,1
10993198,10993215,17,1,0,0,2
10993211,10993217,6,1,0,0,1
10993216,10993287,71,0,0,1,2
10993218,10993314,96,0,0,1,1
10993288,10993743,455,1,0,0,2
10993315,10993737,422,1,0,0,1
10993339,10993588,249,0,1,0,2
10993345,10993564,219,0,1,0,1
10993738,10993914,176,0,0,1,1
10993744,10993804,60,0,0,1,2
10993805,10993830,25,1,0,0,2
10993831,10993920,89,0,0,1,2
10993915,10993936,21,1,0,0,1
10993921,10993934,13,1,0,0,2
10993935,10994069,134,0,0,1,2
10993937,10994070,133,0,0,1,1
10994070,10994089,19,1,0,0,2
10994071,10994088,17,1,0,0,1
10994089,10994297,208,0,0,1,1
10994090,10994299,209,0,0,1,2
10994298,10994302,4,1,0,0,1
10994300,10994311,11,1,0,0,2
10994303,10994465,162,0,0,1,1
10994312,10994437,125,0,0,1,2
10994438,10995651,1213,1,0,0,2
10994466,10994476,10,1,0,0,1
10994477,10994842,365,0,0,1,1
10994843,10994861,18,1,0,0,1
10994862,10995127,265,0,0,1,1
10995128,10995650,522,1,0,0,1
10995208,10995467,259,0,1,0,2
10995212,10995487,275,0,1,0,1
10995651,10995861,210,0,0,1,1
10995652,10995859,207,0,0,1,2
10995860,10995881,21,1,0,0,2
10995862,10995882,20,1,0,0,1
10995882,10996057,175,0,0,1,2
10995883,10996064,181,0,0,1,1
10996058,10996076,18,1,0,0,2
10996065,10996076,11,1,0,0,1
10996077,10996449,372,0,0,1,1
10996077,10996451,374,0,0,1,2
10996450,10996462,12,1,0,0,1
10996452,10996457,5,1,0,0,2
10996458,10996642,184,0,0,1,2
10996463,10996647,184,0,0,1,1
10996643,10996662,19,1,0,0,2
10996648,10996659,11,1,0,0,1
10996660,10996859,199,0,0,1,1
10996663,10996859,196,0,0,1,2
10996860,10996879,19,1,0,0,2
10996860,10996881,21,1,0,0,1
10996880,10997278,398,0,0,1,2
10996882,10997391,509,0,0,1,1
10997279,10997303,24,1,0,0,2
10997304,10997386,82,0,0,1,2
10997387,10997420,33,1,0,0,2
10997392,10997413,21,1,0,0,1
10997414,10997999,585,0,0,1,1
10997421,10997575,154,0,0,1,2
10997576,10997678,102,1,0,0,2
10997679,10997701,22,0,0,1,2
10997702,10997746,44,1,0,0,2
10997747,10997779,32,0,0,1,2
10997780,10998263,483,1,0,0,2
10998000,10998019,19,1,0,0,1
10998020,10998098,78,0,0,1,1
10998099,10998157,58,1,0,0,1
10998158,10998488,330,0,0,1,1
10998264,10998322,58,0,0,1,2
10998323,10998376,53,1,0,0,2
10998377,10998419,42,0,0,1,2
10998420,10998425,5,1,0,0,2
10998426,10998480,54,0,0,1,2
10998481,10998514,33,1,0,0,2
10998489,10998497,8,1,0,0,1
10998498,10999599,1101,0,0,1,1
10998515,10998547,32,0,0,1,2
10998548,10998795,247,1,0,0,2
10998796,10998825,29,0,0,1,2
10998826,10998835,9,1,0,0,2
10998836,10998865,29,0,0,1,2
10998866,10998979,113,1,0,0,2
10998980,10999157,177,0,0,1,2
10999158,10999173,15,1,0,0,2
10999174,10999323,149,0,0,1,2
10999324,10999339,15,1,0,0,2
10999340,10999437,97,0,0,1,2
10999438,10999463,25,1,0,0,2
10999464,10999595,131,0,0,1,2
10999596,10999628,32,1,0,0,2
10999600,10999618,18,1,0,0,1
10999619,10999759,140,0,0,1,1
10999629,10999761,132,0,0,1,2
10999760,10999770,10,1,0,0,1
10999762,10999766,4,1,0,0,2
10999767,10999920,153,0,0,1,2
10999771,11000230,459,0,0,1,1
10999921,10999927,6,1,0,0,2
10999928,11000027,99,0,0,1,2
11000028,11000348,320,1,0,0,2
11000231,11000256,25,1,0,0,1
11000257,11000307,50,0,0,1,1
11000308,11000465,157,1,0,0,1
11000349,11000397,48,0,0,1,2
11000398,11001134,736,1,0,0,2
11000466,11000540,74,0,0,1,1
11000541,11001230,689,1,0,0,1
11000620,11001140,520,0,1,0,1
11000626,11001103,477,0,1,0,2
11001135,11001427,292,0,0,1,2
11001231,11001423,192,0,0,1,1
11001424,11001460,36,1,0,0,1
11001428,11001456,28,1,0,0,2
11001457,11001604,147,0,0,1,2
11001461,11001601,140,0,0,1,1
11001602,11001631,29,1,0,0,1
11001605,11001640,35,1,0,0,2
11001632,11002448,816,0,0,1,1
11001641,11002671,1030,0,0,1,2
11002449,11002460,11,1,0,0,1
11002461,11002667,206,0,0,1,1
11002668,11002692,24,1,0,0,1
11002672,11002691,19,1,0,0,2
11002692,11002786,94,0,0,1,2
11002693,11002781,88,0,0,1,1
11002782,11002806,24,1,0,0,1
11002787,11002807,20,1,0,0,2
11002807,11003011,204,0,0,1,1
11002808,11003011,203,0,0,1,2
11003012,11003134,122,1,0,0,1
11003012,11003164,152,1,0,0,2
11003135,11003308,173,0,0,1,1
11003165,11003429,264,0,0,1,2
11003309,11003315,6,1,0,0,1
11003316,11003429,113,0,0,1,1
11003430,11003521,91,1,0,0,2
11003430,11003523,93,1,0,0,1
11003522,11003595,73,0,0,1,2
11003524,11003594,70,0,0,1,1
11003595,11003629,34,1,0,0,1
11003596,11003631,35,1,0,0,2
11003630,11003843,213,0,0,1,1
11003632,11003850,218,0,0,1,2
11003844,11004281,437,1,0,0,1
11003851,11004364,513,1,0,0,2
11003915,11004204,289,0,1,0,2
11003918,11004183,265,0,1,0,1
11004282,11004754,472,0,0,1,1
11004365,11004756,391,0,0,1,2
11004755,11004773,18,1,0,0,1
11004757,11004776,19,1,0,0,2
11004774,11005791,1017,0,0,1,1
11004777,11004985,208,0,0,1,2
11004986,11004997,11,1,0,0,2
11004998,11005787,789,0,0,1,2
11005788,11005813,25,1,0,0,2
11005792,11005804,12,1,0,0,1
11005805,11005937,132,0,0,1,1
11005814,11005940,126,0,0,1,2
11005938,11005958,20,1,0,0,1
11005941,11005978,37,1,0,0,2
11005959,11006218,259,0,0,1,1
11005979,11006101,122,0,0,1,2
11006102,11006783,681,1,0,0,2
11006219,11006256,37,1,0,0,1
11006257,11006371,114,0,0,1,1
11006372,11006440,68,1,0,0,1
11006441,11006721,280,0,0,1,1
11006722,11006771,49,1,0,0,1
11006772,11007129,357,0,0,1,1
11006784,11007016,232,0,0,1,2
11007017,11007030,13,1,0,0,2
11007031,11007129,98,0,0,1,2
11007130,11011474,4344,1,0,0,1
11007130,11011693,4563,1,0,0,2
11008187,11008306,119,0,1,0,2
11008505,11008660,155,0,1,0,2
11008719,11009253,534,0,1,0,2
11009390,11011440,2050,0,1,0,2
11009690,11010307,617,0,1,0,1
11010353,11010400,47,0,1,0,1
11010421,11010425,4,0,1,0,1
11010568,11010635,67,0,1,0,1
11010656,11011020,364,0,1,0,1
11011475,11011593,118,0,0,1,1
11011594,11011617,23,1,0,0,1
11011618,11011774,156,0,0,1,1
11011694,11011773,79,0,0,1,2
11011774,11011796,22,1,0,0,2
11011775,11011796,21,1,0,0,1
11011797,11011985,188,0,0,1,2
11011797,11011987,190,0,0,1,1
11011986,11012002,16,1,0,0,2
11011988,11012005,17,1,0,0,1
11012003,11012130,127,0,0,1,2
11012006,11012282,276,0,0,1,1
11012131,11013929,1798,1,0,0,2
11012283,11012308,25,1,0,0,1
11012309,11013005,696,0,0,1,1
11013006,11013534,528,1,0,0,1
11013045,11013298,253,0,1,0,2
11013068,11013228,160,0,1,0,1
11013264,11013272,8,0,1,0,1
11013419,11013421,2,0,1,0,2
11013452,11013453,1,0,1,0,2
11013535,11013574,39,0,0,1,1
11013575,11013594,19,1,0,0,1
11013595,11013812,217,0,0,1,1
11013813,11013877,64,1,0,0,1
11013878,11014009,131,0,0,1,1
11013930,11014009,79,0,0,1,2
11014010,11014050,40,1,0,0,1
11014010,11014056,46,1,0,0,2
11014051,11014314,263,0,0,1,1
11014057,11014309,252,0,0,1,2
11014310,11014657,347,1,0,0,2
11014315,11014561,246,1,0,0,1
11014338,11014515,177,0,1,0,2
11014347,11014498,151,0,1,0,1
11014562,11014710,148,0,0,1,1
11014658,11014710,52,0,0,1,2
11014711,11014732,21,1,0,0,1
11014711,11014760,49,1,0,0,2
11014733,11014947,214,0,0,1,1
11014761,11014948,187,0,0,1,2
11014948,11014966,18,1,0,0,1
11014949,11014964,15,1,0,0,2
11014965,11015338,373,0,0,1,2
11014967,11015770,803,0,0,1,1
11015339,11015354,15,1,0,0,2
11015355,11015416,61,0,0,1,2
11015417,11015433,16,1,0,0,2
11015434,11015712,278,0,0,1,2
11015713,11015728,15,1,0,0,2
11015729,11015771,42,0,0,1,2
11015771,11015783,12,1,0,0,1
11015772,11015794,22,1,0,0,2
11015784,11015917,133,0,0,1,1
11015795,11015910,115,0,0,1,2
11015911,11017326,1415,1,0,0,2
11015918,11015934,16,1,0,0,1
11015935,11016056,121,0,0,1,1
11016057,11016070,13,1,0,0,1
11016071,11016264,193,0,0,1,1
11016265,11016281,16,1,0,0,1
11016282,11016499,217,0,0,1,1
11016500,11016526,26,1,0,0,1
11016527,11016893,366,0,0,1,1
11016894,11016915,21,1,0,0,1
11016916,11017113,197,0,0,1,1
11017114,11017269,155,1,0,0,1
11017270,11017420,150,0,0,1,1
11017327,11017419,92,0,0,1,2
11017420,11017457,37,1,0,0,2
11017421,11017455,34,1,0,0,1
11017456,11017857,401,0,0,1,1
11017458,11017872,414,0,0,1,2
11017858,11018392,534,1,0,0,1
11017873,11018410,537,1,0,0,2
11017904,11018276,372,0,1,0,2
11017912,11018179,267,0,1,0,1
11018393,11018467,74,0,0,1,1
11018411,11018467,56,0,0,1,2
11018468,11018508,40,1,0,0,1
11018468,11018511,43,1,0,0,2
11018509,11018640,131,0,0,1,1
11018512,11018642,130,0,0,1,2
11018641,11018661,20,1,0,0,1
11018643,11018666,23,1,0,0,2
11018662,11018878,216,0,0,1,1
11018667,11018883,216,0,0,1,2
11018879,11018900,21,1,0,0,1
11018884,11018898,14,1,0,0,2
11018899,11019342,443,0,0,1,2
11018901,11019117,216,0,0,1,1
11019118,11019128,10,1,0,0,1
11019129,11019340,211,0,0,1,1
11019341,11019359,18,1,0,0,1
11019343,11019358,15,1,0,0,2
11019359,11019526,167,0,0,1,2
11019360,11019520,160,0,0,1,1
11019521,11019538,17,1,0,0,1
11019527,11019538,11,1,0,0,2
11019539,11019751,212,0,0,1,2
11019539,11020031,492,0,0,1,1
11019752,11019762,10,1,0,0,2
11019763,11020190,427,0,0,1,2
11020032,11020036,4,1,0,0,1
11020037,11020189,152,0,0,1,1
11020190,11020209,19,1,0,0,1
11020191,11020211,20,1,0,0,2
11020210,11020348,138,0,0,1,1
11020212,11020347,135,0,0,1,2
11020348,11020368,20,1,0,0,2
11020349,11020367,18,1,0,0,1
11020368,11020776,408,0,0,1,1
11020369,11020741,372,0,0,1,2
11020742,11020752,10,1,0,0,2
11020753,11020778,25,0,0,1,2
11020777,11020781,4,1,0,0,1
11020779,11020794,15,1,0,0,2
11020782,11020957,175,0,0,1,1
11020795,11020959,164,0,0,1,2
11020958,11021252,294,1,0,0,1
11020960,11021255,295,1,0,0,2
11021024,11021162,138,0,1,0,1
11021036,11021113,77,0,1,0,2
11021253,11021325,72,0,0,1,1
11021256,11021327,71,0,0,1,2
11021326,11021405,79,1,0,0,1
11021328,11021466,138,1,0,0,2
11021406,11021645,239,0,0,1,1
11021467,11021642,175,0,0,1,2
11021643,11021663,20,1,0,0,2
11021646,11021665,19,1,0,0,1
11021664,11022191,527,0,0,1,2
11021666,11022189,523,0,0,1,1
11022190,11022203,13,1,0,0,1
11022192,11022203,11,1,0,0,2
11022204,11022348,144,0,0,1,1
11022204,11022567,363,0,0,1,2
11022349,11022366,17,1,0,0,1
11022367,11022570,203,0,0,1,1
11022568,11022590,22,1,0,0,2
11022571,11022587,16,1,0,0,1
11022588,11022835,247,0,0,1,1
11022591,11022834,243,0,0,1,2
11022835,11022849,14,1,0,0,2
11022836,11022846,10,1,0,0,1
11022847,11023092,245,0,0,1,1
11022850,11022969,119,0,0,1,2
11022970,11022990,20,1,0,0,2
11022991,11023097,106,0,0,1,2
11023093,11023112,19,1,0,0,1
11023098,11023166,68,1,0,0,2
11023113,11023327,214,0,0,1,1
11023167,11023329,162,0,0,1,2
11023328,11023348,20,1,0,0,1
11023330,11023350,20,1,0,0,2
11023349,11023926,577,0,0,1,1
11023351,11023917,566,0,0,1,2
11023918,11023980,62,1,0,0,2
11023927,11023976,49,1,0,0,1
11023977,11024095,118,0,0,1,1
11023981,11024093,112,0,0,1,2
11024094,11024150,56,1,0,0,2
11024096,11024135,39,1,0,0,1
11024136,11024294,158,0,0,1,1
11024151,11024523,372,0,0,1,2
11024295,11024308,13,1,0,0,1
11024309,11024522,213,0,0,1,1
11024523,11024541,18,1,0,0,1
11024524,11024634,110,1,0,0,2
11024542,11024712,170,0,0,1,1
11024635,11024798,163,0,0,1,2
11024713,11024723,10,1,0,0,1
11024724,11024914,190,0,0,1,1
11024799,11024874,75,1,0,0,2
11024875,11024907,32,0,0,1,2
11024908,11024943,35,1,0,0,2
11024915,11024927,12,1,0,0,1
11024928,11025298,370,0,0,1,1
11024944,11025305,361,0,0,1,2
11025299,11025320,21,1,0,0,1
11025306,11025318,12,1,0,0,2
11025319,11025437,118,0,0,1,2
11025321,11025483,162,0,0,1,1
11025438,11025682,244,1,0,0,2
11025484,11025503,19,1,0,0,1
11025504,11025782,278,0,0,1,1
11025683,11025757,74,0,0,1,2
11025758,11026020,262,1,0,0,2
11025783,11025802,19,1,0,0,1
11025803,11025946,143,0,0,1,1
11025947,11026024,77,1,0,0,1
11026021,11026048,27,0,0,1,2
11026025,11026056,31,0,0,1,1
11026049,11026104,55,1,0,0,2
11026057,11026077,20,1,0,0,1
11026078,11026521,443,0,0,1,1
11026105,11026133,28,0,0,1,2
11026134,11026139,5,1,0,0,2
11026140,11026237,97,0,0,1,2
11026238,11026242,4,1,0,0,2
11026243,11026519,276,0,0,1,2
11026520,11026544,24,1,0,0,2
11026522,11026543,21,1,0,0,1
11026544,11026830,286,0,0,1,1
11026545,11026828,283,0,0,1,2
11026829,11026849,20,1,0,0,2
11026831,11026848,17,1,0,0,1
11026849,11026978,129,0,0,1,1
11026850,11026975,125,0,0,1,2
11026976,11026998,22,1,0,0,2
11026979,11026997,18,1,0,0,1
11026998,11027591,593,0,0,1,1
11026999,11027650,651,0,0,1,2
11027592,11027597,5,1,0,0,1
11027598,11027714,116,0,0,1,1
11027651,11027945,294,1,0,0,2
11027715,11027728,13,1,0,0,1
11027729,11028027,298,0,0,1,1
11027946,11028009,63,0,0,1,2
11028010,11028417,407,1,0,0,2
11028028,11028032,4,1,0,0,1
11028033,11028130,97,0,0,1,1
11028131,11028212,81,1,0,0,1
11028213,11028345,132,0,0,1,1
11028346,11028356,10,1,0,0,1
11028357,11028523,166,0,0,1,1
11028418,11028522,104,0,0,1,2
11028523,11028555,32,1,0,0,2
11028524,11028551,27,1,0,0,1
11028552,11028843,291,0,0,1,1
11028556,11028842,286,0,0,1,2
11028843,11028864,21,1,0,0,2
11028844,11028864,20,1,0,0,1
11028865,11028971,106,0,0,1,2
11028865,11028979,114,0,0,1,1
11028972,11028999,27,1,0,0,2
11028980,11028991,11,1,0,0,1
11028992,11029154,162,0,0,1,1
11029000,11029150,150,0,0,1,2
11029151,11029186,35,1,0,0,2
11029155,11029177,22,1,0,0,1
11029178,11029323,145,0,0,1,1
11029187,11029483,296,0,0,1,2
11029324,11029340,16,1,0,0,1
11029341,11029651,310,0,0,1,1
11029484,11029506,22,1,0,0,2
11029507,11029646,139,0,0,1,2
11029647,11029679,32,1,0,0,2
11029652,11029659,7,1,0,0,1
11029660,11029787,127,0,0,1,1
11029680,11029779,99,0,0,1,2
11029780,11029818,38,1,0,0,2
11029788,11029794,6,1,0,0,1
11029795,11030582,787,0,0,1,1
11029819,11029868,49,0,0,1,2
11029869,11030295,426,1,0,0,2
11030296,11030325,29,0,0,1,2
11030326,11030542,216,1,0,0,2
11030543,11030578,35,0,0,1,2
11030579,11030720,141,1,0,0,2
11030583,11030668,85,1,0,0,1
11030669,11030915,246,0,0,1,1
11030721,11030747,26,0,0,1,2
11030748,11030752,4,1,0,0,2
11030753,11030916,163,0,0,1,2
11030916,11030931,15,1,0,0,1
11030917,11030936,19,1,0,0,2
11030932,11032407,1475,0,0,1,1
11030937,11031059,122,0,0,1,2
11031060,11031073,13,1,0,0,2
11031074,11031710,636,0,0,1,2
11031711,11031717,6,1,0,0,2
11031718,11032017,299,0,0,1,2
11032018,11032062,44,1,0,0,2
11032063,11032170,107,0,0,1,2
11032171,11032930,759,1,0,0,2
11032408,11032969,561,1,0,0,1
11032455,11032667,212,0,1,0,1
11032462,11032586,124,0,1,0,2
11032931,11032964,33,0,0,1,2
11032965,11033116,151,1,0,0,2
11032970,11033048,78,0,0,1,1
11033049,11033148,99,1,0,0,1
11033117,11033173,56,0,0,1,2
11033149,11033202,53,0,0,1,1
11033174,11033199,25,1,0,0,2
11033200,11033276,76,0,0,1,2
11033203,11033209,6,1,0,0,1
11033210,11033252,42,0,0,1,1
11033253,11033298,45,1,0,0,1
11033277,11033294,17,1,0,0,2
11033295,11033447,152,0,0,1,2
11033299,11033446,147,0,0,1,1
11033447,11033476,29,1,0,0,1
11033448,11033476,28,1,0,0,2
11033477,11033612,135,0,0,1,1
11033477,11033614,137,0,0,1,2
11033613,11033629,16,1,0,0,1
11033615,11033621,6,1,0,0,2
11033622,11033874,252,0,0,1,2
11033630,11033872,242,0,0,1,1
11033873,11033886,13,1,0,0,1
11033875,11033883,8,1,0,0,2
11033884,11034490,606,0,0,1,2
11033887,11034045,158,0,0,1,1
11034046,11034054,8,1,0,0,1
11034055,11034280,225,0,0,1,1
11034281,11034292,11,1,0,0,1
11034293,11034960,667,0,0,1,1
11034491,11034519,28,1,0,0,2
11034520,11034954,434,0,0,1,2
11034955,11035012,57,1,0,0,2
11034961,11034976,15,1,0,0,1
11034977,11035525,548,0,0,1,1
11035013,11035106,93,0,0,1,2
11035107,11035260,153,1,0,0,2
11035261,11035525,264,0,0,1,2
11035526,11035589,63,1,0,0,1
11035526,11035607,81,1,0,0,2
11035590,11035659,69,0,0,1,1
11035608,11035661,53,0,0,1,2
11035660,11035704,44,1,0,0,1
11035662,11035788,126,1,0,0,2
11035705,11035746,41,0,0,1,1
11035747,11035777,30,1,0,0,1
11035778,11035979,201,0,0,1,1
11035789,11035977,188,0,0,1,2
11035978,11036002,24,1,0,0,2
11035980,11035999,19,1,0,0,1
11036000,11036185,185,0,0,1,1
11036003,11036188,185,0,0,1,2
11036186,11036208,22,1,0,0,1
11036189,11036210,21,1,0,0,2
11036209,11036866,657,0,0,1,1
11036211,11036866,655,0,0,1,2
11036867,11036886,19,1,0,0,2
11036867,11036888,21,1,0,0,1
11036887,11037031,144,0,0,1,2
11036889,11037028,139,0,0,1,1
11037029,11037050,21,1,0,0,1
11037032,11037050,18,1,0,0,2
11037051,11037219,168,0,0,1,1
11037051,11037223,172,0,0,1,2
11037220,11037241,21,1,0,0,1
11037224,11037239,15,1,0,0,2
11037240,11037596,356,0,0,1,2
11037242,11037598,356,0,0,1,1
11037597,11037606,9,1,0,0,2
11037599,11037606,7,1,0,0,1
11037607,11037703,96,0,0,1,2
11037607,11037739,132,0,0,1,1
11037704,11038952,1248,1,0,0,2
11037740,11037978,238,1,0,0,1
11037926,11038896,970,0,1,0,2
11037979,11038057,78,0,0,1,1
11038058,11038062,4,1,0,0,1
11038063,11038105,42,0,0,1,1
11038106,11038121,15,1,0,0,1
11038122,11038289,167,0,0,1,1
11038290,11038730,440,1,0,0,1
11038301,11038719,418,0,1,0,1
11038731,11038782,51,0,0,1,1
11038783,11038908,125,1,0,0,1
11038909,11039171,262,0,0,1,1
11038953,11038987,34,0,0,1,2
11038988,11039041,53,1,0,0,2
11039042,11039100,58,0,0,1,2
11039101,11039325,224,1,0,0,2
11039172,11039217,45,1,0,0,1
11039218,11039244,26,0,0,1,1
11039245,11039317,72,1,0,0,1
11039318,11039420,102,0,0,1,1
11039326,11039416,90,0,0,1,2
11039417,11039429,12,1,0,0,2
11039421,11039433,12,1,0,0,1
11039430,11039720,290,0,0,1,2
11039434,11039722,288,0,0,1,1
11039721,11039738,17,1,0,0,2
11039723,11039736,13,1,0,0,1
11039737,11039886,149,0,0,1,1
11039739,11039884,145,0,0,1,2
11039885,11039908,23,1,0,0,2
11039887,11039896,9,1,0,0,1
11039897,11039999,102,0,0,1,1
11039909,11039997,88,0,0,1,2
11039998,11040021,23,1,0,0,2
11040000,11040019,19,1,0,0,1
11040020,11041160,1140,0,0,1,1
11040022,11040172,150,0,0,1,2
11040173,11040179,6,1,0,0,2
11040180,11040293,113,0,0,1,2
11040294,11040310,16,1,0,0,2
11040311,11040510,199,0,0,1,2
11040511,11040515,4,1,0,0,2
11040516,11040729,213,0,0,1,2
11040730,11040759,29,1,0,0,2
11040760,11040852,92,0,0,1,2
11040853,11043955,3102,1,0,0,2
11041161,11043919,2758,1,0,0,1
11041483,11043855,2372,0,1,0,2
11043575,11043845,270,0,1,0,1
11043920,11044184,264,0,0,1,1
11043956,11043993,37,0,0,1,2
11043994,11044016,22,1,0,0,2
11044017,11044185,168,0,0,1,2
11044185,11044223,38,1,0,0,1
11044186,11044225,39,1,0,0,2
11044224,11044351,127,0,0,1,1
11044226,11044352,126,0,0,1,2
11044352,11044383,31,1,0,0,1
11044353,11044384,31,1,0,0,2
11044384,11044563,179,0,0,1,1
11044385,11044571,186,0,0,1,2
11044564,11045174,610,1,0,0,1
11044572,11045201,629,1,0,0,2
11044600,11045186,586,0,1,0,2
11044602,11045157,555,0,1,0,1
11045175,11045290,115,0,0,1,1
11045202,11045292,90,0,0,1,2
11045291,11045322,31,1,0,0,1
11045293,11045325,32,1,0,0,2
11045323,11045483,160,0,0,1,1
11045326,11045477,151,0,0,1,2
11045478,11045708,230,1,0,0,2
11045484,11045698,214,1,0,0,1
11045507,11045652,145,0,1,0,1
11045510,11045646,136,0,1,0,2
11045699,11047190,1491,0,0,1,1
11045709,11047582,1873,0,0,1,2
11047191,11047199,8,1,0,0,1
11047200,11047581,381,0,0,1,1
11047582,11047627,45,1,0,0,1
11047583,11047628,45,1,0,0,2
11047628,11048121,493,0,0,1,1
11047629,11048121,492,0,0,1,2
11048122,11048139,17,1,0,0,1
11048122,11048139,17,1,0,0,2
11048140,11049765,1625,0,0,1,2
11048140,11049766,1626,0,0,1,1
11049766,11050008,242,1,0,0,2
11049767,11049979,212,1,0,0,1
11049841,11049883,42,0,1,0,2
11049980,11050081,101,0,0,1,1
11050009,11050082,73,0,0,1,2
11050082,11050121,39,1,0,0,1
11050083,11050136,53,1,0,0,2
11050122,11050287,165,0,0,1,1
11050137,11050287,150,0,0,1,2
11050288,11050304,16,1,0,0,1
11050288,11050315,27,1,0,0,2
11050305,11050449,144,0,0,1,1
11050316,11050446,130,0,0,1,2
11050447,11050465,18,1,0,0,2
11050450,11050461,11,1,0,0,1
11050462,11050903,441,0,0,1,1
11050466,11050902,436,0,0,1,2
11050903,11050929,26,1,0,0,2
11050904,11050926,22,1,0,0,1
11050927,11051132,205,0,0,1,1
11050930,11051127,197,0,0,1,2
11051128,11051213,85,1,0,0,2
11051133,11051210,77,1,0,0,1
11051211,11051314,103,0,0,1,1
11051214,11051276,62,0,0,1,2
11051277,11051338,61,1,0,0,2
11051315,11051341,26,1,0,0,1
11051339,11051769,430,0,0,1,2
11051342,11051769,427,0,0,1,1
11051770,11051787,17,1,0,0,2
11051770,11051790,20,1,0,0,1
11051788,11051923,135,0,0,1,2
11051791,11051924,133,0,0,1,1
11051924,11051951,27,1,0,0,2
11051925,11051946,21,1,0,0,1
11051947,11052233,286,0,0,1,1
11051952,11052233,281,0,0,1,2
11052234,11052254,20,1,0,0,2
11052234,11052256,22,1,0,0,1
11052255,11052386,131,0,0,1,2
11052257,11052390,133,0,0,1,1
11052387,11052503,116,1,0,0,2
11052391,11052414,23,1,0,0,1
11052415,11053016,601,0,0,1,1
11052504,11052602,98,0,0,1,2
11052603,11052707,104,1,0,0,2
11052708,11052792,84,0,0,1,2
11052793,11052809,16,1,0,0,2
11052810,11052980,170,0,0,1,2
11052981,11053077,96,1,0,0,2
11053017,11053058,41,1,0,0,1
11053059,11053370,311,0,0,1,1
11053078,11053370,292,0,0,1,2
11053371,11053388,17,1,0,0,1
11053371,11053389,18,1,0,0,2
11053389,11053695,306,0,0,1,1
11053390,11053687,297,0,0,1,2
11053688,11053711,23,1,0,0,2
11053696,11053709,13,1,0,0,1
11053710,11053920,210,0,0,1,1
11053712,11053916,204,0,0,1,2
11053917,11053940,23,1,0,0,2
11053921,11053940,19,1,0,0,1
11053941,11054113,172,0,0,1,1
11053941,11054176,235,0,0,1,2
11054114,11054118,4,1,0,0,1
11054119,11054238,119,0,0,1,1
11054177,11054198,21,1,0,0,2
11054199,11054233,34,0,0,1,2
11054234,11054297,63,1,0,0,2
11054239,11054248,9,1,0,0,1
11054249,11055235,986,0,0,1,1
11054298,11054501,203,0,0,1,2
11054502,11054687,185,1,0,0,2
11054688,11054721,33,0,0,1,2
11054722,11056133,1411,1,0,0,2
11055236,11055278,42,1,0,0,1
11055279,11055552,273,0,0,1,1
11055553,11056037,484,1,0,0,1
11055645,11055830,185,0,1,0,2
11055652,11055838,186,0,1,0,1
11056038,11056396,358,0,0,1,1
11056134,11056391,257,0,0,1,2
11056392,11056437,45,1,0,0,2
11056397,11056434,37,1,0,0,1
11056435,11056753,318,0,0,1,1
11056438,11056575,137,0,0,1,2
11056576,11056585,9,1,0,0,2
11056586,11056751,165,0,0,1,2
11056752,11056859,107,1,0,0,2
11056754,11056849,95,1,0,0,1
11056850,11056999,149,0,0,1,1
11056860,11056922,62,0,0,1,2
11056923,11057044,121,1,0,0,2
11057000,11057024,24,1,0,0,1
11057025,11057217,192,0,0,1,1
11057045,11057124,79,0,0,1,2
11057125,11057155,30,1,0,0,2
11057156,11057216,60,0,0,1,2
11057217,11057746,529,1,0,0,2
11057218,11057245,27,1,0,0,1
11057246,11057334,88,0,0,1,1
11057335,11057640,305,1,0,0,1
11057343,11057615,272,0,1,0,2
11057363,11057544,181,0,1,0,1
11057641,11057676,35,0,0,1,1
11057677,11057707,30,1,0,0,1
11057708,11057849,141,0,0,1,1
11057747,11057851,104,0,0,1,2
11057850,11057875,25,1,0,0,1
11057852,11057874,22,1,0,0,2
11057875,11058036,161,0,0,1,2
11057876,11058039,163,0,0,1,1
11058037,11058054,17,1,0,0,2
11058040,11058053,13,1,0,0,1
11058054,11058623,569,0,0,1,1
11058055,11058618,563,0,0,1,2
11058619,11058635,16,1,0,0,2
11058624,11058637,13,1,0,0,1
11058636,11058892,256,0,0,1,2
11058638,11058892,254,0,0,1,1
11058893,11058903,10,1,0,0,1
11058893,11058904,11,1,0,0,2
11058904,11059699,795,0,0,1,1
11058905,11059839,934,0,0,1,2
11059700,11059721,21,1,0,0,1
11059722,11059839,117,0,0,1,1
11059840,11059905,65,1,0,0,2
11059840,11059910,70,1,0,0,1
11059906,11060046,140,0,0,1,2
11059911,11060047,136,0,0,1,1
11060047,11060077,30,1,0,0,2
11060048,11060072,24,1,0,0,1
11060073,11060555,482,0,0,1,1
11060078,11060552,474,0,0,1,2
11060553,11060572,19,1,0,0,2
11060556,11060572,16,1,0,0,1
11060573,11060730,157,0,0,1,2
11060573,11060734,161,0,0,1,1
11060731,11060751,20,1,0,0,2
11060735,11060747,12,1,0,0,1
11060748,11061512,764,0,0,1,1
11060752,11061206,454,0,0,1,2
11061207,11061211,4,1,0,0,2
11061212,11061595,383,0,0,1,2
11061513,11061524,11,1,0,0,1
11061525,11062223,698,0,0,1,1
11061596,11061635,39,1,0,0,2
11061636,11061696,60,0,0,1,2
11061697,11061940,243,1,0,0,2
11061941,11061973,32,0,0,1,2
11061974,11062027,53,1,0,0,2
11062028,11062092,64,0,0,1,2
11062093,11062126,33,1,0,0,2
11062127,11062164,37,0,0,1,2
11062165,11062189,24,1,0,0,2
11062190,11062226,36,0,0,1,2
11062224,11062247,23,1,0,0,1
11062227,11062607,380,1,0,0,2
11062248,11063023,775,0,0,1,1
11062608,11062656,48,0,0,1,2
11062657,11062692,35,1,0,0,2
11062693,11062717,24,0,0,1,2
11062718,11062846,128,1,0,0,2
11062847,11062888,41,0,0,1,2
11062889,11069275,6386,1,0,0,2
11063024,11063398,374,1,0,0,1
11063399,11063422,23,0,0,1,1
11063423,11063535,112,1,0,0,1
11063536,11063596,60,0,0,1,1
11063597,11064059,462,1,0,0,1
11063888,11064223,335,0,1,0,2
11063916,11063950,34,0,1,0,1
11063974,11063983,9,0,1,0,1
11064060,11064155,95,0,0,1,1
11064156,11064181,25,1,0,0,1
11064182,11064305,123,0,0,1,1
11064306,11064325,19,1,0,0,1
11064326,11064612,286,0,0,1,1
11064613,11064628,15,1,0,0,1
11064629,11064767,138,0,0,1,1
11064768,11064782,14,1,0,0,1
11064783,11065005,222,0,0,1,1
11065006,11065314,308,1,0,0,1
11065028,11065289,261,0,1,0,2
11065045,11065209,164,0,1,0,1
11065315,11065361,46,0,0,1,1
11065319,11065335,16,0,1,0,2
11065362,11065370,8,1,0,0,1
11065371,11065411,40,0,0,1,1
11065412,11065430,18,1,0,0,1
11065431,11065548,117,0,0,1,1
11065549,11065553,4,1,0,0,1
11065554,11065586,32,0,0,1,1
11065587,11065655,68,1,0,0,1
11065656,11065734,78,0,0,1,1
11065735,11065767,32,1,0,0,1
11065768,11065879,111,0,0,1,1
11065880,11065908,28,1,0,0,1
11065895,11066256,361,0,1,0,2
11065909,11065991,82,0,0,1,1
11065992,11066119,127,1,0,0,1
11066004,11066005,1,0,1,0,1
11066120,11066143,23,0,0,1,1
11066144,11066257,113,1,0,0,1
11066258,11066584,326,0,0,1,1
11066585,11066667,82,1,0,0,1
11066668,11066792,124,0,0,1,1
11066793,11067647,854,1,0,0,1
11066801,11067660,859,0,1,0,2
11066839,11066897,58,0,1,0,1
11066980,11066989,9,0,1,0,1
11067014,11067114,100,0,1,0,1
11067210,11067301,91,0,1,0,1
11067357,11067410,53,0,1,0,1
11067530,11067562,32,0,1,0,1
11067648,11067786,138,0,0,1,1
11067787,11067791,4,1,0,0,1
11067792,11068271,479,0,0,1,1
11068272,11068302,30,1,0,0,1
11068303,11068398,95,0,0,1,1
11068393,11069173,780,0,1,0,2
11068399,11068453,54,1,0,0,1
11068454,11068504,50,0,0,1,1
11068505,11069305,800,1,0,0,1
11068588,11068747,159,0,1,0,1
11068791,11069139,348,0,1,0,1
11069276,11069425,149,0,0,1,2
11069306,11069523,217,0,0,1,1
11069426,11069436,10,1,0,0,2
11069437,11069556,119,0,0,1,2
11069524,11069528,4,1,0,0,1
11069529,11070086,557,0,0,1,1
11069557,11069562,5,1,0,0,2
11069563,11069597,34,0,0,1,2
11069598,11069609,11,1,0,0,2
11069610,11069920,310,0,0,1,2
11069921,11069925,4,1,0,0,2
11069926,11070084,158,0,0,1,2
11070085,11070131,46,1,0,0,2
11070087,11070128,41,1,0,0,1
11070129,11070209,80,0,0,1,1
11070132,11070192,60,0,0,1,2
11070193,11070661,468,1,0,0,2
11070210,11070570,360,1,0,0,1
11070242,11070468,226,0,1,0,1
11070251,11070476,225,0,1,0,2
11070571,11070603,32,0,0,1,1
11070604,11070660,56,1,0,0,1
11070661,11070770,109,0,0,1,1
11070662,11070769,107,0,0,1,2
11070770,11070800,30,1,0,0,2
11070771,11070801,30,1,0,0,1
11070801,11070962,161,0,0,1,2
11070802,11070961,159,0,0,1,1
11070962,11070983,21,1,0,0,1
11070963,11070983,20,1,0,0,2
11070984,11071458,474,0,0,1,1
11070984,11071458,474,0,0,1,2
11071459,11071466,7,1,0,0,2
11071459,11071469,10,1,0,0,1
11071467,11071657,190,0,0,1,2
11071470,11071660,190,0,0,1,1
11071658,11071673,15,1,0,0,2
11071661,11071674,13,1,0,0,1
11071674,11072146,472,0,0,1,2
11071675,11072326,651,0,0,1,1
11072147,11072153,6,1,0,0,2
11072154,11072626,472,0,0,1,2
11072327,11072339,12,1,0,0,1
11072340,11072480,140,0,0,1,1
11072481,11072486,5,1,0,0,1
11072487,11073360,873,0,0,1,1
11072627,11072656,29,1,0,0,2
11072657,11072698,41,0,0,1,2
11072699,11072714,15,1,0,0,2
11072715,11072826,111,0,0,1,2
11072827,11072944,117,1,0,0,2
11072945,11072973,28,0,0,1,2
11072974,11074732,1758,1,0,0,2
11073361,11073443,82,1,0,0,1
11073436,11073770,334,0,1,0,2
11073444,11073608,164,0,0,1,1
11073609,11073698,89,1,0,0,1
11073699,11073972,273,0,0,1,1
11073973,11073979,6,1,0,0,1
11073980,11074203,223,0,0,1,1
11074204,11074730,526,1,0,0,1
11074216,11074654,438,0,1,0,2
11074243,11074587,344,0,1,0,1
11074731,11074899,168,0,0,1,1
11074733,11074898,165,0,0,1,2
11074899,11074935,36,1,0,0,2
11074900,11074933,33,1,0,0,1
11074934,11075069,135,0,0,1,1
11074936,11075069,133,0,0,1,2
11075070,11075098,28,1,0,0,1
11075070,11075166,96,1,0,0,2
11075099,11075281,182,0,0,1,1
11075167,11075248,81,0,0,1,2
11075249,11075256,7,1,0,0,2
11075257,11075281,24,0,0,1,2
11075282,11075303,21,1,0,0,1
11075282,11075718,436,1,0,0,2
11075304,11075426,122,0,0,1,1
11075427,11075534,107,1,0,0,1
11075535,11075557,22,0,0,1,1
11075558,11075570,12,1,0,0,1
11075571,11075627,56,0,0,1,1
11075628,11075633,5,1,0,0,1
11075634,11075713,79,0,0,1,1
11075714,11075718,4,1,0,0,1
11075719,11076106,387,0,0,1,2
11075719,11076141,422,0,0,1,1
11076107,11076232,125,1,0,0,2
11076142,11076147,5,1,0,0,1
11076148,11076221,73,0,0,1,1
11076222,11076230,8,1,0,0,1
11076231,11076308,77,0,0,1,1
11076233,11076302,69,0,0,1,2
11076303,11076331,28,1,0,0,2
11076309,11076326,17,1,0,0,1
11076327,11076379,52,0,0,1,1
11076332,11076368,36,0,0,1,2
11076369,11076423,54,1,0,0,2
11076380,11076396,16,1,0,0,1
11076397,11076493,96,0,0,1,1
11076424,11076503,79,0,0,1,2
11076494,11076509,15,1,0,0,1
11076504,11076517,13,1,0,0,2
11076510,11076647,137,0,0,1,1
11076518,11076539,21,0,0,1,2
11076540,11076759,219,1,0,0,2
11076648,11076726,78,1,0,0,1
11076727,11076960,233,0,0,1,1
11076760,11076811,51,0,0,1,2
11076812,11076867,55,1,0,0,2
11076868,11076919,51,0,0,1,2
11076920,11076998,78,1,0,0,2
11076961,11076981,20,1,0,0,1
11076982,11077462,480,0,0,1,1
11076999,11077024,25,0,0,1,2
11077025,11077029,4,1,0,0,2
11077030,11077108,78,0,0,1,2
11077109,11080615,3506,1,0,0,2
11077463,11077542,79,1,0,0,1
11077533,11077727,194,0,1,0,2
11077543,11077623,80,0,0,1,1
11077624,11078901,1277,1,0,0,1
11077884,11077905,21,0,1,0,2
11078085,11078932,847,0,1,0,2
11078902,11078952,50,0,0,1,1
11078953,11082528,3575,1,0,0,1
11078978,11080027,1049,0,1,0,2
11079977,11079983,6,0,1,0,1
11080048,11080520,472,0,1,0,2
11080598,11080606,8,0,1,0,2
11080616,11080648,32,0,0,1,2
11080649,11082654,2005,1,0,0,2
11080776,11082446,1670,0,1,0,2
11081874,11082391,517,0,1,0,1
11082529,11082601,72,0,0,1,1
11082602,11082646,44,1,0,0,1
11082647,11083167,520,0,0,1,1
11082655,11082679,24,0,0,1,2
11082680,11082692,12,1,0,0,2
11082693,11082768,75,0,0,1,2
11082769,11082796,27,1,0,0,2
11082797,11082861,64,0,0,1,2
11082862,11083040,178,1,0,0,2
11083041,11083092,51,0,0,1,2
11083093,11083107,14,1,0,0,2
11083108,11083141,33,0,0,1,2
11083142,11083371,229,1,0,0,2
11083168,11083172,4,1,0,0,1
11083173,11083224,51,0,0,1,1
11083225,11083309,84,1,0,0,1
11083310,11083416,106,0,0,1,1
11083372,11083424,52,0,0,1,2
11083417,11083440,23,1,0,0,1
11083425,11084245,820,1,0,0,2
11083441,11083473,32,0,0,1,1
11083474,11084241,767,1,0,0,1
11083503,11084125,622,0,1,0,2
11083515,11084112,597,0,1,0,1
11084242,11084342,100,0,0,1,1
11084246,11084339,93,0,0,1,2
11084340,11084634,294,1,0,0,2
11084343,11084639,296,1,0,0,1
11084365,11084573,208,0,1,0,2
11084370,11084558,188,0,1,0,1
11084635,11084742,107,0,0,1,2
11084640,11084745,105,0,0,1,1
11084743,11084770,27,1,0,0,2
11084746,11084772,26,1,0,0,1
11084771,11084951,180,0,0,1,2
11084773,11084955,182,0,0,1,1
11084952,11084970,18,1,0,0,2
11084956,11084963,7,1,0,0,1
11084964,11085133,169,0,0,1,1
11084971,11085135,164,0,0,1,2
11085134,11085144,10,1,0,0,1
11085136,11085147,11,1,0,0,2
11085145,11085825,680,0,0,1,1
11085148,11085824,676,0,0,1,2
11085825,11085842,17,1,0,0,2
11085826,11085841,15,1,0,0,1
11085842,11086008,166,0,0,1,1
11085843,11086008,165,0,0,1,2
11086009,11086026,17,1,0,0,1
11086009,11086028,19,1,0,0,2
11086027,11086174,147,0,0,1,1
11086029,11086173,144,0,0,1,2
11086174,11086194,20,1,0,0,2
11086175,11086193,18,1,0,0,1
11086194,11086340,146,0,0,1,1
11086195,11086338,143,0,0,1,2
11086339,11086444,105,1,0,0,2
11086341,11086469,128,1,0,0,1
11086445,11086681,236,0,0,1,2
11086470,11086573,103,0,0,1,1
11086574,11086582,8,1,0,0,1
11086583,11086873,290,0,0,1,1
11086682,11096079,9397,1,0,0,2
11086800,11086829,29,0,1,0,2
11086855,11088757,1902,0,1,0,2
11086874,11086899,25,1,0,0,1
11086900,11087122,222,0,0,1,1
11087123,11087144,21,1,0,0,1
11087145,11087248,103,0,0,1,1
11087249,11087314,65,1,0,0,1
11087315,11087359,44,0,0,1,1
11087360,11088884,1524,1,0,0,1
11088348,11088613,265,0,1,0,1
11088885,11088934,49,0,0,1,1
11088935,11090279,1344,1,0,0,1
11089072,11089592,520,0,1,0,2
11089285,11089556,271,0,1,0,1
11089724,11092675,2951,0,1,0,2
11089949,11089969,20,0,1,0,1
11090280,11090301,21,0,0,1,1
11090302,11090572,270,1,0,0,1
11090573,11090682,109,0,0,1,1
11090683,11090716,33,1,0,0,1
11090717,11090851,134,0,0,1,1
11090852,11090976,124,1,0,0,1
11090977,11090997,20,0,0,1,1
11090998,11091014,16,1,0,0,1
11091015,11091080,65,0,0,1,1
11091081,11092750,1669,1,0,0,1
11091092,11091093,1,0,1,0,1
11091245,11091306,61,0,1,0,1
11091458,11091803,345,0,1,0,1
11092001,11092077,76,0,1,0,1
11092394,11092612,218,0,1,0,1
11092751,11093138,387,0,0,1,1
11093139,11093163,24,1,0,0,1
11093164,11093369,205,0,0,1,1
11093370,11093377,7,1,0,0,1
11093378,11093453,75,0,0,1,1
11093413,11095334,1921,0,1,0,2
11093454,11095572,2118,1,0,0,1
11094624,11094960,336,0,1,0,1
11095573,11095600,27,0,0,1,1
11095601,11095813,212,1,0,0,1
11095814,11095964,150,0,0,1,1
11095965,11095971,6,1,0,0,1
11095972,11096478,506,0,0,1,1
11096080,11096102,22,0,0,1,2
11096103,11096179,76,1,0,0,2
11096180,11096244,64,0,0,1,2
11096245,11096268,23,1,0,0,2
11096269,11096480,211,0,0,1,2
11096479,11096515,36,1,0,0,1
11096481,11096514,33,1,0,0,2
11096515,11096564,49,0,0,1,2
11096516,11096562,46,0,0,1,1
11096563,11096572,9,1,0,0,1
11096565,11096583,18,1,0,0,2
11096573,11096735,162,0,0,1,1
11096584,11096699,115,0,0,1,2
11096700,11096774,74,1,0,0,2
11096736,11096777,41,1,0,0,1
11096775,11096891,116,0,0,1,2
11096778,11096893,115,0,0,1,1
11096892,11097171,279,1,0,0,2
11096894,11096946,52,1,0,0,1
11096947,11097018,71,0,0,1,1
11097019,11097041,22,1,0,0,1
11097042,11097068,26,0,0,1,1
11097063,11097069,6,0,1,0,2
11097069,11097164,95,1,0,0,1
11097090,11097095,5,0,1,0,2
11097165,11097189,24,0,0,1,1
11097172,11097194,22,0,0,1,2
11097190,11097240,50,1,0,0,1
11097195,11097217,22,1,0,0,2
11097218,11097422,204,0,0,1,2
11097241,11097307,66,0,0,1,1
11097308,11097323,15,1,0,0,1
11097324,11097415,91,0,0,1,1
11097416,11097443,27,1,0,0,1
11097423,11097436,13,1,0,0,2
11097437,11097490,53,0,0,1,2
11097444,11097489,45,0,0,1,1
11097490,11097822,332,1,0,0,1
11097491,11097834,343,1,0,0,2
11097524,11097781,257,0,1,0,2
11097529,11097751,222,0,1,0,1
11097823,11097880,57,0,0,1,1
11097835,11097880,45,0,0,1,2
11097881,11097907,26,1,0,0,2
11097881,11097914,33,1,0,0,1
11097908,11098198,290,0,0,1,2
11097915,11098374,459,0,0,1,1
11098199,11098212,13,1,0,0,2
11098213,11098376,163,0,0,1,2
11098375,11098398,23,1,0,0,1
11098377,11098398,21,1,0,0,2
11098399,11098629,230,0,0,1,1
11098399,11098631,232,0,0,1,2
11098630,11098643,13,1,0,0,1
11098632,11098642,10,1,0,0,2
11098643,11098837,194,0,0,1,2
11098644,11098836,192,0,0,1,1
11098837,11098851,14,1,0,0,1
11098838,11098853,15,1,0,0,2
11098852,11098958,106,0,0,1,1
11098854,11098962,108,0,0,1,2
11098959,11098982,23,1,0,0,1
11098963,11098986,23,1,0,0,2
11098983,11099129,146,0,0,1,1
11098987,11099117,130,0,0,1,2
11099118,11103149,4031,1,0,0,2
11099130,11099196,66,1,0,0,1
11099197,11099267,70,0,0,1,1
11099268,11099300,32,1,0,0,1
11099301,11099355,54,0,0,1,1
11099356,11102873,3517,1,0,0,1
11099419,11099618,199,0,1,0,2
11099726,11100891,1165,0,1,0,2
11100086,11100280,194,0,1,0,1
11100921,11101152,231,0,1,0,2
11101178,11102594,1416,0,1,0,2
11102153,11102558,405,0,1,0,1
11102874,11103013,139,0,0,1,1
11103014,11103922,908,1,0,0,1
11103150,11103175,25,0,0,1,2
11103176,11103411,235,1,0,0,2
11103412,11103451,39,0,0,1,2
11103452,11103516,64,1,0,0,2
11103517,11103540,23,0,0,1,2
11103541,11104035,494,1,0,0,2
11103618,11103746,128,0,1,0,2
11103923,11104195,272,0,0,1,1
11104036,11104063,27,0,0,1,2
11104064,11104102,38,1,0,0,2
11104103,11104194,91,0,0,1,2
11104195,11104260,65,1,0,0,2
11104196,11104269,73,1,0,0,1
11104261,11104388,127,0,0,1,2
11104270,11104387,117,0,0,1,1
11104388,11104414,26,1,0,0,1
11104389,11104416,27,1,0,0,2
11104415,11104636,221,0,0,1,1
11104417,11104637,220,0,0,1,2
11104637,11104662,25,1,0,0,1
11104638,11104670,32,1,0,0,2
11104663,11104881,218,0,0,1,1
11104671,11104883,212,0,0,1,2
11104882,11104903,21,1,0,0,1
11104884,11104903,19,1,0,0,2
11104904,11105236,332,0,0,1,1
11104904,11105505,601,0,0,1,2
11105237,11105250,13,1,0,0,1
11105251,11105503,252,0,0,1,1
11105504,11105514,10,1,0,0,1
11105506,11105516,10,1,0,0,2
11105515,11105654,139,0,0,1,1
11105517,11105656,139,0,0,1,2
11105655,11105664,9,1,0,0,1
11105657,11105667,10,1,0,0,2
11105665,11105895,230,0,0,1,1
11105668,11105902,234,0,0,1,2
11105896,11105916,20,1,0,0,1
11105903,11105912,9,1,0,0,2
11105913,11106051,138,0,0,1,2
11105917,11106049,132,0,0,1,1
11106050,11106070,20,1,0,0,1
11106052,11106071,19,1,0,0,2
11106071,11106227,156,0,0,1,1
11106072,11106229,157,0,0,1,2
11106228,11106256,28,1,0,0,1
11106230,11106250,20,1,0,0,2
11106251,11106380,129,0,0,1,2
11106257,11106548,291,0,0,1,1
11106381,11106390,9,1,0,0,2
11106391,11106548,157,0,0,1,2
11106549,11106622,73,1,0,0,1
11106549,11106632,83,1,0,0,2
11106623,11106986,363,0,0,1,1
11106633,11106979,346,0,0,1,2
11106980,11107000,20,1,0,0,2
11106987,11107003,16,1,0,0,1
11107001,11107147,146,0,0,1,2
11107004,11107138,134,0,0,1,1
11107139,11107154,15,1,0,0,1
11107148,11107160,12,1,0,0,2
11107155,11107356,201,0,0,1,1
11107161,11107355,194,0,0,1,2
11107356,11107373,17,1,0,0,2
11107357,11107373,16,1,0,0,1
11107374,11108119,745,0,0,1,2
11107374,11108654,1280,0,0,1,1
11108120,11108141,21,1,0,0,2
11108142,11108304,162,0,0,1,2
11108305,11117146,8841,1,0,0,2
11108655,11109876,1221,1,0,0,1
11108736,11109133,397,0,1,0,1
11108756,11109276,520,0,1,0,2
11109858,11110548,690,0,1,0,2
11109877,11109926,49,0,0,1,1
11109927,11110875,948,1,0,0,1
11110637,11110644,7,0,1,0,2
11110690,11110717,27,0,1,0,2
11110809,11110871,62,0,1,0,2
11110876,11110904,28,0,0,1,1
11110905,11111116,211,1,0,0,1
11111117,11111137,20,0,0,1,1
11111138,11111158,20,1,0,0,1
11111159,11111184,25,0,0,1,1
11111185,11114030,2845,1,0,0,1
11111429,11111595,166,0,1,0,2
11111622,11111624,2,0,1,0,2
11111755,11116789,5034,0,1,0,2
11112144,11112456,312,0,1,0,1
11112738,11113520,782,0,1,0,1
11114031,11114064,33,0,0,1,1
11114065,11116992,2927,1,0,0,1
11114145,11116684,2539,0,1,0,1
11116993,11117340,347,0,0,1,1
11117147,11117169,22,0,0,1,2
11117170,11117240,70,1,0,0,2
11117241,11117268,27,0,0,1,2
11117269,11117394,125,1,0,0,2
11117341,11117382,41,1,0,0,1
11117383,11117546,163,0,0,1,1
11117395,11117543,148,0,0,1,2
11117544,11117592,48,1,0,0,2
11117547,11117584,37,1,0,0,1
11117585,11117658,73,0,0,1,1
11117593,11117657,64,0,0,1,2
11117658,11117736,78,1,0,0,2
11117659,11117735,76,1,0,0,1
11117736,11117766,30,0,0,1,1
11117737,11117803,66,0,0,1,2
11117767,11117850,83,1,0,0,1
11117804,11117811,7,1,0,0,2
11117812,11117832,20,0,0,1,2
11117833,11117837,4,1,0,0,2
11117838,11118067,229,0,0,1,2
11117851,11117942,91,0,0,1,1
11117943,11117953,10,1,0,0,1
11117954,11118064,110,0,0,1,1
11118065,11118097,32,1,0,0,1
11118068,11118104,36,1,0,0,2
11118098,11118176,78,0,0,1,1
11118105,11118176,71,0,0,1,2
11118177,11118245,68,1,0,0,1
11118177,11118259,82,1,0,0,2
11118246,11118357,111,0,0,1,1
11118260,11118355,95,0,0,1,2
11118356,11118400,44,1,0,0,2
11118358,11118393,35,1,0,0,1
11118394,11118546,152,0,0,1,1
11118401,11118545,144,0,0,1,2
11118546,11118577,31,1,0,0,2
11118547,11118569,22,1,0,0,1
11118570,11118745,175,0,0,1,1
11118578,11118746,168,0,0,1,2
11118746,11118768,22,1,0,0,1
11118747,11118769,22,1,0,0,2
11118769,11120545,1776,0,0,1,1
11118770,11119301,531,0,0,1,2
11119302,11119307,5,1,0,0,2
11119308,11120414,1106,0,0,1,2
11120415,11122757,2342,1,0,0,2
11120546,11120637,91,1,0,0,1
11120638,11120661,23,0,0,1,1
11120662,11120666,4,1,0,0,1
11120667,11120854,187,0,0,1,1
11120855,11120862,7,1,0,0,1
11120863,11120911,48,0,0,1,1
11120912,11121405,493,1,0,0,1
11120957,11121147,190,0,1,0,1
11120961,11121171,210,0,1,0,2
11121406,11121455,49,0,0,1,1
11121456,11121534,78,1,0,0,1
11121535,11121640,105,0,0,1,1
11121641,11121645,4,1,0,0,1
11121646,11121783,137,0,0,1,1
11121784,11121794,10,1,0,0,1
11121795,11122506,711,0,0,1,1
11122507,11125036,2529,1,0,0,1
11122687,11122746,59,0,1,0,2
11122758,11122789,31,0,0,1,2
11122790,11123533,743,1,0,0,2
11122805,11123394,589,0,1,0,2
11122856,11123322,466,0,1,0,1
11123534,11123573,39,0,0,1,2
11123574,11125307,1733,1,0,0,2
11124099,11124122,23,0,1,0,2
11124161,11124180,19,0,1,0,2
11124211,11124213,2,0,1,0,2
11124242,11124264,22,0,1,0,2
11124638,11124792,154,0,1,0,2
11124828,11124847,19,0,1,0,2
11125037,11125096,59,0,0,1,1
11125097,11125171,74,1,0,0,1
11125172,11125256,84,0,0,1,1
11125257,11125284,27,1,0,0,1
11125285,11125449,164,0,0,1,1
11125308,11125448,140,0,0,1,2
11125449,11125488,39,1,0,0,2
11125450,11125515,65,1,0,0,1
11125489,11125696,207,0,0,1,2
11125516,11125697,181,0,0,1,1
11125697,11125848,151,1,0,0,2
11125698,11125715,17,1,0,0,1
11125716,11125839,123,0,0,1,1
11125840,11125868,28,1,0,0,1
11125849,11125974,125,0,0,1,2
11125869,11125980,111,0,0,1,1
11125975,11126029,54,1,0,0,2
11125981,11126023,42,1,0,0,1
11126024,11126168,144,0,0,1,1
11126030,11126179,149,0,0,1,2
11126169,11126187,18,1,0,0,1
11126180,11129494,3314,1,0,0,2
11126188,11126279,91,0,0,1,1
11126280,11126333,53,1,0,0,1
11126334,11126366,32,0,0,1,1
11126367,11129470,3103,1,0,0,1
11126991,11129315,2324,0,1,0,2
11127730,11127833,103,0,1,0,1
11128026,11129276,1250,0,1,0,1
11129471,11129789,318,0,0,1,1
11129495,11129790,295,0,0,1,2
11129790,11129824,34,1,0,0,1
11129791,11129830,39,1,0,0,2
11129825,11130128,303,0,0,1,1
11129831,11130125,294,0,0,1,2
11130126,11130166,40,1,0,0,2
11130129,11130155,26,1,0,0,1
11130156,11130449,293,0,0,1,1
11130167,11130448,281,0,0,1,2
11130449,11130520,71,1,0,0,2
11130450,11130513,63,1,0,0,1
11130514,11130687,173,0,0,1,1
11130521,11130687,166,0,0,1,2
11130688,11130706,18,1,0,0,2
11130688,11130708,20,1,0,0,1
11130707,11131431,724,0,0,1,2
11130709,11131636,927,0,0,1,1
11131432,11131444,12,1,0,0,2
11131445,11131637,192,0,0,1,2
11131637,11131661,24,1,0,0,1
11131638,11131661,23,1,0,0,2
11131662,11131791,129,0,0,1,1
11131662,11131792,130,0,0,1,2
11131792,11131808,16,1,0,0,1
11131793,11131809,16,1,0,0,2
11131809,11132355,546,0,0,1,1
11131810,11132143,333,0,0,1,2
11132144,11132156,12,1,0,0,2
11132157,11132356,199,0,0,1,2
11132356,11132362,6,1,0,0,1
11132357,11132370,13,1,0,0,2
11132363,11132470,107,0,0,1,1
11132371,11132472,101,0,0,1,2
11132471,11132498,27,1,0,0,1
11132473,11132506,33,1,0,0,2
11132499,11132635,136,0,0,1,1
11132507,11132930,423,0,0,1,2
11132636,11132645,9,1,0,0,1
11132646,11132738,92,0,0,1,1
11132739,11132777,38,1,0,0,1
11132778,11132863,85,0,0,1,1
11132864,11132914,50,1,0,0,1
11132915,11133029,114,0,0,1,1
11132931,11132950,19,1,0,0,2
11132951,11133244,293,0,0,1,2
11133030,11134988,1958,1,0,0,1
11133245,11133286,41,1,0,0,2
11133287,11133348,61,0,0,1,2
11133349,11135287,1938,1,0,0,2
11134093,11134625,532,0,1,0,2
11134119,11134547,428,0,1,0,1
11134989,11135017,28,0,0,1,1
11135018,11135231,213,1,0,0,1
11135232,11135252,20,0,0,1,1
11135253,11135905,652,1,0,0,1
11135288,11135319,31,0,0,1,2
11135330,11135539,209,0,1,0,2
11135359,11135574,215,0,1,0,1
11135549,11136208,659,1,0,0,2
11135906,11135935,29,0,0,1,1
11135936,11135996,60,1,0,0,1
11135997,11136040,43,0,0,1,1
11136041,11136118,77,1,0,0,1
11136119,11136269,150,0,0,1,1
11136209,11136273,64,0,0,1,2
11136270,11136287,17,1,0,0,1
11136274,11136353,79,1,0,0,2
11136288,11136481,193,0,0,1,1
11136354,11136386,32,0,0,1,2
11136387,11136786,399,1,0,0,2
11136482,11136494,12,1,0,0,1
11136495,11136665,170,0,0,1,1
11136666,11136693,27,1,0,0,1
11136694,11136724,30,0,0,1,1
11136725,11142205,5480,1,0,0,1
11136787,11136830,43,0,0,1,2
11136831,11137026,195,1,0,0,2
11137027,11137126,99,0,0,1,2
11137127,11137436,309,1,0,0,2
11137235,11137241,6,0,1,0,2
11137263,11137306,43,0,1,0,2
11137339,11137341,2,0,1,0,2
11137437,11137482,45,0,0,1,2
11137483,11142380,4897,1,0,0,2
11137685,11142029,4344,0,1,0,2
11138777,11141809,3032,0,1,0,1
11142206,11142283,77,0,0,1,1
11142284,11142323,39,1,0,0,1
11142324,11143094,770,0,0,1,1
11142381,11143091,710,0,0,1,2
11143092,11143145,53,1,0,0,2
11143095,11143118,23,1,0,0,1
11143119,11143284,165,0,0,1,1
11143146,11143280,134,0,0,1,2
11143281,11144015,734,1,0,0,2
11143285,11143314,29,1,0,0,1
11143315,11143519,204,0,0,1,1
11143520,11143662,142,1,0,0,1
11143663,11143715,52,0,0,1,1
11143716,11143784,68,1,0,0,1
11143785,11143880,95,0,0,1,1
11143881,11143904,23,1,0,0,1
11143905,11144094,189,0,0,1,1
11144016,11144095,79,0,0,1,2
11144095,11144119,24,1,0,0,1
11144096,11144119,23,1,0,0,2
11144120,11144300,180,0,0,1,2
11144120,11144301,181,0,0,1,1
11144301,11144322,21,1,0,0,2
11144302,11144321,19,1,0,0,1
11144322,11144579,257,0,0,1,1
11144323,11144576,253,0,0,1,2
11144577,11144650,73,1,0,0,2
11144580,11144595,15,1,0,0,1
11144596,11144745,149,0,0,1,1
11144651,11144743,92,0,0,1,2
11144744,11144835,91,1,0,0,2
11144746,11144774,28,1,0,0,1
11144775,11145153,378,0,0,1,1
11144836,11144856,20,0,0,1,2
11144857,11146184,1327,1,0,0,2
11145154,11145170,16,1,0,0,1
11145171,11145318,147,0,0,1,1
11145319,11145326,7,1,0,0,1
11145327,11145442,115,0,0,1,1
11145443,11147129,1686,1,0,0,1
11145584,11145850,266,0,1,0,1
11145599,11145827,228,0,1,0,2
11146185,11146219,34,0,0,1,2
11146220,11146696,476,1,0,0,2
11146697,11146718,21,0,0,1,2
11146719,11146812,93,1,0,0,2
11146813,11146849,36,0,0,1,2
11146860,11147143,283,0,1,0,2
11147130,11147176,46,0,0,1,1
11147152,11147152,0,1,0,0,2
11147153,11147378,225,0,0,1,2
11147177,11147702,525,1,0,0,1
11147379,11147404,25,1,0,0,2
11147405,11147509,104,0,0,1,2
11147510,11147801,291,1,0,0,2
11147703,11147740,37,0,0,1,1
11147741,11147772,31,1,0,0,1
11147773,11148041,268,0,0,1,1
11147802,11148043,241,0,0,1,2
11148042,11148046,4,1,0,0,1
11148044,11148095,51,1,0,0,2
11148047,11148248,201,0,0,1,1
11148096,11148245,149,0,0,1,2
11148246,11151517,3271,1,0,0,2
11148249,11150045,1796,1,0,0,1
11149027,11149027,0,0,1,0,1
11149052,11149258,206,0,1,0,1
11149057,11149235,178,0,1,0,2
11149734,11149906,172,0,1,0,1
11149739,11149873,134,0,1,0,2
11150046,11150066,20,0,0,1,1
11150067,11150072,5,1,0,0,1
11150073,11150195,122,0,0,1,1
11150196,11150578,382,1,0,0,1
11150579,11150643,64,0,0,1,1
11150644,11150698,54,1,0,0,1
11150699,11150853,154,0,0,1,1
11150854,11150899,45,1,0,0,1
11150900,11150922,22,0,0,1,1
11150923,11151039,116,1,0,0,1
11151040,11151159,119,0,0,1,1
11151160,11151167,7,1,0,0,1
11151168,11151198,30,0,0,1,1
11151199,11151338,139,1,0,0,1
11151339,11151361,22,0,0,1,1
11151362,11151447,85,1,0,0,1
11151448,11151605,157,0,0,1,1
11151518,11151604,86,0,0,1,2
11151605,11151643,38,1,0,0,2
11151606,11151638,32,1,0,0,1
11151639,11151799,160,0,0,1,1
11151644,11151800,156,0,0,1,2
11151800,11151824,24,1,0,0,1
11151801,11151861,60,1,0,0,2
11151825,11151982,157,0,0,1,1
11151862,11151982,120,0,0,1,2
11151983,11152002,19,1,0,0,1
11151983,11152002,19,1,0,0,2
11152003,11152288,285,0,0,1,2
11152003,11152289,286,0,0,1,1
11152289,11152313,24,1,0,0,2
11152290,11152312,22,1,0,0,1
11152313,11152469,156,0,0,1,1
11152314,11152472,158,0,0,1,2
11152470,11152492,22,1,0,0,1
11152473,11152491,18,1,0,0,2
11152492,11152649,157,0,0,1,2
11152493,11152632,139,0,0,1,1
11152633,11152657,24,1,0,0,1
11152650,11152669,19,1,0,0,2
11152658,11152834,176,0,0,1,1
11152670,11152835,165,0,0,1,2
11152835,11152850,15,1,0,0,1
11152836,11152851,15,1,0,0,2
11152851,11153430,579,0,0,1,1
11152852,11152983,131,0,0,1,2
11152984,11152991,7,1,0,0,2
11152992,11153114,122,0,0,1,2
11153115,11153132,17,1,0,0,2
11153133,11153154,21,0,0,1,2
11153155,11155892,2737,1,0,0,2
11153431,11155882,2451,1,0,0,1
11153932,11153945,13,0,1,0,1
11153957,11155749,1792,0,1,0,2
11153966,11153978,12,0,1,0,1
11154002,11155667,1665,0,1,0,1
11155883,11156135,252,0,0,1,1
11155893,11155928,35,0,0,1,2
11155929,11155939,10,1,0,0,2
11155940,11156133,193,0,0,1,2
11156134,11156179,45,1,0,0,2
11156136,11156177,41,1,0,0,1
11156178,11156700,522,0,0,1,1
11156180,11156687,507,0,0,1,2
11156688,11156727,39,1,0,0,2
11156701,11156728,27,1,0,0,1
11156728,11157701,973,0,0,1,2
11156729,11157705,976,0,0,1,1
11157702,11157978,276,1,0,0,2
11157706,11157994,288,1,0,0,1
11157745,11157886,141,0,1,0,1
11157746,11157897,151,0,1,0,2
11157979,11158216,237,0,0,1,2
11157995,11158216,221,0,0,1,1
11158217,11158253,36,1,0,0,2
11158217,11158255,38,1,0,0,1
11158254,11158446,192,0,0,1,2
11158256,11158449,193,0,0,1,1
11158447,11158514,67,1,0,0,2
11158450,11158528,78,1,0,0,1
11158515,11158657,142,0,0,1,2
11158529,11158661,132,0,0,1,1
11158658,11158672,14,1,0,0,2
11158662,11158680,18,1,0,0,1
11158673,11158823,150,0,0,1,2
11158681,11158876,195,0,0,1,1
11158824,11158833,9,1,0,0,2
11158834,11158882,48,0,0,1,2
11158877,11158896,19,1,0,0,1
11158883,11158897,14,1,0,0,2
11158897,11159069,172,0,0,1,1
11158898,11159071,173,0,0,1,2
11159070,11159089,19,1,0,0,1
11159072,11159088,16,1,0,0,2
11159089,11159366,277,0,0,1,2
11159090,11159363,273,0,0,1,1
11159364,11159381,17,1,0,0,1
11159367,11159420,53,1,0,0,2
11159382,11159641,259,0,0,1,1
11159421,11159639,218,0,0,1,2
11159640,11159659,19,1,0,0,2
11159642,11159658,16,1,0,0,1
11159659,11159908,249,0,0,1,1
11159660,11159906,246,0,0,1,2
11159907,11159926,19,1,0,0,2
11159909,11159927,18,1,0,0,1
11159927,11160084,157,0,0,1,2
11159928,11160144,216,0,0,1,1
11160085,11160162,77,1,0,0,2
11160145,11160158,13,1,0,0,1
11160159,11160351,192,0,0,1,1
11160163,11160201,38,0,0,1,2
11160202,11160519,317,1,0,0,2
11160352,11160357,5,1,0,0,1
11160358,11160424,66,0,0,1,1
11160425,11160470,45,1,0,0,1
11160471,11160544,73,0,0,1,1
11160520,11160550,30,0,0,1,2
11160545,11160567,22,1,0,0,1
11160551,11160565,14,1,0,0,2
11160566,11160695,129,0,0,1,2
11160568,11160693,125,0,0,1,1
11160694,11160717,23,1,0,0,1
11160696,11160718,22,1,0,0,2
11160718,11161014,296,0,0,1,1
11160719,11160984,265,0,0,1,2
11160985,11160989,4,1,0,0,2
11160990,11161211,221,0,0,1,2
11161015,11161032,17,1,0,0,1
11161033,11161213,180,0,0,1,1
11161212,11161242,30,1,0,0,2
11161214,11161231,17,1,0,0,1
11161232,11161875,643,0,0,1,1
11161243,11161267,24,0,0,1,2
11161268,11163569,2301,1,0,0,2
11161876,11161882,6,1,0,0,1
11161883,11162039,156,0,0,1,1
11162040,11162055,15,1,0,0,1
11162056,11162559,503,0,0,1,1
11162560,11162578,18,1,0,0,1
11162579,11162653,74,0,0,1,1
11162654,11163480,826,1,0,0,1
11162799,11162966,167,0,1,0,2
11162799,11162997,198,0,1,0,1
11163481,11163687,206,0,0,1,1
11163570,11163653,83,0,0,1,2
11163654,11163898,244,1,0,0,2
11163688,11163819,131,1,0,0,1
11163820,11164123,303,0,0,1,1
11163899,11163985,86,0,0,1,2
11163986,11164052,66,1,0,0,2
11164053,11164117,64,0,0,1,2
11164118,11164152,34,1,0,0,2
11164124,11164152,28,1,0,0,1
11164153,11164296,143,0,0,1,1
11164153,11164299,146,0,0,1,2
11164297,11164317,20,1,0,0,1
11164300,11164337,37,1,0,0,2
11164318,11165607,1289,0,0,1,1
11164338,11164428,90,0,0,1,2
11164429,11164464,35,1,0,0,2
11164465,11165610,1145,0,0,1,2
11165608,11165619,11,1,0,0,1
11165611,11165620,9,1,0,0,2
11165620,11165766,146,0,0,1,1
11165621,11165763,142,0,0,1,2
11165764,11165835,71,1,0,0,2
11165767,11165779,12,1,0,0,1
11165780,11166088,308,0,0,1,1
11165836,11165903,67,0,0,1,2
11165904,11169646,3742,1,0,0,2
11166089,11166098,9,1,0,0,1
11166099,11166268,169,0,0,1,1
11166269,11169279,3010,1,0,0,1
11166439,11168893,2454,0,1,0,2
11168597,11168883,286,0,1,0,1
11169280,11169300,20,0,0,1,1
11169301,11169702,401,1,0,0,1
11169647,11169685,38,0,0,1,2
11169686,11169727,41,1,0,0,2
11169703,11169833,130,0,0,1,1
11169728,11169833,105,0,0,1,2
11169834,11170011,177,1,0,0,2
11169834,11170027,193,1,0,0,1
11170012,11170202,190,0,0,1,2
11170028,11170204,176,0,0,1,1
11170203,11170281,78,1,0,0,2
11170205,11170255,50,1,0,0,1
11170256,11170360,104,0,0,1,1
11170282,11170358,76,0,0,1,2
11170359,11170394,35,1,0,0,2
11170361,11170393,32,1,0,0,1
11170394,11170568,174,0,0,1,1
11170395,11170567,172,0,0,1,2
11170568,11170587,19,1,0,0,2
11170569,11170598,29,1,0,0,1
11170588,11171182,594,0,0,1,2
11170599,11171182,583,0,0,1,1
11171183,11171199,16,1,0,0,1
11171183,11171201,18,1,0,0,2
11171200,11171331,131,0,0,1,1
11171202,11171337,135,0,0,1,2
11171332,11171349,17,1,0,0,1
11171338,11171348,10,1,0,0,2
11171349,11172062,713,0,0,1,2
11171350,11171908,558,0,0,1,1
11171909,11171915,6,1,0,0,1
11171916,11172037,121,0,0,1,1
11172038,11172042,4,1,0,0,1
11172043,11172500,457,0,0,1,1
11172063,11172222,159,1,0,0,2
11172223,11172259,36,0,0,1,2
11172260,11172279,19,1,0,0,2
11172280,11172496,216,0,0,1,2
11172497,11172564,67,1,0,0,2
11172501,11172565,64,1,0,0,1
11172565,11172674,109,0,0,1,2
11172566,11172675,109,0,0,1,1
11172675,11172715,40,1,0,0,2
11172676,11172707,31,1,0,0,1
11172708,11172860,152,0,0,1,1
11172716,11173280,564,0,0,1,2
11172861,11172865,4,1,0,0,1
11172866,11173294,428,0,0,1,1
11173281,11173298,17,1,0,0,2
11173295,11173309,14,1,0,0,1
11173299,11173407,108,0,0,1,2
11173310,11173557,247,0,0,1,1
11173408,11173416,8,1,0,0,2
11173417,11173528,111,0,0,1,2
11173529,11175992,2463,1,0,0,2
11173558,11173820,262,1,0,0,1
11173821,11173857,36,0,0,1,1
11173858,11174290,432,1,0,0,1
11174291,11174323,32,0,0,1,1
11174324,11174589,265,1,0,0,1
11174590,11174648,58,0,0,1,1
11174649,11174832,183,1,0,0,1
11174833,11174853,20,0,0,1,1
11174854,11175049,195,1,0,0,1
11175050,11175160,110,0,0,1,1
11175161,11175301,140,1,0,0,1
11175302,11175371,69,0,0,1,1
11175372,11175426,54,1,0,0,1
11175427,11175461,34,0,0,1,1
11175462,11175513,51,1,0,0,1
11175514,11175536,22,0,0,1,1
11175537,11175629,92,1,0,0,1
11175630,11175671,41,0,0,1,1
11175672,11175824,152,1,0,0,1
11175825,11175848,23,0,0,1,1
11175849,11175856,7,1,0,0,1
11175857,11176037,180,0,0,1,1
11175993,11176042,49,0,0,1,2
11176038,11176144,106,1,0,0,1
11176043,11177084,1041,1,0,0,2
11176145,11176254,109,0,0,1,1
11176255,11176611,356,1,0,0,1
11176612,11176679,67,0,0,1,1
11176680,11176684,4,1,0,0,1
11176685,11176723,38,0,0,1,1
11176724,11176775,51,1,0,0,1
11176776,11176884,108,0,0,1,1
11176885,11176911,26,1,0,0,1
11176912,11177217,305,0,0,1,1
11177085,11177512,427,0,0,1,2
11177218,11177236,18,1,0,0,1
11177237,11177490,253,0,0,1,1
11177491,11177517,26,1,0,0,1
11177513,11177517,4,1,0,0,2
11177518,11177678,160,0,0,1,1
11177518,11177862,344,0,0,1,2
11177679,11177685,6,1,0,0,1
11177686,11177868,182,0,0,1,1
11177863,11177921,58,1,0,0,2
11177869,11177878,9,1,0,0,1
11177879,11178405,526,0,0,1,1
11177922,11177946,24,0,0,1,2
11177947,11179664,1717,1,0,0,2
11178406,11178412,6,1,0,0,1
11178413,11178519,106,0,0,1,1
11178520,11178601,81,1,0,0,1
11178554,11178598,44,0,1,0,2
11178602,11178720,118,0,0,1,1
11178721,11178758,37,1,0,0,1
11178759,11178788,29,0,0,1,1
11178789,11178917,128,1,0,0,1
11178918,11179098,180,0,0,1,1
11179099,11180012,913,1,0,0,1
11179161,11179432,271,0,1,0,2
11179171,11179430,259,0,1,0,1
11179457,11179563,106,0,1,0,2
11179665,11179706,41,0,0,1,2
11179707,11183782,4075,1,0,0,2
11180013,11180156,143,0,0,1,1
11180157,11180559,402,1,0,0,1
11180305,11180307,2,0,1,0,2
11180463,11183462,2999,0,1,0,2
11180560,11180602,42,0,0,1,1
11180603,11183266,2663,1,0,0,1
11181098,11181288,190,0,1,0,1
11181874,11182401,527,0,1,0,1
11182730,11183069,339,0,1,0,1
11183137,11183185,48,0,1,0,1
11183267,11183368,101,0,0,1,1
11183369,11183433,64,1,0,0,1
11183434,11183563,129,0,0,1,1
11183564,11183592,28,1,0,0,1
11183593,11183719,126,0,0,1,1
11183720,11183750,30,1,0,0,1
11183751,11183868,117,0,0,1,1
11183783,11183809,26,0,0,1,2
11183810,11184908,1098,1,0,0,2
11183869,11183881,12,1,0,0,1
11183882,11184289,407,0,0,1,1
11184290,11184302,12,1,0,0,1
11184303,11184488,185,0,0,1,1
11184489,11185121,632,1,0,0,1
11184519,11184738,219,0,1,0,2
11184541,11184734,193,0,1,0,1
11184762,11184782,20,0,1,0,1
11184780,11184815,35,0,1,0,2
11184909,11184953,44,0,0,1,2
11184954,11191765,6811,1,0,0,2
11185065,11185070,5,0,1,0,2
11185122,11185218,96,0,0,1,1
11185219,11185241,22,1,0,0,1
11185242,11185362,120,0,0,1,1
11185363,11185369,6,1,0,0,1
11185370,11185604,234,0,0,1,1
11185605,11185625,20,1,0,0,1
11185626,11186061,435,0,0,1,1
11186062,11186075,13,1,0,0,1
11186076,11186161,85,0,0,1,1
11186162,11186199,37,1,0,0,1
11186200,11186374,174,0,0,1,1
11186375,11186411,36,1,0,0,1
11186412,11186452,40,0,0,1,1
11186453,11190659,4206,1,0,0,1
11186515,11190581,4066,0,1,0,2
11186706,11186971,265,0,1,0,1
11187265,11187365,100,0,1,0,1
11187388,11187482,94,0,1,0,1
11187602,11187861,259,0,1,0,1
11188453,11188479,26,0,1,0,1
11188751,11189999,1248,0,1,0,1
11190660,11190699,39,0,0,1,1
11190700,11191791,1091,1,0,0,1
11190877,11191519,642,0,1,0,2
11190924,11191223,299,0,1,0,1
11191766,11191887,121,0,0,1,2
11191792,11191888,96,0,0,1,1
11191888,11191915,27,1,0,0,2
11191889,11191923,34,1,0,0,1
11191916,11192046,130,0,0,1,2
11191924,11192048,124,0,0,1,1
11192047,11192075,28,1,0,0,2
11192049,11192075,26,1,0,0,1
11192076,11192289,213,0,0,1,2
11192076,11192294,218,0,0,1,1
11192290,11192310,20,1,0,0,2
11192295,11192310,15,1,0,0,1
11192311,11192485,174,0,0,1,2
11192311,11192755,444,0,0,1,1
11192486,11192497,11,1,0,0,2
11192498,11192817,319,0,0,1,2
11192756,11192766,10,1,0,0,1
11192767,11192834,67,0,0,1,1
11192818,11192834,16,1,0,0,2
11192835,11192862,27,1,0,0,1
11192835,11193035,200,0,0,1,2
11192863,11192910,47,0,0,1,1
11192911,11193775,864,1,0,0,1
11193036,11196586,3550,1,0,0,2
11193776,11193844,68,0,0,1,1
11193845,11194158,313,1,0,0,1
11194159,11194215,56,0,0,1,1
11194216,11194282,66,1,0,0,1
11194283,11194473,190,0,0,1,1
11194474,11194720,246,1,0,0,1
11194721,11194751,30,0,0,1,1
11194752,11194988,236,1,0,0,1
11194989,11195016,27,0,0,1,1
11195017,11195036,19,1,0,0,1
11195037,11195123,86,0,0,1,1
11195124,11195361,237,1,0,0,1
11195362,11195477,115,0,0,1,1
11195478,11195782,304,1,0,0,1
11195783,11195803,20,0,0,1,1
11195804,11196486,682,1,0,0,1
11196487,11196547,60,0,0,1,1
11196548,11196930,382,1,0,0,1
11196587,11196609,22,0,0,1,2
11196610,11196618,8,1,0,0,2
11196619,11196644,25,0,0,1,2
11196645,11196682,37,1,0,0,2
11196683,11196721,38,0,0,1,2
11196722,11196734,12,1,0,0,2
11196735,11196872,137,0,0,1,2
11196873,11197192,319,1,0,0,2
11196931,11196965,34,0,0,1,1
11196966,11196982,16,1,0,0,1
11196983,11197140,157,0,0,1,1
11197141,11197391,250,1,0,0,1
11197193,11197219,26,0,0,1,2
11197220,11197323,103,1,0,0,2
11197324,11197345,21,0,0,1,2
11197346,11197364,18,1,0,0,2
11197365,11197429,64,0,0,1,2
11197392,11197428,36,0,0,1,1
11197429,11197487,58,1,0,0,1
11197430,11197536,106,1,0,0,2
11197488,11197545,57,0,0,1,1
11197537,11197559,22,0,0,1,2
11197546,11197651,105,1,0,0,1
11197560,11198656,1096,1,0,0,2
11197652,11197747,95,0,0,1,1
11197748,11198406,658,1,0,0,1
11198407,11198434,27,0,0,1,1
11198435,11198491,56,1,0,0,1
11198492,11198538,46,0,0,1,1
11198539,11198552,13,1,0,0,1
11198553,11198628,75,0,0,1,1
11198629,11198670,41,1,0,0,1
11198657,11198862,205,0,0,1,2
11198671,11198860,189,0,0,1,1
11198861,11198887,26,1,0,0,1
11198863,11198886,23,1,0,0,2
11198887,11199023,136,0,0,1,2
11198888,11199026,138,0,0,1,1
11199024,11199048,24,1,0,0,2
11199027,11199047,20,1,0,0,1
11199048,11199208,160,0,0,1,1
11199049,11199207,158,0,0,1,2
11199208,11199231,23,1,0,0,2
11199209,11199231,22,1,0,0,1
11199232,11199442,210,0,0,1,2
11199232,11199443,211,0,0,1,1
11199443,11199496,53,1,0,0,2
11199444,11199492,48,1,0,0,1
11199493,11199578,85,0,0,1,1
11199497,11199580,83,0,0,1,2
11199579,11199620,41,1,0,0,1
11199581,11199623,42,1,0,0,2
11199621,11199690,69,0,0,1,1
11199624,11200466,842,0,0,1,2
11199691,11199702,11,1,0,0,1
11199703,11199833,130,0,0,1,1
11199834,11199842,8,1,0,0,1
11199843,11201435,1592,0,0,1,1
11200467,11200687,220,1,0,0,2
11200688,11200723,35,0,0,1,2
11200724,11207344,6620,1,0,0,2
11201331,11201351,20,0,1,0,2
11201436,11203786,2350,1,0,0,1
11201476,11201856,380,0,1,0,2
11201549,11201832,283,0,1,0,1
11202169,11202202,33,0,1,0,2
11202247,11202247,0,0,1,0,2
11202272,11202292,20,0,1,0,2
11202319,11203594,1275,0,1,0,2
11202632,11203126,494,0,1,0,1
11203229,11203501,272,0,1,0,1
11203694,11203696,2,0,1,0,2
11203787,11203911,124,0,0,1,1
11203912,11203938,26,1,0,0,1
11203939,11204045,106,0,0,1,1
11204046,11204256,210,1,0,0,1
11204257,11204283,26,0,0,1,1
11204284,11204491,207,1,0,0,1
11204492,11204515,23,0,0,1,1
11204516,11204635,119,1,0,0,1
11204636,11204662,26,0,0,1,1
11204663,11204960,297,1,0,0,1
11204961,11204994,33,0,0,1,1
11204991,11205001,10,0,1,0,2
11204995,11207723,2728,1,0,0,1
11205029,11205041,12,0,1,0,2
11205074,11205110,36,0,1,0,2
11205210,11205316,106,0,1,0,2
11205379,11205387,8,0,1,0,2
11205521,11206975,1454,0,1,0,2
11206729,11206955,226,0,1,0,1
11207174,11207265,91,0,1,0,2
11207345,11207402,57,0,0,1,2
11207403,11207903,500,1,0,0,2
11207724,11207752,28,0,0,1,1
11207753,11209983,2230,1,0,0,1
11207904,11207948,44,0,0,1,2
11207959,11208852,893,0,1,0,2
11208421,11208654,233,0,1,0,1
11208862,11210137,1275,1,0,0,2
11208967,11209187,220,0,1,0,2
11209222,11209649,427,0,1,0,2
11209420,11209589,169,0,1,0,1
11209690,11209709,19,0,1,0,2
11209984,11210015,31,0,0,1,1
11210016,11210673,657,1,0,0,1
11210138,11210190,52,0,0,1,2
11210191,11210674,483,1,0,0,2
11210251,11210432,181,0,1,0,2
11210251,11210446,195,0,1,0,1
11210674,11210820,146,0,0,1,1
11210675,11210818,143,0,0,1,2
11210819,11210861,42,1,0,0,2
11210821,11210870,49,1,0,0,1
11210862,11211040,178,0,0,1,2
11210871,11211041,170,0,0,1,1
11211041,11211073,32,1,0,0,2
11211042,11211081,39,1,0,0,1
11211074,11211201,127,0,0,1,2
11211082,11211199,117,0,0,1,1
11211200,11211221,21,1,0,0,1
11211202,11211221,19,1,0,0,2
11211222,11211336,114,0,0,1,2
11211222,11211337,115,0,0,1,1
11211337,11211360,23,1,0,0,2
11211338,11211360,22,1,0,0,1
11211361,11211804,443,0,0,1,1
11211361,11211805,444,0,0,1,2
11211805,11211819,14,1,0,0,1
11211806,11211811,5,1,0,0,2
11211812,11212171,359,0,0,1,2
11211820,11212331,511,0,0,1,1
11212172,11212190,18,1,0,0,2
11212191,11212513,322,0,0,1,2
11212332,11212348,16,1,0,0,1
11212349,11212519,170,0,0,1,1
11212514,11212545,31,1,0,0,2
11212520,11212543,23,1,0,0,1
11212544,11212985,441,0,0,1,1
11212546,11212638,92,0,0,1,2
11212639,11212645,6,1,0,0,2
11212646,11212682,36,0,0,1,2
11212683,11212695,12,1,0,0,2
11212696,11212852,156,0,0,1,2
11212853,11212865,12,1,0,0,2
11212866,11212983,117,0,0,1,2
11212984,11212990,6,1,0,0,2
11212986,11213004,18,1,0,0,1
11212991,11213109,118,0,0,1,2
11213005,11213115,110,0,0,1,1
11213110,11213133,23,1,0,0,2
11213116,11213121,5,1,0,0,1
11213122,11213581,459,0,0,1,1
11213134,11213328,194,0,0,1,2
11213329,11213346,17,1,0,0,2
11213347,11213404,57,0,0,1,2
11213405,11214269,864,1,0,0,2
11213582,11213667,85,1,0,0,1
11213668,11213709,41,0,0,1,1
11213710,11213725,15,1,0,0,1
11213726,11213905,179,0,0,1,1
11213906,11213962,56,1,0,0,1
11213963,11214099,136,0,0,1,1
11214100,11214230,130,1,0,0,1
11214231,11214268,37,0,0,1,1
11214269,11214275,6,1,0,0,1
11214270,11214409,139,0,0,1,2
11214276,11214583,307,0,0,1,1
11214410,11214414,4,1,0,0,2
11214415,11214587,172,0,0,1,2
11214584,11214641,57,1,0,0,1
11214588,11214611,23,1,0,0,2
11214612,11214748,136,0,0,1,2
11214642,11214921,279,0,0,1,1
11214749,11214844,95,1,0,0,2
11214845,11214871,26,0,0,1,2
11214872,11214897,25,1,0,0,2
11214898,11214974,76,0,0,1,2
11214922,11214926,4,1,0,0,1
11214927,11215247,320,0,0,1,1
11214975,11214981,6,1,0,0,2
11214982,11215017,35,0,0,1,2
11215018,11216222,1204,1,0,0,2
11215248,11215315,67,1,0,0,1
11215316,11215404,88,0,0,1,1
11215405,11215440,35,1,0,0,1
11215441,11215529,88,0,0,1,1
11215530,11215782,252,1,0,0,1
11215783,11215883,100,0,0,1,1
11215884,11224656,8772,1,0,0,1
11216223,11216248,25,0,0,1,2
11216249,11223321,7072,1,0,0,2
11216862,11216884,22,0,1,0,2
11216928,11217365,437,0,1,0,1
11216930,11217675,745,0,1,0,2
11217766,11217920,154,0,1,0,2
11218204,11218204,0,0,1,0,2
11218226,11220650,2424,0,1,0,2
11218286,11218301,15,0,1,0,1
11219118,11220505,1387,0,1,0,1
11220904,11223271,2367,0,1,0,2
11221608,11222951,1343,0,1,0,1
11223322,11223396,74,0,0,1,2
11223407,11223412,5,0,1,0,2
11223422,11223780,358,1,0,0,2
11223449,11223454,5,0,1,0,2
11223484,11223490,6,0,1,0,2
11223781,11223823,42,0,0,1,2
11223834,11224004,170,0,1,0,2
11224014,11224110,96,1,0,0,2
11224111,11224138,27,0,0,1,2
11224139,11225033,894,1,0,0,2
11224295,11224317,22,0,1,0,2
11224657,11224712,55,0,0,1,1
11224713,11224869,156,1,0,0,1
11224870,11224901,31,0,0,1,1
11224902,11224989,87,1,0,0,1
11224990,11225086,96,0,0,1,1
11225034,11225093,59,0,0,1,2
11225087,11225143,56,1,0,0,1
11225094,11228022,2928,1,0,0,2
11225144,11225229,85,0,0,1,1
11225230,11225307,77,1,0,0,1
11225308,11225382,74,0,0,1,1
11225383,11225509,126,1,0,0,1
11225510,11225535,25,0,0,1,1
11225536,11225850,314,1,0,0,1
11225851,11225895,44,0,0,1,1
11225896,11225912,16,1,0,0,1
11225913,11225948,35,0,0,1,1
11225949,11226311,362,1,0,0,1
11226312,11226340,28,0,0,1,1
11226341,11228100,1759,1,0,0,1
11227618,11227832,214,0,1,0,2
11227631,11227831,200,0,1,0,1
11228023,11228075,52,0,0,1,2
11228076,11228092,16,1,0,0,2
11228093,11228374,281,0,0,1,2
11228101,11228138,37,0,0,1,1
11228139,11228147,8,1,0,0,1
11228148,11228598,450,0,0,1,1
11228375,11228381,6,1,0,0,2
11228382,11228628,246,0,0,1,2
11228599,11228605,6,1,0,0,1
11228606,11228654,48,0,0,1,1
11228629,11228639,10,1,0,0,2
11228640,11228675,35,0,0,1,2
11228655,11228659,4,1,0,0,1
11228660,11228851,191,0,0,1,1
11228676,11228691,15,1,0,0,2
11228692,11228884,192,0,0,1,2
11228852,11228856,4,1,0,0,1
11228857,11228901,44,0,0,1,1
11228885,11229761,876,1,0,0,2
11228902,11229688,786,1,0,0,1
11229015,11229035,20,0,1,0,2
11229074,11229259,185,0,1,0,1
11229080,11229274,194,0,1,0,2
11229640,11229655,15,0,1,0,2
11229689,11229718,29,0,0,1,1
11229719,11229761,42,1,0,0,1
