start,end,duration,saccade,blink,fixation,eye
23054048,23054083,35,0,0,1,1
23054048,23054087,39,0,0,1,2
23054084,23054988,904,1,0,0,1
23054088,23054988,900,1,0,0,2
23054125,23054977,852,0,1,0,1
23054125,23054977,852,0,1,0,2
23054989,23055086,97,0,0,1,2
23054989,23055136,147,0,0,1,1
23055087,23055091,4,1,0,0,2
23055092,23055141,49,0,0,1,2
23055137,23055207,70,1,0,0,1
23055142,23055208,66,1,0,0,2
23055208,23055297,89,0,0,1,1
23055209,23055297,88,0,0,1,2
23055298,23055341,43,1,0,0,2
23055298,23055342,44,1,0,0,1
23055342,23055569,227,0,0,1,2
23055343,23055570,227,0,0,1,1
23055570,23055600,30,1,0,0,2
23055571,23055602,31,1,0,0,1
23055601,23055828,227,0,0,1,2
23055603,23055829,226,0,0,1,1
23055829,23056129,300,1,0,0,2
23055830,23056056,226,1,0,0,1
23055844,23056028,184,0,1,0,2
23055847,23056003,156,0,1,0,1
23056057,23056095,38,0,0,1,1
23056096,23056133,37,1,0,0,1
23056130,23056437,307,0,0,1,2
23056134,23056437,303,0,0,1,1
23056438,23056461,23,1,0,0,2
23056438,23056467,29,1,0,0,1
23056462,23056746,284,0,0,1,2
23056468,23056755,287,0,0,1,1
23056747,23057208,461,1,0,0,2
23056756,23057077,321,1,0,0,1
23056767,23057032,265,0,1,0,2
23056780,23056998,218,0,1,0,1
23057053,23057055,2,0,1,0,2
23057078,23057379,301,0,0,1,1
23057132,23057145,13,0,1,0,2
23057209,23057381,172,0,0,1,2
23057380,23057401,21,1,0,0,1
23057382,23057398,16,1,0,0,2
23057399,23057662,263,0,0,1,2
23057402,23057675,273,0,0,1,1
23057663,23058003,340,1,0,0,2
23057676,23057918,242,1,0,0,1
23057684,23057876,192,0,1,0,2
23057694,23057870,176,0,1,0,1
23057919,23057942,23,0,0,1,1
23057943,23057980,37,1,0,0,1
23057981,23058899,918,0,0,1,1
23058004,23058880,876,0,0,1,2
23058881,23060039,1158,1,0,0,2
23058900,23059924,1024,1,0,0,1
23058915,23059996,1081,0,1,0,2
23058953,23059899,946,0,1,0,1
23059925,23059971,46,0,0,1,1
23059972,23060013,41,1,0,0,1
23060014,23060313,299,0,0,1,1
23060040,23060316,276,0,0,1,2
23060314,23060346,32,1,0,0,1
23060317,23060345,28,1,0,0,2
23060346,23060540,194,0,0,1,2
23060347,23060538,191,0,0,1,1
23060539,23060568,29,1,0,0,1
23060541,23060567,26,1,0,0,2
23060568,23060811,243,0,0,1,2
23060569,23060831,262,0,0,1,1
23060812,23061424,612,1,0,0,2
23060830,23061085,255,0,1,0,2
23060832,23061189,357,1,0,0,1
23060854,23061042,188,0,1,0,1
23061190,23062624,1434,0,0,1,1
23061425,23062623,1198,0,0,1,2
23062624,23062641,17,1,0,0,2
23062625,23062640,15,1,0,0,1
23062641,23063420,779,0,0,1,1
23062642,23063420,778,0,0,1,2
23063421,23063470,49,1,0,0,1
23063421,23063472,51,1,0,0,2
23063471,23063774,303,0,0,1,1
23063473,23063773,300,0,0,1,2
23063774,23063812,38,1,0,0,2
23063775,23063813,38,1,0,0,1
23063813,23063973,160,0,0,1,2
23063814,23063972,158,0,0,1,1
23063973,23064004,31,1,0,0,1
23063974,23064003,29,1,0,0,2
23064004,23066089,2085,0,0,1,2
23064005,23066643,2638,0,0,1,1
23066090,23066179,89,1,0,0,2
23066180,23066206,26,0,0,1,2
23066207,23066683,476,1,0,0,2
23066644,23066663,19,1,0,0,1
23066664,23066886,222,0,0,1,1
23066684,23066720,36,0,0,1,2
23066721,23066982,261,1,0,0,2
23066887,23066974,87,1,0,0,1
23066975,23067088,113,0,0,1,1
23066983,23067090,107,0,0,1,2
23067089,23067125,36,1,0,0,1
23067091,23067133,42,1,0,0,2
23067126,23067218,92,0,0,1,1
23067134,23067219,85,0,0,1,2
23067219,23067255,36,1,0,0,1
23067220,23067255,35,1,0,0,2
23067256,23067461,205,0,0,1,1
23067256,23067462,206,0,0,1,2
23067462,23067494,32,1,0,0,1
23067463,23067493,30,1,0,0,2
23067494,23067796,302,0,0,1,2
23067495,23067793,298,0,0,1,1
23067794,23067825,31,1,0,0,1
23067797,23067824,27,1,0,0,2
23067825,23069419,1594,0,0,1,2
23067826,23069418,1592,0,0,1,1
23069419,23069506,87,1,0,0,1
23069420,23069506,86,1,0,0,2
23069507,23069650,143,0,0,1,2
23069507,23069651,144,0,0,1,1
23069651,23069709,58,1,0,0,2
23069652,23069707,55,1,0,0,1
23069708,23069784,76,0,0,1,1
23069710,23069785,75,0,0,1,2
23069785,23069835,50,1,0,0,1
23069786,23069817,31,1,0,0,2
23069818,23070078,260,0,0,1,2
23069836,23070081,245,0,0,1,1
23070079,23070106,27,1,0,0,2
23070082,23070107,25,1,0,0,1
23070107,23071586,1479,0,0,1,2
23070108,23071591,1483,0,0,1,1
23071587,23071837,250,1,0,0,2
23071592,23071805,213,1,0,0,1
23071612,23071775,163,0,1,0,2
23071623,23071758,135,0,1,0,1
23071806,23072091,285,0,0,1,1
23071838,23072090,252,0,0,1,2
23072091,23072143,52,1,0,0,2
23072092,23072169,77,1,0,0,1
23072144,23072246,102,0,0,1,2
23072170,23072245,75,0,0,1,1
23072246,23072287,41,1,0,0,1
23072247,23072279,32,1,0,0,2
23072280,23074683,2403,0,0,1,2
23072288,23074681,2393,0,0,1,1
23074682,23074783,101,1,0,0,1
23074684,23074877,193,1,0,0,2
23074784,23074809,25,0,0,1,1
23074810,23074867,57,1,0,0,1
23074868,23074915,47,0,0,1,1
23074878,23074916,38,0,0,1,2
23074916,23074965,49,1,0,0,1
23074917,23074959,42,1,0,0,2
23074960,23075082,122,0,0,1,2
23074966,23075083,117,0,0,1,1
23075083,23075120,37,1,0,0,2
23075084,23075112,28,1,0,0,1
23075113,23075269,156,0,0,1,1
23075121,23075264,143,0,0,1,2
23075265,23075285,20,1,0,0,2
23075270,23075285,15,1,0,0,1
23075286,23077107,1821,0,0,1,1
23075286,23077107,1821,0,0,1,2
23077108,23077185,77,1,0,0,1
23077108,23077186,78,1,0,0,2
23077186,23077293,107,0,0,1,1
23077187,23077294,107,0,0,1,2
23077294,23077361,67,1,0,0,1
23077295,23077360,65,1,0,0,2
23077361,23077433,72,0,0,1,2
23077362,23077435,73,0,0,1,1
23077434,23077497,63,1,0,0,2
23077436,23077498,62,1,0,0,1
23077498,23077592,94,0,0,1,2
23077499,23077593,94,0,0,1,1
23077593,23077636,43,1,0,0,2
23077594,23077637,43,1,0,0,1
23077637,23077792,155,0,0,1,2
23077638,23077792,154,0,0,1,1
23077793,23077826,33,1,0,0,1
23077793,23077826,33,1,0,0,2
23077827,23079693,1866,0,0,1,1
23077827,23079696,1869,0,0,1,2
23079694,23079773,79,1,0,0,1
23079697,23079774,77,1,0,0,2
23079774,23079966,192,0,0,1,1
23079775,23079969,194,0,0,1,2
23079967,23080006,39,1,0,0,1
23079970,23080027,57,1,0,0,2
23080007,23080125,118,0,0,1,1
23080028,23080125,97,0,0,1,2
23080126,23080220,94,1,0,0,2
23080126,23080221,95,1,0,0,1
23080221,23080301,80,0,0,1,2
23080222,23080303,81,0,0,1,1
23080302,23080348,46,1,0,0,2
23080304,23080361,57,1,0,0,1
23080349,23080439,90,0,0,1,2
23080362,23080437,75,0,0,1,1
23080438,23080478,40,1,0,0,1
23080440,23080477,37,1,0,0,2
23080478,23081780,1302,0,0,1,2
23080479,23081780,1301,0,0,1,1
23081781,23081813,32,1,0,0,1
23081781,23081814,33,1,0,0,2
23081814,23082202,388,0,0,1,1
23081815,23082202,387,0,0,1,2
23082203,23082292,89,1,0,0,2
23082203,23082300,97,1,0,0,1
23082293,23082658,365,0,0,1,2
23082301,23082658,357,0,0,1,1
23082659,23082725,66,1,0,0,1
23082659,23082726,67,1,0,0,2
23082726,23082798,72,0,0,1,1
23082727,23082796,69,0,0,1,2
23082797,23082842,45,1,0,0,2
23082799,23082843,44,1,0,0,1
23082843,23084653,1810,0,0,1,2
23082844,23084663,1819,0,0,1,1
23084654,23084980,326,1,0,0,2
23084664,23084984,320,1,0,0,1
23084689,23084881,192,0,1,0,2
23084705,23084860,155,0,1,0,1
23084888,23084889,1,0,1,0,1
23084917,23084943,26,0,1,0,2
23084932,23084932,0,0,1,0,1
23084981,23085073,92,0,0,1,2
23084985,23085064,79,0,0,1,1
23085065,23085231,166,1,0,0,1
23085074,23085254,180,1,0,0,2
23085095,23085203,108,0,1,0,2
23085099,23085187,88,0,1,0,1
23085232,23085304,72,0,0,1,1
23085255,23085304,49,0,0,1,2
23085305,23085371,66,1,0,0,2
23085305,23085374,69,1,0,0,1
23085372,23085456,84,0,0,1,2
23085375,23085456,81,0,0,1,1
23085457,23085488,31,1,0,0,2
23085457,23085495,38,1,0,0,1
23085489,23087947,2458,0,0,1,2
23085496,23087949,2453,0,0,1,1
23087948,23088054,106,1,0,0,2
23087950,23088061,111,1,0,0,1
23088055,23088155,100,0,0,1,2
23088062,23088156,94,0,0,1,1
23088156,23088198,42,1,0,0,2
23088157,23088200,43,1,0,0,1
23088199,23088411,212,0,0,1,2
23088201,23088411,210,0,0,1,1
23088412,23088511,99,1,0,0,1
23088412,23088511,99,1,0,0,2
23088512,23088580,68,0,0,1,2
23088512,23088581,69,0,0,1,1
23088581,23088633,52,1,0,0,2
23088582,23088630,48,1,0,0,1
23088603,23088612,9,0,1,0,1
23088631,23088703,72,0,0,1,1
23088634,23088702,68,0,0,1,2
23088703,23088735,32,1,0,0,2
23088704,23088736,32,1,0,0,1
23088736,23088905,169,0,0,1,2
23088737,23088906,169,0,0,1,1
23088906,23088935,29,1,0,0,2
23088907,23088935,28,1,0,0,1
23088936,23089120,184,0,0,1,2
23088936,23089127,191,0,0,1,1
23089121,23089150,29,1,0,0,2
23089128,23089139,11,1,0,0,1
23089140,23090514,1374,0,0,1,1
23089151,23090517,1366,0,0,1,2
23090515,23090654,139,1,0,0,1
23090518,23090669,151,1,0,0,2
23090655,23090857,202,0,0,1,1
23090670,23090857,187,0,0,1,2
23090858,23090938,80,1,0,0,1
23090858,23090940,82,1,0,0,2
23090939,23091100,161,0,0,1,1
23090941,23091100,159,0,0,1,2
23091101,23091181,80,1,0,0,1
23091101,23091182,81,1,0,0,2
23091182,23091336,154,0,0,1,1
23091183,23091339,156,0,0,1,2
23091337,23091375,38,1,0,0,1
23091340,23091381,41,1,0,0,2
23091376,23091945,569,0,0,1,1
23091382,23091946,564,0,0,1,2
23091946,23091980,34,1,0,0,1
23091947,23091980,33,1,0,0,2
23091981,23093193,1212,0,0,1,1
23091981,23093194,1213,0,0,1,2
23093194,23093292,98,1,0,0,1
23093195,23093292,97,1,0,0,2
23093293,23093556,263,0,0,1,1
23093293,23093557,264,0,0,1,2
23093557,23093626,69,1,0,0,1
23093558,23093625,67,1,0,0,2
23093626,23093703,77,0,0,1,2
23093627,23093703,76,0,0,1,1
23093704,23093747,43,1,0,0,2
23093704,23093748,44,1,0,0,1
23093748,23093814,66,0,0,1,2
23093749,23093813,64,0,0,1,1
23093814,23093849,35,1,0,0,1
23093815,23093848,33,1,0,0,2
23093849,23093965,116,0,0,1,2
23093850,23093965,115,0,0,1,1
23093966,23093992,26,1,0,0,1
23093966,23093993,27,1,0,0,2
23093993,23095673,1680,0,0,1,1
23093994,23095673,1679,0,0,1,2
23095674,23095682,8,1,0,0,1
23095674,23095688,14,1,0,0,2
23095683,23096079,396,0,0,1,1
23095689,23096078,389,0,0,1,2
23096079,23096132,53,1,0,0,2
23096080,23096132,52,1,0,0,1
23096133,23096197,64,0,0,1,1
23096133,23096199,66,0,0,1,2
23096198,23096248,50,1,0,0,1
23096200,23096247,47,1,0,0,2
23096248,23096343,95,0,0,1,2
23096249,23096342,93,0,0,1,1
23096343,23096375,32,1,0,0,1
23096344,23096375,31,1,0,0,2
23096376,23097979,1603,0,0,1,2
23096376,23097980,1604,0,0,1,1
23097980,23098087,107,1,0,0,2
23097981,23098078,97,1,0,0,1
23098079,23098114,35,0,0,1,1
23098088,23098116,28,0,0,1,2
23098115,23098172,57,1,0,0,1
23098117,23098174,57,1,0,0,2
23098173,23098286,113,0,0,1,1
23098175,23098284,109,0,0,1,2
23098285,23098332,47,1,0,0,2
23098287,23098330,43,1,0,0,1
23098331,23098649,318,0,0,1,1
23098333,23098649,316,0,0,1,2
23098650,23098684,34,1,0,0,1
23098650,23098691,41,1,0,0,2
23098685,23099720,1035,0,0,1,1
23098692,23099720,1028,0,0,1,2
23099721,23099806,85,1,0,0,2
23099721,23099813,92,1,0,0,1
23099807,23100166,359,0,0,1,2
23099814,23100166,352,0,0,1,1
23100167,23100251,84,1,0,0,1
23100167,23100253,86,1,0,0,2
23100252,23100336,84,0,0,1,1
23100254,23100338,84,0,0,1,2
23100337,23100382,45,1,0,0,1
23100339,23100380,41,1,0,0,2
23100381,23100557,176,0,0,1,2
23100383,23100558,175,0,0,1,1
23100558,23100589,31,1,0,0,2
23100559,23100590,31,1,0,0,1
23100590,23100832,242,0,0,1,2
23100591,23100831,240,0,0,1,1
23100832,23100865,33,1,0,0,1
23100833,23100863,30,1,0,0,2
23100864,23101830,966,0,0,1,2
23100866,23101830,964,0,0,1,1
23101831,23101927,96,1,0,0,1
23101831,23101939,108,1,0,0,2
23101928,23102291,363,0,0,1,1
23101940,23102289,349,0,0,1,2
23102290,23102368,78,1,0,0,2
23102292,23102374,82,1,0,0,1
23102369,23102456,87,0,0,1,2
23102375,23102459,84,0,0,1,1
23102457,23102502,45,1,0,0,2
23102460,23102504,44,1,0,0,1
23102503,23102690,187,0,0,1,2
23102505,23102689,184,0,0,1,1
23102690,23102722,32,1,0,0,1
23102691,23102722,31,1,0,0,2
23102723,23103924,1201,0,0,1,2
23102723,23103925,1202,0,0,1,1
23103925,23104168,243,1,0,0,2
23103926,23104165,239,1,0,0,1
23103991,23104069,78,0,1,0,2
23103999,23104057,58,0,1,0,1
23104166,23104383,217,0,0,1,1
23104169,23104382,213,0,0,1,2
23104383,23104451,68,1,0,0,2
23104384,23104455,71,1,0,0,1
23104452,23104574,122,0,0,1,2
23104456,23104574,118,0,0,1,1
23104575,23104606,31,1,0,0,2
23104575,23104615,40,1,0,0,1
23104607,23106239,1632,0,0,1,2
23104616,23106238,1622,0,0,1,1
23106239,23106341,102,1,0,0,1
23106240,23106349,109,1,0,0,2
23106342,23106702,360,0,0,1,1
23106350,23106702,352,0,0,1,2
23106703,23106774,71,1,0,0,1
23106703,23106776,73,1,0,0,2
23106775,23106859,84,0,0,1,1
23106777,23106858,81,0,0,1,2
23106859,23106902,43,1,0,0,2
23106860,23106897,37,1,0,0,1
23106898,23107841,943,0,0,1,1
23106903,23107833,930,0,0,1,2
23107834,23107865,31,1,0,0,2
23107842,23107863,21,1,0,0,1
23107864,23108564,700,0,0,1,1
23107866,23108563,697,0,0,1,2
23108564,23108645,81,1,0,0,2
23108565,23108643,78,1,0,0,1
23108644,23108884,240,0,0,1,1
23108646,23108883,237,0,0,1,2
23108884,23108938,54,1,0,0,2
23108885,23108940,55,1,0,0,1
23108939,23109053,114,0,0,1,2
23108941,23109052,111,0,0,1,1
23109053,23109127,74,1,0,0,1
23109054,23109127,73,1,0,0,2
23109128,23109206,78,0,0,1,1
23109128,23109208,80,0,0,1,2
23109207,23109253,46,1,0,0,1
23109209,23109252,43,1,0,0,2
23109253,23109612,359,0,0,1,2
23109254,23109613,359,0,0,1,1
23109613,23109647,34,1,0,0,2
23109614,23109648,34,1,0,0,1
23109648,23109782,134,0,0,1,2
23109649,23109781,132,0,0,1,1
23109782,23109816,34,1,0,0,1
23109783,23109815,32,1,0,0,2
23109816,23110660,844,0,0,1,2
23109817,23110660,843,0,0,1,1
23110661,23110758,97,1,0,0,1
23110661,23110758,97,1,0,0,2
23110759,23111027,268,0,0,1,1
23110759,23111028,269,0,0,1,2
23111028,23111085,57,1,0,0,1
23111029,23111084,55,1,0,0,2
23111085,23111181,96,0,0,1,2
23111086,23111178,92,0,0,1,1
23111179,23111216,37,1,0,0,1
23111182,23111215,33,1,0,0,2
23111216,23111550,334,0,0,1,2
23111217,23111548,331,0,0,1,1
23111549,23111582,33,1,0,0,1
23111551,23111580,29,1,0,0,2
23111581,23112678,1097,0,0,1,2
23111583,23112675,1092,0,0,1,1
23112676,23112730,54,1,0,0,1
23112679,23112730,51,1,0,0,2
23112731,23112805,74,0,0,1,2
23112731,23112808,77,0,0,1,1
23112806,23112898,92,1,0,0,2
23112809,23112872,63,1,0,0,1
23112873,23113073,200,0,0,1,1
23112899,23113074,175,0,0,1,2
23113074,23113140,66,1,0,0,1
23113075,23113140,65,1,0,0,2
23113141,23113221,80,0,0,1,2
23113141,23113222,81,0,0,1,1
23113222,23113254,32,1,0,0,2
23113223,23113254,31,1,0,0,1
23113255,23113389,134,0,0,1,1
23113255,23113389,134,0,0,1,2
23113390,23113420,30,1,0,0,1
23113390,23113421,31,1,0,0,2
23113421,23114735,1314,0,0,1,1
23113422,23114736,1314,0,0,1,2
23114736,23114821,85,1,0,0,1
23114737,23114821,84,1,0,0,2
23114822,23115118,296,0,0,1,1
23114822,23115120,298,0,0,1,2
23115119,23115175,56,1,0,0,1
23115121,23115184,63,1,0,0,2
23115176,23115292,116,0,0,1,1
23115185,23115293,108,0,0,1,2
23115293,23115329,36,1,0,0,1
23115294,23115330,36,1,0,0,2
23115330,23116551,1221,0,0,1,1
23115331,23116556,1225,0,0,1,2
23116552,23116572,20,1,0,0,1
23116557,23116581,24,1,0,0,2
23116573,23116803,230,0,0,1,1
23116582,23116803,221,0,0,1,2
23116804,23116861,57,1,0,0,2
23116804,23116864,60,1,0,0,1
23116862,23117108,246,0,0,1,2
23116865,23117108,243,0,0,1,1
23117109,23117235,126,1,0,0,2
23117109,23117237,128,1,0,0,1
23117236,23117290,54,0,0,1,2
23117238,23117290,52,0,0,1,1
23117291,23117321,30,1,0,0,2
23117291,23117345,54,1,0,0,1
23117322,23117455,133,0,0,1,2
23117346,23117452,106,0,0,1,1
23117453,23117482,29,1,0,0,1
23117456,23117474,18,1,0,0,2
23117475,23118320,845,0,0,1,2
23117483,23118321,838,0,0,1,1
23118321,23118354,33,1,0,0,2
23118322,23118354,32,1,0,0,1
23118355,23118535,180,0,0,1,2
23118355,23118536,181,0,0,1,1
23118536,23118569,33,1,0,0,2
23118537,23118570,33,1,0,0,1
23118570,23118671,101,0,0,1,2
23118571,23118671,100,0,0,1,1
23118672,23118703,31,1,0,0,2
23118672,23118704,32,1,0,0,1
23118704,23119229,525,0,0,1,2
23118705,23119229,524,0,0,1,1
23119230,23119251,21,1,0,0,1
23119230,23119251,21,1,0,0,2
23119252,23119637,385,0,0,1,1
23119252,23119637,385,0,0,1,2
23119638,23119784,146,1,0,0,2
23119638,23119788,150,1,0,0,1
23119785,23119877,92,0,0,1,2
23119789,23119875,86,0,0,1,1
23119876,23119911,35,1,0,0,1
23119878,23119918,40,1,0,0,2
23119912,23120151,239,0,0,1,1
23119919,23120143,224,0,0,1,2
23120144,23120172,28,1,0,0,2
23120152,23120171,19,1,0,0,1
23120172,23121174,1002,0,0,1,1
23120173,23121171,998,0,0,1,2
23121172,23121242,70,1,0,0,2
23121175,23121243,68,1,0,0,1
23121243,23121618,375,0,0,1,2
23121244,23121618,374,0,0,1,1
23121619,23121648,29,1,0,0,2
23121619,23121649,30,1,0,0,1
23121649,23121794,145,0,0,1,2
23121650,23121793,143,0,0,1,1
23121794,23121831,37,1,0,0,1
23121795,23121829,34,1,0,0,2
23121830,23123136,1306,0,0,1,2
23121832,23123136,1304,0,0,1,1
23123137,23123204,67,1,0,0,1
23123137,23123206,69,1,0,0,2
23123205,23123562,357,0,0,1,1
23123207,23123561,354,0,0,1,2
23123562,23123628,66,1,0,0,2
23123563,23123618,55,1,0,0,1
23123619,23123737,118,0,0,1,1
23123629,23123737,108,0,0,1,2
23123738,23123779,41,1,0,0,2
23123738,23123780,42,1,0,0,1
23123780,23124978,1198,0,0,1,2
23123781,23124977,1196,0,0,1,1
23124978,23125057,79,1,0,0,1
23124979,23125080,101,1,0,0,2
23125058,23125090,32,0,0,1,1
23125081,23125416,335,0,0,1,2
23125091,23125097,6,1,0,0,1
23125098,23125414,316,0,0,1,1
23125415,23125466,51,1,0,0,1
23125417,23125462,45,1,0,0,2
23125463,23125566,103,0,0,1,2
23125467,23125565,98,0,0,1,1
23125566,23125604,38,1,0,0,1
23125567,23125611,44,1,0,0,2
23125605,23125765,160,0,0,1,1
23125612,23125765,153,0,0,1,2
23125766,23125797,31,1,0,0,1
23125766,23125803,37,1,0,0,2
23125798,23126153,355,0,0,1,1
23125804,23126150,346,0,0,1,2
23126151,23126173,22,1,0,0,2
23126154,23126164,10,1,0,0,1
23126165,23126455,290,0,0,1,1
23126174,23126449,275,0,0,1,2
23126450,23127284,834,1,0,0,2
23126456,23127006,550,1,0,0,1
23126510,23127024,514,0,1,0,2
23126518,23126995,477,0,1,0,1
23127007,23127044,37,0,0,1,1
23127045,23127260,215,1,0,0,1
23127060,23127237,177,0,1,0,2
23127070,23127218,148,0,1,0,1
23127261,23127330,69,0,0,1,1
23127285,23127312,27,0,0,1,2
23127313,23127467,154,1,0,0,2
23127331,23127453,122,1,0,0,1
23127346,23127425,79,0,1,0,2
23127352,23127408,56,0,1,0,1
23127454,23127638,184,0,0,1,1
23127468,23127639,171,0,0,1,2
23127639,23127672,33,1,0,0,1
23127640,23127677,37,1,0,0,2
23127673,23128734,1061,0,0,1,1
23127678,23128734,1056,0,0,1,2
23128735,23128758,23,1,0,0,1
23128735,23128760,25,1,0,0,2
23128759,23129065,306,0,0,1,1
23128761,23129064,303,0,0,1,2
23129065,23129113,48,1,0,0,2
23129066,23129100,34,1,0,0,1
23129101,23129346,245,0,0,1,1
23129114,23129345,231,0,0,1,2
23129346,23129380,34,1,0,0,2
23129347,23129381,34,1,0,0,1
23129381,23130217,836,0,0,1,2
23129382,23130221,839,0,0,1,1
23130218,23130410,192,1,0,0,2
23130222,23130388,166,1,0,0,1
23130246,23130346,100,0,1,0,2
23130249,23130332,83,0,1,0,1
23130389,23130653,264,0,0,1,1
23130411,23130653,242,0,0,1,2
23130654,23130717,63,1,0,0,1
23130654,23130718,64,1,0,0,2
23130718,23130792,74,0,0,1,1
23130719,23130795,76,0,0,1,2
23130793,23130838,45,1,0,0,1
23130796,23130839,43,1,0,0,2
23130839,23130911,72,0,0,1,1
23130840,23130911,71,0,0,1,2
23130912,23130946,34,1,0,0,1
23130912,23130947,35,1,0,0,2
23130947,23131152,205,0,0,1,1
23130948,23131152,204,0,0,1,2
23131153,23131179,26,1,0,0,1
23131153,23131180,27,1,0,0,2
23131180,23132298,1118,0,0,1,1
23131181,23132302,1121,0,0,1,2
23132299,23132490,191,1,0,0,1
23132303,23132488,185,1,0,0,2
23132489,23132738,249,0,0,1,2
23132491,23132736,245,0,0,1,1
23132737,23132805,68,1,0,0,1
23132739,23132795,56,1,0,0,2
23132796,23132865,69,0,0,1,2
23132806,23132866,60,0,0,1,1
23132866,23132903,37,1,0,0,2
23132867,23132904,37,1,0,0,1
23132904,23133844,940,0,0,1,2
23132905,23133846,941,0,0,1,1
23133845,23133874,29,1,0,0,2
23133847,23133873,26,1,0,0,1
23133874,23134355,481,0,0,1,1
23133875,23134356,481,0,0,1,2
23134356,23134411,55,1,0,0,1
23134357,23134426,69,1,0,0,2
23134412,23134834,422,0,0,1,1
23134427,23134833,406,0,0,1,2
23134834,23134878,44,1,0,0,2
23134835,23134877,42,1,0,0,1
23134878,23134965,87,0,0,1,1
23134879,23134963,84,0,0,1,2
23134964,23134998,34,1,0,0,2
23134966,23134997,31,1,0,0,1
23134998,23135232,234,0,0,1,1
23134999,23135234,235,0,0,1,2
23135233,23135263,30,1,0,0,1
23135235,23135261,26,1,0,0,2
23135262,23135632,370,0,0,1,2
23135264,23135633,369,0,0,1,1
23135633,23135666,33,1,0,0,2
23135634,23135666,32,1,0,0,1
23135667,23136418,751,0,0,1,1
23135667,23136418,751,0,0,1,2
23136419,23136449,30,1,0,0,2
23136419,23136451,32,1,0,0,1
23136450,23136687,237,0,0,1,2
23136452,23136686,234,0,0,1,1
23136687,23136741,54,1,0,0,1
23136688,23136744,56,1,0,0,2
23136742,23136882,140,0,0,1,1
23136745,23136881,136,0,0,1,2
23136882,23136952,70,1,0,0,2
23136883,23136953,70,1,0,0,1
23136953,23137092,139,0,0,1,2
23136954,23137090,136,0,0,1,1
23137091,23137128,37,1,0,0,1
23137093,23137127,34,1,0,0,2
23137128,23138440,1312,0,0,1,2
23137129,23138441,1312,0,0,1,1
23138441,23138522,81,1,0,0,2
23138442,23138511,69,1,0,0,1
23138512,23138971,459,0,0,1,1
23138523,23138970,447,0,0,1,2
23138971,23139043,72,1,0,0,2
23138972,23139035,63,1,0,0,1
23139036,23139159,123,0,0,1,1
23139044,23139159,115,0,0,1,2
23139160,23139202,42,1,0,0,2
23139160,23139203,43,1,0,0,1
23139203,23140753,1550,0,0,1,2
23139204,23140753,1549,0,0,1,1
23140754,23140849,95,1,0,0,1
23140754,23140860,106,1,0,0,2
23140850,23141199,349,0,0,1,1
23140861,23141200,339,0,0,1,2
23141200,23141270,70,1,0,0,1
23141201,23141270,69,1,0,0,2
23141271,23141349,78,0,0,1,1
23141271,23141350,79,0,0,1,2
23141350,23141394,44,1,0,0,1
23141351,23141386,35,1,0,0,2
23141387,23141619,232,0,0,1,2
23141395,23141618,223,0,0,1,1
23141619,23141650,31,1,0,0,1
23141620,23141649,29,1,0,0,2
23141650,23141966,316,0,0,1,2
23141651,23141968,317,0,0,1,1
23141967,23142005,38,1,0,0,2
23141969,23142007,38,1,0,0,1
23142006,23142123,117,0,0,1,2
23142008,23142122,114,0,0,1,1
23142123,23142155,32,1,0,0,1
23142124,23142154,30,1,0,0,2
23142155,23142764,609,0,0,1,2
23142156,23142765,609,0,0,1,1
23142765,23142807,42,1,0,0,2
23142766,23142811,45,1,0,0,1
23142808,23143154,346,0,0,1,2
23142812,23143155,343,0,0,1,1
23143155,23143223,68,1,0,0,2
23143156,23143224,68,1,0,0,1
23143224,23143312,88,0,0,1,2
23143225,23143311,86,0,0,1,1
23143312,23143346,34,1,0,0,1
23143313,23143346,33,1,0,0,2
23143347,23143537,190,0,0,1,1
23143347,23143539,192,0,0,1,2
23143538,23143556,18,1,0,0,1
23143540,23143556,16,1,0,0,2
23143557,23144649,1092,0,0,1,1
23143557,23144651,1094,0,0,1,2
23144650,23144735,85,1,0,0,1
23144652,23144734,82,1,0,0,2
23144735,23144848,113,0,0,1,2
23144736,23144849,113,0,0,1,1
23144849,23144913,64,1,0,0,2
23144850,23144902,52,1,0,0,1
23144903,23145005,102,0,0,1,1
23144914,23145005,91,0,0,1,2
23145006,23145038,32,1,0,0,1
23145006,23145038,32,1,0,0,2
23145039,23145958,919,0,0,1,2
23145039,23145984,945,0,0,1,1
23145959,23146202,243,1,0,0,2
23145985,23146159,174,1,0,0,1
23146005,23146115,110,0,1,0,2
23146008,23146106,98,0,1,0,1
23146160,23146472,312,0,0,1,1
23146203,23146472,269,0,0,1,2
23146473,23146529,56,1,0,0,2
23146473,23146530,57,1,0,0,1
23146530,23146891,361,0,0,1,2
23146531,23146891,360,0,0,1,1
23146892,23146941,49,1,0,0,1
23146892,23146949,57,1,0,0,2
23146942,23147051,109,0,0,1,1
23146950,23147053,103,0,0,1,2
23147052,23147086,34,1,0,0,1
23147054,23147093,39,1,0,0,2
23147087,23147705,618,0,0,1,1
23147094,23147702,608,0,0,1,2
23147703,23147736,33,1,0,0,2
23147706,23147734,28,1,0,0,1
23147735,23148692,957,0,0,1,1
23147737,23148692,955,0,0,1,2
23148693,23148746,53,1,0,0,2
23148693,23148747,54,1,0,0,1
23148747,23149070,323,0,0,1,2
23148748,23149069,321,0,0,1,1
23149070,23149101,31,1,0,0,1
23149071,23149106,35,1,0,0,2
23149102,23149195,93,0,0,1,1
23149107,23149194,87,0,0,1,2
23149195,23149233,38,1,0,0,2
23149196,23149232,36,1,0,0,1
23149233,23149327,94,0,0,1,1
23149234,23149327,93,0,0,1,2
23149328,23149358,30,1,0,0,1
23149328,23149359,31,1,0,0,2
23149359,23149598,239,0,0,1,1
23149360,23149596,236,0,0,1,2
23149597,23149626,29,1,0,0,2
23149599,23149625,26,1,0,0,1
23149626,23150155,529,0,0,1,1
23149627,23150154,527,0,0,1,2
23150155,23150184,29,1,0,0,2
23150156,23150184,28,1,0,0,1
23150185,23150743,558,0,0,1,2
23150185,23150744,559,0,0,1,1
23150744,23150809,65,1,0,0,2
23150745,23150807,62,1,0,0,1
23150808,23150892,84,0,0,1,1
23150810,23150893,83,0,0,1,2
23150893,23150931,38,1,0,0,1
23150894,23150937,43,1,0,0,2
23150932,23152214,1282,0,0,1,1
23150938,23152214,1276,0,0,1,2
23152215,23152335,120,1,0,0,1
23152215,23152337,122,1,0,0,2
23152336,23152739,403,0,0,1,1
23152338,23152739,401,0,0,1,2
23152740,23152826,86,1,0,0,2
23152740,23152833,93,1,0,0,1
23152827,23152906,79,0,0,1,2
23152834,23152904,70,0,0,1,1
23152905,23152952,47,1,0,0,1
23152907,23152952,45,1,0,0,2
23152953,23154380,1427,0,0,1,1
23152953,23154380,1427,0,0,1,2
23154381,23154400,19,1,0,0,2
23154381,23154413,32,1,0,0,1
23154401,23154792,391,0,0,1,2
23154414,23154791,377,0,0,1,1
23154792,23154864,72,1,0,0,1
23154793,23154873,80,1,0,0,2
23154865,23154972,107,0,0,1,1
23154874,23154971,97,0,0,1,2
23154972,23155003,31,1,0,0,2
23154973,23155003,30,1,0,0,1
23155004,23155176,172,0,0,1,1
23155004,23155176,172,0,0,1,2
23155177,23155211,34,1,0,0,1
23155177,23155212,35,1,0,0,2
23155212,23156874,1662,0,0,1,1
23155213,23156872,1659,0,0,1,2
23156873,23156945,72,1,0,0,2
23156875,23156945,70,1,0,0,1
23156946,23157094,148,0,0,1,1
23156946,23157095,149,0,0,1,2
23157095,23157131,36,1,0,0,1
23157096,23157124,28,1,0,0,2
23157125,23158867,1742,0,0,1,2
23157132,23158857,1725,0,0,1,1
23158858,23158883,25,1,0,0,1
23158868,23158882,14,1,0,0,2
23158883,23159043,160,0,0,1,2
23158884,23159048,164,0,0,1,1
23159044,23159221,177,1,0,0,2
23159049,23159229,180,1,0,0,1
23159103,23159140,37,0,1,0,2
23159222,23159490,268,0,0,1,2
23159230,23159490,260,0,0,1,1
23159491,23159572,81,1,0,0,1
23159491,23159572,81,1,0,0,2
23159573,23159653,80,0,0,1,1
23159573,23159656,83,0,0,1,2
23159654,23159696,42,1,0,0,1
23159657,23159697,40,1,0,0,2
23159697,23159844,147,0,0,1,1
23159698,23159842,144,0,0,1,2
23159843,23159882,39,1,0,0,2
23159845,23159874,29,1,0,0,1
23159875,23160260,385,0,0,1,1
23159883,23160255,372,0,0,1,2
23160256,23160290,34,1,0,0,2
23160261,23160288,27,1,0,0,1
23160289,23160552,263,0,0,1,1
23160291,23160550,259,0,0,1,2
23160551,23160584,33,1,0,0,2
23160553,23160584,31,1,0,0,1
23160585,23161236,651,0,0,1,2
23160585,23161238,653,0,0,1,1
23161237,23161313,76,1,0,0,2
23161239,23161315,76,1,0,0,1
23161314,23161607,293,0,0,1,2
23161316,23161610,294,0,0,1,1
23161608,23161669,61,1,0,0,2
23161611,23161679,68,1,0,0,1
23161670,23161748,78,0,0,1,2
23161680,23161747,67,0,0,1,1
23161748,23161788,40,1,0,0,1
23161749,23161788,39,1,0,0,2
23161789,23163962,2173,0,0,1,1
23161789,23163968,2179,0,0,1,2
23163963,23163991,28,1,0,0,1
23163969,23163991,22,1,0,0,2
23163992,23164551,559,0,0,1,1
23163992,23164553,561,0,0,1,2
23164552,23164725,173,1,0,0,1
23164554,23164727,173,1,0,0,2
23164726,23164792,66,0,0,1,1
23164728,23164794,66,0,0,1,2
23164793,23164832,39,1,0,0,1
23164795,23164832,37,1,0,0,2
23164833,23165124,291,0,0,1,1
23164833,23165127,294,0,0,1,2
23165125,23165158,33,1,0,0,1
23165128,23165157,29,1,0,0,2
23165158,23165575,417,0,0,1,2
23165159,23165573,414,0,0,1,1
23165574,23165603,29,1,0,0,1
23165576,23165603,27,1,0,0,2
23165604,23165787,183,0,0,1,1
23165604,23166110,506,0,0,1,2
23165788,23165809,21,1,0,0,1
23165810,23166109,299,0,0,1,1
23166110,23166153,43,1,0,0,1
23166111,23166145,34,1,0,0,2
23166146,23166662,516,0,0,1,2
23166154,23166663,509,0,0,1,1
23166663,23166699,36,1,0,0,2
23166664,23166700,36,1,0,0,1
23166700,23167067,367,0,0,1,2
23166701,23167061,360,0,0,1,1
23167062,23167272,210,1,0,0,1
23167068,23167298,230,1,0,0,2
23167088,23167204,116,0,1,0,1
23167088,23167225,137,0,1,0,2
23167273,23167537,264,0,0,1,1
23167299,23167535,236,0,0,1,2
23167536,23167586,50,1,0,0,2
23167538,23167587,49,1,0,0,1
23167587,23167726,139,0,0,1,2
23167588,23167727,139,0,0,1,1
23167727,23167767,40,1,0,0,2
23167728,23167765,37,1,0,0,1
23167766,23169302,1536,0,0,1,1
23167768,23169303,1535,0,0,1,2
23169303,23169404,101,1,0,0,1
23169304,23169393,89,1,0,0,2
23169394,23169791,397,0,0,1,2
23169405,23169792,387,0,0,1,1
23169792,23169860,68,1,0,0,2
23169793,23169862,69,1,0,0,1
23169861,23169926,65,0,0,1,2
23169863,23169927,64,0,0,1,1
23169927,23169969,42,1,0,0,2
23169928,23169969,41,1,0,0,1
23169970,23170087,117,0,0,1,2
23169970,23170088,118,0,0,1,1
23170088,23170115,27,1,0,0,2
23170089,23170117,28,1,0,0,1
23170116,23170600,484,0,0,1,2
23170118,23170601,483,0,0,1,1
23170601,23170628,27,1,0,0,2
23170602,23170632,30,1,0,0,1
23170629,23171530,901,0,0,1,2
23170633,23171530,897,0,0,1,1
23171531,23171646,115,1,0,0,2
23171531,23171647,116,1,0,0,1
23171647,23171840,193,0,0,1,2
23171648,23171846,198,0,0,1,1
23171841,23171898,57,1,0,0,2
23171847,23171893,46,1,0,0,1
23171894,23172109,215,0,0,1,1
23171899,23172105,206,0,0,1,2
23172106,23172183,77,1,0,0,2
23172110,23172183,73,1,0,0,1
23172184,23172265,81,0,0,1,2
23172184,23172272,88,0,0,1,1
23172266,23172575,309,1,0,0,2
23172273,23172568,295,1,0,0,1
23172287,23172516,229,0,1,0,2
23172300,23172478,178,0,1,0,1
23172569,23172859,290,0,0,1,1
23172576,23172859,283,0,0,1,2
23172860,23172933,73,1,0,0,2
23172860,23172935,75,1,0,0,1
23172934,23173028,94,0,0,1,2
23172936,23173034,98,0,0,1,1
23173029,23173953,924,1,0,0,2
23173035,23173730,695,1,0,0,1
23173052,23173751,699,0,1,0,2
23173060,23173717,657,0,1,0,1
23173731,23173764,33,0,0,1,1
23173765,23173927,162,1,0,0,1
23173782,23173910,128,0,1,0,2
23173787,23173911,124,0,1,0,1
23173928,23174320,392,0,0,1,1
23173954,23174323,369,0,0,1,2
23174321,23174518,197,1,0,0,1
23174324,23174510,186,1,0,0,2
23174337,23174480,143,0,1,0,2
23174340,23174465,125,0,1,0,1
23174511,23174857,346,0,0,1,2
23174519,23174858,339,0,0,1,1
23174858,23175069,211,1,0,0,2
23174859,23175045,186,1,0,0,1
23174878,23175015,137,0,1,0,2
23174879,23174999,120,0,1,0,1
23175046,23175290,244,0,0,1,1
23175070,23175289,219,0,0,1,2
23175290,23175348,58,1,0,0,2
23175291,23175350,59,1,0,0,1
23175349,23175858,509,0,0,1,2
23175351,23175857,506,0,0,1,1
23175858,23175919,61,1,0,0,1
23175859,23175919,60,1,0,0,2
23175920,23176380,460,0,0,1,1
23175920,23176380,460,0,0,1,2
23176381,23176444,63,1,0,0,1
23176381,23176444,63,1,0,0,2
23176445,23176849,404,0,0,1,2
23176445,23176850,405,0,0,1,1
23176850,23176935,85,1,0,0,2
23176851,23176933,82,1,0,0,1
23176934,23177224,290,0,0,1,1
23176936,23177218,282,0,0,1,2
23177219,23177439,220,1,0,0,2
23177225,23177449,224,1,0,0,1
23177251,23177395,144,0,1,0,2
23177252,23177380,128,0,1,0,1
23177440,23177685,245,0,0,1,2
23177450,23177688,238,0,0,1,1
23177686,23178879,1193,1,0,0,2
23177689,23178639,950,1,0,0,1
23177715,23178625,910,0,1,0,2
23177718,23178628,910,0,1,0,1
23178640,23178665,25,0,0,1,1
23178666,23178861,195,1,0,0,1
23178686,23178826,140,0,1,0,2
23178686,23178838,152,0,1,0,1
23178862,23179677,815,0,0,1,1
23178880,23179682,802,0,0,1,2
23179678,23179872,194,1,0,0,1
23179683,23179897,214,1,0,0,2
23179698,23179836,138,0,1,0,2
23179699,23179821,122,0,1,0,1
23179873,23180389,516,0,0,1,1
23179898,23180389,491,0,0,1,2
23180390,23180461,71,1,0,0,1
23180390,23180462,72,1,0,0,2
23180462,23180772,310,0,0,1,1
23180463,23180772,309,0,0,1,2
23180773,23180833,60,1,0,0,1
23180773,23180844,71,1,0,0,2
23180834,23181090,256,0,0,1,1
23180845,23181094,249,0,0,1,2
23181091,23181257,166,1,0,0,1
23181095,23181286,191,1,0,0,2
23181114,23181217,103,0,1,0,2
23181117,23181204,87,0,1,0,1
23181258,23181530,272,0,0,1,1
23181287,23181530,243,0,0,1,2
23181531,23181582,51,1,0,0,1
23181531,23181583,52,1,0,0,2
23181583,23181874,291,0,0,1,1
23181584,23181872,288,0,0,1,2
23181873,23181930,57,1,0,0,2
23181875,23181920,45,1,0,0,1
23181921,23182116,195,0,0,1,1
23181931,23182115,184,0,0,1,2
23182116,23182338,222,1,0,0,2
23182117,23182298,181,1,0,0,1
23182140,23182251,111,0,1,0,2
23182143,23182239,96,0,1,0,1
23182299,23182933,634,0,0,1,1
23182339,23182924,585,0,0,1,2
23182925,23183220,295,1,0,0,2
23182934,23183144,210,1,0,0,1
23182951,23183121,170,0,1,0,2
23182955,23183091,136,0,1,0,1
23183145,23183644,499,0,0,1,1
23183221,23183645,424,0,0,1,2
23183645,23183733,88,1,0,0,1
23183646,23183726,80,1,0,0,2
23183700,23183700,0,0,1,0,2
23183727,23184035,308,0,0,1,2
23183734,23184033,299,0,0,1,1
23184034,23184138,104,1,0,0,1
23184036,23184138,102,1,0,0,2
23184051,23184052,1,0,1,0,2
23184139,23184215,76,0,0,1,2
23184139,23184219,80,0,0,1,1
23184216,23185203,987,1,0,0,2
23184220,23185202,982,1,0,0,1
23184242,23185188,946,0,1,0,2
23184246,23185191,945,0,1,0,1
23185203,23185269,66,0,0,1,1
23185204,23185268,64,0,0,1,2
23185269,23185303,34,1,0,0,2
23185270,23185301,31,1,0,0,1
23185302,23185756,454,0,0,1,1
23185304,23185758,454,0,0,1,2
23185757,23186003,246,1,0,0,1
23185759,23186017,258,1,0,0,2
23185775,23185952,177,0,1,0,2
23185778,23185932,154,0,1,0,1
23186004,23186194,190,0,0,1,1
23186018,23186193,175,0,0,1,2
23186194,23186278,84,1,0,0,2
23186195,23186271,76,1,0,0,1
23186272,23186921,649,0,0,1,1
23186279,23186919,640,0,0,1,2
23186920,23187164,244,1,0,0,2
23186922,23187128,206,1,0,0,1
23186945,23187087,142,0,1,0,2
23186946,23187065,119,0,1,0,1
23187129,23187450,321,0,0,1,1
23187165,23187449,284,0,0,1,2
23187450,23187506,56,1,0,0,2
23187451,23187507,56,1,0,0,1
23187507,23187772,265,0,0,1,2
23187508,23187772,264,0,0,1,1
23187773,23187836,63,1,0,0,1
23187773,23187845,72,1,0,0,2
23187837,23188142,305,0,0,1,1
23187846,23188143,297,0,0,1,2
23188143,23188353,210,1,0,0,1
23188144,23188403,259,1,0,0,2
23188165,23188295,130,0,1,0,1
23188165,23188314,149,0,1,0,2
23188354,23188864,510,0,0,1,1
23188404,23188865,461,0,0,1,2
23188865,23188930,65,1,0,0,1
23188866,23188921,55,1,0,0,2
23188922,23189164,242,0,0,1,2
23188931,23189164,233,0,0,1,1
23189165,23189226,61,1,0,0,1
23189165,23189233,68,1,0,0,2
23189227,23189542,315,0,0,1,1
23189234,23189540,306,0,0,1,2
23189541,23189847,306,1,0,0,2
23189543,23189785,242,1,0,0,1
23189564,23189758,194,0,1,0,2
23189568,23189725,157,0,1,0,1
23189786,23190129,343,0,0,1,1
23189848,23190129,281,0,0,1,2
23190130,23190188,58,1,0,0,1
23190130,23190192,62,1,0,0,2
23190189,23190512,323,0,0,1,1
23190193,23190512,319,0,0,1,2
23190513,23190574,61,1,0,0,2
23190513,23190575,62,1,0,0,1
23190575,23191098,523,0,0,1,2
23190576,23191097,521,0,0,1,1
23191098,23191132,34,1,0,0,1
23191099,23191133,34,1,0,0,2
23191133,23191317,184,0,0,1,1
23191134,23191321,187,0,0,1,2
23191318,23191633,315,1,0,0,1
23191322,23191662,340,1,0,0,2
23191349,23191558,209,0,1,0,2
23191352,23191533,181,0,1,0,1
23191581,23191581,0,0,1,0,1
23191634,23191894,260,0,0,1,1
23191663,23191894,231,0,0,1,2
23191895,23191957,62,1,0,0,1
23191895,23191963,68,1,0,0,2
23191958,23192521,563,0,0,1,1
23191964,23192521,557,0,0,1,2
23192522,23192597,75,1,0,0,1
23192522,23192597,75,1,0,0,2
23192598,23192940,342,0,0,1,1
23192598,23192941,343,0,0,1,2
23192941,23193034,93,1,0,0,1
23192942,23193011,69,1,0,0,2
23193012,23193583,571,0,0,1,2
23193035,23193583,548,0,0,1,1
23193584,23193652,68,1,0,0,1
23193584,23193659,75,1,0,0,2
23193653,23193730,77,0,0,1,1
23193660,23193728,68,0,0,1,2
23193729,23194008,279,1,0,0,2
23193731,23193990,259,1,0,0,1
23193749,23193932,183,0,1,0,2
23193753,23193917,164,0,1,0,1
23193991,23194129,138,0,0,1,1
23194009,23194129,120,0,0,1,2
23194130,23194194,64,1,0,0,1
23194130,23194196,66,1,0,0,2
23194195,23194556,361,0,0,1,1
23194197,23194556,359,0,0,1,2
23194557,23194611,54,1,0,0,1
23194557,23194611,54,1,0,0,2
23194612,23195253,641,0,0,1,1
23194612,23195253,641,0,0,1,2
23195254,23195320,66,1,0,0,2
23195254,23195322,68,1,0,0,1
23195321,23195492,171,0,0,1,2
23195323,23195493,170,0,0,1,1
23195493,23195524,31,1,0,0,2
23195494,23195532,38,1,0,0,1
23195525,23199406,3881,0,0,1,2
23195533,23199407,3874,0,0,1,1
23199407,23199463,56,1,0,0,2
23199408,23199462,54,1,0,0,1
23199463,23199771,308,0,0,1,1
23199464,23199773,309,0,0,1,2
23199772,23199801,29,1,0,0,1
23199774,23199799,25,1,0,0,2
23199800,23201577,1777,0,0,1,2
23199802,23201578,1776,0,0,1,1
23201578,23201740,162,1,0,0,2
23201579,23201711,132,1,0,0,1
23201629,23201661,32,0,1,0,2
23201712,23201920,208,0,0,1,1
23201741,23201914,173,0,0,1,2
23201915,23202218,303,1,0,0,2
23201921,23202112,191,1,0,0,1
23201939,23202088,149,0,1,0,2
23201946,23202051,105,0,1,0,1
23202113,23202424,311,0,0,1,1
23202219,23202424,205,0,0,1,2
23202425,23202456,31,1,0,0,2
23202425,23202458,33,1,0,0,1
23202457,23202661,204,0,0,1,2
23202459,23202662,203,0,0,1,1
23202662,23202709,47,1,0,0,2
23202663,23202711,48,1,0,0,1
23202710,23202817,107,0,0,1,2
23202712,23202818,106,0,0,1,1
23202818,23202856,38,1,0,0,2
23202819,23202838,19,1,0,0,1
23202839,23203002,163,0,0,1,1
23202857,23203002,145,0,0,1,2
23203003,23203031,28,1,0,0,1
23203003,23203031,28,1,0,0,2
23203032,23204439,1407,0,0,1,1
23203032,23204783,1751,0,0,1,2
23204440,23204460,20,1,0,0,1
23204461,23204782,321,0,0,1,1
23204783,23204836,53,1,0,0,1
23204784,23204836,52,1,0,0,2
23204837,23206900,2063,0,0,1,1
23204837,23206900,2063,0,0,1,2
23206901,23207186,285,1,0,0,1
23206901,23207315,414,1,0,0,2
23206937,23207151,214,0,1,0,2
23206948,23207108,160,0,1,0,1
23207187,23207260,73,0,0,1,1
23207261,23207305,44,1,0,0,1
23207306,23207577,271,0,0,1,1
23207316,23207577,261,0,0,1,2
23207578,23207610,32,1,0,0,2
23207578,23207616,38,1,0,0,1
23207611,23208166,555,0,0,1,2
23207617,23208166,549,0,0,1,1
23208167,23208222,55,1,0,0,1
23208167,23208234,67,1,0,0,2
23208223,23208325,102,0,0,1,1
23208235,23208325,90,0,0,1,2
23208326,23208352,26,1,0,0,2
23208326,23208354,28,1,0,0,1
23208353,23209646,1293,0,0,1,2
23208355,23209646,1291,0,0,1,1
23209647,23209663,16,1,0,0,1
23209647,23209664,17,1,0,0,2
23209664,23210048,384,0,0,1,1
23209665,23210049,384,0,0,1,2
23210049,23210079,30,1,0,0,1
23210050,23210078,28,1,0,0,2
23210079,23210537,458,0,0,1,2
23210080,23210536,456,0,0,1,1
23210537,23210571,34,1,0,0,1
23210538,23210572,34,1,0,0,2
23210572,23210823,251,0,0,1,1
23210573,23210824,251,0,0,1,2
23210824,23210852,28,1,0,0,1
23210825,23210852,27,1,0,0,2
23210853,23211183,330,0,0,1,2
23210853,23211184,331,0,0,1,1
23211184,23211214,30,1,0,0,2
23211185,23211215,30,1,0,0,1
23211215,23211709,494,0,0,1,2
23211216,23211709,493,0,0,1,1
23211710,23211736,26,1,0,0,2
23211710,23211737,27,1,0,0,1
23211737,23212064,327,0,0,1,2
23211738,23212064,326,0,0,1,1
23212065,23212116,51,1,0,0,1
23212065,23212117,52,1,0,0,2
23212117,23212252,135,0,0,1,1
23212118,23212248,130,0,0,1,2
23212249,23212272,23,1,0,0,2
23212253,23212273,20,1,0,0,1
23212273,23212480,207,0,0,1,2
23212274,23212492,218,0,0,1,1
23212481,23212756,275,1,0,0,2
23212493,23212709,216,1,0,0,1
23212504,23212658,154,0,1,0,2
23212515,23212617,102,0,1,0,1
23212710,23212861,151,0,0,1,1
23212757,23212860,103,0,0,1,2
23212861,23212893,32,1,0,0,2
23212862,23212893,31,1,0,0,1
23212894,23214155,1261,0,0,1,1
23212894,23214155,1261,0,0,1,2
23214156,23214183,27,1,0,0,2
23214156,23214184,28,1,0,0,1
23214184,23214370,186,0,0,1,2
23214185,23214370,185,0,0,1,1
23214371,23214418,47,1,0,0,1
23214371,23214420,49,1,0,0,2
23214419,23214756,337,0,0,1,1
23214421,23214754,333,0,0,1,2
23214755,23214785,30,1,0,0,2
23214757,23214785,28,1,0,0,1
23214786,23215177,391,0,0,1,1
23214786,23215178,392,0,0,1,2
23215178,23215203,25,1,0,0,1
23215179,23215204,25,1,0,0,2
23215204,23215613,409,0,0,1,1
23215205,23215613,408,0,0,1,2
23215614,23215676,62,1,0,0,2
23215614,23215678,64,1,0,0,1
23215677,23215791,114,0,0,1,2
23215679,23215791,112,0,0,1,1
23215792,23215823,31,1,0,0,2
23215792,23215831,39,1,0,0,1
23215824,23216206,382,0,0,1,2
23215832,23216208,376,0,0,1,1
23216207,23216240,33,1,0,0,2
23216209,23216241,32,1,0,0,1
23216241,23216849,608,0,0,1,2
23216242,23216849,607,0,0,1,1
23216850,23216893,43,1,0,0,1
23216850,23216900,50,1,0,0,2
23216894,23217678,784,0,0,1,1
23216901,23217203,302,0,0,1,2
23217204,23217252,48,1,0,0,2
23217253,23217655,402,0,0,1,2
23217656,23218114,458,1,0,0,2
23217679,23218023,344,1,0,0,1
23217696,23218105,409,0,1,0,2
23217710,23217911,201,0,1,0,1
23217932,23217954,22,0,1,0,1
23218024,23218163,139,0,0,1,1
23218115,23218163,48,0,0,1,2
23218164,23218217,53,1,0,0,1
23218164,23218238,74,1,0,0,2
23218180,23218196,16,0,1,0,2
23218218,23219225,1007,0,0,1,1
23218239,23218283,44,0,0,1,2
23218284,23218315,31,1,0,0,2
23218316,23219058,742,0,0,1,2
23219059,23219080,21,1,0,0,2
23219081,23219124,43,0,0,1,2
23219125,23219147,22,1,0,0,2
23219148,23219187,39,0,0,1,2
23219188,23219362,174,1,0,0,2
23219226,23219259,33,1,0,0,1
23219260,23219730,470,0,0,1,1
23219363,23219623,260,0,0,1,2
23219624,23219646,22,1,0,0,2
23219647,23219730,83,0,0,1,2
23219731,23219762,31,1,0,0,2
23219731,23219763,32,1,0,0,1
23219763,23220286,523,0,0,1,2
23219764,23220286,522,0,0,1,1
23220287,23220320,33,1,0,0,2
23220287,23220323,36,1,0,0,1
23220321,23220592,271,0,0,1,2
23220324,23221421,1097,0,0,1,1
23220593,23221498,905,1,0,0,2
23221422,23221493,71,1,0,0,1
23221494,23221684,190,0,0,1,1
23221499,23221685,186,0,0,1,2
23221685,23221758,73,1,0,0,1
23221686,23221760,74,1,0,0,2
23221759,23221853,94,0,0,1,1
23221761,23221854,93,0,0,1,2
23221854,23221899,45,1,0,0,1
23221855,23221901,46,1,0,0,2
23221900,23222460,560,0,0,1,1
23221902,23222459,557,0,0,1,2
23222460,23222506,46,1,0,0,2
23222461,23222497,36,1,0,0,1
23222498,23222632,134,0,0,1,1
23222507,23222631,124,0,0,1,2
23222632,23222665,33,1,0,0,2
23222633,23222665,32,1,0,0,1
23222666,23223692,1026,0,0,1,1
23222666,23223694,1028,0,0,1,2
23223693,23224206,513,1,0,0,1
23223695,23224197,502,1,0,0,2
23223725,23224187,462,0,1,0,2
23223730,23224137,407,0,1,0,1
23224198,23224316,118,0,0,1,2
23224207,23224313,106,0,0,1,1
23224314,23224376,62,1,0,0,1
23224317,23224381,64,1,0,0,2
23224377,23224538,161,0,0,1,1
23224382,23224540,158,0,0,1,2
23224539,23224575,36,1,0,0,1
23224541,23224571,30,1,0,0,2
23224572,23225431,859,0,0,1,2
23224576,23225432,856,0,0,1,1
23225432,23225465,33,1,0,0,2
23225433,23225458,25,1,0,0,1
23225459,23226588,1129,0,0,1,1
23225466,23226588,1122,0,0,1,2
23226589,23226650,61,1,0,0,2
23226589,23226652,63,1,0,0,1
23226651,23227415,764,0,0,1,2
23226653,23227414,761,0,0,1,1
23227415,23227452,37,1,0,0,1
23227416,23227451,35,1,0,0,2
23227452,23227715,263,0,0,1,2
23227453,23227719,266,0,0,1,1
23227716,23228059,343,1,0,0,2
23227720,23228009,289,1,0,0,1
23227741,23227939,198,0,1,0,2
23227747,23227903,156,0,1,0,1
23228010,23228247,237,0,0,1,1
23228060,23228246,186,0,0,1,2
23228247,23228307,60,1,0,0,2
23228248,23228319,71,1,0,0,1
23228308,23228403,95,0,0,1,2
23228320,23228403,83,0,0,1,1
23228404,23228445,41,1,0,0,1
23228404,23228445,41,1,0,0,2
23228446,23228970,524,0,0,1,1
23228446,23228970,524,0,0,1,2
23228971,23229001,30,1,0,0,1
23228971,23229009,38,1,0,0,2
23229002,23230621,1619,0,0,1,1
23229010,23230616,1606,0,0,1,2
23230617,23230645,28,1,0,0,2
23230622,23230645,23,1,0,0,1
23230646,23230814,168,0,0,1,2
23230646,23230815,169,0,0,1,1
23230815,23230865,50,1,0,0,2
23230816,23230866,50,1,0,0,1
23230866,23231061,195,0,0,1,2
23230867,23231063,196,0,0,1,1
23231062,23231099,37,1,0,0,2
23231064,23231099,35,1,0,0,1
23231100,23232962,1862,0,0,1,1
23231100,23232964,1864,0,0,1,2
23232963,23233010,47,1,0,0,1
23232965,23233011,46,1,0,0,2
23233011,23233127,116,0,0,1,1
23233012,23233128,116,0,0,1,2
23233128,23233196,68,1,0,0,1
23233129,23233193,64,1,0,0,2
23233194,23233468,274,0,0,1,2
23233197,23233477,280,0,0,1,1
23233469,23233747,278,1,0,0,2
23233478,23233714,236,1,0,0,1
23233487,23233658,171,0,1,0,2
23233495,23233616,121,0,1,0,1
23233715,23233821,106,0,0,1,1
23233748,23233819,71,0,0,1,2
23233820,23233885,65,1,0,0,2
23233822,23233875,53,1,0,0,1
23233876,23234203,327,0,0,1,1
23233886,23234203,317,0,0,1,2
23234204,23234238,34,1,0,0,1
23234204,23234239,35,1,0,0,2
23234239,23234393,154,0,0,1,1
23234240,23234392,152,0,0,1,2
23234393,23234432,39,1,0,0,2
23234394,23234426,32,1,0,0,1
23234427,23234570,143,0,0,1,1
23234433,23234569,136,0,0,1,2
23234570,23234604,34,1,0,0,2
23234571,23234604,33,1,0,0,1
23234605,23235918,1313,0,0,1,1
23234605,23235918,1313,0,0,1,2
23235919,23235949,30,1,0,0,2
23235919,23235950,31,1,0,0,1
23235950,23236696,746,0,0,1,2
23235951,23236697,746,0,0,1,1
23236697,23236742,45,1,0,0,2
23236698,23236740,42,1,0,0,1
23236741,23236978,237,0,0,1,1
23236743,23236979,236,0,0,1,2
23236979,23236999,20,1,0,0,1
23236980,23236999,19,1,0,0,2
23237000,23237471,471,0,0,1,1
23237000,23237472,472,0,0,1,2
23237472,23237500,28,1,0,0,1
23237473,23237495,22,1,0,0,2
23237496,23238873,1377,0,0,1,2
23237501,23238872,1371,0,0,1,1
23238873,23238943,70,1,0,0,1
23238874,23238944,70,1,0,0,2
23238944,23239176,232,0,0,1,1
23238945,23239176,231,0,0,1,2
23239177,23239497,320,1,0,0,1
23239177,23239555,378,1,0,0,2
23239205,23239461,256,0,1,0,2
23239228,23239414,186,0,1,0,1
23239498,23240059,561,0,0,1,1
23239556,23240058,502,0,0,1,2
23240059,23240124,65,1,0,0,2
23240060,23240126,66,1,0,0,1
23240125,23240634,509,0,0,1,2
23240127,23240634,507,0,0,1,1
23240635,23240689,54,1,0,0,1
23240635,23240691,56,1,0,0,2
23240690,23240738,48,0,0,1,1
23240692,23240737,45,0,0,1,2
23240738,23240789,51,1,0,0,2
23240739,23240859,120,1,0,0,1
23240790,23240812,22,0,0,1,2
23240813,23240857,44,1,0,0,2
23240858,23240955,97,0,0,1,2
23240860,23240954,94,0,0,1,1
23240955,23240996,41,1,0,0,1
23240956,23240995,39,1,0,0,2
23240996,23241177,181,0,0,1,2
23240997,23241174,177,0,0,1,1
23241175,23241204,29,1,0,0,1
23241178,23241204,26,1,0,0,2
23241205,23243137,1932,0,0,1,2
23241205,23243138,1933,0,0,1,1
23243138,23243177,39,1,0,0,2
23243139,23243179,40,1,0,0,1
23243178,23245294,2116,0,0,1,2
23243180,23245295,2115,0,0,1,1
23245295,23245312,17,1,0,0,2
23245296,23245314,18,1,0,0,1
23245313,23245405,92,0,0,1,2
23245315,23245406,91,0,0,1,1
23245406,23245605,199,1,0,0,2
23245407,23245584,177,1,0,0,1
23245439,23245508,69,0,1,0,2
23245459,23245475,16,0,1,0,1
23245585,23245688,103,0,0,1,1
23245606,23245684,78,0,0,1,2
23245685,23246004,319,1,0,0,2
23245689,23245940,251,1,0,0,1
23245721,23245920,199,0,1,0,2
23245730,23245872,142,0,1,0,1
23245941,23246420,479,0,0,1,1
23246005,23246420,415,0,0,1,2
23246421,23246448,27,1,0,0,1
23246421,23246450,29,1,0,0,2
23246449,23246869,420,0,0,1,1
23246451,23246869,418,0,0,1,2
23246870,23246941,71,1,0,0,1
23246870,23246945,75,1,0,0,2
23246942,23247036,94,0,0,1,1
23246946,23247036,90,0,0,1,2
23247037,23247072,35,1,0,0,1
23247037,23247079,42,1,0,0,2
23247073,23247265,192,0,0,1,1
23247080,23247264,184,0,0,1,2
23247265,23247280,15,1,0,0,2
23247266,23247277,11,1,0,0,1
23247278,23249048,1770,0,0,1,1
23247281,23249048,1767,0,0,1,2
23249049,23249104,55,1,0,0,2
23249049,23249105,56,1,0,0,1
23249105,23249283,178,0,0,1,2
23249106,23249283,177,0,0,1,1
23249284,23249311,27,1,0,0,1
23249284,23249319,35,1,0,0,2
23249312,23249864,552,0,0,1,1
23249320,23249860,540,0,0,1,2
23249861,23249876,15,1,0,0,2
23249865,23249876,11,1,0,0,1
23249877,23251162,1285,0,0,1,1
23249877,23251168,1291,0,0,1,2
23251163,23251184,21,1,0,0,1
23251169,23251180,11,1,0,0,2
23251181,23251549,368,0,0,1,2
23251185,23251549,364,0,0,1,1
23251550,23251578,28,1,0,0,2
23251550,23251580,30,1,0,0,1
23251579,23251972,393,0,0,1,2
23251581,23251973,392,0,0,1,1
23251973,23252041,68,1,0,0,2
23251974,23252032,58,1,0,0,1
23252033,23252392,359,0,0,1,1
23252042,23252389,347,0,0,1,2
23252390,23252411,21,1,0,0,2
23252393,23252429,36,1,0,0,1
23252412,23252601,189,0,0,1,2
23252430,23252601,171,0,0,1,1
23252602,23252652,50,1,0,0,2
23252602,23252653,51,1,0,0,1
23252653,23252870,217,0,0,1,2
23252654,23252871,217,0,0,1,1
23252871,23252942,71,1,0,0,2
23252872,23252943,71,1,0,0,1
23252943,23252993,50,0,0,1,2
23252944,23252994,50,0,0,1,1
23252994,23253032,38,1,0,0,2
23252995,23253034,39,1,0,0,1
23253033,23253175,142,0,0,1,2
23253035,23253174,139,0,0,1,1
23253175,23253207,32,1,0,0,1
23253176,23253210,34,1,0,0,2
23253208,23254385,1177,0,0,1,1
23253211,23254386,1175,0,0,1,2
23254386,23254446,60,1,0,0,1
23254387,23254446,59,1,0,0,2
23254447,23254951,504,0,0,1,1
23254447,23254953,506,0,0,1,2
23254952,23254982,30,1,0,0,1
23254954,23254983,29,1,0,0,2
23254983,23256736,1753,0,0,1,1
23254984,23256737,1753,0,0,1,2
23256737,23256774,37,1,0,0,1
23256738,23256774,36,1,0,0,2
23256775,23257068,293,0,0,1,2
23256775,23257071,296,0,0,1,1
23257069,23257857,788,1,0,0,2
23257072,23257831,759,1,0,0,1
23257126,23257569,443,0,1,0,2
23257132,23257539,407,0,1,0,1
23257624,23257791,167,0,1,0,2
23257628,23257778,150,0,1,0,1
23257805,23257806,1,0,1,0,1
23257832,23258186,354,0,0,1,1
23257858,23258201,343,0,0,1,2
23258187,23258406,219,1,0,0,1
23258202,23258430,228,1,0,0,2
23258216,23258354,138,0,1,0,2
23258219,23258342,123,0,1,0,1
23258407,23258696,289,0,0,1,1
23258431,23258696,265,0,0,1,2
23258697,23258764,67,1,0,0,1
23258697,23258764,67,1,0,0,2
23258765,23258858,93,0,0,1,1
23258765,23258858,93,0,0,1,2
23258859,23258892,33,1,0,0,1
23258859,23258893,34,1,0,0,2
23258893,23259073,180,0,0,1,1
23258894,23259071,177,0,0,1,2
23259072,23259094,22,1,0,0,2
23259074,23259094,20,1,0,0,1
23259095,23259342,247,0,0,1,2
23259095,23259343,248,0,0,1,1
23259343,23259377,34,1,0,0,2
23259344,23259378,34,1,0,0,1
23259378,23259491,113,0,0,1,2
23259379,23260388,1009,0,0,1,1
23259492,23259506,14,1,0,0,2
23259507,23260388,881,0,0,1,2
23260389,23260441,52,1,0,0,1
23260389,23260450,61,1,0,0,2
23260442,23260617,175,0,0,1,1
23260451,23260619,168,0,0,1,2
23260618,23260653,35,1,0,0,1
23260620,23260654,34,1,0,0,2
23260654,23260946,292,0,0,1,1
23260655,23260953,298,0,0,1,2
23260947,23260981,34,1,0,0,1
23260954,23260979,25,1,0,0,2
23260980,23261215,235,0,0,1,2
23260982,23261211,229,0,0,1,1
23261212,23261247,35,1,0,0,1
23261216,23261245,29,1,0,0,2
23261246,23262519,1273,0,0,1,2
23261248,23262517,1269,0,0,1,1
23262518,23262987,469,1,0,0,1
23262520,23263001,481,1,0,0,2
23262561,23262967,406,0,1,0,2
23262571,23262976,405,0,1,0,1
23262988,23263037,49,0,0,1,1
23263002,23263030,28,0,0,1,2
23263031,23263241,210,1,0,0,2
23263038,23263213,175,1,0,0,1
23263056,23263186,130,0,1,0,2
23263060,23263178,118,0,1,0,1
23263214,23263636,422,0,0,1,1
23263242,23263635,393,0,0,1,2
23263636,23263674,38,1,0,0,2
23263637,23263677,40,1,0,0,1
23263675,23263782,107,0,0,1,2
23263678,23263781,103,0,0,1,1
23263782,23263805,23,1,0,0,1
23263783,23263814,31,1,0,0,2
23263806,23264441,635,0,0,1,1
23263815,23264441,626,0,0,1,2
23264442,23264474,32,1,0,0,2
23264442,23264475,33,1,0,0,1
23264475,23266184,1709,0,0,1,2
23264476,23266183,1707,0,0,1,1
23266184,23266228,44,1,0,0,1
23266185,23266236,51,1,0,0,2
23266229,23268322,2093,0,0,1,1
23266237,23268323,2086,0,0,1,2
23268323,23268360,37,1,0,0,1
23268324,23268357,33,1,0,0,2
23268358,23268425,67,0,0,1,2
23268361,23268428,67,0,0,1,1
23268426,23268797,371,1,0,0,2
23268429,23268741,312,1,0,0,1
23268461,23268697,236,0,1,0,2
23268475,23268675,200,0,1,0,1
23268742,23269125,383,0,0,1,1
23268798,23269127,329,0,0,1,2
23269126,23269162,36,1,0,0,1
23269128,23269162,34,1,0,0,2
23269163,23269420,257,0,0,1,1
23269163,23269420,257,0,0,1,2
23269421,23269428,7,1,0,0,2
23269421,23269448,27,1,0,0,1
23269429,23269962,533,0,0,1,2
23269449,23269961,512,0,0,1,1
23269962,23270015,53,1,0,0,1
23269963,23270014,51,1,0,0,2
23270015,23270169,154,0,0,1,2
23270016,23270168,152,0,0,1,1
23270169,23270194,25,1,0,0,1
23270170,23270189,19,1,0,0,2
23270190,23271194,1004,0,0,1,2
23270195,23271196,1001,0,0,1,1
23271195,23271223,28,1,0,0,2
23271197,23271223,26,1,0,0,1
23271224,23271673,449,0,0,1,2
23271224,23271675,451,0,0,1,1
23271674,23271731,57,1,0,0,2
23271676,23271722,46,1,0,0,1
23271723,23271854,131,0,0,1,1
23271732,23271854,122,0,0,1,2
23271855,23271889,34,1,0,0,1
23271855,23271894,39,1,0,0,2
23271890,23272250,360,0,0,1,1
23271895,23272252,357,0,0,1,2
23272251,23272285,34,1,0,0,1
23272253,23272284,31,1,0,0,2
23272285,23272549,264,0,0,1,2
23272286,23272547,261,0,0,1,1
23272548,23272580,32,1,0,0,1
23272550,23272580,30,1,0,0,2
23272581,23273753,1172,0,0,1,2
23272581,23273754,1173,0,0,1,1
23273754,23274262,508,1,0,0,2
23273755,23274227,472,1,0,0,1
23273780,23274222,442,0,1,0,2
23273790,23274195,405,0,1,0,1
23274228,23274700,472,0,0,1,1
23274263,23274699,436,0,0,1,2
23274700,23274749,49,1,0,0,2
23274701,23274748,47,1,0,0,1
23274749,23275077,328,0,0,1,1
23274750,23275077,327,0,0,1,2
23275078,23275148,70,1,0,0,1
23275078,23275148,70,1,0,0,2
23275149,23275246,97,0,0,1,1
23275149,23275246,97,0,0,1,2
23275247,23275289,42,1,0,0,2
23275247,23275290,43,1,0,0,1
23275290,23275650,360,0,0,1,2
23275291,23275652,361,0,0,1,1
23275651,23275689,38,1,0,0,2
23275653,23275691,38,1,0,0,1
23275690,23275842,152,0,0,1,2
23275692,23275842,150,0,0,1,1
23275843,23275874,31,1,0,0,2
23275843,23275875,32,1,0,0,1
23275875,23276567,692,0,0,1,2
23275876,23276567,691,0,0,1,1
23276568,23276602,34,1,0,0,2
23276568,23276603,35,1,0,0,1
23276603,23277343,740,0,0,1,2
23276604,23276785,181,0,0,1,1
23276786,23276796,10,1,0,0,1
23276797,23277344,547,0,0,1,1
23277344,23277404,60,1,0,0,2
23277345,23277403,58,1,0,0,1
23277404,23277569,165,0,0,1,1
23277405,23277569,164,0,0,1,2
23277570,23277609,39,1,0,0,1
23277570,23277618,48,1,0,0,2
23277610,23279677,2067,0,0,1,1
23277619,23279677,2058,0,0,1,2
23279678,23280092,414,1,0,0,1
23279678,23280127,449,1,0,0,2
23279711,23280045,334,0,1,0,2
23279730,23279999,269,0,1,0,1
23280041,23280051,10,0,1,0,1
23280093,23280411,318,0,0,1,1
23280128,23280410,282,0,0,1,2
23280411,23280451,40,1,0,0,2
23280412,23280450,38,1,0,0,1
23280451,23280795,344,0,0,1,1
23280452,23280794,342,0,0,1,2
23280795,23280821,26,1,0,0,2
23280796,23280822,26,1,0,0,1
23280822,23281430,608,0,0,1,2
23280823,23281430,607,0,0,1,1
23281431,23281502,71,1,0,0,1
23281431,23281504,73,1,0,0,2
23281503,23281536,33,0,0,1,1
23281505,23281535,30,0,0,1,2
23281536,23281572,36,1,0,0,2
23281537,23281573,36,1,0,0,1
23281573,23281644,71,0,0,1,2
23281574,23281643,69,0,0,1,1
23281644,23281681,37,1,0,0,1
23281645,23281680,35,1,0,0,2
23281681,23283383,1702,0,0,1,2
23281682,23283383,1701,0,0,1,1
23283384,23283440,56,1,0,0,1
23283384,23283454,70,1,0,0,2
23283441,23283659,218,0,0,1,1
23283455,23283660,205,0,0,1,2
23283660,23283706,46,1,0,0,1
23283661,23283705,44,1,0,0,2
23283706,23285113,1407,0,0,1,2
23283707,23285113,1406,0,0,1,1
23285114,23285149,35,1,0,0,1
23285114,23285149,35,1,0,0,2
23285150,23285626,476,0,0,1,1
23285150,23285626,476,0,0,1,2
23285627,23285648,21,1,0,0,1
23285627,23285648,21,1,0,0,2
23285649,23285680,31,0,0,1,1
23285649,23285692,43,0,0,1,2
23285681,23286061,380,1,0,0,1
23285693,23286061,368,1,0,0,2
23285731,23286009,278,0,1,0,2
23285732,23285994,262,0,1,0,1
23286030,23286037,7,0,1,0,1
23286062,23286375,313,0,0,1,1
23286062,23286376,314,0,0,1,2
23286376,23286419,43,1,0,0,1
23286377,23286417,40,1,0,0,2
23286418,23286707,289,0,0,1,2
23286420,23286706,286,0,0,1,1
23286707,23286748,41,1,0,0,1
23286708,23286759,51,1,0,0,2
23286749,23287301,552,0,0,1,1
23286760,23287300,540,0,0,1,2
23287301,23287367,66,1,0,0,2
23287302,23287365,63,1,0,0,1
23287366,23287433,67,0,0,1,1
23287368,23287434,66,0,0,1,2
23287434,23287497,63,1,0,0,1
23287435,23287491,56,1,0,0,2
23287492,23287584,92,0,0,1,2
23287498,23287584,86,0,0,1,1
23287585,23287609,24,1,0,0,1
23287585,23287610,25,1,0,0,2
23287610,23287877,267,0,0,1,1
23287611,23287878,267,0,0,1,2
23287878,23287910,32,1,0,0,1
23287879,23287909,30,1,0,0,2
23287910,23289217,1307,0,0,1,2
23287911,23289021,1110,0,0,1,1
23289022,23289026,4,1,0,0,1
23289027,23289216,189,0,0,1,1
23289217,23289271,54,1,0,0,1
23289218,23289272,54,1,0,0,2
23289272,23289602,330,0,0,1,1
23289273,23289601,328,0,0,1,2
23289602,23289637,35,1,0,0,2
23289603,23289637,34,1,0,0,1
23289638,23291312,1674,0,0,1,2
23289638,23291408,1770,0,0,1,1
23291313,23291317,4,1,0,0,2
23291318,23291409,91,0,0,1,2
23291409,23291788,379,1,0,0,1
23291410,23292108,698,1,0,0,2
23291449,23291739,290,0,1,0,2
23291455,23291725,270,0,1,0,1
23291750,23291755,5,0,1,0,1
23291789,23291817,28,0,0,1,1
23291818,23292073,255,1,0,0,1
23291842,23292014,172,0,1,0,2
23291851,23291999,148,0,1,0,1
23292025,23292032,7,0,1,0,1
23292074,23292438,364,0,0,1,1
23292109,23292438,329,0,0,1,2
23292439,23292489,50,1,0,0,2
23292439,23292506,67,1,0,0,1
23292490,23292586,96,0,0,1,2
23292507,23292583,76,0,0,1,1
23292584,23292631,47,1,0,0,1
23292587,23292623,36,1,0,0,2
23292624,23292758,134,0,0,1,2
23292632,23292758,126,0,0,1,1
23292759,23292786,27,1,0,0,2
23292759,23292787,28,1,0,0,1
23292787,23293782,995,0,0,1,2
23292788,23293781,993,0,0,1,1
23293782,23293805,23,1,0,0,1
23293783,23293805,22,1,0,0,2
23293806,23294343,537,0,0,1,1
23293806,23294343,537,0,0,1,2
23294344,23294395,51,1,0,0,1
23294344,23294398,54,1,0,0,2
23294396,23294566,170,0,0,1,1
23294399,23294565,166,0,0,1,2
23294566,23294588,22,1,0,0,2
23294567,23294588,21,1,0,0,1
23294589,23297955,3366,0,0,1,2
23294589,23297956,3367,0,0,1,1
23297956,23298035,79,1,0,0,2
23297957,23298022,65,1,0,0,1
23298023,23298118,95,0,0,1,1
23298036,23298119,83,0,0,1,2
23298119,23298155,36,1,0,0,1
23298120,23298154,34,1,0,0,2
23298155,23298273,118,0,0,1,2
23298156,23298273,117,0,0,1,1
23298274,23298313,39,1,0,0,1
23298274,23298314,40,1,0,0,2
23298314,23299340,1026,0,0,1,1
23298315,23299338,1023,0,0,1,2
23299339,23299369,30,1,0,0,2
23299341,23299369,28,1,0,0,1
23299370,23299535,165,0,0,1,2
23299370,23299536,166,0,0,1,1
23299536,23299596,60,1,0,0,2
23299537,23299596,59,1,0,0,1
23299597,23299706,109,0,0,1,1
23299597,23299706,109,0,0,1,2
23299707,23299740,33,1,0,0,2
23299707,23299756,49,1,0,0,1
23299741,23299803,62,0,0,1,2
23299757,23299803,46,0,0,1,1
23299804,23299852,48,1,0,0,2
23299804,23299855,51,1,0,0,1
23299853,23301301,1448,0,0,1,2
23299856,23301296,1440,0,0,1,1
23301297,23301311,14,1,0,0,1
23301302,23301310,8,1,0,0,2
23301311,23301605,294,0,0,1,2
23301312,23301608,296,0,0,1,1
23301606,23301930,324,1,0,0,2
23301609,23301885,276,1,0,0,1
23301667,23301854,187,0,1,0,2
23301678,23301838,160,0,1,0,1
23301886,23302283,397,0,0,1,1
23301931,23302282,351,0,0,1,2
23302283,23302335,52,1,0,0,2
23302284,23302327,43,1,0,0,1
23302328,23302770,442,0,0,1,1
23302336,23302770,434,0,0,1,2
23302771,23302837,66,1,0,0,1
23302771,23302840,69,1,0,0,2
23302838,23302969,131,0,0,1,1
23302841,23302967,126,0,0,1,2
23302968,23303010,42,1,0,0,2
23302970,23303008,38,1,0,0,1
23303009,23303235,226,0,0,1,1
23303011,23303235,224,0,0,1,2
23303236,23303266,30,1,0,0,2
23303236,23303267,31,1,0,0,1
23303267,23303549,282,0,0,1,2
23303268,23303548,280,0,0,1,1
23303549,23303581,32,1,0,0,1
23303550,23303581,31,1,0,0,2
23303582,23304098,516,0,0,1,2
23303582,23304101,519,0,0,1,1
23304099,23304125,26,1,0,0,2
23304102,23304126,24,1,0,0,1
23304126,23304588,462,0,0,1,2
23304127,23304593,466,0,0,1,1
23304589,23304613,24,1,0,0,2
23304594,23304607,13,1,0,0,1
23304608,23305187,579,0,0,1,1
23304614,23305187,573,0,0,1,2
23305188,23305215,27,1,0,0,1
23305188,23305216,28,1,0,0,2
23305216,23305280,64,0,0,1,1
23305217,23305279,62,0,0,1,2
23305280,23305343,63,1,0,0,2
23305281,23305343,62,1,0,0,1
23305344,23305470,126,0,0,1,1
23305344,23305470,126,0,0,1,2
23305471,23305506,35,1,0,0,1
23305471,23305506,35,1,0,0,2
23305507,23307088,1581,0,0,1,1
23305507,23307090,1583,0,0,1,2
23307089,23307121,32,1,0,0,1
23307091,23307117,26,1,0,0,2
23307118,23307383,265,0,0,1,2
23307122,23307393,271,0,0,1,1
23307384,23307618,234,1,0,0,2
23307394,23307573,179,1,0,0,1
23307407,23307530,123,0,1,0,2
23307419,23307489,70,0,1,0,1
23307574,23307878,304,0,0,1,1
23307619,23307879,260,0,0,1,2
23307879,23307906,27,1,0,0,1
23307880,23307907,27,1,0,0,2
23307907,23308127,220,0,0,1,1
23307908,23308128,220,0,0,1,2
23308128,23308193,65,1,0,0,1
23308129,23308198,69,1,0,0,2
23308194,23308483,289,0,0,1,1
23308199,23308482,283,0,0,1,2
23308483,23308542,59,1,0,0,2
23308484,23308540,56,1,0,0,1
23308541,23308901,360,0,0,1,1
23308543,23308898,355,0,0,1,2
23308899,23308940,41,1,0,0,2
23308902,23308940,38,1,0,0,1
23308941,23309142,201,0,0,1,1
23308941,23309142,201,0,0,1,2
23309143,23309196,53,1,0,0,1
23309143,23309198,55,1,0,0,2
23309197,23309296,99,0,0,1,1
23309199,23309297,98,0,0,1,2
23309297,23309332,35,1,0,0,1
23309298,23309331,33,1,0,0,2
23309332,23309484,152,0,0,1,2
23309333,23309489,156,0,0,1,1
23309485,23309512,27,1,0,0,2
23309490,23309512,22,1,0,0,1
23309513,23310092,579,0,0,1,1
23309513,23310092,579,0,0,1,2
23310093,23310132,39,1,0,0,1
23310093,23310132,39,1,0,0,2
23310133,23310395,262,0,0,1,1
23310133,23310395,262,0,0,1,2
23310396,23310427,31,1,0,0,1
23310396,23310427,31,1,0,0,2
23310428,23310946,518,0,0,1,2
23310428,23310951,523,0,0,1,1
23310947,23310974,27,1,0,0,2
23310952,23310974,22,1,0,0,1
23310975,23311638,663,0,0,1,2
23310975,23311640,665,0,0,1,1
23311639,23311692,53,1,0,0,2
23311641,23311691,50,1,0,0,1
23311692,23311859,167,0,0,1,1
23311693,23311858,165,0,0,1,2
23311859,23311869,10,1,0,0,2
23311860,23311870,10,1,0,0,1
23311870,23313752,1882,0,0,1,2
23311871,23313752,1881,0,0,1,1
23313753,23313765,12,1,0,0,2
23313753,23313783,30,1,0,0,1
23313766,23313896,130,0,0,1,2
23313784,23313890,106,0,0,1,1
23313891,23314207,316,1,0,0,1
23313897,23314200,303,1,0,0,2
23313920,23314145,225,0,1,0,2
23313927,23314130,203,0,1,0,1
23314201,23314681,480,0,0,1,2
23314208,23314680,472,0,0,1,1
23314681,23314743,62,1,0,0,1
23314682,23314742,60,1,0,0,2
23314743,23315001,258,0,0,1,2
23314744,23315000,256,0,0,1,1
23315001,23315074,73,1,0,0,1
23315002,23315074,72,1,0,0,2
23315075,23315391,316,0,0,1,1
23315075,23315391,316,0,0,1,2
23315392,23315457,65,1,0,0,2
23315392,23315465,73,1,0,0,1
23315458,23315560,102,0,0,1,2
23315466,23315562,96,0,0,1,1
23315561,23315592,31,1,0,0,2
23315563,23315592,29,1,0,0,1
23315593,23315851,258,0,0,1,1
23315593,23315851,258,0,0,1,2
23315852,23315882,30,1,0,0,2
23315852,23315883,31,1,0,0,1
23315883,23316029,146,0,0,1,2
23315884,23316021,137,0,0,1,1
23316022,23316304,282,1,0,0,1
23316030,23316460,430,1,0,0,2
23316046,23316317,271,0,1,0,2
23316051,23316277,226,0,1,0,1
23316305,23316325,20,0,0,1,1
23316326,23316431,105,1,0,0,1
23316348,23316360,12,0,1,0,1
23316432,23317079,647,0,0,1,1
23316461,23317081,620,0,0,1,2
23317080,23317111,31,1,0,0,1
23317082,23317109,27,1,0,0,2
23317110,23317230,120,0,0,1,2
23317112,23317229,117,0,0,1,1
23317230,23317296,66,1,0,0,1
23317231,23317290,59,1,0,0,2
23317291,23317779,488,0,0,1,2
23317297,23317778,481,0,0,1,1
23317779,23317809,30,1,0,0,1
23317780,23317809,29,1,0,0,2
23317810,23319341,1531,0,0,1,1
23317810,23319355,1545,0,0,1,2
23319342,23319664,322,1,0,0,1
23319356,23319696,340,1,0,0,2
23319386,23319631,245,0,1,0,1
23319386,23319632,246,0,1,0,2
23319665,23319711,46,0,0,1,1
23319697,23319901,204,0,0,1,2
23319712,23319757,45,1,0,0,1
23319758,23319900,142,0,0,1,1
23319901,23319957,56,1,0,0,1
23319902,23319956,54,1,0,0,2
23319957,23320210,253,0,0,1,2
23319958,23320212,254,0,0,1,1
23320211,23320248,37,1,0,0,2
23320213,23320249,36,1,0,0,1
23320249,23320600,351,0,0,1,2
23320250,23320598,348,0,0,1,1
23320599,23320662,63,1,0,0,1
23320601,23320662,61,1,0,0,2
23320663,23320765,102,0,0,1,1
23320663,23320766,103,0,0,1,2
23320766,23320802,36,1,0,0,1
23320767,23320806,39,1,0,0,2
23320803,23321064,261,0,0,1,1
23320807,23321964,1157,0,0,1,2
23321065,23321081,16,1,0,0,1
23321082,23321964,882,0,0,1,1
23321965,23321992,27,1,0,0,2
23321965,23321995,30,1,0,0,1
23321993,23322525,532,0,0,1,2
23321996,23322522,526,0,0,1,1
23322523,23322595,72,1,0,0,1
23322526,23322571,45,1,0,0,2
23322572,23322750,178,0,0,1,2
23322596,23322730,134,0,0,1,1
23322731,23322785,54,1,0,0,1
23322751,23322786,35,1,0,0,2
23322786,23323159,373,0,0,1,1
23322787,23323157,370,0,0,1,2
23323158,23323199,41,1,0,0,2
23323160,23323199,39,1,0,0,1
23323200,23324642,1442,0,0,1,2
23323200,23324905,1705,0,0,1,1
23324643,23324653,10,1,0,0,2
23324654,23324906,252,0,0,1,2
23324906,23325296,390,1,0,0,1
23324907,23325271,364,1,0,0,2
23324947,23325211,264,0,1,0,2
23324954,23325197,243,0,1,0,1
23325219,23325223,4,0,1,0,1
23325272,23325839,567,0,0,1,2
23325297,23325838,541,0,0,1,1
23325839,23325896,57,1,0,0,1
23325840,23325896,56,1,0,0,2
23325897,23326160,263,0,0,1,1
23325897,23326160,263,0,0,1,2
23326161,23326222,61,1,0,0,1
23326161,23326222,61,1,0,0,2
23326223,23326315,92,0,0,1,1
23326223,23326316,93,0,0,1,2
23326316,23326339,23,1,0,0,1
23326317,23326345,28,1,0,0,2
23326340,23326520,180,0,0,1,1
23326346,23326519,173,0,0,1,2
23326520,23326549,29,1,0,0,2
23326521,23326549,28,1,0,0,1
23326550,23328393,1843,0,0,1,1
23326550,23328396,1846,0,0,1,2
23328394,23328447,53,1,0,0,1
23328397,23328447,50,1,0,0,2
23328448,23328565,117,0,0,1,2
23328448,23328566,118,0,0,1,1
23328566,23328602,36,1,0,0,2
23328567,23328602,35,1,0,0,1
23328603,23329113,510,0,0,1,1
23328603,23329120,517,0,0,1,2
23329114,23329129,15,1,0,0,1
23329121,23329131,10,1,0,0,2
23329130,23330533,1403,0,0,1,1
23329132,23330533,1401,0,0,1,2
23330534,23330544,10,1,0,0,2
23330534,23330548,14,1,0,0,1
23330545,23330587,42,0,0,1,2
23330549,23330575,26,0,0,1,1
23330576,23330882,306,1,0,0,1
23330588,23330900,312,1,0,0,2
23330614,23330823,209,0,1,0,2
23330618,23330806,188,0,1,0,1
23330883,23331128,245,0,0,1,1
23330901,23331128,227,0,0,1,2
23331129,23331191,62,1,0,0,2
23331129,23331192,63,1,0,0,1
23331192,23331556,364,0,0,1,2
23331193,23331557,364,0,0,1,1
23331557,23331597,40,1,0,0,2
23331558,23331590,32,1,0,0,1
23331591,23331820,229,0,0,1,1
23331598,23331819,221,0,0,1,2
23331820,23331880,60,1,0,0,2
23331821,23331880,59,1,0,0,1
23331881,23332114,233,0,0,1,1
23331881,23332114,233,0,0,1,2
23332115,23332189,74,1,0,0,1
23332115,23332189,74,1,0,0,2
23332190,23332407,217,0,0,1,2
23332190,23332408,218,0,0,1,1
23332408,23332434,26,1,0,0,2
23332409,23332439,30,1,0,0,1
23332435,23332520,85,0,0,1,2
23332440,23332520,80,0,0,1,1
23332521,23332574,53,1,0,0,2
23332521,23332575,54,1,0,0,1
23332575,23332814,239,0,0,1,2
23332576,23332813,237,0,0,1,1
23332814,23332851,37,1,0,0,1
23332815,23332848,33,1,0,0,2
23332849,23333538,689,0,0,1,2
23332852,23333537,685,0,0,1,1
23333538,23333568,30,1,0,0,1
23333539,23333571,32,1,0,0,2
23333569,23333781,212,0,0,1,1
23333572,23333782,210,0,0,1,2
23333782,23333835,53,1,0,0,1
23333783,23333832,49,1,0,0,2
23333833,23333962,129,0,0,1,2
23333836,23333963,127,0,0,1,1
23333963,23334003,40,1,0,0,2
23333964,23334001,37,1,0,0,1
23334002,23334866,864,0,0,1,1
23334004,23334867,863,0,0,1,2
23334867,23334903,36,1,0,0,1
23334868,23334900,32,1,0,0,2
23334901,23335154,253,0,0,1,2
23334904,23335155,251,0,0,1,1
23335155,23335188,33,1,0,0,2
23335156,23335189,33,1,0,0,1
23335189,23335955,766,0,0,1,2
23335190,23335439,249,0,0,1,1
23335440,23335445,5,1,0,0,1
23335446,23335971,525,0,0,1,1
23335956,23336773,817,1,0,0,2
23335972,23336765,793,1,0,0,1
23335983,23336389,406,0,1,0,2
23336003,23336431,428,0,1,0,1
23336442,23336687,245,0,1,0,2
23336458,23336666,208,0,1,0,1
23336766,23337040,274,0,0,1,1
23336774,23336919,145,0,0,1,2
23336920,23336965,45,1,0,0,2
23336966,23337042,76,0,0,1,2
23337041,23337115,74,1,0,0,1
23337043,23337113,70,1,0,0,2
23337114,23337211,97,0,0,1,2
23337116,23337212,96,0,0,1,1
23337212,23337255,43,1,0,0,2
23337213,23337254,41,1,0,0,1
23337255,23337473,218,0,0,1,1
23337256,23337475,219,0,0,1,2
23337474,23337507,33,1,0,0,1
23337476,23337514,38,1,0,0,2
23337508,23337804,296,0,0,1,1
23337515,23338443,928,0,0,1,2
23337815,23337827,12,0,1,0,1
23337837,23337922,85,1,0,0,1
23337861,23337870,9,0,1,0,1
23337902,23337913,11,0,1,0,1
23337923,23338022,99,0,0,1,1
23338033,23338036,3,0,1,0,1
23338045,23338045,0,1,0,0,1
23338046,23338136,90,0,0,1,1
23338147,23338217,70,0,1,0,1
23338226,23338226,0,1,0,0,1
23338227,23338288,61,0,0,1,1
23338299,23338301,2,0,1,0,1
23338310,23338310,0,1,0,0,1
23338311,23338369,58,0,0,1,1
23338380,23338481,101,0,1,0,1
23338444,23338471,27,1,0,0,2
23338472,23339217,745,0,0,1,2
23338490,23338490,0,1,0,0,1
23338491,23338531,40,0,0,1,1
23338542,23339320,778,0,1,0,1
23339218,23339227,9,1,0,0,2
23339228,23339282,54,0,0,1,2
23339283,23339324,41,1,0,0,2
23339325,23339594,269,0,0,1,2
23339330,23339367,37,1,0,0,1
23339368,23339592,224,0,0,1,1
23339593,23339627,34,1,0,0,1
23339595,23339625,30,1,0,0,2
23339626,23341085,1459,0,0,1,2
23339628,23340270,642,0,0,1,1
23340271,23340288,17,1,0,0,1
23340289,23341364,1075,0,0,1,1
23341086,23341090,4,1,0,0,2
23341091,23341364,273,0,0,1,2
23341365,23341392,27,1,0,0,1
23341365,23341394,29,1,0,0,2
23341393,23341605,212,0,0,1,1
23341395,23341606,211,0,0,1,2
23341606,23341966,360,1,0,0,1
23341607,23342018,411,1,0,0,2
23341674,23342008,334,0,1,0,2
23341681,23341936,255,0,1,0,1
23341967,23341991,24,0,0,1,1
23342002,23342035,33,0,1,0,1
23342019,23342070,51,0,0,1,2
23342045,23342045,0,1,0,0,1
23342046,23342073,27,0,0,1,1
23342071,23342176,105,1,0,0,2
23342074,23342134,60,1,0,0,1
23342116,23342116,0,0,1,0,2
23342135,23342372,237,0,0,1,1
23342177,23342296,119,0,0,1,2
23342297,23342334,37,1,0,0,2
23342335,23342372,37,0,0,1,2
23342373,23342416,43,1,0,0,1
23342373,23342420,47,1,0,0,2
23342417,23342695,278,0,0,1,1
23342421,23342698,277,0,0,1,2
23342696,23342718,22,1,0,0,1
23342699,23342718,19,1,0,0,2
23342719,23342949,230,0,0,1,1
23342719,23342949,230,0,0,1,2
23342950,23342988,38,1,0,0,2
23342950,23342994,44,1,0,0,1
23342989,23343212,223,0,0,1,2
23342995,23343213,218,0,0,1,1
23343213,23343276,63,1,0,0,2
23343214,23343277,63,1,0,0,1
23343277,23343316,39,0,0,1,2
23343278,23343316,38,0,0,1,1
23343317,23343353,36,1,0,0,2
23343317,23343355,38,1,0,0,1
23343354,23343457,103,0,0,1,2
23343356,23343457,101,0,0,1,1
23343458,23343485,27,1,0,0,1
23343458,23343485,27,1,0,0,2
23343486,23343688,202,0,0,1,1
23343486,23343690,204,0,0,1,2
23343689,23343725,36,1,0,0,1
23343691,23343726,35,1,0,0,2
23343726,23343876,150,0,0,1,1
23343727,23343880,153,0,0,1,2
23343877,23343909,32,1,0,0,1
23343881,23343908,27,1,0,0,2
23343909,23344625,716,0,0,1,2
23343910,23344620,710,0,0,1,1
23344621,23344643,22,1,0,0,1
23344626,23344640,14,1,0,0,2
23344641,23345560,919,0,0,1,2
23344644,23345561,917,0,0,1,1
23345561,23345631,70,1,0,0,2
23345562,23345619,57,1,0,0,1
23345620,23345732,112,0,0,1,1
23345632,23345732,100,0,0,1,2
23345733,23345769,36,1,0,0,1
23345733,23345769,36,1,0,0,2
23345770,23347047,1277,0,0,1,2
23345770,23347048,1278,0,0,1,1
23347048,23347085,37,1,0,0,2
23347049,23347085,36,1,0,0,1
23347086,23347696,610,0,0,1,1
23347086,23347698,612,0,0,1,2
23347697,23348107,410,1,0,0,1
23347699,23348119,420,1,0,0,2
23347772,23348049,277,0,1,0,2
23347784,23348014,230,0,1,0,1
23348069,23348076,7,0,1,0,1
23348072,23348074,2,0,1,0,2
23348108,23348460,352,0,0,1,1
23348120,23348264,144,0,0,1,2
23348265,23348338,73,1,0,0,2
23348339,23348461,122,0,0,1,2
23348461,23348498,37,1,0,0,1
23348462,23348499,37,1,0,0,2
23348499,23349031,532,0,0,1,1
23348500,23349031,531,0,0,1,2
23349032,23349036,4,1,0,0,1
23349032,23349042,10,1,0,0,2
23349037,23349220,183,0,0,1,1
23349043,23349222,179,0,0,1,2
23349221,23349268,47,1,0,0,1
23349223,23349269,46,1,0,0,2
23349269,23349545,276,0,0,1,1
23349270,23349547,277,0,0,1,2
23349546,23349586,40,1,0,0,1
23349548,23349598,50,1,0,0,2
23349587,23349715,128,0,0,1,1
23349599,23349713,114,0,0,1,2
23349714,23349748,34,1,0,0,2
23349716,23349747,31,1,0,0,1
23349748,23349854,106,0,0,1,1
23349749,23349855,106,0,0,1,2
23349855,23349895,40,1,0,0,1
23349856,23349887,31,1,0,0,2
23349888,23350778,890,0,0,1,2
23349896,23350777,881,0,0,1,1
23350778,23350796,18,1,0,0,1
23350779,23350801,22,1,0,0,2
23350797,23351068,271,0,0,1,1
23350802,23351068,266,0,0,1,2
23351069,23351121,52,1,0,0,2
23351069,23351122,53,1,0,0,1
23351122,23351216,94,0,0,1,2
23351123,23351216,93,0,0,1,1
23351217,23351249,32,1,0,0,1
23351217,23351249,32,1,0,0,2
23351250,23351339,89,0,0,1,1
23351250,23351339,89,0,0,1,2
23351340,23351372,32,1,0,0,2
23351340,23351373,33,1,0,0,1
23351373,23353031,1658,0,0,1,2
23351374,23353024,1650,0,0,1,1
23353025,23354013,988,1,0,0,1
23353032,23354031,999,1,0,0,2
23353059,23353263,204,0,1,0,2
23353067,23353233,166,0,1,0,1
23353404,23353693,289,0,1,0,2
23353415,23353680,265,0,1,0,1
23353715,23353715,0,0,1,0,1
23353809,23353977,168,0,1,0,2
23353816,23353959,143,0,1,0,1
23353983,23353986,3,0,1,0,1
23354014,23354239,225,0,0,1,1
23354032,23354239,207,0,0,1,2
23354240,23354307,67,1,0,0,2
23354240,23354308,68,1,0,0,1
23354308,23354384,76,0,0,1,2
23354309,23354382,73,0,0,1,1
23354383,23354406,23,1,0,0,1
23354385,23354406,21,1,0,0,2
23354407,23354639,232,0,0,1,1
23354407,23354640,233,0,0,1,2
23354640,23354677,37,1,0,0,1
23354641,23354671,30,1,0,0,2
23354672,23356342,1670,0,0,1,2
23354678,23356340,1662,0,0,1,1
23356341,23356394,53,1,0,0,1
23356343,23356387,44,1,0,0,2
23356388,23358493,2105,0,0,1,2
23356395,23358499,2104,0,0,1,1
23358494,23358526,32,1,0,0,2
23358500,23358526,26,1,0,0,1
23358527,23358636,109,0,0,1,2
23358527,23358642,115,0,0,1,1
23358637,23358954,317,1,0,0,2
23358643,23358949,306,1,0,0,1
23358660,23358886,226,0,1,0,2
23358667,23358869,202,0,1,0,1
23358899,23358910,11,0,1,0,1
23358950,23359185,235,0,0,1,1
23358955,23359184,229,0,0,1,2
23359185,23359223,38,1,0,0,2
23359186,23359223,37,1,0,0,1
23359224,23359484,260,0,0,1,2
23359224,23359485,261,0,0,1,1
23359485,23359527,42,1,0,0,2
23359486,23359526,40,1,0,0,1
23359527,23359827,300,0,0,1,1
23359528,23359828,300,0,0,1,2
23359828,23359874,46,1,0,0,1
23359829,23359883,54,1,0,0,2
23359875,23360130,255,0,0,1,1
23359884,23360127,243,0,0,1,2
23360128,23360182,54,1,0,0,2
23360131,23360183,52,1,0,0,1
23360183,23360297,114,0,0,1,2
23360184,23360297,113,0,0,1,1
23360298,23360324,26,1,0,0,2
23360298,23360332,34,1,0,0,1
23360325,23360602,277,0,0,1,2
23360333,23360602,269,0,0,1,1
23360603,23360636,33,1,0,0,1
23360603,23360644,41,1,0,0,2
23360637,23360728,91,0,0,1,1
23360645,23360727,82,0,0,1,2
23360728,23360758,30,1,0,0,2
23360729,23360757,28,1,0,0,1
23360758,23361056,298,0,0,1,1
23360759,23361058,299,0,0,1,2
23361057,23361099,42,1,0,0,1
23361059,23361090,31,1,0,0,2
23361091,23361289,198,0,0,1,2
23361100,23361288,188,0,0,1,1
23361289,23361324,35,1,0,0,1
23361290,23361322,32,1,0,0,2
23361323,23361523,200,0,0,1,2
23361325,23361521,196,0,0,1,1
23361522,23361555,33,1,0,0,1
23361524,23361554,30,1,0,0,2
23361555,23361806,251,0,0,1,2
23361556,23361807,251,0,0,1,1
23361807,23361837,30,1,0,0,2
23361808,23361839,31,1,0,0,1
23361838,23362055,217,0,0,1,2
23361840,23362055,215,0,0,1,1
23362056,23362271,215,1,0,0,1
23362056,23362293,237,1,0,0,2
23362080,23362203,123,0,1,0,2
23362089,23362186,97,0,1,0,1
23362272,23362396,124,0,0,1,1
23362294,23362391,97,0,0,1,2
23362392,23363446,1054,1,0,0,2
23362397,23363448,1051,1,0,0,1
23362414,23363432,1018,0,1,0,2
23362419,23363437,1018,0,1,0,1
23363447,23363591,144,0,0,1,2
23363449,23363606,157,0,0,1,1
23363592,23363818,226,1,0,0,2
23363607,23363817,210,1,0,0,1
23363626,23363774,148,0,1,0,2
23363628,23363785,157,0,1,0,1
23363818,23363967,149,0,0,1,1
23363819,23363967,148,0,0,1,2
23363968,23364005,37,1,0,0,1
23363968,23364005,37,1,0,0,2
23364006,23364316,310,0,0,1,2
23364006,23364317,311,0,0,1,1
23364317,23364345,28,1,0,0,2
23364318,23364344,26,1,0,0,1
23364345,23364549,204,0,0,1,1
23364346,23364549,203,0,0,1,2
23479284,23479512,228,0,0,1,2
23479284,23479513,229,0,0,1,1
23479513,23479576,63,1,0,0,2
23479514,23479576,62,1,0,0,1
23479577,23479638,61,0,0,1,1
23479577,23479638,61,0,0,1,2
23479639,23479682,43,1,0,0,1
23479639,23479683,44,1,0,0,2
23479683,23479865,182,0,0,1,1
23479684,23479863,179,0,0,1,2
23479864,23479906,42,1,0,0,2
23479866,23479898,32,1,0,0,1
23479899,23480325,426,0,0,1,1
23479907,23480326,419,0,0,1,2
23480326,23480356,30,1,0,0,1
23480327,23480356,29,1,0,0,2
23480357,23482234,1877,0,0,1,2
23480357,23482235,1878,0,0,1,1
23482235,23482284,49,1,0,0,2
23482236,23482285,49,1,0,0,1
23482285,23482378,93,0,0,1,2
23482286,23482379,93,0,0,1,1
23482379,23482485,106,1,0,0,2
23482380,23482479,99,1,0,0,1
23482442,23482447,5,0,1,0,2
23482480,23482625,145,0,0,1,1
23482486,23482608,122,0,0,1,2
23482619,23482620,1,0,1,0,2
23482626,23482662,36,1,0,0,1
23482630,23482648,18,1,0,0,2
23482649,23482869,220,0,0,1,2
23482663,23482864,201,0,0,1,1
23482865,23482899,34,1,0,0,1
23482870,23482893,23,1,0,0,2
23482894,23482932,38,0,0,1,2
23482900,23483162,262,0,0,1,1
23482943,23482943,0,0,1,0,2
23482952,23482952,0,1,0,0,2
23482953,23483026,73,0,0,1,2
23483037,23483075,38,0,1,0,2
23483084,23483084,0,1,0,0,2
23483085,23483161,76,0,0,1,2
23483162,23483194,32,1,0,0,2
23483163,23483193,30,1,0,0,1
23483194,23483425,231,0,0,1,1
23483195,23483426,231,0,0,1,2
23483426,23483582,156,1,0,0,1
23483427,23483670,243,1,0,0,2
23483443,23483552,109,0,1,0,2
23483449,23483472,23,0,1,0,1
23483508,23483514,6,0,1,0,1
23483583,23484511,928,0,0,1,1
23483671,23483734,63,0,0,1,2
23483735,23483754,19,1,0,0,2
23483755,23484512,757,0,0,1,2
23484512,23484599,87,1,0,0,1
23484513,23484599,86,1,0,0,2
23484600,23484939,339,0,0,1,1
23484600,23484941,341,0,0,1,2
23484940,23485016,76,1,0,0,1
23484942,23485013,71,1,0,0,2
23485014,23485086,72,0,0,1,2
23485017,23485087,70,0,0,1,1
23485087,23485136,49,1,0,0,2
23485088,23485130,42,1,0,0,1
23485131,23486208,1077,0,0,1,1
23485137,23486207,1070,0,0,1,2
23486208,23486280,72,1,0,0,2
23486209,23486288,79,1,0,0,1
23486281,23486735,454,0,0,1,2
23486289,23486735,446,0,0,1,1
23486736,23486813,77,1,0,0,1
23486736,23486820,84,1,0,0,2
23486814,23486893,79,0,0,1,1
23486821,23486892,71,0,0,1,2
23486893,23486934,41,1,0,0,2
23486894,23486934,40,1,0,0,1
23486935,23487056,121,0,0,1,1
23486935,23487061,126,0,0,1,2
23487057,23487083,26,1,0,0,1
23487072,23487158,86,0,1,0,2
23487084,23487259,175,0,0,1,1
23487168,23487210,42,1,0,0,2
23487188,23487201,13,0,1,0,2
23487211,23487233,22,0,0,1,2
23487244,23487246,2,0,1,0,2
23487256,23487306,50,1,0,0,2
23487260,23487288,28,1,0,0,1
23487286,23487297,11,0,1,0,2
23487289,23487895,606,0,0,1,1
23487307,23487342,35,0,0,1,2
23487353,23487374,21,0,1,0,2
23487383,23487383,0,1,0,0,2
23487384,23487894,510,0,0,1,2
23487895,23488013,118,1,0,0,2
23487896,23488011,115,1,0,0,1
23488012,23488305,293,0,0,1,1
23488014,23488305,291,0,0,1,2
23488306,23488376,70,1,0,0,1
23488306,23488386,80,1,0,0,2
23488377,23488487,110,0,0,1,1
23488387,23488489,102,0,0,1,2
23488488,23488547,59,1,0,0,1
23488490,23488542,52,1,0,0,2
23488523,23488538,15,0,1,0,1
23488543,23489126,583,0,0,1,2
23488548,23488585,37,0,0,1,1
23488596,23488677,81,0,1,0,1
23488687,23489443,756,1,0,0,1
23488717,23489423,706,0,1,0,1
23489127,23489438,311,1,0,0,2
23489161,23489372,211,0,1,0,2
23489439,23489571,132,0,0,1,2
23489444,23489572,128,0,0,1,1
23489572,23489660,88,1,0,0,2
23489573,23489654,81,1,0,0,1
23489655,23489958,303,0,0,1,1
23489661,23489958,297,0,0,1,2
23489959,23490010,51,1,0,0,1
23489959,23490017,58,1,0,0,2
23490011,23490097,86,0,0,1,1
23490018,23490101,83,0,0,1,2
23490098,23490140,42,1,0,0,1
23490102,23490138,36,1,0,0,2
23490139,23490200,61,0,0,1,2
23490141,23490200,59,0,0,1,1
23490201,23490237,36,1,0,0,1
23490201,23490237,36,1,0,0,2
23490238,23491135,897,0,0,1,1
23490238,23491137,899,0,0,1,2
23491136,23491972,836,1,0,0,1
23491138,23492003,865,1,0,0,2
23491190,23491992,802,0,1,0,2
23491195,23491961,766,0,1,0,1
23491973,23492105,132,0,0,1,1
23492004,23492098,94,0,0,1,2
23492099,23492180,81,1,0,0,2
23492106,23492172,66,1,0,0,1
23492173,23492277,104,0,0,1,1
23492181,23492277,96,0,0,1,2
23492278,23492319,41,1,0,0,1
23492278,23492322,44,1,0,0,2
23492320,23492471,151,0,0,1,1
23492323,23492471,148,0,0,1,2
23492472,23492506,34,1,0,0,1
23492472,23492525,53,1,0,0,2
23492507,23493856,1349,0,0,1,1
23492526,23493857,1331,0,0,1,2
23493857,23494030,173,1,0,0,1
23493858,23494031,173,1,0,0,2
23493889,23493966,77,0,1,0,2
23493892,23493963,71,0,1,0,1
23494031,23494346,315,0,0,1,1
23494032,23494345,313,0,0,1,2
23494346,23494398,52,1,0,0,2
23494347,23494406,59,1,0,0,1
23494399,23494453,54,0,0,1,2
23494407,23494453,46,0,0,1,1
23494454,23494497,43,1,0,0,1
23494454,23494498,44,1,0,0,2
23494498,23494553,55,0,0,1,1
23494499,23494553,54,0,0,1,2
23494554,23494580,26,1,0,0,1
23494554,23494591,37,1,0,0,2
23494581,23494994,413,0,0,1,1
23494592,23494996,404,0,0,1,2
23494995,23495025,30,1,0,0,1
23494997,23495025,28,1,0,0,2
23495026,23495969,943,0,0,1,2
23495026,23495970,944,0,0,1,1
23495970,23496033,63,1,0,0,2
23495971,23496028,57,1,0,0,1
23496029,23496166,137,0,0,1,1
23496034,23496167,133,0,0,1,2
23496167,23496219,52,1,0,0,1
23496168,23496218,50,1,0,0,2
23496219,23496299,80,0,0,1,2
23496220,23496298,78,0,0,1,1
23496299,23496355,56,1,0,0,1
23496300,23496349,49,1,0,0,2
23496350,23496390,40,0,0,1,2
23496356,23496390,34,0,0,1,1
23496391,23496438,47,1,0,0,1
23496391,23496439,48,1,0,0,2
23496439,23496535,96,0,0,1,1
23496440,23496534,94,0,0,1,2
23496535,23496573,38,1,0,0,2
23496536,23496596,60,1,0,0,1
23496574,23496751,177,0,0,1,2
23496597,23496753,156,0,0,1,1
23496752,23496776,24,1,0,0,2
23496754,23496773,19,1,0,0,1
23496774,23497001,227,0,0,1,1
23496777,23497000,223,0,0,1,2
23497001,23497031,30,1,0,0,2
23497002,23497031,29,1,0,0,1
23497032,23497631,599,0,0,1,2
23497032,23497632,600,0,0,1,1
23497632,23497693,61,1,0,0,2
23497633,23497692,59,1,0,0,1
23497693,23497801,108,0,0,1,1
23497694,23497799,105,0,0,1,2
23497800,23497855,55,1,0,0,2
23497802,23497846,44,1,0,0,1
23497847,23498085,238,0,0,1,1
23497856,23498085,229,0,0,1,2
23498086,23498119,33,1,0,0,1
23498086,23498120,34,1,0,0,2
23498120,23498326,206,0,0,1,1
23498121,23498327,206,0,0,1,2
23498327,23498358,31,1,0,0,1
23498328,23498358,30,1,0,0,2
23498359,23498780,421,0,0,1,1
23498359,23499083,724,0,0,1,2
23498781,23498901,120,1,0,0,1
23498902,23499081,179,0,0,1,1
23499082,23499127,45,1,0,0,1
23499084,23499109,25,1,0,0,2
23499110,23499356,246,0,0,1,2
23499128,23499289,161,0,0,1,1
23499290,23499299,9,1,0,0,1
23499300,23499356,56,0,0,1,1
23499357,23499365,8,1,0,0,1
23499357,23499365,8,1,0,0,2
23499366,23499895,529,0,0,1,1
23499366,23499896,530,0,0,1,2
23499896,23499974,78,1,0,0,1
23499897,23499976,79,1,0,0,2
23499975,23500032,57,0,0,1,1
23499977,23500032,55,0,0,1,2
23500033,23500072,39,1,0,0,1
23500033,23500073,40,1,0,0,2
23500073,23500162,89,0,0,1,1
23500074,23500163,89,0,0,1,2
23500163,23500197,34,1,0,0,1
23500164,23500196,32,1,0,0,2
23500197,23501159,962,0,0,1,2
23500198,23501159,961,0,0,1,1
23501160,23501243,83,1,0,0,1
23501160,23501244,84,1,0,0,2
23501244,23501601,357,0,0,1,1
23501245,23501601,356,0,0,1,2
23501602,23501647,45,1,0,0,2
23501602,23501649,47,1,0,0,1
23501648,23501754,106,0,0,1,2
23501650,23501755,105,0,0,1,1
23501755,23501795,40,1,0,0,2
23501756,23501785,29,1,0,0,1
23501786,23502742,956,0,0,1,1
23501796,23502742,946,0,0,1,2
23502743,23502780,37,1,0,0,2
23502743,23502797,54,1,0,0,1
23502781,23502883,102,0,0,1,2
23502798,23502884,86,0,0,1,1
23502884,23502935,51,1,0,0,2
23502885,23502935,50,1,0,0,1
23502936,23503061,125,0,0,1,2
23502936,23503062,126,0,0,1,1
23503062,23503108,46,1,0,0,2
23503063,23503108,45,1,0,0,1
23503109,23503196,87,0,0,1,2
23503109,23503197,88,0,0,1,1
23503197,23503241,44,1,0,0,2
23503198,23503235,37,1,0,0,1
23503236,23503867,631,0,0,1,1
23503242,23503868,626,0,0,1,2
23503868,23503899,31,1,0,0,1
23503869,23503898,29,1,0,0,2
23503899,23504371,472,0,0,1,2
23503900,23504370,470,0,0,1,1
23504371,23504475,104,1,0,0,1
23504372,23504474,102,1,0,0,2
23504475,23504809,334,0,0,1,2
23504476,23504810,334,0,0,1,1
23504810,23504896,86,1,0,0,2
23504811,23504896,85,1,0,0,1
23504897,23504950,53,0,0,1,2
23504897,23504951,54,0,0,1,1
23504951,23505000,49,1,0,0,2
23504952,23505007,55,1,0,0,1
23505001,23506157,1156,0,0,1,2
23505008,23506156,1148,0,0,1,1
23506157,23506242,85,1,0,0,1
23506158,23506242,84,1,0,0,2
23506243,23506640,397,0,0,1,2
23506243,23506641,398,0,0,1,1
23506641,23506702,61,1,0,0,2
23506642,23506730,88,1,0,0,1
23506703,23506798,95,0,0,1,2
23506731,23506798,67,0,0,1,1
23506799,23506832,33,1,0,0,2
23506799,23506841,42,1,0,0,1
23506833,23506908,75,0,0,1,2
23506842,23506905,63,0,0,1,1
23506906,23506951,45,1,0,0,1
23506909,23506930,21,1,0,0,2
23506931,23507772,841,0,0,1,2
23506952,23508050,1098,0,0,1,1
23507773,23507777,4,1,0,0,2
23507778,23508051,273,0,0,1,2
23508051,23508129,78,1,0,0,1
23508052,23508129,77,1,0,0,2
23508130,23508217,87,0,0,1,1
23508130,23508219,89,0,0,1,2
23508218,23508306,88,1,0,0,1
23508220,23508297,77,1,0,0,2
23508298,23508360,62,0,0,1,2
23508307,23508361,54,0,0,1,1
23508361,23508406,45,1,0,0,2
23508362,23508401,39,1,0,0,1
23508402,23508581,179,0,0,1,1
23508407,23508581,174,0,0,1,2
23508582,23508614,32,1,0,0,1
23508582,23508616,34,1,0,0,2
23508615,23509557,942,0,0,1,1
23508617,23509559,942,0,0,1,2
23509558,23509640,82,1,0,0,1
23509560,23509640,80,1,0,0,2
23509641,23510073,432,0,0,1,1
23509641,23510074,433,0,0,1,2
23510074,23510153,79,1,0,0,1
23510075,23510142,67,1,0,0,2
23510143,23510226,83,0,0,1,2
23510154,23510225,71,0,0,1,1
23510226,23510276,50,1,0,0,1
23510227,23510275,48,1,0,0,2
23510276,23510349,73,0,0,1,2
23510277,23510349,72,0,0,1,1
23510350,23510382,32,1,0,0,1
23510350,23510384,34,1,0,0,2
23510383,23511491,1108,0,0,1,1
23510385,23511489,1104,0,0,1,2
23511490,23511581,91,1,0,0,2
23511492,23511572,80,1,0,0,1
23511573,23511931,358,0,0,1,1
23511582,23511931,349,0,0,1,2
23511932,23511981,49,1,0,0,2
23511932,23511988,56,1,0,0,1
23511982,23512061,79,0,0,1,2
23511989,23512061,72,0,0,1,1
23512062,23512096,34,1,0,0,1
23512062,23512096,34,1,0,0,2
23512097,23512154,57,0,0,1,1
23512097,23512155,58,0,0,1,2
23512155,23512187,32,1,0,0,1
23512156,23512187,31,1,0,0,2
23512188,23512333,145,0,0,1,1
23512188,23512336,148,0,0,1,2
23512334,23512354,20,1,0,0,1
23512337,23512359,22,1,0,0,2
23512355,23513514,1159,0,0,1,1
23512360,23513516,1156,0,0,1,2
23513515,23513584,69,1,0,0,1
23513517,23513591,74,1,0,0,2
23513585,23513654,69,0,0,1,1
23513592,23513657,65,0,0,1,2
23513655,23513690,35,1,0,0,1
23513658,23513701,43,1,0,0,2
23513691,23513936,245,0,0,1,1
23513702,23513938,236,0,0,1,2
23513937,23513974,37,1,0,0,1
23513939,23513975,36,1,0,0,2
23513975,23514402,427,0,0,1,1
23513976,23514400,424,0,0,1,2
23514401,23514656,255,1,0,0,2
23514403,23514643,240,1,0,0,1
23514445,23514604,159,0,1,0,2
23514459,23514578,119,0,1,0,1
23514644,23514883,239,0,0,1,1
23514657,23514882,225,0,0,1,2
23514883,23514979,96,1,0,0,2
23514884,23514971,87,1,0,0,1
23514972,23515221,249,0,0,1,1
23514980,23515219,239,0,0,1,2
23515220,23515285,65,1,0,0,2
23515222,23515290,68,1,0,0,1
23515286,23515373,87,0,0,1,2
23515291,23515375,84,0,0,1,1
23515374,23515416,42,1,0,0,2
23515376,23515418,42,1,0,0,1
23515417,23515642,225,0,0,1,2
23515419,23515643,224,0,0,1,1
23515643,23515656,13,1,0,0,2
23515644,23515658,14,1,0,0,1
23515657,23516581,924,0,0,1,2
23515659,23516581,922,0,0,1,1
23516582,23516672,90,1,0,0,1
23516582,23516678,96,1,0,0,2
23516673,23516854,181,0,0,1,1
23516679,23516853,174,0,0,1,2
23516854,23516922,68,1,0,0,2
23516855,23516909,54,1,0,0,1
23516910,23517036,126,0,0,1,1
23516923,23517035,112,0,0,1,2
23517036,23517079,43,1,0,0,2
23517037,23517078,41,1,0,0,1
23517079,23518189,1110,0,0,1,1
23517080,23518189,1109,0,0,1,2
23518190,23518440,250,1,0,0,1
23518190,23518440,250,1,0,0,2
23518227,23518375,148,0,1,0,2
23518229,23518365,136,0,1,0,1
23518441,23518592,151,0,0,1,2
23518441,23518593,152,0,0,1,1
23518593,23518650,57,1,0,0,2
23518594,23518651,57,1,0,0,1
23518651,23518784,133,0,0,1,2
23518652,23518785,133,0,0,1,1
23518785,23518815,30,1,0,0,2
23518786,23518824,38,1,0,0,1
23518816,23519794,978,0,0,1,2
23518825,23519793,968,0,0,1,1
23519794,23519843,49,1,0,0,1
23519795,23519856,61,1,0,0,2
23519844,23520218,374,0,0,1,1
23519857,23520217,360,0,0,1,2
23520218,23520277,59,1,0,0,2
23520219,23520264,45,1,0,0,1
23520265,23520354,89,0,0,1,1
23520278,23520354,76,0,0,1,2
23520355,23520390,35,1,0,0,1
23520355,23520400,45,1,0,0,2
23520391,23520848,457,0,0,1,1
23520401,23520849,448,0,0,1,2
23520849,23520878,29,1,0,0,1
23520850,23520878,28,1,0,0,2
23520879,23521639,760,0,0,1,2
23520879,23521642,763,0,0,1,1
23521640,23521694,54,1,0,0,2
23521643,23521696,53,1,0,0,1
23521695,23521876,181,0,0,1,2
23521697,23521878,181,0,0,1,1
23521877,23521930,53,1,0,0,2
23521879,23521930,51,1,0,0,1
23521931,23522015,84,0,0,1,1
23521931,23522015,84,0,0,1,2
23522016,23522061,45,1,0,0,2
23522016,23522070,54,1,0,0,1
23522062,23522190,128,0,0,1,2
23522071,23522191,120,0,0,1,1
23522191,23522220,29,1,0,0,2
23522192,23522221,29,1,0,0,1
23522221,23523029,808,0,0,1,2
23522222,23523478,1256,0,0,1,1
23523030,23523041,11,1,0,0,2
23523042,23523477,435,0,0,1,2
23523478,23523541,63,1,0,0,2
23523479,23523539,60,1,0,0,1
23523540,23523620,80,0,0,1,1
23523542,23523620,78,0,0,1,2
23523621,23523653,32,1,0,0,1
23523621,23523657,36,1,0,0,2
23523654,23523730,76,0,0,1,1
23523658,23523731,73,0,0,1,2
23523731,23523766,35,1,0,0,1
23523732,23523766,34,1,0,0,2
23523767,23524891,1124,0,0,1,2
23523767,23524892,1125,0,0,1,1
23524892,23524938,46,1,0,0,2
23524893,23524940,47,1,0,0,1
23524939,23525201,262,0,0,1,2
23524941,23525201,260,0,0,1,1
23525202,23525255,53,1,0,0,2
23525202,23525258,56,1,0,0,1
23525256,23525354,98,0,0,1,2
23525259,23525352,93,0,0,1,1
23525353,23525400,47,1,0,0,1
23525355,23525387,32,1,0,0,2
23525388,23526184,796,0,0,1,2
23525401,23526183,782,0,0,1,1
23526184,23526234,50,1,0,0,1
23526185,23526233,48,1,0,0,2
23526234,23526672,438,0,0,1,2
23526235,23526671,436,0,0,1,1
23526672,23526772,100,1,0,0,1
23526673,23526778,105,1,0,0,2
23526759,23526761,2,0,1,0,1
23526773,23526867,94,0,0,1,1
23526779,23526867,88,0,0,1,2
23526868,23526911,43,1,0,0,2
23526868,23528129,1261,1,0,0,1
23526879,23528079,1200,0,1,0,1
23526912,23527100,188,0,0,1,2
23527101,23527133,32,1,0,0,2
23527134,23527578,444,0,0,1,2
23527579,23527607,28,1,0,0,2
23527608,23528054,446,0,0,1,2
23528055,23528128,73,1,0,0,2
23528129,23528324,195,0,0,1,2
23528130,23528327,197,0,0,1,1
23528325,23528387,62,1,0,0,2
23528328,23528389,61,1,0,0,1
23528388,23528491,103,0,0,1,2
23528390,23528493,103,0,0,1,1
23528492,23528563,71,1,0,0,2
23528494,23528559,65,1,0,0,1
23528560,23528640,80,0,0,1,1
23528564,23528641,77,0,0,1,2
23528641,23528688,47,1,0,0,1
23528642,23528682,40,1,0,0,2
23528683,23529235,552,0,0,1,2
23528689,23529236,547,0,0,1,1
23529236,23529275,39,1,0,0,2
23529237,23529274,37,1,0,0,1
23529275,23529816,541,0,0,1,1
23529276,23529816,540,0,0,1,2
23529817,23530129,312,1,0,0,2
23529817,23530155,338,1,0,0,1
23529885,23530055,170,0,1,0,2
23529888,23530048,160,0,1,0,1
23530130,23530323,193,0,0,1,2
23530156,23530321,165,0,0,1,1
23530322,23530388,66,1,0,0,1
23530324,23530402,78,1,0,0,2
23530389,23530450,61,0,0,1,1
23530403,23530449,46,0,0,1,2
23530450,23530485,35,1,0,0,2
23530451,23530487,36,1,0,0,1
23530486,23531686,1200,0,0,1,2
23530488,23531280,792,0,0,1,1
23531281,23531285,4,1,0,0,1
23531286,23531688,402,0,0,1,1
23531687,23531777,90,1,0,0,2
23531689,23531766,77,1,0,0,1
23531767,23532183,416,0,0,1,1
23531778,23532183,405,0,0,1,2
23532184,23532254,70,1,0,0,1
23532184,23532255,71,1,0,0,2
23532255,23532363,108,0,0,1,1
23532256,23532365,109,0,0,1,2
23532364,23532402,38,1,0,0,1
23532366,23532410,44,1,0,0,2
23532403,23532912,509,0,0,1,1
23532411,23532914,503,0,0,1,2
23532913,23532949,36,1,0,0,1
23532915,23532948,33,1,0,0,2
23532949,23533321,372,0,0,1,2
23532950,23533322,372,0,0,1,1
23533322,23533360,38,1,0,0,2
23533323,23533357,34,1,0,0,1
23533358,23533550,192,0,0,1,1
23533361,23533553,192,0,0,1,2
23533551,23533635,84,1,0,0,1
23533554,23533626,72,1,0,0,2
23533627,23533965,338,0,0,1,2
23533636,23533964,328,0,0,1,1
23533965,23534028,63,1,0,0,1
23533966,23534028,62,1,0,0,2
23534029,23534178,149,0,0,1,2
23534029,23534189,160,0,0,1,1
23534179,23534208,29,1,0,0,2
23534190,23534216,26,1,0,0,1
23534209,23535220,1011,0,0,1,2
23534217,23535220,1003,0,0,1,1
23535221,23535302,81,1,0,0,2
23535221,23535303,82,1,0,0,1
23535303,23535647,344,0,0,1,2
23535304,23535648,344,0,0,1,1
23535648,23535693,45,1,0,0,2
23535649,23535694,45,1,0,0,1
23535694,23535839,145,0,0,1,2
23535695,23535838,143,0,0,1,1
23535839,23535858,19,1,0,0,1
23535840,23535858,18,1,0,0,2
23535859,23536995,1136,0,0,1,1
23535859,23536998,1139,0,0,1,2
23536996,23537243,247,1,0,0,1
23536999,23537275,276,1,0,0,2
23537046,23537200,154,0,1,0,2
23537047,23537189,142,0,1,0,1
23537244,23537426,182,0,0,1,1
23537276,23537429,153,0,0,1,2
23537427,23537491,64,1,0,0,1
23537430,23537490,60,1,0,0,2
23537491,23537548,57,0,0,1,2
23537492,23537548,56,0,0,1,1
23537549,23537582,33,1,0,0,1
23537549,23537583,34,1,0,0,2
23537583,23537734,151,0,0,1,1
23537584,23537735,151,0,0,1,2
23537735,23537766,31,1,0,0,1
23537736,23537767,31,1,0,0,2
23537767,23538133,366,0,0,1,1
23537768,23538133,365,0,0,1,2
23538134,23538153,19,1,0,0,2
23538134,23538156,22,1,0,0,1
23538154,23539011,857,0,0,1,2
23538157,23539013,856,0,0,1,1
23539012,23539252,240,1,0,0,2
23539014,23539237,223,1,0,0,1
23539054,23539172,118,0,1,0,2
23539055,23539167,112,0,1,0,1
23539238,23539270,32,0,0,1,1
23539253,23539485,232,0,0,1,2
23539271,23539283,12,1,0,0,1
23539284,23539486,202,0,0,1,1
23539486,23539556,70,1,0,0,2
23539487,23539548,61,1,0,0,1
23539549,23539621,72,0,0,1,1
23539557,23539621,64,0,0,1,2
23539622,23539659,37,1,0,0,1
23539622,23539660,38,1,0,0,2
23539660,23540852,1192,0,0,1,1
23539661,23540851,1190,0,0,1,2
23540852,23540898,46,1,0,0,2
23540853,23540897,44,1,0,0,1
23540898,23541239,341,0,0,1,1
23540899,23541238,339,0,0,1,2
23541239,23541312,73,1,0,0,2
23541240,23541311,71,1,0,0,1
23541312,23541457,145,0,0,1,1
23541313,23541456,143,0,0,1,2
23541457,23541496,39,1,0,0,2
23541458,23541491,33,1,0,0,1
23541492,23542452,960,0,0,1,1
23541497,23542451,954,0,0,1,2
23542452,23542516,64,1,0,0,2
23542453,23542517,64,1,0,0,1
23542517,23542884,367,0,0,1,2
23542518,23542884,366,0,0,1,1
23542885,23542935,50,1,0,0,1
23542885,23542938,53,1,0,0,2
23542936,23543943,1007,0,0,1,1
23542939,23543944,1005,0,0,1,2
23543944,23544024,80,1,0,0,1
23543945,23544022,77,1,0,0,2
23544023,23544482,459,0,0,1,2
23544025,23544481,456,0,0,1,1
23544482,23544565,83,1,0,0,1
23544483,23544568,85,1,0,0,2
23544566,23544686,120,0,0,1,1
23544569,23544686,117,0,0,1,2
23544687,23544720,33,1,0,0,2
23544687,23544721,34,1,0,0,1
23544721,23545178,457,0,0,1,2
23544722,23545627,905,0,0,1,1
23545189,23545641,452,0,1,0,2
23545628,23545703,75,1,0,0,1
23545651,23545712,61,1,0,0,2
23545704,23546060,356,0,0,1,1
23545713,23546060,347,0,0,1,2
23546061,23546123,62,1,0,0,1
23546061,23546133,72,1,0,0,2
23546124,23546226,102,0,0,1,1
23546134,23546225,91,0,0,1,2
23546226,23546266,40,1,0,0,2
23546227,23546263,36,1,0,0,1
23546264,23547406,1142,0,0,1,1
23546267,23546607,340,0,0,1,2
23546608,23546625,17,1,0,0,2
23546626,23547347,721,0,0,1,2
23547348,23547357,9,1,0,0,2
23547358,23547405,47,0,0,1,2
23547406,23547466,60,1,0,0,2
23547407,23547466,59,1,0,0,1
23547467,23547845,378,0,0,1,2
23547467,23547846,379,0,0,1,1
23547846,23548071,225,1,0,0,2
23547847,23547921,74,1,0,0,1
23547904,23548015,111,0,1,0,2
23547922,23548031,109,0,0,1,1
23548032,23548064,32,1,0,0,1
23548038,23548043,5,0,1,0,2
23548065,23548572,507,0,0,1,1
23548072,23548451,379,0,0,1,2
23548462,23548537,75,0,1,0,2
23548546,23548546,0,1,0,0,2
23548547,23548601,54,0,0,1,2
23548573,23548590,17,1,0,0,1
23548591,23548669,78,0,0,1,1
23548612,23548628,16,0,1,0,2
23548637,23548637,0,1,0,0,2
23548638,23548719,81,0,0,1,2
23548670,23548744,74,1,0,0,1
23548730,23549199,469,0,1,0,2
23548745,23548779,34,0,0,1,1
23548780,23548816,36,1,0,0,1
23548817,23548911,94,0,0,1,1
23548912,23548920,8,1,0,0,1
23548921,23549159,238,0,0,1,1
23549160,23549239,79,1,0,0,1
23549178,23549183,5,0,1,0,1
23549209,23549248,39,1,0,0,2
23549240,23549566,326,0,0,1,1
23549249,23549564,315,0,0,1,2
23549565,23549619,54,1,0,0,2
23549567,23549612,45,1,0,0,1
23549613,23549749,136,0,0,1,1
23549620,23549749,129,0,0,1,2
23549750,23549789,39,1,0,0,2
23549750,23549791,41,1,0,0,1
23549790,23550711,921,0,0,1,2
23549792,23550709,917,0,0,1,1
23550710,23551047,337,1,0,0,1
23550712,23551064,352,1,0,0,2
23550745,23550943,198,0,1,0,2
23550746,23550930,184,0,1,0,1
23551048,23551197,149,0,0,1,1
23551065,23551197,132,0,0,1,2
23551198,23551277,79,1,0,0,2
23551198,23551278,80,1,0,0,1
23551278,23551310,32,0,0,1,2
23551279,23551311,32,0,0,1,1
23551311,23551353,42,1,0,0,2
23551312,23551352,40,1,0,0,1
23551353,23551402,49,0,0,1,1
23551354,23551400,46,0,0,1,2
23551401,23551430,29,1,0,0,2
23551403,23551450,47,1,0,0,1
23551431,23551595,164,0,0,1,2
23551451,23551585,134,0,0,1,1
23551586,23551627,41,1,0,0,1
23551596,23551613,17,1,0,0,2
23551614,23552671,1057,0,0,1,2
23551628,23552671,1043,0,0,1,1
23552672,23552780,108,1,0,0,2
23552672,23552782,110,1,0,0,1
23552781,23552817,36,0,0,1,2
23552783,23552814,31,0,0,1,1
23552815,23553343,528,1,0,0,1
23552818,23553547,729,1,0,0,2
23552849,23553331,482,0,1,0,1
23552849,23553331,482,0,1,0,2
23553344,23553371,27,0,0,1,1
23553372,23553652,280,1,0,0,1
23553387,23553501,114,0,1,0,2
23553387,23553506,119,0,1,0,1
23553548,23553607,59,0,0,1,2
23553608,23553652,44,1,0,0,2
23553653,23553755,102,0,0,1,1
23553653,23553755,102,0,0,1,2
23553756,23553786,30,1,0,0,1
23553756,23553795,39,1,0,0,2
23553787,23554908,1121,0,0,1,1
23553796,23554909,1113,0,0,1,2
23554909,23555127,218,1,0,0,1
23554910,23555156,246,1,0,0,2
23554949,23555061,112,0,1,0,1
23554949,23555063,114,0,1,0,2
23555128,23555310,182,0,0,1,1
23555157,23555308,151,0,0,1,2
23555309,23555449,140,1,0,0,2
23555311,23555448,137,1,0,0,1
23555449,23555510,61,0,0,1,1
23555450,23555511,61,0,0,1,2
23555511,23555561,50,1,0,0,1
23555512,23555563,51,1,0,0,2
23555562,23555656,94,0,0,1,1
23555564,23555656,92,0,0,1,2
23555657,23555686,29,1,0,0,2
23555657,23555688,31,1,0,0,1
23555687,23555846,159,0,0,1,2
23555689,23555847,158,0,0,1,1
23555847,23555876,29,1,0,0,2
23555848,23555868,20,1,0,0,1
23555869,23556573,704,0,0,1,1
23555877,23556573,696,0,0,1,2
23556574,23556810,236,1,0,0,1
23556574,23556819,245,1,0,0,2
23556628,23556772,144,0,1,0,2
23556632,23556747,115,0,1,0,1
23556811,23557073,262,0,0,1,1
23556820,23557070,250,0,0,1,2
23557071,23557153,82,1,0,0,2
23557074,23557160,86,1,0,0,1
23557154,23557229,75,0,0,1,2
23557161,23557230,69,0,0,1,1
23557230,23557273,43,1,0,0,2
23557231,23557276,45,1,0,0,1
23557274,23558381,1107,0,0,1,2
23557277,23558379,1102,0,0,1,1
23558380,23558466,86,1,0,0,1
23558382,23558468,86,1,0,0,2
23558467,23558927,460,0,0,1,1
23558469,23558926,457,0,0,1,2
23558927,23559003,76,1,0,0,2
23558928,23559010,82,1,0,0,1
23559004,23559057,53,0,0,1,2
23559011,23559055,44,0,0,1,1
23559056,23559104,48,1,0,0,1
23559058,23559101,43,1,0,0,2
23559102,23559196,94,0,0,1,2
23559105,23559197,92,0,0,1,1
23559197,23559236,39,1,0,0,2
23559198,23559232,34,1,0,0,1
23559233,23559992,759,0,0,1,1
23559237,23559949,712,0,0,1,2
23559960,23559994,34,0,1,0,2
23559993,23560257,264,1,0,0,1
23560004,23560251,247,1,0,0,2
23560072,23560189,117,0,1,0,2
23560074,23560175,101,0,1,0,1
23560252,23560480,228,0,0,1,2
23560258,23560479,221,0,0,1,1
23560480,23560553,73,1,0,0,1
23560481,23560552,71,1,0,0,2
23560553,23560704,151,0,0,1,2
23560554,23560703,149,0,0,1,1
23560704,23560734,30,1,0,0,1
23560705,23560734,29,1,0,0,2
23560735,23561447,712,0,0,1,2
23560735,23561457,722,0,0,1,1
23561448,23561516,68,1,0,0,2
23561458,23561519,61,1,0,0,1
23561517,23561620,103,0,0,1,2
23561520,23561619,99,0,0,1,1
23561620,23561658,38,1,0,0,1
23561621,23561666,45,1,0,0,2
23561659,23561906,247,0,0,1,1
23561667,23561905,238,0,0,1,2
23561906,23561976,70,1,0,0,2
23561907,23561975,68,1,0,0,1
23561976,23562030,54,0,0,1,1
23561977,23562028,51,0,0,1,2
23562029,23562071,42,1,0,0,2
23562031,23562073,42,1,0,0,1
23562072,23562155,83,0,0,1,2
23562074,23562155,81,0,0,1,1
23562156,23562190,34,1,0,0,2
23562156,23562196,40,1,0,0,1
23562191,23562376,185,0,0,1,2
23562197,23562379,182,0,0,1,1
23562377,23562413,36,1,0,0,2
23562380,23562411,31,1,0,0,1
23562412,23563052,640,0,0,1,1
23562414,23563054,640,0,0,1,2
23563053,23563097,44,1,0,0,1
23563055,23563097,42,1,0,0,2
23563098,23563394,296,0,0,1,2
23563098,23563395,297,0,0,1,1
23563395,23563460,65,1,0,0,2
23563396,23563460,64,1,0,0,1
23563461,23563509,48,0,0,1,2
23563461,23563511,50,0,0,1,1
23563510,23563558,48,1,0,0,2
23563512,23563552,40,1,0,0,1
23563553,23563729,176,0,0,1,1
23563559,23563734,175,0,0,1,2
23563730,23563765,35,1,0,0,1
23563735,23563763,28,1,0,0,2
23563764,23564520,756,0,0,1,2
23563766,23564519,753,0,0,1,1
23564520,23564601,81,1,0,0,1
23564521,23564601,80,1,0,0,2
23564602,23564942,340,0,0,1,1
23564602,23564942,340,0,0,1,2
23564943,23565015,72,1,0,0,1
23564943,23565028,85,1,0,0,2
23565016,23565116,100,0,0,1,1
23565029,23565113,84,0,0,1,2
23565114,23565159,45,1,0,0,2
23565117,23565157,40,1,0,0,1
23565158,23565971,813,0,0,1,1
23565160,23565971,811,0,0,1,2
23565972,23566041,69,1,0,0,1
23565972,23566042,70,1,0,0,2
23566042,23566545,503,0,0,1,1
23566043,23566546,503,0,0,1,2
23566546,23566604,58,1,0,0,1
23566547,23566597,50,1,0,0,2
23566598,23566707,109,0,0,1,2
23566605,23566706,101,0,0,1,1
23566707,23566730,23,1,0,0,1
23566708,23566730,22,1,0,0,2
23566731,23568618,1887,0,0,1,1
23566731,23568618,1887,0,0,1,2
23568619,23568645,26,1,0,0,1
23568619,23568646,27,1,0,0,2
23568646,23569354,708,0,0,1,1
23568647,23569353,706,0,0,1,2
23569354,23569384,30,1,0,0,2
23569355,23569388,33,1,0,0,1
23569385,23569452,67,0,0,1,2
23569389,23569452,63,0,0,1,1
23569453,23569504,51,1,0,0,2
23569453,23569511,58,1,0,0,1
23569505,23569682,177,0,0,1,2
23569512,23569684,172,0,0,1,1
23569683,23569725,42,1,0,0,2
23569685,23569727,42,1,0,0,1
23569726,23571724,1998,0,0,1,2
23569728,23571582,1854,0,0,1,1
23571583,23571593,10,1,0,0,1
23571594,23571722,128,0,0,1,1
23571723,23572009,286,1,0,0,1
23571725,23572015,290,1,0,0,2
23571781,23571949,168,0,1,0,2
23571784,23571941,157,0,1,0,1
23572010,23573525,1515,0,0,1,1
23572016,23573521,1505,0,0,1,2
23573522,23573597,75,1,0,0,2
23573526,23573596,70,1,0,0,1
23573597,23573688,91,0,0,1,1
23573598,23573689,91,0,0,1,2
23573689,23573716,27,1,0,0,1
23573690,23573724,34,1,0,0,2
23573717,23573986,269,0,0,1,1
23573725,23573990,265,0,0,1,2
23573987,23574024,37,1,0,0,1
23573991,23574029,38,1,0,0,2
23574025,23574144,119,0,0,1,1
23574030,23574146,116,0,0,1,2
23574145,23574176,31,1,0,0,1
23574147,23574176,29,1,0,0,2
23574177,23574651,474,0,0,1,1
23574177,23574658,481,0,0,1,2
23574652,23574681,29,1,0,0,1
23574659,23574675,16,1,0,0,2
23574676,23575108,432,0,0,1,2
23574682,23575107,425,0,0,1,1
23575108,23575121,13,1,0,0,1
23575109,23575124,15,1,0,0,2
23575122,23575325,203,0,0,1,1
23575125,23575325,200,0,0,1,2
23575326,23575369,43,1,0,0,1
23575326,23575370,44,1,0,0,2
23575370,23575928,558,0,0,1,1
23575371,23575928,557,0,0,1,2
23575929,23575961,32,1,0,0,1
23575929,23575963,34,1,0,0,2
23575962,23576498,536,0,0,1,1
23575964,23576498,534,0,0,1,2
23576499,23576530,31,1,0,0,1
23576499,23576531,32,1,0,0,2
23576531,23576880,349,0,0,1,1
23576532,23576879,347,0,0,1,2
23576880,23576916,36,1,0,0,2
23576881,23576916,35,1,0,0,1
23576917,23577386,469,0,0,1,2
23576917,23577390,473,0,0,1,1
23577387,23577713,326,1,0,0,2
23577391,23577685,294,1,0,0,1
23577433,23577639,206,0,1,0,2
23577441,23577621,180,0,1,0,1
23577686,23577765,79,0,0,1,1
23577714,23577764,50,0,0,1,2
23577765,23577811,46,1,0,0,2
23577766,23577811,45,1,0,0,1
23577812,23578586,774,0,0,1,2
23577812,23579107,1295,0,0,1,1
23578587,23578591,4,1,0,0,2
23578592,23578668,76,0,0,1,2
23578669,23578684,15,1,0,0,2
23578685,23578740,55,0,0,1,2
23578741,23578766,25,1,0,0,2
23578767,23579106,339,0,0,1,2
23579107,23579174,67,1,0,0,2
23579108,23579178,70,1,0,0,1
23579175,23579264,89,0,0,1,2
23579179,23579264,85,0,0,1,1
23579265,23579297,32,1,0,0,2
23579265,23579298,33,1,0,0,1
23579298,23579465,167,0,0,1,2
23579299,23579469,170,0,0,1,1
23579466,23579486,20,1,0,0,2
23579470,23579500,30,1,0,0,1
23579487,23580783,1296,0,0,1,2
23579501,23580785,1284,0,0,1,1
23580784,23580844,60,1,0,0,2
23580786,23580838,52,1,0,0,1
23580839,23581035,196,0,0,1,1
23580845,23581034,189,0,0,1,2
23581035,23581070,35,1,0,0,2
23581036,23581068,32,1,0,0,1
23581069,23582097,1028,0,0,1,1
23581071,23582103,1032,0,0,1,2
23582098,23582121,23,1,0,0,1
23582104,23582120,16,1,0,0,2
23582121,23582400,279,0,0,1,2
23582122,23582392,270,0,0,1,1
23582393,23582405,12,1,0,0,1
23582401,23582405,4,1,0,0,2
23582406,23582900,494,0,0,1,1
23582406,23582902,496,0,0,1,2
23582901,23582943,42,1,0,0,1
23582903,23582945,42,1,0,0,2
23582944,23583024,80,0,0,1,1
23582946,23583024,78,0,0,1,2
23583025,23583438,413,1,0,0,1
23583025,23583481,456,1,0,0,2
23583145,23583385,240,0,1,0,2
23583149,23583360,211,0,1,0,1
23583439,23583867,428,0,0,1,1
23583482,23583865,383,0,0,1,2
23583866,23583903,37,1,0,0,2
23583868,23583900,32,1,0,0,1
23583901,23584146,245,0,0,1,1
23583904,23584146,242,0,0,1,2
23584147,23584167,20,1,0,0,1
23584147,23584192,45,1,0,0,2
23584168,23584421,253,0,0,1,1
23584193,23584420,227,0,0,1,2
23584421,23584462,41,1,0,0,2
23584422,23584453,31,1,0,0,1
23584454,23585746,1292,0,0,1,1
23584463,23585486,1023,0,0,1,2
23585487,23585492,5,1,0,0,2
23585493,23585744,251,0,0,1,2
23585745,23585808,63,1,0,0,2
23585747,23585811,64,1,0,0,1
23585809,23585990,181,0,0,1,2
23585812,23585990,178,0,0,1,1
23585991,23586023,32,1,0,0,1
23585991,23586031,40,1,0,0,2
23586024,23587956,1932,0,0,1,1
23586032,23587807,1775,0,0,1,2
23587808,23587819,11,1,0,0,2
23587820,23587969,149,0,0,1,2
23587957,23588429,472,1,0,0,1
23587970,23588441,471,1,0,0,2
23588005,23588411,406,0,1,0,2
23588007,23588376,369,0,1,0,1
23588430,23588627,197,0,0,1,1
23588442,23588629,187,0,0,1,2
23588628,23588876,248,1,0,0,1
23588630,23588894,264,1,0,0,2
23588655,23588829,174,0,1,0,2
23588657,23588813,156,0,1,0,1
23588877,23589063,186,0,0,1,1
23588895,23589064,169,0,0,1,2
23589064,23589123,59,1,0,0,1
23589065,23589127,62,1,0,0,2
23589124,23589231,107,0,0,1,1
23589128,23589229,101,0,0,1,2
23589230,23589261,31,1,0,0,2
23589232,23589260,28,1,0,0,1
23589261,23590904,1643,0,0,1,1
23589262,23590905,1643,0,0,1,2
23590905,23590970,65,1,0,0,1
23590906,23590950,44,1,0,0,2
23590951,23591321,370,0,0,1,2
23590971,23591316,345,0,0,1,1
23591317,23591332,15,1,0,0,1
23591322,23591347,25,1,0,0,2
23591333,23592126,793,0,0,1,1
23591348,23592138,790,0,0,1,2
23592127,23592156,29,1,0,0,1
23592139,23592154,15,1,0,0,2
23592155,23593336,1181,0,0,1,2
23592157,23593336,1179,0,0,1,1
23593337,23593388,51,1,0,0,2
23593337,23593389,52,1,0,0,1
23593389,23593934,545,0,0,1,2
23593390,23594318,928,0,0,1,1
23593935,23593942,7,1,0,0,2
23593943,23594108,165,0,0,1,2
23594109,23594148,39,1,0,0,2
23594149,23594316,167,0,0,1,2
23594317,23594373,56,1,0,0,2
23594319,23594378,59,1,0,0,1
23594374,23594547,173,0,0,1,2
23594379,23594545,166,0,0,1,1
23594546,23594594,48,1,0,0,1
23594548,23594594,46,1,0,0,2
23594595,23594697,102,0,0,1,1
23594595,23594698,103,0,0,1,2
23594698,23594728,30,1,0,0,1
23594699,23594737,38,1,0,0,2
23594729,23595994,1265,0,0,1,1
23594738,23594931,193,0,0,1,2
23594932,23594954,22,1,0,0,2
23594955,23596119,1164,0,0,1,2
23595995,23596000,5,1,0,0,1
23596001,23596119,118,0,0,1,1
23596120,23596158,38,1,0,0,1
23596120,23596167,47,1,0,0,2
23596159,23596312,153,0,0,1,1
23596168,23596311,143,0,0,1,2
23596312,23596339,27,1,0,0,2
23596313,23596335,22,1,0,0,1
23596336,23597343,1007,0,0,1,1
23596340,23597350,1010,0,0,1,2
23597344,23597364,20,1,0,0,1
23597351,23597371,20,1,0,0,2
23597365,23598128,763,0,0,1,1
23597372,23598137,765,0,0,1,2
23598129,23598384,255,1,0,0,1
23598138,23598419,281,1,0,0,2
23598162,23598296,134,0,1,0,2
23598169,23598268,99,0,1,0,1
23598385,23598437,52,0,0,1,1
23598420,23598593,173,0,0,1,2
23598438,23598453,15,1,0,0,1
23598454,23598595,141,0,0,1,1
23598594,23598641,47,1,0,0,2
23598596,23598633,37,1,0,0,1
23598634,23598987,353,0,0,1,1
23598642,23598985,343,0,0,1,2
23598986,23599013,27,1,0,0,2
23598988,23599011,23,1,0,0,1
23599012,23599364,352,0,0,1,1
23599014,23599364,350,0,0,1,2
23599365,23599381,16,1,0,0,1
23599365,23599394,29,1,0,0,2
23599382,23599670,288,0,0,1,1
23599395,23599671,276,0,0,1,2
23599671,23599706,35,1,0,0,1
23599672,23599706,34,1,0,0,2
23599707,23599815,108,0,0,1,1
23599707,23599816,109,0,0,1,2
23599816,23599885,69,1,0,0,1
23599817,23599877,60,1,0,0,2
23599878,23599989,111,0,0,1,2
23599886,23599988,102,0,0,1,1
23599989,23600129,140,1,0,0,1
23599990,23600031,41,1,0,0,2
23600013,23600120,107,0,1,0,1
23600032,23601172,1140,0,0,1,2
23600130,23601174,1044,0,0,1,1
23601173,23601331,158,1,0,0,2
23601175,23601331,156,1,0,0,1
23601332,23601415,83,0,0,1,1
23601332,23601564,232,0,0,1,2
23601416,23601427,11,1,0,0,1
23601428,23601563,135,0,0,1,1
23601564,23601609,45,1,0,0,1
23601565,23601620,55,1,0,0,2
23601610,23602707,1097,0,0,1,1
23601621,23602706,1085,0,0,1,2
23602707,23602738,31,1,0,0,2
23602708,23602738,30,1,0,0,1
23602739,23604197,1458,0,0,1,1
23602739,23604296,1557,0,0,1,2
23604198,23604221,23,1,0,0,1
23604222,23604296,74,0,0,1,1
23604297,23604349,52,1,0,0,1
23604297,23604356,59,1,0,0,2
23604350,23604897,547,0,0,1,1
23604357,23604897,540,0,0,1,2
23604898,23604959,61,1,0,0,1
23604898,23604981,83,1,0,0,2
23604960,23605160,200,0,0,1,1
23604982,23605163,181,0,0,1,2
23605161,23605184,23,1,0,0,1
23605164,23605191,27,1,0,0,2
23605185,23606109,924,0,0,1,1
23605192,23606110,918,0,0,1,2
23606110,23606139,29,1,0,0,1
23606111,23606140,29,1,0,0,2
23606140,23606901,761,0,0,1,1
23606141,23606901,760,0,0,1,2
23606902,23606955,53,1,0,0,1
23606902,23606968,66,1,0,0,2
23606956,23607123,167,0,0,1,1
23606969,23607125,156,0,0,1,2
23607124,23607172,48,1,0,0,1
23607126,23607172,46,1,0,0,2
23607173,23608946,1773,0,0,1,1
23607173,23608946,1773,0,0,1,2
23608947,23608966,19,1,0,0,2
23608947,23608967,20,1,0,0,1
23608967,23609188,221,0,0,1,2
23608968,23609183,215,0,0,1,1
23609184,23609200,16,1,0,0,1
23609189,23609200,11,1,0,0,2
23609201,23609374,173,0,0,1,1
23609201,23609374,173,0,0,1,2
23609375,23609421,46,1,0,0,1
23609375,23609426,51,1,0,0,2
23609422,23609669,247,0,0,1,1
23609427,23609669,242,0,0,1,2
23609670,23609717,47,1,0,0,1
23609670,23609719,49,1,0,0,2
23609718,23610427,709,0,0,1,1
23609720,23610427,707,0,0,1,2
23610428,23610476,48,1,0,0,1
23610428,23610478,50,1,0,0,2
23610477,23610805,328,0,0,1,1
23610479,23610806,327,0,0,1,2
23610806,23610844,38,1,0,0,1
23610807,23610837,30,1,0,0,2
23610838,23610965,127,0,0,1,2
23610845,23610970,125,0,0,1,1
23610966,23610985,19,1,0,0,2
23610971,23610985,14,1,0,0,1
23610986,23611888,902,0,0,1,2
23610986,23612622,1636,0,0,1,1
23611889,23611894,5,1,0,0,2
23611895,23612622,727,0,0,1,2
23612623,23612783,160,1,0,0,2
23612623,23612817,194,1,0,0,1
23612784,23612840,56,0,0,1,2
23612818,23612838,20,0,0,1,1
23612839,23612878,39,1,0,0,1
23612841,23612878,37,1,0,0,2
23612879,23613684,805,0,0,1,1
23612879,23613685,806,0,0,1,2
23613685,23613719,34,1,0,0,1
23613686,23613714,28,1,0,0,2
23613715,23614924,1209,0,0,1,2
23613720,23614921,1201,0,0,1,1
23614922,23615209,287,1,0,0,1
23614925,23615232,307,1,0,0,2
23614951,23615118,167,0,1,0,2
23614957,23615097,140,0,1,0,1
23615210,23615611,401,0,0,1,1
23615233,23615612,379,0,0,1,2
23615612,23615668,56,1,0,0,1
23615613,23615670,57,1,0,0,2
23615669,23615951,282,0,0,1,1
23615671,23615950,279,0,0,1,2
23615951,23616035,84,1,0,0,2
23615952,23616019,67,1,0,0,1
23616020,23616271,251,0,0,1,1
23616036,23616272,236,0,0,1,2
23616272,23616309,37,1,0,0,1
23616273,23616309,36,1,0,0,2
23616310,23616450,140,0,0,1,1
23616310,23616450,140,0,0,1,2
23616451,23616505,54,1,0,0,1
23616451,23616514,63,1,0,0,2
23616506,23616634,128,0,0,1,1
23616515,23616632,117,0,0,1,2
23616633,23616665,32,1,0,0,2
23616635,23616675,40,1,0,0,1
23616666,23616858,192,0,0,1,2
23616676,23616857,181,0,0,1,1
23616858,23616892,34,1,0,0,1
23616859,23616891,32,1,0,0,2
23616892,23618363,1471,0,0,1,2
23616893,23618362,1469,0,0,1,1
23618363,23618396,33,1,0,0,1
23618364,23618399,35,1,0,0,2
23618397,23618537,140,0,0,1,1
23618400,23618538,138,0,0,1,2
23618538,23618569,31,1,0,0,1
23618539,23618570,31,1,0,0,2
23618570,23620509,1939,0,0,1,1
23618571,23620505,1934,0,0,1,2
23620506,23620525,19,1,0,0,2
23620510,23620521,11,1,0,0,1
23620522,23620853,331,0,0,1,1
23620526,23621515,989,0,0,1,2
23620854,23620866,12,1,0,0,1
23620867,23621169,302,0,0,1,1
23621170,23621175,5,1,0,0,1
23621176,23621514,338,0,0,1,1
23621515,23621534,19,1,0,0,1
23621516,23621533,17,1,0,0,2
23621534,23621638,104,0,0,1,2
23621535,23621639,104,0,0,1,1
23621639,23622175,536,1,0,0,2
23621640,23622460,820,1,0,0,1
23621808,23622142,334,0,1,0,1
23621814,23622147,333,0,1,0,2
23622176,23622203,27,0,0,1,2
23622204,23622762,558,1,0,0,2
23622229,23622441,212,0,1,0,2
23622230,23622390,160,0,1,0,1
23622461,23622648,187,0,0,1,1
23622649,23622672,23,1,0,0,1
23622673,23623435,762,0,0,1,1
23622763,23623218,455,0,0,1,2
23623219,23623223,4,1,0,0,2
23623224,23623381,157,0,0,1,2
23623382,23623403,21,1,0,0,2
23623404,23623429,25,0,0,1,2
23623430,23623618,188,1,0,0,2
23623436,23623453,17,1,0,0,1
23623454,23623655,201,0,0,1,1
23623619,23623649,30,0,0,1,2
23623650,23623741,91,1,0,0,2
23623656,23623668,12,1,0,0,1
23623669,23624102,433,0,0,1,1
23623742,23623984,242,0,0,1,2
23623985,23624058,73,1,0,0,2
23624059,23624099,40,0,0,1,2
23624100,23624204,104,1,0,0,2
23624103,23624142,39,1,0,0,1
23624143,23626006,1863,0,0,1,1
23624205,23624262,57,0,0,1,2
23624263,23624310,47,1,0,0,2
23624311,23624415,104,0,0,1,2
23624416,23624991,575,1,0,0,2
23624992,23625215,223,0,0,1,2
23625216,23625589,373,1,0,0,2
23625590,23625677,87,0,0,1,2
23625678,23625695,17,1,0,0,2
23625696,23625721,25,0,0,1,2
23625722,23627194,1472,1,0,0,2
23626007,23626020,13,1,0,0,1
23626021,23626224,203,0,0,1,1
23626225,23626256,31,1,0,0,1
23626257,23626302,45,0,0,1,1
23626303,23626823,520,1,0,0,1
23626332,23626810,478,0,1,0,2
23626337,23626779,442,0,1,0,1
23626824,23626874,50,0,0,1,1
23626875,23627159,284,1,0,0,1
23626893,23627088,195,0,1,0,2
23626896,23627078,182,0,1,0,1
23627160,23627465,305,0,0,1,1
23627195,23627463,268,0,0,1,2
23627464,23627521,57,1,0,0,2
23627466,23627522,56,1,0,0,1
23627522,23627896,374,0,0,1,2
23627523,23627897,374,0,0,1,1
23627897,23627964,67,1,0,0,2
23627898,23627965,67,1,0,0,1
23627965,23628133,168,0,0,1,2
23627966,23628132,166,0,0,1,1
23628133,23628168,35,1,0,0,1
23628134,23628168,34,1,0,0,2
23628169,23629012,843,0,0,1,2
23628169,23629014,845,0,0,1,1
23629013,23629078,65,1,0,0,2
23629015,23629031,16,1,0,0,1
23629032,23629547,515,0,0,1,1
23629079,23629292,213,0,0,1,2
23629293,23629306,13,1,0,0,2
23629307,23629537,230,0,0,1,2
23629538,23629555,17,1,0,0,2
23629548,23629557,9,1,0,0,1
23629556,23629777,221,0,0,1,2
23629558,23629780,222,0,0,1,1
23629778,23629842,64,1,0,0,2
23629781,23629832,51,1,0,0,1
23629833,23631873,2040,0,0,1,1
23629843,23630628,785,0,0,1,2
23630629,23630648,19,1,0,0,2
23630649,23630766,117,0,0,1,2
23630767,23630797,30,1,0,0,2
23630798,23631169,371,0,0,1,2
23631170,23631174,4,1,0,0,2
23631175,23631265,90,0,0,1,2
23631266,23631280,14,1,0,0,2
23631281,23631469,188,0,0,1,2
23631470,23631497,27,1,0,0,2
23631498,23631607,109,0,0,1,2
23631608,23632537,929,1,0,0,2
23631874,23631891,17,1,0,0,1
23631892,23631995,103,0,0,1,1
23631996,23632345,349,1,0,0,1
23632026,23632255,229,0,1,0,2
23632029,23632234,205,0,1,0,1
23632346,23632587,241,0,0,1,1
23632538,23632586,48,0,0,1,2
23632587,23632626,39,1,0,0,2
23632588,23632624,36,1,0,0,1
23632625,23633285,660,0,0,1,1
23632627,23633283,656,0,0,1,2
23633284,23633339,55,1,0,0,2
23633286,23633341,55,1,0,0,1
23633340,23633398,58,0,0,1,2
23633342,23633765,423,0,0,1,1
23633399,23633476,77,1,0,0,2
23633477,23633765,288,0,0,1,2
23633766,23633837,71,1,0,0,1
23633766,23633837,71,1,0,0,2
23633838,23633950,112,0,0,1,1
23633838,23633950,112,0,0,1,2
23633951,23633982,31,1,0,0,1
23633951,23633996,45,1,0,0,2
23633983,23635417,1434,0,0,1,1
23633997,23635419,1422,0,0,1,2
23635418,23635467,49,1,0,0,1
23635420,23635462,42,1,0,0,2
23635463,23635643,180,0,0,1,2
23635468,23635646,178,0,0,1,1
23635644,23635681,37,1,0,0,2
23635647,23635678,31,1,0,0,1
23635679,23636560,881,0,0,1,1
23635682,23636560,878,0,0,1,2
23636561,23636583,22,1,0,0,1
23636561,23636589,28,1,0,0,2
23636584,23637419,835,0,0,1,1
23636590,23637419,829,0,0,1,2
23637420,23637442,22,1,0,0,1
23637420,23637444,24,1,0,0,2
23637443,23637498,55,0,0,1,1
23637445,23637497,52,0,0,1,2
23637498,23638003,505,1,0,0,2
23637499,23637994,495,1,0,0,1
23637537,23637943,406,0,1,0,2
23637543,23637948,405,0,1,0,1
23637995,23638197,202,0,0,1,1
23638004,23638195,191,0,0,1,2
23638196,23638255,59,1,0,0,2
23638198,23638245,47,1,0,0,1
23638246,23638352,106,0,0,1,1
23638256,23638352,96,0,0,1,2
23638353,23638622,269,1,0,0,1
23638353,23638666,313,1,0,0,2
23638381,23638538,157,0,1,0,1
23638381,23638548,167,0,1,0,2
23638623,23638643,20,0,0,1,1
23638644,23638649,5,1,0,0,1
23638650,23638950,300,0,0,1,1
23638667,23638950,283,0,0,1,2
23638951,23639021,70,1,0,0,1
23638951,23639021,70,1,0,0,2
23639022,23639138,116,0,0,1,2
23639022,23639139,117,0,0,1,1
23639139,23639179,40,1,0,0,2
23639140,23639176,36,1,0,0,1
23639177,23640845,1668,0,0,1,1
23639180,23640202,1022,0,0,1,2
23640203,23640214,11,1,0,0,2
23640215,23640492,277,0,0,1,2
23640493,23640504,11,1,0,0,2
23640505,23640839,334,0,0,1,2
23640840,23640861,21,1,0,0,2
23640846,23640850,4,1,0,0,1
23640851,23640969,118,0,0,1,1
23640862,23640969,107,0,0,1,2
23640970,23641029,59,1,0,0,2
23640970,23641031,61,1,0,0,1
23641030,23641154,124,0,0,1,2
23641032,23641153,121,0,0,1,1
23641154,23641188,34,1,0,0,1
23641155,23641187,32,1,0,0,2
23641188,23641398,210,0,0,1,2
23641189,23641395,206,0,0,1,1
23641396,23641435,39,1,0,0,1
23641399,23641423,24,1,0,0,2
23641424,23643100,1676,0,0,1,2
23641436,23643099,1663,0,0,1,1
23643100,23643451,351,1,0,0,1
23643101,23643487,386,1,0,0,2
23643153,23643408,255,0,1,0,2
23643157,23643392,235,0,1,0,1
23643452,23643496,44,0,0,1,1
23643488,23643666,178,0,0,1,2
23643497,23643506,9,1,0,0,1
23643507,23643665,158,0,0,1,1
23643666,23643713,47,1,0,0,1
23643667,23643716,49,1,0,0,2
23643714,23643931,217,0,0,1,1
23643717,23643930,213,0,0,1,2
23643931,23644003,72,1,0,0,2
23643932,23644001,69,1,0,0,1
23644002,23644218,216,0,0,1,1
23644004,23644218,214,0,0,1,2
23644219,23644270,51,1,0,0,1
23644219,23644270,51,1,0,0,2
23644271,23644494,223,0,0,1,2
23644271,23644495,224,0,0,1,1
23644495,23644547,52,1,0,0,2
23644496,23644561,65,1,0,0,1
23644548,23644917,369,0,0,1,2
23644562,23644917,355,0,0,1,1
23644918,23644992,74,1,0,0,1
23644918,23645000,82,1,0,0,2
23644993,23645170,177,0,0,1,1
23645001,23645169,168,0,0,1,2
23645170,23645217,47,1,0,0,2
23645171,23645207,36,1,0,0,1
23645208,23646552,1344,0,0,1,1
23645218,23646555,1337,0,0,1,2
23646553,23646581,28,1,0,0,1
23646556,23646581,25,1,0,0,2
23646582,23647351,769,0,0,1,1
23646582,23647351,769,0,0,1,2
23647352,23647405,53,1,0,0,1
23647352,23647405,53,1,0,0,2
23647406,23647587,181,0,0,1,1
23647406,23647587,181,0,0,1,2
23647588,23647619,31,1,0,0,2
23647588,23647620,32,1,0,0,1
23647620,23647821,201,0,0,1,2
23647621,23647821,200,0,0,1,1
23647822,23647853,31,1,0,0,2
23647822,23647854,32,1,0,0,1
23647854,23649456,1602,0,0,1,2
23647855,23649456,1601,0,0,1,1
23649457,23649479,22,1,0,0,1
23649457,23649484,27,1,0,0,2
23649480,23649691,211,0,0,1,1
23649485,23649698,213,0,0,1,2
23649692,23650057,365,1,0,0,1
23649699,23650100,401,1,0,0,2
23649729,23649954,225,0,1,0,2
23649731,23649939,208,0,1,0,1
23650058,23650287,229,0,0,1,1
23650101,23650287,186,0,0,1,2
23650288,23650325,37,1,0,0,2
23650288,23650326,38,1,0,0,1
23650326,23650801,475,0,0,1,2
23650327,23650799,472,0,0,1,1
23650800,23650833,33,1,0,0,1
23650802,23650834,32,1,0,0,2
23650834,23651201,367,0,0,1,1
23650835,23651199,364,0,0,1,2
23651200,23651238,38,1,0,0,2
23651202,23651237,35,1,0,0,1
23651238,23651336,98,0,0,1,1
23651239,23651335,96,0,0,1,2
23651336,23651428,92,1,0,0,2
23651337,23651398,61,1,0,0,1
23651399,23651581,182,0,0,1,1
23651429,23651580,151,0,0,1,2
23651581,23651611,30,1,0,0,2
23651582,23651619,37,1,0,0,1
23651612,23652516,904,0,0,1,2
23651620,23652517,897,0,0,1,1
23652517,23652548,31,1,0,0,2
23652518,23652546,28,1,0,0,1
23652547,23652781,234,0,0,1,1
23652549,23652587,38,0,0,1,2
23652588,23652610,22,1,0,0,2
23652611,23652631,20,0,0,1,2
23652632,23652636,4,1,0,0,2
23652637,23652781,144,0,0,1,2
23652782,23652834,52,1,0,0,1
23652782,23652884,102,1,0,0,2
23652835,23653139,304,0,0,1,1
23652885,23653545,660,0,0,1,2
23653140,23653155,15,1,0,0,1
23653156,23654865,1709,0,0,1,1
23653546,23653565,19,1,0,0,2
23653566,23653597,31,0,0,1,2
23653598,23653610,12,1,0,0,2
23653611,23653706,95,0,0,1,2
23653707,23653724,17,1,0,0,2
23653725,23655051,1326,0,0,1,2
23654866,23654881,15,1,0,0,1
23654882,23655239,357,0,0,1,1
23655052,23655090,38,1,0,0,2
23655091,23655226,135,0,0,1,2
23655227,23655267,40,1,0,0,2
23655240,23655245,5,1,0,0,1
23655246,23655347,101,0,0,1,1
23655268,23655371,103,0,0,1,2
23655348,23655357,9,1,0,0,1
23655358,23655382,24,0,0,1,1
23655372,23655400,28,1,0,0,2
23655383,23655414,31,1,0,0,1
23655401,23655438,37,0,0,1,2
23655415,23655929,514,0,0,1,1
23655439,23655611,172,1,0,0,2
23655612,23655701,89,0,0,1,2
23655702,23655811,109,1,0,0,2
23655812,23655842,30,0,0,1,2
23655843,23655848,5,1,0,0,2
23655849,23655972,123,0,0,1,2
23655930,23656155,225,1,0,0,1
23655973,23655980,7,1,0,0,2
23655981,23656082,101,0,0,1,2
23656083,23656195,112,1,0,0,2
23656156,23658092,1936,0,0,1,1
23656196,23656260,64,0,0,1,2
23656261,23656299,38,1,0,0,2
23656300,23656864,564,0,0,1,2
23656865,23656919,54,1,0,0,2
23656920,23656971,51,0,0,1,2
23656972,23656996,24,1,0,0,2
23656997,23657039,42,0,0,1,2
23657040,23657064,24,1,0,0,2
23657065,23657703,638,0,0,1,2
23657704,23657886,182,1,0,0,2
23657887,23657944,57,0,0,1,2
23657945,23658031,86,1,0,0,2
23658032,23658092,60,0,0,1,2
23658093,23658203,110,1,0,0,1
23658093,23658452,359,1,0,0,2
23658204,23658891,687,0,0,1,1
23658453,23658525,72,0,0,1,2
23658526,23658961,435,1,0,0,2
23658892,23658937,45,1,0,0,1
23658938,23659317,379,0,0,1,1
23658962,23659805,843,0,0,1,2
23659318,23659431,113,1,0,0,1
23659432,23659614,182,0,0,1,1
23659615,23659647,32,1,0,0,1
23659648,23659800,152,0,0,1,1
23659801,23659818,17,1,0,0,1
23659806,23661180,1374,1,0,0,2
23659819,23660173,354,0,0,1,1
23660174,23660343,169,1,0,0,1
23660215,23660313,98,0,1,0,2
23660221,23660297,76,0,1,0,1
23660344,23660367,23,0,0,1,1
23660368,23660455,87,1,0,0,1
23660456,23660510,54,0,0,1,1
23660511,23660853,342,1,0,0,1
23660854,23660886,32,0,0,1,1
23660887,23660981,94,1,0,0,1
23660982,23661003,21,0,0,1,1
23661004,23661116,112,1,0,0,1
23661117,23661180,63,0,0,1,1
23661181,23661268,87,1,0,0,1
23661181,23661406,225,0,0,1,2
23661269,23661405,136,0,0,1,1
23661406,23661446,40,1,0,0,1
23661407,23661484,77,1,0,0,2
23661447,23661755,308,0,0,1,1
23661485,23661511,26,0,0,1,2
23661512,23661543,31,1,0,0,2
23661544,23661564,20,0,0,1,2
23661565,23661605,40,1,0,0,2
23661606,23661632,26,0,0,1,2
23661633,23661644,11,1,0,0,2
23661645,23661697,52,0,0,1,2
23661698,23661829,131,1,0,0,2
23661756,23661795,39,1,0,0,1
23661796,23662159,363,0,0,1,1
23661830,23661884,54,0,0,1,2
23661885,23662010,125,1,0,0,2
23662011,23662165,154,0,0,1,2
23662160,23662221,61,1,0,0,1
23662166,23662228,62,1,0,0,2
23662222,23662257,35,0,0,1,1
23662229,23662255,26,0,0,1,2
23662256,23662309,53,1,0,0,2
23662258,23662310,52,1,0,0,1
23662310,23662395,85,0,0,1,2
23662311,23662395,84,0,0,1,1
23662396,23662436,40,1,0,0,2
23662396,23662438,42,1,0,0,1
23662437,23662497,60,0,0,1,2
23662439,23662497,58,0,0,1,1
23662498,23662536,38,1,0,0,1
23662498,23662536,38,1,0,0,2
23662537,23662928,391,0,0,1,1
23662537,23663557,1020,0,0,1,2
23662929,23662936,7,1,0,0,1
23662937,23663550,613,0,0,1,1
23663551,23663575,24,1,0,0,1
23663558,23663570,12,1,0,0,2
23663571,23664236,665,0,0,1,2
23663576,23664063,487,0,0,1,1
23664064,23664077,13,1,0,0,1
23664078,23664235,157,0,0,1,1
23664236,23664290,54,1,0,0,1
23664237,23664302,65,1,0,0,2
23664291,23666328,2037,0,0,1,1
23664303,23666328,2025,0,0,1,2
23666329,23667090,761,1,0,0,1
23666329,23667105,776,1,0,0,2
23666381,23666751,370,0,1,0,2
23666382,23666753,371,0,1,0,1
23666823,23667024,201,0,1,0,2
23666826,23667009,183,0,1,0,1
23667091,23667385,294,0,0,1,1
23667106,23667383,277,0,0,1,2
23667384,23667442,58,1,0,0,2
23667386,23667432,46,1,0,0,1
23667433,23668006,573,0,0,1,1
23667443,23668005,562,0,0,1,2
23668006,23668043,37,1,0,0,2
23668007,23668043,36,1,0,0,1
23668044,23668159,115,0,0,1,1
23668044,23668159,115,0,0,1,2
23668160,23668183,23,1,0,0,1
23668160,23668189,29,1,0,0,2
23668184,23668950,766,0,0,1,1
23668190,23669411,1221,0,0,1,2
23668951,23668956,5,1,0,0,1
23668957,23669410,453,0,0,1,1
23669411,23669465,54,1,0,0,1
23669412,23669464,52,1,0,0,2
23669465,23669681,216,0,0,1,2
23669466,23669681,215,0,0,1,1
23669682,23669714,32,1,0,0,1
23669682,23669718,36,1,0,0,2
23669715,23670199,484,0,0,1,1
23669719,23671531,1812,0,0,1,2
23670200,23670218,18,1,0,0,1
23670219,23671526,1307,0,0,1,1
23671527,23671545,18,1,0,0,1
23671532,23671547,15,1,0,0,2
23671546,23671936,390,0,0,1,1
23671548,23671942,394,0,0,1,2
23671937,23672055,118,1,0,0,1
23671943,23672046,103,1,0,0,2
23672047,23672575,528,0,0,1,2
23672056,23672575,519,0,0,1,1
23672576,23672603,27,1,0,0,2
23672576,23672604,28,1,0,0,1
23672604,23672941,337,0,0,1,2
23672605,23672941,336,0,0,1,1
23672942,23672998,56,1,0,0,1
23672942,23673004,62,1,0,0,2
23672999,23674890,1891,0,0,1,1
23673005,23673959,954,0,0,1,2
23673960,23673975,15,1,0,0,2
23673976,23674891,915,0,0,1,2
23674891,23674933,42,1,0,0,1
23674892,23674946,54,1,0,0,2
23674934,23675049,115,0,0,1,1
23674947,23675049,102,0,0,1,2
23675050,23675059,9,1,0,0,1
23675050,23675059,9,1,0,0,2
23675060,23675216,156,0,0,1,1
23675060,23675220,160,0,0,1,2
23675217,23675244,27,1,0,0,1
23675221,23675242,21,1,0,0,2
23675243,23676355,1112,0,0,1,2
23675245,23676355,1110,0,0,1,1
23676356,23676390,34,1,0,0,2
23676356,23676391,35,1,0,0,1
23676391,23676907,516,0,0,1,2
23676392,23676905,513,0,0,1,1
23676906,23677768,862,1,0,0,1
23676908,23677399,491,1,0,0,2
23676962,23677310,348,0,1,0,1
23676963,23677335,372,0,1,0,2
23677400,23677440,40,0,0,1,2
23677441,23677830,389,1,0,0,2
23677471,23677685,214,0,1,0,2
23677473,23677666,193,0,1,0,1
23677769,23678068,299,0,0,1,1
23677831,23678065,234,0,0,1,2
23678066,23678115,49,1,0,0,2
23678069,23678108,39,1,0,0,1
23678109,23678458,349,0,0,1,1
23678116,23678460,344,0,0,1,2
23678459,23678499,40,1,0,0,1
23678461,23678502,41,1,0,0,2
23678500,23678946,446,0,0,1,1
23678503,23678946,443,0,0,1,2
23678947,23679017,70,1,0,0,1
23678947,23679022,75,1,0,0,2
23679018,23679111,93,0,0,1,1
23679023,23679110,87,0,0,1,2
23679111,23679148,37,1,0,0,2
23679112,23679146,34,1,0,0,1
23679147,23680356,1209,0,0,1,1
23679149,23680355,1206,0,0,1,2
23680356,23680367,11,1,0,0,2
23680357,23680371,14,1,0,0,1
23680368,23680750,382,0,0,1,2
23680372,23680752,380,0,0,1,1
23680751,23680821,70,1,0,0,2
23680753,23680803,50,1,0,0,1
23680804,23681030,226,0,0,1,1
23680822,23681031,209,0,0,1,2
23681031,23681070,39,1,0,0,1
23681032,23681071,39,1,0,0,2
23681071,23681750,679,0,0,1,1
23681072,23681750,678,0,0,1,2
23681751,23681760,9,1,0,0,1
23681751,23681765,14,1,0,0,2
23681761,23683020,1259,0,0,1,1
23681766,23683020,1254,0,0,1,2
23683021,23683094,73,1,0,0,2
23683021,23683097,76,1,0,0,1
23683095,23683423,328,0,0,1,2
23683098,23683421,323,0,0,1,1
23683422,23683737,315,1,0,0,1
23683424,23683743,319,1,0,0,2
23683467,23683675,208,0,1,0,2
23683473,23683650,177,0,1,0,1
23683738,23684314,576,0,0,1,1
23683744,23684314,570,0,0,1,2
23684315,23684372,57,1,0,0,1
23684315,23684374,59,1,0,0,2
23684373,23684472,99,0,0,1,1
23684375,23684473,98,0,0,1,2
23684473,23684513,40,1,0,0,1
23684474,23684505,31,1,0,0,2
23684506,23685374,868,0,0,1,2
23684514,23684727,213,0,0,1,1
23684728,23684746,18,1,0,0,1
23684747,23685372,625,0,0,1,1
23685373,23685404,31,1,0,0,1
23685375,23685404,29,1,0,0,2
23685405,23685830,425,0,0,1,1
23685405,23685831,426,0,0,1,2
23685831,23685890,59,1,0,0,1
23685832,23685891,59,1,0,0,2
23685891,23686015,124,0,0,1,1
23685892,23686015,123,0,0,1,2
23686016,23686037,21,1,0,0,2
23686016,23686066,50,1,0,0,1
23686038,23687090,1052,0,0,1,2
23686067,23687094,1027,0,0,1,1
23687091,23687120,29,1,0,0,2
23687095,23687129,34,1,0,0,1
23687121,23687932,811,0,0,1,2
23687130,23687615,485,0,0,1,1
23687616,23687668,52,1,0,0,1
23687669,23687933,264,0,0,1,1
23687933,23687963,30,1,0,0,2
23687934,23687990,56,1,0,0,1
23687964,23688385,421,0,0,1,2
23687991,23688385,394,0,0,1,1
23688386,23688485,99,1,0,0,1
23688386,23688487,101,1,0,0,2
23688486,23688769,283,0,0,1,1
23688488,23688769,281,0,0,1,2
23688770,23688811,41,1,0,0,1
23688770,23688812,42,1,0,0,2
23688812,23689126,314,0,0,1,1
23688813,23689129,316,0,0,1,2
23689127,23689175,48,1,0,0,1
23689130,23689173,43,1,0,0,2
23689174,23689378,204,0,0,1,2
23689176,23689377,201,0,0,1,1
23689378,23689439,61,1,0,0,1
23689379,23689455,76,1,0,0,2
23689440,23689495,55,0,0,1,1
23689456,23689494,38,0,0,1,2
23689495,23689526,31,1,0,0,2
23689496,23689525,29,1,0,0,1
23689526,23689656,130,0,0,1,1
23689527,23689658,131,0,0,1,2
23689657,23689687,30,1,0,0,1
23689659,23689689,30,1,0,0,2
23689688,23690015,327,0,0,1,1
23689690,23690013,323,0,0,1,2
23690014,23690045,31,1,0,0,2
23690016,23690044,28,1,0,0,1
23690045,23690648,603,0,0,1,1
23690046,23690954,908,0,0,1,2
23690649,23690660,11,1,0,0,1
23690661,23690954,293,0,0,1,1
23690955,23690976,21,1,0,0,1
23690955,23690981,26,1,0,0,2
23690977,23691079,102,0,0,1,1
23690982,23691080,98,0,0,1,2
23691080,23691146,66,1,0,0,1
23691081,23691146,65,1,0,0,2
23691147,23691734,587,0,0,1,1
23691147,23691734,587,0,0,1,2
23691735,23691769,34,1,0,0,1
23691735,23691770,35,1,0,0,2
23691770,23693145,1375,0,0,1,1
23691771,23693334,1563,0,0,1,2
23693146,23693152,6,1,0,0,1
23693153,23693336,183,0,0,1,1
23693335,23693388,53,1,0,0,2
23693337,23693387,50,1,0,0,1
23693388,23693408,20,0,0,1,1
23693389,23693428,39,0,0,1,2
23693409,23693819,410,1,0,0,1
23693429,23693808,379,1,0,0,2
23693473,23693706,233,0,1,0,1
23693477,23693711,234,0,1,0,2
23693809,23693963,154,0,0,1,2
23693820,23693965,145,0,0,1,1
23693964,23694038,74,1,0,0,2
23693966,23694024,58,1,0,0,1
23694025,23694342,317,0,0,1,1
23694039,23694343,304,0,0,1,2
23694343,23694397,54,1,0,0,1
23694344,23694398,54,1,0,0,2
23694398,23694600,202,0,0,1,1
23694399,23694599,200,0,0,1,2
23694600,23694666,66,1,0,0,2
23694601,23694670,69,1,0,0,1
23694667,23694794,127,0,0,1,2
23694671,23694794,123,0,0,1,1
23694795,23694833,38,1,0,0,2
23694795,23694834,39,1,0,0,1
23694834,23695593,759,0,0,1,2
23694835,23695591,756,0,0,1,1
23695592,23695635,43,1,0,0,1
23695594,23695634,40,1,0,0,2
23695635,23695906,271,0,0,1,2
23695636,23695907,271,0,0,1,1
23695907,23695972,65,1,0,0,2
23695908,23695972,64,1,0,0,1
23695973,23696092,119,0,0,1,1
23695973,23696092,119,0,0,1,2
23696093,23696123,30,1,0,0,2
23696093,23696126,33,1,0,0,1
23696124,23697262,1138,0,0,1,2
23696127,23697261,1134,0,0,1,1
23697262,23697289,27,1,0,0,1
23697263,23697290,27,1,0,0,2
23697290,23697990,700,0,0,1,1
23697291,23697997,706,0,0,1,2
23697991,23698012,21,1,0,0,1
23697998,23698013,15,1,0,0,2
23698013,23698058,45,0,0,1,1
23698014,23698067,53,0,0,1,2
23698059,23698379,320,1,0,0,1
23698068,23698400,332,1,0,0,2
23698106,23698298,192,0,1,0,2
23698110,23698279,169,0,1,0,1
23698380,23698679,299,0,0,1,1
23698401,23698680,279,0,0,1,2
23698680,23698744,64,1,0,0,1
23698681,23698745,64,1,0,0,2
23698745,23698987,242,0,0,1,1
23698746,23698986,240,0,0,1,2
23698987,23699049,62,1,0,0,2
23698988,23699035,47,1,0,0,1
23699036,23699308,272,0,0,1,1
23699050,23699307,257,0,0,1,2
23699308,23699377,69,1,0,0,2
23699309,23699377,68,1,0,0,1
23699378,23699467,89,0,0,1,1
23699378,23699468,90,0,0,1,2
23699468,23699505,37,1,0,0,1
23699469,23699535,66,1,0,0,2
23699506,23699729,223,0,0,1,1
23699536,23699568,32,0,0,1,2
23699569,23699585,16,1,0,0,2
23699586,23699732,146,0,0,1,2
23699730,23699761,31,1,0,0,1
23699733,23699777,44,1,0,0,2
23699762,23700154,392,0,0,1,1
23699778,23700155,377,0,0,1,2
23700155,23700168,13,1,0,0,1
23700156,23700179,23,1,0,0,2
23700169,23700411,242,0,0,1,1
23700180,23700407,227,0,0,1,2
23700408,23700548,140,1,0,0,2
23700412,23700444,32,1,0,0,1
23700445,23700699,254,0,0,1,1
23700549,23700701,152,0,0,1,2
23700700,23700730,30,1,0,0,1
23700702,23700745,43,1,0,0,2
23700731,23700999,268,0,0,1,1
23700746,23700799,53,0,0,1,2
23700800,23702524,1724,1,0,0,2
23701000,23701032,32,1,0,0,1
23701033,23702371,1338,0,0,1,1
23702372,23702385,13,1,0,0,1
23702386,23702464,78,0,0,1,1
23702465,23702523,58,1,0,0,1
23702524,23703034,510,0,0,1,1
23702525,23702545,20,0,0,1,2
23702546,23702573,27,1,0,0,2
23702574,23703034,460,0,0,1,2
23703035,23703065,30,1,0,0,1
23703035,23703066,31,1,0,0,2
23703066,23704599,1533,0,0,1,1
23703067,23703346,279,0,0,1,2
23703347,23703438,91,1,0,0,2
23703439,23703503,64,0,0,1,2
23703504,23703822,318,1,0,0,2
23703823,23703898,75,0,0,1,2
23703899,23704050,151,1,0,0,2
23704051,23704169,118,0,0,1,2
23704170,23704187,17,1,0,0,2
23704188,23704340,152,0,0,1,2
23704341,23704375,34,1,0,0,2
23704376,23704563,187,0,0,1,2
23704564,23704689,125,1,0,0,2
23704600,23704619,19,1,0,0,1
23704620,23704843,223,0,0,1,1
23704690,23704711,21,0,0,1,2
23704712,23704726,14,1,0,0,2
23704727,23704831,104,0,0,1,2
23704832,23705066,234,1,0,0,2
23704844,23704894,50,1,0,0,1
23704895,23705012,117,0,0,1,1
23705013,23705065,52,1,0,0,1
23705066,23705327,261,0,0,1,1
23705067,23705327,260,0,0,1,2
23705328,23705374,46,1,0,0,1
23705328,23705378,50,1,0,0,2
23705375,23705671,296,0,0,1,1
23705379,23705671,292,0,0,1,2
23705672,23705726,54,1,0,0,1
23705672,23706014,342,1,0,0,2
23705727,23706239,512,0,0,1,1
23706015,23706159,144,0,0,1,2
23706160,23706310,150,1,0,0,2
23706240,23706284,44,1,0,0,1
23706285,23706393,108,0,0,1,1
23706311,23706393,82,0,0,1,2
23706394,23706415,21,1,0,0,1
23706394,23706422,28,1,0,0,2
23706416,23706660,244,0,0,1,1
23706423,23707706,1283,0,0,1,2
23706661,23706672,11,1,0,0,1
23706673,23707707,1034,0,0,1,1
23707707,23707735,28,1,0,0,2
23707708,23707736,28,1,0,0,1
23707736,23708607,871,0,0,1,2
23707737,23708606,869,0,0,1,1
23708607,23708663,56,1,0,0,1
23708608,23708666,58,1,0,0,2
23708664,23708815,151,0,0,1,1
23708667,23708815,148,0,0,1,2
23708816,23708849,33,1,0,0,2
23708816,23708850,34,1,0,0,1
23708850,23710455,1605,0,0,1,2
23708851,23710449,1598,0,0,1,1
23710450,23710477,27,1,0,0,1
23710456,23710476,20,1,0,0,2
23710477,23710880,403,0,0,1,2
23710478,23710876,398,0,0,1,1
23710877,23711070,193,1,0,0,1
23710881,23711094,213,1,0,0,2
23710936,23711012,76,0,1,0,2
23710947,23711003,56,0,1,0,1
23711071,23711173,102,0,0,1,1
23711095,23711165,70,0,0,1,2
23711166,23711547,381,1,0,0,2
23711174,23711498,324,1,0,0,1
23711205,23711437,232,0,1,0,2
23711206,23711415,209,0,1,0,1
23711499,23712295,796,0,0,1,1
23711548,23712296,748,0,0,1,2
23712296,23712329,33,1,0,0,1
23712297,23712338,41,1,0,0,2
23712330,23712712,382,0,0,1,1
23712339,23712709,370,0,0,1,2
23712710,23712768,58,1,0,0,2
23712713,23712778,65,1,0,0,1
23712769,23712865,96,0,0,1,2
23712779,23712866,87,0,0,1,1
23712866,23712901,35,1,0,0,2
23712867,23712901,34,1,0,0,1
23712902,23713947,1045,0,0,1,1
23712902,23713951,1049,0,0,1,2
23713948,23713988,40,1,0,0,1
23713952,23713984,32,1,0,0,2
23713985,23714474,489,0,0,1,2
23713989,23714473,484,0,0,1,1
23714474,23714530,56,1,0,0,1
23714475,23714532,57,1,0,0,2
23714531,23714727,196,0,0,1,1
23714533,23714734,201,0,0,1,2
23714728,23714759,31,1,0,0,1
23714735,23714760,25,1,0,0,2
23714760,23716182,1422,0,0,1,1
23714761,23716463,1702,0,0,1,2
23716183,23716187,4,1,0,0,1
23716188,23716476,288,0,0,1,1
23716464,23716811,347,1,0,0,2
23716477,23716736,259,1,0,0,1
23716502,23716680,178,0,1,0,2
23716514,23716641,127,0,1,0,1
23716737,23717041,304,0,0,1,1
23716812,23717042,230,0,0,1,2
23717042,23717116,74,1,0,0,1
23717043,23717126,83,1,0,0,2
23717117,23717582,465,0,0,1,1
23717127,23717582,455,0,0,1,2
23717583,23717607,24,1,0,0,2
23717583,23717608,25,1,0,0,1
23717608,23717949,341,0,0,1,2
23717609,23717949,340,0,0,1,1
23717950,23718010,60,1,0,0,2
23717950,23718011,61,1,0,0,1
23718011,23718085,74,0,0,1,2
23718012,23718085,73,0,0,1,1
23718086,23718125,39,1,0,0,2
23718086,23718134,48,1,0,0,1
23718126,23718244,118,0,0,1,2
23718135,23718245,110,0,0,1,1
23718245,23718276,31,1,0,0,2
23718246,23718293,47,1,0,0,1
23718277,23719157,880,0,0,1,2
23718294,23719146,852,0,0,1,1
23719147,23719174,27,1,0,0,1
23719158,23719163,5,1,0,0,2
23719164,23719569,405,0,0,1,2
23719175,23719568,393,0,0,1,1
23719569,23719639,70,1,0,0,1
23719570,23719640,70,1,0,0,2
23719640,23719741,101,0,0,1,1
23719641,23719742,101,0,0,1,2
23719742,23719782,40,1,0,0,1
23719743,23719783,40,1,0,0,2
23719783,23721645,1862,0,0,1,1
23719784,23721645,1861,0,0,1,2
23721646,23721849,203,1,0,0,1
23721646,23722004,358,1,0,0,2
23721681,23721785,104,0,1,0,2
23721693,23721752,59,0,1,0,1
23721850,23721925,75,0,0,1,1
23721926,23722011,85,1,0,0,1
23722005,23722274,269,0,0,1,2
23722012,23722275,263,0,0,1,1
23722275,23722349,74,1,0,0,2
23722276,23722349,73,1,0,0,1
23722350,23722880,530,0,0,1,1
23722350,23722880,530,0,0,1,2
23722881,23722937,56,1,0,0,1
23722881,23722940,59,1,0,0,2
23722938,23723108,170,0,0,1,1
23722941,23723107,166,0,0,1,2
23723108,23723149,41,1,0,0,2
23723109,23723135,26,1,0,0,1
23723136,23723478,342,0,0,1,1
23723150,23723478,328,0,0,1,2
23723479,23723507,28,1,0,0,1
23723479,23723515,36,1,0,0,2
23723508,23723773,265,0,0,1,1
23723516,23723775,259,0,0,1,2
23723774,23723809,35,1,0,0,1
23723776,23723803,27,1,0,0,2
23723804,23723964,160,0,0,1,2
23723810,23723964,154,0,0,1,1
23723965,23723998,33,1,0,0,1
23723965,23723999,34,1,0,0,2
23723999,23724205,206,0,0,1,1
23724000,23724206,206,0,0,1,2
23724206,23726380,2174,1,0,0,1
23724207,23726369,2162,1,0,0,2
23724239,23726349,2110,0,1,0,1
23724239,23726349,2110,0,1,0,2
23726370,23726442,72,0,0,1,2
23726381,23726439,58,0,0,1,1
23726440,23726639,199,1,0,0,1
23726443,23726649,206,1,0,0,2
23726460,23726604,144,0,1,0,2
23726463,23726602,139,0,1,0,1
23726640,23726779,139,0,0,1,1
23726650,23726779,129,0,0,1,2
23726780,23726810,30,1,0,0,1
23726780,23726908,128,1,0,0,2
23726811,23727013,202,0,0,1,1
23726909,23726991,82,0,0,1,2
23726992,23727055,63,1,0,0,2
23727014,23727037,23,1,0,0,1
23727038,23727264,226,0,0,1,1
23727056,23727110,54,0,0,1,2
23727111,23727206,95,1,0,0,2
23727207,23727267,60,0,0,1,2
23727265,23727289,24,1,0,0,1
23727268,23727340,72,1,0,0,2
23727290,23727514,224,0,0,1,1
23727341,23727514,173,0,0,1,2
23784598,23784833,235,0,0,1,1
23784627,23784834,207,0,0,1,2
23784834,23784910,76,1,0,0,1
23784835,23785084,249,1,0,0,2
23784881,23785048,167,0,1,0,2
23784911,23785046,135,0,0,1,1
23785047,23785304,257,1,0,0,1
23785063,23785269,206,0,1,0,1
23785085,23785268,183,0,0,1,2
23785269,23785298,29,1,0,0,2
23785299,23786123,824,0,0,1,2
23785305,23785781,476,0,0,1,1
23785792,23785944,152,0,1,0,1
23785953,23785953,0,1,0,0,1
23785954,23786008,54,0,0,1,1
23786019,23786022,3,0,1,0,1
23786032,23786037,5,1,0,0,1
23786038,23786120,82,0,0,1,1
23786121,23786463,342,1,0,0,1
23786124,23787072,948,1,0,0,2
23786136,23786331,195,0,1,0,1
23786140,23786992,852,0,1,0,2
23786366,23786373,7,0,1,0,1
23786464,23786702,238,0,0,1,1
23786703,23786733,30,1,0,0,1
23786734,23787707,973,0,0,1,1
23787016,23787063,47,0,1,0,2
23787073,23787225,152,0,0,1,2
23787226,23787267,41,1,0,0,2
23787239,23787258,19,0,1,0,2
23787268,23787362,94,0,0,1,2
23787363,23787517,154,1,0,0,2
23787518,23787774,256,0,0,1,2
23787718,23788032,314,0,1,0,1
23787775,23787864,89,1,0,0,2
23787865,23787933,68,0,0,1,2
23787934,23788130,196,1,0,0,2
23788041,23788051,10,0,1,0,2
23788042,23788159,117,1,0,0,1
23788131,23788412,281,0,0,1,2
23788160,23788412,252,0,0,1,1
23788413,23788482,69,1,0,0,1
23788413,23788491,78,1,0,0,2
23788483,23788573,90,0,0,1,1
23788492,23788575,83,0,0,1,2
23788574,23788613,39,1,0,0,1
23788576,23788621,45,1,0,0,2
23788614,23790039,1425,0,0,1,1
23788622,23789230,608,0,0,1,2
23789231,23789614,383,1,0,0,2
23789615,23790036,421,0,0,1,2
23790037,23790145,108,1,0,0,2
23790040,23790143,103,1,0,0,1
23790144,23790182,38,0,0,1,1
23790146,23790536,390,0,0,1,2
23790183,23790198,15,1,0,0,1
23790199,23790535,336,0,0,1,1
23790536,23790578,42,1,0,0,1
23790537,23790579,42,1,0,0,2
23790579,23790793,214,0,0,1,1
23790580,23790794,214,0,0,1,2
23790794,23790826,32,1,0,0,1
23790795,23790839,44,1,0,0,2
23790827,23791190,363,0,0,1,1
23790840,23790954,114,0,0,1,2
23790955,23790959,4,1,0,0,2
23790960,23791189,229,0,0,1,2
23791190,23791223,33,1,0,0,2
23791191,23791228,37,1,0,0,1
23791224,23791525,301,0,0,1,2
23791229,23791525,296,0,0,1,1
23791526,23791603,77,1,0,0,1
23791526,23791610,84,1,0,0,2
23791604,23791993,389,0,0,1,1
23791611,23791994,383,0,0,1,2
23791994,23792202,208,1,0,0,1
23791995,23792082,87,1,0,0,2
23792044,23792161,117,0,1,0,1
23792083,23792124,41,0,0,1,2
23792125,23792213,88,1,0,0,2
23792203,23792960,757,0,0,1,1
23792214,23792673,459,0,0,1,2
23792674,23792678,4,1,0,0,2
23792679,23792746,67,0,0,1,2
23792747,23792875,128,1,0,0,2
23792876,23792945,69,0,0,1,2
23792946,23793200,254,1,0,0,2
23792961,23793015,54,1,0,0,1
23792974,23792993,19,0,1,0,1
23793016,23793131,115,0,0,1,1
23793132,23793178,46,1,0,0,1
23793179,23793358,179,0,0,1,1
23793201,23793359,158,0,0,1,2
23793359,23793411,52,1,0,0,1
23793360,23793408,48,1,0,0,2
23793409,23793482,73,0,0,1,2
23793412,23793483,71,0,0,1,1
23793483,23793611,128,1,0,0,2
23793484,23793519,35,1,0,0,1
23793520,23793574,54,0,0,1,1
23793575,23793610,35,1,0,0,1
23793611,23793918,307,0,0,1,1
23793612,23793703,91,0,0,1,2
23793704,23793736,32,1,0,0,2
23793737,23793916,179,0,0,1,2
23793917,23793991,74,1,0,0,2
23793919,23793949,30,1,0,0,1
23793950,23794162,212,0,0,1,1
23793992,23794044,52,0,0,1,2
23794045,23794063,18,1,0,0,2
23794064,23794174,110,0,0,1,2
23794163,23795376,1213,1,0,0,1
23794175,23795420,1245,1,0,0,2
23794275,23795365,1090,0,1,0,1
23794279,23795368,1089,0,1,0,2
23795377,23795449,72,0,0,1,1
23795421,23795451,30,0,0,1,2
23795450,23795703,253,1,0,0,1
23795452,23795706,254,1,0,0,2
23795470,23795632,162,0,1,0,2
23795473,23795606,133,0,1,0,1
23795704,23795745,41,0,0,1,1
23795707,23795746,39,0,0,1,2
23795746,23795783,37,1,0,0,1
23795747,23795957,210,1,0,0,2
23795784,23795994,210,0,0,1,1
23795958,23795992,34,0,0,1,2
23795993,23796130,137,1,0,0,2
23795995,23796012,17,1,0,0,1
23796013,23796267,254,0,0,1,1
23796131,23796169,38,0,0,1,2
23796170,23796426,256,1,0,0,2
23796268,23796313,45,1,0,0,1
23796314,23796574,260,0,0,1,1
23796427,23796573,146,0,0,1,2
23796574,23796680,106,1,0,0,2
23796575,23796603,28,1,0,0,1
23796604,23797088,484,0,0,1,1
23796681,23797090,409,0,0,1,2
23797089,23797166,77,1,0,0,1
23797091,23797178,87,1,0,0,2
23797167,23797553,386,0,0,1,1
23797179,23797552,373,0,0,1,2
23797553,23797615,62,1,0,0,2
23797554,23797614,60,1,0,0,1
23797615,23797778,163,0,0,1,1
23797616,23797781,165,0,0,1,2
23797779,23797786,7,1,0,0,1
23797782,23797786,4,1,0,0,2
23797787,23798490,703,0,0,1,1
23797787,23798491,704,0,0,1,2
23798491,23798536,45,1,0,0,1
23798492,23798574,82,1,0,0,2
23798537,23798932,395,0,0,1,1
23798575,23798784,209,0,0,1,2
23798785,23798798,13,1,0,0,2
23798799,23798932,133,0,0,1,2
23798933,23799001,68,1,0,0,2
23798933,23799004,71,1,0,0,1
23799002,23799042,40,0,0,1,2
23799005,23799043,38,0,0,1,1
23799043,23799127,84,1,0,0,2
23799044,23799100,56,1,0,0,1
23799101,23799165,64,0,0,1,1
23799128,23799167,39,0,0,1,2
23799166,23799201,35,1,0,0,1
23799168,23799203,35,1,0,0,2
23799202,23799382,180,0,0,1,1
23799204,23799377,173,0,0,1,2
23799378,23799405,27,1,0,0,2
23799383,23799405,22,1,0,0,1
23799406,23800199,793,0,0,1,1
23799406,23800201,795,0,0,1,2
23800200,23800243,43,1,0,0,1
23800202,23800249,47,1,0,0,2
23800244,23800337,93,0,0,1,1
23800250,23800337,87,0,0,1,2
23800338,23800376,38,1,0,0,1
23800338,23800377,39,1,0,0,2
23800377,23800604,227,0,0,1,1
23800378,23800605,227,0,0,1,2
23800605,23800689,84,1,0,0,1
23800606,23800687,81,1,0,0,2
23800688,23800730,42,0,0,1,2
23800690,23800729,39,0,0,1,1
23800730,23800781,51,1,0,0,1
23800731,23800783,52,1,0,0,2
23800782,23800838,56,0,0,1,1
23800784,23800841,57,0,0,1,2
23800839,23800884,45,1,0,0,1
23800842,23800885,43,1,0,0,2
23800885,23801238,353,0,0,1,1
23800886,23801238,352,0,0,1,2
23801239,23801268,29,1,0,0,1
23801239,23801270,31,1,0,0,2
23801269,23801786,517,0,0,1,1
23801271,23801780,509,0,0,1,2
23801781,23801856,75,1,0,0,2
23801787,23801849,62,1,0,0,1
23801850,23802008,158,0,0,1,1
23801857,23802008,151,0,0,1,2
23802009,23802058,49,1,0,0,1
23802009,23802063,54,1,0,0,2
23802059,23802252,193,0,0,1,1
23802064,23802248,184,0,0,1,2
23802249,23802343,94,1,0,0,2
23802253,23802333,80,1,0,0,1
23802334,23803354,1020,0,0,1,1
23802344,23802600,256,0,0,1,2
23802601,23802614,13,1,0,0,2
23802615,23803131,516,0,0,1,2
23803132,23803205,73,1,0,0,2
23803206,23803342,136,0,0,1,2
23803343,23803432,89,1,0,0,2
23803355,23803436,81,1,0,0,1
23803433,23803812,379,0,0,1,2
23803437,23803812,375,0,0,1,1
23803813,23803869,56,1,0,0,1
23803813,23803871,58,1,0,0,2
23803870,23803965,95,0,0,1,1
23803872,23803962,90,0,0,1,2
23803963,23804008,45,1,0,0,2
23803966,23803997,31,1,0,0,1
23803998,23804888,890,0,0,1,1
23804009,23804887,878,0,0,1,2
23804888,23804968,80,1,0,0,2
23804889,23804969,80,1,0,0,1
23804969,23805231,262,0,0,1,2
23804970,23805232,262,0,0,1,1
23805232,23805288,56,1,0,0,2
23805233,23805288,55,1,0,0,1
23805289,23805395,106,0,0,1,1
23805289,23805396,107,0,0,1,2
23805396,23805455,59,1,0,0,1
23805397,23805464,67,1,0,0,2
23805456,23806385,929,0,0,1,1
23805465,23805635,170,0,0,1,2
23805636,23805652,16,1,0,0,2
23805653,23805959,306,0,0,1,2
23805960,23806011,51,1,0,0,2
23806012,23806359,347,0,0,1,2
23806360,23806512,152,1,0,0,2
23806386,23806474,88,1,0,0,1
23806475,23806892,417,0,0,1,1
23806513,23806891,378,0,0,1,2
23806892,23806923,31,1,0,0,2
23806893,23806922,29,1,0,0,1
23806923,23808009,1086,0,0,1,1
23806924,23808010,1086,0,0,1,2
23808010,23808033,23,1,0,0,1
23808011,23808033,22,1,0,0,2
23808034,23808269,235,0,0,1,2
23808034,23808272,238,0,0,1,1
23808270,23808345,75,1,0,0,2
23808273,23808336,63,1,0,0,1
23808337,23808397,60,0,0,1,1
23808346,23808395,49,0,0,1,2
23808396,23808461,65,1,0,0,2
23808398,23808461,63,1,0,0,1
23808462,23808492,30,0,0,1,1
23808462,23808494,32,0,0,1,2
23808493,23808582,89,1,0,0,1
23808495,23808584,89,1,0,0,2
23808583,23808652,69,0,0,1,1
23808585,23808653,68,0,0,1,2
23808653,23808688,35,1,0,0,1
23808654,23808699,45,1,0,0,2
23808689,23808846,157,0,0,1,1
23808700,23808846,146,0,0,1,2
23808847,23808875,28,1,0,0,1
23808847,23808884,37,1,0,0,2
23808876,23809759,883,0,0,1,1
23808885,23809758,873,0,0,1,2
23809759,23809828,69,1,0,0,2
23809760,23809825,65,1,0,0,1
23809826,23810028,202,0,0,1,1
23809829,23810025,196,0,0,1,2
23810026,23810112,86,1,0,0,2
23810029,23810127,98,1,0,0,1
23810113,23810196,83,0,0,1,2
23810128,23810192,64,0,0,1,1
23810193,23810268,75,1,0,0,1
23810197,23810232,35,1,0,0,2
23810233,23811050,817,0,0,1,2
23810269,23811048,779,0,0,1,1
23811049,23811169,120,1,0,0,1
23811051,23811170,119,1,0,0,2
23811170,23811262,92,0,0,1,1
23811171,23811264,93,0,0,1,2
23811263,23811320,57,1,0,0,1
23811265,23811331,66,1,0,0,2
23811321,23811515,194,0,0,1,1
23811332,23811512,180,0,0,1,2
23811513,23811617,104,1,0,0,2
23811516,23811576,60,1,0,0,1
23811577,23811653,76,0,0,1,1
23811618,23811650,32,0,0,1,2
23811651,23811694,43,1,0,0,2
23811654,23811689,35,1,0,0,1
23811690,23811925,235,0,0,1,1
23811695,23811763,68,0,0,1,2
23811764,23812075,311,1,0,0,2
23811926,23811958,32,1,0,0,1
23811959,23812540,581,0,0,1,1
23812076,23812129,53,0,0,1,2
23812130,23812176,46,1,0,0,2
23812177,23812341,164,0,0,1,2
23812342,23812381,39,1,0,0,2
23812382,23812412,30,0,0,1,2
23812413,23812504,91,1,0,0,2
23812505,23812538,33,0,0,1,2
23812539,23812618,79,1,0,0,2
23812541,23812559,18,1,0,0,1
23812560,23812977,417,0,0,1,1
23812619,23812759,140,0,0,1,2
23812760,23812781,21,1,0,0,2
23812782,23812977,195,0,0,1,2
23812978,23813037,59,1,0,0,1
23812978,23813044,66,1,0,0,2
23813038,23813071,33,0,0,1,1
23813045,23813072,27,0,0,1,2
23813072,23813107,35,1,0,0,1
23813073,23813110,37,1,0,0,2
23813108,23813156,48,0,0,1,1
23813111,23813157,46,0,0,1,2
23813157,23813200,43,1,0,0,1
23813158,23813204,46,1,0,0,2
23813201,23813495,294,0,0,1,1
23813205,23813496,291,0,0,1,2
23813496,23813525,29,1,0,0,1
23813497,23813526,29,1,0,0,2
23813526,23814077,551,0,0,1,1
23813527,23814077,550,0,0,1,2
23814078,23814140,62,1,0,0,1
23814078,23814149,71,1,0,0,2
23814141,23814410,269,0,0,1,1
23814150,23814409,259,0,0,1,2
23814410,23814472,62,1,0,0,2
23814411,23814499,88,1,0,0,1
23814473,23814579,106,0,0,1,2
23814500,23814576,76,0,0,1,1
23814577,23814630,53,1,0,0,1
23814580,23814624,44,1,0,0,2
23814625,23814783,158,0,0,1,2
23814631,23814785,154,0,0,1,1
23814784,23814811,27,1,0,0,2
23814786,23814812,26,1,0,0,1
23814812,23815502,690,0,0,1,2
23814813,23815501,688,0,0,1,1
23815502,23815573,71,1,0,0,1
23815503,23815571,68,1,0,0,2
23815572,23815954,382,0,0,1,2
23815574,23815953,379,0,0,1,1
23815954,23816011,57,1,0,0,1
23815955,23816031,76,1,0,0,2
23816012,23816098,86,0,0,1,1
23816032,23816098,66,0,0,1,2
23816099,23816132,33,1,0,0,1
23816099,23816148,49,1,0,0,2
23816133,23816662,529,0,0,1,1
23816149,23816658,509,0,0,1,2
23816659,23816692,33,1,0,0,2
23816663,23816675,12,1,0,0,1
23816676,23817084,408,0,0,1,1
23816693,23816850,157,0,0,1,2
23816851,23816868,17,1,0,0,2
23816869,23816924,55,0,0,1,2
23816925,23816943,18,1,0,0,2
23816944,23817085,141,0,0,1,2
23817085,23817143,58,1,0,0,1
23817086,23817204,118,1,0,0,2
23817144,23817429,285,0,0,1,1
23817205,23817430,225,0,0,1,2
23817430,23817496,66,1,0,0,1
23817431,23817497,66,1,0,0,2
23817497,23817604,107,0,0,1,1
23817498,23817606,108,0,0,1,2
23817605,23817644,39,1,0,0,1
23817607,23818697,1090,1,0,0,2
23817620,23818620,1000,0,1,0,2
23817645,23818594,949,0,0,1,1
23818595,23818674,79,1,0,0,1
23818675,23818923,248,0,0,1,1
23818698,23818915,217,0,0,1,2
23818916,23819168,252,1,0,0,2
23818924,23819010,86,1,0,0,1
23819011,23819083,72,0,0,1,1
23819084,23819119,35,1,0,0,1
23819120,23819348,228,0,0,1,1
23819169,23819204,35,0,0,1,2
23819205,23819229,24,1,0,0,2
23819230,23819348,118,0,0,1,2
23819349,23819381,32,1,0,0,1
23819349,23819395,46,1,0,0,2
23819382,23820286,904,0,0,1,1
23819396,23820287,891,0,0,1,2
23820287,23820361,74,1,0,0,1
23820288,23820360,72,1,0,0,2
23820361,23820590,229,0,0,1,2
23820362,23820589,227,0,0,1,1
23820590,23820674,84,1,0,0,1
23820591,23820683,92,1,0,0,2
23820675,23820721,46,0,0,1,1
23820684,23820722,38,0,0,1,2
23820722,23820787,65,1,0,0,1
23820723,23820900,177,1,0,0,2
23820763,23820864,101,0,1,0,2
23820788,23820852,64,0,0,1,1
23820853,23820902,49,1,0,0,1
23820901,23821075,174,0,0,1,2
23820903,23821077,174,0,0,1,1
23821076,23821113,37,1,0,0,2
23821078,23821106,28,1,0,0,1
23821107,23822047,940,0,0,1,1
23821114,23821218,104,0,0,1,2
23821219,23821282,63,1,0,0,2
23821283,23821869,586,0,0,1,2
23821870,23821874,4,1,0,0,2
23821875,23822040,165,0,0,1,2
23822041,23822180,139,1,0,0,2
23822048,23822201,153,1,0,0,1
23822108,23822126,18,0,1,0,1
23822111,23822119,8,0,1,0,2
23822181,23822545,364,0,0,1,2
23822202,23822544,342,0,0,1,1
23822545,23822613,68,1,0,0,1
23822546,23822617,71,1,0,0,2
23822614,23822658,44,0,0,1,1
23822618,23822659,41,0,0,1,2
23822659,23822700,41,1,0,0,1
23822660,23822727,67,1,0,0,2
23822701,23822768,67,0,0,1,1
23822728,23822771,43,0,0,1,2
23822769,23822796,27,1,0,0,1
23822772,23822814,42,1,0,0,2
23822797,23823862,1065,0,0,1,1
23822815,23823861,1046,0,0,1,2
23823862,23823960,98,1,0,0,2
23823863,23823960,97,1,0,0,1
23823961,23824370,409,0,0,1,2
23823961,23824371,410,0,0,1,1
23824371,23824417,46,1,0,0,2
23824372,23824415,43,1,0,0,1
23824416,23824521,105,0,0,1,1
23824418,23824518,100,0,0,1,2
23824519,23824542,23,1,0,0,2
23824522,23824546,24,1,0,0,1
23824543,23824931,388,0,0,1,2
23824547,23825012,465,0,0,1,1
23824932,23825088,156,1,0,0,2
23825013,23825039,26,1,0,0,1
23825040,23825639,599,0,0,1,1
23825089,23825978,889,0,0,1,2
23825640,23825656,16,1,0,0,1
23825657,23825976,319,0,0,1,1
23825977,23826055,78,1,0,0,1
23825979,23826035,56,1,0,0,2
23826036,23826130,94,0,0,1,2
23826056,23826133,77,0,0,1,1
23826131,23826177,46,1,0,0,2
23826134,23826192,58,1,0,0,1
23826178,23827088,910,0,0,1,2
23826193,23826501,308,0,0,1,1
23826502,23826560,58,1,0,0,1
23826561,23826914,353,0,0,1,1
23826915,23826999,84,1,0,0,1
23827000,23827081,81,0,0,1,1
23827082,23827159,77,1,0,0,1
23827089,23827159,70,1,0,0,2
23827160,23827520,360,0,0,1,2
23827160,23827522,362,0,0,1,1
23827521,23827589,68,1,0,0,2
23827523,23827591,68,1,0,0,1
23827590,23827686,96,0,0,1,2
23827592,23827685,93,0,0,1,1
23827686,23827720,34,1,0,0,1
23827687,23827720,33,1,0,0,2
23827721,23828636,915,0,0,1,1
23827721,23828636,915,0,0,1,2
23828637,23828699,62,1,0,0,1
23828637,23828740,103,1,0,0,2
23828700,23829051,351,0,0,1,1
23828741,23829048,307,0,0,1,2
23829049,23829115,66,1,0,0,2
23829052,23829144,92,1,0,0,1
23829116,23829196,80,0,0,1,2
23829145,23829197,52,0,0,1,1
23829197,23829244,47,1,0,0,2
23829198,23829259,61,1,0,0,1
23829245,23829391,146,0,0,1,2
23829260,23829390,130,0,0,1,1
23829391,23829428,37,1,0,0,1
23829392,23829430,38,1,0,0,2
23829429,23830305,876,0,0,1,1
23829431,23830306,875,0,0,1,2
23830306,23830413,107,1,0,0,1
23830307,23830414,107,1,0,0,2
23830414,23830770,356,0,0,1,1
23830415,23830732,317,0,0,1,2
23830733,23830737,4,1,0,0,2
23830738,23830773,35,0,0,1,2
23830771,23830845,74,1,0,0,1
23830774,23830869,95,1,0,0,2
23830846,23830920,74,0,0,1,1
23830870,23830925,55,0,0,1,2
23830921,23831122,201,1,0,0,1
23830926,23830970,44,1,0,0,2
23830956,23831112,156,0,1,0,1
23830971,23831252,281,0,0,1,2
23831123,23831145,22,0,0,1,1
23831146,23831282,136,1,0,0,1
23831157,23831265,108,0,1,0,1
23831253,23831284,31,1,0,0,2
23831283,23831387,104,0,0,1,1
23831285,23831580,295,0,0,1,2
23831388,23831925,537,1,0,0,1
23831399,23831483,84,0,1,0,1
23831504,23831507,3,0,1,0,1
23831547,23831863,316,0,1,0,1
23831581,23832292,711,1,0,0,2
23831623,23831870,247,0,1,0,2
23831926,23832054,128,0,0,1,1
23831954,23831958,4,0,1,0,2
23832055,23832059,4,1,0,0,1
23832060,23832100,40,0,0,1,1
23832101,23832122,21,1,0,0,1
23832123,23832191,68,0,0,1,1
23832192,23832259,67,1,0,0,1
23832260,23832564,304,0,0,1,1
23832293,23832401,108,0,0,1,2
23832402,23832423,21,1,0,0,2
23832424,23832564,140,0,0,1,2
23832565,23832617,52,1,0,0,2
23832565,23832625,60,1,0,0,1
23832618,23832755,137,0,0,1,2
23832626,23832756,130,0,0,1,1
23832756,23832792,36,1,0,0,2
23832757,23832780,23,1,0,0,1
23832781,23833200,419,0,0,1,1
23832793,23833203,410,0,0,1,2
23833201,23833230,29,1,0,0,1
23833204,23833230,26,1,0,0,2
23833231,23834151,920,0,0,1,1
23833231,23834156,925,0,0,1,2
23834152,23834191,39,1,0,0,1
23834157,23834186,29,1,0,0,2
23834187,23834599,412,0,0,1,2
23834192,23834599,407,0,0,1,1
23834600,23834661,61,1,0,0,1
23834600,23834682,82,1,0,0,2
23834662,23834732,70,0,0,1,1
23834683,23834773,90,0,0,1,2
23834743,23834792,49,0,1,0,1
23834774,23835889,1115,1,0,0,2
23834789,23835862,1073,0,1,0,2
23834802,23834847,45,1,0,0,1
23834819,23834829,10,0,1,0,1
23834848,23834869,21,0,0,1,1
23834870,23835450,580,1,0,0,1
23834959,23835348,389,0,1,0,1
23835451,23835591,140,0,0,1,1
23835592,23835893,301,1,0,0,1
23835607,23835830,223,0,1,0,1
23835890,23836191,301,0,0,1,2
23835894,23836193,299,0,0,1,1
23836192,23836270,78,1,0,0,2
23836194,23836422,228,1,0,0,1
23836271,23836295,24,0,0,1,2
23836296,23836351,55,1,0,0,2
23836352,23836376,24,0,0,1,2
23836377,23836436,59,1,0,0,2
23836423,23836527,104,0,0,1,1
23836437,23836527,90,0,0,1,2
23836528,23836553,25,1,0,0,2
23836528,23836570,42,1,0,0,1
23836554,23837070,516,0,0,1,2
23836571,23837074,503,0,0,1,1
23837071,23837130,59,1,0,0,2
23837075,23837156,81,1,0,0,1
23837131,23837355,224,0,0,1,2
23837157,23837355,198,0,0,1,1
23837356,23837418,62,1,0,0,2
23837356,23837544,188,1,0,0,1
23837419,23837453,34,0,0,1,2
23837454,23837600,146,1,0,0,2
23837545,23837964,419,0,0,1,1
23837601,23837882,281,0,0,1,2
23837883,23838051,168,1,0,0,2
23837965,23838032,67,1,0,0,1
23838010,23838013,3,0,1,0,1
23838033,23838133,100,0,0,1,1
23838052,23838130,78,0,0,1,2
23838131,23839094,963,1,0,0,2
23838134,23838180,46,1,0,0,1
23838144,23839033,889,0,1,0,2
23838181,23838637,456,0,0,1,1
23838638,23838656,18,1,0,0,1
23838657,23839002,345,0,0,1,1
23839003,23839084,81,1,0,0,1
23839021,23839024,3,0,1,0,1
23839085,23839463,378,0,0,1,1
23839095,23839138,43,0,0,1,2
23839139,23839154,15,1,0,0,2
23839155,23839191,36,0,0,1,2
23839192,23839214,22,1,0,0,2
23839215,23839457,242,0,0,1,2
23839458,23839572,114,1,0,0,2
23839464,23839510,46,1,0,0,1
23839511,23839945,434,0,0,1,1
23839573,23839943,370,0,0,1,2
23839944,23840001,57,1,0,0,2
23839946,23839976,30,1,0,0,1
23839977,23840665,688,0,0,1,1
23840002,23840441,439,0,0,1,2
23840442,23840552,110,1,0,0,2
23840553,23840663,110,0,0,1,2
23840664,23840719,55,1,0,0,2
23840666,23840714,48,1,0,0,1
23840715,23840967,252,0,0,1,1
23840720,23840967,247,0,0,1,2
23840968,23841027,59,1,0,0,1
23840968,23841257,289,1,0,0,2
23841028,23841166,138,0,0,1,1
23841167,23841248,81,1,0,0,1
23841249,23841352,103,0,0,1,1
23841258,23841349,91,0,0,1,2
23841350,23841396,46,1,0,0,2
23841353,23841390,37,1,0,0,1
23841391,23841555,164,0,0,1,1
23841397,23841551,154,0,0,1,2
23841552,23841610,58,1,0,0,2
23841556,23841586,30,1,0,0,1
23841587,23841816,229,0,0,1,1
23841611,23841815,204,0,0,1,2
23841816,23841854,38,1,0,0,2
23841817,23841846,29,1,0,0,1
23841847,23842161,314,0,0,1,1
23841855,23842159,304,0,0,1,2
23842160,23842711,551,1,0,0,2
23842162,23842240,78,1,0,0,1
23842241,23842660,419,0,0,1,1
23842661,23842728,67,1,0,0,1
23842712,23842776,64,0,0,1,2
23842729,23842777,48,0,0,1,1
23842777,23842818,41,1,0,0,2
23842778,23842817,39,1,0,0,1
23842818,23842892,74,0,0,1,1
23842819,23842894,75,0,0,1,2
23842893,23842925,32,1,0,0,1
23842895,23842923,28,1,0,0,2
23842924,23843417,493,0,0,1,2
23842926,23843403,477,0,0,1,1
23843404,23843938,534,1,0,0,1
23843418,23844024,606,1,0,0,2
23843509,23843915,406,0,1,0,1
23843518,23844004,486,0,1,0,2
23843939,23844044,105,0,0,1,1
23844025,23844047,22,0,0,1,2
23844045,23844074,29,1,0,0,1
23844048,23844066,18,1,0,0,2
23844067,23844161,94,0,0,1,2
23844075,23844244,169,0,0,1,1
23844162,23844187,25,1,0,0,2
23844188,23844243,55,0,0,1,2
23844244,23844336,92,1,0,0,2
23844245,23844328,83,1,0,0,1
23844329,23844360,31,0,0,1,1
23844337,23844361,24,0,0,1,2
23844361,23844412,51,1,0,0,1
23844362,23844410,48,1,0,0,2
23844411,23844508,97,0,0,1,2
23844413,23844510,97,0,0,1,1
23844509,23844564,55,1,0,0,2
23844511,23844561,50,1,0,0,1
23844562,23845672,1110,0,0,1,1
23844565,23845674,1109,0,0,1,2
23845673,23845762,89,1,0,0,1
23845675,23845761,86,1,0,0,2
23845762,23846193,431,0,0,1,2
23845763,23846192,429,0,0,1,1
23846193,23846264,71,1,0,0,1
23846194,23846277,83,1,0,0,2
23846265,23846360,95,0,0,1,1
23846278,23846362,84,0,0,1,2
23846361,23846407,46,1,0,0,1
23846363,23846407,44,1,0,0,2
23846408,23846665,257,0,0,1,2
23846408,23846667,259,0,0,1,1
23846666,23846690,24,1,0,0,2
23846668,23846687,19,1,0,0,1
23846688,23847938,1250,0,0,1,1
23846691,23846725,34,0,0,1,2
23846726,23846741,15,1,0,0,2
23846742,23846800,58,0,0,1,2
23846801,23846864,63,1,0,0,2
23846865,23847066,201,0,0,1,2
23847067,23847587,520,1,0,0,2
23847588,23847937,349,0,0,1,2
23847938,23848020,82,1,0,0,2
23847939,23848012,73,1,0,0,1
23848013,23848097,84,0,0,1,1
23848021,23848097,76,0,0,1,2
23848098,23848165,67,1,0,0,2
23848098,23848175,77,1,0,0,1
23848166,23848269,103,0,0,1,2
23848176,23848268,92,0,0,1,1
23848269,23848305,36,1,0,0,1
23848270,23848311,41,1,0,0,2
23848306,23849261,955,0,0,1,1
23848312,23849031,719,0,0,1,2
23849032,23849159,127,1,0,0,2
23849160,23849228,68,0,0,1,2
23849229,23849339,110,1,0,0,2
23849262,23849303,41,1,0,0,1
23849304,23849671,367,0,0,1,1
23849340,23849671,331,0,0,1,2
23849672,23849758,86,1,0,0,1
23849672,23849759,87,1,0,0,2
23849759,23849811,52,0,0,1,1
23849760,23849812,52,0,0,1,2
23849812,23849866,54,1,0,0,1
23849813,23849867,54,1,0,0,2
23849867,23849903,36,0,0,1,1
23849868,23849904,36,0,0,1,2
23849904,23849955,51,1,0,0,1
23849905,23849950,45,1,0,0,2
23849951,23850211,260,0,0,1,2
23849956,23850211,255,0,0,1,1
23850212,23850242,30,1,0,0,2
23850212,23850245,33,1,0,0,1
23850243,23850783,540,0,0,1,2
23850246,23850785,539,0,0,1,1
23850784,23850812,28,1,0,0,2
23850786,23850817,31,1,0,0,1
23850813,23850997,184,0,0,1,2
23850818,23850995,177,0,0,1,1
23850996,23851096,100,1,0,0,1
23850998,23851096,98,1,0,0,2
23851097,23851259,162,0,0,1,1
23851097,23851260,163,0,0,1,2
23851260,23851345,85,1,0,0,1
23851261,23851338,77,1,0,0,2
23851339,23851399,60,0,0,1,2
23851346,23851401,55,0,0,1,1
23851400,23851456,56,1,0,0,2
23851402,23851452,50,1,0,0,1
23851453,23851495,42,0,0,1,1
23851457,23851495,38,0,0,1,2
23851496,23851547,51,1,0,0,1
23851496,23851547,51,1,0,0,2
23851548,23851617,69,0,0,1,2
23851548,23852276,728,0,0,1,1
23851618,23851638,20,1,0,0,2
23851639,23851863,224,0,0,1,2
23851864,23851883,19,1,0,0,2
23851884,23852276,392,0,0,1,2
23852277,23852298,21,1,0,0,1
23852277,23852307,30,1,0,0,2
23852299,23852578,279,0,0,1,1
23852308,23852576,268,0,0,1,2
23852577,23852696,119,1,0,0,2
23852579,23852691,112,1,0,0,1
23852692,23852761,69,0,0,1,1
23852697,23852752,55,0,0,1,2
23852753,23852803,50,1,0,0,2
23852762,23852806,44,1,0,0,1
23852804,23853026,222,0,0,1,2
23852807,23853026,219,0,0,1,1
23853027,23853088,61,1,0,0,2
23853027,23853104,77,1,0,0,1
23853089,23853166,77,0,0,1,2
23853105,23853166,61,0,0,1,1
23853167,23853199,32,1,0,0,2
23853167,23853205,38,1,0,0,1
23853200,23853273,73,0,0,1,2
23853206,23853272,66,0,0,1,1
23853273,23853303,30,1,0,0,1
23853274,23853321,47,1,0,0,2
23853304,23853932,628,0,0,1,1
23853322,23853936,614,0,0,1,2
23853933,23853959,26,1,0,0,1
23853937,23853958,21,1,0,0,2
23853959,23854325,366,0,0,1,2
23853960,23854323,363,0,0,1,1
23854324,23854387,63,1,0,0,1
23854326,23854387,61,1,0,0,2
23854388,23854518,130,0,0,1,2
23854388,23854776,388,0,0,1,1
23854519,23854536,17,1,0,0,2
23854537,23854665,128,0,0,1,2
23854666,23854688,22,1,0,0,2
23854689,23854777,88,0,0,1,2
23854777,23854872,95,1,0,0,1
23854778,23854880,102,1,0,0,2
23854873,23854945,72,0,0,1,1
23854881,23854942,61,0,0,1,2
23854943,23855024,81,1,0,0,2
23854946,23855001,55,1,0,0,1
23855002,23855084,82,0,0,1,1
23855025,23855086,61,0,0,1,2
23855085,23855125,40,1,0,0,1
23855087,23855195,108,1,0,0,2
23855126,23855585,459,0,0,1,1
23855196,23855381,185,0,0,1,2
23855382,23855517,135,1,0,0,2
23855518,23855541,23,0,0,1,2
23855542,23855709,167,1,0,0,2
23855586,23855616,30,1,0,0,1
23855617,23855821,204,0,0,1,1
23855710,23855749,39,0,0,1,2
23855750,23856186,436,1,0,0,2
23855822,23855953,131,1,0,0,1
23855954,23856295,341,0,0,1,1
23856187,23856292,105,0,0,1,2
23856293,23856387,94,1,0,0,2
23856296,23856378,82,1,0,0,1
23856315,23856322,7,0,1,0,1
23856379,23856782,403,0,0,1,1
23856388,23856782,394,0,0,1,2
23856783,23856815,32,1,0,0,1
23856783,23856819,36,1,0,0,2
23856816,23857006,190,0,0,1,1
23856820,23857007,187,0,0,1,2
23857007,23857040,33,1,0,0,1
23857008,23857072,64,1,0,0,2
23857041,23857670,629,0,0,1,1
23857073,23857598,525,0,0,1,2
23857599,23857712,113,1,0,0,2
23857671,23857704,33,1,0,0,1
23857705,23857815,110,0,0,1,1
23857713,23857810,97,0,0,1,2
23857811,23857863,52,1,0,0,2
23857816,23857832,16,1,0,0,1
23857833,23858090,257,0,0,1,1
23857864,23857971,107,0,0,1,2
23857972,23857985,13,1,0,0,2
23857986,23858089,103,0,0,1,2
23858090,23858134,44,1,0,0,2
23858091,23858137,46,1,0,0,1
23858135,23858213,78,0,0,1,2
23858138,23858215,77,0,0,1,1
23858214,23858266,52,1,0,0,2
23858216,23858274,58,1,0,0,1
23858267,23858333,66,0,0,1,2
23858275,23858332,57,0,0,1,1
23858333,23858377,44,1,0,0,1
23858334,23858368,34,1,0,0,2
23858369,23858652,283,0,0,1,2
23858378,23858754,376,0,0,1,1
23858653,23858697,44,1,0,0,2
23858698,23858752,54,0,0,1,2
23858753,23858784,31,1,0,0,2
23858755,23858782,27,1,0,0,1
23858783,23859341,558,0,0,1,1
23858785,23858964,179,0,0,1,2
23858965,23858969,4,1,0,0,2
23858970,23859183,213,0,0,1,2
23859184,23859424,240,1,0,0,2
23859342,23859421,79,1,0,0,1
23859422,23859803,381,0,0,1,1
23859425,23859803,378,0,0,1,2
23859804,23859857,53,1,0,0,2
23859804,23859861,57,1,0,0,1
23859858,23859968,110,0,0,1,2
23859862,23859967,105,0,0,1,1
23859968,23859996,28,1,0,0,1
23859969,23859999,30,1,0,0,2
23859997,23861037,1040,0,0,1,1
23860000,23861037,1037,0,0,1,2
23861038,23861364,326,1,0,0,1
23861038,23861385,347,1,0,0,2
23861065,23861230,165,0,1,0,2
23861069,23861216,147,0,1,0,1
23861365,23861391,26,0,0,1,1
23861386,23861495,109,0,0,1,2
23861392,23861402,10,1,0,0,1
23861403,23861494,91,0,0,1,1
23861495,23861579,84,1,0,0,1
23861496,23861581,85,1,0,0,2
23861580,23861640,60,0,0,1,1
23861582,23861641,59,0,0,1,2
23861641,23861685,44,1,0,0,1
23861642,23861676,34,1,0,0,2
23861677,23861839,162,0,0,1,2
23861686,23861837,151,0,0,1,1
23861838,23861879,41,1,0,0,1
23861840,23861869,29,1,0,0,2
23861870,23862665,795,0,0,1,2
23861880,23862663,783,0,0,1,1
23862664,23862779,115,1,0,0,1
23862666,23862785,119,1,0,0,2
23862780,23863184,404,0,0,1,1
23862786,23863184,398,0,0,1,2
23863185,23863253,68,1,0,0,1
23863185,23863253,68,1,0,0,2
23863254,23863287,33,0,0,1,1
23863254,23863288,34,0,0,1,2
23863288,23863341,53,1,0,0,1
23863289,23863332,43,1,0,0,2
23863333,23863380,47,0,0,1,2
23863342,23863381,39,0,0,1,1
23863381,23863415,34,1,0,0,2
23863382,23863410,28,1,0,0,1
23863411,23863589,178,0,0,1,1
23863416,23863590,174,0,0,1,2
23863590,23863608,18,1,0,0,1
23863591,23863615,24,1,0,0,2
23863609,23864809,1200,0,0,1,1
23863616,23864807,1191,0,0,1,2
23864808,23864873,65,1,0,0,2
23864810,23864872,62,1,0,0,1
23864873,23864989,116,0,0,1,1
23864874,23864989,115,0,0,1,2
23864990,23865018,28,1,0,0,1
23864990,23865028,38,1,0,0,2
23865019,23865860,841,0,0,1,1
23865029,23865858,829,0,0,1,2
23865859,23865917,58,1,0,0,2
23865861,23865917,56,1,0,0,1
23865918,23866260,342,0,0,1,1
23865918,23866260,342,0,0,1,2
23866261,23866326,65,1,0,0,1
23866261,23866332,71,1,0,0,2
23866327,23866418,91,0,0,1,1
23866333,23866418,85,0,0,1,2
23866419,23866454,35,1,0,0,2
23866419,23866459,40,1,0,0,1
23866455,23866675,220,0,0,1,2
23866460,23866675,215,0,0,1,1
23866676,23866706,30,1,0,0,1
23866676,23866708,32,1,0,0,2
23866707,23867331,624,0,0,1,1
23866709,23867331,622,0,0,1,2
23867332,23867360,28,1,0,0,2
23867332,23867369,37,1,0,0,1
23867361,23867872,511,0,0,1,2
23867370,23867872,502,0,0,1,1
23867873,23867907,34,1,0,0,1
23867873,23867925,52,1,0,0,2
23867908,23868366,458,0,0,1,1
23867926,23868369,443,0,0,1,2
23868367,23869238,871,1,0,0,1
23868370,23869253,883,1,0,0,2
23868429,23869231,802,0,1,0,2
23868430,23869196,766,0,1,0,1
23869239,23869296,57,0,0,1,1
23869254,23869282,28,0,0,1,2
23869283,23869592,309,1,0,0,2
23869297,23869478,181,1,0,0,1
23869314,23869445,131,0,1,0,2
23869318,23869426,108,0,1,0,1
23869479,23869564,85,0,0,1,1
23869565,23869593,28,1,0,0,1
23869593,23869959,366,0,0,1,2
23869594,23870773,1179,0,0,1,1
23869960,23870102,142,1,0,0,2
23870103,23870181,78,0,0,1,2
23870182,23870339,157,1,0,0,2
23870340,23870418,78,0,0,1,2
23870419,23870452,33,1,0,0,2
23870453,23870650,197,0,0,1,2
23870651,23870693,42,1,0,0,2
23870694,23870874,180,0,0,1,2
23870774,23870796,22,1,0,0,1
23870797,23871136,339,0,0,1,1
23870875,23871189,314,1,0,0,2
23871137,23871202,65,1,0,0,1
23871190,23871213,23,0,0,1,2
23871203,23871258,55,0,0,1,1
23871214,23871281,67,1,0,0,2
23871259,23871291,32,1,0,0,1
23871282,23871520,238,0,0,1,2
23871292,23871538,246,0,0,1,1
23871521,23871647,126,1,0,0,2
23871539,23871573,34,1,0,0,1
23871574,23872045,471,0,0,1,1
23871648,23871692,44,0,0,1,2
23871693,23871817,124,1,0,0,2
23871818,23871947,129,0,0,1,2
23871948,23872226,278,1,0,0,2
23872046,23872055,9,1,0,0,1
23872056,23872739,683,0,0,1,1
23872227,23872313,86,0,0,1,2
23872314,23872318,4,1,0,0,2
23872319,23872418,99,0,0,1,2
23872419,23872909,490,1,0,0,2
23872740,23872767,27,1,0,0,1
23872768,23873251,483,0,0,1,1
23872910,23872975,65,0,0,1,2
23872976,23873023,47,1,0,0,2
23873024,23873250,226,0,0,1,2
23873251,23873366,115,1,0,0,2
23873252,23873316,64,1,0,0,1
23873317,23874467,1150,0,0,1,1
23873367,23873432,65,0,0,1,2
23873433,23873450,17,1,0,0,2
23873451,23873525,74,0,0,1,2
23873526,23873530,4,1,0,0,2
23873531,23874021,490,0,0,1,2
23874022,23874040,18,1,0,0,2
23874041,23874466,425,0,0,1,2
23874467,23874524,57,1,0,0,2
23874468,23874488,20,1,0,0,1
23874489,23874722,233,0,0,1,1
23874525,23874677,152,0,0,1,2
23874678,23875138,460,1,0,0,2
23874723,23875047,324,1,0,0,1
23874746,23874966,220,0,1,0,2
23874749,23874959,210,0,1,0,1
23875048,23875091,43,0,0,1,1
23875092,23875147,55,1,0,0,1
23875139,23875263,124,0,0,1,2
23875148,23875262,114,0,0,1,1
23875263,23875281,18,1,0,0,1
23875264,23875291,27,1,0,0,2
23875282,23876080,798,0,0,1,1
23875292,23875786,494,0,0,1,2
23875787,23876806,1019,1,0,0,2
23876081,23876113,32,1,0,0,1
23876114,23876357,243,0,0,1,1
23876358,23876372,14,1,0,0,1
23876373,23876432,59,0,0,1,1
23876433,23876451,18,1,0,0,1
23876452,23876632,180,0,0,1,1
23876633,23876642,9,1,0,0,1
23876643,23877018,375,0,0,1,1
23876807,23877018,211,0,0,1,2
23877019,23877073,54,1,0,0,1
23877019,23877080,61,1,0,0,2
23877074,23877129,55,0,0,1,1
23877081,23877136,55,0,0,1,2
23877130,23877665,535,1,0,0,1
23877137,23877699,562,1,0,0,2
23877160,23877674,514,0,1,0,2
23877163,23877641,478,0,1,0,1
23877666,23878586,920,0,0,1,1
23877700,23878016,316,0,0,1,2
23878017,23878021,4,1,0,0,2
23878022,23878589,567,0,0,1,2
23878587,23878616,29,1,0,0,1
23878590,23878614,24,1,0,0,2
23878615,23879281,666,0,0,1,2
23878617,23879406,789,0,0,1,1
23879282,23879336,54,1,0,0,2
23879337,23879403,66,0,0,1,2
23879404,23880583,1179,1,0,0,2
23879407,23880423,1016,1,0,0,1
23879485,23879780,295,0,1,0,2
23879488,23879761,273,0,1,0,1
23879825,23880084,259,0,1,0,2
23879829,23880070,241,0,1,0,1
23880121,23880334,213,0,1,0,2
23880124,23880319,195,0,1,0,1
23880424,23880517,93,0,0,1,1
23880518,23880570,52,1,0,0,1
23880571,23880939,368,0,0,1,1
23880584,23880936,352,0,0,1,2
23880937,23881017,80,1,0,0,2
23880940,23880967,27,1,0,0,1
23880968,23882058,1090,0,0,1,1
23881018,23881079,61,0,0,1,2
23881080,23881105,25,1,0,0,2
23881106,23881173,67,0,0,1,2
23881174,23881297,123,1,0,0,2
23881298,23881344,46,0,0,1,2
23881345,23881450,105,1,0,0,2
23881451,23881511,60,0,0,1,2
23881512,23882016,504,1,0,0,2
23882017,23882057,40,0,0,1,2
23882058,23882127,69,1,0,0,2
23882059,23882110,51,1,0,0,1
23882111,23882332,221,0,0,1,1
23882128,23882332,204,0,0,1,2
23882333,23882364,31,1,0,0,1
23882333,23882374,41,1,0,0,2
23882365,23882651,286,0,0,1,1
23882375,23884176,1801,0,0,1,2
23882652,23882679,27,1,0,0,1
23882680,23884165,1485,0,0,1,1
23884166,23885010,844,1,0,0,1
23884177,23885397,1220,1,0,0,2
23884202,23884938,736,0,1,0,2
23884206,23884899,693,0,1,0,1
23885011,23885333,322,0,0,1,1
23885334,23885397,63,1,0,0,1
23885398,23885434,36,0,0,1,2
23885398,23885435,37,0,0,1,1
23885435,23885487,52,1,0,0,2
23885436,23885492,56,1,0,0,1
23885488,23885548,60,0,0,1,2
23885493,23885548,55,0,0,1,1
23885549,23885594,45,1,0,0,1
23885549,23885668,119,1,0,0,2
23885595,23885690,95,0,0,1,1
23885669,23885692,23,0,0,1,2
23885691,23885724,33,1,0,0,1
23885693,23885725,32,1,0,0,2
23885725,23886756,1031,0,0,1,1
23885726,23886758,1032,0,0,1,2
23886757,23886821,64,1,0,0,1
23886759,23886836,77,1,0,0,2
23886822,23887121,299,0,0,1,1
23886837,23887120,283,0,0,1,2
23887121,23887157,36,1,0,0,2
23887122,23887144,22,1,0,0,1
23887145,23888863,1718,0,0,1,1
23887158,23887479,321,0,0,1,2
23887480,23887484,4,1,0,0,2
23887485,23888837,1352,0,0,1,2
23888838,23888926,88,1,0,0,2
23888864,23888926,62,1,0,0,1
23888927,23889131,204,0,0,1,2
23888927,23889135,208,0,0,1,1
23889132,23889202,70,1,0,0,2
23889136,23889200,64,1,0,0,1
23889201,23889335,134,0,0,1,1
23889203,23889333,130,0,0,1,2
23889334,23889664,330,1,0,0,2
23889336,23889712,376,1,0,0,1
23889410,23889627,217,0,1,0,2
23889413,23889608,195,0,1,0,1
23889665,23890007,342,0,0,1,2
23889713,23890009,296,0,0,1,1
23890008,23890353,345,1,0,0,2
23890010,23890063,53,1,0,0,1
23890064,23890151,87,0,0,1,1
23890152,23890181,29,1,0,0,1
23890182,23891782,1600,0,0,1,1
23890354,23890535,181,0,0,1,2
23890536,23891114,578,1,0,0,2
23891115,23891149,34,0,0,1,2
23891150,23891686,536,1,0,0,2
23891687,23891782,95,0,0,1,2
23891783,23891836,53,1,0,0,1
23891783,23891846,63,1,0,0,2
23891837,23891984,147,0,0,1,1
23891847,23891923,76,0,0,1,2
23891924,23892074,150,1,0,0,2
23891985,23892020,35,1,0,0,1
23892021,23892600,579,0,0,1,1
23892075,23892097,22,0,0,1,2
23892098,23892163,65,1,0,0,2
23892164,23892202,38,0,0,1,2
23892203,23892238,35,1,0,0,2
23892239,23892482,243,0,0,1,2
23892483,23892668,185,1,0,0,2
23892601,23892629,28,1,0,0,1
23892630,23893816,1186,0,0,1,1
23892669,23892693,24,0,0,1,2
23892694,23892858,164,1,0,0,2
23892859,23892938,79,0,0,1,2
23892939,23892962,23,1,0,0,2
23892963,23893014,51,0,0,1,2
23893015,23893180,165,1,0,0,2
23893181,23893240,59,0,0,1,2
23893241,23893467,226,1,0,0,2
23893468,23893580,112,0,0,1,2
23893581,23893658,77,1,0,0,2
23893659,23893697,38,0,0,1,2
23893698,23893717,19,1,0,0,2
23893718,23893814,96,0,0,1,2
23893815,23894103,288,1,0,0,2
23893817,23893865,48,1,0,0,1
23893866,23894022,156,0,0,1,1
23894023,23894067,44,1,0,0,1
23894068,23894214,146,0,0,1,1
23894104,23894213,109,0,0,1,2
23894214,23894435,221,1,0,0,2
23894215,23894277,62,1,0,0,1
23894278,23894362,84,0,0,1,1
23894363,23894409,46,1,0,0,1
23894410,23894785,375,0,0,1,1
23894436,23894532,96,0,0,1,2
23894533,23894742,209,1,0,0,2
23894743,23894787,44,0,0,1,2
23894786,23894808,22,1,0,0,1
23894788,23894822,34,1,0,0,2
23894809,23895432,623,0,0,1,1
23894823,23894916,93,0,0,1,2
23894917,23895000,83,1,0,0,2
23895001,23895270,269,0,0,1,2
23895271,23895502,231,1,0,0,2
23895433,23895501,68,1,0,0,1
23895502,23895545,43,0,0,1,1
23895503,23895546,43,0,0,1,2
23895546,23895588,42,1,0,0,1
23895547,23895597,50,1,0,0,2
23895589,23895802,213,0,0,1,1
23895598,23895803,205,0,0,1,2
23895803,23895839,36,1,0,0,1
23895804,23895842,38,1,0,0,2
23895840,23896114,274,0,0,1,1
23895843,23896114,271,0,0,1,2
23896115,23896132,17,1,0,0,2
23896115,23896145,30,1,0,0,1
23896133,23896525,392,0,0,1,2
23896146,23896518,372,0,0,1,1
23896519,23896544,25,1,0,0,1
23896526,23896547,21,1,0,0,2
23896545,23896744,199,0,0,1,1
23896548,23896743,195,0,0,1,2
23896744,23896792,48,1,0,0,2
23896745,23896796,51,1,0,0,1
23896793,23896944,151,0,0,1,2
23896797,23896941,144,0,0,1,1
23896942,23896960,18,1,0,0,1
23896945,23896959,14,1,0,0,2
23896960,23898821,1861,0,0,1,2
23896961,23898821,1860,0,0,1,1
23898822,23899706,884,1,0,0,1
23898822,23899732,910,1,0,0,2
23898854,23899476,622,0,1,0,2
23898864,23899449,585,0,1,0,1
23899507,23899662,155,0,1,0,2
23899509,23899647,138,0,1,0,1
23899707,23900143,436,0,0,1,1
23899733,23900143,410,0,0,1,2
23900144,23900187,43,1,0,0,1
23900144,23900197,53,1,0,0,2
23900188,23900336,148,0,0,1,1
23900198,23900337,139,0,0,1,2
23900337,23900366,29,1,0,0,1
23900338,23900363,25,1,0,0,2
23900364,23901472,1108,0,0,1,2
23900367,23901474,1107,0,0,1,1
23901473,23901503,30,1,0,0,2
23901475,23901505,30,1,0,0,1
23901504,23901814,310,0,0,1,2
23901506,23901813,307,0,0,1,1
23901814,23901865,51,1,0,0,1
23901815,23901866,51,1,0,0,2
23901866,23903912,2046,0,0,1,1
23901867,23902044,177,0,0,1,2
23902045,23902084,39,1,0,0,2
23902085,23903234,1149,0,0,1,2
23903235,23903244,9,1,0,0,2
23903245,23903308,63,0,0,1,2
23903309,23903324,15,1,0,0,2
23903325,23903509,184,0,0,1,2
23903510,23903571,61,1,0,0,2
23903572,23903747,175,0,0,1,2
23903748,23903829,81,1,0,0,2
23903830,23903913,83,0,0,1,2
23903913,23903950,37,1,0,0,1
23903914,23904014,100,1,0,0,2
23903951,23904151,200,0,0,1,1
23904015,23904038,23,0,0,1,2
23904039,23904056,17,1,0,0,2
23904057,23904115,58,0,0,1,2
23904116,23904907,791,1,0,0,2
23904152,23904904,752,1,0,0,1
23904171,23904865,694,0,1,0,2
23904174,23904868,694,0,1,0,1
23904905,23905540,635,0,0,1,1
23904908,23905178,270,0,0,1,2
23905179,23905198,19,1,0,0,2
23905199,23905377,178,0,0,1,2
23905378,23905595,217,1,0,0,2
23905541,23905594,53,1,0,0,1
23905595,23905623,28,0,0,1,1
23905596,23905624,28,0,0,1,2
23905624,23905698,74,1,0,0,1
23905625,23905708,83,1,0,0,2
23905699,23905776,77,0,0,1,1
23905709,23905778,69,0,0,1,2
23905777,23905838,61,1,0,0,1
23905779,23905839,60,1,0,0,2
23905839,23905920,81,0,0,1,1
23905840,23905919,79,0,0,1,2
23905920,23905955,35,1,0,0,2
23905921,23905956,35,1,0,0,1
23905956,23906094,138,0,0,1,2
23905957,23906091,134,0,0,1,1
23906092,23906125,33,1,0,0,1
23906095,23906126,31,1,0,0,2
23906126,23907796,1670,0,0,1,1
23906127,23907076,949,0,0,1,2
23907077,23907086,9,1,0,0,2
23907087,23907797,710,0,0,1,2
23907797,23907834,37,1,0,0,1
23907798,23907855,57,1,0,0,2
23907835,23907933,98,0,0,1,1
23907856,23907932,76,0,0,1,2
23907933,23907987,54,1,0,0,2
23907934,23907976,42,1,0,0,1
23907977,23909553,1576,0,0,1,1
23907988,23908146,158,0,0,1,2
23908147,23908205,58,1,0,0,2
23908206,23908507,301,0,0,1,2
23908508,23908521,13,1,0,0,2
23908522,23908760,238,0,0,1,2
23908761,23908846,85,1,0,0,2
23908847,23909544,697,0,0,1,2
23909545,23909571,26,1,0,0,2
23909554,23909572,18,1,0,0,1
23909572,23909765,193,0,0,1,2
23909573,23909768,195,0,0,1,1
23909766,23909845,79,1,0,0,2
23909769,23909787,18,1,0,0,1
23909788,23910017,229,0,0,1,1
23909846,23910037,191,0,0,1,2
23910018,23910875,857,1,0,0,1
23910038,23910882,844,1,0,0,2
23910072,23910838,766,0,1,0,1
23910075,23910841,766,0,1,0,2
23910876,23911248,372,0,0,1,1
23910883,23911087,204,0,0,1,2
23911088,23911092,4,1,0,0,2
23911093,23911201,108,0,0,1,2
23911202,23911564,362,1,0,0,2
23911249,23911287,38,1,0,0,1
23911288,23911498,210,0,0,1,1
23911499,23911545,46,1,0,0,1
23911546,23911664,118,0,0,1,1
23911565,23911664,99,0,0,1,2
23911665,23911709,44,1,0,0,2
23911665,23911713,48,1,0,0,1
23911710,23912784,1074,0,0,1,2
23911714,23912790,1076,0,0,1,1
23912785,23912825,40,1,0,0,2
23912791,23912813,22,1,0,0,1
23912814,23913601,787,0,0,1,1
23912826,23913601,775,0,0,1,2
23913602,23913664,62,1,0,0,1
23913602,23913699,97,1,0,0,2
23913665,23913758,93,0,0,1,1
23913700,23913762,62,0,0,1,2
23913759,23913773,14,1,0,0,1
23913763,23913791,28,1,0,0,2
23913774,23913940,166,0,0,1,1
23913792,23913940,148,0,0,1,2
23913941,23913962,21,1,0,0,1
23913941,23913977,36,1,0,0,2
23913963,23915544,1581,0,0,1,1
23913978,23914191,213,0,0,1,2
23914192,23914197,5,1,0,0,2
23914198,23914483,285,0,0,1,2
23914484,23914579,95,1,0,0,2
23914580,23915419,839,0,0,1,2
23915420,23915437,17,1,0,0,2
23915438,23915644,206,0,0,1,2
23915545,23916150,605,1,0,0,1
23915645,23916253,608,1,0,0,2
23915692,23915938,246,0,1,0,2
23915693,23915920,227,0,1,0,1
23916151,23916328,177,0,0,1,1
23916254,23916306,52,0,0,1,2
23916307,23916417,110,1,0,0,2
23916329,23916366,37,1,0,0,1
23916367,23916777,410,0,0,1,1
23916418,23916634,216,0,0,1,2
23916635,23916674,39,1,0,0,2
23916675,23916778,103,0,0,1,2
23916778,23916836,58,1,0,0,1
23916779,23916851,72,1,0,0,2
23916837,23917337,500,0,0,1,1
23916852,23917337,485,0,0,1,2
23917338,23917394,56,1,0,0,2
23917338,23917397,59,1,0,0,1
23917395,23917576,181,0,0,1,2
23917398,23917575,177,0,0,1,1
23917576,23917641,65,1,0,0,1
23917577,23917644,67,1,0,0,2
23917642,23917732,90,0,0,1,1
23917645,23917732,87,0,0,1,2
23917733,23917774,41,1,0,0,2
23917733,23917783,50,1,0,0,1
23917775,23917888,113,0,0,1,2
23917784,23917887,103,0,0,1,1
23917888,23917938,50,1,0,0,1
23917889,23917919,30,1,0,0,2
23917920,23919786,1866,0,0,1,2
23917939,23919786,1847,0,0,1,1
23919787,23919841,54,1,0,0,1
23919787,23919841,54,1,0,0,2
23919842,23921860,2018,0,0,1,2
23919842,23921862,2020,0,0,1,1
23921861,23922186,325,1,0,0,2
23921863,23922100,237,1,0,0,1
23921885,23922031,146,0,1,0,2
23921894,23922003,109,0,1,0,1
23922101,23922294,193,0,0,1,1
23922187,23922292,105,0,0,1,2
23922293,23922329,36,1,0,0,2
23922295,23922319,24,1,0,0,1
23922320,23922539,219,0,0,1,1
23922330,23922538,208,0,0,1,2
23922539,23922627,88,1,0,0,2
23922540,23922628,88,1,0,0,1
23922628,23923252,624,0,0,1,2
23922629,23923254,625,0,0,1,1
23923253,23923321,68,1,0,0,2
23923255,23923321,66,1,0,0,1
23923322,23923571,249,0,0,1,2
23923322,23923572,250,0,0,1,1
23923572,23923649,77,1,0,0,2
23923573,23923647,74,1,0,0,1
23923648,23923871,223,0,0,1,1
23923650,23923868,218,0,0,1,2
23923869,23923944,75,1,0,0,2
23923872,23923946,74,1,0,0,1
23923945,23924033,88,0,0,1,2
23923947,23924034,87,0,0,1,1
23924034,23924070,36,1,0,0,2
23924035,23924070,35,1,0,0,1
23924071,23924145,74,0,0,1,1
23924071,23924145,74,0,0,1,2
23924146,23924181,35,1,0,0,1
23924146,23924181,35,1,0,0,2
23924182,23925579,1397,0,0,1,1
23924182,23925579,1397,0,0,1,2
23925580,23925636,56,1,0,0,1
23925580,23925752,172,1,0,0,2
23925637,23925725,88,0,0,1,1
23925726,23925772,46,1,0,0,1
23925753,23925963,210,0,0,1,2
23925773,23925966,193,0,0,1,1
23925964,23925983,19,1,0,0,2
23925967,23926002,35,1,0,0,1
23925984,23926286,302,0,0,1,2
23926003,23926484,481,0,0,1,1
23926287,23926291,4,1,0,0,2
23926292,23926482,190,0,0,1,2
23926483,23926503,20,1,0,0,2
23926485,23926502,17,1,0,0,1
23926503,23926987,484,0,0,1,1
23926504,23926983,479,0,0,1,2
23926984,23926999,15,1,0,0,2
23926988,23927026,38,1,0,0,1
23927000,23927662,662,0,0,1,2
23927027,23927158,131,0,0,1,1
23927159,23927272,113,1,0,0,1
23927273,23927303,30,0,0,1,1
23927304,23927381,77,1,0,0,1
23927382,23927671,289,0,0,1,1
23927663,23928094,431,1,0,0,2
23927672,23927974,302,1,0,0,1
23927693,23927924,231,0,1,0,2
23927698,23927899,201,0,1,0,1
23927975,23928200,225,0,0,1,1
23928095,23928214,119,0,0,1,2
23928201,23928276,75,1,0,0,1
23928215,23928276,61,1,0,0,2
23928277,23928670,393,0,0,1,2
23928277,23928672,395,0,0,1,1
23928671,23928734,63,1,0,0,2
23928673,23928736,63,1,0,0,1
23928735,23929133,398,0,0,1,2
23928737,23929136,399,0,0,1,1
23929134,23929196,62,1,0,0,2
23929137,23929196,59,1,0,0,1
23929197,23929305,108,0,0,1,1
23929197,23929306,109,0,0,1,2
23929306,23929352,46,1,0,0,1
23929307,23929354,47,1,0,0,2
23929353,23929483,130,0,0,1,1
23929355,23929488,133,0,0,1,2
23929484,23929513,29,1,0,0,1
23929489,23929504,15,1,0,0,2
23929505,23930423,918,0,0,1,2
23929514,23930416,902,0,0,1,1
23930417,23930447,30,1,0,0,1
23930424,23930443,19,1,0,0,2
23930444,23930631,187,0,0,1,2
23930448,23930631,183,0,0,1,1
23930632,23930684,52,1,0,0,1
23930632,23930685,53,1,0,0,2
23930685,23930896,211,0,0,1,1
23930686,23930896,210,0,0,1,2
23930897,23930922,25,1,0,0,1
23930897,23930928,31,1,0,0,2
23930923,23932780,1857,0,0,1,1
23930929,23932783,1854,0,0,1,2
23932781,23932886,105,1,0,0,1
23932784,23932906,122,1,0,0,2
23932887,23933043,156,0,0,1,1
23932907,23933036,129,0,0,1,2
23933037,23933469,432,1,0,0,2
23933044,23933323,279,1,0,0,1
23933063,23933259,196,0,1,0,2
23933071,23933226,155,0,1,0,1
23933324,23933429,105,0,0,1,1
23933430,23933472,42,1,0,0,1
23933470,23933785,315,0,0,1,2
23933473,23933784,311,0,0,1,1
23933785,23933826,41,1,0,0,1
23933786,23933888,102,1,0,0,2
23933827,23933971,144,0,0,1,1
23933889,23933970,81,0,0,1,2
23933971,23934078,107,1,0,0,2
23933972,23934024,52,1,0,0,1
23934025,23935535,1510,0,0,1,1
23934079,23934109,30,0,0,1,2
23934110,23934186,76,1,0,0,2
23934187,23934212,25,0,0,1,2
23934213,23934595,382,1,0,0,2
23934596,23934637,41,0,0,1,2
23934638,23935325,687,1,0,0,2
23935326,23935371,45,0,0,1,2
23935372,23935445,73,1,0,0,2
23935446,23935534,88,0,0,1,2
23935535,23935621,86,1,0,0,2
23935536,23935602,66,1,0,0,1
23935603,23935806,203,0,0,1,1
23935622,23935807,185,0,0,1,2
23935807,23935841,34,1,0,0,1
23935808,23935860,52,1,0,0,2
23935842,23937738,1896,0,0,1,1
23935861,23935988,127,0,0,1,2
23935989,23935996,7,1,0,0,2
23935997,23936264,267,0,0,1,2
23936265,23936280,15,1,0,0,2
23936281,23936955,674,0,0,1,2
23936956,23936978,22,1,0,0,2
23936979,23937758,779,0,0,1,2
23937739,23938117,378,1,0,0,1
23937759,23938116,357,1,0,0,2
23937780,23937982,202,0,1,0,2
23937783,23937961,178,0,1,0,1
23938117,23938158,41,0,0,1,2
23938118,23938158,40,0,0,1,1
23938159,23938226,67,1,0,0,1
23938159,23938242,83,1,0,0,2
23938227,23938408,181,0,0,1,1
23938243,23938409,166,0,0,1,2
23938409,23938461,52,1,0,0,1
23938410,23938469,59,1,0,0,2
23938462,23938762,300,0,0,1,1
23938470,23938761,291,0,0,1,2
23938762,23938804,42,1,0,0,2
23938763,23938793,30,1,0,0,1
23938794,23939067,273,0,0,1,1
23938805,23939067,262,0,0,1,2
23939068,23939148,80,1,0,0,1
23939068,23939156,88,1,0,0,2
23939149,23939262,113,0,0,1,1
23939157,23939242,85,0,0,1,2
23939243,23939330,87,1,0,0,2
23939263,23939306,43,1,0,0,1
23939307,23939423,116,0,0,1,1
23939331,23939428,97,0,0,1,2
23939424,23939454,30,1,0,0,1
23939429,23939483,54,1,0,0,2
23939455,23940289,834,0,0,1,1
23939484,23939523,39,0,0,1,2
23939524,23939542,18,1,0,0,2
23939543,23939643,100,0,0,1,2
23939644,23939701,57,1,0,0,2
23939702,23939722,20,0,0,1,2
23939723,23939745,22,1,0,0,2
23939746,23940113,367,0,0,1,2
23940114,23940459,345,1,0,0,2
23940290,23940295,5,1,0,0,1
23940296,23940546,250,0,0,1,1
23940460,23940543,83,0,0,1,2
23940544,23940619,75,1,0,0,2
23940547,23940595,48,1,0,0,1
23940596,23941476,880,0,0,1,1
23940620,23941475,855,0,0,1,2
23941476,23941515,39,1,0,0,2
23941477,23941503,26,1,0,0,1
23941504,23941935,431,0,0,1,1
23941516,23941935,419,0,0,1,2
23941936,23941966,30,1,0,0,1
23941936,23941966,30,1,0,0,2
23941967,23942953,986,0,0,1,1
23941967,23942953,986,0,0,1,2
23942954,23943243,289,1,0,0,1
23942954,23943378,424,1,0,0,2
23942977,23943183,206,0,1,0,2
23942982,23943145,163,0,1,0,1
23943244,23943513,269,0,0,1,1
23943379,23943445,66,0,0,1,2
23943446,23943465,19,1,0,0,2
23943466,23943513,47,0,0,1,2
23943514,23943539,25,1,0,0,1
23943514,23943554,40,1,0,0,2
23943540,23943969,429,0,0,1,1
23943555,23943886,331,0,0,1,2
23943887,23944026,139,1,0,0,2
23943970,23944007,37,1,0,0,1
23944008,23944298,290,0,0,1,1
23944027,23944293,266,0,0,1,2
23944294,23944332,38,1,0,0,2
23944299,23944331,32,1,0,0,1
23944332,23945066,734,0,0,1,1
23944333,23944510,177,0,0,1,2
23944511,23944931,420,1,0,0,2
23944932,23945076,144,0,0,1,2
23945067,23945090,23,1,0,0,1
23945077,23945081,4,1,0,0,2
23945082,23945263,181,0,0,1,2
23945091,23945263,172,0,0,1,1
23945264,23945302,38,1,0,0,1
23945264,23945312,48,1,0,0,2
23945303,23945663,360,0,0,1,1
23945313,23945662,349,0,0,1,2
23945663,23945681,18,1,0,0,2
23945664,23945682,18,1,0,0,1
23945682,23946066,384,0,0,1,2
23945683,23946065,382,0,0,1,1
23946066,23946076,10,1,0,0,1
23946067,23946077,10,1,0,0,2
23946077,23947359,1282,0,0,1,1
23946078,23947355,1277,0,0,1,2
23947356,23949153,1797,1,0,0,2
23947360,23948023,663,1,0,0,1
23947403,23947684,281,0,1,0,2
23947408,23947646,238,0,1,0,1
23948024,23948219,195,0,0,1,1
23948220,23948262,42,1,0,0,1
23948263,23948518,255,0,0,1,1
23948519,23948596,77,1,0,0,1
23948597,23948744,147,0,0,1,1
23948745,23948797,52,1,0,0,1
23948798,23949011,213,0,0,1,1
23949012,23949046,34,1,0,0,1
23949047,23949836,789,0,0,1,1
23949154,23949202,48,0,0,1,2
23949203,23949329,126,1,0,0,2
23949330,23949495,165,0,0,1,2
23949496,23949561,65,1,0,0,2
23949562,23949809,247,0,0,1,2
23949810,23949814,4,1,0,0,2
23949815,23950134,319,0,0,1,2
23949837,23949852,15,1,0,0,1
23949853,23950139,286,0,0,1,1
23950135,23950225,90,1,0,0,2
23950140,23950219,79,1,0,0,1
23950220,23950299,79,0,0,1,1
23950226,23950460,234,0,0,1,2
23950300,23950324,24,1,0,0,1
23950325,23950460,135,0,0,1,1
23950461,23950500,39,1,0,0,1
23950461,23950547,86,1,0,0,2
23950501,23951781,1280,0,0,1,1
23950548,23952453,1905,0,0,1,2
23951782,23951858,76,1,0,0,1
23951859,23951905,46,0,0,1,1
23951906,23951995,89,1,0,0,1
23951996,23952091,95,0,0,1,1
23952092,23952113,21,1,0,0,1
23952114,23952358,244,0,0,1,1
23952359,23952390,31,1,0,0,1
23952391,23952454,63,0,0,1,1
23952454,23952537,83,1,0,0,2
23952455,23952540,85,1,0,0,1
23952538,23952894,356,0,0,1,2
23952541,23952896,355,0,0,1,1
23952895,23953259,364,1,0,0,2
23952897,23953173,276,1,0,0,1
23952921,23953118,197,0,1,0,2
23952929,23953056,127,0,1,0,1
23953174,23953426,252,0,0,1,1
23953260,23953281,21,0,0,1,2
23953282,23953335,53,1,0,0,2
23953336,23953427,91,0,0,1,2
23953427,23953458,31,1,0,0,1
23953428,23953465,37,1,0,0,2
23953459,23953815,356,0,0,1,1
23953466,23953780,314,0,0,1,2
23953781,23953845,64,1,0,0,2
23953816,23953845,29,1,0,0,1
23953846,23954033,187,0,0,1,2
23953846,23954034,188,0,0,1,1
23954034,23954079,45,1,0,0,2
23954035,23954063,28,1,0,0,1
23954064,23954850,786,0,0,1,1
23954080,23954855,775,0,0,1,2
23954851,23954873,22,1,0,0,1
23954856,23954889,33,1,0,0,2
23954874,23955148,274,0,0,1,1
23954890,23955154,264,0,0,1,2
23955149,23955177,28,1,0,0,1
23955155,23955183,28,1,0,0,2
23955178,23955718,540,0,0,1,1
23955184,23955720,536,0,0,1,2
23955719,23955766,47,1,0,0,1
23955721,23955766,45,1,0,0,2
23955767,23955959,192,0,0,1,1
23955767,23955960,193,0,0,1,2
23955960,23955991,31,1,0,0,1
23955961,23955990,29,1,0,0,2
23955991,23957291,1300,0,0,1,2
23955992,23957287,1295,0,0,1,1
23957288,23957315,27,1,0,0,1
23957292,23957314,22,1,0,0,2
23957315,23957838,523,0,0,1,2
23957316,23957839,523,0,0,1,1
23957839,23957859,20,1,0,0,2
23957840,23957860,20,1,0,0,1
23957860,23958003,143,0,0,1,2
23957861,23958003,142,0,0,1,1
23958004,23958371,367,1,0,0,1
23958004,23958434,430,1,0,0,2
23958034,23958267,233,0,1,0,2
23958038,23958244,206,0,1,0,1
23958372,23958555,183,0,0,1,1
23958435,23958555,120,0,0,1,2
23958556,23958622,66,1,0,0,1
23958556,23959063,507,1,0,0,2
23958623,23958973,350,0,0,1,1
23958974,23959016,42,1,0,0,1
23959017,23959325,308,0,0,1,1
23959064,23959284,220,0,0,1,2
23959285,23959580,295,1,0,0,2
23959326,23959367,41,1,0,0,1
23959368,23959642,274,0,0,1,1
23959581,23959639,58,0,0,1,2
23959640,23959704,64,1,0,0,2
23959643,23959722,79,1,0,0,1
23959705,23959813,108,0,0,1,2
23959723,23959813,90,0,0,1,1
23959814,23959848,34,1,0,0,1
23959814,23959848,34,1,0,0,2
23959849,23960856,1007,0,0,1,1
23959849,23961549,1700,0,0,1,2
23960857,23960865,8,1,0,0,1
23960866,23961545,679,0,0,1,1
23961546,23961574,28,1,0,0,1
23961550,23961563,13,1,0,0,2
23961564,23961768,204,0,0,1,2
23961575,23961767,192,0,0,1,1
23961768,23961831,63,1,0,0,1
23961769,23961835,66,1,0,0,2
23961832,23962063,231,0,0,1,1
23961836,23962067,231,0,0,1,2
23962064,23962084,20,1,0,0,1
23962068,23962078,10,1,0,0,2
23962079,23962731,652,0,0,1,2
23962085,23962732,647,0,0,1,1
23962732,23962766,34,1,0,0,2
23962733,23962771,38,1,0,0,1
23962767,23963759,992,0,0,1,2
23962772,23963761,989,0,0,1,1
23963760,23964320,560,1,0,0,2
23963762,23964072,310,1,0,0,1
23963794,23963992,198,0,1,0,2
23963802,23963968,166,0,1,0,1
23964073,23964199,126,0,0,1,1
23964200,23964286,86,1,0,0,1
23964287,23964596,309,0,0,1,1
23964321,23964595,274,0,0,1,2
23964596,23964656,60,1,0,0,2
23964597,23964652,55,1,0,0,1
23964653,23964983,330,0,0,1,1
23964657,23964982,325,0,0,1,2
23964983,23965035,52,1,0,0,2
23964984,23965036,52,1,0,0,1
23965036,23965377,341,0,0,1,2
23965037,23965375,338,0,0,1,1
23965376,23965435,59,1,0,0,1
23965378,23965447,69,1,0,0,2
23965436,23965744,308,0,0,1,1
23965448,23965743,295,0,0,1,2
23965744,23965808,64,1,0,0,2
23965745,23965807,62,1,0,0,1
23965808,23965989,181,0,0,1,1
23965809,23965990,181,0,0,1,2
23965990,23966021,31,1,0,0,1
23965991,23966020,29,1,0,0,2
23966021,23967048,1027,0,0,1,2
23966022,23967421,1399,0,0,1,1
23967049,23967063,14,1,0,0,2
23967064,23967422,358,0,0,1,2
23967422,23967488,66,1,0,0,1
23967423,23967487,64,1,0,0,2
23967488,23967760,272,0,0,1,2
23967489,23967759,270,0,0,1,1
23967760,23967813,53,1,0,0,1
23967761,23967813,52,1,0,0,2
23967814,23968983,1169,0,0,1,1
23967814,23968984,1170,0,0,1,2
23968984,23969023,39,1,0,0,1
23968985,23969021,36,1,0,0,2
23969022,23969232,210,0,0,1,2
23969024,23969597,573,0,0,1,1
23969233,23969270,37,1,0,0,2
23969271,23969596,325,0,0,1,2
23969597,23969614,17,1,0,0,2
23969598,23969626,28,1,0,0,1
23969615,23969852,237,0,0,1,2
23969627,23969852,225,0,0,1,1
23969853,23970138,285,1,0,0,1
23969853,23970266,413,1,0,0,2
23969881,23970089,208,0,1,0,2
23969887,23970063,176,0,1,0,1
23970139,23970347,208,0,0,1,1
23970267,23970347,80,0,0,1,2
23970348,23970410,62,1,0,0,1
23970348,23970411,63,1,0,0,2
23970411,23970698,287,0,0,1,1
23970412,23970700,288,0,0,1,2
23970699,23970754,55,1,0,0,1
23970701,23970756,55,1,0,0,2
23970755,23971058,303,0,0,1,1
23970757,23971064,307,0,0,1,2
23971059,23971072,13,1,0,0,1
23971065,23971083,18,1,0,0,2
23971073,23971432,359,0,0,1,1
23971084,23971432,348,0,0,1,2
23971433,23971476,43,1,0,0,1
23971433,23971507,74,1,0,0,2
23971477,23971668,191,0,0,1,1
23971508,23971670,162,0,0,1,2
23971669,23971735,66,1,0,0,1
23971671,23971745,74,1,0,0,2
23971736,23971843,107,0,0,1,1
23971746,23971842,96,0,0,1,2
23971843,23971877,34,1,0,0,2
23971844,23971876,32,1,0,0,1
23971877,23972970,1093,0,0,1,1
23971878,23972969,1091,0,0,1,2
23972970,23972998,28,1,0,0,2
23972971,23972999,28,1,0,0,1
23972999,23973407,408,0,0,1,2
23973000,23973408,408,0,0,1,1
23973408,23973453,45,1,0,0,2
23973409,23973446,37,1,0,0,1
23973447,23975574,2127,0,0,1,1
23973454,23974614,1160,0,0,1,2
23974615,23974623,8,1,0,0,2
23974624,23975576,952,0,0,1,2
23975575,23975759,184,1,0,0,1
23975577,23975778,201,1,0,0,2
23975610,23975689,79,0,1,0,2
23975621,23975656,35,0,1,0,1
23975760,23975951,191,0,0,1,1
23975779,23975952,173,0,0,1,2
23975952,23976037,85,1,0,0,1
23975953,23976068,115,1,0,0,2
23976038,23976242,204,0,0,1,1
23976069,23976182,113,0,0,1,2
23976183,23976204,21,1,0,0,2
23976205,23976241,36,0,0,1,2
23976242,23976289,47,1,0,0,2
23976243,23976291,48,1,0,0,1
23976290,23976353,63,0,0,1,2
23976292,23976532,240,0,0,1,1
23976354,23976358,4,1,0,0,2
23976359,23976426,67,0,0,1,2
23976427,23976482,55,1,0,0,2
23976483,23976531,48,0,0,1,2
23976532,23976595,63,1,0,0,2
23976533,23976583,50,1,0,0,1
23976584,23976857,273,0,0,1,1
23976596,23976856,260,0,0,1,2
23976857,23976909,52,1,0,0,2
23976858,23976894,36,1,0,0,1
23976895,23976967,72,0,0,1,1
23976910,23976965,55,0,0,1,2
23976966,23977047,81,1,0,0,2
23976968,23977046,78,1,0,0,1
23977047,23977238,191,0,0,1,1
23977048,23977239,191,0,0,1,2
23977239,23977268,29,1,0,0,1
23977240,23977288,48,1,0,0,2
23977269,23977572,303,0,0,1,1
23977289,23977539,250,0,0,1,2
23977540,23977616,76,1,0,0,2
23977573,23977604,31,1,0,0,1
23977605,23978210,605,0,0,1,1
23977617,23978211,594,0,0,1,2
23978211,23978241,30,1,0,0,1
23978212,23978312,100,1,0,0,2
23978242,23978541,299,0,0,1,1
23978313,23978414,101,0,0,1,2
23978415,23978713,298,1,0,0,2
23978542,23978587,45,1,0,0,1
23978588,23980621,2033,0,0,1,1
23978714,23978988,274,0,0,1,2
23978989,23979004,15,1,0,0,2
23979005,23979882,877,0,0,1,2
23979883,23979900,17,1,0,0,2
23979901,23980292,391,0,0,1,2
23980293,23980309,16,1,0,0,2
23980310,23980491,181,0,0,1,2
23980492,23980516,24,1,0,0,2
23980517,23980600,83,0,0,1,2
23980601,23980640,39,1,0,0,2
23980622,23980652,30,1,0,0,1
23980641,23980759,118,0,0,1,2
23980653,23980793,140,0,0,1,1
23980760,23981791,1031,1,0,0,2
23980794,23981238,444,1,0,0,1
23980809,23981222,413,0,1,0,2
23980825,23981195,370,0,1,0,1
23981239,23981351,112,0,0,1,1
23981352,23981638,286,1,0,0,1
23981370,23981571,201,0,1,0,2
23981377,23981546,169,0,1,0,1
23981639,23981955,316,0,0,1,1
23981792,23981956,164,0,0,1,2
23981956,23981983,27,1,0,0,1
23981957,23981982,25,1,0,0,2
23981983,23982130,147,0,0,1,2
23981984,23982127,143,0,0,1,1
23982128,23982147,19,1,0,0,1
23982131,23982170,39,1,0,0,2
23982148,23983188,1040,0,0,1,1
23982171,23982230,59,0,0,1,2
23982231,23982429,198,1,0,0,2
23982430,23982511,81,0,0,1,2
23982512,23983062,550,1,0,0,2
23983063,23983123,60,0,0,1,2
23983124,23983279,155,1,0,0,2
23983189,23983239,50,1,0,0,1
23983240,23983350,110,0,0,1,1
23983280,23983328,48,0,0,1,2
23983329,23983388,59,1,0,0,2
23983351,23983386,35,1,0,0,1
23983387,23984417,1030,0,0,1,1
23983389,23983428,39,0,0,1,2
23983429,23983458,29,1,0,0,2
23983459,23983600,141,0,0,1,2
23983601,23983622,21,1,0,0,2
23983623,23983693,70,0,0,1,2
23983694,23983746,52,1,0,0,2
23983747,23983797,50,0,0,1,2
23983798,23983877,79,1,0,0,2
23983878,23983908,30,0,0,1,2
23983909,23984051,142,1,0,0,2
23984052,23984092,40,0,0,1,2
23984093,23984713,620,1,0,0,2
23984418,23984549,131,1,0,0,1
23984550,23984616,66,0,0,1,1
23984617,23984678,61,1,0,0,1
23984679,23985451,772,0,0,1,1
23984714,23984738,24,0,0,1,2
23984739,23984878,139,1,0,0,2
23984879,23985005,126,0,0,1,2
23985006,23985039,33,1,0,0,2
23985040,23985150,110,0,0,1,2
23985151,23985345,194,1,0,0,2
23985346,23985414,68,0,0,1,2
23985415,23985544,129,1,0,0,2
23985452,23985506,54,1,0,0,1
23985507,23985651,144,0,0,1,1
23985545,23985609,64,0,0,1,2
23985610,23985745,135,1,0,0,2
23985652,23985690,38,1,0,0,1
23985691,23985852,161,0,0,1,1
23985746,23985836,90,0,0,1,2
23985837,23986726,889,1,0,0,2
23985853,23986542,689,1,0,0,1
23985903,23986489,586,0,1,0,1
23985904,23986490,586,0,1,0,2
23986543,23986662,119,0,0,1,1
23986663,23986730,67,1,0,0,1
23986727,23986817,90,0,0,1,2
23986731,23986818,87,0,0,1,1
23986818,23986878,60,1,0,0,2
23986819,23986877,58,1,0,0,1
23986878,23986972,94,0,0,1,1
23986879,23986971,92,0,0,1,2
23986972,23987030,58,1,0,0,2
23986973,23987007,34,1,0,0,1
23987008,23987148,140,0,0,1,1
23987031,23987146,115,0,0,1,2
23987147,23987370,223,1,0,0,2
23987149,23987361,212,1,0,0,1
23987182,23987330,148,0,1,0,2
23987184,23987307,123,0,1,0,1
23987362,23987945,583,0,0,1,1
23987371,23987958,587,0,0,1,2
23987946,23987950,4,1,0,0,1
23987951,23988682,731,0,0,1,1
23987959,23987974,15,1,0,0,2
23987975,23988149,174,0,0,1,2
23988150,23988164,14,1,0,0,2
23988165,23988534,369,0,0,1,2
23988535,23988562,27,1,0,0,2
23988563,23988659,96,0,0,1,2
23988660,23988749,89,1,0,0,2
23988683,23988756,73,1,0,0,1
23988750,23988886,136,0,0,1,2
23988757,23988887,130,0,0,1,1
23988887,23988938,51,1,0,0,2
23988888,23988927,39,1,0,0,1
23988928,23989474,546,0,0,1,1
23988939,23989042,103,0,0,1,2
23989043,23989079,36,1,0,0,2
23989080,23989474,394,0,0,1,2
23989475,23989498,23,1,0,0,1
23989475,23989509,34,1,0,0,2
23989499,23989995,496,0,0,1,1
23989510,23989992,482,0,0,1,2
23989993,23990025,32,1,0,0,2
23989996,23990007,11,1,0,0,1
23990008,23990294,286,0,0,1,1
23990026,23990294,268,0,0,1,2
23990295,23990314,19,1,0,0,2
23990295,23990327,32,1,0,0,1
23990315,23990757,442,0,0,1,2
23990328,23990745,417,0,0,1,1
23990746,23991068,322,1,0,0,1
23990758,23991239,481,1,0,0,2
23990796,23991039,243,0,1,0,2
23990799,23990999,200,0,1,0,1
23991069,23991444,375,0,0,1,1
23991240,23991443,203,0,0,1,2
23991444,23991493,49,1,0,0,2
23991445,23991505,60,1,0,0,1
23991494,23991762,268,0,0,1,2
23991506,23991763,257,0,0,1,1
23991763,23991830,67,1,0,0,2
23991764,23991855,91,1,0,0,1
23991831,23992185,354,0,0,1,2
23991856,23992184,328,0,0,1,1
23992185,23992251,66,1,0,0,1
23992186,23992250,64,1,0,0,2
23992251,23992596,345,0,0,1,2
23992252,23992595,343,0,0,1,1
23992596,23992642,46,1,0,0,1
23992597,23992650,53,1,0,0,2
23992643,23992767,124,0,0,1,1
23992651,23992766,115,0,0,1,2
23992767,23992831,64,1,0,0,2
23992768,23992799,31,1,0,0,1
23992800,23993728,928,0,0,1,1
23992832,23993071,239,0,0,1,2
23993072,23993115,43,1,0,0,2
23993116,23993287,171,0,0,1,2
23993288,23993352,64,1,0,0,2
23993353,23993405,52,0,0,1,2
23993406,23993672,266,1,0,0,2
23993673,23993726,53,0,0,1,2
23993727,23993830,103,1,0,0,2
23993729,23993759,30,1,0,0,1
23993760,23994055,295,0,0,1,1
23993831,23993928,97,0,0,1,2
23993929,23993949,20,1,0,0,2
23993950,23993992,42,0,0,1,2
23993993,23994005,12,1,0,0,2
23994006,23994056,50,0,0,1,2
23994056,23994136,80,1,0,0,1
23994057,23994175,118,1,0,0,2
23994137,23994256,119,0,0,1,1
23994176,23994259,83,0,0,1,2
23994257,23994297,40,1,0,0,1
23994260,23994310,50,1,0,0,2
23994298,23994898,600,0,0,1,1
23994311,23994708,397,0,0,1,2
23994709,23994773,64,1,0,0,2
23994774,23994993,219,0,0,1,2
23994899,23994922,23,1,0,0,1
23994923,23995516,593,0,0,1,1
23994994,23995000,6,1,0,0,2
23995001,23996150,1149,0,0,1,2
23995517,23995652,135,1,0,0,1
23995653,23995796,143,0,0,1,1
23995797,23995819,22,1,0,0,1
23995820,23996065,245,0,0,1,1
23996066,23996093,27,1,0,0,1
23996094,23996116,22,0,0,1,1
23996117,23996338,221,1,0,0,1
23996151,23996531,380,1,0,0,2
23996228,23996250,22,0,1,0,1
23996230,23996246,16,0,1,0,2
23996339,23996404,65,0,0,1,1
23996405,23996444,39,1,0,0,1
23996445,23996656,211,0,0,1,1
23996532,23996650,118,0,0,1,2
23996651,23997352,701,1,0,0,2
23996657,23997125,468,1,0,0,1
23996694,23996913,219,0,1,0,2
23996696,23996885,189,0,1,0,1
23997126,23997492,366,0,0,1,1
23997353,23997380,27,0,0,1,2
23997381,23997432,51,1,0,0,2
23997433,23997493,60,0,0,1,2
23997493,23997549,56,1,0,0,1
23997494,24002010,4516,1,0,0,2
23997550,23997616,66,0,0,1,1
23997617,23997649,32,1,0,0,1
23997650,23997750,100,0,0,1,1
23997751,23997781,30,1,0,0,1
23997782,23999283,1501,0,0,1,1
23999284,23999340,56,1,0,0,1
23999341,24001219,1878,0,0,1,1
24001220,24001261,41,1,0,0,1
24001262,24001294,32,0,0,1,1
24001295,24001403,108,1,0,0,1
24001404,24001431,27,0,0,1,1
24001432,24001770,338,1,0,0,1
24001448,24001724,276,0,1,0,2
24001458,24001684,226,0,1,0,1
24001722,24001724,2,0,1,0,1
24001771,24001930,159,0,0,1,1
24001931,24001983,52,1,0,0,1
24001984,24002242,258,0,0,1,1
24002011,24002243,232,0,0,1,2
24002243,24002284,41,1,0,0,1
24002244,24002316,72,1,0,0,2
24002285,24003021,736,0,0,1,1
24002317,24002682,365,0,0,1,2
24002683,24002709,26,1,0,0,2
24002710,24002827,117,0,0,1,2
24002828,24002920,92,1,0,0,2
24002921,24003020,99,0,0,1,2
24003021,24003057,36,1,0,0,2
24003022,24003059,37,1,0,0,1
24003058,24003160,102,0,0,1,2
24003060,24003160,100,0,0,1,1
24003161,24003182,21,1,0,0,1
24003161,24003190,29,1,0,0,2
24003183,24004686,1503,0,0,1,1
24003191,24003611,420,0,0,1,2
24003612,24003648,36,1,0,0,2
24003649,24003772,123,0,0,1,2
24003773,24003811,38,1,0,0,2
24003812,24003880,68,0,0,1,2
24003881,24003965,84,1,0,0,2
24003966,24004018,52,0,0,1,2
24004019,24004032,13,1,0,0,2
24004033,24004222,189,0,0,1,2
24004223,24004284,61,1,0,0,2
24004285,24004314,29,0,0,1,2
24004315,24004339,24,1,0,0,2
24004340,24004457,117,0,0,1,2
24004458,24004472,14,1,0,0,2
24004473,24004682,209,0,0,1,2
24004683,24004744,61,1,0,0,2
24004687,24004744,57,1,0,0,1
24004745,24004782,37,0,0,1,2
24004745,24004816,71,0,0,1,1
24004783,24004794,11,1,0,0,2
24004795,24004816,21,0,0,1,2
24004817,24004848,31,1,0,0,1
24004817,24004874,57,1,0,0,2
24004849,24006739,1890,0,0,1,1
24004875,24005599,724,0,0,1,2
24005600,24005604,4,1,0,0,2
24005605,24005824,219,0,0,1,2
24005825,24005861,36,1,0,0,2
24005862,24006161,299,0,0,1,2
24006162,24006175,13,1,0,0,2
24006176,24006441,265,0,0,1,2
24006442,24006446,4,1,0,0,2
24006447,24006536,89,0,0,1,2
24006537,24006542,5,1,0,0,2
24006543,24006644,101,0,0,1,2
24006645,24006693,48,1,0,0,2
24006694,24006731,37,0,0,1,2
24006732,24007901,1169,1,0,0,2
24006740,24007186,446,1,0,0,1
24006768,24006978,210,0,1,0,2
24006773,24006939,166,0,1,0,1
24007187,24007492,305,0,0,1,1
24007493,24007547,54,1,0,0,1
24007548,24008276,728,0,0,1,1
24007902,24008034,132,0,0,1,2
24008035,24008058,23,1,0,0,2
24008059,24008277,218,0,0,1,2
24008277,24008360,83,1,0,0,1
24008278,24008355,77,1,0,0,2
24008356,24008451,95,0,0,1,2
24008361,24008451,90,0,0,1,1
24008452,24008485,33,1,0,0,2
24008452,24008492,40,1,0,0,1
24008486,24008786,300,0,0,1,2
24008493,24008785,292,0,0,1,1
24008786,24008829,43,1,0,0,1
24008787,24008822,35,1,0,0,2
24008823,24010147,1324,0,0,1,2
24008830,24010145,1315,0,0,1,1
24010146,24010187,41,1,0,0,1
24010148,24010194,46,1,0,0,2
24010188,24010403,215,0,0,1,1
24010195,24010401,206,0,0,1,2
24010402,24010439,37,1,0,0,2
24010404,24010433,29,1,0,0,1
24010434,24010898,464,0,0,1,1
24010440,24010904,464,0,0,1,2
24010899,24010912,13,1,0,0,1
24010905,24010909,4,1,0,0,2
24010910,24012209,1299,0,0,1,2
24010913,24011273,360,0,0,1,1
24011274,24011290,16,1,0,0,1
24011291,24012208,917,0,0,1,1
24012209,24012507,298,1,0,0,1
24012210,24012532,322,1,0,0,2
24012250,24012468,218,0,1,0,2
24012256,24012436,180,0,1,0,1
24012508,24012744,236,0,0,1,1
24012533,24012742,209,0,0,1,2
24012743,24012826,83,1,0,0,2
24012745,24012819,74,1,0,0,1
24012820,24013034,214,0,0,1,1
24012827,24013033,206,0,0,1,2
24013034,24013071,37,1,0,0,2
24013035,24013070,35,1,0,0,1
24013071,24013898,827,0,0,1,1
24013072,24013896,824,0,0,1,2
24013897,24013931,34,1,0,0,2
24013899,24013925,26,1,0,0,1
24013926,24013986,60,0,0,1,1
24013932,24013983,51,0,0,1,2
24013984,24014077,93,1,0,0,2
24013987,24014081,94,1,0,0,1
24014078,24014154,76,0,0,1,2
24014082,24014156,74,0,0,1,1
24014155,24014197,42,1,0,0,2
24014157,24014189,32,1,0,0,1
24014190,24014340,150,0,0,1,1
24014198,24014464,266,0,0,1,2
24014341,24014357,16,1,0,0,1
24014358,24014464,106,0,0,1,1
24014465,24014529,64,1,0,0,2
24014465,24014539,74,1,0,0,1
24014530,24014576,46,0,0,1,2
24014540,24014957,417,0,0,1,1
24014577,24014584,7,1,0,0,2
24014585,24014730,145,0,0,1,2
24014731,24014852,121,1,0,0,2
24014853,24014896,43,0,0,1,2
24014897,24014982,85,1,0,0,2
24014958,24014969,11,1,0,0,1
24014970,24015058,88,0,0,1,1
24014983,24015453,470,0,0,1,2
24015059,24015259,200,1,0,0,1
24015260,24015715,455,0,0,1,1
24015454,24015477,23,1,0,0,2
24015478,24015666,188,0,0,1,2
24015667,24015765,98,1,0,0,2
24015716,24015779,63,1,0,0,1
24015766,24015896,130,0,0,1,2
24015780,24015898,118,0,0,1,1
24015897,24015936,39,1,0,0,2
24015899,24015944,45,1,0,0,1
24015937,24016464,527,0,0,1,2
24015945,24016553,608,0,0,1,1
24016465,24016523,58,1,0,0,2
24016524,24016554,30,0,0,1,2
24016554,24016631,77,1,0,0,1
24016555,24016599,44,1,0,0,2
24016600,24016720,120,0,0,1,2
24016632,24016676,44,0,0,1,1
24016677,24016726,49,1,0,0,1
24016721,24016747,26,1,0,0,2
24016727,24017367,640,0,0,1,1
24016748,24017040,292,0,0,1,2
24017041,24017045,4,1,0,0,2
24017046,24017135,89,0,0,1,2
24017136,24017281,145,1,0,0,2
24017282,24017324,42,0,0,1,2
24017325,24017425,100,1,0,0,2
24017368,24017375,7,1,0,0,1
24017376,24017478,102,0,0,1,1
24017426,24017493,67,0,0,1,2
24017479,24017582,103,1,0,0,1
24017494,24017509,15,1,0,0,2
24017510,24017567,57,0,0,1,2
24017568,24017725,157,1,0,0,2
24017583,24017798,215,0,0,1,1
24017726,24017810,84,0,0,1,2
24017799,24018156,357,1,0,0,1
24017811,24018782,971,1,0,0,2
24017848,24018087,239,0,1,0,2
24017851,24018055,204,0,1,0,1
24018157,24018392,235,0,0,1,1
24018393,24018431,38,1,0,0,1
24018432,24018631,199,0,0,1,1
24018632,24018676,44,1,0,0,1
24018677,24018905,228,0,0,1,1
24018783,24018835,52,0,0,1,2
24018836,24018851,15,1,0,0,2
24018852,24018878,26,0,0,1,2
24018879,24019019,140,1,0,0,2
24018906,24018943,37,1,0,0,1
24018944,24019391,447,0,0,1,1
24019020,24019390,370,0,0,1,2
24019391,24019433,42,1,0,0,2
24019392,24019424,32,1,0,0,1
24019425,24019722,297,0,0,1,1
24019434,24019723,289,0,0,1,2
24019723,24019747,24,1,0,0,1
24019724,24019749,25,1,0,0,2
24019748,24019803,55,0,0,1,1
24019750,24019802,52,0,0,1,2
24019803,24019841,38,1,0,0,2
24019804,24019843,39,1,0,0,1
24019842,24019971,129,0,0,1,2
24019844,24019970,126,0,0,1,1
24019971,24020019,48,1,0,0,1
24019972,24020058,86,1,0,0,2
24020020,24020096,76,0,0,1,1
24020059,24020094,35,0,0,1,2
24020095,24022024,1929,1,0,0,2
24020097,24021462,1365,1,0,0,1
24020126,24021412,1286,0,1,0,2
24020127,24021218,1091,0,1,0,1
24021242,24021408,166,0,1,0,1
24021463,24021521,58,0,0,1,1
24021522,24021776,254,1,0,0,1
24021540,24021713,173,0,1,0,1
24021542,24021730,188,0,1,0,2
24021777,24021871,94,0,0,1,1
24021872,24021897,25,1,0,0,1
24021898,24022242,344,0,0,1,1
24022025,24022074,49,0,0,1,2
24022075,24022165,90,1,0,0,2
24022166,24022248,82,0,0,1,2
24022243,24022279,36,1,0,0,1
24022249,24022294,45,1,0,0,2
24022280,24022411,131,0,0,1,1
24022295,24022453,158,0,0,1,2
24022412,24022430,18,1,0,0,1
24022431,24022521,90,0,0,1,1
24022454,24022586,132,1,0,0,2
24022522,24022573,51,1,0,0,1
24022574,24022808,234,0,0,1,1
24022587,24022730,143,0,0,1,2
24022731,24022808,77,1,0,0,2
24089039,24089177,138,0,0,1,1
24089039,24089302,263,0,0,1,2
24089178,24089189,11,1,0,0,1
24089190,24089302,112,0,0,1,1
24089303,24089381,78,1,0,0,1
24089303,24089381,78,1,0,0,2
24089382,24089431,49,0,0,1,2
24089382,24089432,50,0,0,1,1
24089432,24089492,60,1,0,0,2
24089433,24089490,57,1,0,0,1
24089491,24089541,50,0,0,1,1
24089493,24089540,47,0,0,1,2
24089541,24089578,37,1,0,0,2
24089542,24089585,43,1,0,0,1
24089579,24089663,84,0,0,1,2
24089586,24089665,79,0,0,1,1
24089664,24089700,36,1,0,0,2
24089666,24089701,35,1,0,0,1
24089701,24090031,330,0,0,1,2
24089702,24090031,329,0,0,1,1
24090032,24090063,31,1,0,0,1
24090032,24090064,32,1,0,0,2
24090064,24091210,1146,0,0,1,1
24090065,24091209,1144,0,0,1,2
24091210,24091227,17,1,0,0,2
24091211,24091249,38,1,0,0,1
24091228,24091651,423,0,0,1,2
24091250,24091649,399,0,0,1,1
24091650,24091742,92,1,0,0,1
24091652,24091746,94,1,0,0,2
24091743,24091807,64,0,0,1,1
24091747,24091808,61,0,0,1,2
24091808,24091848,40,1,0,0,1
24091809,24091857,48,1,0,0,2
24091849,24091949,100,0,0,1,1
24091858,24091952,94,0,0,1,2
24091950,24091980,30,1,0,0,1
24091953,24091989,36,1,0,0,2
24091981,24092157,176,0,0,1,1
24091990,24092151,161,0,0,1,2
24092152,24092790,638,1,0,0,2
24092158,24092178,20,1,0,0,1
24092179,24092962,783,0,0,1,1
24092791,24092829,38,0,0,1,2
24092830,24093415,585,1,0,0,2
24092963,24093388,425,1,0,0,1
24092998,24093404,406,0,1,0,2
24093008,24093377,369,0,1,0,1
24093389,24093507,118,0,0,1,1
24093416,24093503,87,0,0,1,2
24093504,24093618,114,1,0,0,2
24093508,24093596,88,1,0,0,1
24093597,24093680,83,0,0,1,1
24093619,24093678,59,0,0,1,2
24093679,24093711,32,1,0,0,2
24093681,24093704,23,1,0,0,1
24093705,24094887,1182,0,0,1,1
24093712,24093971,259,0,0,1,2
24093972,24094001,29,1,0,0,2
24094002,24094886,884,0,0,1,2
24094887,24094975,88,1,0,0,2
24094888,24094973,85,1,0,0,1
24094974,24095363,389,0,0,1,1
24094976,24095363,387,0,0,1,2
24095364,24095439,75,1,0,0,1
24095364,24095441,77,1,0,0,2
24095440,24095535,95,0,0,1,1
24095442,24095535,93,0,0,1,2
24095536,24095579,43,1,0,0,2
24095536,24095582,46,1,0,0,1
24095580,24095706,126,0,0,1,2
24095583,24095706,123,0,0,1,1
24095707,24095742,35,1,0,0,2
24095707,24095749,42,1,0,0,1
24095743,24096093,350,0,0,1,2
24095750,24096094,344,0,0,1,1
24096094,24096128,34,1,0,0,2
24096095,24096128,33,1,0,0,1
24096129,24096712,583,0,0,1,2
24096129,24096716,587,0,0,1,1
24096713,24096812,99,1,0,0,2
24096717,24096810,93,1,0,0,1
24096811,24097136,325,0,0,1,1
24096813,24097136,323,0,0,1,2
24097137,24097225,88,1,0,0,2
24097137,24097236,99,1,0,0,1
24097226,24097282,56,0,0,1,2
24097237,24097283,46,0,0,1,1
24097283,24097333,50,1,0,0,2
24097284,24097323,39,1,0,0,1
24097324,24097420,96,0,0,1,1
24097334,24097421,87,0,0,1,2
24097421,24097454,33,1,0,0,1
24097422,24097454,32,1,0,0,2
24097455,24098462,1007,0,0,1,1
24097455,24098464,1009,0,0,1,2
24098463,24098556,93,1,0,0,1
24098465,24098556,91,1,0,0,2
24098557,24098863,306,0,0,1,1
24098557,24098863,306,0,0,1,2
24098864,24098931,67,1,0,0,1
24098864,24098959,95,1,0,0,2
24098932,24099006,74,0,0,1,1
24098960,24099005,45,0,0,1,2
24099006,24099035,29,1,0,0,2
24099007,24099041,34,1,0,0,1
24099036,24099775,739,0,0,1,2
24099042,24099775,733,0,0,1,1
24099776,24099840,64,1,0,0,2
24099776,24099841,65,1,0,0,1
24099841,24100274,433,0,0,1,2
24099842,24100274,432,0,0,1,1
24100275,24100350,75,1,0,0,2
24100275,24100353,78,1,0,0,1
24100351,24100390,39,0,0,1,2
24100354,24100392,38,0,0,1,1
24100391,24100438,47,1,0,0,2
24100393,24100433,40,1,0,0,1
24100434,24100551,117,0,0,1,1
24100439,24100550,111,0,0,1,2
24100551,24100574,23,1,0,0,2
24100552,24100581,29,1,0,0,1
24100575,24101462,887,0,0,1,2
24100582,24101461,879,0,0,1,1
24101462,24101567,105,1,0,0,1
24101463,24101566,103,1,0,0,2
24101567,24101866,299,0,0,1,2
24101568,24101864,296,0,0,1,1
24101865,24101952,87,1,0,0,1
24101867,24101943,76,1,0,0,2
24101944,24101984,40,0,0,1,2
24101953,24101984,31,0,0,1,1
24101985,24102072,87,1,0,0,2
24101985,24102075,90,1,0,0,1
24102073,24102145,72,0,0,1,2
24102076,24102146,70,0,0,1,1
24102146,24102196,50,1,0,0,2
24102147,24102207,60,1,0,0,1
24102197,24102964,767,0,0,1,2
24102208,24102480,272,0,0,1,1
24102481,24102512,31,1,0,0,1
24102513,24102962,449,0,0,1,1
24102963,24103039,76,1,0,0,1
24102965,24103053,88,1,0,0,2
24103040,24103446,406,0,0,1,1
24103054,24103445,391,0,0,1,2
24103446,24103475,29,1,0,0,2
24103447,24103476,29,1,0,0,1
24103476,24103697,221,0,0,1,2
24103477,24103699,222,0,0,1,1
24103698,24103718,20,1,0,0,2
24103700,24103724,24,1,0,0,1
24103719,24104493,774,0,0,1,2
24103725,24104492,767,0,0,1,1
24104493,24104524,31,1,0,0,1
24104494,24104524,30,1,0,0,2
24104525,24104841,316,0,0,1,2
24104525,24104842,317,0,0,1,1
24104842,24104914,72,1,0,0,2
24104843,24104920,77,1,0,0,1
24104915,24104999,84,0,0,1,2
24104921,24104998,77,0,0,1,1
24104999,24105035,36,1,0,0,1
24105000,24105035,35,1,0,0,2
24105036,24105472,436,0,0,1,1
24105036,24105727,691,0,0,1,2
24105473,24105500,27,1,0,0,1
24105501,24105723,222,0,0,1,1
24105724,24105795,71,1,0,0,1
24105728,24105813,85,1,0,0,2
24105796,24106268,472,0,0,1,1
24105814,24106269,455,0,0,1,2
24106269,24106342,73,1,0,0,1
24106270,24106328,58,1,0,0,2
24106329,24106403,74,0,0,1,2
24106343,24106404,61,0,0,1,1
24106404,24106455,51,1,0,0,2
24106405,24106472,67,1,0,0,1
24106456,24106531,75,0,0,1,2
24106473,24106528,55,0,0,1,1
24106529,24106576,47,1,0,0,1
24106532,24106561,29,1,0,0,2
24106562,24107230,668,0,0,1,2
24106577,24106802,225,0,0,1,1
24106803,24106847,44,1,0,0,1
24106848,24107085,237,0,0,1,1
24107086,24107126,40,1,0,0,1
24107127,24107224,97,0,0,1,1
24107225,24107362,137,1,0,0,1
24107231,24107422,191,1,0,0,2
24107363,24107650,287,0,0,1,1
24107423,24107650,227,0,0,1,2
24107651,24107714,63,1,0,0,1
24107651,24107714,63,1,0,0,2
24107715,24107774,59,0,0,1,1
24107715,24107776,61,0,0,1,2
24107775,24107817,42,1,0,0,1
24107777,24107818,41,1,0,0,2
24107818,24107882,64,0,0,1,1
24107819,24107880,61,0,0,1,2
24107881,24107921,40,1,0,0,2
24107883,24107916,33,1,0,0,1
24107917,24108075,158,0,0,1,1
24107922,24108073,151,0,0,1,2
24108074,24108115,41,1,0,0,2
24108076,24108107,31,1,0,0,1
24108108,24108593,485,0,0,1,1
24108116,24108593,477,0,0,1,2
24108594,24108670,76,1,0,0,1
24108594,24108684,90,1,0,0,2
24108671,24108985,314,0,0,1,1
24108685,24108985,300,0,0,1,2
24108986,24109045,59,1,0,0,1
24108986,24109045,59,1,0,0,2
24109046,24109129,83,0,0,1,2
24109046,24109130,84,0,0,1,1
24109130,24109151,21,1,0,0,2
24109131,24109151,20,1,0,0,1
24109152,24109483,331,0,0,1,1
24109152,24109484,332,0,0,1,2
24109484,24109514,30,1,0,0,1
24109485,24109514,29,1,0,0,2
24109515,24109844,329,0,0,1,1
24109515,24109844,329,0,0,1,2
24109845,24109903,58,1,0,0,1
24109845,24109904,59,1,0,0,2
24109904,24109953,49,0,0,1,1
24109905,24109952,47,0,0,1,2
24109953,24110236,283,1,0,0,2
24109954,24110230,276,1,0,0,1
24109984,24110151,167,0,1,0,1
24109984,24110162,178,0,1,0,2
24110231,24110357,126,0,0,1,1
24110237,24110356,119,0,0,1,2
24110357,24110425,68,1,0,0,2
24110358,24110425,67,1,0,0,1
24110426,24110526,100,0,0,1,2
24110426,24110529,103,0,0,1,1
24110527,24110587,60,1,0,0,2
24110530,24110564,34,1,0,0,1
24110565,24111589,1024,0,0,1,1
24110588,24111587,999,0,0,1,2
24111588,24111660,72,1,0,0,2
24111590,24111664,74,1,0,0,1
24111661,24111984,323,0,0,1,2
24111665,24111984,319,0,0,1,1
24111985,24112040,55,1,0,0,2
24111985,24112042,57,1,0,0,1
24112041,24112125,84,0,0,1,2
24112043,24112126,83,0,0,1,1
24112126,24112157,31,1,0,0,2
24112127,24112157,30,1,0,0,1
24112158,24112870,712,0,0,1,2
24112158,24112871,713,0,0,1,1
24112871,24112939,68,1,0,0,2
24112872,24112942,70,1,0,0,1
24112940,24113299,359,0,0,1,2
24112943,24113298,355,0,0,1,1
24113299,24113348,49,1,0,0,1
24113300,24113353,53,1,0,0,2
24113349,24113500,151,0,0,1,1
24113354,24113500,146,0,0,1,2
24113501,24113536,35,1,0,0,1
24113501,24113541,40,1,0,0,2
24113537,24114413,876,0,0,1,1
24113542,24114412,870,0,0,1,2
24114413,24114444,31,1,0,0,2
24114414,24114447,33,1,0,0,1
24114445,24114743,298,0,0,1,2
24114448,24114742,294,0,0,1,1
24114743,24114831,88,1,0,0,1
24114744,24114830,86,1,0,0,2
24114831,24114874,43,0,0,1,2
24114832,24114874,42,0,0,1,1
24114875,24114924,49,1,0,0,2
24114875,24114937,62,1,0,0,1
24114925,24114999,74,0,0,1,2
24114938,24114999,61,0,0,1,1
24115000,24115037,37,1,0,0,2
24115000,24115038,38,1,0,0,1
24115038,24115250,212,0,0,1,2
24115039,24115248,209,0,0,1,1
24115249,24115304,55,1,0,0,1
24115251,24115282,31,1,0,0,2
24115283,24115895,612,0,0,1,2
24115305,24115895,590,0,0,1,1
24115896,24115983,87,1,0,0,1
24115896,24115988,92,1,0,0,2
24115984,24116290,306,0,0,1,1
24115989,24116290,301,0,0,1,2
24116291,24116385,94,1,0,0,2
24116291,24117316,1025,1,0,0,1
24116354,24117293,939,0,1,0,1
24116386,24116480,94,0,0,1,2
24116481,24116530,49,1,0,0,2
24116531,24116879,348,0,0,1,2
24116880,24116889,9,1,0,0,2
24116890,24117148,258,0,0,1,2
24117149,24117547,398,1,0,0,2
24117317,24117665,348,0,0,1,1
24117548,24117664,116,0,0,1,2
24117665,24117730,65,1,0,0,2
24117666,24117720,54,1,0,0,1
24117721,24117813,92,0,0,1,1
24117731,24117812,81,0,0,1,2
24117813,24117878,65,1,0,0,2
24117814,24117845,31,1,0,0,1
24117846,24118232,386,0,0,1,1
24117879,24118234,355,0,0,1,2
24118233,24118263,30,1,0,0,1
24118235,24118284,49,1,0,0,2
24118264,24118356,92,0,0,1,1
24118285,24119043,758,0,0,1,2
24118357,24118371,14,1,0,0,1
24118372,24119044,672,0,0,1,1
24119044,24119129,85,1,0,0,2
24119045,24119130,85,1,0,0,1
24119130,24119207,77,0,0,1,2
24119131,24119208,77,0,0,1,1
24119208,24119248,40,1,0,0,2
24119209,24119249,40,1,0,0,1
24119249,24119521,272,0,0,1,2
24119250,24119518,268,0,0,1,1
24119519,24119553,34,1,0,0,1
24119522,24119552,30,1,0,0,2
24119553,24120036,483,0,0,1,2
24119554,24120039,485,0,0,1,1
24120037,24120274,237,1,0,0,2
24120040,24120287,247,1,0,0,1
24120275,24120564,289,0,0,1,2
24120288,24120563,275,0,0,1,1
24120564,24120652,88,1,0,0,1
24120565,24120843,278,1,0,0,2
24120626,24120721,95,0,1,0,2
24120653,24120715,62,0,0,1,1
24120716,24120771,55,1,0,0,1
24120772,24120884,112,0,0,1,1
24120844,24120877,33,0,0,1,2
24120878,24121095,217,1,0,0,2
24120885,24121016,131,1,0,0,1
24120913,24120994,81,0,1,0,1
24121017,24121046,29,0,0,1,1
24121047,24121088,41,1,0,0,1
24121089,24121313,224,0,0,1,1
24121096,24121313,217,0,0,1,2
24121314,24121341,27,1,0,0,1
24121314,24121358,44,1,0,0,2
24121342,24121919,577,0,0,1,1
24121359,24121917,558,0,0,1,2
24121918,24122004,86,1,0,0,2
24121920,24122039,119,1,0,0,1
24121947,24121951,4,0,1,0,2
24122005,24122059,54,0,0,1,2
24122040,24122337,297,0,0,1,1
24122060,24122410,350,1,0,0,2
24122338,24122418,80,1,0,0,1
24122411,24122480,69,0,0,1,2
24122419,24122480,61,0,0,1,1
24122481,24122528,47,1,0,0,1
24122481,24122534,53,1,0,0,2
24122529,24122567,38,0,0,1,1
24122535,24122566,31,0,0,1,2
24122567,24122689,122,1,0,0,2
24122568,24122607,39,1,0,0,1
24122608,24122884,276,0,0,1,1
24122690,24122888,198,0,0,1,2
24122885,24122915,30,1,0,0,1
24122889,24122925,36,1,0,0,2
24122916,24123664,748,0,0,1,1
24122926,24123664,738,0,0,1,2
24123665,24123734,69,1,0,0,1
24123665,24123744,79,1,0,0,2
24123735,24124133,398,0,0,1,1
24123745,24124133,388,0,0,1,2
24124134,24124259,125,1,0,0,2
24124134,24125248,1114,1,0,0,1
24124193,24125124,931,0,1,0,1
24124260,24124314,54,0,0,1,2
24124315,24124407,92,1,0,0,2
24124335,24124362,27,0,1,0,2
24124408,24124667,259,0,0,1,2
24124668,24125255,587,1,0,0,2
24124679,24125162,483,0,1,0,2
24125249,24125546,297,0,0,1,1
24125256,24125546,290,0,0,1,2
24125547,24125635,88,1,0,0,1
24125547,24125651,104,1,0,0,2
24125636,24125705,69,0,0,1,1
24125652,24125714,62,0,0,1,2
24125706,24125766,60,1,0,0,1
24125715,24125751,36,1,0,0,2
24125752,24125933,181,0,0,1,2
24125767,24125935,168,0,0,1,1
24125934,24125987,53,1,0,0,2
24125936,24125984,48,1,0,0,1
24125985,24126647,662,0,0,1,1
24125988,24126646,658,0,0,1,2
24126647,24126725,78,1,0,0,2
24126648,24126724,76,1,0,0,1
24126725,24127127,402,0,0,1,1
24126726,24127127,401,0,0,1,2
24127128,24127205,77,1,0,0,2
24127128,24127216,88,1,0,0,1
24127206,24127290,84,0,0,1,2
24127217,24127288,71,0,0,1,1
24127289,24127328,39,1,0,0,1
24127291,24127334,43,1,0,0,2
24127329,24127647,318,0,0,1,1
24127335,24127647,312,0,0,1,2
24127648,24127659,11,1,0,0,1
24127648,24127668,20,1,0,0,2
24127660,24128291,631,0,0,1,1
24127669,24128291,622,0,0,1,2
24128292,24128402,110,1,0,0,1
24128292,24128402,110,1,0,0,2
24128403,24128645,242,0,0,1,2
24128403,24128647,244,0,0,1,1
24128646,24128730,84,1,0,0,2
24128648,24128713,65,1,0,0,1
24128714,24129565,851,0,0,1,1
24128731,24129564,833,0,0,1,2
24129565,24129657,92,1,0,0,2
24129566,24129641,75,1,0,0,1
24129642,24129730,88,0,0,1,1
24129658,24129728,70,0,0,1,2
24129729,24129782,53,1,0,0,2
24129731,24129781,50,1,0,0,1
24129782,24130020,238,0,0,1,1
24129783,24130021,238,0,0,1,2
24130021,24130075,54,1,0,0,1
24130022,24130087,65,1,0,0,2
24130076,24130161,85,0,0,1,1
24130088,24130163,75,0,0,1,2
24130162,24130212,50,1,0,0,1
24130164,24130216,52,1,0,0,2
24130213,24130466,253,0,0,1,1
24130217,24130988,771,0,0,1,2
24130467,24130495,28,1,0,0,1
24130496,24130883,387,0,0,1,1
24130884,24130891,7,1,0,0,1
24130892,24130978,86,0,0,1,1
24130979,24131054,75,1,0,0,1
24130989,24131056,67,1,0,0,2
24131055,24131435,380,0,0,1,1
24131057,24131434,377,0,0,1,2
24131435,24131514,79,1,0,0,2
24131436,24131500,64,1,0,0,1
24131501,24131585,84,0,0,1,1
24131515,24131583,68,0,0,1,2
24131584,24131632,48,1,0,0,2
24131586,24131641,55,1,0,0,1
24131633,24132084,451,0,0,1,2
24131642,24132315,673,0,0,1,1
24132085,24132100,15,1,0,0,2
24132101,24132316,215,0,0,1,2
24132316,24132379,63,1,0,0,1
24132317,24132391,74,1,0,0,2
24132380,24132742,362,0,0,1,1
24132392,24132740,348,0,0,1,2
24132741,24133250,509,1,0,0,2
24132743,24132795,52,1,0,0,1
24132796,24133147,351,0,0,1,1
24133148,24133186,38,1,0,0,1
24133187,24133601,414,0,0,1,1
24133251,24133293,42,0,0,1,2
24133294,24133454,160,1,0,0,2
24133455,24133479,24,0,0,1,2
24133480,24133672,192,1,0,0,2
24133602,24133677,75,1,0,0,1
24133673,24134036,363,0,0,1,2
24133678,24134035,357,0,0,1,1
24134036,24134079,43,1,0,0,1
24134037,24134079,42,1,0,0,2
24134080,24134135,55,0,0,1,1
24134080,24134135,55,0,0,1,2
24134136,24134212,76,1,0,0,1
24134136,24134224,88,1,0,0,2
24134178,24134179,1,0,1,0,1
24134213,24134290,77,0,0,1,1
24134225,24134289,64,0,0,1,2
24134290,24134331,41,1,0,0,2
24134291,24134327,36,1,0,0,1
24134328,24135126,798,0,0,1,1
24134332,24135124,792,0,0,1,2
24135125,24135208,83,1,0,0,2
24135127,24135211,84,1,0,0,1
24135152,24135158,6,0,1,0,1
24135209,24135251,42,0,0,1,2
24135212,24135580,368,0,0,1,1
24135252,24135274,22,1,0,0,2
24135275,24135512,237,0,0,1,2
24135513,24135532,19,1,0,0,2
24135533,24135582,49,0,0,1,2
24135581,24135619,38,1,0,0,1
24135583,24136401,818,1,0,0,2
24135620,24136426,806,0,0,1,1
24136402,24136426,24,0,0,1,2
24136427,24136488,61,1,0,0,2
24136427,24136490,63,1,0,0,1
24136489,24136874,385,0,0,1,2
24136491,24136874,383,0,0,1,1
24136875,24136930,55,1,0,0,1
24136875,24136941,66,1,0,0,2
24136931,24137121,190,0,0,1,1
24136942,24137121,179,0,0,1,2
24137122,24137154,32,1,0,0,1
24137122,24137165,43,1,0,0,2
24137155,24137821,666,0,0,1,1
24137166,24137598,432,0,0,1,2
24137599,24137615,16,1,0,0,2
24137616,24137818,202,0,0,1,2
24137819,24137912,93,1,0,0,2
24137822,24137881,59,1,0,0,1
24137882,24138237,355,0,0,1,1
24137913,24138065,152,0,0,1,2
24138066,24138322,256,1,0,0,2
24138238,24138268,30,1,0,0,1
24138269,24138540,271,0,0,1,1
24138323,24138392,69,0,0,1,2
24138393,24139333,940,1,0,0,2
24138541,24138571,30,1,0,0,1
24138572,24139108,536,0,0,1,1
24139109,24139150,41,1,0,0,1
24139151,24139577,426,0,0,1,1
24139334,24139354,20,0,0,1,2
24139355,24141125,1770,1,0,0,2
24139578,24139631,53,1,0,0,1
24139615,24140560,945,0,1,0,2
24139632,24139746,114,0,0,1,1
24139747,24140605,858,1,0,0,1
24139762,24140571,809,0,1,0,1
24140606,24140923,317,0,0,1,1
24140924,24141016,92,1,0,0,1
24141017,24141082,65,0,0,1,1
24141083,24141120,37,1,0,0,1
24141121,24141894,773,0,0,1,1
24141126,24141267,141,0,0,1,2
24141268,24141272,4,1,0,0,2
24141273,24141767,494,0,0,1,2
24141768,24141787,19,1,0,0,2
24141788,24141896,108,0,0,1,2
24141895,24141977,82,1,0,0,1
24141897,24142090,193,1,0,0,2
24141978,24142257,279,0,0,1,1
24142091,24142181,90,0,0,1,2
24142182,24142215,33,1,0,0,2
24142216,24142258,42,0,0,1,2
24142258,24142335,77,1,0,0,1
24142259,24142346,87,1,0,0,2
24142336,24142433,97,0,0,1,1
24142347,24142431,84,0,0,1,2
24142432,24142495,63,1,0,0,2
24142434,24142484,50,1,0,0,1
24142485,24143166,681,0,0,1,1
24142496,24143169,673,0,0,1,2
24143167,24143257,90,1,0,0,1
24143170,24143263,93,1,0,0,2
24143258,24143630,372,0,0,1,1
24143264,24143590,326,0,0,1,2
24143591,24143595,4,1,0,0,2
24143596,24143634,38,0,0,1,2
24143631,24143723,92,1,0,0,1
24143635,24143708,73,1,0,0,2
24143709,24143863,154,0,0,1,2
24143724,24143863,139,0,0,1,1
24143864,24143905,41,1,0,0,2
24143864,24143925,61,1,0,0,1
24143906,24144064,158,0,0,1,2
24143926,24144066,140,0,0,1,1
24144065,24144098,33,1,0,0,2
24144067,24144097,30,1,0,0,1
24144098,24144574,476,0,0,1,1
24144099,24144577,478,0,0,1,2
24144575,24144647,72,1,0,0,1
24144578,24145105,527,1,0,0,2
24144648,24145031,383,0,0,1,1
24145032,24145095,63,1,0,0,1
24145096,24145213,117,0,0,1,1
24145106,24145148,42,0,0,1,2
24145149,24145252,103,1,0,0,2
24145214,24145243,29,1,0,0,1
24145244,24145953,709,0,0,1,1
24145253,24145482,229,0,0,1,2
24145483,24145505,22,1,0,0,2
24145506,24145703,197,0,0,1,2
24145704,24145812,108,1,0,0,2
24145813,24145879,66,0,0,1,2
24145880,24146018,138,1,0,0,2
24145954,24146363,409,1,0,0,1
24145979,24146352,373,0,1,0,1
24146019,24146303,284,0,0,1,2
24146304,24146585,281,1,0,0,2
24146364,24146401,37,0,0,1,1
24146402,24146475,73,1,0,0,1
24146476,24146527,51,0,0,1,1
24146528,24146579,51,1,0,0,1
24146580,24146616,36,0,0,1,1
24146586,24146705,119,0,0,1,2
24146617,24146636,19,1,0,0,1
24146637,24146702,65,0,0,1,1
24146703,24146772,69,1,0,0,1
24146706,24146827,121,1,0,0,2
24146773,24147168,395,0,0,1,1
24146828,24146998,170,0,0,1,2
24146999,24147046,47,1,0,0,2
24147047,24147359,312,0,0,1,2
24147169,24147244,75,1,0,0,1
24147245,24147358,113,0,0,1,1
24147359,24147429,70,1,0,0,1
24147360,24147517,157,1,0,0,2
24147430,24147795,365,0,0,1,1
24147518,24147798,280,0,0,1,2
24147796,24147837,41,1,0,0,1
24147799,24148066,267,1,0,0,2
24147838,24148663,825,0,0,1,1
24148067,24148094,27,0,0,1,2
24148095,24149023,928,1,0,0,2
24148664,24148727,63,1,0,0,1
24148728,24149174,446,0,0,1,1
24149024,24149129,105,0,0,1,2
24149130,24149134,4,1,0,0,2
24149135,24149173,38,0,0,1,2
24149174,24149228,54,1,0,0,2
24149175,24149226,51,1,0,0,1
24149227,24149323,96,0,0,1,1
24149229,24149324,95,0,0,1,2
24149324,24149359,35,1,0,0,1
24149325,24149508,183,1,0,0,2
24149360,24150159,799,0,0,1,1
24149509,24149783,274,0,0,1,2
24149784,24150056,272,1,0,0,2
24150057,24150161,104,0,0,1,2
24150160,24150212,52,1,0,0,1
24150162,24150213,51,1,0,0,2
24150213,24150635,422,0,0,1,1
24150214,24150631,417,0,0,1,2
24150632,24150705,73,1,0,0,2
24150636,24150688,52,1,0,0,1
24150689,24150785,96,0,0,1,1
24150706,24150785,79,0,0,1,2
24150786,24150811,25,1,0,0,1
24150786,24150818,32,1,0,0,2
24150812,24150933,121,0,0,1,1
24150819,24150932,113,0,0,1,2
24150933,24150962,29,1,0,0,2
24150934,24150962,28,1,0,0,1
24150963,24151500,537,0,0,1,2
24150963,24151501,538,0,0,1,1
24151501,24151642,141,1,0,0,2
24151502,24151604,102,1,0,0,1
24151605,24151996,391,0,0,1,1
24151643,24151680,37,0,0,1,2
24151681,24151724,43,1,0,0,2
24151725,24151987,262,0,0,1,2
24151988,24152085,97,1,0,0,2
24151997,24152062,65,1,0,0,1
24152063,24152136,73,0,0,1,1
24152086,24152138,52,0,0,1,2
24152137,24152337,200,1,0,0,1
24152139,24152206,67,1,0,0,2
24152158,24152327,169,0,1,0,1
24152207,24152692,485,0,0,1,2
24152338,24152693,355,0,0,1,1
24152693,24152742,49,1,0,0,2
24152694,24152726,32,1,0,0,1
24152712,24152717,5,0,1,0,1
24152727,24152812,85,0,0,1,1
24152743,24152967,224,0,0,1,2
24152823,24152884,61,0,1,0,1
24152893,24152893,0,1,0,0,1
24152894,24152940,46,0,0,1,1
24152951,24152978,27,0,1,0,1
24152968,24153629,661,1,0,0,2
24152988,24153035,47,1,0,0,1
24153036,24153145,109,0,0,1,1
24153146,24153194,48,1,0,0,1
24153195,24153393,198,0,0,1,1
24153394,24153438,44,1,0,0,1
24153439,24153488,49,0,0,1,1
24153489,24153556,67,1,0,0,1
24153557,24153581,24,0,0,1,1
24153582,24153637,55,1,0,0,1
24153630,24153723,93,0,0,1,2
24153638,24153719,81,0,0,1,1
24153720,24153761,41,1,0,0,1
24153724,24153790,66,1,0,0,2
24153762,24154309,547,0,0,1,1
24153791,24154304,513,0,0,1,2
24154305,24154774,469,1,0,0,2
24154310,24154388,78,1,0,0,1
24154389,24154819,430,0,0,1,1
24154775,24154823,48,0,0,1,2
24154820,24154878,58,1,0,0,1
24154824,24154889,65,1,0,0,2
24154879,24155060,181,0,0,1,1
24154890,24155063,173,0,0,1,2
24155061,24155128,67,1,0,0,1
24155064,24155115,51,1,0,0,2
24155116,24155901,785,0,0,1,2
24155129,24155897,768,0,0,1,1
24155898,24156631,733,1,0,0,1
24155902,24156642,740,1,0,0,2
24155928,24156370,442,0,1,0,1
24155934,24156375,441,0,1,0,2
24156425,24156611,186,0,1,0,2
24156432,24156606,174,0,1,0,1
24156632,24156744,112,0,0,1,1
24156643,24156740,97,0,0,1,2
24156741,24156770,29,1,0,0,2
24156745,24156772,27,1,0,0,1
24156771,24156892,121,0,0,1,2
24156773,24157062,289,0,0,1,1
24156893,24157042,149,1,0,0,2
24156905,24157031,126,0,1,0,2
24157043,24157069,26,0,0,1,2
24157063,24157074,11,1,0,0,1
24157070,24157075,5,1,0,0,2
24157075,24158246,1171,0,0,1,1
24157076,24158244,1168,0,0,1,2
24158245,24158295,50,1,0,0,2
24158247,24158296,49,1,0,0,1
24158296,24158382,86,0,0,1,2
24158297,24158385,88,0,0,1,1
24158383,24158464,81,1,0,0,2
24158386,24158463,77,1,0,0,1
24158464,24158637,173,0,0,1,1
24158465,24158635,170,0,0,1,2
24158636,24158701,65,1,0,0,2
24158638,24158702,64,1,0,0,1
24158702,24158926,224,0,0,1,2
24158703,24158928,225,0,0,1,1
24158927,24158967,40,1,0,0,2
24158929,24158961,32,1,0,0,1
24158962,24159828,866,0,0,1,1
24158968,24159827,859,0,0,1,2
24159828,24159854,26,1,0,0,2
24159829,24159853,24,1,0,0,1
24159854,24160107,253,0,0,1,1
24159855,24160106,251,0,0,1,2
24160107,24160190,83,1,0,0,2
24160108,24160203,95,1,0,0,1
24160191,24160223,32,0,0,1,2
24160204,24160227,23,0,0,1,1
24160224,24160276,52,1,0,0,2
24160228,24160311,83,1,0,0,1
24160277,24160394,117,0,0,1,2
24160312,24160392,80,0,0,1,1
24160393,24160443,50,1,0,0,1
24160395,24160425,30,1,0,0,2
24160426,24161300,874,0,0,1,2
24160444,24161300,856,0,0,1,1
24161301,24161394,93,1,0,0,1
24161301,24161404,103,1,0,0,2
24161395,24161740,345,0,0,1,1
24161405,24161738,333,0,0,1,2
24161739,24161799,60,1,0,0,2
24161741,24161798,57,1,0,0,1
24161799,24162050,251,0,0,1,1
24161800,24162049,249,0,0,1,2
24162050,24162097,47,1,0,0,2
24162051,24162086,35,1,0,0,1
24162087,24162990,903,0,0,1,1
24162098,24162989,891,0,0,1,2
24162990,24163049,59,1,0,0,2
24162991,24163050,59,1,0,0,1
24163050,24163444,394,0,0,1,2
24163051,24163444,393,0,0,1,1
24163445,24163507,62,1,0,0,1
24163445,24163518,73,1,0,0,2
24163508,24163599,91,0,0,1,1
24163519,24163564,45,0,0,1,2
24163565,24163637,72,1,0,0,2
24163600,24163633,33,1,0,0,1
24163634,24163767,133,0,0,1,1
24163638,24163691,53,0,0,1,2
24163692,24163734,42,1,0,0,2
24163735,24163766,31,0,0,1,2
24163767,24163789,22,1,0,0,2
24163768,24163784,16,1,0,0,1
24163785,24164125,340,0,0,1,1
24163790,24164055,265,0,0,1,2
24164056,24164534,478,1,0,0,2
24164126,24164477,351,1,0,0,1
24164149,24164392,243,0,1,0,1
24164149,24164412,263,0,1,0,2
24164478,24166089,1611,0,0,1,1
24164535,24165116,581,0,0,1,2
24165117,24165139,22,1,0,0,2
24165140,24165253,113,0,0,1,2
24165254,24165349,95,1,0,0,2
24165350,24165397,47,0,0,1,2
24165398,24165510,112,1,0,0,2
24165511,24165645,134,0,0,1,2
24165646,24165708,62,1,0,0,2
24165709,24165784,75,0,0,1,2
24165785,24165791,6,1,0,0,2
24165792,24165882,90,0,0,1,2
24165883,24166158,275,1,0,0,2
24166090,24166136,46,1,0,0,1
24166137,24166748,611,0,0,1,1
24166159,24166749,590,0,0,1,2
24166749,24166773,24,1,0,0,1
24166750,24166776,26,1,0,0,2
24166774,24167653,879,0,0,1,1
24166777,24166959,182,0,0,1,2
24166960,24166976,16,1,0,0,2
24166977,24167348,371,0,0,1,2
24167349,24167384,35,1,0,0,2
24167385,24167655,270,0,0,1,2
24167654,24167691,37,1,0,0,1
24167656,24167701,45,1,0,0,2
24167692,24168133,441,0,0,1,1
24167702,24168135,433,0,0,1,2
24168134,24168163,29,1,0,0,1
24168136,24168166,30,1,0,0,2
24168164,24168517,353,0,0,1,1
24168167,24168523,356,0,0,1,2
24168518,24168944,426,1,0,0,1
24168524,24169051,527,1,0,0,2
24168556,24168846,290,0,1,0,2
24168558,24168817,259,0,1,0,1
24168945,24169326,381,0,0,1,1
24169052,24169143,91,0,0,1,2
24169144,24169227,83,1,0,0,2
24169228,24169258,30,0,0,1,2
24169259,24169416,157,1,0,0,2
24169327,24169370,43,1,0,0,1
24169371,24169769,398,0,0,1,1
24169417,24169482,65,0,0,1,2
24169483,24169544,61,1,0,0,2
24169545,24169644,99,0,0,1,2
24169645,24169651,6,1,0,0,2
24169652,24169767,115,0,0,1,2
24169768,24169829,61,1,0,0,2
24169770,24169818,48,1,0,0,1
24169819,24169906,87,0,0,1,1
24169830,24169906,76,0,0,1,2
24169907,24170015,108,1,0,0,1
24169907,24170016,109,1,0,0,2
24170016,24170084,68,0,0,1,1
24170017,24170085,68,0,0,1,2
24170085,24170119,34,1,0,0,1
24170086,24170121,35,1,0,0,2
24170120,24170346,226,0,0,1,1
24170122,24170348,226,0,0,1,2
24170347,24170375,28,1,0,0,1
24170349,24170381,32,1,0,0,2
24170376,24170974,598,0,0,1,1
24170382,24170959,577,0,0,1,2
24170960,24170989,29,1,0,0,2
24170975,24170995,20,1,0,0,1
24170990,24171419,429,0,0,1,2
24170996,24171422,426,0,0,1,1
24171420,24171469,49,1,0,0,2
24171423,24171489,66,1,0,0,1
24171470,24171665,195,0,0,1,2
24171490,24171649,159,0,0,1,1
24171650,24171683,33,1,0,0,1
24171666,24171671,5,1,0,0,2
24171672,24172192,520,0,0,1,2
24171684,24172193,509,0,0,1,1
24172193,24172211,18,1,0,0,2
24172194,24172223,29,1,0,0,1
24172212,24173464,1252,0,0,1,2
24172224,24172391,167,0,0,1,1
24172392,24172416,24,1,0,0,1
24172417,24173463,1046,0,0,1,1
24173464,24174793,1329,1,0,0,1
24173465,24174810,1345,1,0,0,2
24173506,24174776,1270,0,1,0,2
24173511,24174782,1271,0,1,0,1
24174794,24174953,159,0,0,1,1
24174811,24174954,143,0,0,1,2
24174954,24175003,49,1,0,0,1
24174955,24174997,42,1,0,0,2
24174998,24175109,111,0,0,1,2
24175004,24175109,105,0,0,1,1
24175110,24175128,18,1,0,0,1
24175110,24175131,21,1,0,0,2
24175129,24175389,260,0,0,1,1
24175132,24175387,255,0,0,1,2
24175388,24175404,16,1,0,0,2
24175390,24175407,17,1,0,0,1
24175405,24176688,1283,0,0,1,2
24175408,24175919,511,0,0,1,1
24175920,24175936,16,1,0,0,1
24175937,24176686,749,0,0,1,1
24176687,24176735,48,1,0,0,1
24176689,24176740,51,1,0,0,2
24176736,24176975,239,0,0,1,1
24176741,24176975,234,0,0,1,2
24176976,24177016,40,1,0,0,1
24176976,24177017,41,1,0,0,2
24177017,24177457,440,0,0,1,1
24177018,24178797,1779,0,0,1,2
24177458,24177466,8,1,0,0,1
24177467,24178794,1327,0,0,1,1
24178795,24179697,902,1,0,0,1
24178798,24179731,933,1,0,0,2
24178826,24179701,875,0,1,0,2
24178829,24179667,838,0,1,0,1
24179698,24180427,729,0,0,1,1
24179732,24180430,698,0,0,1,2
24180428,24180461,33,1,0,0,1
24180431,24180460,29,1,0,0,2
24180461,24180726,265,0,0,1,2
24180462,24180725,263,0,0,1,1
24180726,24180755,29,1,0,0,1
24180727,24180756,29,1,0,0,2
24180756,24180949,193,0,0,1,1
24180757,24180948,191,0,0,1,2
24180949,24180984,35,1,0,0,2
24180950,24180981,31,1,0,0,1
24180982,24181194,212,0,0,1,1
24180985,24181196,211,0,0,1,2
24181195,24181227,32,1,0,0,1
24181197,24181226,29,1,0,0,2
24181227,24182324,1097,0,0,1,2
24181228,24181789,561,0,0,1,1
24181790,24181800,10,1,0,0,1
24181801,24182324,523,0,0,1,1
24182325,24182374,49,1,0,0,1
24182325,24182380,55,1,0,0,2
24182375,24182660,285,0,0,1,1
24182381,24182662,281,0,0,1,2
24182661,24182699,38,1,0,0,1
24182663,24182700,37,1,0,0,2
24182700,24184408,1708,0,0,1,1
24182701,24184407,1706,0,0,1,2
24184408,24184491,83,1,0,0,2
24184409,24184487,78,1,0,0,1
24184488,24184665,177,0,0,1,1
24184492,24184664,172,0,0,1,2
24184665,24184701,36,1,0,0,2
24184666,24184700,34,1,0,0,1
24184701,24184886,185,0,0,1,1
24184702,24184887,185,0,0,1,2
24184887,24184920,33,1,0,0,1
24184888,24184918,30,1,0,0,2
24184919,24185221,302,0,0,1,2
24184921,24185217,296,0,0,1,1
24185218,24185586,368,1,0,0,1
24185222,24185594,372,1,0,0,2
24185255,24185488,233,0,1,0,2
24185259,24185476,217,0,1,0,1
24185587,24186016,429,0,0,1,1
24185595,24186016,421,0,0,1,2
24186017,24186079,62,1,0,0,2
24186017,24186080,63,1,0,0,1
24186080,24186102,22,0,0,1,2
24186081,24186195,114,0,0,1,1
24186103,24186112,9,1,0,0,2
24186113,24186195,82,0,0,1,2
24186196,24186230,34,1,0,0,1
24186196,24186267,71,1,0,0,2
24186231,24186535,304,0,0,1,1
24186268,24186534,266,0,0,1,2
24186535,24186577,42,1,0,0,2
24186536,24186567,31,1,0,0,1
24186568,24187301,733,0,0,1,1
24186578,24187298,720,0,0,1,2
24187299,24187319,20,1,0,0,2
24187302,24187328,26,1,0,0,1
24187320,24187845,525,0,0,1,2
24187329,24187845,516,0,0,1,1
24187846,24187904,58,1,0,0,2
24187846,24187907,61,1,0,0,1
24187905,24188074,169,0,0,1,2
24187908,24188075,167,0,0,1,1
24188075,24188111,36,1,0,0,2
24188076,24188112,36,1,0,0,1
24188112,24188595,483,0,0,1,2
24188113,24188600,487,0,0,1,1
24188596,24188614,18,1,0,0,2
24188601,24188605,4,1,0,0,1
24188606,24189914,1308,0,0,1,1
24188615,24189928,1313,0,0,1,2
24189915,24190222,307,1,0,0,1
24189929,24190224,295,1,0,0,2
24189960,24190058,98,0,1,0,2
24189966,24190023,57,0,1,0,1
24190223,24190439,216,0,0,1,1
24190225,24190439,214,0,0,1,2
24190440,24190481,41,1,0,0,1
24190440,24190485,45,1,0,0,2
24190482,24190912,430,0,0,1,1
24190486,24190910,424,0,0,1,2
24190911,24190998,87,1,0,0,2
24190913,24190938,25,1,0,0,1
24190939,24191275,336,0,0,1,1
24190999,24191034,35,0,0,1,2
24191035,24191039,4,1,0,0,2
24191040,24191114,74,0,0,1,2
24191115,24191162,47,1,0,0,2
24191163,24191276,113,0,0,1,2
24191276,24191306,30,1,0,0,1
24191277,24191305,28,1,0,0,2
24191306,24191501,195,0,0,1,2
24191307,24191505,198,0,0,1,1
24191502,24191562,60,1,0,0,2
24191506,24191566,60,1,0,0,1
24191563,24191670,107,0,0,1,2
24191567,24191671,104,0,0,1,1
24191671,24191704,33,1,0,0,2
24191672,24191705,33,1,0,0,1
24191705,24192244,539,0,0,1,2
24191706,24192244,538,0,0,1,1
24192245,24192276,31,1,0,0,1
24192245,24192277,32,1,0,0,2
24192277,24192596,319,0,0,1,1
24192278,24192591,313,0,0,1,2
24192592,24192616,24,1,0,0,2
24192597,24192613,16,1,0,0,1
24192614,24193075,461,0,0,1,1
24192617,24193074,457,0,0,1,2
24193075,24193126,51,1,0,0,2
24193076,24193117,41,1,0,0,1
24193118,24193245,127,0,0,1,1
24193127,24193243,116,0,0,1,2
24193244,24193273,29,1,0,0,2
24193246,24193272,26,1,0,0,1
24193273,24193889,616,0,0,1,1
24193274,24193894,620,0,0,1,2
24193890,24193919,29,1,0,0,1
24193895,24193922,27,1,0,0,2
24193920,24194425,505,0,0,1,1
24193923,24194431,508,0,0,1,2
24194426,24194441,15,1,0,0,1
24194432,24194449,17,1,0,0,2
24194442,24195169,727,0,0,1,1
24194450,24195169,719,0,0,1,2
24195170,24195204,34,1,0,0,1
24195170,24195206,36,1,0,0,2
24195205,24195465,260,0,0,1,1
24195207,24195472,265,0,0,1,2
24195466,24195871,405,1,0,0,1
24195473,24195861,388,1,0,0,2
24195499,24195738,239,0,1,0,1
24195500,24195747,247,0,1,0,2
24195862,24195952,90,0,0,1,2
24195872,24195948,76,0,0,1,1
24195949,24196249,300,1,0,0,1
24195953,24196271,318,1,0,0,2
24195986,24196183,197,0,1,0,2
24195989,24196165,176,0,1,0,1
24196250,24196969,719,0,0,1,1
24196272,24196971,699,0,0,1,2
24196970,24197030,60,1,0,0,1
24196972,24197042,70,1,0,0,2
24197031,24197070,39,0,0,1,1
24197043,24197070,27,0,0,1,2
24197071,24197112,41,1,0,0,1
24197071,24197119,48,1,0,0,2
24197113,24197192,79,0,0,1,1
24197120,24197191,71,0,0,1,2
24197192,24197248,56,1,0,0,2
24197193,24197227,34,1,0,0,1
24197228,24197368,140,0,0,1,1
24197249,24197369,120,0,0,1,2
24197369,24197400,31,1,0,0,1
24197370,24197407,37,1,0,0,2
24197401,24198322,921,0,0,1,1
24197408,24198176,768,0,0,1,2
24198177,24198202,25,1,0,0,2
24198203,24198322,119,0,0,1,2
24198323,24198389,66,1,0,0,1
24198323,24198390,67,1,0,0,2
24198390,24198549,159,0,0,1,1
24198391,24198549,158,0,0,1,2
24198550,24198580,30,1,0,0,1
24198550,24198580,30,1,0,0,2
24198581,24198870,289,0,0,1,2
24198581,24198873,292,0,0,1,1
24198871,24198899,28,1,0,0,2
24198874,24198899,25,1,0,0,1
24198900,24200151,1251,0,0,1,1
24198900,24200158,1258,0,0,1,2
24200152,24200167,15,1,0,0,1
24200159,24200163,4,1,0,0,2
24200164,24200491,327,0,0,1,2
24200168,24200489,321,0,0,1,1
24200490,24200514,24,1,0,0,1
24200492,24200527,35,1,0,0,2
24200515,24200564,49,0,0,1,1
24200528,24200568,40,0,0,1,2
24200565,24200867,302,1,0,0,1
24200569,24200862,293,1,0,0,2
24200594,24200781,187,0,1,0,2
24200596,24200773,177,0,1,0,1
24200863,24201198,335,0,0,1,2
24200868,24201197,329,0,0,1,1
24201198,24201241,43,1,0,0,1
24201199,24201253,54,1,0,0,2
24201242,24201435,193,0,0,1,1
24201254,24201434,180,0,0,1,2
24201435,24201471,36,1,0,0,2
24201436,24201471,35,1,0,0,1
24201472,24201645,173,0,0,1,1
24201472,24201645,173,0,0,1,2
24201646,24201706,60,1,0,0,2
24201646,24201709,63,1,0,0,1
24201707,24201894,187,0,0,1,2
24201710,24201894,184,0,0,1,1
24201895,24201913,18,1,0,0,2
24201895,24201914,19,1,0,0,1
24201914,24203118,1204,0,0,1,2
24201915,24203117,1202,0,0,1,1
24203118,24203144,26,1,0,0,1
24203119,24203132,13,1,0,0,2
24203133,24203640,507,0,0,1,2
24203145,24203642,497,0,0,1,1
24203641,24203704,63,1,0,0,2
24203643,24203708,65,1,0,0,1
24203705,24203896,191,0,0,1,2
24203709,24203896,187,0,0,1,1
24203897,24203931,34,1,0,0,1
24203897,24203932,35,1,0,0,2
24203932,24204218,286,0,0,1,1
24203933,24204219,286,0,0,1,2
24204219,24204251,32,1,0,0,1
24204220,24204256,36,1,0,0,2
24204252,24205365,1113,0,0,1,1
24204257,24204820,563,0,0,1,2
24204821,24204879,58,1,0,0,2
24204880,24205251,371,0,0,1,2
24205252,24205292,40,1,0,0,2
24205293,24205363,70,0,0,1,2
24205364,24205386,22,1,0,0,2
24205366,24205375,9,1,0,0,1
24205376,24205570,194,0,0,1,1
24205387,24205558,171,0,0,1,2
24205559,24205603,44,1,0,0,2
24205571,24205587,16,1,0,0,1
24205588,24205786,198,0,0,1,1
24205604,24205800,196,0,0,1,2
24205787,24206135,348,1,0,0,1
24205801,24207060,1259,1,0,0,2
24205841,24206071,230,0,1,0,2
24205846,24206050,204,0,1,0,1
24206136,24206231,95,0,0,1,1
24206232,24206579,347,1,0,0,1
24206261,24206521,260,0,1,0,2
24206265,24206500,235,0,1,0,1
24206580,24206688,108,0,0,1,1
24206689,24206715,26,1,0,0,1
24206716,24206789,73,0,0,1,1
24206790,24206814,24,1,0,0,1
24206815,24206995,180,0,0,1,1
24206996,24207038,42,1,0,0,1
24207039,24207205,166,0,0,1,1
24207061,24207108,47,0,0,1,2
24207109,24207121,12,1,0,0,2
24207122,24207207,85,0,0,1,2
24207206,24207246,40,1,0,0,1
24207208,24207260,52,1,0,0,2
24207247,24207320,73,0,0,1,1
24207261,24207319,58,0,0,1,2
24207320,24207386,66,1,0,0,2
24207321,24207379,58,1,0,0,1
24207380,24207475,95,0,0,1,1
24207387,24207474,87,0,0,1,2
24207475,24207522,47,1,0,0,2
24207476,24207518,42,1,0,0,1
24207519,24208442,923,0,0,1,1
24207523,24208209,686,0,0,1,2
24208210,24208214,4,1,0,0,2
24208215,24208443,228,0,0,1,2
24208443,24208513,70,1,0,0,1
24208444,24208508,64,1,0,0,2
24208509,24208595,86,0,0,1,2
24208514,24208597,83,0,0,1,1
24208596,24208633,37,1,0,0,2
24208598,24208628,30,1,0,0,1
24208629,24208759,130,0,0,1,1
24208634,24208762,128,0,0,1,2
24208760,24208780,20,1,0,0,1
24208763,24208783,20,1,0,0,2
24208781,24210133,1352,0,0,1,1
24208784,24208902,118,0,0,1,2
24208903,24208958,55,1,0,0,2
24208959,24209501,542,0,0,1,2
24209502,24209509,7,1,0,0,2
24209510,24209804,294,0,0,1,2
24209805,24209822,17,1,0,0,2
24209823,24210066,243,0,0,1,2
24210067,24210085,18,1,0,0,2
24210086,24210133,47,0,0,1,2
24210134,24210165,31,1,0,0,1
24210134,24210169,35,1,0,0,2
24210166,24210451,285,0,0,1,1
24210170,24210441,271,0,0,1,2
24210442,24210501,59,1,0,0,2
24210452,24210462,10,1,0,0,1
24210463,24210598,135,0,0,1,1
24210502,24210585,83,0,0,1,2
24210586,24211322,736,1,0,0,2
24210599,24211211,612,1,0,0,1
24210644,24211158,514,0,1,0,2
24210653,24211167,514,0,1,0,1
24211212,24211597,385,0,0,1,1
24211323,24211493,170,0,0,1,2
24211494,24211515,21,1,0,0,2
24211516,24211589,73,0,0,1,2
24211590,24212087,497,1,0,0,2
24211598,24211633,35,1,0,0,1
24211634,24211751,117,0,0,1,1
24211752,24212002,250,1,0,0,1
24211773,24211869,96,0,1,0,1
24211774,24211894,120,0,1,0,2
24212003,24212153,150,0,0,1,1
24212088,24212153,65,0,0,1,2
24212154,24212182,28,1,0,0,1
24212154,24212248,94,1,0,0,2
24212183,24212812,629,0,0,1,1
24212249,24212384,135,0,0,1,2
24212385,24212919,534,1,0,0,2
24212813,24212844,31,1,0,0,1
24212845,24213326,481,0,0,1,1
24212920,24213251,331,0,0,1,2
24213252,24213282,30,1,0,0,2
24213283,24213329,46,0,0,1,2
24213327,24213356,29,1,0,0,1
24213330,24213362,32,1,0,0,2
24213357,24213613,256,0,0,1,1
24213363,24213614,251,0,0,1,2
24213614,24213676,62,1,0,0,1
24213615,24213676,61,1,0,0,2
24213677,24213722,45,0,0,1,2
24213677,24213830,153,0,0,1,1
24213723,24214237,514,1,0,0,2
24213831,24213865,34,1,0,0,1
24213866,24214271,405,0,0,1,1
24214238,24214274,36,0,0,1,2
24214272,24214314,42,1,0,0,1
24214275,24214389,114,1,0,0,2
24214315,24214499,184,0,0,1,1
24214390,24214450,60,0,0,1,2
24214451,24214641,190,1,0,0,2
24214500,24214542,42,1,0,0,1
24214543,24214916,373,0,0,1,1
24214642,24214884,242,0,0,1,2
24214885,24214989,104,1,0,0,2
24214917,24214945,28,1,0,0,1
24214946,24215622,676,0,0,1,1
24214990,24215159,169,0,0,1,2
24215160,24215438,278,1,0,0,2
24215439,24215493,54,0,0,1,2
24215494,24216625,1131,1,0,0,2
24215623,24216618,995,1,0,0,1
24215675,24216585,910,0,1,0,1
24215676,24216587,911,0,1,0,2
24216619,24216964,345,0,0,1,1
24216626,24216961,335,0,0,1,2
24216962,24217070,108,1,0,0,2
24216965,24216998,33,1,0,0,1
24216999,24217549,550,0,0,1,1
24217071,24217109,38,0,0,1,2
24217110,24217156,46,1,0,0,2
24217157,24217406,249,0,0,1,2
24217407,24217715,308,1,0,0,2
24217550,24217614,64,1,0,0,1
24217615,24217658,43,0,0,1,1
24217659,24217702,43,1,0,0,1
24217703,24217755,52,0,0,1,1
24217716,24217755,39,0,0,1,2
24217756,24217793,37,1,0,0,1
24217756,24217817,61,1,0,0,2
24217794,24217977,183,0,0,1,1
24217818,24217865,47,0,0,1,2
24217866,24217913,47,1,0,0,2
24217914,24217970,56,0,0,1,2
24217971,24218076,105,1,0,0,2
24217978,24218007,29,1,0,0,1
24218008,24219338,1330,0,0,1,1
24218077,24218165,88,0,0,1,2
24218166,24218180,14,1,0,0,2
24218181,24218237,56,0,0,1,2
24218238,24218278,40,1,0,0,2
24218279,24218315,36,0,0,1,2
24218316,24218415,99,1,0,0,2
24218416,24218475,59,0,0,1,2
24218476,24218623,147,1,0,0,2
24218624,24218720,96,0,0,1,2
24218721,24218780,59,1,0,0,2
24218781,24219324,543,0,0,1,2
24219325,24219386,61,1,0,0,2
24219339,24219397,58,1,0,0,1
24219387,24220090,703,0,0,1,2
24219398,24220177,779,0,0,1,1
24220091,24220100,9,1,0,0,2
24220101,24220175,74,0,0,1,2
24220176,24220190,14,1,0,0,2
24220178,24220183,5,1,0,0,1
24220184,24220471,287,0,0,1,1
24220191,24220372,181,0,0,1,2
24220373,24220391,18,1,0,0,2
24220392,24220714,322,0,0,1,2
24220472,24220479,7,1,0,0,1
24220480,24220718,238,0,0,1,1
24220715,24220781,66,1,0,0,2
24220719,24220761,42,1,0,0,1
24220762,24220937,175,0,0,1,1
24220782,24220833,51,0,0,1,2
24220834,24220856,22,1,0,0,2
24220857,24220948,91,0,0,1,2
24220938,24220967,29,1,0,0,1
24220949,24220989,40,1,0,0,2
24220968,24221243,275,0,0,1,1
24220990,24221011,21,0,0,1,2
24221012,24221212,200,1,0,0,2
24221213,24221235,22,0,0,1,2
24221236,24221275,39,1,0,0,2
24221244,24221353,109,1,0,0,1
24221276,24221366,90,0,0,1,2
24221354,24221456,102,0,0,1,1
24221367,24222664,1297,1,0,0,2
24221457,24222646,1189,1,0,0,1
24221507,24222566,1059,0,1,0,1
24221512,24222566,1054,0,1,0,2
24222647,24222853,206,0,0,1,1
24222665,24222799,134,0,0,1,2
24222800,24222805,5,1,0,0,2
24222806,24222853,47,0,0,1,2
24222854,24222902,48,1,0,0,1
24222854,24223146,292,1,0,0,2
24222903,24223088,185,0,0,1,1
24223089,24223144,55,1,0,0,1
24223145,24223265,120,0,0,1,1
24223147,24223265,118,0,0,1,2
24223266,24223295,29,1,0,0,1
24223266,24223295,29,1,0,0,2
24223296,24224194,898,0,0,1,2
24223296,24224195,899,0,0,1,1
24224195,24224199,4,1,0,0,2
24224196,24224220,24,1,0,0,1
24224200,24224749,549,0,0,1,2
24224221,24224752,531,0,0,1,1
24224750,24224783,33,1,0,0,2
24224753,24224782,29,1,0,0,1
24224783,24224856,73,0,0,1,1
24224784,24224857,73,0,0,1,2
24224857,24224922,65,1,0,0,1
24224858,24224922,64,1,0,0,2
24224923,24225040,117,0,0,1,2
24224923,24225042,119,0,0,1,1
24225041,24225079,38,1,0,0,2
24225043,24225078,35,1,0,0,1
24225079,24225278,199,0,0,1,1
24225080,24225277,197,0,0,1,2
24225278,24225298,20,1,0,0,2
24225279,24225306,27,1,0,0,1
24225299,24225670,371,0,0,1,2
24225307,24225669,362,0,0,1,1
24225670,24225687,17,1,0,0,1
24225671,24225687,16,1,0,0,2
24225688,24225919,231,0,0,1,1
24225688,24225921,233,0,0,1,2
24225920,24225956,36,1,0,0,1
24225922,24225964,42,1,0,0,2
24225957,24226236,279,0,0,1,1
24225965,24226242,277,0,0,1,2
24226237,24226264,27,1,0,0,1
24226243,24226247,4,1,0,0,2
24226248,24226932,684,0,0,1,2
24226265,24226932,667,0,0,1,1
24226933,24227000,67,1,0,0,1
24226933,24227007,74,1,0,0,2
24227001,24227129,128,0,0,1,1
24227008,24227128,120,0,0,1,2
24227129,24227219,90,1,0,0,2
24227130,24227209,79,1,0,0,1
24227210,24227256,46,0,0,1,1
24227220,24227260,40,0,0,1,2
24227257,24228086,829,1,0,0,1
24227261,24228102,841,1,0,0,2
24227285,24228051,766,0,1,0,2
24227287,24228053,766,0,1,0,1
24228087,24228686,599,0,0,1,1
24228103,24228590,487,0,0,1,2
24228591,24228603,12,1,0,0,2
24228604,24228684,80,0,0,1,2
24228685,24228767,82,1,0,0,2
24228687,24228788,101,1,0,0,1
24228768,24228823,55,0,0,1,2
24228789,24228825,36,0,0,1,1
24228824,24228867,43,1,0,0,2
24228826,24228850,24,1,0,0,1
24228851,24229016,165,0,0,1,1
24228868,24229014,146,0,0,1,2
24229015,24229050,35,1,0,0,2
24229017,24229051,34,1,0,0,1
24229051,24229354,303,0,0,1,2
24229052,24229353,301,0,0,1,1
24229354,24229388,34,1,0,0,1
24229355,24229404,49,1,0,0,2
24229389,24229724,335,0,0,1,1
24229405,24230032,627,0,0,1,2
24229725,24229741,16,1,0,0,1
24229742,24230030,288,0,0,1,1
24230031,24230070,39,1,0,0,1
24230033,24230066,33,1,0,0,2
24230067,24230305,238,0,0,1,2
24230071,24230305,234,0,0,1,1
24230306,24230352,46,1,0,0,2
24230306,24230380,74,1,0,0,1
24230353,24230482,129,0,0,1,2
24230381,24230482,101,0,0,1,1
24230483,24230522,39,1,0,0,1
24230483,24230522,39,1,0,0,2
24230523,24230597,74,0,0,1,1
24230523,24230598,75,0,0,1,2
24230598,24230630,32,1,0,0,1
24230599,24230628,29,1,0,0,2
24230629,24231042,413,0,0,1,2
24230631,24231305,674,0,0,1,1
24231043,24231085,42,1,0,0,2
24231086,24231211,125,0,0,1,2
24231212,24231218,6,1,0,0,2
24231219,24231306,87,0,0,1,2
24231306,24231339,33,1,0,0,1
24231307,24231338,31,1,0,0,2
24231339,24232414,1075,0,0,1,2
24231340,24232419,1079,0,0,1,1
24232415,24232748,333,1,0,0,2
24232420,24232697,277,1,0,0,1
24232450,24232613,163,0,1,0,1
24232450,24232620,170,0,1,0,2
24232698,24233054,356,0,0,1,1
24232749,24233055,306,0,0,1,2
24233055,24233104,49,1,0,0,1
24233056,24233148,92,1,0,0,2
24233105,24233567,462,0,0,1,1
24233149,24233566,417,0,0,1,2
24233567,24233620,53,1,0,0,2
24233568,24233627,59,1,0,0,1
24233621,24233807,186,0,0,1,2
24233628,24233806,178,0,0,1,1
24233807,24233873,66,1,0,0,1
24233808,24233885,77,1,0,0,2
24233874,24234028,154,0,0,1,1
24233886,24234028,142,0,0,1,2
24234029,24234059,30,1,0,0,1
24234029,24234068,39,1,0,0,2
24234060,24235332,1272,0,0,1,1
24234069,24235332,1263,0,0,1,2
24235333,24235391,58,1,0,0,2
24235333,24235395,62,1,0,0,1
24235392,24235564,172,0,0,1,2
24235396,24235562,166,0,0,1,1
24235563,24235602,39,1,0,0,1
24235565,24235594,29,1,0,0,2
24235595,24235983,388,0,0,1,2
24235603,24235983,380,0,0,1,1
24235984,24236011,27,1,0,0,2
24235984,24236012,28,1,0,0,1
24236012,24236714,702,0,0,1,2
24236013,24236713,700,0,0,1,1
24236714,24236745,31,1,0,0,1
24236715,24236745,30,1,0,0,2
24236746,24237422,676,0,0,1,1
24236746,24237424,678,0,0,1,2
24237423,24237456,33,1,0,0,1
24237425,24237453,28,1,0,0,2
24237454,24237877,423,0,0,1,2
24237457,24237879,422,0,0,1,1
24237878,24237961,83,1,0,0,2
24237880,24237959,79,1,0,0,1
24237960,24238164,204,0,0,1,1
24237962,24238163,201,0,0,1,2
24238164,24238222,58,1,0,0,2
24238165,24238221,56,1,0,0,1
24238222,24238476,254,0,0,1,1
24238223,24238477,254,0,0,1,2
24238477,24238523,46,1,0,0,1
24238478,24238531,53,1,0,0,2
24238524,24238771,247,0,0,1,1
24238532,24238772,240,0,0,1,2
24238772,24238797,25,1,0,0,1
24238773,24238795,22,1,0,0,2
24238796,24238928,132,0,0,1,2
24238798,24238926,128,0,0,1,1
24238927,24238987,60,1,0,0,1
24238929,24238996,67,1,0,0,2
24238988,24239103,115,0,0,1,1
24238997,24239105,108,0,0,1,2
24239104,24239148,44,1,0,0,1
24239106,24239140,34,1,0,0,2
24239141,24239313,172,0,0,1,2
24239149,24239313,164,0,0,1,1
24239314,24239342,28,1,0,0,2
24239314,24239364,50,1,0,0,1
24239343,24240356,1013,0,0,1,2
24239365,24240357,992,0,0,1,1
24240357,24240436,79,1,0,0,2
24240358,24240409,51,1,0,0,1
24240410,24240547,137,0,0,1,1
24240437,24240548,111,0,0,1,2
24240548,24240589,41,1,0,0,1
24240549,24240580,31,1,0,0,2
24240581,24241053,472,0,0,1,2
24240590,24241740,1150,0,0,1,1
24241054,24241081,27,1,0,0,2
24241082,24241742,660,0,0,1,2
24241741,24241765,24,1,0,0,1
24241743,24241767,24,1,0,0,2
24241766,24242444,678,0,0,1,1
24241768,24242449,681,0,0,1,2
24242445,24242788,343,1,0,0,1
24242450,24242783,333,1,0,0,2
24242484,24242690,206,0,1,0,2
24242488,24242677,189,0,1,0,1
24242784,24242834,50,0,0,1,2
24242789,24242836,47,0,0,1,1
24242835,24242908,73,1,0,0,2
24242837,24242901,64,1,0,0,1
24242902,24243014,112,0,0,1,1
24242909,24243012,103,0,0,1,2
24243013,24243297,284,1,0,0,2
24243015,24243251,236,1,0,0,1
24243038,24243202,164,0,1,0,2
24243042,24243182,140,0,1,0,1
24243252,24243834,582,0,0,1,1
24243298,24243384,86,0,0,1,2
24243385,24243402,17,1,0,0,2
24243403,24243618,215,0,0,1,2
24243619,24243623,4,1,0,0,2
24243624,24243748,124,0,0,1,2
24243749,24243781,32,1,0,0,2
24243782,24243833,51,0,0,1,2
24243834,24244007,173,1,0,0,2
24243835,24243866,31,1,0,0,1
24243867,24243929,62,0,0,1,1
24243930,24244057,127,1,0,0,1
24244008,24244084,76,0,0,1,2
24244058,24244084,26,0,0,1,1
24244085,24244120,35,1,0,0,2
24244085,24244133,48,1,0,0,1
24244121,24244324,203,0,0,1,2
24244134,24244435,301,0,0,1,1
24244325,24244340,15,1,0,0,2
24244341,24244376,35,0,0,1,2
24244377,24244401,24,1,0,0,2
24244402,24244435,33,0,0,1,2
24244436,24244463,27,1,0,0,1
24244436,24244471,35,1,0,0,2
24244464,24245932,1468,0,0,1,1
24244472,24244714,242,0,0,1,2
24244715,24244744,29,1,0,0,2
24244745,24244839,94,0,0,1,2
24244840,24244890,50,1,0,0,2
24244891,24244982,91,0,0,1,2
24244983,24245020,37,1,0,0,2
24245021,24245052,31,0,0,1,2
24245053,24245081,28,1,0,0,2
24245082,24245482,400,0,0,1,2
24245483,24245991,508,1,0,0,2
24245933,24246090,157,1,0,0,1
24245992,24246130,138,0,0,1,2
24246091,24246133,42,0,0,1,1
24246131,24246178,47,1,0,0,2
24246134,24246264,130,1,0,0,1
24246179,24246680,501,0,0,1,2
24246265,24246311,46,0,0,1,1
24246312,24246575,263,1,0,0,1
24246576,24246684,108,0,0,1,1
24246681,24246714,33,1,0,0,2
24246685,24246723,38,1,0,0,1
24246715,24247237,522,0,0,1,2
24246724,24247236,512,0,0,1,1
24247237,24247288,51,1,0,0,1
24247238,24247285,47,1,0,0,2
24247286,24247814,528,0,0,1,2
24247289,24247716,427,0,0,1,1
24247717,24248037,320,1,0,0,1
24247815,24247853,38,1,0,0,2
24247854,24248089,235,0,0,1,2
24248038,24248086,48,0,0,1,1
24248087,24248163,76,1,0,0,1
24248090,24248411,321,1,0,0,2
24248164,24248340,176,0,0,1,1
24248341,24248410,69,1,0,0,1
24248411,24248666,255,0,0,1,1
24248412,24248666,254,0,0,1,2
24248667,24248700,33,1,0,0,1
24248667,24248700,33,1,0,0,2
24248701,24249204,503,0,0,1,1
24248701,24249206,505,0,0,1,2
24249205,24249481,276,1,0,0,1
24249207,24249491,284,1,0,0,2
24249236,24249375,139,0,1,0,1
24249236,24249388,152,0,1,0,2
24249482,24249745,263,0,0,1,1
24249492,24249746,254,0,0,1,2
24249746,24249808,62,1,0,0,1
24249747,24249813,66,1,0,0,2
24249809,24249910,101,0,0,1,1
24249814,24249911,97,0,0,1,2
24249911,24249950,39,1,0,0,1
24249912,24249943,31,1,0,0,2
24249944,24250089,145,0,0,1,2
24249951,24250094,143,0,0,1,1
24250090,24250109,19,1,0,0,2
24250095,24250110,15,1,0,0,1
24250110,24251454,1344,0,0,1,2
24250111,24251455,1344,0,0,1,1
24251455,24251512,57,1,0,0,2
24251456,24251511,55,1,0,0,1
24251512,24251611,99,0,0,1,1
24251513,24251612,99,0,0,1,2
24251612,24251646,34,1,0,0,1
24251613,24251649,36,1,0,0,2
24251647,24253502,1855,0,0,1,1
24251650,24253501,1851,0,0,1,2
24253502,24253843,341,1,0,0,2
24253503,24253830,327,1,0,0,1
24253539,24253727,188,0,1,0,1
24253541,24253734,193,0,1,0,2
24253831,24253939,108,0,0,1,1
24253844,24253925,81,0,0,1,2
24253926,24254269,343,1,0,0,2
24253940,24254268,328,1,0,0,1
24253987,24254177,190,0,1,0,2
24253988,24254168,180,0,1,0,1
24254269,24254598,329,0,0,1,1
24254270,24254600,330,0,0,1,2
24254599,24254639,40,1,0,0,1
24254601,24254643,42,1,0,0,2
24254640,24254898,258,0,0,1,1
24254644,24254897,253,0,0,1,2
24254898,24254925,27,1,0,0,2
24254899,24254926,27,1,0,0,1
24254926,24254990,64,0,0,1,2
24254927,24254991,64,0,0,1,1
24254991,24255073,82,1,0,0,2
24254992,24255062,70,1,0,0,1
24255063,24255178,115,0,0,1,1
24255074,24255181,107,0,0,1,2
24255179,24255212,33,1,0,0,1
24255182,24255215,33,1,0,0,2
24255213,24255886,673,0,0,1,1
24255216,24255467,251,0,0,1,2
24255468,24255487,19,1,0,0,2
24255488,24255598,110,0,0,1,2
24255599,24255680,81,1,0,0,2
24255681,24255714,33,0,0,1,2
24255715,24256173,458,1,0,0,2
24255887,24255929,42,1,0,0,1
24255930,24256777,847,0,0,1,1
24256174,24256288,114,0,0,1,2
24256289,24256428,139,1,0,0,2
24256429,24256488,59,0,0,1,2
24256489,24256566,77,1,0,0,2
24256567,24256637,70,0,0,1,2
24256638,24256683,45,1,0,0,2
24256684,24256733,49,0,0,1,2
24256734,24256980,246,1,0,0,2
24256778,24256833,55,1,0,0,1
24256834,24256938,104,0,0,1,1
24256939,24256976,37,1,0,0,1
24256977,24257720,743,0,0,1,1
24256981,24257720,739,0,0,1,2
24257721,24257752,31,1,0,0,2
24257721,24257755,34,1,0,0,1
24257753,24258919,1166,0,0,1,2
24257756,24258922,1166,0,0,1,1
24258920,24258951,31,1,0,0,2
24258923,24258939,16,1,0,0,1
24258940,24259072,132,0,0,1,1
24258952,24259069,117,0,0,1,2
24259070,24259427,357,1,0,0,2
24259073,24259386,313,1,0,0,1
24259102,24259310,208,0,1,0,2
24259108,24259296,188,0,1,0,1
24259387,24259809,422,0,0,1,1
24259428,24259808,380,0,0,1,2
24259809,24259852,43,1,0,0,2
24259810,24259846,36,1,0,0,1
24259847,24260148,301,0,0,1,1
24259853,24260150,297,0,0,1,2
24260149,24260188,39,1,0,0,1
24260151,24260172,21,1,0,0,2
24260173,24260623,450,0,0,1,2
24260189,24260624,435,0,0,1,1
24260624,24260653,29,1,0,0,2
24260625,24260653,28,1,0,0,1
24260654,24260858,204,0,0,1,1
24260654,24260858,204,0,0,1,2
24260859,24260923,64,1,0,0,1
24260859,24260924,65,1,0,0,2
24260924,24261045,121,0,0,1,1
24260925,24261043,118,0,0,1,2
24261044,24261079,35,1,0,0,2
24261046,24261067,21,1,0,0,1
24261068,24262177,1109,0,0,1,1
24261080,24262177,1097,0,0,1,2
24262178,24262248,70,1,0,0,1
24262178,24262249,71,1,0,0,2
24262249,24262312,63,0,0,1,1
24262250,24262312,62,0,0,1,2
24262313,24262344,31,1,0,0,1
24262313,24262345,32,1,0,0,2
24262345,24262499,154,0,0,1,1
24262346,24263334,988,0,0,1,2
24262500,24262510,10,1,0,0,1
24262511,24263333,822,0,0,1,1
24263334,24263360,26,1,0,0,1
24263335,24263360,25,1,0,0,2
24263361,24263796,435,0,0,1,1
24263361,24263800,439,0,0,1,2
24263797,24263821,24,1,0,0,1
24263801,24263824,23,1,0,0,2
24263822,24264093,271,0,0,1,1
24263825,24264094,269,0,0,1,2
24264094,24264123,29,1,0,0,1
24264095,24264122,27,1,0,0,2
24264123,24264290,167,0,0,1,2
24264124,24264284,160,0,0,1,1
24264285,24264624,339,1,0,0,1
24264291,24264645,354,1,0,0,2
24264322,24264516,194,0,1,0,2
24264325,24264492,167,0,1,0,1
24264625,24264915,290,0,0,1,1
24264646,24264913,267,0,0,1,2
24264914,24265096,182,1,0,0,2
24264916,24264959,43,1,0,0,1
24264960,24265265,305,0,0,1,1
24265097,24265177,80,0,0,1,2
24265178,24265212,34,1,0,0,2
24265213,24265263,50,0,0,1,2
24265264,24265318,54,1,0,0,2
24265266,24265303,37,1,0,0,1
24265304,24265496,192,0,0,1,1
24265319,24265496,177,0,0,1,2
24265497,24265564,67,1,0,0,1
24265497,24265564,67,1,0,0,2
24265565,24265712,147,0,0,1,1
24265565,24265713,148,0,0,1,2
24265713,24265741,28,1,0,0,1
24265714,24265743,29,1,0,0,2
24265742,24267227,1485,0,0,1,1
24265744,24267225,1481,0,0,1,2
24267226,24267336,110,1,0,0,2
24267228,24267291,63,1,0,0,1
24267292,24267398,106,0,0,1,1
24267337,24267392,55,0,0,1,2
24267393,24267450,57,1,0,0,2
24267399,24267428,29,1,0,0,1
24267429,24267515,86,0,0,1,1
24267451,24267511,60,0,0,1,2
24267512,24267672,160,1,0,0,2
24267516,24267551,35,1,0,0,1
24267552,24268098,546,0,0,1,1
24267673,24267756,83,0,0,1,2
24267757,24267845,88,1,0,0,2
24267846,24267888,42,0,0,1,2
24267889,24267893,4,1,0,0,2
24267894,24268069,175,0,0,1,2
24268070,24268141,71,1,0,0,2
24268099,24268118,19,1,0,0,1
24268119,24269330,1211,0,0,1,1
24268142,24268173,31,0,0,1,2
24268174,24268305,131,1,0,0,2
24268306,24268555,249,0,0,1,2
24268556,24268594,38,1,0,0,2
24268595,24268618,23,0,0,1,2
24268619,24268749,130,1,0,0,2
24268750,24268813,63,0,0,1,2
24268814,24269143,329,1,0,0,2
24269144,24269174,30,0,0,1,2
24269175,24269641,466,1,0,0,2
24269331,24269590,259,1,0,0,1
24269416,24269525,109,0,1,0,2
24269423,24269495,72,0,1,0,1
24269591,24269767,176,0,0,1,1
24269642,24269767,125,0,0,1,2
24269768,24269834,66,1,0,0,1
24269768,24269856,88,1,0,0,2
24269835,24270098,263,0,0,1,1
24269857,24269967,110,0,0,1,2
24269968,24270046,78,1,0,0,2
24270047,24270083,36,0,0,1,2
24270084,24270506,422,1,0,0,2
24270099,24270127,28,1,0,0,1
24270128,24270385,257,0,0,1,1
24270386,24270434,48,1,0,0,1
24270435,24270663,228,0,0,1,1
24270507,24270541,34,0,0,1,2
24270542,24270562,20,1,0,0,2
24270563,24270629,66,0,0,1,2
24270630,24270723,93,1,0,0,2
24270664,24270715,51,1,0,0,1
24270716,24270935,219,0,0,1,1
24270724,24270936,212,0,0,1,2
24270936,24271016,80,1,0,0,1
24270937,24271017,80,1,0,0,2
24271017,24271099,82,0,0,1,1
24271018,24271099,81,0,0,1,2
24271100,24271135,35,1,0,0,1
24271100,24271135,35,1,0,0,2
24271136,24271484,348,0,0,1,1
24271136,24271484,348,0,0,1,2
24271485,24271517,32,1,0,0,2
24271485,24271520,35,1,0,0,1
24271518,24272173,655,0,0,1,2
24271521,24272173,652,0,0,1,1
24272174,24272217,43,1,0,0,1
24272174,24272220,46,1,0,0,2
24272218,24272463,245,0,0,1,1
24272221,24272465,244,0,0,1,2
24272464,24272485,21,1,0,0,1
24272466,24272502,36,1,0,0,2
24272486,24273244,758,0,0,1,1
24272503,24273552,1049,0,0,1,2
24273245,24273261,16,1,0,0,1
24273262,24274109,847,0,0,1,1
24273553,24273570,17,1,0,0,2
24273571,24274111,540,0,0,1,2
24274110,24274134,24,1,0,0,1
24274112,24274137,25,1,0,0,2
24274135,24274270,135,0,0,1,1
24274138,24274275,137,0,0,1,2
24274271,24274563,292,1,0,0,1
24274276,24274864,588,1,0,0,2
24274307,24274461,154,0,1,0,2
24274316,24274442,126,0,1,0,1
24274564,24274790,226,0,0,1,1
24274791,24274844,53,1,0,0,1
24274845,24275169,324,0,0,1,1
24274865,24275168,303,0,0,1,2
24275169,24275298,129,1,0,0,2
24275170,24275231,61,1,0,0,1
24275232,24275475,243,0,0,1,1
24275299,24275476,177,0,0,1,2
24275476,24275533,57,1,0,0,1
24275477,24275748,271,1,0,0,2
24275534,24276650,1116,0,0,1,1
24275749,24276174,425,0,0,1,2
24276175,24276238,63,1,0,0,2
24276239,24276657,418,0,0,1,2
24276651,24276678,27,1,0,0,1
24276658,24276778,120,1,0,0,2
24276679,24276844,165,0,0,1,1
24276779,24276835,56,0,0,1,2
24276836,24276884,48,1,0,0,2
24276845,24276861,16,1,0,0,1
24276862,24277221,359,0,0,1,1
24276885,24276923,38,0,0,1,2
24276924,24277191,267,1,0,0,2
24277192,24277219,27,0,0,1,2
24277220,24277788,568,1,0,0,2
24277222,24277282,60,1,0,0,1
24277283,24277752,469,0,0,1,1
24277753,24277788,35,1,0,0,1
24277789,24278211,422,0,0,1,2
24277789,24279174,1385,0,0,1,1
24278212,24278224,12,1,0,0,2
24278225,24278467,242,0,0,1,2
24278468,24278473,5,1,0,0,2
24278474,24278518,44,0,0,1,2
24278519,24278934,415,1,0,0,2
24278935,24278955,20,0,0,1,2
24278956,24279081,125,1,0,0,2
24279082,24279106,24,0,0,1,2
24279107,24279805,698,1,0,0,2
24279175,24279204,29,1,0,0,1
24279205,24279342,137,0,0,1,1
24279343,24279748,405,1,0,0,1
24279361,24279632,271,0,1,0,2
24279366,24279616,250,0,1,0,1
24279749,24280020,271,0,0,1,1
24279806,24279847,41,0,0,1,2
24279848,24279968,120,1,0,0,2
24279969,24280017,48,0,0,1,2
24280018,24280351,333,1,0,0,2
24280021,24280057,36,1,0,0,1
24280058,24280289,231,0,0,1,1
24280290,24280330,40,1,0,0,1
24280331,24280560,229,0,0,1,1
24280352,24280561,209,0,0,1,2
24280561,24280579,18,1,0,0,1
24280562,24280599,37,1,0,0,2
24280580,24280952,372,0,0,1,1
24280600,24280952,352,0,0,1,2
24280953,24281021,68,1,0,0,1
24280953,24281169,216,1,0,0,2
24281022,24281260,238,0,0,1,1
24281170,24281219,49,0,0,1,2
24281220,24281635,415,1,0,0,2
24281261,24281290,29,1,0,0,1
24281291,24282211,920,0,0,1,1
24281636,24281659,23,0,0,1,2
24281660,24281892,232,1,0,0,2
24281893,24281918,25,0,0,1,2
24281919,24282454,535,1,0,0,2
24282212,24282263,51,1,0,0,1
24282264,24282622,358,0,0,1,1
24282455,24282549,94,0,0,1,2
24282550,24282691,141,1,0,0,2
24282623,24282662,39,1,0,0,1
24282663,24284281,1618,0,0,1,1
24282692,24283366,674,0,0,1,2
24283367,24283389,22,1,0,0,2
24283390,24283415,25,0,0,1,2
24283416,24283431,15,1,0,0,2
24283432,24283497,65,0,0,1,2
24283498,24283568,70,1,0,0,2
24283569,24283613,44,0,0,1,2
24283614,24283977,363,1,0,0,2
24283978,24284005,27,0,0,1,2
24284006,24284038,32,1,0,0,2
24284039,24284123,84,0,0,1,2
24284124,24284739,615,1,0,0,2
24284282,24284683,401,1,0,0,1
24284297,24284632,335,0,1,0,2
24284307,24284575,268,0,1,0,1
24284684,24285533,849,0,0,1,1
24284740,24284783,43,0,0,1,2
24284784,24284912,128,1,0,0,2
24284913,24284942,29,0,0,1,2
24284943,24285018,75,1,0,0,2
24285019,24285198,179,0,0,1,2
24285199,24285300,101,1,0,0,2
24285301,24285495,194,0,0,1,2
24285496,24285611,115,1,0,0,2
24285534,24285603,69,1,0,0,1
24285604,24285716,112,0,0,1,1
24285612,24285715,103,0,0,1,2
24285716,24285752,36,1,0,0,2
24285717,24285751,34,1,0,0,1
24285752,24285901,149,0,0,1,1
24285753,24285906,153,0,0,1,2
24285902,24285923,21,1,0,0,1
24285907,24285923,16,1,0,0,2
24285924,24287151,1227,0,0,1,1
24285924,24287152,1228,0,0,1,2
24287152,24287199,47,1,0,0,1
24287153,24287198,45,1,0,0,2
24287199,24287453,254,0,0,1,2
24287200,24287453,253,0,0,1,1
24287454,24287485,31,1,0,0,1
24287454,24287485,31,1,0,0,2
24287486,24288613,1127,0,0,1,1
24287486,24288620,1134,0,0,1,2
24288614,24288642,28,1,0,0,1
24288621,24288645,24,1,0,0,2
24288643,24289206,563,0,0,1,1
24288646,24289207,561,0,0,1,2
24289207,24289428,221,1,0,0,1
24289208,24289435,227,1,0,0,2
24289253,24289351,98,0,1,0,2
24289258,24289337,79,0,1,0,1
24289429,24289921,492,0,0,1,1
24289436,24289922,486,0,0,1,2
24289922,24289947,25,1,0,0,1
24289923,24289958,35,1,0,0,2
24289948,24290307,359,0,0,1,1
24289959,24290307,348,0,0,1,2
24290308,24290327,19,1,0,0,1
24290308,24290334,26,1,0,0,2
24290328,24290682,354,0,0,1,1
24290335,24290683,348,0,0,1,2
24290683,24290766,83,1,0,0,1
24290684,24290765,81,1,0,0,2
24290766,24290857,91,0,0,1,2
24290767,24290857,90,0,0,1,1
24290858,24290904,46,1,0,0,1
24290858,24290904,46,1,0,0,2
24290905,24291213,308,0,0,1,1
24290905,24291214,309,0,0,1,2
24291214,24291250,36,1,0,0,1
24291215,24291248,33,1,0,0,2
24291249,24291652,403,0,0,1,2
24291251,24292353,1102,0,0,1,1
24291653,24291689,36,1,0,0,2
24291690,24291723,33,0,0,1,2
24291724,24291784,60,1,0,0,2
24291785,24291947,162,0,0,1,2
24291948,24291970,22,1,0,0,2
24291971,24292038,67,0,0,1,2
24292039,24292099,60,1,0,0,2
24292100,24292147,47,0,0,1,2
24292148,24292256,108,1,0,0,2
24292257,24292300,43,0,0,1,2
24292301,24292425,124,1,0,0,2
24292354,24292399,45,1,0,0,1
24292400,24292572,172,0,0,1,1
24292426,24292571,145,0,0,1,2
24292572,24292604,32,1,0,0,2
24292573,24292595,22,1,0,0,1
24292596,24293493,897,0,0,1,1
24292605,24293494,889,0,0,1,2
24293494,24293528,34,1,0,0,1
24293495,24293523,28,1,0,0,2
24293524,24294401,877,0,0,1,2
24293529,24294420,891,0,0,1,1
24294402,24295063,661,1,0,0,2
24294421,24294876,455,1,0,0,1
24294458,24294842,384,0,1,0,2
24294466,24294835,369,0,1,0,1
24294877,24295729,852,0,0,1,1
24295064,24295291,227,0,0,1,2
24295292,24295308,16,1,0,0,2
24295309,24295726,417,0,0,1,2
24295727,24295914,187,1,0,0,2
24295730,24295916,186,1,0,0,1
24295915,24296022,107,0,0,1,2
24295917,24296021,104,0,0,1,1
24296022,24296054,32,1,0,0,1
24296023,24296062,39,1,0,0,2
24296055,24296308,253,0,0,1,1
24296063,24296308,245,0,0,1,2
24296309,24296342,33,1,0,0,2
24296309,24296343,34,1,0,0,1
24296343,24297853,1510,0,0,1,2
24296344,24297853,1509,0,0,1,1
24297854,24297919,65,1,0,0,1
24297854,24297920,66,1,0,0,2
24297920,24298126,206,0,0,1,1
24297921,24298123,202,0,0,1,2
24298124,24298156,32,1,0,0,2
24298127,24298155,28,1,0,0,1
24298156,24298581,425,0,0,1,1
24298157,24298582,425,0,0,1,2
24298582,24298611,29,1,0,0,1
24298583,24298611,28,1,0,0,2
24298612,24300029,1417,0,0,1,1
24298612,24300032,1420,0,0,1,2
24300030,24300392,362,1,0,0,1
24300033,24300394,361,1,0,0,2
24300075,24300304,229,0,1,0,2
24300081,24300290,209,0,1,0,1
24300393,24300534,141,0,0,1,1
24300395,24300531,136,0,0,1,2
24300532,24300820,288,1,0,0,2
24300535,24300606,71,1,0,0,1
24300607,24300773,166,0,0,1,1
24300774,24300816,42,1,0,0,1
24300817,24301000,183,0,0,1,1
24300821,24300888,67,0,0,1,2
24300889,24301215,326,1,0,0,2
24301001,24301042,41,1,0,0,1
24301043,24301560,517,0,0,1,1
24301216,24301297,81,0,0,1,2
24301298,24301437,139,1,0,0,2
24301438,24301559,121,0,0,1,2
24301560,24301611,51,1,0,0,2
24301561,24301625,64,1,0,0,1
24301612,24301898,286,0,0,1,2
24301626,24301898,272,0,0,1,1
24301899,24301952,53,1,0,0,2
24301899,24301957,58,1,0,0,1
24301953,24302080,127,0,0,1,2
24301958,24302079,121,0,0,1,1
24302080,24302108,28,1,0,0,1
24302081,24302100,19,1,0,0,2
24302101,24302372,271,0,0,1,2
24302109,24302373,264,0,0,1,1
24302373,24302402,29,1,0,0,2
24302374,24302402,28,1,0,0,1
24302403,24304018,1615,0,0,1,2
24302403,24304019,1616,0,0,1,1
24304019,24304108,89,1,0,0,2
24304020,24304080,60,1,0,0,1
24304081,24304230,149,0,0,1,1
24304109,24304231,122,0,0,1,2
24304231,24304265,34,1,0,0,1
24304232,24304261,29,1,0,0,2
24304262,24304510,248,0,0,1,2
24304266,24305216,950,0,0,1,1
24304511,24304579,68,1,0,0,2
24304580,24305217,637,0,0,1,2
24305217,24305283,66,1,0,0,1
24305218,24305295,77,1,0,0,2
24305284,24305866,582,0,0,1,1
24305296,24305319,23,0,0,1,2
24305320,24305481,161,1,0,0,2
24305482,24305566,84,0,0,1,2
24305567,24305623,56,1,0,0,2
24305624,24305865,241,0,0,1,2
24305866,24305895,29,1,0,0,2
24305867,24305884,17,1,0,0,1
24305885,24306130,245,0,0,1,1
24305896,24305934,38,0,0,1,2
24305935,24306018,83,1,0,0,2
24306019,24306060,41,0,0,1,2
24306061,24306089,28,1,0,0,2
24306090,24306116,26,0,0,1,2
24306117,24307029,912,1,0,0,2
24306131,24306658,527,1,0,0,1
24306211,24306617,406,0,1,0,2
24306216,24306622,406,0,1,0,1
24306659,24306724,65,0,0,1,1
24306725,24307027,302,1,0,0,1
24306758,24306974,216,0,1,0,2
24306760,24306956,196,0,1,0,1
24307028,24307385,357,0,0,1,1
24307030,24307385,355,0,0,1,2
24307386,24307435,49,1,0,0,1
24307386,24307450,64,1,0,0,2
24307436,24307841,405,0,0,1,1
24307451,24307510,59,0,0,1,2
24307511,24307771,260,1,0,0,2
24307772,24307842,70,0,0,1,2
24307842,24307869,27,1,0,0,1
24307843,24308026,183,1,0,0,2
24307870,24307960,90,0,0,1,1
24307961,24308028,67,1,0,0,1
24308027,24308165,138,0,0,1,2
24308029,24308165,136,0,0,1,1
24308166,24308197,31,1,0,0,2
24308166,24308207,41,1,0,0,1
24308198,24308410,212,0,0,1,2
24308208,24308411,203,0,0,1,1
24308411,24308439,28,1,0,0,2
24308412,24308443,31,1,0,0,1
24308440,24309027,587,0,0,1,2
24308444,24309025,581,0,0,1,1
24309026,24309054,28,1,0,0,1
24309028,24309052,24,1,0,0,2
24309053,24309295,242,0,0,1,2
24309055,24309295,240,0,0,1,1
24309296,24309352,56,1,0,0,1
24309296,24309360,64,1,0,0,2
24309353,24309499,146,0,0,1,1
24309361,24309499,138,0,0,1,2
24309500,24309533,33,1,0,0,2
24309500,24309535,35,1,0,0,1
24309534,24310647,1113,0,0,1,2
24309536,24310638,1102,0,0,1,1
24310639,24310666,27,1,0,0,1
24310648,24310664,16,1,0,0,2
24310665,24311032,367,0,0,1,2
24310667,24311026,359,0,0,1,1
24311027,24311049,22,1,0,0,1
24311033,24311050,17,1,0,0,2
24311050,24311410,360,0,0,1,1
24311051,24311407,356,0,0,1,2
24311408,24311717,309,1,0,0,2
24311411,24311662,251,1,0,0,1
24311442,24311597,155,0,1,0,2
24311443,24311552,109,0,1,0,1
24311663,24311990,327,0,0,1,1
24311718,24311989,271,0,0,1,2
24311990,24312046,56,1,0,0,2
24311991,24312045,54,1,0,0,1
24312046,24312308,262,0,0,1,1
24312047,24312308,261,0,0,1,2
24312309,24312354,45,1,0,0,1
24312309,24312361,52,1,0,0,2
24312355,24312718,363,0,0,1,1
24312362,24312717,355,0,0,1,2
24312718,24312768,50,1,0,0,2
24312719,24312768,49,1,0,0,1
24312769,24312979,210,0,0,1,1
24312769,24312981,212,0,0,1,2
24312980,24313008,28,1,0,0,1
24312982,24313025,43,1,0,0,2
24313009,24313141,132,0,0,1,1
24313026,24313149,123,0,0,1,2
24313142,24314507,1365,1,0,0,1
24313150,24314513,1363,1,0,0,2
24313182,24314380,1198,0,1,0,2
24313184,24314418,1234,0,1,0,1
24314508,24314581,73,0,0,1,1
24314514,24314582,68,0,0,1,2
24314582,24314872,290,1,0,0,1
24314583,24314915,332,1,0,0,2
24314606,24314807,201,0,1,0,1
24314606,24314830,224,0,1,0,2
24314873,24314948,75,0,0,1,1
24314916,24314952,36,0,0,1,2
24314949,24316803,1854,1,0,0,1
24314953,24317559,2606,1,0,0,2
24314969,24316746,1777,0,1,0,1
24314969,24316746,1777,0,1,0,2
24316804,24316913,109,0,0,1,1
24316914,24316948,34,1,0,0,1
24316949,24317075,126,0,0,1,1
24317076,24317316,240,1,0,0,1
24317093,24317288,195,0,1,0,2
24317093,24317291,198,0,1,0,1
24317317,24317366,49,0,0,1,1
24317367,24317399,32,1,0,0,1
24317400,24317616,216,0,0,1,1
24317560,24317611,51,0,0,1,2
24317612,24318363,751,1,0,0,2
24317617,24317639,22,1,0,0,1
24317640,24317730,90,0,0,1,1
24317731,24318335,604,1,0,0,1
24317794,24318308,514,0,1,0,2
24317805,24318299,494,0,1,0,1
24318336,24318385,49,0,0,1,1
24318364,24318386,22,0,0,1,2
24318386,24318425,39,1,0,0,1
24318387,24318424,37,1,0,0,2
24318425,24318588,163,0,0,1,2
24318426,24318586,160,0,0,1,1
24318587,24318630,43,1,0,0,1
24318589,24318632,43,1,0,0,2
24318631,24318735,104,0,0,1,1
24318633,24318735,102,0,0,1,2
24318736,24318784,48,1,0,0,1
24318736,24318786,50,1,0,0,2
24318785,24318892,107,0,0,1,1
24318787,24318892,105,0,0,1,2
24408460,24408697,237,0,0,1,2
24408460,24408699,239,0,0,1,1
24408698,24408771,73,1,0,0,2
24408700,24408770,70,1,0,0,1
24408771,24408851,80,0,0,1,1
24408772,24408852,80,0,0,1,2
24408852,24408883,31,1,0,0,1
24408853,24408885,32,1,0,0,2
24408884,24409242,358,0,0,1,1
24408886,24409243,357,0,0,1,2
24409243,24409289,46,1,0,0,1
24409244,24409263,19,1,0,0,2
24409264,24409900,636,0,0,1,2
24409290,24409899,609,0,0,1,1
24409900,24409946,46,1,0,0,1
24409901,24409933,32,1,0,0,2
24409934,24410097,163,0,0,1,2
24409947,24410096,149,0,0,1,1
24410097,24410128,31,1,0,0,1
24410098,24410128,30,1,0,0,2
24410129,24410402,273,0,0,1,2
24410129,24410403,274,0,0,1,1
24410403,24410437,34,1,0,0,2
24410404,24410511,107,1,0,0,1
24410438,24410712,274,0,0,1,2
24410512,24410560,48,0,0,1,1
24410561,24410569,8,1,0,0,1
24410570,24410713,143,0,0,1,1
24410713,24410748,35,1,0,0,2
24410714,24410767,53,1,0,0,1
24410749,24410867,118,0,0,1,2
24410768,24410871,103,0,0,1,1
24410868,24411507,639,1,0,0,2
24410872,24411534,662,1,0,0,1
24410910,24411198,288,0,1,0,2
24410920,24411182,262,0,1,0,1
24411307,24411429,122,0,1,0,2
24411307,24411457,150,0,1,0,1
24411508,24411715,207,0,0,1,2
24411517,24411523,6,0,1,0,1
24411535,24411799,264,0,0,1,1
24411716,24411751,35,1,0,0,2
24411752,24411798,46,0,0,1,2
24411799,24411839,40,1,0,0,2
24411800,24411856,56,1,0,0,1
24411840,24411951,111,0,0,1,2
24411857,24411960,103,0,0,1,1
24411952,24411959,7,1,0,0,2
24411960,24412067,107,0,0,1,2
24411961,24411990,29,1,0,0,1
24411991,24412052,61,0,0,1,1
24412053,24412059,6,1,0,0,1
24412060,24412134,74,0,0,1,1
24412068,24412134,66,1,0,0,2
24412135,24412139,4,1,0,0,1
24412135,24412172,37,0,0,1,2
24412140,24412167,27,0,0,1,1
24412168,24412770,602,1,0,0,1
24412173,24412787,614,1,0,0,2
24412194,24412537,343,0,1,0,2
24412199,24412493,294,0,1,0,1
24412562,24412568,6,0,1,0,2
24412590,24412712,122,0,1,0,1
24412590,24412721,131,0,1,0,2
24412771,24413078,307,0,0,1,1
24412788,24413077,289,0,0,1,2
24413078,24413125,47,1,0,0,2
24413079,24413120,41,1,0,0,1
24413121,24413307,186,0,0,1,1
24413126,24413306,180,0,0,1,2
24413307,24413339,32,1,0,0,2
24413308,24413363,55,1,0,0,1
24413340,24413532,192,0,0,1,2
24413364,24413530,166,0,0,1,1
24413531,24413645,114,1,0,0,1
24413533,24413661,128,1,0,0,2
24413557,24413621,64,0,1,0,2
24413563,24413609,46,0,1,0,1
24413646,24413787,141,0,0,1,1
24413662,24413792,130,0,0,1,2
24413788,24413984,196,1,0,0,1
24413793,24413968,175,1,0,0,2
24413815,24413927,112,0,1,0,2
24413822,24413921,99,0,1,0,1
24413969,24414128,159,0,0,1,2
24413985,24414129,144,0,0,1,1
24414129,24414167,38,1,0,0,2
24414130,24414175,45,1,0,0,1
24414168,24414386,218,0,0,1,2
24414176,24414385,209,0,0,1,1
24414386,24414440,54,1,0,0,1
24414387,24414415,28,1,0,0,2
24414416,24415095,679,0,0,1,2
24414441,24415095,654,0,0,1,1
24415096,24415134,38,1,0,0,2
24415096,24415135,39,1,0,0,1
24415135,24415284,149,0,0,1,2
24415136,24415286,150,0,0,1,1
24415285,24415308,23,1,0,0,2
24415287,24415310,23,1,0,0,1
24415309,24415733,424,0,0,1,2
24415311,24415735,424,0,0,1,1
24415734,24415764,30,1,0,0,2
24415736,24415763,27,1,0,0,1
24415764,24415984,220,0,0,1,1
24415765,24415983,218,0,0,1,2
24415984,24416277,293,1,0,0,2
24415985,24416380,395,1,0,0,1
24416008,24416203,195,0,1,0,2
24416012,24416190,178,0,1,0,1
24416278,24416348,70,0,0,1,2
24416349,24416379,30,1,0,0,2
24416380,24416630,250,0,0,1,2
24416381,24416618,237,0,0,1,1
24416619,24416645,26,1,0,0,1
24416631,24416646,15,1,0,0,2
24416646,24417224,578,0,0,1,1
24416647,24417224,577,0,0,1,2
24417225,24417261,36,1,0,0,2
24417225,24417264,39,1,0,0,1
24417262,24417469,207,0,0,1,2
24417265,24417472,207,0,0,1,1
24417470,24417487,17,1,0,0,2
24417473,24417509,36,1,0,0,1
24417488,24417731,243,0,0,1,2
24417510,24417738,228,0,0,1,1
24417732,24417750,18,1,0,0,2
24417739,24417758,19,1,0,0,1
24417751,24417977,226,0,0,1,2
24417759,24417988,229,0,0,1,1
24417978,24419342,1364,1,0,0,2
24417989,24419360,1371,1,0,0,1
24418024,24419331,1307,0,1,0,2
24418030,24419299,1269,0,1,0,1
24419343,24419370,27,0,0,1,2
24419361,24419415,54,0,0,1,1
24419371,24419380,9,1,0,0,2
24419381,24419407,26,0,0,1,2
24419408,24419506,98,1,0,0,2
24419416,24419495,79,1,0,0,1
24419496,24419696,200,0,0,1,1
24419507,24419692,185,0,0,1,2
24419693,24419727,34,1,0,0,2
24419697,24419733,36,1,0,0,1
24419728,24419900,172,0,0,1,2
24419734,24419896,162,0,0,1,1
24419897,24419925,28,1,0,0,1
24419901,24419950,49,1,0,0,2
24419926,24420431,505,0,0,1,1
24419951,24420431,480,0,0,1,2
24420432,24420453,21,1,0,0,2
24420432,24420474,42,1,0,0,1
24420454,24420679,225,0,0,1,2
24420475,24420676,201,0,0,1,1
24420677,24420706,29,1,0,0,1
24420680,24420705,25,1,0,0,2
24420706,24421200,494,0,0,1,2
24420707,24421199,492,0,0,1,1
24421200,24421230,30,1,0,0,1
24421201,24421228,27,1,0,0,2
24421229,24421675,446,0,0,1,2
24421231,24421655,424,0,0,1,1
24421656,24421715,59,1,0,0,1
24421676,24421714,38,1,0,0,2
24421715,24422049,334,0,0,1,2
24421716,24422039,323,0,0,1,1
24422040,24422286,246,1,0,0,1
24422050,24422334,284,1,0,0,2
24422075,24422205,130,0,1,0,2
24422078,24422185,107,0,1,0,1
24422287,24422414,127,0,0,1,1
24422335,24422414,79,0,0,1,2
24422415,24422447,32,1,0,0,1
24422415,24422448,33,1,0,0,2
24422448,24423741,1293,0,0,1,1
24422449,24423750,1301,0,0,1,2
24423742,24423787,45,1,0,0,1
24423751,24423767,16,1,0,0,2
24423768,24425206,1438,0,0,1,2
24423788,24425207,1419,0,0,1,1
24425207,24425280,73,1,0,0,2
24425208,24425281,73,1,0,0,1
24425281,24425323,42,0,0,1,2
24425282,24425323,41,0,0,1,1
24425324,24425367,43,1,0,0,1
24425324,24425367,43,1,0,0,2
24425368,24425571,203,0,0,1,2
24425368,24425572,204,0,0,1,1
24425572,24425605,33,1,0,0,2
24425573,24425604,31,1,0,0,1
24425605,24427738,2133,0,0,1,1
24425606,24427742,2136,0,0,1,2
24427739,24428237,498,1,0,0,1
24427743,24428367,624,1,0,0,2
24427768,24427901,133,0,1,0,2
24427778,24427877,99,0,1,0,1
24428018,24428156,138,0,1,0,2
24428032,24428137,105,0,1,0,1
24428238,24428303,65,0,0,1,1
24428304,24428350,46,1,0,0,1
24428351,24428471,120,0,0,1,1
24428368,24428470,102,0,0,1,2
24428471,24428503,32,1,0,0,2
24428472,24428500,28,1,0,0,1
24428501,24429224,723,0,0,1,1
24428504,24429222,718,0,0,1,2
24429223,24429258,35,1,0,0,2
24429225,24429258,33,1,0,0,1
24429259,24430270,1011,0,0,1,1
24429259,24430271,1012,0,0,1,2
24430271,24430349,78,1,0,0,1
24430272,24430377,105,1,0,0,2
24430350,24430447,97,0,0,1,1
24430378,24430446,68,0,0,1,2
24430447,24430512,65,1,0,0,2
24430448,24430493,45,1,0,0,1
24430494,24430979,485,0,0,1,1
24430513,24430978,465,0,0,1,2
24430979,24431014,35,1,0,0,2
24430980,24431013,33,1,0,0,1
24431014,24432270,1256,0,0,1,1
24431015,24431310,295,0,0,1,2
24431311,24431324,13,1,0,0,2
24431325,24431488,163,0,0,1,2
24431489,24431502,13,1,0,0,2
24431503,24432136,633,0,0,1,2
24432137,24432197,60,1,0,0,2
24432198,24432245,47,0,0,1,2
24432246,24432364,118,1,0,0,2
24432271,24432354,83,1,0,0,1
24432355,24432727,372,0,0,1,1
24432365,24432728,363,0,0,1,2
24432728,24432794,66,1,0,0,1
24432729,24432793,64,1,0,0,2
24432794,24432896,102,0,0,1,2
24432795,24432897,102,0,0,1,1
24432897,24432923,26,1,0,0,2
24432898,24432928,30,1,0,0,1
24432924,24433872,948,0,0,1,2
24432929,24433878,949,0,0,1,1
24433873,24433894,21,1,0,0,2
24433879,24433898,19,1,0,0,1
24433895,24434962,1067,0,0,1,2
24433899,24434964,1065,0,0,1,1
24434963,24435032,69,1,0,0,2
24434965,24435030,65,1,0,0,1
24435031,24435074,43,0,0,1,1
24435033,24435073,40,0,0,1,2
24435074,24435153,79,1,0,0,2
24435075,24435154,79,1,0,0,1
24435154,24435363,209,0,0,1,2
24435155,24435364,209,0,0,1,1
24435364,24435456,92,1,0,0,2
24435365,24435450,85,1,0,0,1
24435451,24435526,75,0,0,1,1
24435457,24435526,69,0,0,1,2
24435527,24435564,37,1,0,0,1
24435527,24435572,45,1,0,0,2
24435565,24436308,743,0,0,1,1
24435573,24436308,735,0,0,1,2
24436309,24436347,38,1,0,0,1
24436309,24436348,39,1,0,0,2
24436348,24436984,636,0,0,1,1
24436349,24436981,632,0,0,1,2
24436982,24437174,192,1,0,0,2
24436985,24437148,163,1,0,0,1
24437026,24437112,86,0,1,0,2
24437031,24437101,70,0,1,0,1
24437149,24437476,327,0,0,1,1
24437175,24437476,301,0,0,1,2
24437477,24437528,51,1,0,0,1
24437477,24437538,61,1,0,0,2
24437529,24437636,107,0,0,1,1
24437539,24437634,95,0,0,1,2
24437635,24437676,41,1,0,0,2
24437637,24437669,32,1,0,0,1
24437670,24437894,224,0,0,1,1
24437677,24437893,216,0,0,1,2
24437894,24437947,53,1,0,0,2
24437895,24437911,16,1,0,0,1
24437912,24438735,823,0,0,1,1
24437948,24438735,787,0,0,1,2
24438736,24438805,69,1,0,0,2
24438736,24438807,71,1,0,0,1
24438806,24439200,394,0,0,1,2
24438808,24439202,394,0,0,1,1
24439201,24439288,87,1,0,0,2
24439203,24439287,84,1,0,0,1
24439288,24439369,81,0,0,1,1
24439289,24439366,77,0,0,1,2
24439367,24439442,75,1,0,0,2
24439370,24439418,48,1,0,0,1
24439402,24439432,30,0,1,0,2
24439419,24440611,1192,0,0,1,1
24439443,24439516,73,0,0,1,2
24439527,24439534,7,0,1,0,2
24439543,24439543,0,1,0,0,2
24439544,24440614,1070,0,0,1,2
24440612,24440736,124,1,0,0,1
24440615,24440735,120,1,0,0,2
24440736,24440994,258,0,0,1,2
24440737,24440994,257,0,0,1,1
24440995,24441041,46,1,0,0,1
24440995,24441054,59,1,0,0,2
24441042,24441123,81,0,0,1,1
24441055,24441122,67,0,0,1,2
24441123,24441195,72,1,0,0,2
24441124,24441189,65,1,0,0,1
24441190,24441306,116,0,0,1,1
24441196,24441306,110,0,0,1,2
24441307,24441339,32,1,0,0,1
24441307,24441346,39,1,0,0,2
24441340,24442590,1250,0,0,1,1
24441347,24442589,1242,0,0,1,2
24442590,24442677,87,1,0,0,2
24442591,24442680,89,1,0,0,1
24442678,24443083,405,0,0,1,2
24442681,24443084,403,0,0,1,1
24443084,24443178,94,1,0,0,2
24443085,24443171,86,1,0,0,1
24443172,24443252,80,0,0,1,1
24443179,24443253,74,0,0,1,2
24443253,24443299,46,1,0,0,1
24443254,24443301,47,1,0,0,2
24443300,24443372,72,0,0,1,1
24443302,24443370,68,0,0,1,2
24443371,24443412,41,1,0,0,2
24443373,24443407,34,1,0,0,1
24443408,24443708,300,0,0,1,1
24443413,24443703,290,0,0,1,2
24443704,24443734,30,1,0,0,2
24443709,24443724,15,1,0,0,1
24443725,24444577,852,0,0,1,1
24443735,24444575,840,0,0,1,2
24444576,24444811,235,1,0,0,2
24444578,24444775,197,1,0,0,1
24444620,24444735,115,0,1,0,2
24444635,24444713,78,0,1,0,1
24444776,24445099,323,0,0,1,1
24444812,24445098,286,0,0,1,2
24445099,24445198,99,1,0,0,2
24445100,24445197,97,1,0,0,1
24445198,24445253,55,0,0,1,1
24445199,24445255,56,0,0,1,2
24445254,24445303,49,1,0,0,1
24445256,24445303,47,1,0,0,2
24445304,24446925,1621,0,0,1,2
24445304,24446929,1625,0,0,1,1
24446926,24446969,43,1,0,0,2
24446930,24446975,45,1,0,0,1
24446970,24447220,250,0,0,1,2
24446976,24447222,246,0,0,1,1
24447221,24447291,70,1,0,0,2
24447223,24447291,68,1,0,0,1
24447292,24447418,126,0,0,1,1
24447292,24447418,126,0,0,1,2
24447419,24447444,25,1,0,0,1
24447419,24447444,25,1,0,0,2
24447445,24447699,254,0,0,1,2
24447445,24447702,257,0,0,1,1
24447700,24447934,234,1,0,0,2
24447703,24447922,219,1,0,0,1
24447739,24447851,112,0,1,0,2
24447742,24447822,80,0,1,0,1
24447923,24448163,240,0,0,1,1
24447935,24448150,215,0,0,1,2
24448151,24448379,228,1,0,0,2
24448164,24448360,196,1,0,0,1
24448189,24448325,136,0,1,0,2
24448196,24448326,130,0,1,0,1
24448361,24448437,76,0,0,1,1
24448380,24448437,57,0,0,1,2
24448438,24448474,36,1,0,0,1
24448438,24448480,42,1,0,0,2
24448475,24450266,1791,0,0,1,1
24448481,24450261,1780,0,0,1,2
24450262,24450468,206,1,0,0,2
24450267,24450429,162,1,0,0,1
24450286,24450398,112,0,1,0,2
24450294,24450380,86,0,1,0,1
24450430,24450550,120,0,0,1,1
24450469,24450551,82,0,0,1,2
24450551,24450595,44,1,0,0,1
24450552,24450603,51,1,0,0,2
24450596,24450907,311,0,0,1,1
24450604,24450908,304,0,0,1,2
24450908,24450947,39,1,0,0,1
24450909,24450942,33,1,0,0,2
24450943,24451160,217,0,0,1,2
24450948,24451160,212,0,0,1,1
24451161,24451190,29,1,0,0,1
24451161,24451192,31,1,0,0,2
24451191,24452348,1157,0,0,1,1
24451193,24452348,1155,0,0,1,2
24452349,24452423,74,1,0,0,2
24452349,24452424,75,1,0,0,1
24452424,24452509,85,0,0,1,2
24452425,24452511,86,0,0,1,1
24452510,24452556,46,1,0,0,2
24452512,24452555,43,1,0,0,1
24452556,24452740,184,0,0,1,1
24452557,24452745,188,0,0,1,2
24452741,24452769,28,1,0,0,1
24452746,24452767,21,1,0,0,2
24452768,24453388,620,0,0,1,2
24452770,24453388,618,0,0,1,1
24453389,24453424,35,1,0,0,2
24453389,24453425,36,1,0,0,1
24453425,24454142,717,0,0,1,2
24453426,24454141,715,0,0,1,1
24454142,24454244,102,1,0,0,1
24454143,24454251,108,1,0,0,2
24454245,24454569,324,0,0,1,1
24454252,24454568,316,0,0,1,2
24454569,24454662,93,1,0,0,2
24454570,24454652,82,1,0,0,1
24454653,24454769,116,0,0,1,1
24454663,24454768,105,0,0,1,2
24454769,24454818,49,1,0,0,2
24454770,24454819,49,1,0,0,1
24454819,24455189,370,0,0,1,2
24454820,24455192,372,0,0,1,1
24455190,24455262,72,1,0,0,2
24455193,24455204,11,1,0,0,1
24455205,24455437,232,0,0,1,1
24455263,24455300,37,0,0,1,2
24455301,24455372,71,1,0,0,2
24455373,24455439,66,0,0,1,2
24455438,24455473,35,1,0,0,1
24455440,24455502,62,1,0,0,2
24455474,24455804,330,0,0,1,1
24455503,24455535,32,0,0,1,2
24455536,24455861,325,1,0,0,2
24455805,24455837,32,1,0,0,1
24455838,24456703,865,0,0,1,1
24455862,24455946,84,0,0,1,2
24455947,24455975,28,1,0,0,2
24455976,24456077,101,0,0,1,2
24456078,24456084,6,1,0,0,2
24456085,24456197,112,0,0,1,2
24456198,24456390,192,1,0,0,2
24456391,24456412,21,0,0,1,2
24456413,24456446,33,1,0,0,2
24456447,24456582,135,0,0,1,2
24456583,24456798,215,1,0,0,2
24456704,24456796,92,1,0,0,1
24456797,24457162,365,0,0,1,1
24456799,24457161,362,0,0,1,2
24457162,24457230,68,1,0,0,2
24457163,24457224,61,1,0,0,1
24457225,24458517,1292,0,0,1,1
24457231,24458511,1280,0,0,1,2
24458512,24458721,209,1,0,0,2
24458518,24458744,226,1,0,0,1
24458546,24458658,112,0,1,0,2
24458552,24458654,102,0,1,0,1
24458722,24458910,188,0,0,1,2
24458745,24458911,166,0,0,1,1
24458911,24458978,67,1,0,0,2
24458912,24458975,63,1,0,0,1
24458976,24459035,59,0,0,1,1
24458979,24459034,55,0,0,1,2
24459035,24459083,48,1,0,0,2
24459036,24459083,47,1,0,0,1
24459084,24459167,83,0,0,1,2
24459084,24459168,84,0,0,1,1
24459168,24459199,31,1,0,0,2
24459169,24459200,31,1,0,0,1
24459200,24459344,144,0,0,1,2
24459201,24459345,144,0,0,1,1
24459345,24459375,30,1,0,0,2
24459346,24459375,29,1,0,0,1
24459376,24460300,924,0,0,1,2
24459376,24460301,925,0,0,1,1
24460301,24460368,67,1,0,0,2
24460302,24460367,65,1,0,0,1
24460368,24460750,382,0,0,1,1
24460369,24460748,379,0,0,1,2
24460749,24460833,84,1,0,0,2
24460751,24460834,83,1,0,0,1
24460834,24460909,75,0,0,1,2
24460835,24460907,72,0,0,1,1
24460908,24460949,41,1,0,0,1
24460910,24460946,36,1,0,0,2
24460947,24461849,902,0,0,1,2
24460950,24461853,903,0,0,1,1
24461850,24461926,76,1,0,0,2
24461854,24461927,73,1,0,0,1
24461927,24462279,352,0,0,1,2
24461928,24462279,351,0,0,1,1
24462280,24462347,67,1,0,0,1
24462280,24462348,68,1,0,0,2
24462348,24462458,110,0,0,1,1
24462349,24462459,110,0,0,1,2
24462459,24462492,33,1,0,0,1
24462460,24462499,39,1,0,0,2
24462493,24463918,1425,0,0,1,1
24462500,24463918,1418,0,0,1,2
24463919,24464115,196,1,0,0,1
24463919,24464128,209,1,0,0,2
24463964,24464072,108,0,1,0,2
24463971,24464053,82,0,1,0,1
24464116,24464465,349,0,0,1,1
24464129,24464464,335,0,0,1,2
24464465,24464572,107,1,0,0,2
24464466,24466217,1751,1,0,0,1
24464554,24466206,1652,0,1,0,1
24464573,24464665,92,0,0,1,2
24464666,24464715,49,1,0,0,2
24464716,24465114,398,0,0,1,2
24465115,24465151,36,1,0,0,2
24465152,24465640,488,0,0,1,2
24465641,24465656,15,1,0,0,2
24465657,24465682,25,0,0,1,2
24465683,24465799,116,1,0,0,2
24465800,24465830,30,0,0,1,2
24465831,24466207,376,1,0,0,2
24466208,24466629,421,0,0,1,2
24466218,24466629,411,0,0,1,1
24466630,24466673,43,1,0,0,1
24466630,24466674,44,1,0,0,2
24466674,24466757,83,0,0,1,1
24466675,24466759,84,0,0,1,2
24466758,24466779,21,1,0,0,1
24466760,24466782,22,1,0,0,2
24466780,24468002,1222,0,0,1,1
24466783,24467997,1214,0,0,1,2
24467998,24468174,176,1,0,0,2
24468003,24468191,188,1,0,0,1
24468022,24468115,93,0,1,0,2
24468032,24468107,75,0,1,0,1
24468175,24468224,49,0,0,1,2
24468192,24468224,32,0,0,1,1
24468225,24468273,48,1,0,0,1
24468225,24468277,52,1,0,0,2
24468274,24468351,77,0,0,1,1
24468278,24468350,72,0,0,1,2
24468351,24468383,32,1,0,0,2
24468352,24468383,31,1,0,0,1
24468384,24469445,1061,0,0,1,2
24468384,24469450,1066,0,0,1,1
24469446,24469713,267,1,0,0,2
24469451,24469734,283,1,0,0,1
24469481,24469623,142,0,1,0,2
24469485,24469619,134,0,1,0,1
24469714,24469877,163,0,0,1,2
24469735,24469875,140,0,0,1,1
24469876,24469956,80,1,0,0,1
24469878,24469957,79,1,0,0,2
24469957,24470028,71,0,0,1,1
24469958,24470026,68,0,0,1,2
24470027,24470066,39,1,0,0,2
24470029,24470063,34,1,0,0,1
24470064,24470202,138,0,0,1,1
24470067,24470203,136,0,0,1,2
24470203,24470231,28,1,0,0,1
24470204,24470231,27,1,0,0,2
24470232,24470601,369,0,0,1,1
24470232,24470602,370,0,0,1,2
24470602,24470631,29,1,0,0,1
24470603,24470632,29,1,0,0,2
24470632,24471270,638,0,0,1,1
24470633,24471271,638,0,0,1,2
24471271,24471354,83,1,0,0,1
24471272,24471355,83,1,0,0,2
24471355,24471733,378,0,0,1,1
24471356,24471733,377,0,0,1,2
24471734,24471788,54,1,0,0,2
24471734,24471790,56,1,0,0,1
24471789,24471889,100,0,0,1,2
24471791,24471888,97,0,0,1,1
24471889,24471923,34,1,0,0,1
24471890,24471931,41,1,0,0,2
24471924,24472662,738,0,0,1,1
24471932,24472662,730,0,0,1,2
24472663,24472735,72,1,0,0,1
24472663,24472737,74,1,0,0,2
24472736,24473120,384,0,0,1,1
24472738,24473119,381,0,0,1,2
24473120,24473192,72,1,0,0,2
24473121,24473186,65,1,0,0,1
24473187,24473269,82,0,0,1,1
24473193,24473267,74,0,0,1,2
24473268,24473310,42,1,0,0,2
24473270,24473312,42,1,0,0,1
24473311,24473439,128,0,0,1,2
24473313,24473434,121,0,0,1,1
24473435,24473464,29,1,0,0,1
24473440,24473457,17,1,0,0,2
24473458,24474244,786,0,0,1,2
24473465,24474244,779,0,0,1,1
24474245,24474298,53,1,0,0,1
24474245,24474301,56,1,0,0,2
24474299,24474443,144,0,0,1,1
24474302,24474436,134,0,0,1,2
24474437,24474674,237,1,0,0,2
24474444,24474653,209,1,0,0,1
24474458,24474604,146,0,1,0,2
24474467,24474582,115,0,1,0,1
24474654,24474735,81,0,0,1,1
24474675,24474735,60,0,0,1,2
24474736,24474798,62,1,0,0,1
24474736,24474828,92,1,0,0,2
24474799,24475011,212,0,0,1,1
24474829,24475011,182,0,0,1,2
24475012,24475039,27,1,0,0,1
24475012,24475042,30,1,0,0,2
24475040,24475344,304,0,0,1,1
24475043,24476162,1119,0,0,1,2
24475345,24475362,17,1,0,0,1
24475363,24476169,806,0,0,1,1
24476163,24476171,8,1,0,0,2
24476170,24476176,6,1,0,0,1
24476172,24476203,31,0,0,1,2
24476177,24476205,28,0,0,1,1
24476204,24477386,1182,1,0,0,2
24476206,24476456,250,1,0,0,1
24476234,24476465,231,0,1,0,2
24476235,24476435,200,0,1,0,1
24476457,24476518,61,0,0,1,1
24476519,24476556,37,1,0,0,1
24476557,24476605,48,0,0,1,1
24476606,24476762,156,1,0,0,1
24476644,24476662,18,0,1,0,1
24476689,24476692,3,0,1,0,1
24476716,24476753,37,0,1,0,1
24476763,24476808,45,0,0,1,1
24476819,24476823,4,0,1,0,1
24476833,24476887,54,1,0,0,1
24476888,24477020,132,0,0,1,1
24477031,24477031,0,0,1,0,1
24477040,24477040,0,1,0,0,1
24477041,24478294,1253,0,0,1,1
24477387,24477416,29,0,0,1,2
24477417,24477681,264,1,0,0,2
24477682,24477784,102,0,0,1,2
24477785,24478876,1091,1,0,0,2
24478295,24478408,113,1,0,0,1
24478311,24478325,14,0,1,0,1
24478358,24478850,492,0,1,0,2
24478409,24478791,382,0,0,1,1
24478792,24478877,85,1,0,0,1
24478877,24478958,81,0,0,1,2
24478878,24478958,80,0,0,1,1
24478959,24478993,34,1,0,0,2
24478959,24478994,35,1,0,0,1
24478994,24479800,806,0,0,1,2
24478995,24479800,805,0,0,1,1
24479801,24480039,238,1,0,0,1
24479801,24480039,238,1,0,0,2
24479825,24479968,143,0,1,0,2
24479829,24479961,132,0,1,0,1
24480040,24480261,221,0,0,1,1
24480040,24480261,221,0,0,1,2
24480262,24480333,71,1,0,0,2
24480262,24480334,72,1,0,0,1
24480334,24480388,54,0,0,1,2
24480335,24480389,54,0,0,1,1
24480389,24480450,61,1,0,0,2
24480390,24480438,48,1,0,0,1
24480439,24480595,156,0,0,1,1
24480451,24480596,145,0,0,1,2
24480596,24480613,17,1,0,0,1
24480597,24480613,16,1,0,0,2
24480614,24481613,999,0,0,1,2
24480614,24481615,1001,0,0,1,1
24481614,24481712,98,1,0,0,2
24481616,24481715,99,1,0,0,1
24481713,24482074,361,0,0,1,2
24481716,24482073,357,0,0,1,1
24482074,24482147,73,1,0,0,1
24482075,24482148,73,1,0,0,2
24482148,24482225,77,0,0,1,1
24482149,24482222,73,0,0,1,2
24482223,24482269,46,1,0,0,2
24482226,24482267,41,1,0,0,1
24482268,24482338,70,0,0,1,1
24482270,24482338,68,0,0,1,2
24482339,24482374,35,1,0,0,2
24482349,24482396,47,0,1,0,1
24482375,24482951,576,0,0,1,2
24482406,24482865,459,1,0,0,1
24482422,24482574,152,0,1,0,1
24482596,24482856,260,0,1,0,1
24482866,24482940,74,0,0,1,1
24482951,24482964,13,0,1,0,1
24482952,24483514,562,1,0,0,2
24482974,24483214,240,1,0,0,1
24482995,24483177,182,0,1,0,2
24482998,24483124,126,0,1,0,1
24483215,24483420,205,0,0,1,1
24483421,24483475,54,1,0,0,1
24483476,24483626,150,0,0,1,1
24483515,24483626,111,0,0,1,2
24483627,24483665,38,1,0,0,2
24483627,24483666,39,1,0,0,1
24483666,24483813,147,0,0,1,2
24483667,24483816,149,0,0,1,1
24483814,24483853,39,1,0,0,2
24483817,24483848,31,1,0,0,1
24483849,24485008,1159,0,0,1,1
24483854,24484698,844,0,0,1,2
24484699,24484739,40,1,0,0,2
24484740,24485008,268,0,0,1,2
24485009,24485054,45,1,0,0,1
24485009,24485062,53,1,0,0,2
24485055,24485327,272,0,0,1,1
24485063,24485327,264,0,0,1,2
24485328,24485404,76,1,0,0,1
24485328,24485405,77,1,0,0,2
24485405,24485457,52,0,0,1,1
24485406,24485458,52,0,0,1,2
24485458,24485499,41,1,0,0,1
24485459,24485504,45,1,0,0,2
24485500,24485567,67,0,0,1,1
24485505,24485563,58,0,0,1,2
24485564,24485615,51,1,0,0,2
24485568,24485605,37,1,0,0,1
24485606,24486530,924,0,0,1,1
24485616,24486529,913,0,0,1,2
24486530,24486634,104,1,0,0,2
24486531,24486637,106,1,0,0,1
24486635,24487033,398,0,0,1,2
24486638,24487033,395,0,0,1,1
24487034,24487107,73,1,0,0,2
24487034,24487108,74,1,0,0,1
24487108,24487200,92,0,0,1,2
24487109,24487200,91,0,0,1,1
24487201,24487234,33,1,0,0,2
24487201,24487237,36,1,0,0,1
24487235,24487919,684,0,0,1,2
24487238,24487917,679,0,0,1,1
24487918,24488007,89,1,0,0,1
24487920,24488009,89,1,0,0,2
24488008,24488393,385,0,0,1,1
24488010,24488393,383,0,0,1,2
24488394,24488460,66,1,0,0,1
24488394,24488463,69,1,0,0,2
24488461,24488541,80,0,0,1,1
24488464,24488541,77,0,0,1,2
24488542,24488578,36,1,0,0,2
24488542,24488579,37,1,0,0,1
24488579,24489325,746,0,0,1,2
24488580,24489326,746,0,0,1,1
24489326,24489418,92,1,0,0,2
24489327,24489415,88,1,0,0,1
24489416,24489554,138,0,0,1,1
24489419,24489554,135,0,0,1,2
24489555,24489600,45,1,0,0,2
24489555,24489602,47,1,0,0,1
24489601,24489798,197,0,0,1,2
24489603,24489799,196,0,0,1,1
24489799,24489897,98,1,0,0,2
24489800,24489863,63,1,0,0,1
24489864,24489944,80,0,0,1,1
24489898,24489945,47,0,0,1,2
24489945,24489990,45,1,0,0,1
24489946,24489989,43,1,0,0,2
24489990,24490237,247,0,0,1,2
24489991,24490234,243,0,0,1,1
24490235,24490262,27,1,0,0,1
24490238,24490273,35,1,0,0,2
24490263,24490603,340,0,0,1,1
24490274,24490603,329,0,0,1,2
24490604,24490686,82,1,0,0,1
24490604,24490686,82,1,0,0,2
24490687,24491077,390,0,0,1,1
24490687,24491078,391,0,0,1,2
24491078,24491143,65,1,0,0,1
24491079,24491147,68,1,0,0,2
24491144,24491240,96,0,0,1,1
24491148,24491243,95,0,0,1,2
24491241,24491282,41,1,0,0,1
24491244,24491284,40,1,0,0,2
24491283,24491945,662,0,0,1,1
24491285,24491946,661,0,0,1,2
24491946,24492038,92,1,0,0,1
24491947,24492028,81,1,0,0,2
24492029,24492449,420,0,0,1,2
24492039,24492450,411,0,0,1,1
24492450,24492533,83,1,0,0,2
24492451,24492531,80,1,0,0,1
24492519,24492524,5,0,1,0,2
24492532,24492642,110,0,0,1,1
24492534,24492644,110,0,0,1,2
24492643,24492681,38,1,0,0,1
24492645,24492672,27,1,0,0,2
24492673,24492784,111,0,0,1,2
24492682,24492781,99,0,0,1,1
24492782,24492824,42,1,0,0,1
24492785,24492940,155,1,0,0,2
24492825,24493336,511,0,0,1,1
24492941,24493049,108,0,0,1,2
24493050,24493447,397,1,0,0,2
24493337,24493446,109,1,0,0,1
24493349,24493357,8,0,1,0,2
24493447,24493774,327,0,0,1,1
24493448,24493774,326,0,0,1,2
24493775,24493843,68,1,0,0,1
24493775,24493843,68,1,0,0,2
24493844,24493942,98,0,0,1,2
24493844,24493943,99,0,0,1,1
24493943,24493977,34,1,0,0,2
24493944,24493977,33,1,0,0,1
24493978,24494205,227,0,0,1,2
24493978,24494207,229,0,0,1,1
24494206,24494236,30,1,0,0,2
24494208,24494237,29,1,0,0,1
24494237,24494660,423,0,0,1,2
24494238,24494661,423,0,0,1,1
24494661,24494745,84,1,0,0,2
24494662,24494746,84,1,0,0,1
24494746,24495155,409,0,0,1,2
24494747,24495154,407,0,0,1,1
24495155,24495209,54,1,0,0,1
24495156,24495216,60,1,0,0,2
24495210,24495274,64,0,0,1,1
24495217,24495274,57,0,0,1,2
24495275,24495310,35,1,0,0,1
24495275,24495323,48,1,0,0,2
24495311,24495387,76,0,0,1,1
24495324,24495385,61,0,0,1,2
24495386,24495421,35,1,0,0,2
24495388,24495420,32,1,0,0,1
24495421,24496044,623,0,0,1,1
24495422,24496040,618,0,0,1,2
24496041,24496203,162,1,0,0,2
24496045,24496195,150,1,0,0,1
24496196,24496511,315,0,0,1,1
24496204,24496510,306,0,0,1,2
24496511,24496565,54,1,0,0,2
24496512,24496578,66,1,0,0,1
24496566,24496660,94,0,0,1,2
24496579,24496660,81,0,0,1,1
24496661,24496694,33,1,0,0,1
24496661,24496694,33,1,0,0,2
24496695,24497038,343,0,0,1,1
24496695,24497040,345,0,0,1,2
24497039,24497071,32,1,0,0,1
24497041,24497072,31,1,0,0,2
24497072,24497370,298,0,0,1,1
24497073,24497367,294,0,0,1,2
24497368,24497461,93,1,0,0,2
24497371,24497462,91,1,0,0,1
24497462,24497836,374,0,0,1,2
24497463,24497837,374,0,0,1,1
24497837,24497891,54,1,0,0,2
24497838,24497887,49,1,0,0,1
24497888,24497994,106,0,0,1,1
24497892,24497983,91,0,0,1,2
24497984,24498373,389,1,0,0,2
24497995,24498296,301,1,0,0,1
24498008,24498265,257,0,1,0,2
24498018,24498188,170,0,1,0,1
24498297,24498751,454,0,0,1,1
24498374,24498422,48,0,0,1,2
24498423,24498441,18,1,0,0,2
24498442,24498463,21,0,0,1,2
24498464,24498477,13,1,0,0,2
24498478,24498748,270,0,0,1,2
24498749,24498816,67,1,0,0,2
24498752,24498806,54,1,0,0,1
24498807,24499183,376,0,0,1,1
24498817,24499183,366,0,0,1,2
24499184,24499246,62,1,0,0,1
24499184,24499247,63,1,0,0,2
24499247,24499422,175,0,0,1,1
24499248,24499421,173,0,0,1,2
24499422,24499455,33,1,0,0,2
24499423,24499457,34,1,0,0,1
24499456,24500053,597,0,0,1,2
24499458,24500055,597,0,0,1,1
24500054,24500118,64,1,0,0,2
24500056,24500118,62,1,0,0,1
24500119,24500484,365,0,0,1,2
24500119,24500489,370,0,0,1,1
24500485,24500543,58,1,0,0,2
24500490,24500546,56,1,0,0,1
24500544,24500655,111,0,0,1,2
24500547,24500655,108,0,0,1,1
24500656,24500687,31,1,0,0,1
24500656,24500693,37,1,0,0,2
24500688,24501053,365,0,0,1,1
24500694,24501039,345,0,0,1,2
24501040,24501367,327,1,0,0,2
24501054,24501265,211,1,0,0,1
24501066,24501242,176,0,1,0,2
24501077,24501209,132,0,1,0,1
24501266,24501527,261,0,0,1,1
24501368,24501528,160,0,0,1,2
24501528,24501583,55,1,0,0,1
24501529,24501594,65,1,0,0,2
24501584,24501899,315,0,0,1,1
24501595,24501898,303,0,0,1,2
24501899,24501985,86,1,0,0,2
24501900,24501995,95,1,0,0,1
24501986,24502059,73,0,0,1,2
24501996,24502061,65,0,0,1,1
24502060,24502092,32,1,0,0,2
24502062,24502094,32,1,0,0,1
24502093,24503037,944,0,0,1,2
24502095,24503040,945,0,0,1,1
24503038,24503140,102,1,0,0,2
24503041,24503140,99,1,0,0,1
24503141,24503449,308,0,0,1,2
24503141,24503450,309,0,0,1,1
24503450,24503537,87,1,0,0,2
24503451,24504545,1094,1,0,0,1
24503505,24504504,999,0,1,0,1
24503538,24503619,81,0,0,1,2
24503620,24503660,40,1,0,0,2
24503661,24504334,673,0,0,1,2
24504335,24504603,268,1,0,0,2
24504373,24504513,140,0,1,0,2
24504546,24504815,269,0,0,1,1
24504604,24504816,212,0,0,1,2
24504816,24504877,61,1,0,0,1
24504817,24504897,80,1,0,0,2
24504878,24504968,90,0,0,1,1
24504898,24504967,69,0,0,1,2
24504968,24505021,53,1,0,0,2
24504969,24505010,41,1,0,0,1
24505011,24505215,204,0,0,1,1
24505022,24505213,191,0,0,1,2
24505214,24505226,12,1,0,0,2
24505216,24505224,8,1,0,0,1
24505225,24506030,805,0,0,1,1
24505227,24506031,804,0,0,1,2
24506031,24506086,55,1,0,0,1
24506032,24506094,62,1,0,0,2
24506087,24506390,303,0,0,1,1
24506095,24506390,295,0,0,1,2
24506391,24506465,74,1,0,0,2
24506391,24506466,75,1,0,0,1
24506466,24506546,80,0,0,1,2
24506467,24506547,80,0,0,1,1
24506547,24506583,36,1,0,0,2
24506548,24506583,35,1,0,0,1
24506584,24507286,702,0,0,1,1
24506584,24507288,704,0,0,1,2
24507287,24507380,93,1,0,0,1
24507289,24507378,89,1,0,0,2
24507379,24507755,376,0,0,1,2
24507381,24507756,375,0,0,1,1
24507756,24507796,40,1,0,0,2
24507757,24507793,36,1,0,0,1
24507794,24508036,242,0,0,1,1
24507797,24508037,240,0,0,1,2
24508037,24508057,20,1,0,0,1
24508038,24508048,10,1,0,0,2
24508049,24508782,733,0,0,1,2
24508058,24508781,723,0,0,1,1
24508782,24508832,50,1,0,0,1
24508783,24508827,44,1,0,0,2
24508828,24509149,321,0,0,1,2
24508833,24509148,315,0,0,1,1
24509149,24509211,62,1,0,0,1
24509150,24509212,62,1,0,0,2
24509212,24509297,85,0,0,1,1
24509213,24509297,84,0,0,1,2
24509298,24509330,32,1,0,0,1
24509298,24509338,40,1,0,0,2
24509331,24509487,156,0,0,1,1
24509339,24509487,148,0,0,1,2
24509488,24509502,14,1,0,0,1
24509488,24509518,30,1,0,0,2
24509503,24509735,232,0,0,1,1
24509519,24509741,222,0,0,1,2
24509736,24509761,25,1,0,0,1
24509742,24509760,18,1,0,0,2
24509761,24510070,309,0,0,1,2
24509762,24510071,309,0,0,1,1
24510071,24510137,66,1,0,0,2
24510072,24510132,60,1,0,0,1
24510133,24510626,493,0,0,1,1
24510138,24510626,488,0,0,1,2
24510627,24510692,65,1,0,0,2
24510627,24510693,66,1,0,0,1
24510693,24510776,83,0,0,1,2
24510694,24510777,83,0,0,1,1
24510777,24510820,43,1,0,0,2
24510778,24510802,24,1,0,0,1
24510803,24511389,586,0,0,1,1
24510821,24512374,1553,0,0,1,2
24511390,24511400,10,1,0,0,1
24511401,24512477,1076,0,0,1,1
24512375,24512392,17,1,0,0,2
24512393,24512475,82,0,0,1,2
24512476,24512522,46,1,0,0,2
24512478,24512521,43,1,0,0,1
24512522,24513033,511,0,0,1,1
24512523,24513033,510,0,0,1,2
24513034,24513057,23,1,0,0,1
24513034,24513058,24,1,0,0,2
24513058,24514467,1409,0,0,1,1
24513059,24514467,1408,0,0,1,2
24514468,24515460,992,1,0,0,1
24514468,24515464,996,1,0,0,2
24514535,24515445,910,0,1,0,2
24514539,24515449,910,0,1,0,1
24515461,24515644,183,0,0,1,1
24515465,24515597,132,0,0,1,2
24515598,24515605,7,1,0,0,2
24515606,24515637,31,0,0,1,2
24515638,24515938,300,1,0,0,2
24515645,24515943,298,1,0,0,1
24515669,24515810,141,0,1,0,1
24515669,24515818,149,0,1,0,2
24515841,24515841,0,0,1,0,1
24515939,24516174,235,0,0,1,2
24515944,24516179,235,0,0,1,1
24516175,24516198,23,1,0,0,2
24516180,24516197,17,1,0,0,1
24516198,24517761,1563,0,0,1,1
24516199,24517761,1562,0,0,1,2
24517762,24517812,50,1,0,0,2
24517762,24517827,65,1,0,0,1
24517813,24518003,190,0,0,1,2
24517828,24518003,175,0,0,1,1
24518004,24518044,40,1,0,0,2
24518004,24518045,41,1,0,0,1
24518045,24519723,1678,0,0,1,2
24518046,24519899,1853,0,0,1,1
24519724,24519827,103,1,0,0,2
24519828,24519904,76,0,0,1,2
24519900,24520867,967,1,0,0,1
24519905,24520912,1007,1,0,0,2
24519935,24520413,478,0,1,0,2
24519937,24520414,477,0,1,0,1
24520441,24520641,200,0,1,0,1
24520441,24520656,215,0,1,0,2
24520690,24520823,133,0,1,0,2
24520692,24520808,116,0,1,0,1
24520868,24521658,790,0,0,1,1
24520913,24521657,744,0,0,1,2
24521658,24521705,47,1,0,0,2
24521659,24521706,47,1,0,0,1
24521706,24521777,71,0,0,1,2
24521707,24521777,70,0,0,1,1
24521778,24521816,38,1,0,0,1
24521778,24521816,38,1,0,0,2
24521817,24521918,101,0,0,1,2
24521817,24521919,102,0,0,1,1
24521919,24521963,44,1,0,0,2
24521920,24521956,36,1,0,0,1
24521957,24522131,174,0,0,1,1
24521964,24522137,173,0,0,1,2
24522132,24522158,26,1,0,0,1
24522138,24522154,16,1,0,0,2
24522155,24523394,1239,0,0,1,2
24522159,24523394,1235,0,0,1,1
24523395,24523437,42,1,0,0,1
24523395,24523437,42,1,0,0,2
24523438,24523572,134,0,0,1,2
24523438,24523573,135,0,0,1,1
24523573,24523603,30,1,0,0,2
24523574,24523605,31,1,0,0,1
24523604,24525542,1938,0,0,1,2
24523606,24525542,1936,0,0,1,1
24525543,24526436,893,1,0,0,1
24525543,24526442,899,1,0,0,2
24525586,24526424,838,0,1,0,2
24525588,24526425,837,0,1,0,1
24526437,24527057,620,0,0,1,1
24526443,24527056,613,0,0,1,2
24527057,24527152,95,1,0,0,2
24527058,24527127,69,1,0,0,1
24527128,24527233,105,0,0,1,1
24527153,24527233,80,0,0,1,2
24527234,24527256,22,1,0,0,1
24527234,24527272,38,1,0,0,2
24527257,24529324,2067,0,0,1,1
24527273,24529325,2052,0,0,1,2
24529325,24529390,65,1,0,0,1
24529326,24529399,73,1,0,0,2
24529391,24531461,2070,0,0,1,1
24529400,24531697,2297,0,0,1,2
24531462,24531476,14,1,0,0,1
24531477,24531695,218,0,0,1,1
24531696,24531743,47,1,0,0,1
24531698,24531735,37,1,0,0,2
24531736,24532180,444,0,0,1,2
24531744,24532181,437,0,0,1,1
24532181,24532236,55,1,0,0,2
24532182,24532227,45,1,0,0,1
24532228,24533052,824,0,0,1,1
24532237,24533052,815,0,0,1,2
24533053,24533248,195,1,0,0,2
24533053,24533250,197,1,0,0,1
24533100,24533194,94,0,1,0,2
24533102,24533195,93,0,1,0,1
24533249,24533385,136,0,0,1,2
24533251,24533384,133,0,0,1,1
24533385,24533456,71,1,0,0,1
24533386,24533460,74,1,0,0,2
24533457,24533587,130,0,0,1,1
24533461,24533586,125,0,0,1,2
24533587,24533628,41,1,0,0,2
24533588,24533627,39,1,0,0,1
24533628,24533777,149,0,0,1,1
24533629,24533777,148,0,0,1,2
24533778,24533809,31,1,0,0,1
24533778,24533809,31,1,0,0,2
24533810,24534086,276,0,0,1,1
24533810,24534088,278,0,0,1,2
24534087,24534118,31,1,0,0,1
24534089,24534117,28,1,0,0,2
24534118,24534436,318,0,0,1,2
24534119,24534440,321,0,0,1,1
24534437,24534459,22,1,0,0,2
24534441,24534457,16,1,0,0,1
24534458,24534990,532,0,0,1,1
24534460,24534986,526,0,0,1,2
24534987,24535022,35,1,0,0,2
24534991,24535019,28,1,0,0,1
24535020,24535117,97,0,0,1,1
24535023,24535117,94,0,0,1,2
24535118,24535159,41,1,0,0,1
24535118,24535175,57,1,0,0,2
24535160,24536114,954,0,0,1,1
24535176,24536114,938,0,0,1,2
24536115,24536151,36,1,0,0,1
24536115,24536154,39,1,0,0,2
24536152,24536719,567,0,0,1,1
24536155,24536721,566,0,0,1,2
24536720,24536766,46,1,0,0,1
24536722,24536765,43,1,0,0,2
24536766,24536842,76,0,0,1,2
24536767,24537188,421,0,0,1,1
24536843,24536877,34,1,0,0,2
24536878,24537186,308,0,0,1,2
24537187,24538689,1502,1,0,0,2
24537189,24537219,30,1,0,0,1
24537220,24537267,47,0,0,1,1
24537268,24538664,1396,1,0,0,1
24537307,24538649,1342,0,1,0,2
24537311,24538653,1342,0,1,0,1
24538665,24538876,211,0,0,1,1
24538690,24538874,184,0,0,1,2
24538875,24538963,88,1,0,0,2
24538877,24538945,68,1,0,0,1
24538946,24538989,43,0,0,1,1
24538964,24538988,24,0,0,1,2
24538989,24539189,200,1,0,0,2
24538990,24539039,49,1,0,0,1
24539040,24539149,109,0,0,1,1
24539150,24539178,28,1,0,0,1
24539179,24541166,1987,0,0,1,1
24539190,24539533,343,0,0,1,2
24539534,24539568,34,1,0,0,2
24539569,24541163,1594,0,0,1,2
24541164,24541222,58,1,0,0,2
24541167,24541213,46,1,0,0,1
24541214,24541311,97,0,0,1,1
24541223,24541314,91,0,0,1,2
24541312,24541341,29,1,0,0,1
24541315,24541347,32,1,0,0,2
24541342,24543311,1969,0,0,1,1
24541348,24543309,1961,0,0,1,2
24543310,24543329,19,1,0,0,2
24543312,24543328,16,1,0,0,1
24543329,24543701,372,0,0,1,1
24543330,24543702,372,0,0,1,2
24543702,24544113,411,1,0,0,1
24543703,24544106,403,1,0,0,2
24543812,24544064,252,0,1,0,2
24543812,24544066,254,0,1,0,1
24544107,24544189,82,0,0,1,2
24544114,24544194,80,0,0,1,1
24544190,24544482,292,1,0,0,2
24544195,24544459,264,1,0,0,1
24544230,24544404,174,0,1,0,2
24544233,24544401,168,0,1,0,1
24544460,24545045,585,0,0,1,1
24544483,24545045,562,0,0,1,2
24545046,24545107,61,1,0,0,1
24545046,24545140,94,1,0,0,2
24545108,24545219,111,0,0,1,1
24545141,24545218,77,0,0,1,2
24545219,24545270,51,1,0,0,2
24545220,24545250,30,1,0,0,1
24545251,24546435,1184,0,0,1,1
24545271,24546436,1165,0,0,1,2
24546436,24546499,63,1,0,0,1
24546437,24546509,72,1,0,0,2
24546500,24546604,104,0,0,1,1
24546510,24546605,95,0,0,1,2
24546605,24546641,36,1,0,0,1
24546606,24546648,42,1,0,0,2
24546642,24547181,539,0,0,1,1
24546649,24546905,256,0,0,1,2
24546906,24546930,24,1,0,0,2
24546931,24547175,244,0,0,1,2
24547176,24547202,26,1,0,0,2
24547182,24547201,19,1,0,0,1
24547202,24548906,1704,0,0,1,1
24547203,24548905,1702,0,0,1,2
24548906,24549277,371,1,0,0,2
24548907,24549271,364,1,0,0,1
24548978,24549201,223,0,1,0,2
24548983,24549188,205,0,1,0,1
24549272,24549694,422,0,0,1,1
24549278,24549691,413,0,0,1,2
24549692,24549744,52,1,0,0,2
24549695,24549755,60,1,0,0,1
24549745,24549940,195,0,0,1,2
24549756,24549940,184,0,0,1,1
24549941,24550026,85,1,0,0,1
24549941,24550035,94,1,0,0,2
24550027,24550091,64,0,0,1,1
24550036,24550091,55,0,0,1,2
24550092,24550131,39,1,0,0,1
24550092,24550142,50,1,0,0,2
24550132,24551517,1385,0,0,1,1
24550143,24550969,826,0,0,1,2
24550970,24551586,616,1,0,0,2
24551518,24551580,62,1,0,0,1
24551581,24551756,175,0,0,1,1
24551587,24551755,168,0,0,1,2
24551756,24551792,36,1,0,0,2
24551757,24551792,35,1,0,0,1
24551793,24553746,1953,0,0,1,1
24551793,24553748,1955,0,0,1,2
24553747,24553778,31,1,0,0,1
24553749,24553782,33,1,0,0,2
24553779,24553995,216,0,0,1,1
24553783,24553997,214,0,0,1,2
24553996,24554320,324,1,0,0,1
24553998,24554347,349,1,0,0,2
24554058,24554276,218,0,1,0,1
24554059,24554254,195,0,1,0,2
24554321,24554395,74,0,0,1,1
24554348,24554399,51,0,0,1,2
24554396,24554433,37,1,0,0,1
24554400,24554435,35,1,0,0,2
24554434,24555192,758,0,0,1,1
24554436,24555191,755,0,0,1,2
24555192,24555212,20,1,0,0,2
24555193,24555212,19,1,0,0,1
24555213,24556532,1319,0,0,1,1
24555213,24556533,1320,0,0,1,2
24556533,24556593,60,1,0,0,1
24556534,24556602,68,1,0,0,2
24556594,24556698,104,0,0,1,1
24556603,24556695,92,0,0,1,2
24556696,24556740,44,1,0,0,2
24556699,24556740,41,1,0,0,1
24556741,24558671,1930,0,0,1,2
24556741,24558672,1931,0,0,1,1
24558672,24558700,28,1,0,0,2
24558673,24558695,22,1,0,0,1
24558696,24558937,241,0,0,1,1
24558701,24558938,237,0,0,1,2
24558938,24559002,64,1,0,0,1
24558939,24559000,61,1,0,0,2
24559001,24559144,143,0,0,1,2
24559003,24559145,142,0,0,1,1
24559145,24559219,74,1,0,0,2
24559146,24559217,71,1,0,0,1
24559218,24559688,470,0,0,1,1
24559220,24559687,467,0,0,1,2
24559688,24559718,30,1,0,0,2
24559689,24559718,29,1,0,0,1
24559719,24560070,351,0,0,1,2
24559719,24560198,479,0,0,1,1
24560071,24560075,4,1,0,0,2
24560076,24560198,122,0,0,1,2
24560199,24560259,60,1,0,0,1
24560199,24560271,72,1,0,0,2
24560260,24560375,115,0,0,1,1
24560272,24560350,78,0,0,1,2
24560351,24560394,43,1,0,0,2
24560376,24560392,16,1,0,0,1
24560393,24562127,1734,0,0,1,1
24560395,24561010,615,0,0,1,2
24561011,24561061,50,1,0,0,2
24561062,24562127,1065,0,0,1,2
24562128,24562184,56,1,0,0,2
24562128,24562203,75,1,0,0,1
24562185,24562845,660,0,0,1,2
24562204,24564247,2043,0,0,1,1
24562846,24562853,7,1,0,0,2
24562854,24563193,339,0,0,1,2
24563194,24563215,21,1,0,0,2
24563216,24564247,1031,0,0,1,2
24564248,24564254,6,1,0,0,2
24564248,24564274,26,1,0,0,1
24564255,24564374,119,0,0,1,2
24564275,24564358,83,0,0,1,1
24564359,24564871,512,1,0,0,1
24564375,24564850,475,1,0,0,2
24564402,24564817,415,0,1,0,1
24564403,24564815,412,0,1,0,2
24564851,24564973,122,0,0,1,2
24564872,24564930,58,0,0,1,1
24564931,24564940,9,1,0,0,1
24564941,24564973,32,0,0,1,1
24564974,24565269,295,1,0,0,1
24564974,24565316,342,1,0,0,2
24565003,24565257,254,0,1,0,2
24565011,24565192,181,0,1,0,1
24565224,24565226,2,0,1,0,1
24565270,24565458,188,0,0,1,1
24565317,24565342,25,0,0,1,2
24565343,24565432,89,1,0,0,2
24565433,24565460,27,0,0,1,2
24565459,24565527,68,1,0,0,1
24565461,24565524,63,1,0,0,2
24565525,24565793,268,0,0,1,2
24565528,24565794,266,0,0,1,1
24565794,24565861,67,1,0,0,2
24565795,24565854,59,1,0,0,1
24565855,24566171,316,0,0,1,1
24565862,24566171,309,0,0,1,2
24566172,24566236,64,1,0,0,1
24566172,24566236,64,1,0,0,2
24566237,24566286,49,0,0,1,2
24566237,24566287,50,0,0,1,1
24566287,24566323,36,1,0,0,2
24566288,24566323,35,1,0,0,1
24566324,24567142,818,0,0,1,1
24566324,24567142,818,0,0,1,2
24567143,24567173,30,1,0,0,2
24567143,24567174,31,1,0,0,1
24567174,24567565,391,0,0,1,2
24567175,24567564,389,0,0,1,1
24567565,24567622,57,1,0,0,1
24567566,24567623,57,1,0,0,2
24567623,24568189,566,0,0,1,1
24567624,24568188,564,0,0,1,2
24568189,24568216,27,1,0,0,2
24568190,24568215,25,1,0,0,1
24568216,24569685,1469,0,0,1,1
24568217,24569680,1463,0,0,1,2
24569681,24569696,15,1,0,0,2
24569686,24569690,4,1,0,0,1
24569691,24569899,208,0,0,1,1
24569697,24569890,193,0,0,1,2
24569891,24570078,187,1,0,0,2
24569900,24570056,156,1,0,0,1
24569920,24570005,85,0,1,0,2
24569923,24569993,70,0,1,0,1
24570057,24570449,392,0,0,1,1
24570079,24570451,372,0,0,1,2
24570450,24570498,48,1,0,0,1
24570452,24570499,47,1,0,0,2
24570499,24570754,255,0,0,1,1
24570500,24570753,253,0,0,1,2
24570754,24570821,67,1,0,0,2
24570755,24570812,57,1,0,0,1
24570813,24571102,289,0,0,1,1
24570822,24571103,281,0,0,1,2
24571103,24571174,71,1,0,0,1
24571104,24571175,71,1,0,0,2
24571175,24571216,41,0,0,1,1
24571176,24571216,40,0,0,1,2
24571217,24571256,39,1,0,0,1
24571217,24571263,46,1,0,0,2
24571257,24571358,101,0,0,1,1
24571264,24571362,98,0,0,1,2
24571359,24571388,29,1,0,0,1
24571363,24571381,18,1,0,0,2
24571382,24571507,125,0,0,1,2
24571389,24571509,120,0,0,1,1
24571508,24571547,39,1,0,0,2
24571510,24571542,32,1,0,0,1
24571543,24573112,1569,0,0,1,1
24571548,24572328,780,0,0,1,2
24572329,24572347,18,1,0,0,2
24572348,24573102,754,0,0,1,2
24573103,24573139,36,1,0,0,2
24573113,24573119,6,1,0,0,1
24573120,24573239,119,0,0,1,1
24573140,24573238,98,0,0,1,2
24573239,24573310,71,1,0,0,2
24573240,24573320,80,1,0,0,1
24573311,24573393,82,0,0,1,2
24573321,24573394,73,0,0,1,1
24573394,24573431,37,1,0,0,2
24573395,24573430,35,1,0,0,1
24573431,24573656,225,0,0,1,1
24573432,24573656,224,0,0,1,2
24573657,24573689,32,1,0,0,2
24573657,24573690,33,1,0,0,1
24573690,24575293,1603,0,0,1,2
24573691,24575291,1600,0,0,1,1
24575292,24575598,306,1,0,0,1
24575294,24575669,375,1,0,0,2
24575332,24575562,230,0,1,0,2
24575333,24575527,194,0,1,0,1
24575599,24575841,242,0,0,1,1
24575670,24575841,171,0,0,1,2
24575842,24575900,58,1,0,0,2
24575842,24575904,62,1,0,0,1
24575901,24576011,110,0,0,1,2
24575905,24576019,114,0,0,1,1
24576012,24576239,227,1,0,0,2
24576020,24576242,222,1,0,0,1
24576040,24576175,135,0,1,0,2
24576044,24576153,109,0,1,0,1
24576240,24576455,215,0,0,1,2
24576243,24576455,212,0,0,1,1
24576456,24576522,66,1,0,0,1
24576456,24576523,67,1,0,0,2
24576523,24577006,483,0,0,1,1
24576524,24577005,481,0,0,1,2
24577006,24577059,53,1,0,0,2
24577007,24577067,60,1,0,0,1
24577060,24577269,209,0,0,1,2
24577068,24577269,201,0,0,1,1
24577270,24577346,76,1,0,0,1
24577270,24577347,77,1,0,0,2
24577347,24577450,103,0,0,1,1
24577348,24577451,103,0,0,1,2
24577451,24577494,43,1,0,0,1
24577452,24577494,42,1,0,0,2
24577495,24577734,239,0,0,1,2
24577495,24577736,241,0,0,1,1
24577735,24577768,33,1,0,0,2
24577737,24577768,31,1,0,0,1
24577769,24579651,1882,0,0,1,2
24577769,24579747,1978,0,0,1,1
24579652,24579673,21,1,0,0,2
24579674,24579759,85,0,0,1,2
24579748,24579999,251,1,0,0,1
24579760,24580062,302,1,0,0,2
24579789,24579970,181,0,1,0,1
24579794,24580000,206,0,1,0,2
24580000,24580226,226,0,0,1,1
24580063,24580101,38,0,0,1,2
24580102,24582090,1988,1,0,0,2
24580237,24580241,4,0,1,0,1
24580250,24580250,0,1,0,0,1
24580251,24580321,70,0,0,1,1
24580322,24580388,66,1,0,0,1
24580334,24580343,9,0,1,0,1
24580377,24580379,2,0,1,0,1
24580389,24580595,206,0,0,1,1
24580606,24580697,91,0,1,0,1
24580706,24580706,0,1,0,0,1
24580707,24581904,1197,0,0,1,1
24581905,24581976,71,1,0,0,1
24581958,24581961,3,0,1,0,1
24581977,24582153,176,0,0,1,1
24582091,24582158,67,0,0,1,2
24582154,24582495,341,1,0,0,1
24582159,24582575,416,1,0,0,2
24582221,24582447,226,0,1,0,2
24582222,24582400,178,0,1,0,1
24582431,24582437,6,0,1,0,1
24582496,24582678,182,0,0,1,1
24582576,24582677,101,0,0,1,2
24582678,24582736,58,1,0,0,2
24582679,24582737,58,1,0,0,1
24582737,24583754,1017,0,0,1,2
24582738,24583754,1016,0,0,1,1
24583755,24583818,63,1,0,0,1
24583755,24583827,72,1,0,0,2
24583819,24583882,63,0,0,1,1
24583828,24583881,53,0,0,1,2
24583882,24583921,39,1,0,0,2
24583883,24583920,37,1,0,0,1
24583921,24583989,68,0,0,1,1
24583922,24583989,67,0,0,1,2
24583990,24584021,31,1,0,0,1
24583990,24584021,31,1,0,0,2
24584022,24584174,152,0,0,1,1
24584022,24584177,155,0,0,1,2
24584175,24584189,14,1,0,0,1
24584178,24584193,15,1,0,0,2
24584190,24584637,447,0,0,1,1
24584194,24584637,443,0,0,1,2
24584638,24584668,30,1,0,0,1
24584638,24584668,30,1,0,0,2
24584669,24585581,912,0,0,1,2
24584669,24585582,913,0,0,1,1
24585582,24585638,56,1,0,0,2
24585583,24585637,54,1,0,0,1
24585638,24585825,187,0,0,1,1
24585639,24585824,185,0,0,1,2
24585825,24585836,11,1,0,0,2
24585826,24585832,6,1,0,0,1
24585833,24587283,1450,0,0,1,1
24585837,24587282,1445,0,0,1,2
24587283,24587296,13,1,0,0,2
24587284,24587294,10,1,0,0,1
24587295,24587649,354,0,0,1,1
24587297,24587630,333,0,0,1,2
24587631,24588573,942,1,0,0,2
24587650,24588500,850,1,0,0,1
24587678,24588456,778,0,1,0,1
24587678,24588493,815,0,1,0,2
24588501,24589271,770,0,0,1,1
24588574,24589269,695,0,0,1,2
24589270,24589337,67,1,0,0,2
24589272,24589346,74,1,0,0,1
24589338,24589537,199,0,0,1,2
24589347,24589535,188,0,0,1,1
24589536,24589803,267,1,0,0,1
24589538,24590273,735,1,0,0,2
24589562,24589702,140,0,1,0,1
24589563,24589698,135,0,1,0,2
24589804,24590026,222,0,0,1,1
24590027,24590049,22,1,0,0,1
24590050,24591676,1626,0,0,1,1
24590274,24590323,49,0,0,1,2
24590324,24590551,227,1,0,0,2
24590552,24590617,65,0,0,1,2
24590618,24590671,53,1,0,0,2
24590672,24590692,20,0,0,1,2
24590693,24591756,1063,1,0,0,2
24591677,24591728,51,1,0,0,1
24591729,24591813,84,0,0,1,1
24591757,24591814,57,0,0,1,2
24591814,24591857,43,1,0,0,1
24591815,24591866,51,1,0,0,2
24591858,24592408,550,0,0,1,1
24591867,24592405,538,0,0,1,2
24592406,24592439,33,1,0,0,2
24592409,24592441,32,1,0,0,1
24592440,24593723,1283,0,0,1,2
24592442,24593738,1296,0,0,1,1
24593724,24594159,435,1,0,0,2
24593739,24594015,276,1,0,0,1
24593756,24593959,203,0,1,0,2
24593764,24593929,165,0,1,0,1
24593967,24593969,2,0,1,0,1
24594016,24594266,250,0,0,1,1
24594160,24594267,107,0,0,1,2
24594267,24594315,48,1,0,0,1
24594268,24594324,56,1,0,0,2
24594316,24594668,352,0,0,1,1
24594325,24594668,343,0,0,1,2
24594669,24594712,43,1,0,0,1
24594669,24594723,54,1,0,0,2
24594713,24594906,193,0,0,1,1
24594724,24594905,181,0,0,1,2
24594906,24594990,84,1,0,0,2
24594907,24594990,83,1,0,0,1
24594991,24595404,413,0,0,1,1
24594991,24595404,413,0,0,1,2
24595405,24595451,46,1,0,0,1
24595405,24595461,56,1,0,0,2
24595452,24595713,261,0,0,1,1
24595462,24595712,250,0,0,1,2
24595713,24595853,140,1,0,0,2
24595714,24595781,67,1,0,0,1
24595782,24595883,101,0,0,1,1
24595854,24595881,27,0,0,1,2
24595882,24595919,37,1,0,0,2
24595884,24595924,40,1,0,0,1
24595920,24595945,25,0,0,1,2
24595925,24596066,141,0,0,1,1
24595946,24596020,74,1,0,0,2
24596021,24596062,41,0,0,1,2
24596063,24596161,98,1,0,0,2
24596067,24596098,31,1,0,0,1
24596099,24597418,1319,0,0,1,1
24596162,24596320,158,0,0,1,2
24596321,24596465,144,1,0,0,2
24596466,24596512,46,0,0,1,2
24596513,24596850,337,1,0,0,2
24596851,24597042,191,0,0,1,2
24597043,24597072,29,1,0,0,2
24597073,24597178,105,0,0,1,2
24597179,24597183,4,1,0,0,2
24597184,24597244,60,0,0,1,2
24597245,24597264,19,1,0,0,2
24597265,24597323,58,0,0,1,2
24597324,24597511,187,1,0,0,2
24597419,24597479,60,1,0,0,1
24597480,24597583,103,0,0,1,1
24597512,24597581,69,0,0,1,2
24597582,24597648,66,1,0,0,2
24597584,24597624,40,1,0,0,1
24597625,24598262,637,0,0,1,1
24597649,24598073,424,0,0,1,2
24598074,24598108,34,1,0,0,2
24598109,24598262,153,0,0,1,2
24598263,24598296,33,1,0,0,2
24598263,24598297,34,1,0,0,1
24598297,24598590,293,0,0,1,2
24598298,24599480,1182,0,0,1,1
24598591,24598596,5,1,0,0,2
24598597,24599455,858,0,0,1,2
24599456,24599936,480,1,0,0,2
24599481,24599797,316,1,0,0,1
24599496,24599736,240,0,1,0,2
24599504,24599708,204,0,1,0,1
24599798,24600044,246,0,0,1,1
24599937,24600045,108,0,0,1,2
24600045,24600090,45,1,0,0,1
24600046,24600096,50,1,0,0,2
24600091,24600312,221,0,0,1,1
24600097,24600311,214,0,0,1,2
24600312,24600366,54,1,0,0,2
24600313,24600365,52,1,0,0,1
24600366,24600636,270,0,0,1,1
24600367,24600635,268,0,0,1,2
24600636,24600698,62,1,0,0,2
24600637,24600696,59,1,0,0,1
24600697,24600892,195,0,0,1,1
24600699,24600893,194,0,0,1,2
24600893,24600977,84,1,0,0,1
24600894,24600979,85,1,0,0,2
24600978,24601211,233,0,0,1,1
24600980,24601210,230,0,0,1,2
24601211,24601293,82,1,0,0,2
24601212,24601282,70,1,0,0,1
24601283,24601388,105,0,0,1,1
24601294,24601389,95,0,0,1,2
24601389,24601424,35,1,0,0,1
24601390,24601431,41,1,0,0,2
24601425,24602576,1151,0,0,1,1
24601432,24602576,1144,0,0,1,2
24602577,24602631,54,1,0,0,2
24602577,24602636,59,1,0,0,1
24602632,24602907,275,0,0,1,2
24602637,24602906,269,0,0,1,1
24602907,24602939,32,1,0,0,1
24602908,24602948,40,1,0,0,2
24602940,24603425,485,0,0,1,1
24602949,24603425,476,0,0,1,2
24603426,24603457,31,1,0,0,1
24603426,24603457,31,1,0,0,2
24603458,24604207,749,0,0,1,1
24603458,24604219,761,0,0,1,2
24604208,24604492,284,1,0,0,1
24604220,24604604,384,1,0,0,2
24604243,24604459,216,0,1,0,2
24604247,24604443,196,0,1,0,1
24604493,24604776,283,0,0,1,1
24604605,24604663,58,0,0,1,2
24604664,24604686,22,1,0,0,2
24604687,24604783,96,0,0,1,2
24604777,24604811,34,1,0,0,1
24604784,24604803,19,1,0,0,2
24604804,24605032,228,0,0,1,2
24604812,24605032,220,0,0,1,1
24605033,24605106,73,1,0,0,2
24605033,24605107,74,1,0,0,1
24605107,24605341,234,0,0,1,2
24605108,24605343,235,0,0,1,1
24605342,24605398,56,1,0,0,2
24605344,24605401,57,1,0,0,1
24605399,24605595,196,0,0,1,2
24605402,24605594,192,0,0,1,1
24605595,24605657,62,1,0,0,1
24605596,24605666,70,1,0,0,2
24605658,24605898,240,0,0,1,1
24605667,24605900,233,0,0,1,2
24605899,24605954,55,1,0,0,1
24605901,24605956,55,1,0,0,2
24605955,24606044,89,0,0,1,1
24605957,24606046,89,0,0,1,2
24606045,24606099,54,1,0,0,1
24606047,24606107,60,1,0,0,2
24606100,24606215,115,0,0,1,1
24606108,24606217,109,0,0,1,2
24606216,24606249,33,1,0,0,1
24606218,24606254,36,1,0,0,2
24606250,24607787,1537,0,0,1,1
24606255,24607787,1532,0,0,1,2
24607788,24607834,46,1,0,0,2
24607788,24607845,57,1,0,0,1
24607835,24607999,164,0,0,1,2
24607846,24607997,151,0,0,1,1
24607998,24608038,40,1,0,0,1
24608000,24608037,37,1,0,0,2
24608038,24608756,718,0,0,1,2
24608039,24609933,1894,0,0,1,1
24608757,24608773,16,1,0,0,2
24608774,24609933,1159,0,0,1,2
24609934,24609951,17,1,0,0,2
24609934,24609954,20,1,0,0,1
24609952,24610098,146,0,0,1,2
24609955,24610098,143,0,0,1,1
24610099,24610387,288,1,0,0,2
24610099,24610400,301,1,0,0,1
24610120,24610317,197,0,1,0,2
24610123,24610310,187,0,1,0,1
24610352,24610355,3,0,1,0,1
24610388,24610692,304,0,0,1,2
24610401,24610692,291,0,0,1,1
24610693,24610746,53,1,0,0,1
24610693,24610746,53,1,0,0,2
24610747,24611137,390,0,0,1,1
24610747,24611137,390,0,0,1,2
24611138,24611302,164,1,0,0,1
24611138,24611313,175,1,0,0,2
24611303,24611437,134,0,0,1,1
24611314,24611435,121,0,0,1,2
24611436,24611467,31,1,0,0,2
24611438,24611466,28,1,0,0,1
24611467,24612575,1108,0,0,1,1
24611468,24612463,995,0,0,1,2
24612464,24612480,16,1,0,0,2
24612481,24612575,94,0,0,1,2
24612576,24612627,51,1,0,0,2
24612576,24612628,52,1,0,0,1
24612628,24612860,232,0,0,1,2
24612629,24612859,230,0,0,1,1
24612860,24612892,32,1,0,0,1
24612861,24612893,32,1,0,0,2
24612893,24613907,1014,0,0,1,1
24612894,24613919,1025,0,0,1,2
24613908,24613934,26,1,0,0,1
24613920,24613935,15,1,0,0,2
24613935,24614222,287,0,0,1,1
24613936,24614223,287,0,0,1,2
24614223,24614240,17,1,0,0,1
24614224,24614243,19,1,0,0,2
24614241,24614673,432,0,0,1,1
24614244,24614661,417,0,0,1,2
24614662,24615357,695,1,0,0,2
24614674,24615295,621,1,0,0,1
24614703,24615253,550,0,1,0,2
24614707,24615256,549,0,1,0,1
24615296,24615468,172,0,0,1,1
24615358,24615424,66,0,0,1,2
24615425,24615771,346,1,0,0,2
24615469,24615717,248,1,0,0,1
24615500,24615643,143,0,1,0,2
24615501,24615613,112,0,1,0,1
24615637,24615648,11,0,1,0,1
24615718,24615866,148,0,0,1,1
24615772,24615869,97,0,0,1,2
24615867,24615934,67,1,0,0,1
24615870,24615945,75,1,0,0,2
24615935,24616028,93,0,0,1,1
24615946,24616028,82,0,0,1,2
24616029,24616062,33,1,0,0,1
24616029,24616072,43,1,0,0,2
24616063,24616829,766,0,0,1,1
24616073,24616829,756,0,0,1,2
24616830,24616867,37,1,0,0,1
24616830,24616899,69,1,0,0,2
24616868,24617210,342,0,0,1,1
24616900,24617211,311,0,0,1,2
24617211,24617268,57,1,0,0,1
24617212,24617269,57,1,0,0,2
24617269,24617809,540,0,0,1,1
24617270,24617809,539,0,0,1,2
24617810,24617833,23,1,0,0,1
24617810,24617833,23,1,0,0,2
24617834,24618151,317,0,0,1,2
24617834,24618152,318,0,0,1,1
24618152,24618184,32,1,0,0,2
24618153,24618182,29,1,0,0,1
24618183,24618455,272,0,0,1,1
24618185,24618454,269,0,0,1,2
24618455,24618465,10,1,0,0,2
24618456,24618466,10,1,0,0,1
24618466,24619229,763,0,0,1,2
24618467,24619230,763,0,0,1,1
24619230,24619571,341,1,0,0,2
24619231,24619561,330,1,0,0,1
24619276,24619484,208,0,1,0,2
24619282,24619460,178,0,1,0,1
24619562,24619746,184,0,0,1,1
24619572,24619747,175,0,0,1,2
24619747,24619815,68,1,0,0,1
24619748,24619824,76,1,0,0,2
24619816,24620125,309,0,0,1,1
24619825,24620126,301,0,0,1,2
24620126,24620161,35,1,0,0,1
24620127,24620149,22,1,0,0,2
24620150,24620425,275,0,0,1,2
24620162,24620427,265,0,0,1,1
24620426,24620447,21,1,0,0,2
24620428,24620446,18,1,0,0,1
24620447,24620651,204,0,0,1,1
24620448,24620652,204,0,0,1,2
24620652,24620714,62,1,0,0,1
24620653,24620713,60,1,0,0,2
24620714,24620785,71,0,0,1,2
24620715,24620789,74,0,0,1,1
24620786,24620823,37,1,0,0,2
24620790,24620810,20,1,0,0,1
24620811,24621758,947,0,0,1,1
24620824,24621328,504,0,0,1,2
24621329,24621340,11,1,0,0,2
24621341,24621764,423,0,0,1,2
24621759,24621781,22,1,0,0,1
24621765,24621787,22,1,0,0,2
24621782,24622660,878,0,0,1,1
24621788,24621896,108,0,0,1,2
24621897,24621901,4,1,0,0,2
24621902,24622463,561,0,0,1,2
24622464,24622496,32,1,0,0,2
24622497,24622660,163,0,0,1,2
24622661,24622717,56,1,0,0,1
24622661,24622740,79,1,0,0,2
24622718,24622861,143,0,0,1,1
24622741,24622862,121,0,0,1,2
24622862,24622904,42,1,0,0,1
24622863,24622904,41,1,0,0,2
24622905,24623224,319,0,0,1,2
24622905,24623234,329,0,0,1,1
24623225,24623952,727,1,0,0,2
24623235,24623556,321,1,0,0,1
24623255,24623545,290,0,1,0,2
24623262,24623481,219,0,1,0,1
24623557,24624070,513,0,0,1,1
24623953,24624070,117,0,0,1,2
24624071,24624103,32,1,0,0,1
24624071,24624103,32,1,0,0,2
24624104,24624826,722,0,0,1,2
24624104,24624830,726,0,0,1,1
24624827,24625320,493,1,0,0,2
24624831,24625150,319,1,0,0,1
24624869,24625110,241,0,1,0,2
24624873,24625071,198,0,1,0,1
24625151,24625527,376,0,0,1,1
24625321,24625386,65,0,0,1,2
24625387,24625424,37,1,0,0,2
24625425,24625526,101,0,0,1,2
24625527,24625558,31,1,0,0,2
24625528,24625558,30,1,0,0,1
24625559,24625822,263,0,0,1,2
24625559,24625823,264,0,0,1,1
24625823,24625874,51,1,0,0,2
24625824,24625871,47,1,0,0,1
24625872,24626269,397,0,0,1,1
24625875,24626272,397,0,0,1,2
24626270,24626331,61,1,0,0,1
24626273,24626329,56,1,0,0,2
24626330,24626735,405,0,0,1,2
24626332,24626735,403,0,0,1,1
24626736,24626789,53,1,0,0,1
24626736,24626799,63,1,0,0,2
24626790,24626909,119,0,0,1,1
24626800,24626909,109,0,0,1,2
24626910,24626940,30,1,0,0,1
24626910,24626941,31,1,0,0,2
24626941,24627848,907,0,0,1,1
24626942,24627848,906,0,0,1,2
24627849,24627911,62,1,0,0,1
24627849,24627912,63,1,0,0,2
24627912,24628069,157,0,0,1,1
24627913,24628070,157,0,0,1,2
24628070,24628109,39,1,0,0,1
24628071,24628113,42,1,0,0,2
24628110,24628529,419,0,0,1,1
24628114,24628527,413,0,0,1,2
24628528,24628566,38,1,0,0,2
24628530,24628547,17,1,0,0,1
24628548,24629910,1362,0,0,1,1
24628567,24629903,1336,0,0,1,2
24629904,24630143,239,1,0,0,2
24629911,24630114,203,1,0,0,1
24629941,24630063,122,0,1,0,2
24629949,24630029,80,0,1,0,1
24630115,24630378,263,0,0,1,1
24630144,24630380,236,0,0,1,2
24630379,24630445,66,1,0,0,1
24630381,24630456,75,1,0,0,2
24630446,24630593,147,0,0,1,1
24630457,24630587,130,0,0,1,2
24630588,24630838,250,1,0,0,2
24630594,24630806,212,1,0,0,1
24630616,24630767,151,0,1,0,2
24630625,24630730,105,0,1,0,1
24630807,24631144,337,0,0,1,1
24630839,24631144,305,0,0,1,2
24631145,24631217,72,1,0,0,1
24631145,24631217,72,1,0,0,2
24631218,24631308,90,0,0,1,1
24631218,24631309,91,0,0,1,2
24631309,24631352,43,1,0,0,1
24631310,24631355,45,1,0,0,2
24631353,24631510,157,0,0,1,1
24631356,24631512,156,0,0,1,2
24631511,24631537,26,1,0,0,1
24631513,24631538,25,1,0,0,2
24631538,24632227,689,0,0,1,1
24631539,24632222,683,0,0,1,2
24632223,24632254,31,1,0,0,2
24632228,24632253,25,1,0,0,1
24632254,24632738,484,0,0,1,1
24632255,24632737,482,0,0,1,2
24632738,24632800,62,1,0,0,2
24632739,24632798,59,1,0,0,1
24632799,24633001,202,0,0,1,1
24632801,24633003,202,0,0,1,2
24633002,24633038,36,1,0,0,1
24633004,24633037,33,1,0,0,2
24633038,24633923,885,0,0,1,2
24633039,24633920,881,0,0,1,1
24633921,24633942,21,1,0,0,1
24633924,24633951,27,1,0,0,2
24633943,24634850,907,0,0,1,1
24633952,24634844,892,0,0,1,2
24634845,24634862,17,1,0,0,2
24634851,24635195,344,1,0,0,1
24634863,24634889,26,0,0,1,2
24634890,24635398,508,1,0,0,2
24634918,24635153,235,0,1,0,2
24634923,24635118,195,0,1,0,1
24635196,24635438,242,0,0,1,1
24635399,24635440,41,0,0,1,2
24635439,24635456,17,1,0,0,1
24635441,24635452,11,1,0,0,2
24635453,24635720,267,0,0,1,2
24635457,24635721,264,0,0,1,1
24635721,24635755,34,1,0,0,2
24635722,24635757,35,1,0,0,1
24635756,24636425,669,0,0,1,2
24635758,24636423,665,0,0,1,1
24636424,24636507,83,1,0,0,1
24636426,24636504,78,1,0,0,2
24636505,24636604,99,0,0,1,2
24636508,24636604,96,0,0,1,1
24636605,24636636,31,1,0,0,2
24636605,24636637,32,1,0,0,1
24636637,24638321,1684,0,0,1,2
24636638,24638320,1682,0,0,1,1
24638321,24638386,65,1,0,0,1
24638322,24638367,45,1,0,0,2
24638368,24639474,1106,0,0,1,2
24638387,24639487,1100,0,0,1,1
24639475,24639511,36,1,0,0,2
24639488,24639492,4,1,0,0,1
24639493,24639743,250,0,0,1,1
24639512,24639736,224,0,0,1,2
24639737,24639753,16,1,0,0,2
24639744,24639754,10,1,0,0,1
24639754,24640366,612,0,0,1,2
24639755,24640361,606,0,0,1,1
24640362,24640886,524,1,0,0,1
24640367,24640927,560,1,0,0,2
24640422,24640828,406,0,1,0,1
24640424,24640830,406,0,1,0,2
24640887,24641011,124,0,0,1,1
24640928,24641012,84,0,0,1,2
24641012,24641078,66,1,0,0,1
24641013,24641078,65,1,0,0,2
24641079,24642354,1275,0,0,1,2
24641079,24642356,1277,0,0,1,1
24642355,24642432,77,1,0,0,2
24642357,24642419,62,1,0,0,1
24642420,24642511,91,0,0,1,1
24642433,24642509,76,0,0,1,2
24642510,24642569,59,1,0,0,2
24642512,24642547,35,1,0,0,1
24642548,24642782,234,0,0,1,1
24642570,24642782,212,0,0,1,2
24642783,24642815,32,1,0,0,2
24642783,24642816,33,1,0,0,1
24642816,24643643,827,0,0,1,2
24642817,24643643,826,0,0,1,1
24643644,24643684,40,1,0,0,2
24643644,24643698,54,1,0,0,1
24643685,24645658,1973,0,0,1,2
24643699,24643908,209,0,0,1,1
24643909,24643929,20,1,0,0,1
24643930,24645662,1732,0,0,1,1
24645659,24645673,14,1,0,0,2
24645663,24645673,10,1,0,0,1
24645674,24645718,44,0,0,1,2
24645674,24645724,50,0,0,1,1
24645719,24646353,634,1,0,0,2
24645725,24646315,590,1,0,0,1
24645754,24646273,519,0,1,0,1
24645754,24646273,519,0,1,0,2
24646316,24646556,240,0,0,1,1
24646354,24646546,192,0,0,1,2
24646547,24646909,362,1,0,0,2
24646557,24646865,308,1,0,0,1
24646581,24646760,179,0,1,0,1
24646581,24646785,204,0,1,0,2
24646866,24646973,107,0,0,1,1
24646910,24646953,43,0,0,1,2
24646954,24647042,88,1,0,0,2
24646974,24647038,64,1,0,0,1
24647039,24647263,224,0,0,1,1
24647043,24647264,221,0,0,1,2
24647264,24647311,47,1,0,0,1
24647265,24647323,58,1,0,0,2
24647312,24648186,874,0,0,1,1
24647324,24648187,863,0,0,1,2
24648187,24648231,44,1,0,0,1
24648188,24648255,67,1,0,0,2
24648232,24648362,130,0,0,1,1
24648256,24648372,116,0,0,1,2
24648363,24648386,23,1,0,0,1
24648373,24648386,13,1,0,0,2
24648387,24648857,470,0,0,1,2
24648387,24649342,955,0,0,1,1
24648858,24648866,8,1,0,0,2
24648867,24649337,470,0,0,1,2
24649338,24649359,21,1,0,0,2
24649343,24649361,18,1,0,0,1
24649360,24650255,895,0,0,1,2
24649362,24650241,879,0,0,1,1
24650242,24650628,386,1,0,0,1
24650256,24650600,344,1,0,0,2
24650282,24650508,226,0,1,0,2
24650284,24650515,231,0,1,0,1
24650601,24650839,238,0,0,1,2
24650629,24650841,212,0,0,1,1
24650840,24650922,82,1,0,0,2
24650842,24650882,40,1,0,0,1
24650883,24651081,198,0,0,1,1
24650923,24651082,159,0,0,1,2
24651082,24651101,19,1,0,0,1
24651083,24651121,38,1,0,0,2
24651102,24651641,539,0,0,1,1
24651122,24651640,518,0,0,1,2
24651641,24651718,77,1,0,0,2
24651642,24651718,76,1,0,0,1
24651719,24651773,54,0,0,1,1
24651719,24651775,56,0,0,1,2
24651774,24651813,39,1,0,0,1
24651776,24651827,51,1,0,0,2
24651814,24651925,111,0,0,1,1
24651828,24651923,95,0,0,1,2
24651924,24651957,33,1,0,0,2
24651926,24651959,33,1,0,0,1
24651958,24652394,436,0,0,1,2
24651960,24652394,434,0,0,1,1
24652395,24652430,35,1,0,0,2
24652395,24652433,38,1,0,0,1
24652431,24652691,260,0,0,1,2
24652434,24652690,256,0,0,1,1
24652691,24652725,34,1,0,0,1
24652692,24652722,30,1,0,0,2
24652723,24653324,601,0,0,1,2
24652726,24653323,597,0,0,1,1
24653324,24653366,42,1,0,0,1
24653325,24653369,44,1,0,0,2
24653367,24653578,211,0,0,1,1
24653370,24653578,208,0,0,1,2
24653579,24653619,40,1,0,0,1
24653579,24653619,40,1,0,0,2
24653620,24653903,283,0,0,1,2
24653620,24653910,290,0,0,1,1
24653904,24653922,18,1,0,0,2
24653911,24653927,16,1,0,0,1
24653923,24654200,277,0,0,1,2
24653928,24654200,272,0,0,1,1
24654201,24654220,19,1,0,0,1
24654201,24654234,33,1,0,0,2
24654221,24655466,1245,0,0,1,1
24654235,24655463,1228,0,0,1,2
24655464,24655802,338,1,0,0,2
24655467,24655748,281,1,0,0,1
24655500,24655695,195,0,1,0,2
24655504,24655657,153,0,1,0,1
24655749,24655927,178,0,0,1,1
24655803,24655928,125,0,0,1,2
24655928,24655955,27,1,0,0,1
24655929,24655968,39,1,0,0,2
24655956,24656455,499,0,0,1,1
24655969,24656456,487,0,0,1,2
24656456,24656487,31,1,0,0,1
24656457,24656487,30,1,0,0,2
24656488,24656845,357,0,0,1,2
24656488,24656846,358,0,0,1,1
24656846,24656951,105,1,0,0,2
24656847,24657044,197,1,0,0,1
24656935,24656977,42,0,1,0,1
24656952,24657000,48,0,0,1,2
24657001,24657048,47,1,0,0,2
24657045,24657096,51,0,0,1,1
24657049,24657097,48,0,0,1,2
24657097,24657132,35,1,0,0,1
24657098,24657133,35,1,0,0,2
24657133,24657235,102,0,0,1,1
24657134,24657235,101,0,0,1,2
24657236,24657261,25,1,0,0,1
24657236,24657272,36,1,0,0,2
24657262,24658535,1273,0,0,1,1
24657273,24658536,1263,0,0,1,2
24658536,24658596,60,1,0,0,1
24658537,24658583,46,1,0,0,2
24658584,24659585,1001,0,0,1,2
24658597,24659142,545,0,0,1,1
24659143,24659157,14,1,0,0,1
24659158,24659584,426,0,0,1,1
24659585,24659617,32,1,0,0,1
24659586,24659615,29,1,0,0,2
24659616,24660677,1061,0,0,1,2
24659618,24660320,702,0,0,1,1
24660321,24660332,11,1,0,0,1
24660333,24660659,326,0,0,1,1
24660660,24661052,392,1,0,0,1
24660678,24661054,376,1,0,0,2
24660705,24660972,267,0,1,0,1
24660705,24660976,271,0,1,0,2
24661053,24661373,320,0,0,1,1
24661055,24661372,317,0,0,1,2
24661373,24661409,36,1,0,0,2
24661374,24661411,37,1,0,0,1
24661410,24661805,395,0,0,1,2
24661412,24661806,394,0,0,1,1
24661806,24661874,68,1,0,0,2
24661807,24661867,60,1,0,0,1
24661868,24661933,65,0,0,1,1
24661875,24661933,58,0,0,1,2
